评论id,老师id,老师姓名,发表时间,点赞减去点踩数量,点赞量,点踩量,内容
9376,14,彭列平,2015-10-25 12:20:09,0,6,6,怎么会有这种老师  思想偏见严重
11575,14,彭列平,2015-12-06 10:38:56,6,9,3,每次点名
14847,14,彭列平,2016-01-10 04:55:17,6,11,5,喜欢 很亲切
14848,14,彭列平,2016-01-10 04:53:28,25,29,4,好亲切
14849,14,彭列平,2016-01-10 04:53:35,9,12,3,亲和温柔
21531,14,彭列平,2016-02-29 06:20:31,0,4,4,不错的
22850,14,彭列平,2016-03-13 11:59:12,2,3,1,比较闲
25995,14,彭列平,2016-06-15 03:21:04,1,3,2,呵呵哒
26493,14,彭列平,2016-06-19 07:01:23,-1,2,3,不错的
27363,14,彭列平,2016-06-25 07:50:40,-4,1,5,老师很亲切和善，助教哥哥人也很好，给分不错，考试时很多不会，凭自己理解写的还是拿到了满意的分数，感恩
27364,14,彭列平,2016-06-25 07:55:42,6,7,1,点名靠签字还是很水的
27408,14,彭列平,2016-06-26 01:48:35,-12,6,18,虽然说是点名 但最后几次课会把签到表传下来  就可以补签   没有作业没有论文    事少课好      给分还好    wuli理科生形策?点拯救者    水了一学期最后4.5   太感谢
27463,14,彭列平,2016-06-26 10:48:26,-12,8,20,给分特别好，我可以肯定地说我一节课都没听讲（不过我都去上课了），最后考试背题目背ppt而且还没背全，考试的时候到最后根本BB不出来，最后居然绩点辣么高。谜一样。
27724,14,彭列平,2016-06-27 09:41:09,0,1,1,挺好的老师
27856,14,彭列平,2016-06-28 00:00:15,7,8,1,并不觉得给分好。。蛮水的 签签到就行
27938,14,彭列平,2016-06-28 06:39:38,1,2,1,虽然我绩点低，但是老师超好
28061,14,彭列平,2016-06-28 08:03:15,0,1,1,人很好诶 很耐心
28116,14,彭列平,2016-06-28 08:07:34,-3,2,5,挺水的，助教拿单子签名。貌似给分还可以？
28741,14,彭列平,2016-06-28 13:42:48,0,2,2,和不去一样，水，绩点低
29491,14,彭列平,2016-06-30 01:31:52,0,0,0,人好事情少
29631,14,彭列平,2016-06-30 05:40:09,0,2,2,谜一样的给分
30855,14,彭列平,2016-07-02 16:27:45,1,1,0,事少点名
52323,14,彭列平,2017-06-18 09:51:21,22,27,5,马上就考形策了，据说给我们超棒的彭老师打满分就能收获好成绩！(´ε｀ )♡
53579,14,彭列平,2017-06-27 05:13:32,1,2,1,……给分怕不是超随意，并不懂这个体系
54762,14,彭列平,2017-06-30 07:23:21,0,1,1,感觉给分不太好……
80788,14,彭列平,2018-07-01 05:54:25,6,7,1,事情少\n\n考前打个10分保平安
80813,14,彭列平,2018-07-01 09:45:50,-2,0,2,考试之前先给彭老师一个九分好评，希望能考一个好看的分数。事少，讲得好，很亲切，很水，还有一分是因为...实在是太水了，哈哈哈哈
82230,14,彭列平,2019-11-17 06:50:19,4,6,2,行策一 水课 基本不听 平时签到 学生手册考试都满 考前突击了一下 感觉给分不太好
82233,14,彭列平,2018-07-07 13:59:35,2,2,0,拉我绩点 无语了简直
82236,14,彭列平,2018-07-07 14:06:32,1,1,0,怎一个惨字了得\n\n
82254,14,彭列平,2018-07-07 14:58:42,-6,2,8,给分挺好的，背了两天的PPT和思考题，4.5~
82285,14,彭列平,2018-07-07 16:26:39,-1,0,1,比起其他行测老师还每堂课点人回答以及小测这些有的没的，简直好太多了
82286,14,彭列平,2018-07-08 00:59:22,-6,1,7,卡在4.2。和另一个钟为民老师的同学一起准备的很充分，结果钟为民老师的那位同学满了，然而emmmm，这位老师这里，平时分和学生手册都满了，只能说老师给分真的不怎么好
82894,14,彭列平,2018-07-09 09:22:24,-4,1,5,其实我觉得还行....平时签到可以找别人代替.....也没有其他事了....行策考试还是要靠自己吧......考前背了一天.....最后4.2
83473,14,彭列平,2018-07-10 10:55:15,0,0,0,是个好老师，形策课么本来就是水水的
83753,14,彭列平,2018-07-11 07:01:04,7,8,1,为了满足正太要求所有人总评减四分了解一下。
102624,14,彭列平,2019-02-14 08:11:30,1,2,1,谁知道这个寒假留没留作业，有点害怕?
111154,14,彭列平,2019-06-30 05:54:19,1,1,0,10求过
111758,14,彭列平,2019-07-02 18:59:18,0,0,0,不说别的，形策这种课给分不好就直接pass吧
111778,14,彭列平,2019-07-02 22:42:32,0,0,0,上过的所有课中给分最迷的一门
111791,14,彭列平,2019-07-02 23:16:25,0,1,1,该死的正态
111847,14,彭列平,2019-07-03 01:06:15,6,6,0,人好事少大绩杀
111928,14,彭列平,2019-07-03 03:11:46,-4,4,8,人好事少，最后的考试复习了两小时就4.5了，讲道理好好背+字写得好看应该就不会差了。并且一学分的课大家真的不要太在意绩点，这个老师真的事情很少很少，要用题目点名的时候还会和大家说“这次不要先走哦，我一会儿有个课堂题目点名”，反正就算3.5我也喜欢这个老师。
125884,14,彭列平,2020-09-15 09:41:05,0,1,1,绩杀不多说
125977,14,彭列平,2020-09-16 07:03:38,0,0,0,谢谢老师，形策1至少大家成绩都差不多
137161,14,彭列平,2021-07-01 14:57:45,0,0,0,出分前求保佑
137577,14,彭列平,2021-07-05 07:08:09,0,0,0,出分求保佑
137829,14,彭列平,2021-07-06 08:54:44,0,1,1,上课水 次次发签到表 给分random
139637,14,彭列平,2021-07-18 15:34:49,1,1,0,形策除了一次很轻很轻的寒假作业没有别的事了，上课纸质签到开溜代签干自己的事都很方便，对应的期末给分看天，总的来说无功无过。
139921,14,彭列平,2021-08-19 14:03:33,1,1,0,nice！！！
140413,14,彭列平,2021-09-11 02:08:18,0,0,0,中规中矩，考前看了一小时ppt，最后3.6
141753,14,彭列平,2021-10-24 12:22:14,1,1,0,拖堂严重，不按时间表
152820,14,彭列平,2022-04-20 06:44:14,3,3,0,谢谢你堂老压
155502,14,彭列平,2022-06-13 15:13:38,0,0,0,出分求保佑
156787,14,彭列平,2022-06-21 03:16:31,4,4,0,谢谢老师捞我\n\n谢谢老师的课对比之下真的事很少
156803,14,彭列平,2022-06-21 03:42:39,1,1,0,能给4.2很好了
156912,14,彭列平,2022-06-21 10:29:00,2,2,0,在我认识的同学里，彭老师的形策是事情最少的，俩学期思考题全都是思考就行，干活的一共就一次小组汇报（10人一组，极水），也没有任何作业。点名是要雷达的，给分也还不错的，看得出有在捞。就给个10了
160717,14,彭列平,2022-10-05 08:58:48,0,0,0,彭老师班主任的班上学生bd\n\n老师怎的很好很好很好
175947,14,彭列平,2023-06-27 08:26:46,0,0,0,老师很好，事情很少，但是给分不是很好，自己拿到了4.2感觉还是不够但是一看最低的均绩感觉也没啥大不了的，只能说一学分的课程，持续整整一年，也没必要斤斤计较。
195929,14,彭列平,2024-07-01 01:44:18,0,0,0,给分太差
222046,14,彭列平,2025-06-29 07:13:35,0,0,0,形策课：点名时间固定，作业极少（几乎可以算没有了），给分比预期好不少
4845,16,孙凌云,2015-06-29 14:02:09,25,35,10,绝对不水！大家喜欢吗？
41690,16,孙凌云,2017-01-12 10:58:18,20,23,3,长得很帅
57563,16,孙凌云,2017-07-09 23:04:25,14,16,2,4学分的课上成12学分感
61140,16,孙凌云,2017-11-09 03:49:55,14,15,1,帅，好
63051,16,孙凌云,2017-11-28 04:49:40,8,10,2,不管怎么说是工业设计算是靠谱的老师了
63643,16,孙凌云,2017-12-11 10:06:58,7,8,1,醍醐灌顶，相当受启发
104639,16,孙凌云,2019-03-25 16:59:20,2,4,2,我爱孙老师～听他的课就是信息量巨大的体验
107594,16,孙凌云,2019-05-07 09:43:28,12,13,1,超级棒的老师，信息量和前沿程度都超级赞，很为学生着想的老师，讲课的方法技巧也超厉害，老师很帅(๑>؂<๑）
123010,16,孙凌云,2020-04-30 04:14:18,3,5,2,帅且靠谱！
141553,16,孙凌云,2021-10-14 07:55:09,9,9,0,卷王🤪可能就是喜欢看学生卷吧
148726,16,孙凌云,2022-01-13 10:10:12,3,6,3,可以说是我大学以来见过的授课最认真、最科学、最积极主动的老师了。课上下来并不轻松，但是绝对不亏
159434,16,孙凌云,2022-07-19 09:16:58,-1,3,4,讲课非常有逻辑，干货满满！
176717,16,孙凌云,2023-06-30 00:36:10,-8,2,10,给分不好，考评机制不公平，但是内容很充实
201543,16,孙凌云,2024-12-02 03:42:53,-3,1,4,非常好的学习体验
206065,16,孙凌云,2024-12-13 04:34:11,-2,1,3,非常帅
219773,16,孙凌云,2025-06-05 12:24:47,0,1,1,数数sly以及底下的王gy陈lq乃至月牙楼hci有关的老师一作paper数量\n\n是老师太努力？还是学生太没用？怎么学生就发不出自己的一作paper呢？
27196,45,刘玉生,2016-06-27 07:50:23,-46,3,49,拿了100分
65659,45,刘玉生,2018-01-08 05:27:36,-18,0,18,风趣幽默，讲得太好啦！！！
66677,45,刘玉生,2018-01-18 07:13:11,-12,0,12,很善良的老师
78764,45,刘玉生,2018-07-08 03:25:49,-9,1,10,老师人非常好
110727,45,刘玉生,2019-06-28 05:48:27,26,33,7,NMSL❤️\n\n???????????
110728,45,刘玉生,2019-06-28 05:55:24,15,15,0,上课挺没意思的，虽然软工这门课本身就没什么意思。明明是软件工程课，老师却经常不说清楚各种报告、任务的需求……大程是真的心累
110959,45,刘玉生,2019-06-28 23:13:12,10,10,0,两次签到10分了解一下
135606,45,刘玉生,2021-05-17 01:08:45,3,9,6,相比于其他软工老师，lysyyds，工作量很少，人很佛，很宽厚
157179,45,刘玉生,2022-06-22 07:24:17,19,19,0,老师和助教仿佛从来不见面一样，大程要求模糊不清，最可气的是，其他老师在考场里都说了选择题判分规则，他居然不来说！！！
157493,45,刘玉生,2022-06-23 12:15:02,27,27,0,楼下不要乱说，lys老师不是不说，是只在自己教学班的一个考场说，不在自己教学班的另一个考场说，流汗黄豆.jpg。\n\n\n\n考试周期间安排线下展示，还在群里暗戳戳说会点名，占用大家两个小时，最后也没点。考前对考试重点丝毫未提（别的班提了）。\n\n\n\n优点是事情比别的班少不少，人比较nice，脾气比较好。好像软工这烂课也没什么其他好老师可以选了。\n\n\n\n最后问一句这破课什么时候取消？？？？？
157930,45,刘玉生,2022-06-25 16:00:48,17,17,0,刚出成绩，拿到本科三年最低绩点。\n\n想来是因为没有卷课堂发言去提平时分吧。
157937,45,刘玉生,2022-06-26 04:55:13,21,23,2,楼下淡定。我平时卷了12次发言，最后还是绩杀了。给分比wzy差了十条街了属于是
157938,45,刘玉生,2022-06-25 16:18:23,35,40,5,？？？\n\n给分非常不好，劝退了。上课看上去很友善，事情也不会太多，但是给分太差了。一个班100多号人只有个位数能上90+，怎么回事呢？\n\n快逃吧
157939,45,刘玉生,2022-06-25 16:20:32,23,23,0,快逃！这课给分最好的真的是王章野。虽然事情多，给分是真的好，上90概率比lys班高了六七倍，我真的是服了。顺便抱怨一下，为啥考试周中间开展示课，也不讲考试重点，甚至判分规则都不咱班里说清楚，别的班都知道！
157942,45,刘玉生,2022-06-25 16:33:15,11,11,0,垃圾课
157948,45,刘玉生,2022-06-25 17:24:42,11,11,0,平时事情少\n\n但是给分（）尤指平时分）不太行
157949,45,刘玉生,2022-06-25 17:47:08,13,13,0,卷了课堂发言也很低，感觉考试跟没去一样
157950,45,刘玉生,2022-06-27 00:43:21,13,14,1,流汗黄豆.jpg
157952,45,刘玉生,2022-06-25 17:58:56,10,10,0,刘玉生不会还以为自己给分很好吧
157963,45,刘玉生,2022-06-25 23:29:00,10,10,0,给分很差，
157994,45,刘玉生,2022-06-26 03:57:50,7,7,0,教室氛围挺适合休息的，明年还来🥰
158005,45,刘玉生,2022-06-26 06:59:25,9,9,0,牛马老师 给分极差 不顾学生 只在意自己的公司
158060,45,刘玉生,2022-06-26 13:39:04,7,7,0,正义审判，1分完事
158128,45,刘玉生,2022-06-27 06:00:51,8,8,0,给分不行
158152,45,刘玉生,2022-06-27 08:15:39,9,9,0,给分差，还甩锅，老师助教仿佛从不沟通，个位数上九十沾沾自喜
158231,45,刘玉生,2022-06-27 15:33:39,8,8,0,在一个考场说了选择题给分规则不在另一个考场说，给分烂还自我感动、不听意见。。选lys的输惨了
158233,45,刘玉生,2022-06-27 15:35:27,7,8,1,在一个考场说了选择题给分规则不在另一个考场说，给分烂还自我感动、不听意见。。选lys的输惨了
158257,45,刘玉生,2022-06-28 01:00:03,11,11,0,给分烂得不行，快逃
158266,45,刘玉生,2022-06-28 02:42:58,8,8,0,考试周还搞期末展示，还自以为安排的很好，还感觉学生都很爱自己？纯纯的吸血鬼！
158318,45,刘玉生,2022-06-28 09:13:48,8,8,0,呵呵哒，一分都嫌多
158320,45,刘玉生,2022-06-28 09:27:04,11,11,0,yacc丁真，鉴定为reduce了吸血鬼shift的马
158352,45,刘玉生,2022-06-28 15:21:42,9,9,0,给分是真的烂，垃圾老师
158414,45,刘玉生,2022-06-30 03:17:58,37,43,6,yacc丁真，纯纯1分；给分稀烂，只会摆烂。\n\n52/60平均分，尊享小丑专属；混沌规则，纵享出分刺激。\n\n本科最低分拿到手软！吸血鬼lys非你莫属！
158415,45,刘玉生,2022-06-29 05:46:44,13,13,0,规则混沌，给分稀烂
158416,45,刘玉生,2022-06-29 05:47:26,28,29,1,你知不知道很多保研边缘人，出国人，因为你，人生轨迹都变了？一分滚粗
158418,45,刘玉生,2022-06-29 05:57:31,15,15,0,给分规则不说清楚，一百多人个位数上90。。。除了烂就是烂
158419,45,刘玉生,2022-06-29 06:10:31,17,18,1,我们居然有几位同学上了90分，我lys给分真是太好啦！你们还不感恩？
158437,45,刘玉生,2022-06-29 09:14:54,9,11,2,千言万语化成一句 谢谢老师(😅
158443,45,刘玉生,2022-06-29 09:44:05,12,12,0,"""一直在帮拉"" ? 原来直接把我拉下去"
158446,45,刘玉生,2022-06-29 10:09:37,13,13,0,在一个考场说了选择题给分规则不在另一个考场说，就这一点一分都嫌多
158455,45,刘玉生,2022-06-29 11:54:21,8,8,0,给分呵呵
158478,45,刘玉生,2022-06-29 14:22:26,11,12,1,分享刘玉生老师经典言行：\n\n1. （被问到为什么平均分比王章野班少很多）“王老师班人数太少，只有10来人，没有可比性。我们班人数最多，超过100人”、“平均分 平时分 5个班肯定会有一个高高低低的，不可能都在一个基准”\n\n2. （被问到为什么bonus少加了）“当时是说了最多可以给5分，我和以前同一门课的发言情况对比了一下，觉得今年最多给3分比较合适”\n\n3. （被问到为什么别的班组长直接加总评）“我这里 组长一直以来没有加总评，因为我觉得组长们是辛苦了，但同时也锻炼了自己”\n\n4. “我一直在为同学们考虑啊”\n\n5. 60分平时分平均分52，下一届学弟学妹自己看着办吧
158489,45,刘玉生,2022-06-29 16:31:20,7,7,0,每天一骂 reduce shift 的码
158539,45,刘玉生,2022-06-30 05:45:49,10,10,0,niu and ma
158541,45,刘玉生,2022-06-30 05:56:29,9,9,0,为什么没有0分
158580,45,刘玉生,2022-06-30 10:18:45,10,10,0,管你们在群里怎么吵，我不看，我不回，毕竟我在开着公司呢
158581,45,刘玉生,2022-06-30 10:20:19,7,7,0,1分献上
158629,45,刘玉生,2022-07-01 01:30:13,11,11,0,烂太烂了真的是烂，从没上过这么让人心梗的课，平时分为什么给那么低
158635,45,刘玉生,2022-07-01 02:04:57,9,9,0,快逃！
158638,45,刘玉生,2022-07-01 02:21:46,9,9,0,每日一分
158650,45,刘玉生,2022-07-01 03:30:17,21,21,0,看似给分垃圾 实则是为了将自己跟软工教学组其他老师拉到同一水平线 从而平衡下一届软工各个班级的人数 lys这波属实在大气层
158737,45,刘玉生,2022-07-01 16:25:01,5,5,0,一分都嫌多
158786,45,刘玉生,2022-07-02 07:06:13,10,10,0,已读不回
158803,45,刘玉生,2022-07-02 11:01:49,8,8,0,一分都嫌多！牛马老师
158847,45,刘玉生,2022-07-02 17:13:00,6,6,0,他木琴趋势了导致这样的
158856,45,刘玉生,2022-07-03 04:36:11,7,7,0,给分和别的班差了至少一档两档，傻逼玩意儿
158920,45,刘玉生,2022-07-03 09:47:58,8,8,0,刘一分
158958,45,刘玉生,2022-07-04 02:34:58,5,5,0,为什么没有-1分
159041,45,刘玉生,2022-07-05 03:43:41,7,7,0,难受！！！
159061,45,刘玉生,2022-07-05 08:48:15,-21,0,21,男神！！！
159072,45,刘玉生,2022-07-08 14:04:03,4,4,0,楼上那个男神是不是打错了ac01
159086,45,刘玉生,2022-07-06 03:31:05,4,4,0,给分太烂！给分太烂！给分太烂！给分太烂！给分太烂！给分太烂！给分太烂！给分太烂！给分太烂！给分太烂！给分太烂！给分太烂！给分太烂！给分太烂！给分太烂！给分太烂！给分太烂！给分太烂！给分太烂！给分太烂！给分太烂！给分太烂！给分太烂！给分太烂！给分太烂！给分太烂！给分太烂！给分太烂！给分太烂！给分太烂！给分太烂！给分太烂！给分太烂！给分太烂！给分太烂！给分太烂！给分太烂！给分太烂！给分太烂！给分太烂！给分太烂！给分太烂！给分太烂！给分太烂！给分太烂！给分太烂！给分太烂！给分太烂！给分太烂！给分太烂！给分太烂！给分太烂！给分太烂！给分太烂！给分太烂！给分太烂！给分太烂！给分太烂！给分太烂！给分太烂！给分太烂！给分太烂！给分太烂！给分太烂！给分太烂！给分太烂！给分太烂！给分太烂！给分太烂！给分太烂！给分太烂！给分太烂！给分太烂！给分太烂！给分太烂！给分太烂！给分太烂！给分太烂！给分太烂！给分太烂！给分太烂！给分太烂！给分太烂！给分太烂！给分太烂！给分太烂！给分太烂！给分太烂！给分太烂！给分太烂！给分太烂！给分太烂！给分太烂！给分太烂！给分太烂！给分太烂！给分太烂！给分太烂！给分太烂！给分太烂！给分太烂！给分太烂！给分太烂！给分太烂！给分太烂！给分太烂！给分太烂！给分太烂！给分太烂！给分太烂！给分太烂！给分太烂！给分太烂！给分太烂！给分太烂！给分太烂！给分太烂！给分太烂！给分太烂！给分太烂！给分太烂！给分太烂！给分太烂！给分太烂！给分太烂！给分太烂！给分太烂！给分太烂！给分太烂！给分太烂！给分太烂！给分太烂！给分太烂！给分太烂！给分太烂！给分太烂！给分太烂！给分太烂！给分太烂！给分太烂！给分太烂！给分太烂！给分太烂！给分太烂！给分太烂！给分太烂！给分太烂！给分太烂！给分太烂！给分太烂！
159087,45,刘玉生,2022-07-06 03:31:05,4,4,0,给分太烂！给分太烂！给分太烂！给分太烂！给分太烂！给分太烂！给分太烂！给分太烂！给分太烂！给分太烂！给分太烂！给分太烂！给分太烂！给分太烂！给分太烂！给分太烂！给分太烂！给分太烂！给分太烂！给分太烂！给分太烂！给分太烂！给分太烂！给分太烂！给分太烂！给分太烂！给分太烂！给分太烂！给分太烂！给分太烂！给分太烂！给分太烂！给分太烂！给分太烂！给分太烂！给分太烂！给分太烂！给分太烂！给分太烂！给分太烂！给分太烂！给分太烂！给分太烂！给分太烂！给分太烂！给分太烂！给分太烂！给分太烂！给分太烂！给分太烂！给分太烂！给分太烂！给分太烂！给分太烂！给分太烂！给分太烂！给分太烂！给分太烂！给分太烂！给分太烂！给分太烂！给分太烂！给分太烂！给分太烂！给分太烂！给分太烂！给分太烂！给分太烂！给分太烂！给分太烂！给分太烂！给分太烂！给分太烂！给分太烂！给分太烂！给分太烂！给分太烂！给分太烂！给分太烂！给分太烂！给分太烂！给分太烂！给分太烂！给分太烂！给分太烂！给分太烂！给分太烂！给分太烂！给分太烂！给分太烂！给分太烂！给分太烂！给分太烂！给分太烂！给分太烂！给分太烂！给分太烂！给分太烂！给分太烂！给分太烂！给分太烂！给分太烂！给分太烂！给分太烂！给分太烂！给分太烂！给分太烂！给分太烂！给分太烂！给分太烂！给分太烂！给分太烂！给分太烂！给分太烂！给分太烂！给分太烂！给分太烂！给分太烂！给分太烂！给分太烂！给分太烂！给分太烂！给分太烂！给分太烂！给分太烂！给分太烂！给分太烂！给分太烂！给分太烂！给分太烂！给分太烂！给分太烂！给分太烂！给分太烂！给分太烂！给分太烂！给分太烂！给分太烂！给分太烂！给分太烂！给分太烂！给分太烂！给分太烂！给分太烂！给分太烂！给分太烂！给分太烂！给分太烂！给分太烂！给分太烂！
159101,45,刘玉生,2022-07-06 07:42:53,5,5,0,一分打卡
159314,45,刘玉生,2022-07-12 07:20:23,1,1,0,一分打卡
159404,45,刘玉生,2022-07-16 12:46:13,1,1,0,给分稀烂，对学生态度也很差
159532,45,刘玉生,2022-08-04 15:30:23,1,1,0,垃圾lys
159775,45,刘玉生,2022-08-29 08:33:26,2,2,0,垃圾，丝毫不关心学生的前途
159837,45,刘玉生,2022-09-05 12:34:17,1,1,0,垃圾，谁选谁后悔
159992,45,刘玉生,2022-09-11 07:33:25,1,1,0,均绩3.4是假的，2.4不知道有没有
160313,45,刘玉生,2022-09-19 01:23:29,1,1,0,快逃快逃
164069,45,刘玉生,2022-12-17 16:30:14,3,3,0,选课时间到了，学长提醒学弟学妹们快逃
165992,45,刘玉生,2023-01-10 15:43:41,3,3,0,纯sb
170502,45,刘玉生,2023-03-06 03:15:24,2,2,0,太差了
171933,45,刘玉生,2023-04-13 02:32:29,3,3,0,20级来骂了\n\n拿着工资不上课，学隔壁班，让学生上整节课\n\n事多的一比，这个教学班已经一无是处\n\n预置他的听我劝，毫不犹豫退掉
171934,45,刘玉生,2023-04-13 02:34:43,1,1,0,好好去开公司吧，来上什么课啊
175223,45,刘玉生,2023-06-22 13:32:25,1,1,0,恶心人
175750,45,刘玉生,2023-06-26 11:50:20,0,1,1,100
177422,45,刘玉生,2023-07-03 08:35:08,-1,0,1,今年给分有点逆转的感觉（怀疑是考试简单了），虽然上课依然没有必要听，但是事情确实比wzy班少不少，反正逃不掉的话硬着头皮上也不是不可
177428,45,刘玉生,2023-07-03 08:46:47,-1,0,1,刘玉生今年nb!
178365,45,刘玉生,2023-07-11 03:06:51,0,1,1,lys今年给分还行，可以
190609,45,刘玉生,2024-03-11 13:33:56,6,6,0,第一节课点名，牛逼
193672,45,刘玉生,2024-06-15 04:17:32,4,4,0,端午节假期晚上安排展示，牛逼
196689,45,刘玉生,2024-07-04 18:38:03,1,1,0,摆烂组的一个小组长，首先是对软工这门课，教的东西感觉没人听，考的东西只要会画图就不可能被斩杀，但想拿高分需要画出大量的时间。对刘老师的软工课来讲，有4次共计20分的点名分，基本上都是在课前说点名，课间手动签。然后的话是20分的各类报告和20分的展示。感觉大程事实上没有想象的那么重要，严格来讲大程也确实不占分（但会影响报告和展示时的直观感受）。最好组里有一个或少数几个佬能完成大程主要的任务，剩下的人专注做报告、画图、做ppt等，否则最后做的很可能是依托答辩。至于分数感觉不像前几年说的那么离谱，而事情确实是少（除了上课只需要管几份报告和两次展示）。
196720,45,刘玉生,2024-07-05 01:59:23,-8,1,9,还行，事确实少，期末复习了二十多个小时，一半时间是在背题库😥😥😥剩下一半时间就是学画图和计算，简答那一题就凭运气了，最后总评94，虽然不知道我期末多少分，但平时分肯定给的还行
222033,45,刘玉生,2025-06-29 05:41:27,1,1,0,刘玉生老师，是一个课上不怎么管的老师，就像之前的评论所说的，软件工程这门课就是shi，谁来也不能改变它是shi这一事实\n\n就lys老师的上课而言\n\n每学期会有④次点名（包括纸质签到+小测），一般在第一节课课间，接受课后补签，签了就给分，没签就不给——没什么好说的\n\n大程是一如既往的难评，一定要找一个负责任的组长组员——会省很多事\n\n大程报告一定要用心写，最好看看往年学长的格式，看看ppt上的要求，积极和助教老师沟通（高点现成的latex模板会方便很多）\n\n期末考试是不定项+判断+简答+画图：优先复习画图，多画多练，50分一定要确保能基本拿满，简答题注意wzy老师的quiz3，不定项和判断来自于软工36章题库（量力而为）\n\n总的来说，shi就是shi，这课没得洗，lys老师虽然讲不出什么花来，但也不会刻意的恶心同学，事情相对比较少，给分方面也不算很差，至少我觉得给分甚至挺好（？），可以选！\n\n——zszm
32,52,白洪欢,2015-03-14 15:29:34,62,96,34,上过白老师的C程，对于初学者来说还是挺不错的。但对与计算机专业的同学来说，觉得某些要点讲得还不够，以致在后续课程中总觉得自己C程还没入门
42,52,白洪欢,2015-03-14 15:30:57,91,103,12,真心很好。很细
70,52,白洪欢,2017-07-11 03:49:02,213,226,13,逆向工程专家
99,52,白洪欢,2015-03-14 15:51:32,4,8,4,给分好！
118,52,白洪欢,2015-03-14 15:59:44,29,37,8,通识课会放电影！
156,52,白洪欢,2015-03-14 16:14:43,13,15,2,很有收获
189,52,白洪欢,2015-03-14 16:39:39,35,48,13,比较有趣
287,52,白洪欢,2015-03-15 00:17:22,4,6,2,有趣，能学到知识
340,52,白洪欢,2015-03-15 01:05:02,376,418,42,他的课准备得很用心 讲解的也很细致。不点名。对学生也很好，尤其是机房作业设置方面。好爱他的！
367,52,白洪欢,2015-03-15 01:31:42,42,58,16,很有良心的老师，能学到东西的课
473,52,白洪欢,2015-03-15 03:00:08,4,8,4,在白老师的课上学到了很多东西。
582,52,白洪欢,2015-03-15 06:02:30,12,17,5,这个老师很牛
670,52,白洪欢,2015-03-15 11:24:41,87,100,13,小白很棒的！上过大计基，讲的都是非常实用的内容，还会有很多技巧教给大家，还会放电影，对同学们的要求也比较合理。
780,52,白洪欢,2015-03-17 02:09:14,3,8,5,相当不错的老师
833,52,白洪欢,2015-03-17 15:56:12,182,213,31,小白老师只要是计院的应该都知道，现在已经当爹了哈哈哈哈！上过他的汇编语言，课间的时候会放电影给我们看…光顾着看电影了结果低空飘过真是愧对老师TAT
904,52,白洪欢,2016-06-08 12:54:29,1033,1087,54,潜伏在民间的黑客
1055,52,白洪欢,2015-03-21 16:02:29,0,4,4,讲课真的好好，上过他的课其他都是将就
1127,52,白洪欢,2019-04-16 11:08:30,312,334,22,目前为止最爱的浙大老师，人超好，讲的东西，他的很多见解（不仅是学习，还有很多人生）都非常非常好！
1242,52,白洪欢,2015-03-21 16:58:19,1,4,3,很有趣 电影哦
1331,52,白洪欢,2015-03-22 00:10:41,7,9,2,好老师  人特别好  感动  赞赞赞
1472,52,白洪欢,2015-03-22 06:21:03,5,8,3,很好的老师
1479,52,白洪欢,2015-03-22 07:02:39,32,38,6,能学到很多，老师很赞~
1501,52,白洪欢,2015-03-25 01:50:01,30,33,3,就是平时任务轻，上课有用，不拘泥书本
1543,52,白洪欢,2015-03-22 11:44:12,-2,2,4,轻松，好
1610,52,白洪欢,2015-03-23 01:58:08,6,8,2,挺有意思的老师
1746,52,白洪欢,2015-03-24 03:34:00,25,27,2,男神棒棒哒，能学到的东西还是蛮多的！
1825,52,白洪欢,2017-09-19 11:47:18,23,29,6,细致又不枯燥。是那种又能听的很明白又觉得很有兴趣的课。
1899,52,白洪欢,2015-03-26 05:03:30,104,120,16,网购达人⊙ω⊙
2209,52,白洪欢,2015-04-08 10:33:48,22,25,3,听白老师的课很享受，激发了我对编程的兴趣，可以说是启蒙老师，大爱！！
2288,52,白洪欢,2015-06-18 11:28:57,16,20,4,在浙大学习最喜欢的老师
3020,52,白洪欢,2015-05-13 02:58:30,11,15,4,喜欢放电影2333 听了他的大计基c程汇编
3290,52,白洪欢,2015-05-27 11:01:28,15,17,2,欢欢超级有趣，我上过老师的计算机基础，他讲了很多很有趣的东西，很多很有用的东西，负责而且幽默，摄影技术也很不错哦
3432,52,白洪欢,2015-06-12 10:36:24,5,7,2,讲课超有趣～
3551,52,白洪欢,2015-06-17 01:33:00,14,22,8,上课还好，讲的很明白，就是TC强迫症有点不好……
3777,52,白洪欢,2015-06-17 04:09:24,6,8,2,可爱 长知识 但一直没仔细听听过
3843,52,白洪欢,2015-06-17 05:56:24,3,7,4,软件保护技术666
3848,52,白洪欢,2015-06-17 06:16:25,1,5,4,很有研究，很有技术
4054,52,白洪欢,2015-06-17 15:34:27,13,20,7,非常耐心，仔细。问他题目完全感受不到压力，好老师～
4081,52,白洪欢,2015-06-17 16:33:59,2,6,4,喜欢.
4122,52,白洪欢,2015-06-18 00:55:38,1,5,4,很好的一个老师
4177,52,白洪欢,2015-06-18 03:06:45,160,171,11,专业黑客 对编程真的理解深刻 讲解清楚细致 就是用的环境也太老古董了点 让人难以操练。。
4692,52,白洪欢,2015-06-26 05:41:05,3,6,3,真良心老师！上了他的计算机基础和C程…下学期上他的汇编
5357,52,白洪欢,2015-07-07 03:00:49,37,45,8,潜伏在民间的黑客
5859,52,白洪欢,2015-07-09 15:45:25,16,20,4,老师很好，我觉得他是我在浙大目前遇到的最好的老师
5947,52,白洪欢,2015-07-10 03:26:04,52,56,4,学会用ebay了…
6042,52,白洪欢,2015-07-10 12:19:09,5,7,2,好！
6800,52,白洪欢,2015-07-23 03:55:09,2,5,3,最崇拜的老师，男神啊
6903,52,白洪欢,2015-08-01 10:34:57,3,5,2,听听就懂了，讲得很细
6966,52,白洪欢,2015-08-23 10:31:35,18,23,5,毕竟计院文艺担当，上课各种冷笑话
7403,52,白洪欢,2015-09-14 08:13:30,24,27,3,666666666666黑客老司机
7659,52,白洪欢,2015-09-15 07:43:02,5,7,2,最爱的老师！萌萌哒\n\n
7955,52,白洪欢,2015-09-16 08:29:16,18,21,3,老师居然说要教我们如何当黑客\n\n刺激。。。。\n\n
8163,52,白洪欢,2015-09-17 07:49:25,3,6,3,八错哒
8175,52,白洪欢,2015-09-17 09:08:30,2,6,4,资源大天使！！！！太棒了！！！
8185,52,白洪欢,2015-09-17 10:27:37,4,5,1,赞赞赞~良心品质好老师~！绝对有用而不枯燥~~~
8362,52,白洪欢,2015-09-19 11:16:40,0,3,3,对学生很有耐心，很专业\n\n
8711,52,白洪欢,2015-09-24 09:00:54,4,6,2,老师超好\n\n\n\n
8929,52,白洪欢,2015-10-01 17:09:48,-1,3,4,上你的课因为太聚精会神所以每次都在第四节后半段睡着……改不了了，蹭课也睡着……
9279,52,白洪欢,2015-10-20 03:41:26,2,4,2,记得当年讲了很久的图灵，哈哈，还有巴尔扎克和小裁缝
9368,52,白洪欢,2015-10-25 08:15:10,0,3,3,超喜欢小白～课真的讲得好
9374,52,白洪欢,2015-10-25 12:07:25,3,4,1,炒鸡赞！！！！！！！！！
9506,52,白洪欢,2015-10-29 05:18:36,1,2,1,好好的老师
9507,52,白洪欢,2015-10-29 05:20:08,1,4,3,虽然绩点低了点，但的确是好老师
10049,52,白洪欢,2015-11-15 02:49:38,0,2,2,幽默风趣
10193,52,白洪欢,2015-11-17 09:59:19,2,5,3,很耐心 讲课很细 电脑白痴如我都可以听懂
10268,52,白洪欢,2015-11-18 00:53:15,2,5,3,超级棒的老师 给分很好
10328,52,白洪欢,2015-11-18 05:51:40,1,3,2,冷幽默。点赞
10558,52,白洪欢,2018-08-26 08:26:27,109,118,9,编程序狂魔 拆东西狂魔 英语教学狂魔 仙剑狂魔
11116,52,白洪欢,2015-11-24 09:59:51,8,21,13,密码学惨不忍睹。\n\n通识课小白大概还是不错的，这种非常有深度的专业课真心不适合他来讲，真正对密码学有兴趣的人会比较失望。
11177,52,白洪欢,2015-11-25 03:22:51,30,41,11,密码学准备的超级认真，花的时间绝对是我们学生的10倍！人很好，讲的很清楚，大爱白老师！
11257,52,白洪欢,2015-11-26 03:22:46,1,2,1,总之，好好学习总是没错的，小白老师很好，温柔的扼杀有木有？太安逸了都不想好好学习，现在想起来觉得后怕
11283,52,白洪欢,2015-11-26 08:47:15,2,3,1,课程准备非常充分，对学生很好
11324,52,白洪欢,2015-11-27 03:04:01,7,11,4,密码学的给分呜呜呜
11330,52,白洪欢,2015-11-27 03:45:27,2,4,2,有趣的老师，讲的东西蛮有用的
11697,52,白洪欢,2015-12-11 15:25:08,-1,3,4,很呆萌
11977,52,白洪欢,2015-12-21 12:18:29,0,3,3,有趣⋯⋯⋯⋯
12452,52,白洪欢,2015-12-23 10:08:00,6,7,1,从此引发了我对计算机的兴趣
12478,52,白洪欢,2015-12-23 11:16:37,-1,2,3,讲课很清楚，很实用
12604,52,白洪欢,2015-12-23 15:04:50,3,7,4,业界良心
12626,52,白洪欢,2015-12-23 15:53:47,1,4,3,小白在讲课之余还会分享一些实用技巧和个人经验。个人的大计基和C程上的都是他的课，而且成绩都不错。
12694,52,白洪欢,2015-12-24 02:09:03,0,4,4,讲的东西很多，不拘泥于书本。但是究其水平博而不精，问他有些问题也会出现他不知道然后强行回答的情况。当然，他了解的再少，也比我多一点，相比这门课的要求绰绰有余。
12787,52,白洪欢,2015-12-24 04:36:03,3,5,2,用自己的一套材料，有自己的网站。讲课条理清晰。好评！下次还会再来。
12799,52,白洪欢,2015-12-24 05:34:37,-8,8,16,上课太死板
13247,52,白洪欢,2015-12-25 15:04:26,0,2,2,很好哒
13261,52,白洪欢,2015-12-26 01:45:16,4,6,2,超级好！！！！
13332,52,白洪欢,2015-12-26 18:29:05,1,3,2,很好很好
13664,52,白洪欢,2015-12-30 09:06:41,1,3,2,最爱小白！！
13678,52,白洪欢,2015-12-30 10:03:42,3,5,2,老师讲的东西很有用  每次听完课都想赶快回去试，老师人也超好 。发邮件问他问题都很及时耐心解答。大爱白老师！！
13770,52,白洪欢,2015-12-30 22:58:48,17,25,8,如果你只在乎考试知识点，慎选白洪欢老师。  小白会插播很多有用的常识，除他之外你不会听到了，很少有老师是真正讲一些课本之外有用的东西。跟着他学习是一件快乐的事
13814,52,白洪欢,2015-12-31 09:08:02,1,2,1,没得挑\n\n
14079,52,白洪欢,2016-01-04 06:20:09,10,14,4,超赞的老师，为学生着想，每次作业都笑看其他室友狗一样地往来于机房
14319,52,白洪欢,2016-01-06 08:07:34,5,6,1,老师很为学生着想，上课内容很丰富，作业也很锻炼人的能力，具有各种破解软件的技能。可惜c程没有选他的(ಥ_ಥ)
14478,52,白洪欢,2016-01-07 08:26:35,2,3,1,超级超级棒！会关心学生！讲课幽默！强力推荐！
15419,52,白洪欢,2016-01-14 10:23:18,0,2,2,超级棒
15795,52,白洪欢,2016-01-16 09:32:27,-1,2,3,有趣的老师
15829,52,白洪欢,2016-01-16 11:27:03,8,12,4,超级好 ebay海淘达人 不点名 不照着课本讲课 教我们拆电脑！以及黑别人的电脑哈哈哈哈
16673,52,白洪欢,2016-01-18 16:54:04,-10,8,18,选课需慎重\n\n
17339,52,白洪欢,2016-02-03 10:16:32,0,2,2,好好好\n\n
17793,52,白洪欢,2016-01-21 01:43:57,15,19,4,可以说是浙大最喜欢的一个老师，这是一个你上课可以去水但是你不会选择去水的课，真是超爱他，而且你可以从细微处感觉到他的细心贴心和对学生的关心，超赞！！！！！
18570,52,白洪欢,2016-01-22 04:42:13,-1,1,2,老师人真的很好
18766,52,白洪欢,2016-01-22 13:16:54,3,5,2,小白么么哒，给分棒棒哒
18891,52,白洪欢,2016-01-22 16:54:07,2,3,1,膜拜，五体投地
18893,52,白洪欢,2016-01-22 16:58:19,0,4,4,给分好 平时拓展比较多 但是期末可能要自习复习
18901,52,白洪欢,2016-01-22 17:23:22,-6,14,20,说真的我觉得有点莫名其妙 老师讲的东西确实很多 但是都不实用 很多已经被淘汰的东西 而且给分真是呵呵了
18902,52,白洪欢,2016-01-22 17:27:24,4,6,2,浙大男神 民间黑客 细致入微 资源丰富 一心一意为学生 真的 在大学遇到这样认真负责 无条件对学生好的老师 只有无尽的感动
18921,52,白洪欢,2016-01-22 22:42:18,-2,0,2,神奇的老师
18961,52,白洪欢,2016-01-23 00:46:05,0,1,1,课程上的很实用，呆萌的，给分也不错，人好
18993,52,白洪欢,2016-01-23 02:16:00,9,10,1,感觉新人要慎选
19011,52,白洪欢,2016-01-23 03:51:43,1,2,1,给分好，讲得好，绝对好！
19030,52,白洪欢,2016-01-23 05:41:37,1,2,1,白白暖男
19066,52,白洪欢,2016-01-23 07:32:46,2,6,4,小白男神啊！！！大计基作业不多，不用去机房，给分温和，超级赞！
19228,52,白洪欢,2016-01-23 14:58:50,-1,2,3,绝对男神
19710,52,白洪欢,2016-01-25 06:46:42,4,5,1,超爱小白老师，座作为一个社科学生，小白激发了我对计算机的兴趣，尤其是做一名黑客（任重而道远啊），不仅仅是讲课细致，而且还有很对其他的见解，人很可爱，哈哈
19991,52,白洪欢,2016-01-26 00:37:37,5,8,3,超爱超爱 像我这种电脑渣都觉得上课很有趣了
20042,52,白洪欢,2016-01-26 02:55:38,-1,3,4,完美的
21539,52,白洪欢,2016-02-29 06:39:37,1,2,1,事情少 答疑什么的超认真  良心老师
21560,52,白洪欢,2016-02-29 07:58:04,-1,2,3,特地过来赞的，良心老师
22083,52,白洪欢,2016-03-02 09:47:55,0,4,4,到浙大来迄今最喜欢的老师，听他的课完全让自己热爱上了计算机，而不仅仅为了考试和学分。（热爱上了成绩也是高高的啊 ^_^ ）
22299,52,白洪欢,2016-07-06 05:47:32,2,6,4,对高水平的大神很好，对基础差的学生不是很友善，
22344,52,白洪欢,2016-03-04 01:25:08,0,2,2,讲的超好
23693,52,白洪欢,2016-04-13 00:03:59,3,5,2,上课讲解细致 民间黑客 自己的主页牛逼
23713,52,白洪欢,2016-04-13 08:10:27,0,3,3,上课从不用课本，却又讲的非常细，满分必须的
23748,52,白洪欢,2016-04-14 11:31:22,1,3,2,C语言在这么多老师里面讲得算非常好了；\n\nC大程极其负责，选他能学到很多东西；\n\n密码学极其无聊，同一个内容将很多遍；\n\n汇编讲得还行，不过x86有点过时了，没有很多必要学这门课。\n\n
23916,52,白洪欢,2016-04-21 03:12:05,1,3,2,好，感动
25133,52,白洪欢,2016-05-06 02:48:33,1,5,4,选上他的课是我上大学以来认为最幸运的事
25570,52,白洪欢,2016-05-26 02:14:44,96,116,20,如果你只在乎考试知识点，那么建议慎选。小白的课一些基础的知识点是不会特别强调的，相反，小白会延展更多的知识点（其他老师一带而过的）如果0基础，你需要课后花大量时间来研究达到老师的教学高度。然而在大量时间投入后，你会发现，小白会教你非常多非常有用然而课本永远不会教的知识。小白是非常好的老师，然而可能对于想水的同学并不合适，他适合那种基础雄厚的大神或者努力家。
25653,52,白洪欢,2016-05-31 05:42:59,4,9,5,计院学生慎选！！
25968,52,白洪欢,2016-06-14 15:44:44,0,2,2,给分好，人很厉害
26185,52,白洪欢,2016-06-16 07:31:30,2,3,1,老师讲的很清楚 用的自己的讲义 也很风趣
26369,52,白洪欢,2016-06-17 06:32:11,2,6,4,如果你只是想应付考试，小白的课不适合你。如果你是真的想学编程，小白绝对没错
27024,52,白洪欢,2016-06-22 08:41:14,6,17,11,吹过头了，基本靠自学
27176,52,白洪欢,2016-06-23 11:08:49,2,3,1,老师给分我是还不知道，但是肯定都是根据实际情况给的，所以分低的话只能怪自己啦，但是讲课真的超级喜欢，像我这种大计基不认真，可是c程却从没落下一节的课人，都是因为他讲的好
27465,52,白洪欢,2016-06-26 10:52:06,1,4,3,只做出一到上机题。。不过老师还是很好
27971,52,白洪欢,2016-06-28 07:55:55,-2,1,3,1231231231
27983,52,白洪欢,2016-06-28 07:56:59,2,3,1,认真听就会有收获
28102,52,白洪欢,2016-06-28 08:06:40,-1,2,3,作业少，非常少，c程作业不到别人的三分之一
28293,52,白洪欢,2016-06-28 08:27:34,-3,1,4,老师人很好，讲课也很好～
28392,52,白洪欢,2016-06-28 08:49:17,0,1,1,认真听，一定学的好！
28441,52,白洪欢,2016-06-28 08:59:58,0,2,2,小白棒棒哒+_+
28544,52,白洪欢,2016-06-28 10:00:58,1,2,1,上课完美！作业少！（不过C程考前请自学Dev c++...比用TC啥的效率高很多啊
28781,52,白洪欢,2016-06-28 14:42:25,-1,1,2,小白讲的比书好，可惜自己不听作死。。。
29302,52,白洪欢,2016-06-29 14:44:16,-1,0,1,虽然我没认真听课
29564,52,白洪欢,2016-06-30 03:38:29,3,4,1,白老师是我最喜欢的浙大老师之一，他教授的语言学习方法学其他语言也通用，大爱！！
30684,52,白洪欢,2016-07-02 08:07:27,0,2,2,从来不按书上讲。我一学期上课没翻过书，但很多知识点比书上讲得还深刻，简直大神！
30772,52,白洪欢,2016-07-02 12:34:24,1,4,3,不要报他的程序设计专题，别问我为什么。。
31321,52,白洪欢,2016-07-03 15:55:03,1,1,0,棒棒棒
31385,52,白洪欢,2017-05-17 09:26:13,3,4,1,很认真，给分不错!
31415,52,白洪欢,2016-07-04 01:33:02,0,1,1,上课会扩展很多知识，给分高。
31452,52,白洪欢,2016-07-07 02:26:04,-1,9,10,白男神 不满绩的都是自己作死
31471,52,白洪欢,2016-07-04 03:03:15,2,4,2,小白真的人超级超级好！上课讲的很详细很透彻，很通俗易懂，听过课基本不用复习了！ 当时补选他的课，他还帮我去和那里的老师说。期末考上机一紧张第一次没做出，补考才做出，居然给分还那么让我惊喜！太开心了！爱死小白了！力推！
31580,52,白洪欢,2016-07-04 07:06:03,0,2,2,一种任务轻确又很好掌握知识的体验！
32061,52,白洪欢,2016-07-05 13:57:07,-2,2,4,老师讲得超级好，而且给分好好，第一门满绩的课呀！
32236,52,白洪欢,2016-07-06 04:15:45,1,7,6,考试运气不好，以为自己最多80几了，结果老师竟然奇迹般给了90几，太好的老师不解释
32470,52,白洪欢,2016-07-07 04:14:52,3,5,2,不是很会讲课，对程设专题不满意
32502,52,白洪欢,2016-07-07 07:40:56,5,6,1,不吹不黑，上了小白的C小程和C大程。小程讲的很细致很棒，会对很多难点进行分析。但是C大程就不怎么样了，并没有很仔细讲考试的重点，把过多的时间花在了基本不考的图形和过于底层的东西。课后的大作业比较多，对于学生的要求比较高，给分一般。
32579,52,白洪欢,2016-07-08 01:55:53,-3,5,8,虽然感觉其实也并没有传说中那么好的，不过老师非常亲切，上课认真听是可以学到很多东西的。给分吧，感觉并没有很好。
32913,52,白洪欢,2016-07-30 07:09:35,0,2,2,大学里最棒的老师之一
33497,52,白洪欢,2016-09-20 00:29:07,0,0,0,上课很专业哦～～
33843,52,白洪欢,2017-01-12 11:02:07,1,4,3,超赞的！
33888,52,白洪欢,2016-09-22 09:43:00,1,2,1,教很多有用的技巧，课堂生动有趣，计算机技术高超！
33953,52,白洪欢,2016-09-23 12:39:05,-1,2,3,非常好！
34275,52,白洪欢,2017-01-23 17:04:57,5,8,3,即使我大计只有3.3我依然深爱小白，即使我跑断了腿我也要选下个学期的C程。就是这么任性，吼吼吼
34840,52,白洪欢,2016-10-24 15:34:33,-2,1,3,白老师棒棒哒
34956,52,白洪欢,2016-10-27 05:28:32,1,2,1,超级棒
35103,52,白洪欢,2016-11-02 09:01:03,4,7,3,前两节课简直就是为我打开了新世界的大门！大开眼界呀，现在非常想学习计算机了…现在超级期待他给我们演示侵入病毒！
35163,52,白洪欢,2016-11-03 11:16:04,2,4,2,上过他的密码学，会让学生感到惭愧，因为班里没有任何一个学生比白老师更努力。真的是好老师！浙大的良心老师。
35688,52,白洪欢,2016-11-10 07:45:50,-1,2,3,可以学到很多，老师在密码学很有研究，而且老师的讲解很细致呢
35841,52,白洪欢,2016-11-10 08:27:07,0,1,1,很好啊，会讲很多有趣的东西
35882,52,白洪欢,2017-01-07 03:54:21,1,3,2,上大计基都不无聊！！喜欢老师！
35935,52,白洪欢,2016-11-10 08:57:38,4,7,3,图灵的迷弟
35958,52,白洪欢,2016-11-10 09:09:56,-1,1,2,棒棒棒
35978,52,白洪欢,2016-11-10 09:30:30,0,1,1,超级好的老师，还会给我们很多好玩的程序！感谢教务系统能让我遇见这位老师！
36000,52,白洪欢,2016-11-10 09:46:49,7,11,4,非常享受啊，会教你很多很厉害很实用又很好玩的东西，密码电文，找回电脑中几年前已删除的文件，输入电脑代码修改图片，笑看象棋软件自动连线，玩爆QQ太守级玩家，自制电脑算法，破解验证码，可以说溜得飞起。人也非常温和，上课时有种很亲切的感觉，如沐春风。
36161,52,白洪欢,2016-11-10 16:19:51,0,2,2,好故事，不讲书
36361,52,白洪欢,2016-11-12 08:32:11,-9,3,12,完全靠自学
36370,52,白洪欢,2016-11-12 13:12:27,1,2,1,老师很厉害，真的很厉害，不过作为计算机白痴我还是听不懂\n\n
36450,52,白洪欢,2016-11-13 16:33:15,10,12,2,计院需要这样讲课的老师，不需要念ppt的老师
36695,52,白洪欢,2016-11-15 11:58:18,2,3,1,公认的好老师，黑客，上他的课可以学到很多东西
36902,52,白洪欢,2016-11-16 11:40:26,39,60,21,上过白的汇编，怎么说呢…知识点讲得很细，基本上结合例子来讲，但是很不成体系，东一榔头西一棒子，如果是零基础的同学的话听着还是比较费劲的。讲真，还不如自己去看他的教材。\n\n另外，老师对于x86底层的一些东西摸得很透了，但对于其在如今的实用性表示怀疑。\n\n至于黑客、破解云云，小白们就散了吧，也就看个热闹。 那些说自己被激发兴趣的，后来都怎么样了呢？
38723,52,白洪欢,2016-12-29 15:09:16,2,4,2,好老师，讲课内容有实用价值
39210,52,白洪欢,2016-12-21 15:30:46,1,4,3,虽然不是很懂，但上得确实是一手好课。
39287,52,白洪欢,2016-12-22 03:00:44,3,5,2,很理解学生，分享很多资源，比如010editor，上课超强。但是，学生上课手机一定要静音，课后作业一定要认真做。想吐槽一下软件的都太古董了，pe还用光盘，软碟通版本太低，thinkpad还用xp。
39811,52,白洪欢,2016-12-28 01:10:14,2,3,1,人很好 专业搞机
40763,52,白洪欢,2017-01-05 09:53:09,0,2,2,很好的一位老师，上他的课我会主动关机
40914,52,白洪欢,2017-01-06 10:08:17,0,3,3,好老师，不解释
40987,52,白洪欢,2017-01-07 08:30:28,-2,2,4,老师真的讲得超好的，讲得很细，拓展了很多。其实知识点也有强调，但是，不认真听没注意就不能怪老师了。有点后悔由于其他课任务太多，这学期有部分课没有好好听...有些东西好好听真的会很有用。资料也超全！
46884,52,白洪欢,2017-01-22 16:03:07,14,19,5,越来越觉得讲得好的老师都不喜欢以点名的方式留住学生(￣Д￣)ﾉ小白就是其中之一233大计基是我大一上最期待的课，没有之一。小白讲课从来不是念教材，而是将知识涉及的每一块的相关图片或是程序的操作步骤结合自己的经历详细展示给你，还会讲很多冷笑话和其他非常好玩又实用的知识。一开始觉得没用知识，好好听的话会发现都是为后面埋下了伏笔的，或者只是不知不觉中将教材顺序调换，你没有发现而已。发邮件也会耐心地回复你，真是太棒太棒的老师，爱他一万年。他说我们这些人很功利，他讲了又不操作，又强烈安利98给我们，于是我寒假就来操作了hhhh“计算机这么好玩，你们怎么就没兴趣呢。“
46896,52,白洪欢,2017-03-06 11:19:50,2,4,2,超爱小白的!真男神!
46914,52,白洪欢,2017-01-23 01:58:21,-11,0,11,烦人啊
46965,52,白洪欢,2017-01-23 05:52:55,-1,1,2,老师上课不点名，但很多干货，实用的内容很多
46976,52,白洪欢,2017-01-23 06:50:49,1,3,2,。。。
47030,52,白洪欢,2017-01-23 09:56:30,0,4,4,老师上课挺有趣的~虽然讲的很多内容对考试帮助不大，但有很多干货。课后答疑也很热心，98的帖子和邮件都有回复~给分没我预期的好，还是给小白老师10分！
47057,52,白洪欢,2017-01-23 12:36:22,0,1,1,老师真的很棒，学会了很多！
47246,52,白洪欢,2017-01-25 01:38:23,1,3,2,干货多！潜伏的黑客
47690,52,白洪欢,2017-02-18 08:46:52,1,2,1,很好哒
48110,52,白洪欢,2017-02-28 13:46:10,8,11,3,老师很好很用心，对于课外拓展很注重
48142,52,白洪欢,2017-03-01 01:33:46,6,10,4,老师讲课很充实，对不了解计算机的同学很有帮助，感觉他是一个黑客，会拓展知识，给分也高，感觉有一种计算机工程师的感觉，跟看过的书中的微软工程师很像，感觉上完这门课，对计算机的理解更深了，最后要说，上课一定要做好笔记，很多有用的东西。
48293,52,白洪欢,2017-03-02 02:45:04,2,3,1,老师人很好 也很风趣 内容很多，讲课节奏也不错
48840,52,白洪欢,2017-03-14 12:04:53,-2,2,4,给分不错
49466,52,白洪欢,2017-05-25 16:40:36,9,11,2,在浙大最喜欢的老师，真的很棒，今天听到老师的第二个小小白出生都100天了，哈哈哈，希望小白一直幸福下去☺
51115,52,白洪欢,2017-05-18 02:40:11,-1,1,2,一个字：爽！
51409,52,白洪欢,2017-06-05 06:04:12,1,4,3,有出息以后除了父母第一个要报答人就小白了，可惜我对破解真的是没有兴趣，不然这辈子就跟他混了
51469,52,白洪欢,2017-06-06 06:36:21,-1,0,1,好老师！\n\n
51926,52,白洪欢,2017-06-13 15:11:56,2,4,2,好老师！
52013,52,白洪欢,2017-06-14 06:50:26,9,11,2,小白的C程，给人的感觉就是嗯，我满脸微笑，但是我都是真才实学，你们这帮傻孩子哈哈哈哈
52908,52,白洪欢,2017-06-23 12:47:06,2,3,1,白老师教你炒股23333 超有趣的老师
52910,52,白洪欢,2017-06-23 12:51:30,-1,2,3,股神白
54548,52,白洪欢,2017-06-29 15:06:14,19,37,18,我认为很多人对白老师过誉了
54867,52,白洪欢,2017-06-30 10:46:47,3,5,2,最不水的老师了，讲的真的都是硬货，不过上小白的课真的挺有难度，密码学最后考的真的都是讲过的内容，不过东西实在有点多服，复习不过来，而且对源码的要求我觉得太高了，平时读读写写到没啥，考试考的话就有点僵硬了。。。
55111,52,白洪欢,2017-07-01 00:28:58,0,3,3,遗憾当初大计基和C没选到白神
56529,52,白洪欢,2017-07-04 02:46:56,0,1,1,水平很高，非常认真负责，而且很会炒股！
57150,52,白洪欢,2017-07-05 23:02:45,0,3,3,密码学，讲得很好很细致，给分也好
57279,52,白洪欢,2017-07-06 10:38:09,3,5,2,在老师“你们怎么这么懒惰”的敦促下认真学习拿了4.8……
57281,52,白洪欢,2017-07-06 10:41:59,0,2,2,高于课本，认真听课，不过还要认真看书，因为他的课是对课本的补充。(ฅ>ω<*ฅ)
57282,52,白洪欢,2017-07-06 10:46:03,1,3,2,不点名，平时作业特别少，讲课清晰，给分特别棒，爱小白~\(≧▽≦)/~
57284,52,白洪欢,2017-07-06 10:49:57,-2,1,3,给分好呀啊呀呀呀呀呀呀
57446,52,白洪欢,2017-07-08 01:02:06,7,7,0,密码学给分太太太太太可怕了\n\n\n\n3.9就前30%了
57477,52,白洪欢,2017-07-08 12:20:34,-14,2,16,大作业迟交的我竟然被满绩了。。。
57484,52,白洪欢,2017-07-08 15:16:10,1,3,2,讲课清晰。复古，偏爱古董。知识拓展的很多。给分好，c满了
57998,52,白洪欢,2017-07-21 16:46:39,1,3,2,在这里感谢一下一直在群里答疑的金老师@谁有毛，金大毛\n\n
58893,52,白洪欢,2017-09-18 09:42:55,-1,0,1,很牛旁征博引
59060,52,白洪欢,2017-09-19 09:07:57,3,4,1,超棒的 第一节课有福利
59565,52,白洪欢,2017-09-23 04:22:29,2,3,1,听老师的课是怎么样的好吗
60276,52,白洪欢,2017-10-16 11:09:18,3,4,1,小白是我人生启蒙老师，只有听小白的课的时候我才会全程集中注意力。而且论关心学生，小白一定是做的最好的，以后有出息第一个报答的就他了
61082,52,白洪欢,2017-11-08 06:59:20,-1,1,2,只有一个感觉，老师他真的好厉害。
61857,52,白洪欢,2017-11-21 09:17:41,0,2,2,能学到很多课本外的东西，但是课本上的东西就很多要靠自己学
63223,52,白洪欢,2017-11-29 09:28:19,15,16,1,隐藏在民间的黑客，上课十分欢乐\n\n尽管老师讲课并不会着重于书本内容，但延展性很强，还和我们讲ebay和paypal?
64507,52,白洪欢,2017-12-24 16:19:24,0,1,1,太喜欢了
64910,52,白洪欢,2017-12-28 02:33:48,4,5,1,老师讲课很棒，自身实力也贼强，一直给我一种大神的感觉，比如他会说xx编程软件不要去网上下载用我的这个版本，因为我优化过啥的﻿⊙▽⊙作业也不多，有一次调试程序的大作业，但其实挺简单的。还建了qq群可以答疑！上课好好听作业好好做最后拿了94(差一分满有点难受qwq 但是老师绝对十分
65058,52,白洪欢,2017-12-28 11:52:39,-14,4,18,计算机零基础的慎选...学大计基的文科生表示什么都没听懂也没觉得有意思
65684,52,白洪欢,2018-01-08 08:18:48,0,1,1,???
66086,52,白洪欢,2018-01-11 13:02:20,6,7,1,他唯一一次发火是在说到有几个同学课都快上完了还不会用第一节课讲的传作业的工具，然后没有多说。大爱小白，有思想有人文情怀还有技术，结课和他合影了，耶！
67041,52,白洪欢,2018-01-20 06:28:55,-1,1,2,老师超级赞！上课不会按照课本来讲，课外的知识干货非常多，很有收获！平时作业也非常少。课堂轻松，每节课下课大家都会不自主的鼓掌  。给老师点赞！！！
67704,52,白洪欢,2018-01-22 05:33:20,1,2,1,棒棒哒
69919,52,白洪欢,2018-01-25 16:08:17,-1,2,3,汇编怎么还不出分啊......
70585,52,白洪欢,2018-01-27 08:59:35,0,5,5,好老师，只可惜计院大佬太多，头铁的选了汇编，3.3，非计院大佬慎选
70826,52,白洪欢,2018-01-27 14:41:45,4,5,1,上汇编课会把内容打下来，讲解的很细致，循序渐进，非常棒~
72569,52,白洪欢,2018-01-30 11:38:08,1,5,4,老师真的好，给分也好(看这评分就知道了)，无奈漏做了一次作业，被卡绩5555
72584,52,白洪欢,2018-01-30 12:44:23,1,2,1,老师真的会教很多有用的东西！还会推荐许多网站！给分也超好！
72620,52,白洪欢,2018-01-30 13:59:46,0,2,2,你不会在别的老师课上听到这么多有用的东西
72708,52,白洪欢,2018-01-31 02:37:48,0,2,2,给分超乎想象的好，期末记得要多刷题库，带着脑子边刷边整理知识点。老师上课会讲自己网购经历已经一些很有趣的事情，去问老师问题也都会回答，只是不会知道你的名字。论文、平时作业也要认真做
73012,52,白洪欢,2018-01-31 14:36:33,1,3,2,作为一名社科生，第一次感觉到计算机非常的有趣，真的学到了很多有用的知识。当舍友们在抱怨自己的大计基老师作业有多多的时候，你就知道选上白老师的课是多么幸运的一件事了。而且，老师人很好，给分也很棒，很可惜老师似乎不教python和javaTT
73108,52,白洪欢,2018-02-01 02:30:07,2,3,1,老师讲课真的很好啊，感觉能学到很多东西。上了老师的大计基，下学期想选老师的C程课冲突了选不上有点遗憾。今年大计基考试的时候都懵逼了，跟练的题库很不一样，本来以为会挂，结果最后还上4了，感谢老师哇！
74163,52,白洪欢,2018-02-06 02:55:09,0,3,3,总共做了五次作业写了一篇论文，最后期末考只会80%不到，成绩是91。
74236,52,白洪欢,2018-02-07 12:08:29,2,4,2,大计给分够良心，作业也是最少的，不过B.W.用不着拿分数去衡量。他并非在用有趣的语言讲课，而是把内容本身安排的足够吸引人。听他的大计感觉他一定写过不少教程…
74332,52,白洪欢,2018-02-11 13:33:01,1,3,2,老师真的很棒，平时作业比其他老师少很多，上课也不死板按书上讲，会拓展很多实用的点，给分也不错
74460,52,白洪欢,2018-02-26 11:57:14,2,3,1,老师会讲很多课外的东西，很实用，也会讲自己在国外网站的购物经验，还会给我们看电影，作业少，不点名，超级好（嘿嘿）。
74565,52,白洪欢,2018-03-03 15:23:32,4,6,2,很棒的老师，提起了我对计算机的兴趣
74988,52,白洪欢,2018-03-07 02:13:39,-1,3,4,好老师 很细心
75279,52,白洪欢,2018-03-08 11:57:40,3,5,2,就一个字
75350,52,白洪欢,2018-03-09 04:53:22,4,5,1,教室人满为患……课讲的真的好
76176,52,白洪欢,2018-03-28 08:56:34,17,21,4,真滴棒，讲课很清晰。还有，表白陈源助教，史上最好，没有之一！还很帅！冲着助教给满分！
78672,52,白洪欢,2018-05-14 10:38:35,1,2,1,在老师主页下电影下游戏哈哈哈
80124,52,白洪欢,2018-06-20 08:16:52,2,4,2,TC，VC?
80271,52,白洪欢,2018-06-24 03:09:04,-2,3,5,C语言要挂了咋办?
80357,52,白洪欢,2018-06-25 12:22:20,6,10,4,电影放的很多，密码学不知道在讲什么，给分很低。
80359,52,白洪欢,2018-06-25 12:22:33,5,7,2,上课说话太轻了，后排完全听不到，给分严格，想划水的慎选
82535,52,白洪欢,2018-07-08 12:16:39,3,8,5,不要来选密码学。讲的不清楚考试也莫名其妙
82620,52,白洪欢,2018-07-08 22:07:39,3,8,5,慎选密码学…毕竟这本来不是白老师开的课
82691,52,白洪欢,2018-07-09 17:01:44,5,8,3,给助教小哥哥满昏！！！！！！ 老师也很好啦 又是没考试就来评分 希望能有个好成绩吧 千万别挂千万别挂千万别挂！！！！
83065,52,白洪欢,2018-07-15 00:37:54,1,7,6,作业少，讲的好，重点是给分真的超级好。
83082,52,白洪欢,2018-07-09 15:35:23,-2,1,3,
83364,52,白洪欢,2018-07-10 07:28:22,0,5,5,享受。预置到白老师打消了我炸掉教务系统的冲动
84977,52,白洪欢,2018-07-14 23:44:47,3,9,6,他会强迫你对这么课感兴趣，如果你不喜欢，我就挂你\n\n
85265,52,白洪欢,2018-07-16 15:37:31,5,10,5,密码学挂了很多人。。。
85266,52,白洪欢,2018-07-16 15:41:31,7,9,2,挂科了的体验
85267,52,白洪欢,2018-07-16 16:43:10,1,6,5,密码学平时很轻松！还经常放电影给同学们看！非常推荐！
85271,52,白洪欢,2018-07-16 16:11:13,0,6,6,非常棒的老师！强烈推荐他的密码学，深入浅出，有条有理，讲得非常棒！重点是课间还有电影看！出题也很有水准的，真是男神呀！
85272,52,白洪欢,2018-07-16 16:13:45,2,7,5,十分优秀！密码学强推！
85280,52,白洪欢,2018-07-16 16:55:03,-1,3,4,好得很
85283,52,白洪欢,2018-07-16 19:45:10,4,8,4,密码学给分好，汇编超有趣！
85313,52,白洪欢,2018-07-17 02:24:28,1,2,1,老师很好
85430,52,白洪欢,2018-07-17 23:56:46,-1,2,3,上过白老师的c程和汇编。非常好！不犹豫强烈推荐
85431,52,白洪欢,2018-07-18 00:11:07,2,4,2,白老师真的超赞的 思路清晰讲解也很细 大学以来最享受的几门课之一了 大爱白老师～
85451,52,白洪欢,2018-07-18 03:48:31,19,26,7,我是16计科的同学，沒学过老师其他课，对老师本身没什么意见，但只想说建议不要选密码学这门课。1是课程设置不合理2是老师教的东西都关注在固定算法的实现方式而不是算法的精神（数学原理）3是给分非常烂，期末考不好拿分，平时作业自己认真做了也不给满（注释不足，代码风格不符合老师要求都可能会扣分）
85452,52,白洪欢,2018-07-18 03:56:02,4,8,4,汇编挂了
85680,52,白洪欢,2018-07-25 07:34:34,5,8,3,让我挂了。。。。
85706,52,白洪欢,2018-07-27 02:53:46,8,9,1,无法形容他的汇编。
86093,52,白洪欢,2018-09-06 02:48:16,20,24,4,一暑假过去了，还是无法忘怀我挂掉的密码学
86402,52,白洪欢,2018-09-15 05:50:04,10,11,1,小白老师真的非常非常好 简直是支撑我黑暗的一个学期唯一让我很享受的一节课 人也非常耐心 不厌其烦地回复邮件 又帅又萌 超级超级棒
87327,52,白洪欢,2018-09-27 05:23:55,2,5,3,去年的大计基 超级好！贼酷
88640,52,白洪欢,2018-11-22 13:24:48,-9,13,22,上他的课跟自学没什么区别.....表示有点后悔选了他的课
88642,52,白洪欢,2018-11-05 02:16:19,6,7,1,潜伏在民间的黑客
88667,52,白洪欢,2018-11-05 07:34:22,16,18,2,zju扫地僧
89686,52,白洪欢,2018-11-20 09:14:46,0,6,6,真的很好很好！老师其实对学生要求挺高的，不会体现在作业方面，而是希望大家能课后下功夫。听他的课真的能学到很多很多
90580,52,白洪欢,2018-11-24 07:37:34,1,4,3,超级棒的一个老师，他的汇编算是大一唯一一门上课从不走神的课了
91164,52,白洪欢,2018-12-02 11:59:25,10,14,4,老师讲课很好，还会在课下放电影，作业少，助教好，给分棒，推荐大家选小白的密码学！！强推哦
92145,52,白洪欢,2018-12-26 16:04:09,9,12,3,计算机基础，选上了他的课，没基础的建议退了吧，太累
92181,52,白洪欢,2018-12-27 03:07:32,2,8,6,强烈推荐 汇编+软保+密码学
92549,52,白洪欢,2019-01-02 11:47:13,2,10,8,绝对是好老师。拓展内容丰富，包括设置路由器、破解软件、硬盘格式化虚拟光驱、病毒制作等等等等，干货绝对多。如果只是想掌握知识点建议选别的老师。
93065,52,白洪欢,2019-01-07 07:39:00,6,12,6,啊啊啊啊啊我男神啊，超级赞的老师，可以将枯燥的大计基知识点讲的趣味横生，可以让心情低落到冰点的我瞬间满足感幸福感爆棚。小白会教你好多好多课外的知识，认真听课会学到好多东西的。总之就是干货满满的一节课，人格魅力超强的一个老师。\n\n
95170,52,白洪欢,2019-01-19 03:16:48,4,7,3,期末给划重点\n\n平时很和蔼可亲的\n\n作业也不多
95485,52,白洪欢,2019-01-19 12:53:53,19,25,6,汇编过于硬核\n\n
98377,52,白洪欢,2019-01-23 11:32:19,9,13,4,汇编杀我 考试全手写代码\n\n求师生情让我汇编不挂吧！！
101147,52,白洪欢,2019-01-27 16:57:31,16,22,6,老师认真负责也讲的蛮清楚的，但想水通识课学分的汇编不建议选，毕竟学习帝上显示挂了百分之十二的人，菜鸡表示绩点有点凉！！！想在大二上修软保的同学(计院信安的选修课)，一定记得大一下修汇编！！！
101173,52,白洪欢,2019-01-28 00:56:20,7,7,0,? ? ?
101211,52,白洪欢,2019-01-28 02:09:49,3,7,4,老师很好，也很强，就是我的绩点很糟糕。爱过汇编
101216,52,白洪欢,2019-01-28 02:16:01,-10,8,18,汇编：考前好好看，平时不听课也能上四的\n\n经验：指令都记好怎么用，考得都是他讲过的问题，如如何转换进制输出等等
101694,52,白洪欢,2019-03-27 05:29:26,5,9,4,汇编和软保同时学的操作体验还可以，但是刚开始汇编可能会跟不上软保的进度，后期的话就没什么影响了，可以的话还是最好先学汇编。
101721,52,白洪欢,2019-01-29 02:33:51,1,3,2,经常给我们讲他的黑客事迹
101745,52,白洪欢,2019-02-01 00:36:05,7,10,3,白老师啥时候教我们炒股啊
101857,52,白洪欢,2019-01-29 09:41:15,-17,4,21,太简单了，我嘉霈满了
102229,52,白洪欢,2019-01-31 13:54:45,1,5,4,汇编没挂真的太开心了呜呜呜呜！！我爱小白！！
102982,52,白洪欢,2019-02-25 07:58:50,2,5,3,大爱白老师！！！
103383,52,白洪欢,2019-02-28 00:37:42,3,10,7,汇编挂了
104067,52,白洪欢,2019-03-11 09:44:40,11,15,4,尽管(听说)白老师的一些课挂科率高达五分之一，依然用两年把他几乎全部本科课程基本都上了一遍.为什么我会上这么多他的课呢?
109321,52,白洪欢,2019-06-13 05:53:59,2,4,2,真的很不错，讲的好还耐心
109699,52,白洪欢,2019-07-01 16:54:18,-33,16,49,“（汇编）编程题实在不会不要空，你空着我没法给你打分啊，试卷教务处会抽查的，你随便写点什么他们也看不懂，我这不是讨好你们啊”
110137,52,白洪欢,2019-06-27 03:22:19,5,7,2,都怪袁隆平
111476,52,白洪欢,2019-07-01 17:10:12,-5,3,8,很后悔没有认真听课，最后跟不上进度（甚至作业都不会）退课了。下次有机会一定再来。
111558,52,白洪欢,2019-07-02 03:00:16,-9,3,12,人很好，上课仔细，但水平只能说一般吧。考试的话，认真学了没问题吧，难度不大。
112447,52,白洪欢,2019-07-04 07:59:53,4,9,5,非常爱小白了，浙大目前唯一一个靠人格魅力征服我的老师。对待教学非常用心，对学生也是毫无保留。尽管汇编和密码学有部分比较古老的东西，但是实用性很高，讲解得也非常深入。满分！
113507,52,白洪欢,2019-07-06 21:16:25,-1,3,4,小白的课真的和其它老师的课不一样，不死板按照考纲讲课，能学到很多其他老师不会讲的知识。
113635,52,白洪欢,2019-07-07 01:34:11,0,4,4,超仔细，还会捞你，快乐
113764,52,白洪欢,2019-07-07 10:18:31,6,10,4,看到白老师凌晨3点发消息说已上传成绩 真心为之感动 真是后悔没有好好听老师的C啊
113824,52,白洪欢,2019-07-07 17:14:34,11,12,1,密码学挂了。。。
113976,52,白洪欢,2019-07-08 05:34:25,-8,2,10,密码学真香，推荐选课
113997,52,白洪欢,2019-07-08 07:23:04,-8,2,10,密码学没挂，yeah，10分！
114002,52,白洪欢,2019-07-08 07:54:19,-8,3,11,骂了一个学期密码学，最后真香，这成绩给的太香了
114070,52,白洪欢,2019-07-08 17:10:49,3,6,3,41分理论加一道半实验题，老师愣是捞到3.0，我一辈子都念您的好?
114092,52,白洪欢,2019-07-08 22:33:53,9,11,2,分数感动的都要哭出来了，感觉真的是自己对不起老师
114100,52,白洪欢,2019-07-08 23:08:33,7,10,3,上课偏冷对于低级错误提问甚至会直接diss……但老师强还是真的强的……一学期下来我都练就了在记事本里写代码不出错的本领，虽然最后分数没多高但看到被捞过于开心啦
114107,52,白洪欢,2019-07-08 23:19:10,7,11,4,理论47，实验11，绩点3.0，你懂的。\n\n爱我小白！！！
114117,52,白洪欢,2019-07-09 00:07:31,4,7,3,很幸运能选上小白的c程上课讲的很棒，考试结束还会捞人?
114119,52,白洪欢,2019-07-09 00:07:50,0,3,3,理论下40捞到了2.7，我哭了? ，老师真好
114153,52,白洪欢,2019-07-09 01:35:00,1,5,4,感谢老师海底捞我，我原本以为挂定了，一定好好努力。
114181,52,白洪欢,2019-07-09 03:20:40,0,4,4,上白老师的课真的是收获特别多，而且讲的很细致耐心，最后给分也特别好！！
114189,52,白洪欢,2019-07-09 03:46:17,4,8,4,本来以为要挂的结果3.9？？？\n\n老师上课超nice啊爱他！！！
114192,52,白洪欢,2019-07-09 03:51:28,1,7,6,理论48实验20被捞到3.6，感动中国
114194,52,白洪欢,2019-07-09 03:53:36,4,7,3,理论66，实验题两道，本以为绩点很低了，结果4.2，感谢老师海底捞!
114199,52,白洪欢,2019-07-09 04:06:11,1,3,2,不多说了，给分真好！
114201,52,白洪欢,2019-07-09 04:09:17,2,7,5,说实话感觉有点找不到体系，但是老师讲得很好
114202,52,白洪欢,2019-07-09 04:11:19,2,5,3,感谢老师海底捞！
114204,52,白洪欢,2019-07-09 04:19:45,4,12,8,不得不说，平时pta作业真的超级超级少！！！！上课讲的也很清楚！但是希望老师和助教还有大佬们在群里回答问题时注意一下，每句话都带着刺，真的很不友好。。
114208,52,白洪欢,2019-07-09 04:30:58,2,6,4,老师学术水平高，上课知识点落实很细，重在实践，给分大方。\n\n
114214,52,白洪欢,2019-07-09 04:45:03,3,6,3,以为要挂 枯了 没想到3.9！！！吹爆白洪欢老师！！！
114219,52,白洪欢,2019-07-09 05:51:19,1,5,4,老师这捞人水平也太强了吧呜呜呜
114241,52,白洪欢,2019-07-09 08:52:28,3,6,3,舒服了
114615,52,白洪欢,2019-07-11 00:55:48,5,10,5,话不多说，感谢老师的海底捞
114765,52,白洪欢,2019-07-11 12:02:55,3,9,6,白哥海底捞！爱了，上课干货满满，毫无水分
114829,52,白洪欢,2019-07-12 01:31:17,8,12,4,白老师讲的真的好 听课是享受 作业也不太多 给分超好 海底捞人
115061,52,白洪欢,2019-07-15 03:35:23,5,10,5,海底捞感谢
115428,52,白洪欢,2019-07-23 08:58:11,10,14,4,老师超级好，讲课特别清楚，教学特别认真！
115578,52,白洪欢,2019-08-05 14:00:20,7,11,4,非常负责
115853,52,白洪欢,2019-08-21 06:04:10,75,89,14,姓名：白洪欢；性别：男；绰号：小白；职业：黑客（兼职做老师）；技能：海底捞（针对C程、汇编等硬核课程）；逆向（上过软保的应该都知道吧）；密码学（上过密码学的应该也知道）；拆东西（电脑之类的基本都拆过）；编程+写教程（看看小白主页）；英语教学（上过课的都知道）；网购（eBay忠实用户）；谈人生（发邮件谈人生）。评价：巨好！无论是知识水平还是人格魅力都超级好！
116544,52,白洪欢,2019-09-11 11:15:12,20,26,6,有意思，黑客大佬
116545,52,白洪欢,2019-09-11 11:14:58,18,25,7,有意思，黑客大佬
116787,52,白洪欢,2019-09-16 01:45:02,17,25,8,非常好
118622,52,白洪欢,2019-10-29 16:25:13,-18,22,40,咋说，我觉得汇编太散了，之前我还不知道咋个散法，现在深刻体会到了。我脑子里建立不起来这个编程体系，就是汇编它到底怎么开头结尾，寄存器干什么用的，寻址都怎么寻的，循环怎么跳的，函数怎么调的。我即使知道一点我觉得我也是靠自己自学的，那种不确定感始终萦绕在脑子里。上过Patt的小学期，就算那个汇编简单吧，讲的清晰程度完全不在一个线上啊。真的学得有点难受。
118663,52,白洪欢,2019-10-30 06:40:56,21,25,4,很好的
119040,52,白洪欢,2019-11-10 01:07:00,-41,1,42,
120857,52,白洪欢,2020-01-18 00:03:51,29,33,4,妙啊。
121275,52,白洪欢,2019-12-24 13:45:34,34,38,4,听小白讲那过去的事情
121505,52,白洪欢,2019-12-14 04:03:06,54,61,7,大家注意了！！！是汇编和软保的助教陈源大佬做了查老师反代！！！大佬们都太强了！！！
121515,52,白洪欢,2019-12-13 14:41:46,44,47,3,条理清晰，讲得特别好！作业虽然有难度，但是参考样例程序都是可以做出来的！还有群里的iostream大佬也tql了吧！！！
121649,52,白洪欢,2019-12-10 11:55:01,32,34,2,小白我爱你(ღ♡‿♡ღ)\n\n
121670,52,白洪欢,2020-01-20 11:06:44,70,79,9,身为助教前来说一句：抄袭的作业就不要交了，陈越姥姥的PTA查重相当厉害的，历年提交的作业都在查重范围
121882,52,白洪欢,2020-01-23 05:33:58,28,30,2,讲课内容深入，给分也好
121884,52,白洪欢,2020-01-23 05:35:02,35,40,5,小白叫我炒股😜
121885,52,白洪欢,2020-01-23 05:36:00,-79,3,82,上课好像不错（反正我上课也没听，但是我满绩这就很开心）
121886,52,白洪欢,2020-01-23 05:37:45,35,46,11,吹爆小白！！！感谢老师的满绩~~~
121888,52,白洪欢,2020-01-23 05:47:51,32,34,2,课件详细，知识丰富，考卷真的很专业，一看就很用心的那种
121889,52,白洪欢,2020-01-23 05:56:34,30,31,1,小白老师冲！
121891,52,白洪欢,2020-01-23 05:59:47,29,32,3,我爱小白
121894,52,白洪欢,2020-01-23 06:12:42,33,37,4,听小白老师的课真的很开心！课间还有有趣的电影，老师布置的作业只要上课认真听了都不是问题！老师教的真的很好！！！为小白老师打call！！！
121895,52,白洪欢,2020-01-23 06:33:23,-46,5,51,给分不知道怎么给，玄学！
121896,52,白洪欢,2020-01-23 07:20:47,31,33,2,超喜欢小白老师！
121901,52,白洪欢,2020-01-23 09:08:29,31,36,5,超棒的老师，超好看的《爱情故事》！
121904,52,白洪欢,2020-01-23 10:20:15,45,55,10,大爱小白！！！虽然我的附加题被倒扣了100分😝
121905,52,白洪欢,2020-01-23 10:50:41,-20,19,39,不喜欢，感觉汇编教的很散，上过patt小学期，感觉那个汇编很有体系且简单…（小声
121936,52,白洪欢,2020-01-24 09:36:50,34,39,5,一给我里giao~讲课调理清楚不催眠，分享学习工作经历，生活感悟拉满，让我重拾学习的动力，冲！
121938,52,白洪欢,2020-01-24 16:13:38,32,36,4,浙大最喜欢的老师～给学生看电影，分享个人经历，真心想给学生讲好课，超爱
121966,52,白洪欢,2020-01-26 08:18:58,29,32,3,上课内容丰富 也需要自己好好思考吸收！
121982,52,白洪欢,2020-01-28 06:02:17,32,35,3,超喜欢小白老师！！！
121988,52,白洪欢,2020-01-28 13:55:45,33,36,3,上过汇编，讲课很清楚，节奏不快，适合新人学习，也能学到不少内容
122039,52,白洪欢,2020-02-03 15:52:56,28,32,4,不错哦
122269,52,白洪欢,2020-02-22 04:58:13,40,46,6,请上学期汇编课借书没还的同学赶紧把汇编教材还给小白老师呀
122828,52,白洪欢,2020-04-11 16:11:52,14,19,5,上个学期作死选了小白的软保课……就课论课来评一下吧。首先这个课其实很硬核，特别是实验，一共三次实验作业都相当锻炼人。小白讲的很快因此上课一定要尽可能跟上老师的节奏，手速够快的同学建议多记点笔记，否则实验会极其痛苦（血的教训）。不过实验认真做的话期末考还是不难的，虽然信息量很大但是期末会划重点，只是最后一道20分的默写程序大题有点迷（不过认真背的话算是送分？）。想选的同学强烈建议先学汇编或者在假期或者刚开学几周把汇编的基本指令补清楚，否则还是退课吧。给分的话，我平时实验做的比较认真所以期末感觉还好，最后勉强上了90，但是全班90+人数差不多10%，自行感受。总的来说这课还是相当值得选的，能学到很多黑科技XD~最后小白的电影是真的好看（破音）
123209,52,白洪欢,2020-05-19 13:39:59,9,13,4,好，很好
123630,52,白洪欢,2020-06-10 15:50:32,12,15,3,今天花了好久浏览白老师的个人主页，感觉老师真的是一个爱工作，爱生活的人。希望自己以后也能像白老师这样。
123951,52,白洪欢,2020-06-17 14:35:07,6,7,1,老师很认真，很严格，能学到不少东西。不过教的内容感觉比较古老，要是能跟进一下新版本感觉比较好。
125430,52,白洪欢,2020-09-08 14:13:51,4,8,4,超喜欢小白老师，讲课得很深入，会从原理给你剖析，也能学到很多有趣的技巧，最重要的是对学生超好！！我之前因为缓考的事咨询他，他一直在帮我询问解决问题！！p.s.联系白老师建议用邮件，他回复很快的。
126103,52,白洪欢,2020-09-17 14:18:26,6,18,12,密码学实属大水课，啥都不听，作业就都能写，最后期末无比简单，随便看看openssl文档，刚刚出分果然大家有手就满！
126104,52,白洪欢,2020-09-17 14:24:15,16,27,11,小白老师真的太好了，我连上了他的三门课，汇编、密码学、软保，一个4.8，两个5.0。汇编和密码学没有预修要求的，建议大一就修读，对以后的数学课和软件课很有帮助。
126105,52,白洪欢,2020-09-17 14:25:37,12,15,3,非常推荐新同学选修他的汇编，讲课深入浅出，课堂风趣幽默，能学到很多东西。本来入学也没有很扎实的代码基础，但还是在白老师的汇编课上拿到了4+，之后也对各种编程语言和原理有了更深刻的理解，对很多专业课都有很大的帮助！小白本人也平易近人，会给同学们放电影，还会讲一些人生哲理，真是来浙大遇到的最棒的老师！
126171,52,白洪欢,2020-09-18 10:55:47,8,10,2,超级好，可能严格点但是给分很好！
126173,52,白洪欢,2020-09-18 11:17:34,8,14,6,刚出成绩来给小白老师评分！理论68实验11(没完整做出一题)，最后3.6，感谢小白捞我😭😭以后一定好好学习。小白上课真的很棒哇，感觉上了c以后编程能力提高了很多！！疫情期间在家没有好好学习，感觉对不起老师😭
126708,52,白洪欢,2020-10-14 15:38:58,17,19,2,正在做软保的第一次作业，感觉老师出的题真的很好，各种细节都和课上讲的内容相关，忍不住来评论一下，小白真的是我最佩服的一个老师。
128680,52,白洪欢,2020-12-25 04:00:09,8,14,6,绝对的好老师。教出全球黑客比赛冠军队伍（中国第一支）的队长。
128960,52,白洪欢,2020-12-27 12:16:29,6,11,5,极有风骨，人格仰止。
129059,52,白洪欢,2020-12-29 08:40:54,0,5,5,可可可可
129128,52,白洪欢,2020-12-30 08:33:53,17,23,6,绝对不要看评分高就选的老师，基础不好的朋友快跑。\n\n白老师绝对是好老师，我上的是汇编语言，再简单的内容白老师都会仔细演示给大家看，很用心很有技术力。\n\n太有技术力了，真的很酷炫
130194,52,白洪欢,2021-01-19 01:22:55,6,9,3,电影很好看，老师人很好
130882,52,白洪欢,2021-01-31 02:34:07,91,114,23,提醒一下想选密码学的同学，隔壁diffle的不香吗？\n\n提醒一下想选汇编的同学，隔壁patt不香吗？\n\n提醒一下想选软保的同学，大学四年不挂科不香吗？
131800,52,白洪欢,2021-01-29 03:57:25,10,16,6,小白的课比较硬核，而且作业要求很严格，切记不要抄袭。考试虽然有难度但是都是课上讲的内容，认真听课好好复习成绩不会差，给分很好
132102,52,白洪欢,2021-01-30 09:16:32,-85,12,97,sbsb
132287,52,白洪欢,2021-01-31 13:37:44,-128,10,138,傻逼老师，你怎么不去死啊
133553,52,白洪欢,2021-03-02 05:30:31,7,10,3,上过老师的汇编设计基础，老师人很好，讲课态度很认真，非专业期末考前复习感觉考试基本都会，虽然最后给分一般。觉得知识结构有点散，大多是指令，想学有所成可能得花更多的时间钻研。
133960,52,白洪欢,2021-03-10 14:39:19,2,5,3,老师真的不错 学到了很多东西
134202,52,白洪欢,2021-03-19 07:03:33,2,6,4,老师的知识库太陈旧了呀。或者说是上课讲的内容太陈旧了
134378,52,白洪欢,2021-03-25 09:32:51,14,18,4,给分真的不好，平时分会扣很多（不懂为啥作业都做出来了能给那么低，真如上面所说是注释不合风格？
134381,52,白洪欢,2021-03-25 11:17:09,6,10,4,除了讲课离散跟计算机科学基本不沾边
134648,52,白洪欢,2021-04-07 13:32:27,11,15,4,单论讲课，为何不给10分呢😉
135041,52,白洪欢,2021-04-27 13:45:58,0,4,4,很好很好
135150,52,白洪欢,2021-05-04 08:34:24,-29,6,35,老愤青一个
135520,52,白洪欢,2021-05-12 10:31:38,13,18,5,小白老师的汇编\软保\密码学我都上了，我想我还是有发言权评价的，另外也可以讲一下学这些课的通用好方法。\n\n首先，这几门课都算比较硬核的，不属于水的通识课，甚至可以算是负担较多的专业课。\n\n其中软保第一名，汇编和密码学不相上下，因为我学过微机，大概密码学对我来说更难一些。\n\n我不是相关专业的同学，为什么选这些课呢？\n\n第一，白老师上课耐心细致，下课主动问上课讲过的问题也不会嫌弃你（在qq群里可能会有些嫌弃一些上课明明讲过但是却仍然被提出的简单问题）。\n\n第二，我对这些课程内容感兴趣，比如破解软件，制作游戏外挂，了解病毒机理等，并且自己有一定编程基础，肯花时间在上面学习。\n\n我认为，这些课程不花时间好好学点本事，是没有意义的，一点也不符合事少有趣给分好的课程。\n\n如果要学好这些课程，我的建议是\n\n第一，上课好好听，一定要做笔记。我做笔记的方法很简单，笔记本打开一个word就行。其中软保是最需要做笔记的，最好老师的操作都记下来；其次是密码学，也很需要笔记，因为涉及到算法，课后作业都是算法相关的；汇编也可以好好做笔记，但是因为都是基础知识，如果自己已经了解了可以松一点。好好做笔记也是为了之后课程结束后，自己还有资料可以参考。\n\n第二，课后作业认真完成，尤其是软保+密码学。\n\n第三，拒绝考前抱佛脚。我说的抱佛脚就是，不能单单考前花几个小时，尤其是软保。\n\n我强调了这么多次软保，并不是软保有多难，学习内容不难，考试也不难，但是要你认真对待。我学软保的时候因为考试有很重要的专业课在前一场，所以基本上只复习了一个小时（这门课对我来说也就是个性课，绩点倒是不太关键），但是最后也拿到了3.6，主要原因是平时认真，做一些简单的记忆就可以保证稳稳通过。
136339,52,白洪欢,2021-06-16 14:25:27,9,12,3,老师是好老师，只不过我太菜了，够不着老师的期望。\n\n推箱子根本做不出来，对这门课绩点不抱期待，只求不挂科了。
136597,52,白洪欢,2021-06-21 14:41:18,11,12,1,同楼上，之前每次作业都花了很多时间精力写，推箱子实在是不会，老师讲的很好只能怪自己智商不够，只求小白捞我了……
136633,52,白洪欢,2021-06-22 07:36:28,12,14,2,推箱子，不仅考的是知识，更考的是耐心啊，在考试周马上来到的这个时间，考的是你还能不能静下心来写一写，或者干脆直接放弃赶快去复习吧，千万不要一直吊着
136745,52,白洪欢,2021-06-24 02:43:23,15,18,3,写给学弟学妹：选小白的课一定记着上完就把智云课堂的视频录制了（懂的都懂）
136922,52,白洪欢,2021-06-28 08:49:45,5,8,3,为什么上课的麦那么吵……一直是电流噪音\n\n老师人很好，会为了你认认真真听课而把智云课堂存档录像给关了\n\n在提问交流群里要求学生不能问一些很低级的上课明确讲过的东西\n\n有自己的主页，里面有各种相关课程的精品学习资源\n\n主力用TC授课，操作系统环境是WindowsXP（会提供虚拟机安装途径）\n\n真的希望学弟学妹们上课认认真真听啊……周一下午容易困就买杯咖啡，上课内容太宝贵了错过就没机会了啊
137167,52,白洪欢,2021-07-01 15:49:02,-14,5,19,老愤青一个
137261,52,白洪欢,2021-07-11 14:40:01,15,19,4,感谢小白老师海底捞，信安学子不得不选汇编语言啊啊啊啊啊啊啊
138288,52,白洪欢,2021-07-08 10:51:55,4,5,1,好！捞人！
138764,52,白洪欢,2021-07-10 17:18:23,3,6,3,呜呜呜，讲课真的非常好呀，虽然作业很难，但是给分也不错，感想小白捞我呜呜呜
138768,52,白洪欢,2021-07-10 17:40:54,4,5,1,救我狗命，太感谢了
138865,52,白洪欢,2021-07-11 11:06:29,75,87,12,如果你有幸看到了这里，请认真把它看完再决定是否选择小白老师的汇编课，希望前人的经验能对你们有点帮助\n\n汇编这门课是真的很难，对没有基础的同学很不友好\n\n今年的《汇编语言》，因为是给图灵开的，比往年都难很多，两学分的课最后一次大作业直接是汇编写一个推箱子，没有两个星期天天去肝很难完成，学分很少，但是花的精力比5学分的课程还多\n\n小白老师确实是很负责任的老师，半夜问他题都能及时回复。不过他讲课水平确实不太行，讲的很乱，想到什么讲什么，没有条理（可能汇编本身就很杂乱，但是看王爽的书或者他自己编的书就很容易懂）\n\n另外小白给分比较求是，基本不会捞人，能及格的人更是一分都不会调，如果你不是大佬绩点会很难看，能不挂都烧高香（2020，一百余人，挂了12人；2021，本来一百二十多人，期中弃修了40几个，剩下的挂了11个，我们这些存活的绩点也很难看）\n\n另外这门课的意义不大，为什么这么说呢，其实老师讲的东西主要是dos下面的一些老旧的东西，不只讲8086汇编，后面半个学期讲了许多病毒、软保的东西，什么保护模式，ldt表之类，已经过时很久了，现在根本没人使用，网上连资料都没有，我不知道现在学这种淘汰的东西有什么用，不得不说老师的技术链已经很过时了\n\n\n\n建议大家如果对汇编有兴趣可以看看王爽的书或者他自己写的教材；为了自己的绩点考虑不要去选课，如果有兴趣可以旁听；如果一定要选，建议选《汇编语言程序设计基础》；如果你头铁选了《汇编语言》这门课，感到学不懂一定要果断在期中弃修；如果你十分勇猛选择《软保》，必须有很好的汇编基础，普通人远离，否则大概率挂科！\n\n血的教训，误选，切记！！！
139039,52,白洪欢,2021-07-12 08:43:00,1,6,5,老师好好啊！
139047,52,白洪欢,2021-07-12 09:24:30,-1,3,4,小白小白小白海底捞啊啊啊啊，救我c程于水火。本来考试出来因为不符合课上说的及格要求哭了一个晚上，但是结果出来意外之喜！！！！小白我的神！！
139060,52,白洪欢,2021-07-12 10:11:23,0,2,2,小白无敌
139071,52,白洪欢,2021-07-12 11:48:59,1,4,3,感谢白老师，无敌海底捞，看到成绩抱头流泪。越来越明白老师课堂上的良苦用心，后悔自己的努力没有匹配老师的期望。划水的自己逐渐成了可恨的样子，一些严厉却真正关爱学生的人却可能要永远错过了。
140492,52,白洪欢,2021-09-13 05:19:53,10,13,3,图灵的汇编语言…只能说快逃。感谢老师不挂之恩，让我拿了2.1
140513,52,白洪欢,2021-09-13 08:11:34,1,1,0,老师真的好好好！！！！
141635,52,白洪欢,2021-10-18 11:22:24,2,5,3,真正的计算机老师
141737,52,白洪欢,2022-01-08 12:32:56,11,18,7,选了通识的汇编基础\n\n即使之前上过Patt，自认为稍微有一点基础\n\n但是还是期中弃修了\n\n感觉Patt讲的更加原理性一点\n\n而小白老师讲课虽然很不错\n\n但是感觉还是偏工程了一些
141993,52,白洪欢,2021-11-03 06:50:53,0,2,2,感觉还行
143856,52,白洪欢,2021-12-09 05:27:12,25,33,8,小白很厉害，很喜欢汇编，很喜欢生活，很喜欢看电影。\n\n老师心态感觉很年轻，感觉老师的技能是随兴趣获得的。\n\n小白很不喜欢现在学校里面的一些官僚，也很敢说话。\n\n老师很爱自己的学生，经常会解决问题但不是讲过的问题。\n\n\n\n另外吐槽一下上面说小白讲的很多东西都过时的评论......\n\n底层的东西不是说变就变的，比如Unix + C 已经虎虎生风40多年了\n\n而且小白讲的GDT\LDT 选择描述子怎么可能没有用，还有在linux 下的ELF文件格式，重定位链接都是息息相关的。\n\n虽然DOS下面的汇编相对现在的32\64确实没有什么实际用处，但操作系统为了向前兼容，在一开始的\n\nboot程序中，会将CPU从实模式（16位）引导到保护模式（32位），这段代码就是16位汇编写的。其实小白讲的还是很有用的呀。\n\n而且学16位汇编比32位会简单的很多啊，很多基本的原理是不变的呀，比如传参方式\栈帧\n\n\n\n但小白讲课离散是真滴.......\n\n最后说一句，我永远喜欢小白老师！
144446,52,白洪欢,2021-12-21 13:56:20,-1,14,15,说讲课内容意义不大的，压根没真正进入安全这行。整个AAA战队都是白老师培养出来的，你跟我说汇编没用。\n\n另外说diffle密码学那课好的是真没上过那课，首先这俩不是一门课，一个理论一个实践。其次diffle那个也基本没什么用
144672,52,白洪欢,2021-12-23 05:23:16,-2,2,4,小白老师yyds
144999,52,白洪欢,2021-12-26 11:22:11,-7,0,7,发布于2021.12.21的是谁啊\n\nyyy?\n\ntc?\n\n还是哪个小朋友
145913,52,白洪欢,2022-01-04 09:51:27,15,18,3,刷高绩点请往别处\n\n混水摸鱼勿入斯门
147406,52,白洪欢,2022-01-10 02:49:45,1,4,3,老师上课内容很丰富，一看就很牛，可惜我小垃圾听不进去呜呜
147739,52,白洪欢,2022-01-10 15:24:15,-1,11,12,快逃！
148854,52,白洪欢,2022-01-13 17:48:07,-19,18,37,平常事儿贼多，又是要写作业又是要写论文，讲课不讲重点，最后还放狠话，感谢这门课贡献了我大一上的最低绩点
149979,52,白洪欢,2022-01-18 06:47:50,2,3,1,C小程讲得非常好
150105,52,白洪欢,2022-01-19 05:21:07,-7,2,9,今年软保：\n\n老师讲的挺好的，给分也不错（汇编接近0基础拿下了80+）大家不要害怕，即使汇编基础不是很好只要努力也是能过的。\n\n另外，期末会划重点！\n\n一定要听老师期末划的重点！\n\n试卷最后20分的编程题就是白送分的，只是需要考前多多背诵
150442,52,白洪欢,2022-01-25 09:18:00,2,3,1,老师人挺好的，课也比较硬核:)
151129,52,白洪欢,2022-02-23 09:21:27,0,3,3,白老师讲的C小程对小白真心好，很清晰易懂。
153800,52,白洪欢,2022-05-11 13:28:07,-1,2,3,很好的老师
154982,52,白洪欢,2022-06-07 08:27:30,9,11,2,“老师的作用是给学生引导，如果只是念念PPT就没意思了。我知道很多老师都是这样的，但是我认为不能这样，如果这样的话大家自己看看书就好了。”就冲这句话就想给小白打十分。小白上课会拓展一些考试不考的东西，有些考试考的反而不怎么强调，但是认认真真地听完真的会收获很多，而不仅仅是应试。
155020,52,白洪欢,2022-06-07 14:02:47,-19,1,20,问问题从来不认真回答
155179,52,白洪欢,2022-06-09 06:02:50,16,17,1,悄悄说一声，我之前看到老师的车牌号是3860x😉（希望有人也可以看懂）
155341,52,白洪欢,2022-06-11 06:07:31,10,15,5,小白太赞了，选的是汇编，最后一节课十分细致地给我们分析了期末考点，考100分的同学会得到他的一份小礼物（排名全球第一的一个软件加密锁 hardware against software piracy)。之前有人说最后会删智云课堂，老师解释说是智云课堂（包括学在浙大等）都是外包的，安全性做得太差，随便一个黑客都能任意爬取，所以相关资料都是放在个人网页上，教务处还不许老师删除自己的视频，小白都是用技术手段自己删的（bushi）。总之冲就对了（当然还是要认真学的）。
155504,52,白洪欢,2022-06-13 15:43:25,11,14,3,神秘的黑客老师！！！\n\n\小白/\小白/\小白/
156796,52,白洪欢,2022-06-21 03:26:13,1,2,1,老师对待教学真的很用心，能从他的课堂上收获很多东西
157196,52,白洪欢,2022-06-22 08:39:30,5,9,4,密码学给分挺好
157240,52,白洪欢,2022-06-22 13:26:42,2,3,1,呜呜呜，我爱小白
157258,52,白洪欢,2022-06-22 15:41:58,0,1,1,老师很好，但是讲的课很硬核，不太适合我这种菜鸡…😂
157674,52,白洪欢,2022-06-24 09:40:31,3,5,2,这学期上了老白的C小课堂，感觉看老白用五笔打汉字别有一番风味。除去C程上课不按照书上内容来讲（好吧我承认其实应该不会有人按照这本书来讲，教材是真的写得一点都不好），其他真的挺好的。虽然老白看上去非常严肃，但是讲课其实很风趣的，也会和学生有互动，答疑也是很有耐心。
157695,52,白洪欢,2022-06-24 11:07:39,3,13,10,事多分少，慎选勿入
157719,52,白洪欢,2022-06-24 12:40:37,0,7,7,小白老师上课真的不会犯困，他有一种天然的让你去认真听讲的吸引力！虽然本来是每周二晚上两节的课被他硬生生改成了三节，但是真的非常享受，只觉时光飞逝~\n\n但是讲真小白老师讲课的时候确实是东一棒子西一棒子，虽然主页上有笔记，但是有好些时候还是被绕晕了，不知道怎么找到相应的内容，所以笔记也会记得比较混乱。\n\n关于考试，因为没有好好复习，字符串的处理那边一点儿也没看（就那儿没看），结果最后整张卷子基本到处都考到了，所以当时真的欲哭无泪（所以大家真的边边角角都要好好复习www）然后第四次作业因为混合语言很多细节都不会处理，基本属于没做，真的以为自己要挂了（107人老师挂了8人，90分以上9人），结果最后居然还有3.9，www白老师真的我哭死！
158386,52,白洪欢,2022-06-29 02:21:50,9,13,4,图灵班和信安的汇编语言，老师讲课很好，回答问题也很认真，今年最后一个大作业可能不够难（x），导致最后挂了19个。感觉考卷是默写的内容太多了，可以更合理一点，然后大作业也不容易，希望可以调整考试和作业的成绩占比。
158619,52,白洪欢,2022-06-30 18:35:20,7,9,2,平时分给的蛮好的
158621,52,白洪欢,2022-06-30 22:52:57,4,7,3,小白讲的很好！！是超级棒的老师 但是c小一分不调 理论86实验满 平时小测扣了十分 也直接85…是我自己考的不太好但本来期望老师可以看在期末的份上多给我一分的qwq
158622,52,白洪欢,2022-07-01 00:26:22,12,16,4,讲话有趣，给分很好，凌晨2点还回消息，邮件里的人生导师，完美潇洒的老师(黑客)
159123,52,白洪欢,2022-07-06 13:18:19,8,11,3,创了查老师这位学长，查一查
160292,52,白洪欢,2022-09-17 05:53:38,1,3,2,好求是的小白😭
161052,52,白洪欢,2022-10-25 03:46:29,10,11,1,难度和课时的匹配突出一个离谱
161246,52,白洪欢,2022-11-02 07:07:09,1,5,4,脑子抽了是吧😅
161270,52,白洪欢,2022-11-10 16:16:02,6,9,3,。。。。讲课不行 给分不行
161290,52,白洪欢,2022-11-03 15:41:13,2,6,4,不知道好在哪里…为什么分这么高
161322,52,白洪欢,2022-11-04 05:50:38,4,8,4,**多少有点**
161455,52,白洪欢,2022-11-07 04:53:16,-1,3,4,哈哈哈。
161698,52,白洪欢,2022-11-10 16:17:59,-4,2,6,…闲着没事干不如去出出试卷嗷
161817,52,白洪欢,2022-11-14 02:27:56,-3,3,6,额…\n\n…….
162007,52,白洪欢,2023-01-23 11:23:28,21,44,23,真的不知道好在哪里\n\n他怕不是黑进服务器自己改了好多评分
162591,52,白洪欢,2022-11-27 05:10:18,3,6,3,不懂好在哪里
162641,52,白洪欢,2023-01-17 15:44:41,5,8,3,大计基的事是比别的老师少的，没有office实验之类，就一篇期末论文和平常的pta作业，但是有点难。大计基教改以后本身变成一门不那么好学的课，感觉老师对过斩杀线的应该都捞上来了，但是对能过得就比较求是，可能有同学分不太高。老师的讲课方法可能有点抽象但是大计基确实没什么讲课好的老师。只能说事少但是能拿多少分各凭本事
162656,52,白洪欢,2023-02-18 03:09:41,-1,6,7,您很6
162684,52,白洪欢,2022-12-04 05:39:54,-7,7,14,..就这\n\n老古董捏
163300,52,白洪欢,2022-12-12 10:16:33,-17,22,39,他有多喜欢计算机=我有多讨厌计算机，\n\n老师人很好，但非常不适合我这种计算机小白，很痛苦。\n\n对于有人说他还讲解的人生观很好，这我不敢苟同，\n\n他说计算机很好，是最应该学的学科.......\n\n首先计算机对家条件要求高，有人可以随意拆卸计算机，而有人连下软件都怕把计算机下坏，因为对我们来说这些电子设备并非大风刮来的，想要全面普及（小学初中高中计算机课都不再被占，并设有正经考试）还有很长的一段路。\n\n其次他说因为计算机没毒，比化学安全.......我真的无语，我不禁想象学计算机的都是懦夫了（无意冒犯）
163619,52,白洪欢,2022-12-15 18:48:16,8,14,6,就很疑惑，好在哪里，分数为啥可以这么高？
163878,52,白洪欢,2022-12-16 10:43:28,1,4,3,老师水平很高，是我不配，听不懂不是老师的错，建议没基础的别选，想学黑客的都来
163901,52,白洪欢,2022-12-16 12:56:56,4,6,2,没基础选了痛苦一学期，可能是我太菜了，只讲一些与课程无关的高深内容，还要求掌握，大计基有自己的一套教法，期末要求写他上课内容的论文1k-2k（别的老师都没有），一点都不懂没法写过来评论，不过钉钉回复还是比较热心的
164091,52,白洪欢,2022-12-18 02:48:22,5,5,0,老师人很好。。但是大计基真的对零基础来说比较为难。。
164423,52,白洪欢,2022-12-21 02:32:20,4,9,5,A good hacker or tutor， but not a good teacher.
164761,52,白洪欢,2023-01-15 02:59:03,2,8,6,老师可能更适合上一些兴趣拓展类的通识课，像大计基这样明确要考试、学分又不低的课，愚以为老师这样的上课方式应该不适合大部分同学。我本以为老师评分高可能给分不错，不过到头来还是3.6喜提最低分，看钉钉里都在说谢谢老师，估计大家分都很高吧，反正我也是尽力在学，每次作业都认真完成，期末感觉也没有考炸，怪自己菜菜咯😑
165067,52,白洪欢,2022-12-29 03:16:07,0,4,4,…\n\n上课八行\n\n给分八行
165127,52,白洪欢,2023-06-28 10:01:53,2,10,8,不知道为什么分这么高\n\n有没有董哥说说好在哪里
166120,52,白洪欢,2023-01-11 07:10:56,3,13,10,这查老师评分不是被他黑进来偷偷改了吧
166392,52,白洪欢,2023-01-12 06:57:20,7,10,3,看下均绩 快逃 懂？
166849,52,白洪欢,2023-01-14 02:14:26,0,2,2,（大计基A）给分好好！我以为我要完蛋了
166963,52,白洪欢,2023-01-14 11:21:23,0,4,4,好老师，不用多说！
167172,52,白洪欢,2023-01-15 04:40:12,2,4,2,老师本人是很有人格魅力的，又像侠客又有点bking，很厉害 对学生回答问题也很快。虽然上的是大计基这门烂课，但是老师的事已经很少了，没让我们做什么乱七八糟实验和作业，只是让我们写了一篇一千字以上两千字以下的论文（关于他上课讲过的课外知识，就算水平不高也可以完成），考前还会给我们讲一下范围，总之人真的很好！
168003,52,白洪欢,2023-01-22 03:50:33,3,6,3,…..\n\n真的一般哈
168892,52,白洪欢,2023-02-23 08:48:22,-9,8,17,我是计算机小白，但是作业认真做了，考试复习两天，拿了4.8，差一分满绩，感觉还是不错的。而且老师拓展的很多，应试方面去找别的班同学要就行。
169250,52,白洪欢,2023-02-25 03:50:46,-4,2,6,马上考汇编，求捞
169589,52,白洪欢,2023-02-27 04:28:31,5,9,4,水平很高 讲课清晰 认真负责\n\n特别体谅学生 问问题总是会及时回答 甚至还会帮忙修改代码\n\n因为疫情有部分同学阳了 白老师还专门延长了大作业的ddl（超感动！\n\n最后给分也真的很好 可以看出白老师尽力捞了
171310,52,白洪欢,2023-04-03 08:53:44,1,5,4,上课很用心而且很有趣的牛逼老师
173233,52,白洪欢,2023-05-16 09:57:07,3,5,2,饭点拖堂  每周二都能见识到排出食堂外的打饭队伍
174779,52,白洪欢,2023-06-17 17:03:17,-24,8,32,👎\n\n老古董
176457,52,白洪欢,2023-06-29 03:16:29,1,4,3,本学期修了白老师的汇编语言程序设计基础，分还没出，但是预感期末考的不是很好。\n\n老师上课很有意思，这门课对于想要更深入理解其他高级语言挺好的。比如为什么C语言的数组非得给它指定一个长度，学完以后就觉得很自然了，反而能不指定长度才是值得惊讶的高级特性。\n\n关于汇编语言，如果你不是信安专业的，建议还是作为兴趣学习比较好，比如我推荐感兴趣的直接来旁听老师的课而不是选这门课（逃）\n\n为什么呢？因为汇编的知识点又多又杂，就算你平时作业都认真做了，大作业也写了，最后的考试还是有可能因为学艺不精而G掉，然后喜提一个低绩点\n\n这是因为课程的难度问题，期末考试考的一些知识点在平时作业里是用不到的，所以也就没办法通过做作业复习，真复习还得是好好看书，跟着老师的每一个例子Debug\n\n所以想要在这么课拿高分是非常花时间的，其他回答也说了，两学分的课比五学分的事情还多\n\n而直接旁听就可以避免后者（毕竟这只是一门通识课），当然作业还是要做的\n\n因为老师上课比较曲高和寡，每次来听课的不会超过二十个人，绝对有位置坐
176533,52,白洪欢,2023-06-29 08:09:39,2,5,3,上的是白老师的C程，确实如前人所说，老师基础不会太深入，但是他会讲一些拓展。我觉得老师上课还是认真的，和其他有些老师相比，起码他是按大纲来教学的，有人说白老师的课有点乱。确实有点，我感觉他就是想到什么讲什么，但是不会脱离他那块讲课的内容。言而总之，我觉得白老师是一个值得选的好老师（bhh捞捞我我感激你一辈子呜呜呜）
177284,52,白洪欢,2023-07-02 14:48:58,0,4,4,来自汇编语言程序设计基础，讲得很细致，连程序的编译和调试步骤也会讲解，而且会讲一些拓展内容，能学到好多东西！平时作业也比较容易上手，不算太难。不过期末考试的时候也相应地考得全面细致，要好好复习哦！
177300,52,白洪欢,2023-07-02 23:24:55,3,4,1,一般哈
177589,52,白洪欢,2023-07-04 00:54:47,0,1,1,老师上课有自己的想法 基本都是在讲解代码 平时也只布置代码作业 因此理论部分对于考试稍微欠缺一点 需要自己看别的老师的P TA 但是整体来说还是很推荐的 全编程的小测期中考导致很容易满分 我有一次小测没做出来最后也没被老师扣分 强推一手
177900,52,白洪欢,2023-07-05 10:00:50,-11,4,15,真的给分就不行……救命了 是一点都不捞 刚好卡绩了 不知道为什么有这么高的评分 很后悔选了他，作业比别人多了好多，学的也很认真，结果绩点爆炸了 :-(，但凡捞一点点我也不会这么说他，我自己计算过了一点都没捞过
177949,52,白洪欢,2023-07-05 17:00:18,1,5,4,白老师的程序填空，做过的都说好！
178121,52,白洪欢,2023-07-07 05:10:44,1,1,0,上的白老师的c小，没有任何基础学感觉一开始有点听不太明白，需要自己多做题多看书。感谢小白海底捞!!
178283,52,白洪欢,2023-07-09 12:33:07,7,7,0,好好好好好\n\n备课讲课这么认真的老师很少见了\n\n程序填空更是薄纱pta原生程序填空
178678,52,白洪欢,2023-07-17 06:04:29,-1,1,2,小白很好，非常的朴实，完全符合对程序员的刻板印象。最后一节课还教给我们大学生活学习的道理，真的超感动！
178929,52,白洪欢,2023-08-01 14:40:01,-50,12,62,垃圾。
179569,52,白洪欢,2023-09-18 09:34:58,1,2,1,太强辣
179571,52,白洪欢,2023-09-18 09:42:05,2,3,1,神仙老师神仙课，神仙才会爱的课
179696,52,白洪欢,2023-09-19 11:02:40,-2,1,3,选他就对了
180037,52,白洪欢,2023-09-20 07:27:26,4,6,2,blackwhite yyds
180064,52,白洪欢,2023-09-20 08:19:19,0,1,1,白老师很好的
180162,52,白洪欢,2023-09-20 12:12:10,0,1,1,有c基础就行，老师讲的信安真的非常nb，包括汇编的通识课特别有意思
180452,52,白洪欢,2023-09-21 16:34:47,1,3,2,无敌好老师，对小白巨友好，上他的课能很好学会使用电脑
180464,52,白洪欢,2023-09-22 00:40:17,8,12,4,民间黑客还会教技术 我直接爱死
180725,52,白洪欢,2023-09-25 11:11:43,21,24,3,白老师换win10了，爷青结
180783,52,白洪欢,2023-09-26 07:01:08,16,19,3,讲课、上机从来不点名，但是课上人也很满，虽然我一节课也没去。关键词：寝室，智云，2倍速。\n\n不点名，不卡绩，听课收获多，Q群夜里2点答疑，10分没商量。\n\n非常好C程课，爱来自瓷器。
182302,52,白洪欢,2023-11-14 09:45:08,0,4,4,十分好小白，爱来自大计基课上的计算机小白
183044,52,白洪欢,2023-11-22 00:26:08,1,3,2,讲课好 给分好 技术高
183223,52,白洪欢,2023-11-23 02:24:32,-5,2,7,爱死他了，给分也高
183228,52,白洪欢,2023-11-23 03:08:46,14,20,6,不了解老师上课和课下人品是什么样的，看评论先给个10分\n\n但是大计基是面向全校几乎所有新生的基础通识课程，我不知道小白老师录那些又臭又长又无声的常用软件和网络操作视频时，究竟有没有认真考虑过真正的电脑小白的接受能力和视频观感
183331,52,白洪欢,2023-11-24 01:47:11,-1,3,4,厉害的
183920,52,白洪欢,2023-12-03 17:47:53,4,9,5,小白老师的助教都是AAA队员 水平和人品都好得没得说~~
184742,52,白洪欢,2023-12-22 11:41:04,2,9,7,技术天才！简直是对于计算机无所不知！其高超的专业能力令我折服，授课态度认真负责，是不可多得的好老师
185009,52,白洪欢,2023-12-25 12:33:43,2,9,7,是大一目前遇到最喜欢的老师
185486,52,白洪欢,2023-12-30 11:51:15,6,15,9,老师人很不错，这点没问题，但这一学期的课上完以后，我想了想还是打8分而非10分。\n\n我上的通识课汇编，这门课本身的难度是不小的，又考虑到班上还有相当一部分大一学生或非信息类方向学生，学生学习困难程度可想而知。\n\n但老师从始至终展现出来的，从讲课风格到紧张的大作业ddl，都有一种对学生水平一无所知的美，上课所用的部分工具我也不好确定是否方便入门式学习，授课方式也非常传统，据说给分......也一般。一切能够体现出老师是一位比较守旧的人，倒是让我想起了我的一位专业课老师（尤其是二位老师的主页都有一种远古互联网时代的美），当然守旧不是缺点。\n\n本人暑假上过patt的计概，否则我现在对这门课也没什么底，当然拿白老师对比patt不够公道，但客观的说他们两个的授课能力在汇编基础入门这一块差距是很大的。\n\n或许老师的更多好评不是通过汇编这门课得到的，我只是指出一些我自己觉得存在的问题，老师整个人我感觉是非常不错的，比我遇到的80%以上的老师强多了，最后希望自己别挂
186161,52,白洪欢,2024-01-09 10:00:19,-13,27,40,黑入查老师网站修改自己评分第一人，真的玩不起，自己分为什么低心里没点数？还有你这么会改大计基题库是吧，你会个毛的出卷，考试到最后十分钟说要加时间，看到学生做不完知道加时间了啊，出你的鸟题的时候怎么想不到呢，纯纯JOKER。大计基上课教了什么心里没点数，不会出，就别出，以前是以前，现在是现在，ZJU第一果冻吸。
186170,52,白洪欢,2024-01-09 06:54:49,4,22,18,就是你改了大计基题型？\n\n有本事最后别延时十分钟啊？
186239,52,白洪欢,2024-01-10 03:55:35,7,40,33,无语，改你妈题库，还斩杀，把你妈斩杀了
186534,52,白洪欢,2024-01-14 13:17:22,54,83,29,【以下内容针对白老师】\n\n1. 要考Python完全可以在春夏学期的Python程序设计往深了考，要考编码原理完全可以单开一门课，把这些东西全挤在计算机“基础”这门课里难为刚入学的大一小朋友就是不合适。正如某朵友所说，“老师平时上课完全没有强化过学生去实操写代码，课后PTA上布置的题和考试也完全不是一个等级，花很多时间去讲了前两章。然后学生根本没有机会熟悉代码。如果想要考Python，课上应该增加学生的实操经验，或者至少应该引导学生去思考相关的一些问题。而不是单纯通过提升期未考难度去督促学生另找资源学习一一那听课的意义何在。”\n\n2. 您说“这次考试难度相对有一点，在我预料之中，但我们班的同学相比其他班的同学至少在课堂上是听过编码这些内容的”\n\n老师亲口承认了自己班级比其他班级教学内容丰富是吗？\n\n3. 您说“有些同学考不好不仅不反思自己技不如人的原因，反而认为考试内容与教学内容脱节导致自己考不好，难道只有考跟书上一模一样的内容才叫教考一致吗？”\n\n正如某朵友所说，“我承认大学生的自学能力和寻找学习资源的能力很重要，但我还是认为期末考更多是检验我对所学知识的掌握程度，而不是教考分离。”白老师是觉得大一小朋友认真听讲跟住课堂内容的思维习惯有错吗？所以通过这种形式告诉他们你一学期的辛勤学习最后考出来不如隔壁座位摇奖揺的比你好的？以后直接翘课自学？\n\n【致看到这条的大一小朋友】\n\n大计基这门课改彻底失败的通识课（走向终结也是它自作孽）不能决定你大学生活和以后人生走向的全部，就像在这次事件中这个傲慢、自我感动与自以为是的bhh也并不能代表那个讲台后面认真教书育人的bhh一样。不要因为这一次不合理的考试影响了你考试周的状态（没考大计基B的同学也不要慌，你现在能把握住的主要是Python语法的细枝末节和算法例题程序），更不要因为这区区一门课浇灭了你对大学教育模式的期待与认真踏实追逐知识的热情。
186716,52,白洪欢,2024-01-12 15:39:37,-10,19,29,没上他的课，也不知道他是谁，但我想骂他
186718,52,白洪欢,2024-01-12 15:58:02,9,20,11,我学大计基是什么很贱的人吗😅
186722,52,白洪欢,2024-01-12 18:33:04,4,14,10,死脑瓜
186733,52,白洪欢,2024-01-13 00:59:43,13,16,3,最后的大计基
186749,52,白洪欢,2024-01-13 02:37:53,11,17,6,大计基，呵呵
186775,52,白洪欢,2024-01-13 04:31:03,5,20,15,自我感动的典型
186783,52,白洪欢,2024-01-13 04:59:57,0,7,7,哈哈哈😁
186784,52,白洪欢,2024-01-13 05:02:47,28,45,17,如果我不想转专业的话还挺佩服你的，出卷质量是很高的，确实很有新意，大学就是要有这样的老师。\n\n但也注定了我是永远都做不完还空了几题的那一批受害者。\n\n不选技术的人终究是无能为力的，你这就是在靠选不选技术分层。\n\n除非你的学生清一色没有任何编程基础，那你这次考试，合情合理，给你10分，你就是厉害。\n\n但是呢因为这门课拉低了我的均绩甚至或许会让我挂科，你还欠我一个说法。
186802,52,白洪欢,2024-01-13 06:08:53,2,12,10,不顾我们死活
186803,52,白洪欢,2024-01-13 06:10:08,13,27,14,平衡一下，绩点不是大学的全部，知识才是。
186806,52,白洪欢,2024-01-13 06:13:46,-14,26,40,希望每一位23级学大计基A的同学们联合起来，让bhh不再祸害任何人，我们都有光明的未来
186807,52,白洪欢,2024-01-13 06:16:53,0,14,14,乱改大计基考试，深受其害
186812,52,白洪欢,2024-01-13 06:34:49,-6,14,20,明年没有大计基了所以把我们这届献祭来给课程陪葬了是吧？
186827,52,白洪欢,2024-01-13 08:02:36,-5,13,18,这大计基期末考的意义是什么？？？筛出运气更好的一批人吗
186839,52,白洪欢,2024-01-13 08:31:10,3,17,14,老师，我谢谢你，感谢你出了这么绝妙的一张卷子，让我对计算机更厌恶了，原来计算机基础=Python，我感觉我的复习就像一个笑话，我感觉我上课也像一个笑话，我就是个小丑。
186840,52,白洪欢,2024-01-13 08:31:17,-1,17,18,黑客控评控分是吧，出的什么玩意儿题，显摆自己那点破优越感！！！
186877,52,白洪欢,2024-01-14 00:59:22,14,39,25,还搁这自我陶醉呢，你不会觉得你期末卷出的很好吧，我来告诉你什么是优秀的试卷，优秀的试卷是既能让认真复习的人获得所应得的分数，又能让让学懂和理解这门知识的学生有一点区分度，而你这种把绝大多数学生压的喘不过气，让考前的认真复习变得毫无作用的试卷，我们一般把它称为沟史。
186904,52,白洪欢,2024-01-13 13:21:00,6,17,11,大计基卷子他出的啊...什么sb卷子
186984,52,白洪欢,2024-01-14 04:21:45,-38,29,67,黑入查老师网站修改自己评分第一人，真的玩不起，自己分为什么低心里没点数？还有你这么会改大计基题库是吧，你会个毛的出卷，考试到最后十分钟说要加时间，看到学生做不完知道加时间了啊，出你的鸟题的时候怎么想不到呢，纯纯JOKER。大计基上课教了什么心里没点数，不会出，就别出，以前是以前，现在是现在，ZJU第一果冻吸。
187151,52,白洪欢,2024-01-14 19:12:51,11,52,41,小白有30多年的教学经验，完全懂得怎么命题、怎么命好题，需要你们这群自命不凡的大一小屁孩来教？不就是只会机械地沿用高中学习方法，只会死记硬背所谓“题库”和“历年卷”，根本没理解编码和Python原理，一份试卷让你们原形毕露了而已，平时假装努力来这里骂老师算什么本事。你们不过是一群分数至上的乌合之众，“一场大计考试毁了我的高分梦”急了而已。
187257,52,白洪欢,2024-01-15 10:21:17,1,11,10,很好的老师
187332,52,白洪欢,2024-01-15 13:21:37,0,17,17,近期评分真是凸显出了什么叫造谣一张嘴。呵呵
187588,52,白洪欢,2024-01-16 16:38:50,9,12,3,。。。
187834,52,白洪欢,2024-01-17 14:13:11,14,45,31,有必要造谣吗，咱们客观评价，白老师没有做错任何事情。我是小白大计A的学生，白老师上课有独特的风格，但根本没有教考完全分离。白老师教的是原理，你自己听明白了考试题能看懂就会做（甚至考试题也给了原理教你怎么做）。我可以作证白老师辛辛苦苦出了题，在我们的答疑群里临近期末几周他都是两三点回前一天所有同学的问题。请问这样的付出又有多少老师能做到？他根本没有义务一定要出一份满意的卷子，一定要每天按时给我们答疑。另外，造谣白老师黑进平台更是可笑。白老师在上课时甚至开玩笑直观展示了他一些软件的历史使用记录，清清白白，都是连接控制自己的设备。\n\nBlackwhite，是黑客，但清白\n\n永远支持小白
187914,52,白洪欢,2024-01-17 19:57:19,10,36,26,大一新生闹麻了，小白都能被骂，怕不是只知道背考点刷题库拿高分，一点原理性的东西都不愿意掌握
188185,52,白洪欢,2024-01-18 11:11:14,-13,14,27,挺好的老师，但是对于那些对计算机不感兴趣又只想水课的人来说确实“恶心”
188289,52,白洪欢,2024-01-18 14:54:03,2,9,7,上课质量很高
188478,52,白洪欢,2024-01-19 05:15:42,39,54,15,总而言之，我自己大计基是好好学的，但是考试和教学根本不是一个东西，那些为出卷人辩解的人，要么是大二大三隔岸观火，要么是浙江选技术的薄纱全场。老师人或许很好我不知道也没必要知道，但是大一零基础就接受了不到50小时的计算机训练的小镇做题家真应该被大佬讽刺为不知变通吗？
188486,52,白洪欢,2024-01-19 05:30:54,20,30,10,但是有一说一 让其他班的同学怎么办 让高中没学过技术平时又努力学习的人怎么办\n\n真的别太荒谬 期末还不捞分 让想转专业的同学怎么办\n\nbhh真的谢谢你嘞
188519,52,白洪欢,2024-01-19 07:21:40,22,33,11,只说djjA期末这件事，就事论事这件事白老师办的就是不行，真的没必要洗白老师\n\n楼上说的很对，那些为出卷人辩解的人，要么是大二大三隔岸观火，要么是浙江选技术的薄纱全场\n\n他们是都觉得我们老师就是牛逼，我们老师讲了你们老师都没讲，你们就是活该\n\n难怪ZJU是养蛊的地方\n\n抱抱大家
188667,52,白洪欢,2024-01-19 13:28:56,6,13,7,有几条评论为什么被踩了那么多？不正常吧
188688,52,白洪欢,2024-01-19 14:29:50,18,26,8,自以为是的消愁\n\n还有，谁和你说高考教考分离的？？？？
188695,52,白洪欢,2024-01-19 14:59:23,10,21,11,djja，出题出的很难评，不评价了，但是对于评论区说什么不愿意掌握原理性知识的人，你们tm在叫什么，外省没学过技术的就应该死是吗，就学了几十个小时的什么东西你让我考这种sb试题吗，你以为哪个专业都很闲都可以学好这些课吗，sb闭嘴
188708,52,白洪欢,2024-01-19 15:44:01,10,11,1,汇编语言程序设计基础\n\n1. 非相关专业或无计算机基础（C语言）轻易不要来选这们通识课！！！\n\n2. 小白老师汇编水平，计算机水平很高！！！\n\n3. 小白老师上课很有个性，（前两节课是介绍，让你入门的，讲一讲破解，汇编程序等，不要看了很害怕就逃了），很多时候很跳脱，想到哪就讲到哪。\n\n4. 对于汇编语言程序设计基础：\n\n   - 分数构成：50%的期末考试PTA，50%的平时（5次小作业PTA+1次大作业---贪吃蛇）\n\n   - 要写代码！！！要听课（课比书重要，期末的很多选择题就在平时）！！！要回td调试\n\n5. 他出分很慢（1.10考的，1.19还没出分，急死我了）
188851,52,白洪欢,2024-01-20 09:16:26,15,26,11,大计基出的什么sb试卷
188866,52,白洪欢,2024-01-20 10:21:09,18,21,3,上的是汇编语言基础，djj的事不予评价\n\n老师教的很负责很认真，有编程基础的同学（c/c++比较熟练就没问题）会比较适合，但是没有的话会比较吃力。对于有编程基础的同学，实验部分其实不是很难，主要难的部分在于理论考试和最后的汇编语言写贪吃蛇的大作业（大致需要一天时间）。\n\n个人经历是上课有点小划水，实验部分是全对了，但是理论掌握的不是很好，但最后绩点还算不错（平时作业全交的）。如果理论想考得高一点的话，上课的时候对代码进行逐行分析的时候不要因为简单而走神，只是听听前半部分的话印象不会很深的。\n\n然后注意事项是这门课期末查重（包含历届提交），所以不要上网搜题进行cv，并且 不要随意将代码发给别人！（虽然白老师会调查原创是谁，不会直接给所有相同代码持有者一律0分，但终归总评会扣上1~2分）\n\n学得好的人很有可能满绩（最后满绩的人的个数还算多吧），给分还是不吝啬的，学不太明白的人就不知道给分咋样了。\n\n总而言之，课程有点难度，老师有水平，也十分严谨求真，有付出就会有相应的绩点。
189312,52,白洪欢,2024-01-23 05:26:22,-32,16,48,很好的老师，学不起来多从自己身上找找问题！！！
189381,52,白洪欢,2024-01-23 14:36:22,-2,9,11,有很多收获上课思路很好
189415,52,白洪欢,2024-01-24 03:40:48,14,22,8,楼下那个\n\n“很好的老师，学不起来多从自己身上找找问题！！！”\n\n更加印证了\n\n“他们是都觉得我们老师就是牛逼，我们老师讲了你们老师都没讲，你们就是活该”
189723,52,白洪欢,2024-01-27 15:02:24,3,8,5,呵呵呵
189781,52,白洪欢,2024-01-29 02:59:38,-31,30,61,【以下内容针对白老师】反正査老师的的评分他自己会改，所以啊\n\n1. 要考Python完全可以在春夏学期的Python程序设计往深了考，要考编码原理完全可以单开一门课，把这些东西全挤在计算机“基础”这门课里难为刚入学的大一小朋友就是不合适。正如某朵友所说，“老师平时上课完全没有强化过学生去实操写代码，课后PTA上布置的题和考试也完全不是一个等级，花很多时间去讲了前两章。然后学生根本没有机会熟悉代码。如果想要考Python，课上应该增加学生的实操经验，或者至少应该引导学生去思考相关的一些问题。而不是单纯通过提升期未考难度去督促学生另找资源学习一一那听课的意义何在。”\n\n2. 您说“这次考试难度相对有一点，在我预料之中，但我们班的同学相比其他班的同学至少在课堂上是听过编码这些内容的”\n\n老师亲口承认了自己班级比其他班级教学内容丰富是吗？\n\n3. 您说“有些同学考不好不仅不反思自己技不如人的原因，反而认为考试内容与教学内容脱节导致自己考不好，难道只有考跟书上一模一样的内容才叫教考一致吗？”\n\n正如某朵友所说，“我承认大学生的自学能力和寻找学习资源的能力很重要，但我还是认为期末考更多是检验我对所学知识的掌握程度，而不是教考分离。”白老师是觉得大一小朋友认真听讲跟住课堂内容的思维习惯有错吗？所以通过这种形式告诉他们你一学期的辛勤学习最后考出来不如隔壁座位摇奖揺的比你好的？以后直接翘课自学？
189997,52,白洪欢,2024-02-07 09:20:24,44,57,13,大计基那件事确实是白老师的锅，但是白老师的评分是历年计院学生的评价积攒起来的，白老师的水平大家有目共睹，整天说老师黑进网站改评分的什么居心？有情绪就可以瞎讲话就可以无中生有诽谤造谣是吧
190513,52,白洪欢,2024-03-06 13:06:44,13,16,3,实在是好老师，从他身上学到了很多。大计基的事不了解，但一个课程制度的问题不应该由一个老师来承担责任。
190812,52,白洪欢,2024-03-20 03:29:53,0,5,5,好 给分好
191588,52,白洪欢,2024-04-25 11:38:51,7,12,5,汇编语言程序设计基础\n\n反驳一下下面的同学，我觉得书比课重要。bhh老师不点名，平时课都旷了，考前看看书最后很轻松满了。bhh老师那本教材写的是真的不错。
191658,52,白洪欢,2024-04-27 04:19:30,3,9,6,c语言小测和期中一起考是人干的事？
191708,52,白洪欢,2024-04-28 14:22:58,-36,12,48,讲课垃圾\n\n给分垃圾
191926,52,白洪欢,2024-05-05 12:03:36,3,5,2,。。。
192360,52,白洪欢,2024-05-16 11:25:17,4,6,2,上课质量很高，非常用心，及其耐心，唯一缺点是讲得太慢了，过于细致，课外还得自己学不少。
193249,52,白洪欢,2024-06-05 05:43:56,6,7,1,上的汇编。他讲的确实挺好的，而且教学也很认真，虽然这门课确实比较难，每个作业都要写好久，今年汇编hw4是计算器，前后写了得有10h+。当然白老师依旧很好，10给到
194228,52,白洪欢,2024-06-22 16:44:28,1,4,3,白老师，神
196150,52,白洪欢,2024-07-02 01:09:50,-12,4,16,密码学不点名无小测无期中，平时作业简单（基本可以参考老师主页），最后考试只要复习了也很简单，就是讲课太慢而且方式太复古导致上课体验不太好，9.8肯定是严重过誉，但是8分还是有的
196395,52,白洪欢,2024-07-03 08:18:30,1,1,0,好捞，好捞，C讲课不错
196423,52,白洪欢,2024-07-03 09:27:56,-3,4,7,至少不是坏人
196798,52,白洪欢,2024-07-05 07:49:52,9,10,1,密码学这课还是建议少些造轮子的任务，少考些算法细节这种但凡开卷百分之一百不会错的东西，多讲些密码学思想，算法设计理念的内容。\n\n总的来说老师除了有些古板，讲课节奏太慢以外，挑不出什么缺点，问题主要集中在密码学这门课上，太无聊，和“密码学”这个课程名字相当不搭，适合改名叫“基于VC6.0实现各种密码学轮子”。
196844,52,白洪欢,2024-07-05 12:56:24,2,3,1,c小作业不算多，全是编程题，没有理论题（小测期中同）；上课比较散，补充的内容较多，建议先对照着书本自学一下基础知识；给分求是
196910,52,白洪欢,2024-07-06 01:20:15,8,9,1,密码学，不建议选。\n\n内容十分老旧，只是算法的实现，完全没有原理和设计的解释。给分不好不坏，期末理论之外的四道编程题要打开机房电脑上的xp虚拟机上的vc6编译运行……而且感觉这种题万一出点啥不适应环境的小bug爆零就直接寄。如果不是想卷高分或者某个模块差两分感觉没必要选（
197578,52,白洪欢,2024-07-20 04:37:58,-29,9,38,讨厌bhh
197690,52,白洪欢,2024-07-30 09:16:34,9,10,1,选了汇编语言程序设计 只能说老师人真的好得不得了 都来选
197693,52,白洪欢,2024-07-30 13:23:13,58,61,3,就凭没有“摧眉折腰事权贵”，汇编课没有迫于淫威昧着良心给所谓“计院之子”袁神打高分，就能给10分！
198628,52,白洪欢,2024-09-10 09:31:47,9,11,2,很好的老师，让我翻墙
198629,52,白洪欢,2024-09-10 09:32:15,16,18,2,教我翻墙，给你10分
198630,52,白洪欢,2024-09-10 09:32:46,11,11,0,老师你讲这个我就不困了
198634,52,白洪欢,2024-09-10 09:46:15,5,7,2,好课好课，老师课堂氛围好
198635,52,白洪欢,2024-09-10 09:46:19,2,3,1,白哥太帅了，我爱白哥
198636,52,白洪欢,2024-09-10 09:47:08,1,2,1,有如趣
198696,52,白洪欢,2024-09-11 03:12:44,-37,19,56,勾⑩。
198703,52,白洪欢,2024-09-11 04:23:49,6,8,2,挺好的。
198746,52,白洪欢,2024-09-11 08:35:12,7,14,7,白老师是一个非常好的老师，其自身的水平也是非常的高超，我在大一下选修了白老师的汇编语言，上课过程中我能感觉到白老师讲了很多干货，不过因为我自身的原因汇编学的并不好，再加上作为一门选修课我也很少将精力放在汇编上面，导致我的汇编语言平时分就丢了很多，期末考试的时候也考得很不好，不过白老师还是非常能捞人的，在这种情况下最后也让我过了，不过我还是感觉很对不起白老师没有好好学汇编语言，之后的学期如果有空余还要再选一遍白老师的课
199945,52,白洪欢,2024-10-09 04:29:51,13,19,6,全靠自学是吧
200912,52,白洪欢,2024-10-24 12:01:28,3,3,0,老师好好呀
201309,52,白洪欢,2024-10-31 11:34:35,4,8,4,白老师名不虚传。讲课清晰细致，人很有趣，作业不多，小测不难，上课体验很好。
201983,52,白洪欢,2024-11-08 02:48:01,19,20,1,才华横溢的黑客，浪漫纯粹的理想主义者
202724,52,白洪欢,2024-11-14 04:11:40,1,5,4,白老师真的教的好好啊
204562,52,白洪欢,2024-11-26 17:35:20,-6,6,12,怎么这么多刷分的
204767,52,白洪欢,2024-11-27 22:54:14,2,4,2,我想进三个尖战队😭
205193,52,白洪欢,2024-12-02 12:52:17,3,5,2,有c基础的选它小测会觉得很友好，基本编程无理论题
205276,52,白洪欢,2024-12-03 15:58:25,24,28,4,对于信竞选手和C语言基础雄厚的人来说，他是神；对于零基础的小白来说，他什么都不是。
205383,52,白洪欢,2024-12-05 09:11:12,-2,4,6,只有我觉得大c作业特别多吗？感觉起码有别的老师的三倍了（跟我室友的老师比较）
205443,52,白洪欢,2024-12-06 10:32:36,-21,18,39,纯纯有病真的，没事别选他，我严重怀疑他的分就是刷上去的，课讲得也不咋地，小测还喜欢搞那些乱七八糟的不考死你就不行的那种题，一个考试因为整个狗屁多文件编程题整的一堆人交不上去它就高兴了是吧，纯纯nt
205454,52,白洪欢,2024-12-06 13:13:17,9,12,3,很好的老师\n\n从不签到\n\n问问题从来有求必应\n\n但是上课确实难了点 我觉得是计算机类课的通病吧\n\n很喜欢他课间放的电影 还有超级有激情的讲课！！！\n\n老师很求是 学C语言确实要大量的练习吧（小测题难是真的）\n\n这学期微甲线代大英小测都炸了 希望C语言期末能给我一个惊喜吧
205457,52,白洪欢,2024-12-06 14:34:05,0,4,4,白老师课讲得很细致，很清楚，听您的课很享受。但是小测对于没有编程基础的我来说，拿分还是很困难，虽然每次有花大量时间去打磨作业，可是小测题目总还能让人猝不及防。如果你想学习真知灼见，欢迎选白老师。uhhhhh，继续为我的小测悲伤.......................
205466,52,白洪欢,2024-12-07 04:23:05,4,8,4,不会点名，但非常负责，有问必答，小测对我高中选考技术的还是比较友好的，不过听其他人反馈比较难
205915,52,白洪欢,2024-12-12 15:46:47,-13,9,22,本人浙江技选生，对于小测难度感觉是完全不如高考难，白老师对有编程基础的学生是很好的，小测不难，从不点名，但是我感觉问题就是课上讲的太细了，讲的很慢，而且没有PPT，要么自学要么你上课好好听，像我这种上课不怎么听的碰到理论题就gg了。总体来说我认为老师还是很好的，你有基础加认真学是很舒服的
205979,52,白洪欢,2024-12-13 02:37:12,7,11,4,我能感受到白老师是真的爱技术和教学，作业有不懂的他都会耐心讲解，也不像某些老师一样摆架子。基本上所有他的课我都上了，课上跟着他一起做，考试都没有什么问题。浙大可能只有他能讲逆向，和你自己上论坛自学的体验是完全不一样的，感兴趣的同学一定不要错过。
206459,52,白洪欢,2024-12-15 09:00:44,38,40,2,“实验补考没过的同学，建议仍旧参加理论考，虽然没分但长经验”
206592,52,白洪欢,2024-12-16 15:04:49,-35,10,45,c尖有基础的同学强推bhh\n\n小测只考编程，作业做一半就满分，从来不点名，0考勤分，完全是事少给分好\n\n除了第一节课没去上过课，但除了期末理论考的65分满了，虽然还没考理论但大概率是满绩了\n\n\n\n再次强推！！
206838,52,白洪欢,2025-01-18 11:12:37,10,14,4,C程序设计基础及实验\n\n课程分数构成：考勤5+作业20+小测25+实验考15+理论考35\n\n老师上课体验：白老师的平时分还是给的比较宽松的，不点名，作业写一半对就给满。老师上课也没有按照课本的顺序来讲，还是拓展了比较多的知识的，但是语速偏慢，听着容易走神，秋学期基本上伴随着概统作业和大物实验报告度过了他晚上的课。冬学期狠下心开始认真听课，边听课边做笔记，并最终完成了个人主页的笔记。整体应该算是一位不错的老师，但是我不建议没有计算机或C语言基础的同学来选择白洪欢老师，因为我觉得上课内容更适合有基础的同学，而且小测难度大。小测共4次，为编程题，在上机课完成，难度比别的老师要高，区分度还是比较大的，老师说大概只有1/3的人能完整做对两道题。\n\n课程学习体验：这门课最著名的就是实验考必须做对一题的斩杀线（今年有补考），所以PTA还是要多刷，尽量独立完成每次的作业，有能力的话可以刷一刷PAT的basic level的题。整体来讲实验考是有一道比较简单的，所以考试时不用特别担心。不过也需要认真准备，毕竟今年有不少人参加补考。理论考，其实挺没意义的……建议面向历年卷和教材的附录语法内容复习，理论考题型跟10-15这几年的历年卷大致重合，不用担心试卷太古老的问题。另，C语言自学资源也很丰富，翁恺老师的Mooc就是不错的资源，条理很清晰，也比较适合初学者。
206912,52,白洪欢,2025-01-14 01:34:27,-2,13,15,老师挺好的就是我期末考太差了捞都捞不了
207874,52,白洪欢,2024-12-24 16:46:03,8,9,1,9.8分委屈你了
208328,52,白洪欢,2024-12-27 01:55:28,6,7,1,上课放的电影好有青春感啊 有没有人知道是哪几部电影啊？
208656,52,白洪欢,2024-12-30 13:09:25,-7,7,14,不是很理解为什么那么热衷于多文件编程题\n\n还有就是，没基础并且对c语音兴趣不大的慎选
208800,52,白洪欢,2025-01-02 08:42:07,3,11,8,驳一下上一条评论，多文件是难了，但你就说是不是我们考试的范围？这么多道多文件做下来，最后要是还不会怎么交作业难道不是你自己问题吗？如果会怎么交，多文件题和普通编程题还有什么差别我请问了。\n\n还有白老师平时作业得一半分就给满，不点名，小测成绩不公布便于调分你是半句B话不提啊？\n\n再说慎选，我不选这课你帮我们转专业？
209332,52,白洪欢,2025-01-05 12:20:59,4,4,0,老师确实是好老师，问什么他都炒鸡乐于回答，顺带问一下上一楼，小测真的可以调分吗，小测是真的难啊
209691,52,白洪欢,2025-01-06 14:46:08,6,7,1,白老师真的很好很认真很负责，第一次接触c语言，觉得想我这样的编程白痴肯定会落后于那些有一定计算机基础，脑子又比我聪明的人，但白老师的课让我体会到c的有趣，让我有勇气一次又一次花上好几个小时去写一道题，让我彻底爱上c程，无论最后我的c是几分，小白老师都值得10分
210233,52,白洪欢,2025-01-08 13:12:52,2,2,0,三观很正的老师
210277,52,白洪欢,2025-01-08 16:06:28,7,12,5,我还是那句话，慎选，除非你是大佬，要不然他不适合你
210280,52,白洪欢,2025-01-08 16:43:39,2,5,3,2025年计算机科学基础A期末考试后\n\n看了一年前的评论\n\n为什么白老师班的就是教考不分离？为什么同一门课程的其他老师教学重点，作业和小测就没有放在编码上？白老师出题有没有只照顾本班学生的情况？\n\n对于其他班的学生来说，1.平常缺少教学和练习，2.浪费大量时间在记忆课本知识（我不是白老师班的，我看过部分白老师的智云，他的重点确实很少讲书本的基础知识），3.老师没有说明期末考试的重点，平时小测还在引导学生记忆基础知识\n\n而且为什么考Python部分的题目重复考查列表？复习大纲的Python基础只包含Python程序设计的第1，2章（详细介绍列表是在第3章，我们老师几乎没有讲，也是我看白老师智云的时候才感到奇怪的，为什么大篇幅在讲列表，而为什么你上课大篇幅讲列表，我们其他班的跟着考试也得考很多道列表？）\n\n在补白老师的智云的时候，我确实感到具体的编码方法更能体现计算机课程的意义，但为什么在去年有教学事故的情况下，今年其他开设计算机科学基础A课程的老师仍然在延续自己的教学方式，然而考试却是白老师的教学内容呢？为什么课程组做不到教学内容统一？这对白老师班级和非白老师班级的同学真的公平吗？
210306,52,白洪欢,2025-01-09 01:29:54,6,8,2,发表一下自己在上了bhh老师的汇编语言程序设计基础后的感受：\n\n1.对于汇编:汇编是真的难，自己每次写作业用的时间一般都是一个下午往上走，感觉如果没有一定基础最好不要学。\n\n2.对于老师:老师上课讲的很好，个人认为应该在认真听的情况下是可以听懂的(ps：选课时写的是两节课三节课单双周轮替，但我们上课是一直三节课，不知道是哪里出了问题，并且老师有几次拖了一会，所以只能说有时要注意自己录一会课，不能只指望智云)\n\n3.对于期末考:理论部分需要多翻翻教材理解不同语句的用法，不要像我考前就记住了写代码时常见的几个，导致期末理论就拿了46分。实验部分的话我感觉是比较简单的，如果平常作业认真完成大抵是没问题的，毕竟这个汇编基础基本没有教特别难的算法这些(来自浙江技术考生的看法，如果你觉得双层循环难，那你就当我没说过吧)\n\n4.对于大家可能比较关心的出分:我个人是每次作业都按时交了，奉劝大家不要拿AI或上网查，先不说AI写的经常有问题(不要问我怎么知道的，问就是我有一个朋友)，上网其实很难找，不要小看这个查重能力啊。本人是有一次作业其实写不出来，上网抄了一次，后面是在补交开放后又自己写了一次，不知道有多大影响。期末的理论刚刚提过，实验是拿满，最终绩点也是拿到了4.2，个人感觉已经不错了(本人其他科目一般在平均上下，只能说高考但凡发挥正常也来不了浙大)。\n\n5.对于这个科目的整体感受:如果你来学并且认真学，是真的可以学到很多并且对其他编程语言的学习也有帮助。但是比起其他的通识课，汇编真的花了我蛮多时间的。我是推荐对编程真的有兴趣的人可以体验一下，不过是想过来水的话还是赶紧跑吧(大佬除外，这门课bhh基本不点名。大佬们只要在期末薄纱我们就好了，而我们要考虑的就比较多了)。
210320,52,白洪欢,2025-01-09 02:09:02,-9,8,17,真的离谱，我自己是有C语言基础的，但是他正的太离谱了，跟着他学完全不行，他上的太慢了，其他班上链表的时候，我们班两个星期后才会上，而且文件题甚至是最后一节课才教的，还拖堂30多分钟。对学生的考试真的一点都不关心，其他老师会提前说注意事项，复习要点，如何应试等，他绝对不会。主角很有实力，但是都不上心，不认真。周围的人对他评价都是差，不理解查老师上评分到底为什么这么高！
210648,52,白洪欢,2025-01-09 14:28:48,3,4,1,上的白老师的c程，我听下来感觉老师讲得很好（但是有的地方可能讲的过于细，有的地方又一带而过？）高中从没接触过技术，0基础，也没有很仔细听课但坚持认真做作业还是能轻松跟上的（但是最后理论考全面崩盘了）
211342,52,白洪欢,2025-01-11 08:20:32,3,4,1,给十分但是确实小白老师更适合对c程原本就有基础的 因为补选的班少了一节课加上前面讲了很多其他老师不讲的东西，直到倒数第二周才讲链表，最后一周才讲文件并且拖了半个小时的课。老师也不会教很多应试方向的东西吧，，他应该更希望大家从编程中学到一些东西。最后梦一下c尖5.0 老师你快点出分吧
211444,52,白洪欢,2025-01-13 03:50:57,8,9,1,白老师，讲得细致，不点名，上课直接把说的打在屏幕上，教书行云流水，给分无敌好，9.8的评分还是低了
211572,52,白洪欢,2025-01-12 02:42:24,4,5,1,汇编语言这门课很不错，一学期正常学下来最后考前复习复习就拿了个很棒的绩点
211851,52,白洪欢,2025-01-12 17:08:38,2,2,0,民间黑客，很认真的老师
211889,52,白洪欢,2025-01-13 01:14:45,10,11,1,白老师简直海底捞啊，给分超级无敌好，本来一直担心挂科的事，结果成绩一查没想到这么高
211890,52,白洪欢,2025-01-13 01:14:51,6,10,4,bhh老师是捞神啊一学期每次小测只能拿一半的分，期末理论考前三天疯狂突击，之前一窍不通还是拿了91，感觉老师真的用心在捞了，平时讲得也很好，是我没基础听了也不会，，，
211905,52,白洪欢,2025-01-13 01:32:16,2,4,2,巨捞，给分好
211916,52,白洪欢,2025-01-13 01:47:42,8,10,2,我宣布2倍速bhh是真神。小测上机考，作业程序题，超氵的，虽然不利于理论考复习，但会给pta题库，所以不要紧。最喜欢晚上6点到教室先2倍速过完上次课再做pta最后拍拍屁股走人。讲课全脱稿，有情怀，放片子，除了拖堂会导致智云录不全之外，神。
211932,52,白洪欢,2025-01-13 02:07:29,1,3,2,很捞很捞啊，白老师真的很厉害！
211945,52,白洪欢,2025-01-13 02:33:08,4,6,2,c尖，虽然平时小测非常恶心作业也很难，并且由于平时注重编程而不是理论所以理论考相对比较困难，但是最后给分非常非常非常好，我愿称之为古希腊掌管捞人的神。白老师自己水平非常非常高同时也很亲切。虽然前期学得确实很吃力但是结果还是很满意的。
211964,52,白洪欢,2025-01-13 02:58:18,2,3,1,白洪欢，我的超人！
211972,52,白洪欢,2025-01-13 03:04:16,3,3,0,小白老师给分很好，海底捞，太爱了
211976,52,白洪欢,2025-01-13 03:19:29,5,6,1,白老师讲的速度相对比较慢（有可能是今年C尖补选的原因），而且也确实是着力于让大家学会编程思维而不是死记硬背课本的知识点。适合课后愿意下功夫学习课本的同学选。\n\n作业跟其他教学班比起来还是相对容易一些，对零基础同学比较友好。但是反过来说，如果零基础又不愿意自己复习的话可能就有很多知识点不会，不要这时候再反过来说老师不行，既要又要。\n\n白老实力很强，上课有干货有趣味，给分也有在捞，而且不点名。
211978,52,白洪欢,2025-01-13 09:19:35,1,5,4,C语言程序基础及实验 2024秋冬 说实话被卡绩了，老师注重原理，很不应试，高中没基础的跟着很吃力，看其他评论给分挺好，可惜我没感受到
212071,52,白洪欢,2025-01-13 06:46:44,-4,1,5,不多说，c大程之神，捞王之王，学不明白一点最后4.8，小白老师我爱你
212133,52,白洪欢,2025-01-13 08:45:18,-7,4,11,必须十分，事少给分好\n\n考完理论对完答案一直担心被卡绩94，结果出分99。感谢老师改卷捞捞了\n\n伟大无需多言
212148,52,白洪欢,2025-01-13 09:12:04,0,0,0,给分好
212281,52,白洪欢,2025-01-14 00:25:20,0,1,1,平时分捞满，bhh我爱你🥰🥰🥰
212464,52,白洪欢,2025-01-14 04:59:02,4,4,0,bbh是我爹，超级超级好啊。我真的一点C语言基础也没有，高中选了生物，为了转专业选了C大程，平时听课还是很认真的，白老师也讲的比较慢很清楚，就是平时小测对我来说稍微难了一点，但是基本上把pta保质保量完成了小测也还可以，就是第二次两道编程题有一道一点没做，一道没有全对，其他都是满分，但是期末实验考也是第二题没做对最后12，理论考行命令参数程序阅读题目全错，然后动态分配内存写错又失两分，本来以为要寄了，结果最后被捞到4.8，92分，真的白洪欢我爱你。没有基础的也不要被吓到真的给分超级超级好啊
212472,52,白洪欢,2025-01-14 05:06:07,4,4,0,白老师！！给分超级好！！海底捞！！超级好！！老师平时布置的作业较少，上课讲的拓展内容对于零基础同学也有点深奥，所以一定要认真准备考试，认真学习啊
212515,52,白洪欢,2025-01-14 06:10:03,0,0,0,老师很好，从不点名，上课不会按着书讲，有自己的思路，讲得很好，会打比方来解释，可能我实验考只做对了一题，所以最后成绩不是预期中的好，85分（捞到86也不是老师的义务，85分没挂科我已经非常满意了）
212858,52,白洪欢,2025-01-15 05:29:44,8,9,1,C尖这种课就是有基础的随便嘎嘎乱杀，以我没有基础的来看：\n\n给分应该算不错的，上课教的也很细致，但是不点名还是太香了（我基本没去过，全看智云的）后面过了机考后没认真学，以至于理论考准备没有很充分\n\n然而是c程这种课就是有先来后到，学过的嘻嘻笑，不会的很难受，还请大神们真要来赞叹白老师的水平高的时候，多给大家创造一点有用的价值与舆论，别把这里当做给你显摆绩点的地方
212923,52,白洪欢,2025-01-15 09:16:43,3,3,0,本人对计算机接触较少，但上白老师的课感觉他是一个很厉害的老师，平时也不点名，大计基讲的还是很清楚的，对初学者很友好。至于别的老师班上的同学提到的教考分离的问题，个人认为就是大计基这门课本身设计就不是很合理）最后白老师给分也很好，可惜没机会再上他其他课程了
212968,52,白洪欢,2025-01-15 11:06:29,3,4,1,讲的内容很细很深 而且不点名真的很爽\n\n但是有时候感觉知识点有点细碎 作业只有编程题所以期末理论可能要自己多下功夫 小测确实很难搞心态\n\n但是给分还挺好的！四次小测只有一次全对一次半对 两次都没有做出完全正确的一道 上机只对了一道 理论考感觉也很差 但是最后有83 感觉真的有捞了
213075,52,白洪欢,2025-01-16 02:45:08,5,8,3,大计基满了，上课讲的很清楚，考试内容编码这块也明确提过。关于别的班教考分离不过多评价
213113,52,白洪欢,2025-01-16 04:27:44,9,9,0,C小\n\n上课从不点名！吹爆！但我还是老老实实每节课都去了，而且都认真听了（因为本人不会一点C程）\n\n上课讲的很好，很细致，但我觉得学C程的话，身边还是有一个会C语言的朋友比较好，不然刚开头的时候是真的很痛苦，根本不理解为什么要这样写。\n\n之后慢慢入门了就好了，靠自己调试就可以解决大部分的问题了，剩下的问助教就够了。\n\n还有就是那个xp系统没必要搞...当时搞了我一个晚上结果一点用都没有...\n\n小测挺频繁的（三次），但是和其他考试都错开了，所以不算很忙，PTA的作业无论如何都要自己写出来，一定要靠自己，一定要学会调试，不然小测的时候会很绝望的，有人说小测很难，但是PTA认真写的话其实还可以。\n\n给分的话，应该是不错的（？）主要是我自己就把平时分、小测分拉满了，期末成绩动不了，所以我的成绩没什么参考性。\n\n最后，多看看bhh个人主页，有很多惊喜的，我当时看完之后对他的评价：一个纯粹的完美主义又倔强的人。
213252,52,白洪欢,2025-01-16 13:00:49,4,4,0,捞死了真，已泪目
213854,52,白洪欢,2025-01-20 13:08:21,2,3,1,可以可以还是需要靠点自学
214652,52,白洪欢,2025-02-16 00:09:09,2,3,1,白老师很好，但是上的真的太慢了，比其他班慢了两三个星期，选他的课的同学一定要注意自己往下学，不然期末根本根本来不及。但总的来说还是可选的
214897,52,白洪欢,2025-02-19 03:23:01,1,1,0,特别特别好！
214984,52,白洪欢,2025-02-19 15:59:45,-4,9,13,也就唬一唬外专业的同学了，教的东西至少落后时代20年，就那么固执不愿意接受新的技术吗
215023,52,白洪欢,2025-02-20 05:53:20,2,2,0,小白老师
215479,52,白洪欢,2025-02-26 15:31:09,4,7,3,不点名但是给分不好，只适合有基础的人听，教考分离严重
216492,52,白洪欢,2025-03-17 09:49:52,3,3,0,白老师算是我在浙大最崇拜的老师之一，实验考差点挂科，补考才过，但是最后白老师还是给了一个不错的分数。而且白老师上课从不局限于课本，喜欢拓展很多有意思对知识，讲课也很细致
216606,52,白洪欢,2025-03-19 05:55:50,14,14,0,他真的好爱看电影
219002,52,白洪欢,2025-05-31 13:16:19,9,10,1,密码学的lab很难，且环境非常老旧难以配置，需要消耗大量时间，个人觉得不值得。我非常后悔选了密码学。\n\n不信的同学可以去cc98上搜一下“密码学”，看看多少个求助贴。你也不想半夜写lab写不出来，助教也帮不到你，到最后只能去98发帖问吧\n\n所有密码学的作业是统一的。不要看着课表上有个空位就手贱想选这个课，这个课是真的崩溃\n\n--------------------\n\n并且白孝子很多，你看那个说菜就多练的就知道了。
219043,52,白洪欢,2025-05-20 01:37:17,-8,1,9,下面的，菜就多练。计院的都知道小白的课很硬核，如果为了刷分刷绩点，学院里也有那么多水课，没必要来上
219543,52,白洪欢,2025-05-29 12:35:27,1,1,0,密码学今年难度骤增，老师的初心是好的，但在这几年优绩主义和事少分高的选课原则下这门选修课过几年可能没什么人敢上了
220020,52,白洪欢,2025-06-13 13:35:03,4,4,0,逆天密码学，这辈子最后悔选的课，这学期lab快要到是往年lab的两倍数量了，难度还加大，一次作业写15h真是扫码了，最蠢的是期末考试周前几天还布置一个作业。期末考试还要考，自己课每次拖十分钟还没上完，甚至还录了个一个半小时的网课作为作业说明。选密码学的这辈子有了
32924,144,姚青,2016-08-03 17:41:47,-10,6,16,绩杀不推荐
47867,144,姚青,2017-02-26 14:43:21,2,3,1,还不错吧
53147,144,姚青,2017-06-26 04:59:32,11,13,2,老师助教人很好，平时分只看点名和学生手册，考试给分也很不错。
53171,144,姚青,2017-06-26 06:18:21,2,8,6,形策嘛大家都不听啦，很温柔的老师，上课很细致。事少，点名一两次，一次课堂小作业就一道题，也不拖堂。助教姐姐人很好啊，出分4.5很满足啦
53172,144,姚青,2017-06-26 06:22:59,3,4,1,很好的老师，耐心随和，还有点幽默。
53243,144,姚青,2017-06-26 08:47:22,3,4,1,老师讲的很好很认真细致 给分也好
53285,144,姚青,2017-06-26 09:51:21,3,5,2,讲得还好 给分真的高\n\n
54393,144,姚青,2017-06-29 08:50:15,0,0,0,666
63762,144,姚青,2017-12-14 06:17:15,6,6,0,助教好烦啊……
83893,144,姚青,2018-07-11 12:52:41,9,9,0,给分不好...考试背了很多，大题都会，小组还展示了，还是没上4
83896,144,姚青,2018-07-11 13:01:16,6,8,2,助教给分太差\n\n
83901,144,姚青,2018-07-11 13:09:42,8,8,0,老师人不错，但是这个助教有点事多，最后又卡绩点，不知道说什么好。
83902,144,姚青,2018-07-11 13:11:35,8,8,0,我只是来评个分，莫名其妙最后很低
83998,144,姚青,2018-07-11 16:31:59,4,5,1,给分好差，所以是助教的锅？
84012,144,姚青,2018-07-11 18:38:55,-6,3,9,老师给分真的很好 老师人也很好 非常感谢！
84520,144,姚青,2018-07-13 04:50:13,7,7,0,事多给分不高，室友的形策什么都不用搞都是4+，我这个要展示有论文还有小测……给分巨坑
91559,144,姚青,2018-12-13 08:05:11,8,9,1,姚老师很温柔，特别有气质。讲课也不错，助教感觉一副正派作风。总体来说，还是可以的。
91897,144,姚青,2018-12-24 13:24:07,-5,1,6,打100分，10分给老师，剩下的0给助教，骂人的话我就不说了。
110111,144,姚青,2019-06-23 08:03:25,0,0,0,挺好的挺好的\n\n
111856,144,姚青,2019-07-03 01:20:18,2,2,0,展示也展示了，论文也写了，考试也写得很多，3有点过分了，室友其他老师展示论文什么都没有4.5，很不公平诶
111876,144,姚青,2019-07-03 01:49:30,2,2,0,一无是处
111952,144,姚青,2019-07-03 04:15:00,1,1,0,垃圾老师，给分很差
111954,144,姚青,2019-07-03 04:19:06,1,1,0,可以去当高中老师，要不欺不住人。
112249,144,姚青,2019-07-04 00:08:29,0,0,0,诡异的小组大作业。寒假都回家过年了，还让我们小组共同写一个关于某一个组员家乡的2W字调研报告。都回家去了，怎么搞在一个家乡搞调研呀。最后只能瞎扯弄出个学术垃圾。。。不过老师很有气质，这个真的很喜欢。但是b事是真的多！
114086,144,姚青,2019-07-08 19:00:15,0,0,0,老师很有气质，温温柔柔的，助教也很认真qwq
114087,144,姚青,2019-07-08 19:00:38,0,0,0,老师很有气质，温温柔柔的，助教也很认真qwq
114861,144,姚青,2019-08-06 09:43:49,1,1,0,考试卷子写满=2.7
307,158,李明,2015-03-15 00:36:51,10,14,4,讲述非常不清晰，知识点传授模糊，很多问题讲不清楚
1656,158,李明,2015-03-23 06:48:50,31,34,3,知识点讲不清楚，题目也讲不清楚，经常在一道题上花太多的时间，总之差评
1762,158,李明,2015-03-24 05:45:44,11,17,6,讲课一点都不清楚，有时他自己都搞不清楚。但是上课气氛很自由，我的思维可以完全不受限制。只能说，这个老师只适合特定的学生。想不劳而获的就不要选他了。
3232,158,李明,2015-07-09 02:27:57,34,36,2,讲课速度一节堪比六节强。他可以培养大家的自学能力，可怜我还是C大程吴春明班的。。唉！名字里带明的老师真是极品。。然而下学期还有个王跃明orz
6773,158,李明,2015-07-23 01:38:07,1,1,0,听不太懂…
22918,158,李明,2016-03-15 00:00:36,8,8,0,呵呵呵
25894,158,李明,2016-06-14 00:21:01,3,3,0,呵呵呵
26240,158,李明,2016-06-16 10:58:51,1,2,1,老师人还是挺好的，经常让同学去思考讨论。就是。。经常点名。。。orz
32098,158,李明,2016-07-05 15:23:55,2,3,1,为什么没有0分
32118,158,李明,2016-07-05 16:03:22,-1,0,1,嗯嗯呢
48053,158,李明,2017-02-28 07:01:29,-11,6,17,我就要打10分
48055,158,李明,2017-02-28 07:25:46,6,7,1,不知所云\n\n
49019,158,李明,2017-03-21 15:13:20,6,10,4,怎么说呢，老师除了讲课不太清晰，作业比较多，给分还是不错的，人也很和蔼，嗯。。。推荐喜欢自学的同学去选。
49090,158,李明,2017-05-04 00:40:10,8,9,1,点名之王
49215,158,李明,2017-03-30 00:20:42,5,5,0,呵呵呵
51074,158,李明,2017-05-16 06:21:03,11,11,0,他估计自己都不明白自己讲的是什么
51190,158,李明,2017-07-04 13:52:31,11,11,0,人挺好吧。但是别指望听他的课了，全靠自学。离散这课期末还是很水的，但是给分很低。
51648,158,李明,2017-06-08 02:54:22,2,2,0,！？?\n\n
51870,158,李明,2017-06-13 04:48:50,4,4,0,点名之王不解释
56740,158,李明,2017-07-04 13:21:09,9,9,0,哎，我怎么会在这个班#
56807,158,李明,2017-07-04 16:02:31,11,11,0,传说中的点名之王绝不是吹的 学期初的时候说什么就点三次名 到期中前就用完了三次...接着照样点名 还是那种早课一来就点名 要是还没来下课去补还要扣分 上课速度一节更比六节强 然而不知道到底在讲什么 只会说就是这么个意思 然而并讲不出到底是个什么意思 上课要点人回答问题 不过坐后面点基本不会被叫到 给的quiz还是比较友好的 每次作业要抽样打分的 我第一次就乱搞了然后给了低分 从最后的给分来看 应该是没有调过分的
58096,158,李明,2017-07-30 06:36:28,-4,5,9,老师人真的很好，很善良，课不是老师讲不明白是确实不好学，并不是他的错，很负责，极好的老师\n\n
59625,158,李明,2017-09-25 03:45:56,7,7,0,上课就有一种看着老师现场翻译 ppt 的感觉
64425,158,李明,2017-12-23 12:41:41,-4,2,6,人很好
64426,158,李明,2017-12-23 12:41:30,-4,2,6,老师人挺不错的
64427,158,李明,2018-03-07 07:55:29,-2,3,5,挺好的
73128,158,李明,2018-02-01 03:24:30,-1,4,5,老师人很好的
75077,158,李明,2018-03-07 08:35:05,2,3,1,...
75083,158,李明,2018-03-07 09:05:55,9,9,0,自己讲的自己都听不懂
75630,158,李明,2018-03-14 08:55:33,9,9,0,您先做好备课好吗。
80136,158,李明,2018-06-20 12:02:28,6,10,4,刚开始的时候确实觉得想打0分，但后来慢慢发现其实还行。班上同学的状态很重要，如果班上气氛活跃，你能跟着他思路走，并不会有什么太费劲的，虽然说他有时候自己也不知道自己在讲什么，但经过活跃同学的提醒和postive reinforcement，你还是能把离散学的很好的。如果先戴上了反感的有色眼镜，那你很难再对他的课堂有任何兴趣，这和个人有关。老师人还是很和蔼的，跟我也比较熟，没讲清楚自己下课再看看书也挺好。我通过快一个学期的观察，至少给7分吧！
84730,158,李明,2018-07-13 15:57:54,0,3,3,总有同学上课插入老师讲课内容来补全……感觉这种强行占用资源好自私啊……问的问题也不太过脑子……不过老师讲得确实不太好……主要是在逻辑上有些乱……当然完全自学看课件看网上博客也是没有问题的，离散这门课偏向概念，并且关键词中文名起得都还可以。所以不用太担心啦～～这门课所有的问题都是概念问题请自行翻书查阅（在做作业的时候顺便画一下书就好了）\n\n作业确实略多
84842,158,李明,2018-07-14 04:28:16,7,9,2,实话实说，老师可能上课确实有些讲的不是很好，但他人真的很好，也知道自己讲的不好，会停下来想同学们寻求反馈，会关注到每个同学的提问，也会在课后耐心回答，也会听取同学们的意见。emmm不过老师备课确实不是很充分。嗯还是希望选上这门课的同学能不要抱有成见，能投入这门课，离散这课也就这样吧，都是概念性的东西。
92809,158,李明,2019-01-04 14:18:04,0,1,1,以一己之力拉低了软工的绩点
106956,158,李明,2019-04-30 11:57:57,2,2,0,从拓扑结构优化为引子，讲了一节课线性方程组求解方法，克莱姆法则，高斯消去…深入浅出?深入浅出啊……
107603,158,李明,2019-05-07 12:39:59,-2,1,3,博士生应用数学课\n\n人挺好的，但是讲课逻辑有些不着边际，倘若事先仔细备课我觉得就会好很多的。\n\n\n\n总体还是能听到一些东西的\n\n\n\n其实一节课能让我们彻底听懂一个算法对于我们都是有极大帮助的
109702,158,李明,2019-06-18 13:43:43,3,4,1,他并不懂自己讲的东西，PPT还抄别人的
133484,158,李明,2021-06-22 00:58:55,0,2,2,老师还是负责任的，只是备课不太充分吧，害
133839,158,李明,2021-03-08 02:31:46,3,4,1,无语子，建议自学
134059,158,李明,2021-03-14 14:27:35,1,1,0,哎 无语
136714,158,李明,2021-06-23 09:26:30,1,2,1,他除了知识点有时候讲不清以外，其他方面做的都挺好。其实还是可以选他的课的。
139642,158,李明,2021-07-19 02:12:34,-21,3,24,大一春夏离散数学理论基础，客观公正地来打个9分。\n\n李明老师人真的很好，很负责任，但上课多少有点干货不足。不过离散这门课本身很简单，全靠自己看书和做题也能学得明白。平时注意一下各种概念和英文名词，考试基本就不会有什么问题。\n\n点名也没有评论里说的那么过分，偶尔会点但不多，甚至经常是被同学们催着点名Σ（ﾟдﾟlll）。从给分来看少到一次两次问题不会太大，但作业和小测一定要记得交。\n\n关于给分我其实觉得还蛮不错的，大多数人小测成绩不怎么好看，应该是调低了这一方面的占比。明确在群里说了没有挂科，应该是捞了低分段的人，但80以上应该基本给的就是原分。但还是那句话，课程内容很简单，认真复习再加考试细心一点的话上90不是不可能。\n\n感觉比查老师里往年评论好了不少，如果预置到了也别担心，可以放心去上的。
146661,158,李明,2022-01-07 07:20:11,15,15,0,千万别选，讲的不清不楚，期末题难，经常点名，给分也烂\n\n普通人别选，大佬可以无视。离散很简单？下面那个自己很厉害但请不要误导别人好吧
151521,158,李明,2022-03-07 00:12:39,25,27,2,老师您比我们还摆烂啊，摆烂我能理解，但您摆烂还恶心我们就很令人难受了
151522,158,李明,2022-03-07 00:32:50,25,26,1,不知道上课在干什么。宣称要三周讲完，然后让我们自己一个周末把书看完😅
151523,158,李明,2022-03-07 01:04:49,15,16,1,又摆烂又恶心人，我真大无语了，上课让大家花十分钟把书看一遍，好好的课变成导论的导论课，自己什么都不会讲，呵呵
151530,158,李明,2022-03-07 09:07:51,0,8,8,客观说一句，教学理念可以理解，教学能力不太跟得上，且不太有实际操作性。\n\n花半个周末把他要求的几章过了一遍并且串了一下逻辑，感觉还是有收获的，至少对要学的东西结构比较清楚了。但是这种模式比较适合自学，上课再花时间重复讲就有点水了。而且现实决定很多人不会去看书，并且不适应需要沟通的课堂（包括我本人），所以上课效果不好。\n\n为什么说一个周末预习有可行性，因为离散教的东西多且散且很多是已经学过的，所以实际去理一下大纲对大家学习还是有帮助的。\n\n感觉很多人情绪都很激动，并且骂老师摆烂什么的…我觉得他是认真在备课和上课的。这门课的问题也不止出在老师身上，教材教学大纲教学内容感觉都有问题，在我看来这些内容本来也不太容易教好，因为太多学过的东西了，而且书上的又讲的比较浅。老师的确提供了一种有效的学习方式，只能说个人学习方式和教学方式不能等同，希望理性看待吧。
151600,158,李明,2022-03-09 02:50:20,9,9,0,我不知道他哪来的自信
151833,158,李明,2022-03-17 03:35:11,10,10,0,给老师打个同情分 这课程完美展现了高中和大学教育的衔接之烂 课程设计之sb 以及学院教学水平\n建议我校好好搞教学
153321,158,李明,2022-04-28 03:47:00,31,31,0,离散课见过学生翘课，老师翘课头一次
158745,158,李明,2022-07-01 23:32:06,6,6,0,老师教的也不是很好，给分也很低
160262,158,李明,2022-09-16 03:02:50,14,15,1,别选，cad push pua之王，摆烂王，为什么会有这样的老师？
160391,158,李明,2022-09-21 06:31:19,27,28,1,CAD第一坑导
178297,158,李明,2023-07-09 15:46:51,42,42,0,文庭，我查老师评分怎么这么低？
178727,158,李明,2023-07-20 11:54:28,-3,0,3,lm离散课最显著的优点估计就是到课率高了，二十几个人的班偶尔有一个人没来，隔壁zwt班瑟瑟发抖
190835,158,李明,2024-03-21 01:36:04,8,8,0,听他的课就是一种折磨，听1个半小时跟没听一样，自己都不会叫同学回答自己，结果别人的回答都听不懂，课上经常点人回答问题
191593,158,李明,2024-04-25 14:36:08,11,11,0,老师你就直说吧，你还有哪里不懂的赶紧问我们
195196,158,李明,2024-06-27 06:26:30,7,7,0,考完了，来打个1分...\n\n这学期全班一共8个人，所以根本不用点名...\n\n只能说快逃...快逃...
197266,158,李明,2024-07-10 03:52:43,9,9,0,赤石去吧
221176,158,李明,2025-06-21 22:35:02,-1,0,1,老师的ppt其实做的还是比较用心的，重要的知识点与考点都会涉及，平时分还是会小捞一下的
221624,158,李明,2025-06-25 04:12:40,1,1,0,狗屎，已读不回。\n\n热爱点名。\n\n素质极差。
222087,158,李明,2025-06-29 14:02:24,0,0,0,shit of shit\n\n快逃
23628,172,王章野,2016-04-11 04:08:01,17,20,3,可以把软工课上成人工智能课和毛概课。实验课当理论课上。
48916,172,王章野,2017-03-16 07:43:51,11,13,2,因为不上实验课 两节的理论要上三节 这还可以算是合乎道理。然而中间休息也没有，居然还要拖课？？别的老师90分钟讲完的内容，要讲160分钟？
75351,172,王章野,2018-03-09 05:06:51,10,10,0,老师的普通话是经过离散化处理的，听不明白orz
80585,172,王章野,2018-06-28 05:34:39,8,8,0,鸡蛋里挑骨头小能手，偶像乔布斯，自己英文不怎么好却执着于让你用英文答题。
80691,172,王章野,2018-06-29 09:50:54,11,12,1,原定2点05的课提早到1点15。好吧，你说实验课不用上补在理论课。然后就各种找理由提早到12点半乃至更早，什么展示要提早啦，做quiz要提早啦。课及其无聊，只能通过给分来激励学生答题，然而还是没多少人回答。问的问题诸如有，啥啥单词怎么翻。该老师还及其缺乏常识，最后大程展示，我组大组长用linux电脑展示，该老师把linux侧边栏当做我们大程教务网的侧边栏，实乃滑天下之大稽，这样的老师竟然都能教计算机，服了。
82508,172,王章野,2018-07-08 11:20:12,10,10,0,软工考试前一夜，除了绝望，还是绝望
104406,172,王章野,2019-03-20 00:55:41,2,6,4,老师非常热情，就是提早上课
105980,172,王章野,2019-04-24 03:13:40,3,3,0,上课突然quiz
110312,172,王章野,2019-06-25 13:17:35,5,5,0,感觉这个老师是来搞笑的
111894,172,王章野,2019-07-03 02:17:54,5,5,0,不知所云 不知所以然，\n\n这辈子都不想再见。\n\n非必修的孩子慎选，毕竟知识和成绩一无所获
114439,172,王章野,2019-07-10 03:04:17,4,4,0,老师有一点点迷
134083,172,王章野,2021-03-15 08:12:20,12,12,0,《关于我只想写一个字但是系统要求三个字所以我打了这么多字这件事》\n\n烦
134701,172,王章野,2021-04-21 14:28:20,41,54,13,快逃快逃快逃快逃快逃快逃快逃快逃快逃快逃快逃快逃快逃快逃快逃快逃快逃快逃快逃快逃快逃快逃快逃快逃快逃快逃快逃快逃快逃快逃快逃快逃快逃快逃快逃快逃快逃快逃快逃快逃快逃快逃快逃快逃快逃快逃快逃快逃快逃快逃快逃快逃快逃快逃快逃快逃快逃快逃快逃快逃快逃快逃快逃快逃快逃快逃快逃快逃快逃快逃快逃快逃快逃快逃快逃快逃快逃快逃快逃快逃快逃快逃快逃快逃快逃快逃快逃快逃快逃快逃快逃快逃快逃快逃快逃快逃快逃快逃快逃快逃快逃快逃快逃快逃快逃快逃快逃快逃快逃快逃快逃快逃快逃快逃快逃快逃快逃快逃快逃快逃快逃快逃快逃快逃快逃快逃快逃快逃快逃快逃快逃快逃快逃快逃快逃快逃快逃快逃快逃快逃快逃快逃快逃快逃快逃快逃快逃快逃快逃快逃快逃快逃快逃快逃快逃快逃快逃快逃快逃快逃快逃快逃快逃快逃快逃快逃快逃快逃快逃快逃快逃快逃快逃快逃快逃快逃快逃快逃快逃快逃快逃快逃快逃快逃快逃快逃快逃快逃快逃快逃快逃快逃快逃快逃快逃快逃快逃快逃快逃快逃快逃快逃快逃快逃快逃快逃快逃快逃快逃快逃快逃快逃快逃快逃快逃快逃快逃快逃快逃快逃快逃快逃快逃快逃快逃快逃快逃快逃快逃快逃快逃快逃快逃快逃快逃快逃快逃快逃快逃快逃快逃快逃快逃快逃快逃快逃快逃快逃快逃快逃快逃快逃快逃快逃快逃快逃快逃快逃快逃快逃快逃快逃快逃快逃快逃快逃快逃快逃快逃快逃快逃快逃快逃快逃快逃快逃快逃快逃快逃快逃快逃快逃快逃快逃快逃快逃快逃快逃快逃快逃快逃快逃快逃快逃快逃快逃快逃快逃快逃快逃快逃快逃快逃快逃快逃快逃快逃快逃快逃快逃快逃快逃快逃快逃快逃快逃快逃快逃快逃快逃快逃快逃快逃快逃快逃快逃快逃快逃快逃快逃快逃快逃快逃快逃快逃快逃快逃快逃快逃快逃快逃
134712,172,王章野,2021-04-11 16:21:45,19,21,2,快逃，老师屁都不懂，一大组二十人水成一片，实验课别的班不上他要上，而且还特别没营养。搞一些无聊的提问，对于大作业的要求也很不合理，要求布置下去不关心学生反馈，车轱辘话十级老油条\n\n\n\n\n\n（建议隔壁邓水光，六人一组，责任到人
134853,172,王章野,2021-04-24 23:51:23,26,28,2,我认为，这样的老师全乎可以被看作是计院的耻辱
134864,172,王章野,2021-04-27 07:57:47,46,54,8,谢谢老师让我知道我对软件工程完全没有兴趣\n\n4/27增加部分 细数wzy十大罪状\n\n1.不在上课时间上课：提前一个半小时又延后一个半小时，而且还是星期日的实验课，内容就是同学展示？\n\n2.推诿责任：作为老师一周讲课一周给同学讲，最离谱的是同学讲的比他好，没有比较就没有差距\n\n3.作业布置不合理：这是软件工程这门课的通病，但能把作业布置得毫无意义还给这么短的ddl我只能说wzy独一档\n\n4.分数组成不合理：讨论这一块太好混分了，同时有些优秀的同学也未必能拿到好成绩（容易被队友坑），参考其他班用签到计分我觉得公平多了（不过yjw除外，这老师听说出尔反尔，在我室友的分数没还回来前建议也不要选\n\n5.打断别人说话：同学展示很喜欢打断别人，尤其是报时间，以前我去辩论的时候计时就是用铃铛提醒，清楚又不干扰发言，怎么没有人给他这个建议，他这样打断别人真的很不礼貌\n\n6.自以为是：明明叫大家提早来上课已经很多人不开心了，还说出：“这是法定的课程时间请大家不要请假或缺席”这种蜜汁发言，这老师没有一点自知之明，情商为0\n\n7.对助教要求多：建议学长姐不要给这老师当助教，否则每次理论课和实验课都要去，去了还常常就像个花瓶啥用没有，偶尔老师问你几个问题你嗯几声，不如自己去搞点什么，真的\n\n8.用分数威胁学生：作为学生我们都知道分数对我们的重要性，有时候为了分数我们还会干一些我们自己都不想干的sb事，这老师拿分数威胁我们做的sb事比我这两年半干过最sb的事还要sb，除了“合法”一无是处\n\n9.课程安排离谱：什么课都要上，上了什么都收获不到，唯一学会的就是怎么写文档，建议这门课不要叫软件工程了，叫软件文档编辑还比较契合点，毕竟这是我学到唯一有用的东西了，其他东西出了社会都是另一套规则\n\n10.毫无人性：综合前9点所陈述，归纳整理后我的到这4个字
134867,172,王章野,2021-04-19 13:56:05,20,20,0,无用工作非常多。实验课要求到，要求所有同学预习、做PPT、准备展示。上课前随机抽人讲课，老师的作用就是做些无关痛痒的点评。什么都没学到而且很心累。老师讲课讲得不好我可以打5分，但是他连课都不讲，还拼命给同学增加工作量，1分都太多了。
134954,172,王章野,2021-04-25 06:41:21,20,26,6,如果一定要在“法定”实验课上课，占用大家的法定周末课外时间，麻烦请讲一些有意义的内容吧。
134955,172,王章野,2021-04-25 03:01:20,15,15,0,提早上课又拖堂，很累。。。
134957,172,王章野,2021-04-25 04:35:39,22,31,9,时间吸血鬼，免费增加上课时间，不收一分钱，很良心呢!也不讲很重要的东西和听得懂的东西，给学生轻松学习的氛围!上课一半同学讲，增进同学友谊!
134958,172,王章野,2021-04-25 04:36:15,24,25,1,什么辣鸡老师，自己啥也不会，英文读的是个der，上课要学生上，工资自己拿。周日9.50的课要求学生8.30到，上到接近1点！展示现场抽人，根本不给准备时间，怎么想的？提出的问题更是离谱，根本就是听不懂展示小组的发言，给5分钟的展示时间要求把万字的报告讲清楚，可能吗？别选，别选，别选！快逃，快逃，快逃！
134959,172,王章野,2021-04-25 13:10:48,11,13,2,王章野成功的让我知道了软工>>>3*毛概
134960,172,王章野,2021-04-25 05:55:09,14,14,0,周日上课4h，真有你的
134973,172,王章野,2021-04-25 12:47:16,14,14,0,快逃快逃快逃，已经被搞得通宵到凌晨，最怕两三点钟软工微信群里来一句“同学们，....收到请回复”，还没毕业就要接受这样的开发压力吗。而且这个老师真情实感地让我开始怀疑自己的理解和表达能力了。
134974,172,王章野,2021-04-25 12:52:55,13,13,0,一周前的wzy：（实验课）这是法定的上课时间，大家一定要来，不来的要交假条\n\n这周的wzy：（实验课）这周课提前一个半小时上课，不来扣小组分\n\n用法定上课时间绑架学生，又用小组分威胁学生在非法定上课时间来上课的wzy是屑
134975,172,王章野,2021-04-25 12:53:39,10,10,0,绝了【微笑】
134976,172,王章野,2021-04-25 12:58:04,5,5,0,...
134979,172,王章野,2021-04-25 13:25:03,21,23,2,助教就已经够离谱了，之前实验课老师让大家必须去，自己不在，助教也不说干啥，一直在玩手机。\n\n老师就更离谱了，周日上午实验课拿来展示，2节课上了四个小时。\n\n最离谱的是，20个小组轮着展示，有个别人每个组展示完都有问题要问？？？（这么看，虽然老师确实是蠢，但是展示了四个小时也不全是因为老师doge）
134980,172,王章野,2021-04-25 13:26:42,9,9,0,这老师还不如放个研究生助教在这，起码助教看完展示不会乱提问题
134987,172,王章野,2021-04-26 04:05:41,11,11,0,完全绝了，周末实验课上成了四小时的理论课？？？？提前到一个半小时，再拖堂一个半小时。。。
134988,172,王章野,2021-04-26 04:15:41,6,6,0,兄弟们快跑
134989,172,王章野,2021-04-26 04:41:07,3,4,1,。。。。
134990,172,王章野,2021-05-10 06:15:40,14,14,0,报告给的修改意见明显看出没认真阅读过报告
134993,172,王章野,2021-04-26 06:35:48,15,15,0,众所周知，星期天是法定上课时间。王老师的课不能不来，王老师的课前课后也别想跑。星期天必须拿出六分之一的时间来上我王老师的软件工程
135010,172,王章野,2021-04-26 19:56:00,7,7,0,背后的原因令人暖心🤡
135116,172,王章野,2021-05-01 04:38:05,24,24,0,老师你知道同学是怎么评价你的吗？你认为同学们尊敬你吗？你的家人接受过你吗？你的研究生真的快乐吗？你认为你的课程对学生的发展有帮助吗？你认为我们叫你老师合适吗？
135431,172,王章野,2021-05-10 09:13:55,6,6,0,快逃快逃快逃
135587,172,王章野,2021-05-15 15:29:52,11,11,0,明天早八speech之前再来骂一骂wzysb
135588,172,王章野,2021-05-16 00:32:17,8,8,0,快逃快逃
135589,172,王章野,2021-05-16 01:04:08,13,13,0,没想到他在周末把一个半小时的上机课改成四个小时的展示课居然是因为不知道自己的课该上多长时间
135590,172,王章野,2021-05-16 02:07:07,11,11,0,周日上课上好上满，学费交的很值得。。。。。
135591,172,王章野,2021-05-16 02:27:13,12,12,0,傻逼一个
135592,172,王章野,2021-05-16 02:28:09,19,19,0,“浪费一百多个人的宝贵时间，是很不道德的”\n\n——著名呼吸家王章野
135593,172,王章野,2021-05-16 05:22:44,10,10,0,揣着明白装糊涂是吧 怎么没见过你星期一一点五十过来上课
135627,172,王章野,2021-05-17 08:20:01,8,8,0,快逃~逃~
135628,172,王章野,2021-06-07 08:03:21,21,21,0,臭弟弟！\n\n为什么我大学上的倒数第二门课是这个样子的
135717,172,王章野,2021-05-20 14:07:28,9,10,1,课是下午上的，人是晚上走的
135732,172,王章野,2021-05-22 06:55:54,10,10,0,低情商： 啥b\n高情商： 低情商说的对
135838,172,王章野,2021-05-28 16:30:21,7,11,4,说助教离谱的那个评论，不知道脑子是不是有什么大病，助教就一打工的学姐，给王老师做助教已经很辛苦了，还是头一回看到吐槽吐到助教头上的。
135977,172,王章野,2021-06-28 08:25:41,41,56,15,大三本就很疲累，天降奇兵王章野。上课甩锅给同学，下课验收真的绝。周日早八来展示，下午给他办sang事。醉卧沙场君莫笑，老师助教该吃药。\n\n后记：xbhdl别秀了，你比wzy还nb
136114,172,王章野,2021-06-11 04:11:31,6,6,0,大程展示鸡蛋里挑骨头，还是挑哺乳类动物的骨头。\n\n我向我叫过来一起上软工组队的同学道歉，上他的课真的是种折磨
136726,172,王章野,2021-06-23 12:36:51,6,6,0,极其浪费别人时间
137028,172,王章野,2021-06-29 14:00:43,11,11,0,我点赞都点不过来了
137133,172,王章野,2021-07-01 11:13:58,14,14,0,野蟑王
138160,172,王章野,2021-07-07 15:26:44,12,12,0,经典复刻：考试前一夜，除了绝望还是绝望\n\n小丑🤡竟是我自己
138164,172,王章野,2021-07-07 16:17:59,7,7,0,考试前一晚 除了绝望就是绝望
138197,172,王章野,2021-07-08 01:32:44,10,14,4,怎么说，看他在交卷时会帮学生一个一个检查信息，倒也没那么讨厌他，他应该确实对课程上了心，可能这个老师最大的错误就是太喜欢把自己的那套方式拿出来死抠，尤其是验收大程时对着项目一个点一个点非常仔细地扣，然而这种东西真的很死板
138766,172,王章野,2021-07-10 17:29:33,12,12,0,查老师的均绩怕不是假的，给分巨坑勿选
138767,172,王章野,2021-07-10 17:32:46,12,12,0,呵呵…真行啊这个分数
138775,172,王章野,2021-07-10 22:24:27,10,10,0,就这平时干的事和最后给的分 洗不白了
138810,172,王章野,2021-07-11 03:17:57,27,27,0,两个字：快逃。\n\n总结：事情超级超级多，给分超级差\n\n一学期：三个quiz，三个presentation，一个大程序，四个报告，周日早上去上课\n\n如果你不怕事多\n\n如果你不怕绩点低\n\n如果你时间多\n\n那么，勇士，你选吧！
138811,172,王章野,2021-07-11 03:25:25,37,37,0,我来查老师只为了三件事：骂王章野，骂王章野，还是TM的骂王章野
138816,172,王章野,2021-07-11 04:19:50,18,18,0,花了很多时间，最后只有3的绩点，认真复习认真做了大作业，就这，大家慎重！
138847,172,王章野,2021-07-11 07:37:16,132,137,5,《谏王七策》\n\n	\n\n不才从王师而学软工，时近半载，颇有感。宁斗胆，献言七策，以报王师。\n\n\n\n一、书时书\n\n古人云，宇宙万行皆有道，鸟兽依日之东升西落，草木顺时随春夏秋冬，师授者亦然。应书时书之，合规制，依道也，学生自当随师之号，无敢非者。\n\n\n\n二、守己任\n\n诸生来学，多乃曲知，识见浅薄，此时令徒自学以述知，多妄塞之言也，无及师之半良。王师可勿吝其智，多示诸生，亦守师之任。\n\n\n\n三、业布正\n\n人之一生，须臾也，以学之时，恨短也。古有庄子云：“吾生也有涯，而知也无涯，以有涯随无涯，殆已”。 不必之事可为减，要之业可益细之，布业为弟子能有获，非以成己之事。\n\n\n\n四、明规律\n\n若一律不载于书，则百姓不必从之。常有限生之法，未见明言，事发得罪，实令弟子之不枉及无奈。请师可以例预公言，则弟子无不从之。\n\n\n\n五、耐人言\n\n古之大事者，常有能听言之美。专闻人言，常有所得。折人之言，急持其说，谓人不重，急出之言亦不为所尊。不才目中，王师应乃大事者。\n\n\n\n六、晓变通\n\n万物皆新，故事常不时。就一事常有多法，或法简，或法难。常之下，可变法，使事简，临之事，王师不必直守其旧者也。\n\n\n\n六、礼下士\n\n甘心为师事者，必贵慕王师。诸弊之事，不宜遂授徒治。己所不欲，为之为何？每见王师之佐亦临迫，何难不至是以师又使其成不善之事。\n\n\n\n七、约以法\n\n徒之为非者，须制约，然制宜有理之诛，而非其罪皆归为扣其功绩。又一人之过常加诸数人，此又与株连九族何异？一人过，惩一人，罚有理，无累他。\n\n\n\n不才深知此谏僭矣徒之分，然“士有争友，则身不离于令名;父有争子，则身不陷于不义。故当不义，则子不可以不争于父，臣不可以不争于君，故当不义则争之。从父之令，又焉得为孝乎”不才以王师为吾之友，故献策于此，已无憾矣。
138859,172,王章野,2021-07-11 10:02:53,9,9,0,怎么说呢？当出成绩之后钉钉群里连一个谢谢老师都没有~~~
138862,172,王章野,2021-07-11 10:48:10,6,6,0,傻孩子们 快跑啊
138864,172,王章野,2021-07-11 11:03:45,9,9,0,直接对着你来一段优美的c语言
138866,172,王章野,2021-07-11 11:40:58,6,6,0,见了鬼了
138913,172,王章野,2021-07-11 17:49:28,11,11,0,低情商：《十罪》\n\n高情商：《七策》\n\n中情商：《坐牢》
140351,172,王章野,2021-09-10 02:58:39,10,12,2,教师节回访环节，yue
151952,172,王章野,2022-03-21 14:47:39,6,6,0,乐色老师，屁事特多，讲课稀烂，要求离奇，不切实际
154327,172,王章野,2022-05-30 09:06:23,1,2,1,一共就十个人选了他的课 十个倒霉蛋
154851,172,王章野,2022-06-24 09:57:43,1,2,1,事情很多，最后给分还行吧
155078,172,王章野,2022-06-08 05:43:35,10,14,4,给分超好！！！\n\n吹爆！\n\n我不知道你们满没满，反正👴满了
158582,172,王章野,2022-06-30 10:20:53,2,2,0,给分很香
158787,172,王章野,2022-07-02 07:09:38,1,1,0,给分还行
158913,172,王章野,2022-07-03 08:18:07,6,6,0,没听过，单纯刘玉生太差了，enemy's enemies are friends. 我是纯纯小丑
158982,172,王章野,2022-07-04 07:42:13,2,2,0,再怎么样也比刘玉生好多了
159004,172,王章野,2022-07-04 11:05:42,2,2,0,比刘玉生小丑好太多了
159042,172,王章野,2022-07-05 03:45:19,0,0,0,对比一下lys和wzy\n\nwzy事多，但是给分厚道\n\nlys事少，但是给分乐色
172284,172,王章野,2023-04-24 09:48:11,2,2,0,爱拖课，纯垃圾
174219,172,王章野,2023-06-12 03:43:22,14,14,0,垃圾中的垃圾，翻转课堂是吧😅就你逆天大project搞元宇宙是吧，一看就是拍屁股想出来的屑，根本没考虑过可行性，也没有任何文档，和其他班中规中矩的前后端网页简直逆天😅建议快跑，谁tm爱选你这个b\n\n-------------\n\n听完了验收，这个B是啥也不懂，真的啥也不懂
174413,172,王章野,2023-06-12 04:47:41,2,2,0,肚子里没啥东西，只会指点江山。
174414,172,王章野,2023-06-12 04:48:17,3,3,0,一眼顶针，纯纯sb
174415,172,王章野,2023-06-12 04:51:44,2,2,0,见过的最xx的老师，真的很没用。
174828,172,王章野,2023-06-18 14:58:01,7,7,0,我给你一千万投资
175160,172,王章野,2023-06-22 04:54:11,0,0,0,比较抽象
175581,172,王章野,2023-06-25 15:17:55,0,0,0,考前一天，小丑
177575,172,王章野,2023-07-04 17:06:34,-5,2,7,虽然讲课垃圾，翻转课堂，还出分慢，大程屁事多，但是期末大题全部集中在考前告诉学生还算良心。\n\n7.5补，给分巨良心，期末就学了一天，直接4.2
177765,172,王章野,2023-07-04 17:00:43,-4,2,6,事是真的多，给分是真的好
177798,172,王章野,2023-07-05 02:12:19,5,5,0,事情非常多 给分非常差 平时分比别的班低很多 别信评论的！！ 他们平时分高只是个例
178376,172,王章野,2023-07-11 06:01:55,0,0,0,说实话，给分真没前几年说的那么好，尤其今年听说lys给分也不错的情况下。\n\n另外这个作业量和折磨程度真不如搞搞别的课，宁愿分低一些，虽然分也不高。
195667,172,王章野,2024-06-29 10:36:16,1,1,0,三个老师加起来评分不到4\n\n这 就 是 软 工
196481,172,王章野,2024-07-03 17:05:17,2,2,0,年少不知章野好，错把邹强当成宝
196513,172,王章野,2024-07-04 01:30:45,2,2,0,wzy今年是神中神\n\n事情不像以前那样，算比较少\n\n一次名都没点过\n\n平时分几乎给满\n\n而且有quiz，这个quiz对期末考试帮助很大\n\n还会仔细讲解最后的画图题，帮助很大，你还可以问他你画的对不对，王老师会给你纠正，因为有的细节有时候自己看不出来的\n\n考试时候coupound condition一堆人不太清楚，都以为那个条件没用，其实不对，coupound contition默认有两个判断条件，需要拆分，王老师上课讲得很清楚\n\n总之这学期的wzy就是软工之神！！
197031,172,王章野,2024-07-06 23:33:12,0,0,0,小组内四个满绩😂🤒剩下一个不知道
216590,172,王章野,2025-03-19 02:36:28,16,16,0,上课天天 六小龙 马云马化腾的念 和他蝶一样 要求要求说不明白 天天说车轱辘话然后拖堂 这课真的能学到东西吗
218119,172,王章野,2025-04-21 08:52:12,16,16,0,不是哥们，怎么就你事这么多啊
218120,172,王章野,2025-04-21 09:18:32,14,14,0,好饿，暴雨
218121,172,王章野,2025-04-28 04:00:48,18,18,0,4.21 五点五十下课的课 自己能说出我们预计七点二十结束 不喷的也是神人了 什么傻逼\n\n4.28 补充 中间没下课 按理说十一点半已经下课了 他掏出小测说我们来做一个半小时的小测吧 无敌了
218129,172,王章野,2025-04-21 10:48:55,12,12,0,4.21 你没事吧？没事多吃溜溜梅\n\n事情巨多，这个设计演讲讲到19:00也是没谁了。就没活硬问，问为什么验证要选邮件验证码，这种水平也能当老师也是绝了。你倒是给我钱备案发短信？
218134,172,王章野,2025-04-21 13:08:53,16,16,0,这byd在每个小组展示完就来一句“怎么不拿女同学的照片来用，我们班的女同学长的还是很不错的”
218642,172,王章野,2025-04-28 03:09:02,5,5,0,纯逆天吧，上课拖堂拖麻了，天天提lwf，六小龙，别gb蹭了行不行，好好讲你的课
218680,172,王章野,2025-04-28 16:28:54,4,4,0,节节课拖堂，上课一天天念叨你那b六小龙梁文峰，你要不要听听自己都讲的些什么玩意😅
218897,172,王章野,2025-05-12 04:50:11,8,8,0,有没有懂电脑的IT大神？为什么十一点三十五下课的课，但是现在显示屏上显示十二点四十五？
219017,172,王章野,2025-05-19 03:33:46,4,4,0,真傻逼吧，服了，真觉得自己讲课讲的有什么东西吗？一点都不愿意用自己上课的时间，一定要拖到下课了再验收，真nb，所有教学班里面p事最多
221048,172,王章野,2025-06-21 04:21:12,3,4,1,一个很typical的自以为是的老教师，上课东拉西扯吹浙大吹自己早年见闻，经常毫无歉意地拖堂。但是有四个优点：一是助教人很好，二是整个班timeline很提前，大作业展示和提交比其他班早一到两周，期末复习时间多一点，三是开卷小测，为什么是优点呢？因为期末全年级都会指着他的小测复习。四是人还算善良，最后交卷会一道道小题数，怕我们落下题
221881,172,王章野,2025-06-27 05:28:58,6,6,0,平时分能给的比期末还低，真是nb了啊
221922,172,王章野,2025-06-27 12:08:33,5,5,0,神人老师，事多分差，平时分给的非常随机而且方差非常大，辛苦干活可能平时分80-。还好今年助教人好还帮大家说话尽量，在自己能捞的范围内捞了，要是助教没帮忙我不敢想平时分会有多低。
29067,190,董玮,2016-06-29 08:05:06,3,6,3,讲课烂，给分低
78882,190,董玮,2018-05-16 06:40:24,-4,1,5,字数字数字数
87735,190,董玮,2018-10-11 02:54:10,-3,2,5,上课好催眠嘤嘤嘤，人还是和蔼的
91616,190,董玮,2018-12-16 05:17:10,6,11,5,计网实验 取我性命
93156,190,董玮,2019-01-07 17:17:10,1,2,1,很强，但讲课烂，给分低
93157,190,董玮,2019-01-07 17:20:41,4,6,2,上课是真的听不懂，真 的 听 不 懂。\n\n实验是真的做不来，真 的 做 不 来。\n\n他的计网让我怀疑我的智商，但是我发现我不是一个人，全班都是这样?\n\n摊手
95720,190,董玮,2019-01-20 03:00:02,4,6,2,如果你预置了他的课，你有打算出国或保研的话，建议你先退掉\n\n如果你不在意绩点，当我前面没说\n\n
96040,190,董玮,2019-01-20 11:56:02,5,7,2,讲课真的没法听…实验做了一堆但是考试挑着你没做的考？？？
99844,190,董玮,2019-01-25 08:19:33,6,9,3,教的特别差，讲课催眠，毫无条理，可是自我感觉良好？最后的期末，考了一个上课也没讲平常也没布置的实验，仅仅在考前发了一个文档说让我们自己看看，可能会考？坑！
99847,190,董玮,2019-01-25 08:22:32,7,9,2,听过来人一句，不是大佬不要选\n\n讲课很差，给分更差，实验繁重，然后考试是从没教过的大实验题20分，要取所有人狗命
99925,190,董玮,2019-01-25 21:25:52,3,6,3,上大学一来唯一一个让我想骂娘的老师。我记他一辈子。
99999,190,董玮,2019-01-25 12:16:42,4,7,3,"复习课老师说让我们自己去看一看BGP的资料的时候，我是一脸懵逼的？我是这个班的吗？还是我少做了一个实验？\n\n当时心里还不相信课程组会这么""迷""，让完全没有做过BGP的一整个班考这个。。\n\n然后就真的考了。\n\n心里默念""傻逼课程组""然后原地爆炸。。\n\n不知道该说什么。。\n\n虽然菜，但是7个实验，每个实验都是自己花时间一点点做完的。然后考尼玛这么个玩意儿？\n\nBGP？我会填个ip，真是开心死了呢！"
100118,190,董玮,2019-01-25 15:18:32,4,6,2,给分极差 讲课飞快稀烂 两周一个可以磨人一整天的实验 交完一个另一个就来了 比隔壁班还多了个展示 然后展示完问一些莫名其妙的问题来找茬 然后毫不负责任 你说你没做过BGP你也和其他老师商量下能不能换一个 这么多实验就这么难选 一来甩手一个word说这个可能会考 顺便吐槽下大题填空占试卷60分是想取所有人狗命吗 但相反我觉得老师是非常有B数的 不然也不会最后一节课把第一道题几乎原原本本地漏出来 可能是想要卷面分追上隔壁班的最后尝试吧
100162,190,董玮,2019-01-25 16:21:42,-8,3,11,老师很棒，上课负责，教的也很好
102464,190,董玮,2019-02-03 02:22:07,3,4,1,差评，辛辛苦苦一学期最后成绩不如在隔壁老师班水水过
117495,190,董玮,2019-09-25 05:56:31,2,2,0,老师很和蔼
124282,190,董玮,2020-06-28 12:12:10,1,3,2,老师相当认真负责，人很好，这次线上课程少做了一次应用层的实验，压力稍微少一些。关于老师绩杀的这个问题，我并没有感觉到（虽然我被卡绩了😣）。
154424,190,董玮,2022-06-01 07:26:42,2,2,0,人和蔼，但是笑里藏刀。\n\n\n\n他自己认为对的事情基本不可能说服他，即使这个事是错的。\n\n\n\n其他的倒还好，给一分可能有些刻薄，但真的配不上高分
180248,190,董玮,2023-09-21 08:21:39,2,2,0,我觉得好的，讲课认真，每个知识点也会讲解习题帮助理解。有一年考试考了平时实验没有的内容，后来再没出现过这样情况。
181452,190,董玮,2023-10-18 06:17:14,2,2,0,好惨一老师，第一周还有五个学生，到第二周只剩一个了
190308,190,董玮,2024-02-28 00:36:23,17,18,1,上学期我是董老师计网上课时唯一的学生。虽然很辛苦，但也没有很难，最后更是得了满绩，十分感谢。
201529,190,董玮,2024-11-04 06:12:32,2,2,0,物联网，2024秋第一次开。\n\n讲课比较无聊，念ppt，但该讲的也都讲了，最后一节课划了重点。问题是考完就是不按原分原比例折算，瞎改占比把大家分数都调低是不是有冰？这么喜欢调低分数那我给你1分调低一下你cls均分。
201860,190,董玮,2024-11-13 03:45:25,1,1,0,dw+gy，调分领域大神\n\n看着我的成绩从91变成89变成88到现在直接给我盖上了，真的是难绷\n\n正式出分了回来更新一手，看看会不会更低\n\n11.13更新：才发现出分了，按原分折算的\n\n希望二位老师以后无论上哪门课，都要保持这个风格。
2898,218,徐从富,2015-05-10 14:52:33,17,36,19,真正的开拓视野，提升思维层次的教师。
26804,218,徐从富,2016-06-21 06:47:48,-1,6,7,很棒的
33798,218,徐从富,2016-11-09 06:35:55,-9,3,12,老师说他很仁慈，坐等出分
34071,218,徐从富,2018-12-21 00:38:57,4,6,2,云里雾里\n\n
34657,218,徐从富,2016-11-18 03:52:06,8,12,4,大一表示绩点伤不起
34720,218,徐从富,2016-10-19 08:21:05,12,13,1,老师讲的有些太高端，大一听不懂啊。
35630,218,徐从富,2016-11-21 03:28:39,4,11,7,老师打分是按等级的所以你要好绩点比较难的，但是老师人真的很好的，很负责，什么课只要你自己愿意认真听认真学都可以学到东西。不要抱着太高期待，你以为上个几节课就能对AI有多深了解吗？不是这门课，什么课都不能。老师以后好像也不上了，反正就我而言，老师是很称职的。
36070,218,徐从富,2016-11-18 03:30:23,20,32,12,(´･_･`)人工智能初步，大一很吃亏，大家可以先不选，只有不多的?点，默默哭泣
36345,218,徐从富,2016-11-12 05:12:35,1,3,2,老师人很好，就是讲课听不太懂，有时候会说到其他地方。
37224,218,徐从富,2016-11-18 02:59:55,-3,3,6,很棒的老师，真的能学到很多东西
37238,218,徐从富,2016-11-18 03:50:05,13,18,5,人工智能初步是按等级打分的！！！\n\n只有优秀良好及格！！\n\n和通核算分一样啊啊啊
37239,218,徐从富,2018-12-21 02:07:56,7,12,5,活生生把一门计算机类通识上成了文科➕炒房课 期末考的感觉和考高中政治一样一样的
37242,218,徐从富,2016-11-18 04:05:00,11,17,6,讲课内容对大一来说太过深奥，但考试不是很难。讲课有时会扯。虽然开课时说给分高，但实际绝对是绩杀
37266,218,徐从富,2016-11-18 06:13:40,5,8,3,计科的表示什么都没学到。。。被这门通识的名字忽悠了。。。给分还不好
37271,218,徐从富,2018-12-21 00:20:43,5,9,4,表面仁慈，实际绩杀....慎重啊
37291,218,徐从富,2016-11-18 08:17:08,0,4,4,也许老师很好，但是你要先想想自己能不能接受。反正如果不想对人工智能失望，大一就不要选了。\n\n
37307,218,徐从富,2016-11-18 09:12:43,4,5,1,老师人还可以，但是上课实在是……总之大一慎选，绩杀。
37342,218,徐从富,2016-11-18 11:18:29,3,4,1,老师人很好，考试开卷抄课件。不过大一选的话会比较吃亏，表示很多听不懂，以为会挂科，但最后给的绩点还好。
37344,218,徐从富,2016-11-18 11:38:01,-5,2,7,给分很好啊(不要什么基础，感觉考试很简单，完全抄课件)读书报告最好读专业性较好的论文
38414,218,徐从富,2016-12-03 09:33:50,3,3,0,听不懂
43578,218,徐从富,2017-01-16 14:46:16,2,3,1,我就笑笑
57946,218,徐从富,2017-07-18 09:27:56,-2,1,3,非常开心，讲解到位
60378,218,徐从富,2018-12-21 04:38:04,0,2,2,本来上课单看课件可以看懂的，但他的话在旁边简直就是噪音，还老是跳转PPT，而按着他的思路听课的话......excuse me？他讲课有思路？
61737,218,徐从富,2018-12-21 04:37:01,1,7,6,谁选谁怀孕
61918,218,徐从富,2017-11-21 16:53:49,2,7,5,老师人特别特别好！特别可爱！这门课虽然知识看起来难一些，但考试真心不难！对人工智能感兴趣就大胆选吧~
62920,218,徐从富,2017-11-27 10:59:24,10,13,3,强烈不建议大一对人工智能啥都不懂只是感兴趣的学生选这门课，真的绩杀啊！！！！老师第一节课说你们就算一节课都不听也能及格，结果我真的及格了，还获得了1.5的高绩。：）
63133,218,徐从富,2018-12-21 02:07:31,-3,6,9,傻逼 垃圾 绩杀
64164,218,徐从富,2017-12-21 06:47:28,4,5,1,他不点名
64838,218,徐从富,2017-12-27 11:10:44,0,1,1,我是17大一的，表示上课很难听懂，一堆偏导数概率论的公式。
66507,218,徐从富,2018-01-17 05:14:53,8,9,1,我是大一选的 课上大多数都是大一的 最后好几个大一的绩点四点五 老师挺不错的 但讲课内容确实是大部分听不太懂 最后的考试是开卷 唯一的难点就是计算 但如果你弄懂了课件上的例题就完全能做出来 总的来说 大一不是不能选 但是大二选可能会好一点
68420,218,徐从富,2018-12-21 00:20:04,1,3,2,我的绩点本来可以很体面，如果我不选这门课
74721,218,徐从富,2018-12-20 23:52:28,-4,0,4,老师上课很随意，学不学来不来都随便。评分也只有一篇读书报告和期末开卷考。对于没什么基础的同学，上课内容可能有些不懂，但考试绝对不是问题。至于说绩杀的，我并没有感觉到。水了一学期也是良好3.5。很满意了。想开阔视野选这门课还是不错的。至于相关专业的，我就不乱说了。
81645,218,徐从富,2018-07-05 16:07:26,2,2,0,给分是真的低，其他还好
84969,218,徐从富,2018-12-21 00:16:33,-2,1,3,我大一秋学期选的这门课，没翘过课，绩点1.5，到现在，这门课把我的绩点活活往下拽了差不多0.2，真的很难受，大一付出了很多努力才慢慢把绩点拉上去。。。
86023,218,徐从富,2018-08-27 08:10:11,2,2,0,学校是对优的数量有规定的。整体是不超过20%的优，不超过50%的良以上。
91805,218,徐从富,2018-12-21 02:06:21,3,3,0,秋季开学前两次课是试听的，老师会一再提醒大家，若是听过不适合你，果断退选，因为人数多少无关紧要，关键是你是否真心想学这个课程。今天AI火热，不代表它以后一直火。这个课就是给大家开阔视野、指明方向的，不能奢望通过的短短秋季学期，你就成为AI专家。
118316,218,徐从富,2019-10-24 16:01:28,5,6,1,拜托…这个老师人真的超好的好吗？虽然大一上很多都听不懂，但是态度很和善也会开开玩笑举例子尽量让你听懂啊！考试也是开卷的。你真的不知道自己查查文献问问老师读读书不行吗？自己啥都不会也不主动说老师不好…我无语
119372,218,徐从富,2019-11-12 10:56:57,2,2,0,老师人真的很好，考试也尽力出的很简单了，但是感觉内容对标研究生课程，只不过去掉了算法只剩绪论了。总之老师人真的很棒，但是学到多少要看自己
120132,218,徐从富,2019-11-17 22:54:13,2,3,1,拿了优秀 开心
120144,218,徐从富,2019-11-18 00:01:13,0,2,2,老师人很好，平易近人。上课是听不懂的，老师口音还重，说话很含糊，大多数人也没在听。说? 杀主要是因为五分制，拿不到4.5就3.5往下了。
140210,218,徐从富,2021-09-05 04:05:46,4,4,0,有没有同学说说这课现在还是不是五级制啊
143368,218,徐从富,2021-11-24 07:32:26,22,25,3,首先我是21级的，消息会比较新\n\n首先你可以忽略那些等级评分的评论了，老师已经改掉了\n\n我是大一的，但绩点不错\n\n老师的人品无可挑剔，因为自己家孩子挂科之后确实会体谅学生，期末考26分的人总分没挂科\n\n但是老师第一节课就会告诉你，不要以为这是个水课，你要是一直划水的话期末确实会一头雾水\n\n10%是回答问题和上课签到分。去了就有\n\n50%是期末考试。开卷，时间也很充裕，甚至同意了让忘带资料的同学现场打印。只要你把他的ptt都打印下来并且平时听了一点大概知道什么知识点在哪个ppt里，考个八九十还是很简单的\n\n40%是大作业，读论文报告或者人工智能相关的代码。建议后者，哪怕你不怎么会编程，大概写一写（尽量不止一个）并且会用github大作业就不会差\n\n总之，如果你真的没有兴趣或者在编程思维上一窍不通，那么别选。否则，做好要学习的准备咯
151203,218,徐从富,2022-02-24 12:11:20,0,0,0,上的老师的研究生课，老师对教学挺上心的，也很尊重学生，仅就研究生课而言事情少不点名，给分也很好
176863,218,徐从富,2023-06-30 12:34:54,-9,1,10,逆天老师逆天助教逆天学生😅，铁三角cp，你们锁死吧
187000,218,徐从富,2024-01-14 05:53:45,0,2,2,虽然期末考没考好但是老师人很好，很耐心，你想问问题可以一直留到九点多给你讲明白，课也能学到很多\n\n期末考试区分度不大，开卷的，如果上课一次都不听的话考前预留8h左右把老师最后一节课划重点的模块的内容理解一下基本期末考分数也能上70；如果平时认真听讲考前稍微复习一下应该期末考分数比较容易上90.（以上两种情况都是身边同学亲身经历）\n\n给分的话看情况吧，签到5%，有5次每次1%，请假、智云听课并在钉钉上给老师发消息或者到场这三种情况都能拿到分，会提前一周说明下周是讨论课要签到，不是随机的；大作业45%，可以写论文也可以写程序，提交时间还能和老师商量，实在不行甚至考完之后5-8天交都可以；期末考开卷50%，有70分左右是PPT上原话或者原话的简单理解，计算题是PPT例题稍微改了一下或者简单组合，看懂PPT一般就能答个八九不离十。\n\n总评想90以上还是蛮难的，作为一门通识课来说给分不算好，记得有一次老师说过均绩是80分（老师自己统计的，不是查老师上的）。\n\n总评想上60很简单，哪怕一次课不听，也可以跟老师说一下，考前打印下PPT随便填一点，期末考老师一定会给你捞上30，总评肯定会调到60以上的，挂是肯定挂不了。
190290,218,徐从富,2024-02-27 10:03:26,0,1,1,大一上选了人工智能基础课，从课上知识来说确实不适合低年级去学，一些数学章节真的听不懂。\n\n但老师非常体谅学生，平时看智云等都算到课，最后总评也能感觉老师有捞。卷面分70（算是很低了），总评依旧上了80。\n\n谢谢老师
193209,218,徐从富,2024-06-04 12:20:14,7,7,0,老师人很好，但是课程设计真的是人工智能考古学……老师会讲最新的Transformer等模型，也算是回应诉求了，不过老师专业方向不在这里，实在也讲不清楚。但是有个神人兄弟把两次讨论课做成了自己的pre，一个人讲了十个人的时间……
219966,218,徐从富,2025-06-12 13:31:29,0,0,0,老师人很好，但课是真听不懂
221452,218,徐从富,2025-06-23 16:19:13,1,1,0,给分神了
1040,240,孟炳泉,2015-03-21 13:06:18,63,89,26,老师人超好，讲课很有趣，考前答疑很认真，给分高
1822,240,孟炳泉,2015-03-25 15:34:14,26,39,13,非常好的老师，上课很有趣，贴近生活。
4372,240,孟炳泉,2015-06-19 15:47:54,-13,28,41,上课好无聊，不习惯他的口音，上课时会放搞笑视频什么的，然并卵。
4408,240,孟炳泉,2018-08-25 01:56:35,21,35,14,挺有意思的。
8358,240,孟炳泉,2015-09-19 08:07:21,21,30,9,非常随和亲切的老师，然而有时上课会扯开去，但也算增长见识吧。
8806,240,孟炳泉,2015-09-28 03:51:25,4,10,6,很开心很风趣
11274,240,孟炳泉,2015-11-26 06:42:06,1,8,7,可以的
11476,240,孟炳泉,2015-12-02 11:17:13,1,6,5,很是可以
12338,240,孟炳泉,2015-12-23 04:08:39,-2,5,7,我男神
12612,240,孟炳泉,2015-12-23 15:24:25,-8,12,20,从炒股开始\n\n从炒股结束
12879,240,孟炳泉,2015-12-24 07:17:16,4,10,6,炒鸡认真的老师，有学术气质
13158,240,孟炳泉,2015-12-25 03:45:47,-16,18,34,上课不知道在干什么，听的云里雾里，根本不在乎学生懂不懂，相比之下，周建平老师真是幽默又负责
13721,240,孟炳泉,2015-12-30 11:53:18,20,27,7,还可以，作业少
14357,240,孟炳泉,2016-01-06 13:09:58,1,5,4,很棒！！！
15548,240,孟炳泉,2016-01-15 08:47:00,5,9,4,人很好，作业少，上课也不错
15734,240,孟炳泉,2016-01-16 08:04:10,-1,4,5,挺不错的
15961,240,孟炳泉,2016-01-16 23:12:49,-1,3,4,老师很不错
17948,240,孟炳泉,2016-01-21 04:42:06,-1,11,12,超级无聊 讲课总是一种尔等渣渣的语气( •ิ_• ิ)
19627,240,孟炳泉,2016-01-26 03:40:07,1,4,3,很可以，给了计算机学渣的我3.9
19835,240,孟炳泉,2016-01-25 11:12:42,3,7,4,很萌的老师，作业可以在寝室做，给分也很厚道，大赞(/≧▽≦/)。。
19842,240,孟炳泉,2016-01-25 11:26:23,-2,2,4,还可以啊，老师人不错的⋯⋯最后3.9还好还好⋯⋯
19861,240,孟炳泉,2019-01-10 01:28:09,18,25,7,虽然上课听不懂……但是人很好，作业少，给分不错~上课会放搞笑视频试图活跃气氛……然并卵哈哈哈……总体不错哒
19940,240,孟炳泉,2016-02-23 09:53:17,2,9,7,事情特别少，给分一般，讲解细致，有时候会延伸开去，作业可以不去机房做，没有实验报告。
19961,240,孟炳泉,2016-01-25 16:25:03,1,4,3,负责任，给分好
20216,240,孟炳泉,2016-01-26 14:26:00,0,5,5,课程进度比较慢，但是上课讲很多实用小技能，有时也分享段子、视频。最后考试考得好，什么都好说。
20275,240,孟炳泉,2016-01-27 01:31:33,2,4,2,其实综合来说，这个老师不错。
20486,240,孟炳泉,2016-01-28 00:18:51,0,10,10,老师不好
20754,240,孟炳泉,2016-01-31 03:29:23,-3,6,9,不好不好
21331,240,孟炳泉,2016-02-28 04:54:00,3,5,2,讲课细致，有时候还会放一些蜜汁搞笑的视频
25491,240,孟炳泉,2016-05-23 06:54:32,0,3,3,挺好的。真心
25673,240,孟炳泉,2016-06-01 13:16:00,0,2,2,讲的特别清楚！比较幽默风趣！超级有魅力！
31784,240,孟炳泉,2016-07-05 02:10:21,-1,3,4,我觉得老师讲的有点快，到了六章后的内容我基本就跟不上了，但考前重点什么都抓的挺好的，而且上课也认真负责
32637,240,孟炳泉,2016-11-10 08:58:27,-3,6,9,哎 死板 努力得不到回报
32676,240,孟炳泉,2016-07-09 07:47:26,2,4,2,本垃圾表示孟老师给分真的很好！！！
57090,240,孟炳泉,2017-07-05 13:38:52,3,7,4,上课还行，给分奇奇怪怪付出与回报不成正比
57102,240,孟炳泉,2017-07-05 14:11:56,-2,2,4,好好好\n\n
57156,240,孟炳泉,2017-07-05 23:52:03,5,14,9,为什么我次次到...作业每次认真完成上交...上机题全做出..还比这些都没做到的人分数要低？？？还低了不止一两档？？？\n\n
58261,240,孟炳泉,2017-08-28 04:37:42,1,3,2,是个好老师
64156,240,孟炳泉,2017-12-21 06:17:34,-1,2,3,很认真负责的老师 课间还会下来问同学听懂了没
64840,240,孟炳泉,2017-12-27 11:27:22,6,10,4,恕我直言，文科最好还是别选，老师上课总给我一种“你们什么都知道了我稍微讲下就可以”的感觉，很多java的细节都要自己看书自学，上的还是比较吃力的。
65278,240,孟炳泉,2018-01-04 09:14:24,0,2,2,善良 给分好
65477,240,孟炳泉,2018-01-04 09:45:43,1,3,2,老师人很好很负责，上课讲得也非常细致，真的非常好了
65591,240,孟炳泉,2018-01-06 19:29:09,6,11,5,怒打十分，java老师考试的时候还会混进考场帮忙你们见过嘛！只要不缺课4以上！
72757,240,孟炳泉,2018-01-31 04:57:25,-2,4,6,大计基考试的时候自己心态爆炸没考好，最后绩点也不是特别理想，我觉得绩点不好主要问题应该在我自己，但是老师真的挺好的，谢谢老师让我不挂
72765,240,孟炳泉,2018-01-31 05:06:57,0,3,3,男神！男神！
72771,240,孟炳泉,2018-01-31 05:15:36,-1,2,3,会讲一些有意思的故事，上课还是很有趣的，讲课讲的不错。
72827,240,孟炳泉,2018-01-31 06:49:13,-2,3,5,老师人很好，但是大计基考试的网真的令人窒息，隔10秒卡半分钟，绩点爆炸
72926,240,孟炳泉,2018-01-31 11:34:14,2,3,1,好棒！老师特别为我们着想！
73186,240,孟炳泉,2018-02-01 06:27:35,61,74,13,虽然给分很好，但是我真的听不懂他上课在讲什么～
74333,240,孟炳泉,2018-02-11 13:36:25,2,11,9,没上过他的课，但是考试那天上午去答疑室问他题目。记得老师说：“你怎么这种问题都要问？”“你是文科生吧？”（本人理科生）“上这节课的时候你没去听吧？（我每节课都去了，而且坐第一排）”“这么简单的问题，你怎么还不懂？”……\n\n然而下午考计算机科学基础，满绩……
81588,240,孟炳泉,2018-07-05 13:05:35,-6,3,9,大一遇到的两个超级好老师之一，随便说一句，教学质量和职称高低没有必然联系
82154,240,孟炳泉,2018-07-07 08:49:52,-1,4,5,老师很风趣幽默也很负责，最重要的是自己要预习复习到位，很遗憾自己没有做好，但是老师还是很好的老师......
84313,240,孟炳泉,2018-07-12 13:49:54,-1,3,4,老师上课超级好，就是有点快，不过只要认真听就能跟上而且能收获很多，感觉老师智商超级高！虽然最后怪我自己成绩不是很好，但是老师真的特别特别好！
84483,240,孟炳泉,2018-07-13 03:11:04,27,37,10,老师很好 会调档调分 祝老师早日挤进福布斯榜！
87312,240,孟炳泉,2018-09-27 02:12:46,1,6,5,上课前会有十分古老的冷笑话，超级冷的那种，普通话稍差，讲课还可以。
88316,240,孟炳泉,2018-10-28 10:12:54,3,6,3,讲的有点难，不太系统
90593,240,孟炳泉,2018-11-24 09:49:12,16,19,3,老师好!我想在这里说，我是说了谢谢和祝福才抢的红包哦，结果上课还是被叫起来回答问题了!? ，有一种被误解的尴尬。但是我觉得老师人挺好的，虽然课才过了一半，先给老师打个十分。
91121,240,孟炳泉,2018-11-30 15:17:15,3,5,2,老师教我们炒股哈哈哈哈哈哈哈哈虽然我学不会 挺好玩的
91336,240,孟炳泉,2018-12-06 06:01:30,68,72,4,大计机10分，大股基100分\n\n
91777,240,孟炳泉,2018-12-20 01:57:15,33,37,4,同学们上课了我们讲一下期货
92126,240,孟炳泉,2018-12-26 13:23:21,114,127,13,主修股市 辅修大计基
92673,240,孟炳泉,2019-01-03 12:51:23,7,8,1,老师真的一点架子都没有，可爱得一塌糊涂
93453,240,孟炳泉,2019-01-10 00:12:51,21,27,6,老师大佬无疑了，祝老师早日挤进福布斯财富榜
93461,240,孟炳泉,2019-01-10 01:35:20,16,20,4,虽然大计基难听懂，但是老师的课还是很有趣的，人也有趣，有人情味儿。（ps：每节课都会讲股市）
94112,240,孟炳泉,2019-01-15 07:58:58,11,15,4,过年发500块红包:反正我有的是钱，也没地方花→_→
94813,240,孟炳泉,2019-01-18 08:39:21,18,23,5,老师超级可爱der\n\n不过大计基还是自学为主吧哈哈哈哈哈
94940,240,孟炳泉,2019-01-18 13:19:45,-10,14,24,后面来的同学看好了，这个9分不是老师的业务水平，主要是因为不点名+作业少+小测都会提前通知。平心而论讲课水平也就那样，主要djj本身就容易睡着。老师人有些市侩，感觉更适合去当猿赚大钱而不是来教书？？？
99484,240,孟炳泉,2019-01-25 00:44:32,26,28,2,能听懂股票，听不懂大计基。\n\n
100811,240,孟炳泉,2019-01-27 01:05:58,3,4,1,很奈斯，但是没有基础，有些跟不上
100859,240,孟炳泉,2019-01-27 03:14:31,2,5,3,老师讲课的确不那么系统，但是认真听能发现课本上一些不容易理解的重点老师上课一个不拉地都讲过了。每节课必坐第一排，大作业好好做系统题多刷几遍期末不会有问题的。虽然卡绩但还是很开心了。可能最大的遗憾是讲股票的时候听得不太认真吧。别说老师总想赚大钱，其实每个到老师这个岁数的人都有这种情况，没那么理想化。好喜欢收藏可惜老师只讲了一次。
100869,240,孟炳泉,2019-01-27 03:38:08,0,3,3,怒打十分 神仙老师！人超好！祝老师早日挤入福布斯富豪榜！！
100898,240,孟炳泉,2019-01-27 05:03:04,8,12,4,听是听不懂的，学是要自学的，老师是很可爱的，对老师很有好感，怒夸！！！\n\n(要是你计算机基础很好应该听得懂吧
100900,240,孟炳泉,2019-01-27 05:11:17,0,4,4,老师很平易近人，会教炒股，至于计算机，讲的一般，不过也不能怪他，大计基的教学和考试真的应该改改，讲深了听不懂，讲浅了有基本等于没讲
101071,240,孟炳泉,2019-01-27 12:10:19,1,5,4,老师上课我确实听不太懂，但是老师人很亲切幽默，会放搞笑小视频，会讲一些股票之类的事，而且群里回答问题特别仔细耐心。关键是最后的成绩太出人意料了！！！！本来我以为自己要挂科了，因为期末考试的时候真的一脸懵，但是最后绩点上4了！！！！真的太惊喜太意外了！！！！用很多的感叹号表达一下我的惊喜之情！！！！！！！！！！！！！！！！！！！！！！！！！！！！！！
101076,240,孟炳泉,2019-01-27 12:16:11,-1,1,2,棒！棒！棒！给分超好！
101081,240,孟炳泉,2019-01-27 12:21:53,-3,1,4,事少 给分好\n\n可惜自己太菜了只有3.9
101084,240,孟炳泉,2019-01-27 12:31:22,1,4,3,老师给分好好呀，自己也说给的优秀超标了? ，本来都拿着书回家准备补考了? 真的没想到老师给的惊喜分数！
101091,240,孟炳泉,2019-01-27 12:50:35,-2,3,5,浙大第一好老师！
101142,240,孟炳泉,2019-01-27 16:31:10,5,6,1,老師佢份人好nice！好鍾意！超讚！！！大計基只要自己俾心機去學都係唔難嘅。最緊要的係：股票講嘅好好，雖然我豆聽唔明?上堂嘅時候千祈咪瞓覺，期末溫書時先至唔後悔
101143,240,孟炳泉,2019-01-27 16:34:30,2,6,4,老师特别怀旧，他的笔记本还是xp，经常使用msdos，其实一直都好奇老师到底有多少资产?顺便表扬一下超级可爱的课友
101250,240,孟炳泉,2019-01-28 02:43:13,4,7,3,怎么会有这么可爱的老师啊啊啊非常非常负责 有任何问题QQ私戳老师超认真回复 好爱好爱 本来觉得自己计算机过敏 但是绩点出来很满意！
101798,240,孟炳泉,2019-01-29 05:48:49,-2,2,4,老师人很好，给分也不错
101986,240,孟炳泉,2019-01-30 02:19:51,7,9,2,啊啊啊啊啊啊，真的吹爆老师，太可爱了，所有课里面只有大计基的课程群最活跃，老师看到问题都会很细致的回答，课友也真的很可爱，平时事也比其他老师少，会有两三次小小的quiz当点名，会有一个大作业，但ddl很松。大计基考前认真看书平时题认真刷考试不难，4.8这种绩点哪里找呜呜呜，真的感动哭了，感谢老师捞我，吹爆吹爆！！！
102057,240,孟炳泉,2019-01-30 08:40:46,1,3,2,股票学...嗯，就这样，还是挺有意思的
102184,240,孟炳泉,2019-01-31 07:57:39,-1,3,4,老师真的很好，给分更是不用说，直接十分
102274,240,孟炳泉,2019-01-31 15:54:04,0,4,4,老师给分真的好
102650,240,孟炳泉,2019-02-17 10:18:12,2,6,4,孟老师很认真，也超可爱的，会给我们科普很多事情。如果我早课不那么困和水，一定能学好...然而大计基真的靠自己恶补...背书吧。最后祝孟老师女儿高考加油！
104679,240,孟炳泉,2019-03-26 03:02:12,-4,7,11,经常瞎比比
104950,240,孟炳泉,2019-04-01 01:01:22,0,2,2,老师很好，很幽默，教的很仔细且有耐心。比心
105598,240,孟炳泉,2019-04-17 04:03:47,8,8,0,老师个人评价10分，大计基水太深-10分，大股基太强再+10分，听课自由，给分尽力，绩点随缘，总分10分。
109543,240,孟炳泉,2019-06-17 01:08:47,5,8,3,（通识java程序设计）\n\n老师人很好，代码能力可能一般。\n\n课程面向完全无基础的同学。\n\n接触过编程的同学（即使只学过C程）请三思，不要为了水绩点而浪费人生。
112135,240,孟炳泉,2019-07-03 17:23:10,-3,2,5,老师是好老师，但是我自己太差了。被卡绩了好难过
112185,240,孟炳泉,2019-07-03 20:06:45,6,7,1,会有几次小测，听说其他老师小测理论题或者不小测，但我们每次做的是程序填空，平时可能会辛苦一点，但是在期末复习的时候会轻松不少。\n\n
112490,240,孟炳泉,2019-07-04 11:58:31,1,4,3,Java满啦，谢谢孟老师，孟老师很体贴学生的，上课也很认真，在教java里的老师是个好老师_(:з」∠)_
113529,240,孟炳泉,2019-07-06 23:08:47,4,7,3,老师很可爱的，每节课会给我们分享一个笑话～
115398,240,孟炳泉,2019-07-21 04:42:53,2,5,3,老师人很好，给分也行，但程序水平真的一般，选他的Java 学不到多少课本以外的东西，讲着讲着还经常掉链子……
116645,240,孟炳泉,2019-09-12 07:07:34,1,4,3,老师太可爱了！！！！
121218,240,孟炳泉,2019-12-27 11:09:21,4,6,2,老师人真的超好！！！大计基是听不懂的，这是普遍现象。但是老师真的很温柔啊啊啊啊啊！
121235,240,孟炳泉,2019-12-26 07:37:03,3,4,1,菜鸡我真的听不懂
121788,240,孟炳泉,2020-01-22 01:45:01,5,7,2,孟老师很亲切很热心的，在课上在群里都会和同学互动，还很幽默，讲课挺有意思的
122518,240,孟炳泉,2020-03-03 07:12:41,-1,2,3,老师超级棒 超级无敌棒！
133419,240,孟炳泉,2021-02-28 04:03:20,0,2,2,java通识，签到抓很严，机房课要去并且也有偶尔签到，讲课思路没有很清晰，声音好大很精神！考前答疑认真。总体而言是好老师。
138426,240,孟炳泉,2021-07-09 06:06:25,12,14,2,看过孟老师课间视频的同学举个爪hhhhh\n\n分享一个事儿：\n\n考前一个男生问老师题目，其实课上讲了很多遍了，老师也贼直率：“wok这种题目你还要问”班里同学偷偷地笑了，老师让男生随便回座位问个同学，之后又觉得过意不去，然后打开文档给男生亲自讲了一遍\n\n感觉老师是很认真负责的。\n\nps.务必关注老师课上的文档，是难点重点
139288,240,孟炳泉,2021-07-14 05:05:46,12,18,6,上的Python。给分是真的好，感觉最后成绩比我预估的要高不止一个档次，对很多低分的同学也会狠狠的捞（听说有本来1.5捞成3.3的）。\n\n上课不定时签到，会有quiz，不过认真学的话不难。\n\n但与其他老师相比，孟老师代码水平确实差一点点，课上写程序bug有点多，但老师的讲课思路是非常好的，也在认真讲，答疑也非常用心，课间会问我们有没有听懂。\n\n总之是超级有趣的老师啦，课间会放一些有意思的小视频（比如教你怎么叠衣服），最后期末之前还跟我们说自己把期末试卷出的特别难，因为自己出的卷子不会给自己班同学考哈哈哈。
139355,240,孟炳泉,2021-07-14 16:00:24,3,9,6,孟老师太好了！孟老师太好了！孟老师太好了！\n\nmbq就是我的超人！！！！！！！\n\n衷心祝愿老师早日进入福布斯排行榜！！！
149169,240,孟炳泉,2022-01-14 15:17:35,0,4,4,给分不错哦
149263,240,孟炳泉,2022-01-15 01:53:57,-2,3,5,给分爽了 居然按照正态给
149280,240,孟炳泉,2022-01-15 03:20:08,0,3,3,虽然老师讲课很快，有时候口糊（经常），但是自己看看ppt就行，给分真的超级好！！！
150026,240,孟炳泉,2022-01-18 11:11:23,-1,1,2,给分不错
150948,240,孟炳泉,2022-02-21 10:17:34,7,8,1,好像一只愤怒的小鸟🐤
158612,240,孟炳泉,2022-06-30 17:00:21,4,5,1,捞了，但没完全捞
158795,240,孟炳泉,2022-07-02 09:10:35,1,4,3,不建议投入中等的人选
159871,240,孟炳泉,2022-09-07 07:19:26,10,12,2,就，为什么他分这么高，python上课讲解听不懂，期末也不捞人，3.3（本来想好好学py才退了干红华的预置课
160602,240,孟炳泉,2022-09-27 15:20:32,-2,4,6,1.老师学识渊博，是狂热的计算机爱好者\n\n2.老师讲的很快，思维非常跳跃，听课前请具备一定的计算机基础知识以及计算机术语缩写知识\n\n3.老师事情很少，大家可以放心选择\n\n4.老师性格耿直，不要纠缠不休\n\n5.电脑坏了，想扩大内存，换个显卡，找老孟就对了！！！
160628,240,孟炳泉,2022-09-29 00:21:17,2,4,2,老师人很好，但是我真的听不懂他夹杂着普通话的方言…孟老师我对不起你，我不该上课放别的老师的网课
161358,240,孟炳泉,2022-11-04 14:37:53,33,37,4,同学们，你们先考试，我要去玉泉校区了！
163464,240,孟炳泉,2022-12-14 11:36:36,5,9,4,这学期学的大计基感觉把股票吃透了、\n\n下学期有点想再续前缘，人很好玩很认真，作业好像大计基普遍多，室友又报的cjh感觉也还好，挺可爱一老师，不知道给分咋样。\n\n你如果想一门课学两门知识就无脑入他吧，这学期甚至早到教室10分钟就为给我们上股市的内容，他真的，我哭死。
163473,240,孟炳泉,2022-12-14 11:51:26,4,6,2,很难评价上课水平，因为听不太懂他的口音也跟不上他的思路，目前为止都在自学成才。\n\n从语气上能感觉到他上课会开个玩笑活跃气氛，很负责的老师，会下课之后走下来问哪里有问题有没有听懂。问到过我，但是我没法回答，因为我感觉他好像在说外语。\n\n但是确实不太喜欢课前的讲股票环节，也不太喜欢他对自己普通话水平的奇妙自信。
163868,240,孟炳泉,2022-12-16 09:46:06,-5,2,7,股票没学会，计算机也没学太明白，但是老师很好
164629,240,孟炳泉,2022-12-22 09:54:38,3,9,6,差劲老师，讲起股票来头头是道，除了股票什么也不会，甚至程序编写到一半去查答案，千万别选，受过他荼毒的人们顶我上去
165093,240,孟炳泉,2022-12-29 05:40:06,6,10,4,大计基 python都是他的\n\n其实老师人很好的，很有人情味，挺关心学生的，会在课间下来问学生听没听懂，平时分之类的给的很高\n\n讲课也不算没水平，至少我觉得蛮好，python听得挺懂\n\n至于股票他也是在课前讲，倒也不会占上课时间，听听当娱乐也挺好\n\n给分也好的，他会在登记成绩之前专门要一张绩点转换表，防止给我们所谓的卡绩
167342,240,孟炳泉,2023-01-15 14:37:38,11,13,2,上课除了股票什么都没学到，期末答疑课含糊其辞，毫无知识点；不知道为啥评分这么高
167344,240,孟炳泉,2023-01-15 14:39:31,8,10,2,股票呵呵 课是没学到
167349,240,孟炳泉,2023-01-15 14:52:25,1,5,4,emmm还不错吧，但是djj确实主要靠自学
167384,240,孟炳泉,2023-01-16 01:49:28,7,12,5,（针对大计基课）\n\n给分很差，上课先讲股票，讲真正的课程知识的时候讲得很快又很含糊，会无缝衔接很多课外内容，好不容易弄懂了说不用考。在教程序编写的时候，自己写的程序跑不通，不是自己找错误，而是直接抄教案里的标准答案。学生提出疑问的时候，会先针对人提出批评与质疑而不是研究问题。小测管理非常混乱，学生还在考试人已经去玉泉开会了。期中期末测试题目难倒不是他一人的锅，而是课程本就如此。\n\n老师自恃浙大老教师，为人相当高傲，对一切事情漫不经心，或许是因为自命不凡。曾经有过昨天得新冠，今天去食堂不戴口罩的事例。\n\n总而言之，我不知道是査老师系统出了问题还是他的另外几门课上的好，这种人竟然能上9分。学弟学妹们可以上一下他的课，就知道我所言非虚。
167385,240,孟炳泉,2023-01-16 01:49:31,4,6,2,讲课有点混乱，djj要自己多看PPT或者看其他老师的智云\n\n和同学的交流还是不错的，过节还发红包。\n\n评分高应该是因为给分好吧，是我目前最高的一门了）
167391,240,孟炳泉,2023-01-16 02:32:58,33,46,13,这届大计基好像普遍偏低，大家怨气重也是自然。我绩点不高不低，让我至少能理智的写完这段评测，说说课上的感受。\n\n上课不系统，但凡他按着书本讲我的知识体系都不会稀烂成这样，跟自学没什么区别\n\n总是有些莫名奇妙的拓展，暂且不提被大伙说烂的股票【他真的觉得我们会听欸】不考的硬件还有一堆云里雾里的英文缩写，建议没兴趣的同学在他讲这种时自觉低头封耳，没有意义\n\npta的题目有些神奇，我一度以为不同老师pta题至少一样，但是当我发现别人pta觉得很有用、做到好几道原题的时候，就感觉到不对劲了\n\n     况且，孟的pta是不改的【没错，不给答案已经够恶劣了，但阁下改都不改】他自己还觉得没必要，“你们在群里自己问不会的不就行了”\n\n     ...阁下这么不负责任的老师还满少见的\n\n最看不惯的，还是他的自命清高。总觉得自己教的很好，拓展的准确又到位，学生什么都会基础贼好，官场那套搞的风生水起。\n\n我并不觉得这是可爱。 我认为他无聊又可笑。\n\n\n\n学弟学妹如果预置了他的课，请从入学就做好自学的觉悟，各种思维导图、知识点、题目之类，能蹭别的老师的就蹭点【孟这块是信口开河的，别抱希望了】，或者出门左转。软硬件之类略有涉猎、基础较好的会挺开心的吧。祝好。
167394,240,孟炳泉,2023-01-16 02:47:39,4,6,2,大计基，混乱
167419,240,孟炳泉,2023-01-16 07:03:00,-2,6,8,考新题库的第一届，被老师海底捞了，大赞！
167425,240,孟炳泉,2023-01-17 12:06:41,13,17,4,先抛开这次期末捞不捞人不提，整个课程完全混乱，没有章法，感觉自己学了和没学一毛一样，建议预置他的大计基课程的同学们换别的老师的课上。每次上课前先讲股票，但他的讲的股票和大计基一样烂，依托答辩。
167429,240,孟炳泉,2023-01-16 07:52:45,8,12,4,喜提3.3，下学期Python预置还是他，我寄！
167527,240,孟炳泉,2023-01-17 04:27:42,1,6,5,医学院基础课。作为计算机纯小白，能体会到孟老师很想把大计基教好，但是人是学二代语言的所以PYTHON自己写语法不太对。上课的话很积极滴活跃气氛，但怎奈课程设置离谱内容繁复，CS组想要包罗万象但东西全是浅尝辄止，考试又比学的要难一些（比如，期中补考考Windows快捷键？？）所以也很无奈。捞人是真的下大力气捞了。只要肯好好学，多找老师答疑，最后结果不会太差。毕竟，大计基本来就是折磨人的自学课程。
167606,240,孟炳泉,2023-01-17 15:23:10,3,6,3,炒股大师 大计基上的一团糟 期末狂补天被捞了个3.9 （大概是期中考的不大好）\n\n优点是平时分给的相对好 还是捞了一下的 小测也比较随便\n\n缺点是讲的太烂了没有条理发音很模糊上课听不懂 我全程看的是隔壁pxy的网课 \n\n不太擅长自学的人快跑！！！！！
167998,240,孟炳泉,2023-01-21 18:23:16,6,9,3,烂捏哈
168900,240,孟炳泉,2023-02-23 10:08:03,2,4,2,上课水准不是很好，但期末会捞。
169678,240,孟炳泉,2023-02-27 10:51:17,37,41,4,孟炳泉的课，重点一个不讲，主打的就是一个股票，上课基本只能靠自己，经常脱离课本内容，使人经常云里雾里，考试更是让学生手足无措，差评！！！顶我上去，不要让学弟学妹们重蹈覆辙！！
170631,240,孟炳泉,2023-03-07 10:00:15,2,6,4,菜，且无聊，如果不幸遇到，请千万不要眷念群里他排出的几文大钱，赶紧逃！逃不掉可以上课时耳机堵住听翁恺老师的智云
171320,240,孟炳泉,2023-03-21 13:49:05,7,9,2,爱装。
171982,240,孟炳泉,2023-04-15 11:25:59,6,6,0,要做好全靠自学的准备
172011,240,孟炳泉,2023-04-17 09:14:04,3,4,1,快跑！
172046,240,孟炳泉,2023-04-18 05:25:17,6,8,2,赶紧逃！
173231,240,孟炳泉,2023-05-16 08:06:13,2,5,3,他的quiz和上机测试太多了\n\n虽然他很负责但频率高 题量大 真的吃不消\n\n同寝室同学算到现在也才测试四次\n\n我们已经测试六次了 马上还有两次
173458,240,孟炳泉,2023-05-25 07:41:24,2,4,2,我认为不太好。
174829,240,孟炳泉,2023-06-18 15:03:50,3,6,3,讲课水平烂的一匹，老讲股票，口音严重，吐字不清，偶尔纸质签到（不通知）（但是可以自己补签），小测老师不在，但是热心答疑。
175082,240,孟炳泉,2023-06-21 12:17:20,1,4,3,小测真的太多了，每次都是匆匆忙忙复习一下就测了，手写编程好玄学啊啊啊，不知道最后成绩怎么样。
177745,240,孟炳泉,2023-07-04 14:24:58,3,7,4,老师虽然可能讲课没有那么好 \n\n但是很负责 会问学生听懂没\n\n然后给分很好\n\n虽然quiz和小测多 分数低\n\n但是这只是班里拉开差距而已\n\n综评还是很高的！！！认真做就可以了
177749,240,孟炳泉,2023-07-04 14:38:50,-1,3,4,nice，给分很好
177758,240,孟炳泉,2023-07-04 15:49:00,4,6,2,老师点名6-8次左右？记不太清了，实验课点名了大概两次。我好像有2次没到，每次课上小测都有几题没写出来，课堂的纸质小测都写出来了但是不知道对错（感觉是对的）。实验考只写出来第一题，理论考按照朵朵上的方法看了下自己是81。\n\n自己算了下绩点大概3.3-3.9，老师给捞到4.2了，可能平时分尽量给满了。谢谢老师。\n\n感觉期中以后就很忙，python没有学得很认真，上课也在做自己的事。\n\n建议大家多看书呜呜。感觉把书看过，pta上的作业题都弄懂就很够了，但是我连这样都没做到，还是有点对不起这门课qwq
178162,240,孟炳泉,2023-07-07 10:30:00,1,6,5,给分超级好！！！但是建议自学哦。
179513,240,孟炳泉,2023-09-18 01:20:00,2,3,1,幽默风趣\n\n祝愿老师早点进福莫斯榜( っ'-')
179772,240,孟炳泉,2023-09-19 19:26:32,0,4,4,捞王界唯一真神
180983,240,孟炳泉,2023-09-30 12:59:07,10,12,2,建议自学并从其他地方找题做，听他的课我还不如去听思政
181069,240,孟炳泉,2023-10-07 07:46:40,5,5,0,听不懂啊😫
181078,240,孟炳泉,2023-10-07 11:58:16,4,7,3,感觉上课重点不突出，听得云里雾里......\n\n这位老师给的题不行，想问一下大计基B去哪里找题做比较好啊......
181499,240,孟炳泉,2023-10-19 09:05:09,27,31,4,上课有人说听不懂 他就问别人是从哪考过来的 别人说是内蒙 然后他问内蒙是不是录取分数低 还问别人是不是贫困山区出来的 还cue了一下脱贫😅😅😅真挺无语的 听不懂就说是贫困山区出来的是吗 哪来的优越感😅😅😅
184586,240,孟炳泉,2023-12-22 01:54:37,5,9,4,依托答辩
186242,240,孟炳泉,2024-01-10 04:34:37,9,12,3,一托勾石
186593,240,孟炳泉,2024-01-12 03:56:01,1,3,2,股票哥
189391,240,孟炳泉,2024-01-23 18:17:30,0,5,5,太捞了哥\n\n虽然讲课完全听不懂\n\n但可以相信他的海底捞能力\n\n大计基成功过了(｡･ω･｡)
190080,240,孟炳泉,2024-02-19 13:42:54,0,2,2,讲的很差
190541,240,孟炳泉,2024-03-07 12:58:07,-1,3,4,讲得是真的水，期末捞人是真的好
191104,240,孟炳泉,2024-04-03 09:07:04,2,4,2,我的神，小测取消当场下课！
191841,240,孟炳泉,2024-05-01 16:19:57,-4,4,8,捞王界唯一真神
192305,240,孟炳泉,2024-05-14 11:24:37,-1,2,3,讲课太烂，别选
192695,240,孟炳泉,2024-05-28 11:05:33,2,5,3,客观评价是个好老师，虽然讲课并不是特别好，但是pyhton每节课都会发课堂总结，然后PPT和作业答案都发给学生，自学完全没有压力。\n\n老师比较希望在课堂上看到有学生有反馈，24年的python全班低头做自己的事情，老师很生气直接下课走人了
193980,240,孟炳泉,2024-06-21 07:28:31,1,2,1,上课讲股票、讲期货、讲普京英雄事迹、讲中国下大棋\n\n就是不讲python
194861,240,孟炳泉,2024-06-25 17:51:38,3,10,7,1.首先老师上课是听不懂一点的\n\n2.感觉给分也没说的那么捞\n\n3.当上课听不懂然后老师又不怎么捞的时候…
195271,240,孟炳泉,2024-06-27 14:20:56,0,2,2,老师会传名单纸质签名\n\n课讲得不太好，我后面放弃听课了自己看书做题\n\n但老师人还是非常nice的，会关心学生听没听懂。会在小长假前取消小测当场下课
195871,240,孟炳泉,2024-06-30 12:35:54,0,3,3,反正不捞
198472,240,孟炳泉,2024-09-09 06:33:39,1,2,1,好像还是挺捞的，反正跟老师聊天沟通都还是挺舒服的。上课问问题或者课间问都会及时回复。个人感觉不错。上课感觉还行，不过也有可能是因为作为浙江考生有一定的基础（物化生选考，非技术选考生）。
199146,240,孟炳泉,2024-09-18 07:20:30,0,2,2,一点不捞
199159,240,孟炳泉,2024-09-18 09:10:33,6,8,2,讲课有点乱，需要努力自学😅小白不太友好
199340,240,孟炳泉,2024-09-21 09:33:14,11,14,3,在教室吐痰………ex🤢
199420,240,孟炳泉,2024-09-23 08:24:30,1,4,3,正直礼貌的普通话极为标准的老师，可惜是异性恋患者
199915,240,孟炳泉,2024-10-08 09:14:30,3,6,3,也是感受到了股市的魅力了
201218,240,孟炳泉,2024-11-06 11:39:27,7,8,1,感觉Python这种硬课的话，如果你不是浙江选考了技术的考生，慎选孟老师的Python的课，老师的课体系比较絮乱，而且容易讲着讲着跑偏，让学生很疑惑。而且讲东西跨度挺大，刚开始的一两节课会讲一点大计基，然后后来就迅速进入循环语句，之间有点割裂。在thonny里怎么输入数据都还是上机课上助教教会我的，感觉主要靠自己看书加不懂的问问助教💦\n\n他甚至会对整个班说我讲慢的你们也不懂还不如讲得飞快云云
201823,240,孟炳泉,2024-11-06 13:29:31,2,6,4,老师人超好
204998,240,孟炳泉,2024-11-29 10:30:49,-2,2,4,给分不好
205056,240,孟炳泉,2024-11-30 12:42:13,5,7,2,上课啥都不讲，居然教我下载鲁大师，下完电脑直接蓝屏，什么成分我很难讲，他真的懂电脑吗，我信他我也是真蠢。
206517,240,孟炳泉,2024-12-15 16:03:13,5,5,0,笑话超好的
206899,240,孟炳泉,2024-12-18 08:44:32,7,8,1,我是老高考文科生，完全没有python基础，如果跟我情况相同的同学我强烈建议避雷mbq！！！\n\n老师讲课很不清晰，逻辑很跳（他似乎自认为讲的很清楚）而且答疑时也不是很耐心，当然老师会在群里发ppt，加上自己下去多敲敲代码成绩也是过得去的，就是需要花不必要的时间感觉不值得\n\n老师人其实不错，pta上作业日期放得很宽而且会关心同学听没听懂，但是如果你想学好python这门课，听我的，快逃啊！！！
207533,240,孟炳泉,2024-12-23 01:48:13,3,4,1,本人上的Python 怎么说呢 如果有认真学或者之前有点基础的话那么上课还是能听懂的 小测的题目都是作业里面有的，小测的时候也不管。不过老师还是很负责任的，虽然有时候脾气有点急躁，但是如果有问题去问的话老师还是会很耐心的回答的（记得有个问题线上问了两遍，线下问了一遍，老师都很耐心的回答）还有一点就是老师经常点名，一个学期点了6次吧\n\nps：老师上课有时候还是很有趣的
207734,240,孟炳泉,2024-12-24 05:36:44,4,5,1,上课讲得很快 对外省学子不是很友好\n\n但是人很好
207797,240,孟炳泉,2024-12-24 09:53:04,-2,2,4,不错的老师
207830,240,孟炳泉,2024-12-24 12:07:51,5,7,2,老师讲课使人不知所云，没有基础就只能自学吧。但为人不错，比较不拘小节，作业小测什么的要求不高，有时说话听着有点狂傲，但确实是为大家好的真心话。
207971,240,孟炳泉,2024-12-25 06:07:47,4,5,1,给分好，人也很好玩，但是讲课不太行，基本靠自学
208933,240,孟炳泉,2025-01-08 05:38:52,8,12,4,讲课水平依托，大学的第一节课就被他这么霍霍了，除非你是浙江技术选考生，千万别选
211660,240,孟炳泉,2025-01-12 06:14:44,-2,12,14,讲课水平依托诗，课上讲的乱七八糟，作业和课程内容脱离严重，考试更是和上课讲的完全对不上.不仅如此，这个老师不仅课上喜欢嘲讽学生没有水平，期末更是直接在班级群里公开阴阳所有人没有学计算机的天赋(老子学医科的要牛魔的计算机天赋).周二课上提一嘴周六的小测，此后班级群里只字不提，导致全班一半多的人都没有考.所谓线上答疑更是纯纯依托，他能直接把你的问题原封不动地喂给百度，再把百度的截图发给你，关于问题本身不做任何解释，理解不了就是学生水平不行.这样的老师也有人刷高分，真是几把幽默完了.
212757,240,孟炳泉,2025-01-15 00:55:19,6,6,0,能接受自学一部分的都来选他的大计B，给分太好了，感恩感恩啊感恩，太牛了这感觉平时分肯定捞满了，大计自学没那么难考试也不难，加上孟老师的给分简直是神啊！！！
212761,240,孟炳泉,2025-01-15 01:00:53,8,8,0,老师上课思维很跳跃，但是说实话老师人不坏，刀子嘴豆腐心。出分老师也很捞。没想到能满绩。不过不太推荐没基础的同学来选
212764,240,孟炳泉,2025-01-15 01:04:36,-1,1,2,嘻嘻嘻嘻
212774,240,孟炳泉,2025-01-15 01:30:01,0,2,2,给分超好
212794,240,孟炳泉,2025-01-15 02:34:30,1,3,2,一节课都没听、努力自学把pta题目都刷一遍也能上4.5
212800,240,孟炳泉,2025-01-15 02:42:08,3,4,1,老师给分超级捞！！！捞到满绩了，真的感谢啊啊啊啊啊！！！说实话，如果是外省的学生，没有计算机基础的还是不太建议选，孟老师上课跳跃性蛮大的，体系也不太明晰，基本靠自学。但是给分真的很好！！！！
212802,240,孟炳泉,2025-01-15 04:32:48,2,4,2,必须10分\n\n虽然上课讲的不咋地\n\n但是如果你能接受自学的话\n\n一定要选！\n\n我选的他大计基（b）\n\n都以为要掉下4了\n\n他海底捞啊，直接4.8\n\n感动\n\n实在太捞了
212839,240,孟炳泉,2025-01-15 04:43:32,5,6,1,1.关于楼下说老师嘲讽学生的。有没有可能，老师“宽容”的意思是平时分他会给满呢。。学医确实不需要计算机天赋啊。。\n\n2.关于老师教学方式。不得不说老师知识过硬，但是思维比较快。如果选到他的课最好先用课本预习再去听，这样比较轻松。个人认为python课本的问题在于，很多知识点只用例子的形式展示，需要自己去总结。如果能课前预习下，上课听老师的总结，效果会很好。不然期末补天还是挺累的。\n\n3.关于给分，孟老师刀子嘴豆腐心我的神！能接受自学的就选，拿高绩点不难的
212861,240,孟炳泉,2025-01-15 05:35:45,0,2,2,老师很捞，给分特别好
212873,240,孟炳泉,2025-01-15 06:29:18,0,2,2,捞平时分之王
212886,240,孟炳泉,2025-01-15 07:09:42,1,3,2,说老师嘲讽的，只能说，石砸狗叫
212892,240,孟炳泉,2025-01-15 07:35:44,4,5,1,大计b，感觉老师是高强度冲浪选手，查老师上去年被诟病的一些问题今年就都有改，上课内容和考试范围也结合得很好，没有前面评论里说乱教的情况；给的pta题库也和其他老师差不太多，复习的时候放心看；四次pta小测很好水，老师每次会给忘记的同学补测的机会，甚至上课签到也有补签的机会；能看出来老师尽了自己最大限度不为难学生。今年浅浅讲了下炒股，个人感觉是课堂的调味剂，其实挺有趣的，听一听很涨知识哈哈。老师本人也很有人格魅力，风趣幽默，能听出来是很通透的人，对学生也很负责，会主动问后排的同学听不听得清听得懂，虽然后排大多数是来摸鱼的很心虚哈哈哈哈。最后，给分真的超级好，本人省外文科生毫无计算机基础，考前一周补天，最后感觉卷面答得实在没底，没想到能被捞到4.5，感觉平时分拉满了，呜呜呜谢谢老师，总之老师值得，10分敬上！
212949,240,孟炳泉,2025-01-15 10:20:44,2,3,1,捞王届唯一真神！！虽然88卡绩依然真神！
212987,240,孟炳泉,2025-01-15 12:10:13,1,2,1,孟老师其实真的挺好的，就是上课听不太懂，会在上课的吐痰（但这也不太重要吧，我觉得完全可以上课的时候/课下自学\n\n我其实觉得python基本上哪个老师讲都听不懂吧，除非你是浙江选技术的（小声\n\n但他给分我觉得很好，平时作业只要做了都算满分，小测也很轻松都是做也原题。不过期中期末还是要好好考。苯人上课没听懂过，全靠考前自学最后4.5
213028,240,孟炳泉,2025-01-15 17:08:23,3,3,0,捞王届唯一真神！
213210,240,孟炳泉,2025-01-16 10:39:35,0,2,2,捞啊捞啊捞
213279,240,孟炳泉,2025-01-16 15:53:10,0,2,2,给分好
213704,240,孟炳泉,2025-01-19 08:20:36,1,2,1,大计基B，满绩。点名很轻松，就给个名单纸质签到，这节没来可以下次再签，小测也是，非常轻松，相当于开卷，考前复习pta差不多就够了，大家要会利用B站资源，真非常捞
213870,240,孟炳泉,2025-01-20 16:55:55,2,3,1,老师很好，给分也很好
214136,240,孟炳泉,2025-01-25 07:28:42,0,2,2,很好的老师
214266,240,孟炳泉,2025-01-31 09:45:40,0,0,0,真神。
214385,240,孟炳泉,2025-02-02 15:00:46,1,1,0,6f7gTRkt&#39
215893,240,孟炳泉,2025-03-06 15:08:34,5,5,0,老师很有趣，就是提问的时候喜欢逮着一只羊薅……不过老师还是挺好哒
216136,240,孟炳泉,2025-03-11 03:30:34,0,0,0,完全听不懂在讲什么。。。给分也没那么好。。但是老师还是比较好玩
219794,240,孟炳泉,2025-06-06 12:05:23,1,1,0,讲概念的时候会有点听不懂，但是具体程序讲的很清晰，另外老师挺好玩的
1217,313,方宁,2015-03-21 16:43:53,20,38,18,老师帅帅的，是个很有魅力的人，讲课也很认真，给分还好吧！
1589,313,方宁,2015-03-23 00:08:29,0,4,4,讲课很清楚，而且不枯燥
1863,313,方宁,2015-03-26 02:53:21,0,2,2,听着不枯燥
2656,313,方宁,2015-05-05 03:40:52,29,43,14,老师很帅。但是大计基讲的有点水。
2758,313,方宁,2015-05-07 01:58:47,9,13,4,上他的Java，讲得一般。
4282,313,方宁,2015-06-18 14:17:10,1,5,4,老师好，可惜我很水(╯з╰)
4906,313,方宁,2015-06-30 07:58:00,-2,4,6,棒棒哒
5190,313,方宁,2015-07-05 16:13:45,0,9,9,进大学之后遇到的颜值最高的老师 感觉以后也不会有老师超过他了
5340,313,方宁,2015-07-07 00:43:54,7,13,6,老师讲的很好！有条理浅显易懂
5741,313,方宁,2015-07-09 08:25:33,7,17,10,老师好帅>\\\< 上课深入浅出呢～
6837,313,方宁,2015-07-24 01:33:12,4,12,8,老师长的真的很帅男神啊！可是我都连续两学期选他的课了为什么每次我的成绩都在平均绩点以下TAT
7898,313,方宁,2015-09-16 04:30:14,0,4,4,老师帅
7969,313,方宁,2015-09-16 09:31:04,0,3,3,挺好的
8352,313,方宁,2015-09-19 02:20:22,0,6,6,脾气不好
9204,313,方宁,2015-10-16 12:23:34,43,115,72,作业狗多，狗烦，而且大多数都是没上过就布置出来要自己学。还极其不讲情理。想学大计基的不推荐选他。
11646,313,方宁,2015-12-09 07:04:17,0,5,5,真讨厌
12154,313,方宁,2015-12-22 05:57:30,29,39,10,只能说太水了…本来大计基课本写得就不合理，上课讲得又水，写作业还要提前预习…大计基全凭郁闷的自学
12320,313,方宁,2015-12-23 03:16:01,13,25,12,方老师帅帅的，有点小机灵鬼一样的感觉~刚开学觉得上课很水很无聊，现在觉得讲的还是蛮不错~虽说作业布置的不大合理，但是就当预习了嘛，强力推荐方老师~
12901,313,方宁,2017-05-15 09:25:36,10,22,12,超级的无聊  上课全讲课本上的内容 一点别的干货都没有  偶尔还要自我吹逼一下 布置的全都是你不曾了解他也不曾讲过的作业 烦到不行  无聊到爆炸
13466,313,方宁,2015-12-28 07:14:00,0,1,1,听不懂
13978,313,方宁,2016-01-03 08:49:14,2,6,4,很亲切，会很耐心地回答学生问题
15365,313,方宁,2016-01-14 04:58:27,4,10,6,真的觉得只要认真听就能学到很多东西，上过老师的java，感觉讲得非常清晰有条理，也很负责，适合上课认真的同学
16756,313,方宁,2016-01-19 02:26:56,5,11,6,大计基。真的要报警了。每次作业都是提前布置，做之前都要预习，我真的是很辛苦。
19980,313,方宁,2016-01-25 22:36:52,3,10,7,凭良心讲，老师不错的，推荐给打算认真学习的孩子们，水货勿近。印象中有课堂测试，作业偏多。不过平时认真一点考试压力也就稍微小一点。给分感觉基本正常。
20361,313,方宁,2016-01-27 07:06:43,4,9,5,是我目前所知的，实验作业课程作业留的最多最全面的一个老师…总之上方老师的课，计算机基础要稍好一点…不然许多实验真是抓狂…给分还好吧，就酱…心有一点塞…
20585,313,方宁,2016-01-28 15:59:44,0,1,1,虽说平时作业多，到考完试给分好啊，我有一次测验没做，但分数很棒
20635,313,方宁,2016-01-29 07:51:40,1,2,1,大计基作业挺多的，给分倒是比想象的好一点点
21468,313,方宁,2016-02-29 03:00:40,5,8,3,一般般\n\n作业多\n\n
21719,313,方宁,2016-03-01 01:46:40,0,1,1,帮帮榜
22968,313,方宁,2016-03-15 09:12:23,1,4,3,作业超多，而且枯燥，学霸估计比较喜欢
23405,313,方宁,2016-03-29 03:16:55,4,8,4,老师长得可爱啊 上他的c程设计 感觉讲的蛮仔细
24070,313,方宁,2016-04-26 13:02:50,0,1,1,上课挺好的，就是屁事特多，作业也只能机房做。8分吧
25191,313,方宁,2016-05-08 06:17:24,1,5,4,简直拉基。。。
26304,313,方宁,2016-06-16 16:44:27,4,6,2,感觉老师不怎么讲情理……
27477,313,方宁,2016-07-06 05:42:03,1,1,0,老师人很好的 上他的c 有次有程序提交总是错误 发邮件问他 过一会儿就回复啦 很负责任很耐心的
28238,313,方宁,2016-06-28 08:19:13,1,2,1,老师人还是不错的
30328,313,方宁,2019-02-01 13:55:50,-143,15,158,贱人，没见过这么贱的老师，这是我人生第一次见到这么贱的老师
30333,313,方宁,2016-07-01 09:47:21,-8,0,8,垃圾老师
32127,313,方宁,2016-07-05 16:28:21,1,2,1,作业太多了吧！c程实验每次不仅多而且内容超前，做到崩溃！还有一堆课程作业，一学期下来真的要疯了
32196,313,方宁,2016-07-06 02:26:22,0,0,0,老师给分还好吧我觉得
32202,313,方宁,2016-07-06 02:57:30,1,2,1,老师挺好的 可惜我慢慢就听不懂了\n\n每节课后有作业 上机要到机房有点麻烦
32410,313,方宁,2016-07-06 14:42:25,1,1,0,作业比较多，讲的也比较清楚，课堂有些沉闷，容易睡着的同学只能靠自学了。最后考试好好考给分还是不错的。
32443,313,方宁,2016-07-07 00:37:29,1,1,0,挺喜欢的，负责
33396,313,方宁,2016-12-28 04:41:33,4,16,12,他的C，我觉得我收获的不止是5，还是更多教学不要求的知识，方老师讲解的很好，你有问题也会很耐心回答！虽然作业有点早布置，但都能完成的话你不满很难啊！
34196,313,方宁,2016-12-21 07:15:18,0,1,1,各种不会做的作业
34514,313,方宁,2016-10-12 09:21:19,-1,1,2,........
35783,313,方宁,2016-11-10 08:08:25,7,7,0,作业要自己钻研
35897,313,方宁,2016-11-10 08:46:59,-1,0,1,还不错，挺有意思的老师
38678,313,方宁,2016-12-14 08:09:40,0,0,0,腿长人帅 男神！
38730,313,方宁,2016-12-16 00:14:26,1,1,0,挺正直的老师，上课一般，作业量中等。
39357,313,方宁,2016-12-22 07:35:46,1,1,0,我觉得上的挺好啊，至少也得有八九分吧
39601,313,方宁,2016-12-26 03:14:20,0,0,0,(T＿T)/~~
40322,313,方宁,2017-01-02 17:48:21,1,4,3,千万别选他的大计基╮(╯_╰)╭
40836,313,方宁,2017-01-20 10:55:08,0,1,1,平时作业别太水，考前多看看书，给绩还是挺棒的..\n\n
40899,313,方宁,2017-01-06 06:52:00,1,1,0,上的大计基。不明白分数怎么这么低。其实老师人挺好的，讲得也不错啊。他自己也说了以前自己是不用教书的，只是现在政策改了他只好出来做老师了……\n\n虽然布置的测试确实不会做（一直靠题库），但是测试的分数又不是最终这部分的给分，而且那是大计基课程设置本来不合理的原因吧。
45996,313,方宁,2017-01-20 11:01:58,2,4,2,方老师人很好的，就是上课经常有意无意带出一点怀旧。。。提一点过去的事情，但是讲得真心不错，最后答疑的时候我才跟他正式交流，非常耐心。作业的话，不认真做真的考不出来，最后的大实验是重点，考前多去刷刷题库，不要怕烦啊，多啊，大计基不需要脑筋，只要你认真，高绩点不是梦
46086,313,方宁,2017-01-20 14:54:48,-2,1,3,大计基听了课和没有听课效果差不多，因为总是听得一脸蒙逼……考试还是靠期末前把课本认真自学了两遍……方老师上课一般般吧，作业量不知道和别的老师比起来怎么样。两次当堂小测。大作业没有论文，是25页+的PPT。
46357,313,方宁,2017-01-21 10:27:29,3,3,0,出分太慢了
46499,313,方宁,2017-01-22 01:15:34,1,2,1,老师很好，给分也还不错
46923,313,方宁,2017-01-23 02:17:50,2,3,1,我觉得挺好的，本来大计基就会有点听不懂。大作业做ppt比起那些要求学生做网页的善良的多了。平常的作业也因为以前学生的抱怨大大减少。给分也挺好的
48186,313,方宁,2017-03-01 06:18:03,1,3,2,挺好的老师\n\n
48863,313,方宁,2017-03-15 04:22:19,3,6,3,老师讲的真的很好，人也很好，会认真解答问题。C跟着他学没错的。至于说的作业问题，我觉得没啥，平时没有作业期末会翻车的。
49187,313,方宁,2017-03-29 01:44:16,25,35,10,感觉长像万磁王，讲C程很有料，好老师，水货们乱评的都是些渣渣
49207,313,方宁,2017-03-29 09:14:48,1,2,1,老师很好呀，很亲切，有的时候还很幽默。
49342,313,方宁,2017-04-06 07:17:56,-3,2,5,千万别选这个老师的c程，作业多到爆炸，又难又多，每周布置两周的联系，也是很服。
51708,313,方宁,2017-06-08 12:10:39,4,6,2,记住c小程这本教材不是给浙江大学的学生看的，当我的室友还在为指针的四个题苦恼时，我默默地写完结构的十道题……都是泪呀，不怎么喜欢计科千万别选，但要想锻炼能力还是值得的
54132,313,方宁,2017-07-06 04:33:09,4,5,1,啥都没讲，看书吧\n\n\n\n
54731,313,方宁,2017-06-30 06:07:57,1,1,0,老师超级帅！！学了他的大计基后又选了他的C程（小迷妹一枚）。这两学期作业不怎么多吧（他说以往作业有点多所以这两个学期改进了一下）。给分什么的，只要作业好好做，考试好好考，基本分数还是令人满意的。
57196,313,方宁,2017-07-06 04:03:38,0,4,4,之前一直害怕挂科的c程拿了4.5 作为一个文科生很满意了 谢谢老师
57247,313,方宁,2017-07-06 06:29:11,0,1,1,老师长得很帅，上课也没有小测点名那些东西，人很好，给分也还可以
57270,313,方宁,2017-07-06 10:16:48,-2,3,5,良心老师啊！！！良心老师啊！！！平时3次作业补交2次没交，实验题只做出来一个，理论题大概不到75，以为要挂了，最后成绩居然3.5+！！良心老师！，赞一个
57312,313,方宁,2017-07-06 14:21:40,4,5,1,事多分低，别选
58956,313,方宁,2017-09-19 01:05:50,0,0,0,不点名所以我c程后来就不去了，全靠自学，反正听他讲了还是要自学。给分全看考试。
59041,313,方宁,2017-09-19 07:41:16,3,3,0,很难受
60692,313,方宁,2017-10-27 00:54:33,0,0,0,老师讲得挺好，但是作业也太多了点吧！！！！！！！！！
61178,313,方宁,2017-11-10 03:11:07,0,1,1,不错的
64380,313,方宁,2019-01-03 02:46:18,-112,7,119,老师给分不好，平时作业认真做，考试自认为全对，结果只有99
64737,313,方宁,2017-12-27 04:08:09,1,1,0,老师的C程很好啊~上课都是干货，满满的都是知识，讲课调理也很清晰，很容易懂，事情虽然比较多，但是如果好好完成的话4.8+，给分也很好！
65928,313,方宁,2018-01-10 09:34:58,1,1,0,超喜欢
66020,313,方宁,2018-01-11 03:31:38,28,42,14,方老师这学期已经改变了。作业都是全讲完才布置。老师人很好，上的大计基也比较有趣。错过作业提交时间发邮件给他他都会网开一面的。
68375,313,方宁,2018-01-23 05:31:05,13,15,2,刚开始看到评论说作业多有点怕，但是这学期似乎我们班事情最少？老师很体谅大家，人很儒雅，虽然大计基基本没怎么听懂，分也没出，但是还是很喜欢老师了。
69700,313,方宁,2018-01-25 08:39:02,8,12,4,老师人很好啊，长得帅也挺体贴的，尽量不给学生额外的工作。但重点是，大学计算机科长与基础这门课真的很垃圾！！！！！！这不是老师的问题。教材编得就烂，与计算机小白菜们的实际水平是脱节的！绝对没有我初高中用的信息技术课本好。老师讲的也太专业了，那些专业术语或者例子之类不会予以介绍就直接引用来讲了。期末备考时你会发现这门课有多烦。另外，对大多数学生来说，这绝对是除了微积分线代以外最容易挂的课。如果你的培养方案里没要求这门课，就别选了，因为这门课真没多大用。
73464,313,方宁,2018-02-01 15:06:57,1,5,4,综合来看，是大计基事情最少的老师。
73671,313,方宁,2018-02-02 13:19:47,1,1,0,过分一般般
73690,313,方宁,2018-02-02 16:27:42,0,2,2,哇讲的水作业多给分差，不知道查老师评分给他及格的意思是?
73739,313,方宁,2018-02-03 04:58:19,0,3,3,前辈的话要听，不要随便信一些工科大佬的话，说什么很简单啦你们不会都是渣渣啦，老师讲的确实一般，课程本来就枯燥你要讲得多生动都是做梦。还有，平时作业是真！的！狗！多！百度不如题库。对文科生来说就是绩杀。
74154,313,方宁,2018-02-05 23:31:12,-7,1,8,给分不是特别好
74601,313,方宁,2018-03-04 13:43:02,3,4,1,老师这学期留作业跟以前评论里面比已经很好了，而且有问题都会及时邮件回复，讲课也有自己的思路，很好的老师
74832,313,方宁,2018-03-06 05:14:46,0,1,1,老师的课负担真的不重，课后多看看书，主动权还是在自己的。
75565,313,方宁,2018-03-13 10:57:39,1,2,1,作业多&烦，上课无趣，文/社科遇上工科大佬就GG吧。
76129,313,方宁,2018-03-27 11:18:45,4,4,0,绝了，课后作业永远是预习作业，有时候还跳一章两章这样来的
76420,313,方宁,2018-04-08 23:49:59,2,2,0,我觉得所有djj老师的课都大差不差吧，方老师作业比其他班来说真的不多，期末自己对书复习吧，不管听谁的课都听不懂的hhh
76432,313,方宁,2018-04-09 06:16:13,0,1,1,老师挺帅的，java嘛，没怎么听?
76782,313,方宁,2018-08-25 01:20:05,0,5,5,给分好，期末上机考也不难，平时需要多练，考试四道题都做出来了，满绩
84173,313,方宁,2018-07-12 07:23:16,0,2,2,爱老师，竟然满了！
84182,313,方宁,2018-07-12 07:38:08,0,1,1,虽然上课听不懂，但是。。。结果出乎意料，老师挺温柔，挺帅的
84209,313,方宁,2018-07-12 08:36:45,4,5,1,第一次知道原来平时作业每次都做，(虽然有不会的，平时分竟然可以给不及格的...
84240,313,方宁,2018-07-12 10:23:10,-15,3,18,Python考试超简单 妥妥满绩
84248,313,方宁,2018-07-12 10:37:23,0,1,1,给老师发邮件总是很快回复解答，上课氛围很舒服。本来以为Python大佬太多可能被正态很多，结果跟预期的差不多呢。不过Python真的靠自学?
84412,313,方宁,2018-07-12 21:34:02,1,1,0,python讲的很不错，给分也很好
84557,313,方宁,2018-07-13 07:29:11,1,2,1,老师长得帅，给分给的好
85763,313,方宁,2018-08-04 08:54:57,1,2,1,方老师最后给分超级好得
88083,313,方宁,2018-10-22 03:01:23,1,4,3,老师很好
94764,313,方宁,2019-01-18 05:38:34,3,6,3,老师人很好，高个子也很帅，虽然偶尔上课有一点点无聊吧，我有时候会睡着，但是内容很实用，老师也会幽默一下。老师会写诗，心态也很好。总之上课体验不错，我比较喜欢的。不知道为什么评分只有7.8，我认为可以打9分的，这个评分也不大准，我的信电导论课老师有8分，但是课堂体验简直一坨屎? ，而方宁老师的课则比较不错的
101851,313,方宁,2019-01-29 09:34:17,2,3,1,人不错，就是怎么还不出分呢……(手动捂脸)
102219,313,方宁,2019-01-31 13:00:13,3,5,2,【C程】老师蛮宽松的，上课基本不会点名，平时作业给留很多时间，回复邮件还算及时，但是对自学能力要求比较高，而且C程期末真滴难啊嘤嘤嘤(ಥ_ಥ)
102221,313,方宁,2019-01-31 13:12:51,2,6,4,给分很差，水平一般的不要选，考试难也不调分，挂了很多，而且还扣平时分，绩杀不解释，绝壁不要选
102230,313,方宁,2019-01-31 13:55:13,3,5,2,幽默、和善、负责的老师，还挺善解人意的～我一个小白上他的C语言课体验很不错！
102474,313,方宁,2019-02-03 06:14:32,-8,2,10,老师现在已经不会提前布置作业啦！
102883,313,方宁,2019-02-24 14:43:52,12,18,6,上课专注于讲解丰富的人生哲理，期末考了88，作业全交，给我最后成绩78，呵呵
103451,313,方宁,2019-03-05 12:54:49,4,9,5,作业真的狗多。\n\nPython
103916,313,方宁,2019-03-07 07:53:58,2,6,4,Python什么都没讲就让编程。。。。慎选。。
104007,313,方宁,2019-03-09 08:44:43,4,10,6,没有人情味
105355,313,方宁,2019-07-05 05:43:05,5,7,2,出分巨慢
105763,313,方宁,2019-04-20 06:48:32,-5,4,9,Python留那么多作业也就算了，还不会做。他什么都不讲。在考试周布置了超多作业，还让不让复习了。。。。。超后悔选这个老师
113293,313,方宁,2019-07-06 04:15:07,0,0,0,出分的确慢
113420,313,方宁,2019-07-06 17:13:35,6,8,2,老师还算负责吧 成绩也确实和努力程度相符 顺带夸一下超级认真负责的助教gg
113528,313,方宁,2019-07-06 23:06:47,4,5,1,老师很帅，助教哥哥非常有耐心！
113539,313,方宁,2019-07-06 23:22:21,4,6,2,老师挺好的，就是讲课有点。枯燥。不过老师非常负责，作业虽然比较多，但是多练习对成绩是有好处的。助教小哥哥超级负责，超级负责，超级负责，重要的事情说三遍！期中测试考得并不好，但从总评来看平时分应该是给满了，而且比自己算的上限还多了一点点不知道是怎么回事?（python）
113613,313,方宁,2019-07-07 01:14:14,4,7,3,老师人很帅，老男人大叔嗓
115416,313,方宁,2019-07-22 09:49:38,2,3,1,对编程没兴趣同学慎选，老师讲课比较学究，主要靠自学，期末考试不调分但也不正态，考多少是多少，想水的同学别做梦了，c程理论不太扎实3.9，Python认真复习了一下理论就满了。
125267,313,方宁,2020-09-05 04:58:20,15,27,12,问一下老师捞不捞人
128637,313,方宁,2020-12-25 01:47:36,0,1,1,前人的血泪教训 快逃 第一次在查老师给差评
129351,313,方宁,2021-01-04 12:08:19,0,1,1,太绝了，说有问题的时候都可以发在群里问，结果一点回复也没有，还在上课嘲讽说上课不来怎么会知道，如果上课讲得清楚我还需要问吗？？大计基讲的真的水 老师水平是有的，就是上课真的不行，而且绝对绝对不会捞人
130113,313,方宁,2021-01-17 07:55:32,-21,1,22,呵呵。理论题不过55平时分一分不给。
133020,313,方宁,2021-02-06 09:57:15,4,4,0,想不想来感受一下中年老男人的魅力！老师真的挺帅的。
133094,313,方宁,2021-02-08 04:21:33,2,2,0,老师人还蛮好的，就这门课的话...还是自学吧
133586,313,方宁,2021-03-02 10:49:11,3,5,2,大计基，一学期没点名，说好的两次小测都没进行，把小测的分数全班给满233
136899,313,方宁,2021-06-28 02:28:50,2,3,1,python课讲的不清晰\n\n最让人窒息的在于他会偷偷修改交作业时间，明明30号交变成28号，晚上11:30交的作业变成晚上6:30\n\n就很无语
137061,313,方宁,2021-06-30 07:52:24,7,9,2,python作业题目多，大部分是超前的，基本靠自学，不指导复习，考试那天还有三章的作业不给答案，可以说全靠自己学习
137078,313,方宁,2021-06-30 13:40:51,1,1,0,老师完全不想点名的样子。。可能来的人1/3都不到都没点名。讲的很不错，还会有拓展，就是前期慢了点后期可能会有点刺激
137966,313,方宁,2021-07-07 02:25:57,-3,2,5,疫情那学期上的py，老师讲得还可以（跟我室友的老师比）\n\n暑假一直开放PTA给我们练习，考试成绩没调分，最后考得还不错~\n\n看到评论很多骂老师的 刷一条高分嘤嘤嘤
139081,313,方宁,2021-07-12 13:40:44,0,2,2,谢谢老师捞我！！！
140668,313,方宁,2021-09-15 03:27:34,-1,0,1,上课划水，作业全靠自学，找半天，真就啥也没学到
141773,313,方宁,2021-10-25 07:46:23,0,0,0,太水了
144174,313,方宁,2021-12-20 06:05:47,3,4,1,水是真的水，事是真的多
144815,313,方宁,2021-12-24 09:29:31,0,0,0,计基事情是真的多啊…思科，实验，报告，期末了还被作业打压.jpg
144994,313,方宁,2022-01-07 06:13:36,6,8,2,快逃，大计基A他期末留ppt大作业，别的没有，作业真是tm的多啊，讲的还p用没有，考试全靠自己，作业就会恶心人，留得有多又恶心，真是无语了，给分还奇低
145319,313,方宁,2021-12-29 04:05:58,2,4,2,方老师负责确实是很负责 \n\n大计基作业是真救命的多、、、各种平台都有作业、、嗯可能是别人的两三倍吧、、、、
145331,313,方宁,2021-12-29 05:20:30,1,1,0,事情很多，讲课很水，基本全靠自学。\n\n但老师人挺好的，唉
145548,313,方宁,2021-12-30 08:11:49,1,2,1,平衡一下，虽然事确实很多，但老师人真的很好。
145783,313,方宁,2022-01-02 07:03:17,2,3,1,老师从不点名，有种中年男人的魅力。但是djj不知道是课程的原因还是他的原因，完全听不懂如果没有计算机方面基础的话。期末刷题库就完了。
147810,313,方宁,2022-01-11 02:29:15,2,2,0,作业多
149934,313,方宁,2022-01-18 01:48:55,0,3,3,事好多啊，补交一次就直接扣20％
149974,313,方宁,2022-01-18 06:27:58,8,10,2,说真的，这是我最认真的一次点评，我觉得方老师真的是一个好老师。说他作业多的，你扪心自问，一个星期，平时就留半个小时到一个小时的作业，两个星期一次实验作业，每次两个小时内肯定搞定，期末也就一个PPT。而且，方老师是真的尽心尽力，有问必回，好几次都是深夜回消息，还要不断开放已经过时的作业，最后甚至全部开放，只扣百分之二十，别的老师，我觉得应该是做不到，给分从我们的群来看，应该还是不错的，至于上课水，好好听还是有很多收获的。
150016,313,方宁,2022-01-18 09:44:45,2,2,0,课后作业很多，主要靠自己学。不过老师人很好，作业会延后，人很帅
150399,313,方宁,2022-01-24 10:55:16,6,8,2,从不点名，没有小测，作业按课程组要求来还会适当延后，期末开放补交通道（-20%），期末会给题库，我一次课也没去，期末考前翻了遍目录做了下题库就有91/4.5。
150425,313,方宁,2022-01-25 04:42:38,3,3,0,作业按时做，善用搜索，期末做做老师的模拟题，背背缩写，看看书，两天速成4.8，大计基本来就是烂课，感觉方老师比以前通情达理多了。
151745,313,方宁,2022-03-14 12:12:22,1,1,0,老师很好，讲课挺认真的，虽然作业有点多但是截至时间长，如果有人错过交作业的时间，老师也会再次给机会。
152006,313,方宁,2022-03-23 02:53:15,2,5,3,这个老师是真的不好，一点没素质，完全不考虑学生
153925,313,方宁,2022-05-17 04:01:38,0,1,1,python讲的很不错，就是不捞人而已啊，各位不要乱评，该讲的都会讲清楚的，挺好的老师。
154564,313,方宁,2022-06-02 06:51:40,0,1,1,Python程序设计，体验很好，老师讲课很好
158073,313,方宁,2022-06-26 16:40:17,1,2,1,emmm好久前上的，感觉pta经常提前上课内容好多布置，做的很心烦，给分也不好！
158721,313,方宁,2022-07-02 14:16:31,0,0,0,感谢老师捞我！
158824,313,方宁,2022-07-02 12:49:39,0,0,0,一般般
160520,313,方宁,2022-09-25 13:35:32,2,3,1,到期末了还要做他那个大作业就离谱
168077,313,方宁,2023-01-26 02:45:14,2,4,2,谢谢老师，上课基本没听，最后看PPT和PTA有4.8
169334,313,方宁,2023-02-25 12:32:43,0,2,2,事情比较多，作业量太大。给分中等。
172053,313,方宁,2023-04-18 06:46:50,0,1,1,讲课很一般，但是给分感觉还行，他说自己会调分的。\n\n小测很简单，都是作业原题。有次期中，最好平时打好基础，不然会有难度
173317,313,方宁,2023-05-18 13:25:38,-1,1,2,哦，呕吐送cnm的煞笔不
174358,313,方宁,2023-06-10 13:50:06,1,1,0,讲课缺乏激情，比较平淡，容易走神\n\n平时作业不算太多\n\n不会点名，可能会捞人
174588,313,方宁,2023-06-14 09:38:18,2,2,0,我觉得老师人非常好哇 全宿舍都学python 我了解了一下方老师是作业、小测都比较少且简单的（小测就是原题 做了作业就会了 再不济开小测前背一背答案嘛～）老师虽然吓唬我们要点名，但其实不管人来的多少都没点（不过还是建议大家能来，老师会因为人来的太少有点伤心www）老师上课讲的没那么清晰，不过我感觉python最终都是靠自学hh 我自己没有拿多高的分数 但是觉得方老师很照顾学生也很尽责
177654,313,方宁,2023-07-04 05:38:02,2,2,0,不捞，不调分，给分求是，编程期末少做一个题扣四分
177838,313,方宁,2023-07-05 03:35:50,-2,0,2,不错的老师，没有评论说的那么差，事情很少，小测原题，从不点名，只要努力就会有好结果！！实验题错了一题还有93 很满足了！！
193103,313,方宁,2024-06-03 14:04:59,0,0,0,中肯评价，从不点名，小测简单，还取最高分，教学上可能有些无聊，但是对于大多数想水通识编程的同学们绝对是很好的选择，期末突击过个小测没问题，老师也会捞
234,329,杨颖,2015-03-14 17:17:44,-2,4,6,满满干货，就是常常get不到重点…
1255,329,杨颖,2015-03-21 17:06:10,2,4,2,很不水是真的。但是上课比较无聊，认证听还是有比较大的收获。
10729,329,杨颖,2015-11-23 03:38:25,17,30,13,很讨厌的老师，完全听不懂她在说什么，还作业一大堆
31706,329,杨颖,2016-07-04 14:22:15,4,6,2,杨老师很好，讲课很有趣
36318,329,杨颖,2016-11-11 23:46:44,9,15,6,听不懂在讲什么，但是老师人很有趣……课炒鸡水 学不到什么 作业炒鸡多
36685,329,杨颖,2016-11-15 11:27:48,13,17,4,老师人很好，超爱笑，虽然完全get不到她的笑点…每节课都迟到，但是据说是家里有状况，比较减分的一点就是你完全无法理解她的作业要求，是的，你都听不懂她要你做什么作业………每次都是展示完了才懂她要我们干嘛…
37049,329,杨颖,2016-11-17 07:36:40,5,8,3,……老师人很好玩，挺可爱的。擅长拔刀，diss人在无形之中……就是课有点水，学不到什么东西……有人说搞不清作业要求是真的，期末作业总结发的要求是真的看不懂，只知道一共需要画几张……
38636,329,杨颖,2016-12-13 03:51:55,7,9,2,老师人超级可爱，思维很年轻的大妈，其实课要是仔细听是讲的挺好的，也就是最后作业有点多……\n\n
49655,329,杨颖,2017-04-22 06:11:30,3,6,3,学不到什么东西
64113,329,杨颖,2017-12-21 04:01:12,4,5,1,给分很好！就是作业比较多orz
76724,329,杨颖,2018-04-19 06:33:01,12,15,3,上课巨水 作业巨多 而且自己特别好意思布置下来 这个老师我是服了 不管绩点好不好 首先整个学期的学习过程就让人享受不起来了
89385,329,杨颖,2018-11-19 02:05:33,4,4,0,和老师的笑点不在一个频道上......以及老师很喜欢丝巾
90606,329,杨颖,2018-11-24 13:47:38,5,8,3,老师很可爱。虽然有时候觉得真的讲得很玄乎，作业也挺多挺繁的，但是一个学期下来真的能收获很多东西。期末要求把作业整理成作品集，虽然一下子感觉会感觉很麻烦，但是做完很有成就感。给分也很好，喜欢她。
90828,329,杨颖,2018-11-26 10:46:17,4,7,3,老师超级超级超级超级超级超级可爱！作业做得认真一点给分就很好！我吹爆杨老师！
104255,329,杨颖,2019-03-25 01:01:53,1,2,1,无语了
104859,329,杨颖,2019-03-29 02:35:03,6,8,2,-老师这个作业多久交？-我无所谓的，随便你们，期末交都可以。10min后 -这个作业啊，一周之内交吧。 20min后 -在下周一之前把这个作业交上来啊（现在星期五） ？？？
105198,329,杨颖,2019-04-07 11:37:35,6,9,3,老师能不能说人话？布置作业也要长篇大论的，实在搞不懂作业要求，弄清楚要做什么比做作业难多了
118711,329,杨颖,2019-10-31 02:59:28,1,3,2,傻逼，无语
120184,329,杨颖,2019-11-18 04:01:57,0,2,2,水的一批 作业还多 给分还差
123070,329,杨颖,2020-05-08 03:21:12,11,13,2,每节课都能成为“骚包”计数君
133940,329,杨颖,2021-03-10 07:42:56,5,6,1,不愧是pr的学生
134428,329,杨颖,2021-03-28 06:42:23,7,8,1,真的受不了啦！讲课讲的是啥自己也不知道，作业多到离谱！要求么问一节课也问不明白！兄弟们！和我提刀血洗月牙楼吧！！！
134605,329,杨颖,2021-04-05 05:05:39,0,6,6,如果上她的课和吃💩都能拿这个学分，那我选择吃💩。
144043,329,杨颖,2021-12-16 16:14:13,2,3,1,写她的作业写到破防了，根本就看不懂要求。。。
144780,329,杨颖,2021-12-23 14:36:33,4,5,1,课确实水，但是跟杨妈聊天能学到很多东西。\n\n比如如何跟人相处，如何拿捏男朋友，如何拿捏下属和上司。\n\n她会很开放地分享她的工作经验，说她的项目经历。\n\n我还是第一次遇到对待学生如此真诚的老师。
153470,329,杨颖,2022-04-30 15:09:38,2,2,0,不管怎么说，，给分真的好
155624,329,杨颖,2022-06-14 18:01:27,1,1,0,我的超人 人均4.5+
192314,329,杨颖,2024-05-15 01:09:34,6,6,0,上她的课是我活该的，上课永远的不知所云，作业要求永远的讲不清楚，自诩精英却连话都讲不清楚，只感受到精英的傲气
139741,336,邵健,2021-07-22 11:53:41,5,5,0,纯nt，项目实训乱搞，我吐了
139742,336,邵健,2021-07-22 12:07:50,4,4,0,真的脑瘫，项目实训只会浪费学生时间，人蠢话还多，必修课还耽误实习，怎么会有这么傻逼的课和老师
139743,336,邵健,2021-07-22 12:08:51,2,2,0,纯脑瘫属于是，最后一天才说要展示一个小时，我做你吗的ppt
139744,336,邵健,2021-07-22 12:13:40,1,1,0,满嘴跑火车，项目实训纯恶心人，真的脑瘫
139745,336,邵健,2021-07-22 12:20:25,1,1,0,不知道项目实训在搞什么东西，最后一天突然说验收答辩药一个小时，自己屁事没干让几个组互相评价，服了，和xw一样都是nt
139746,336,邵健,2021-07-22 12:21:29,1,2,1,隔壁学院闻名而来，听说十分愚蠢，看到班级群都在阴阳，也不知道这老师干嘛来的\n\n爷也去过教室，热得要死，老师没人，学生累死，没有休息，不如翘课，王者吃鸡，原神b站，高铁飞机\n\n自己不参与评分也太离谱了，ddl前随意修改展示要求也太离谱了，这要是在本学院得被冲烂了…总之听同学描述，给爷听吐了
158435,336,邵健,2022-06-29 08:59:33,2,2,0,项目实训这课的开设时间点纯是来捣乱的，而且内容本身也毫无价值可言。大胆猜测设置一堆乱七八糟的形式主义规定不过是为了掩盖老师不懂技术而无从教起的事实罢了。\n\n正确的做法并非把项目实训改为线上，而是应该彻底取消，如果更负责任一点的话应该把其他类似的相关课程也一并扫进历史的垃圾堆。
159271,336,邵健,2022-07-10 07:52:53,0,0,0,怎么还有3分
159273,336,邵健,2022-07-10 08:37:46,2,2,0,剑冢，你妈什么时候死？
213327,336,邵健,2025-01-17 03:22:51,0,0,0,软工管普通吧 没有那么烂 但也不怎么样
1031,348,徐镜春,2016-12-19 15:45:33,19,44,25,人超好！很负责！！
1039,348,徐镜春,2015-03-21 13:03:33,18,60,42,大计基选上他的就是作死
1474,348,徐镜春,2019-08-19 08:56:05,12,29,17,很有条理，很清楚，很负责的一个老师！
1639,348,徐镜春,2015-03-23 04:49:40,0,5,5,讲的很清楚
2951,348,徐镜春,2015-05-11 13:15:55,6,11,5,人很好虽然我自己有时候作业不太会做
5516,348,徐镜春,2015-07-08 04:27:06,7,12,5,讲课有趣，但是我有时会玩手机。
7767,348,徐镜春,2015-09-15 13:08:00,6,11,5,大计基上得挺好的呀，很萌的一个老头
8814,348,徐镜春,2015-09-28 06:56:29,0,5,5,很好的老师，懂得理解学生
9369,348,徐镜春,2015-10-25 09:08:07,4,17,13,选了就等死吧
9841,348,徐镜春,2015-12-02 03:17:35,2,6,4,人不错
9896,348,徐镜春,2015-11-12 11:18:48,0,9,9,事情多得要死，上机实验数目超多，别人都几乎没有上机实验
12200,348,徐镜春,2015-12-22 09:54:55,6,15,9,超级古板，课超级无聊。上机实验烦死你
12863,348,徐镜春,2015-12-24 07:00:21,0,3,3,这老师怎么看人吧。
13084,348,徐镜春,2015-12-24 23:03:11,17,23,6,程设讲的挺好的，不过据说大计基比较坑
13906,348,徐镜春,2016-01-02 07:01:27,2,6,4,人很好呀\n\n
13931,348,徐镜春,2016-01-02 12:11:28,6,9,3,无趣的很
14077,348,徐镜春,2016-01-04 06:09:43,13,19,6,大计基事超多，别选
14078,348,徐镜春,2016-01-04 06:10:06,7,15,8,作业太多千万别选
14092,348,徐镜春,2016-01-04 08:19:52,16,34,18,一学期上下来 七个实验+报告；16个上机、测试题 ；两次读书报告；三次小quiz\n\nboy or girl 你知道接下去怎么做了
14113,348,徐镜春,2016-01-04 10:56:22,4,8,4,偶尔以作业的形式点名
14121,348,徐镜春,2016-01-04 13:54:53,0,4,4,逻辑混乱
14964,348,徐镜春,2016-01-11 09:45:04,10,14,4,徐镜春数据结构讲的挺好的\n\n
15276,348,徐镜春,2016-01-24 09:11:31,2,4,2,挺好的老师
15327,348,徐镜春,2016-01-18 15:10:51,-2,2,4,挺好的。
17107,348,徐镜春,2016-01-19 15:07:50,9,17,8,虽然不上他课，然而听说今年是他提议了大计基考试改革。。。我就上来拉拉分了
17110,348,徐镜春,2016-01-19 15:09:02,4,12,8,没上过，然而听同学说深坑
17113,348,徐镜春,2016-01-19 15:10:54,11,20,9,据说是他给大计基题库里加题的，而且缩短了考试时间，狗带
18259,348,徐镜春,2016-01-24 01:05:30,2,5,3,绩杀。
19286,348,徐镜春,2016-01-23 22:40:40,-4,9,13,大计基平时作业虽然多（还是挺有用也蛮好玩的），但是上课还是挺有意思的，算法那一章还有加密讲得挺有意思，学到了.最后给分很好.
19368,348,徐镜春,2016-01-24 03:24:59,2,5,3,人挺好。
19524,348,徐镜春,2016-01-24 13:37:37,4,7,3,引导式教学。上课可能没什么重点，但是会有bonus开阔视野
19614,348,徐镜春,2016-01-25 02:58:11,6,7,1,上机实验超多啊啊啊啊超多报告要写真是烦得要死。上课也是无聊死了，听着听着就想睡觉
20001,348,徐镜春,2016-01-26 01:15:31,13,19,6,真的是 绩杀
20305,348,徐镜春,2016-01-27 03:18:22,3,5,2,大计基选了他就是作死
20385,348,徐镜春,2016-01-27 09:47:34,6,8,2,事情多的要死实验超级难做上课无聊给分低
21103,348,徐镜春,2016-02-17 07:59:49,9,22,13,讲得还行。作业绝对是所有计科老师里最多的，而且比别人多好多。各种报告各种实验，事太多，关键还绩杀。慎选
21171,348,徐镜春,2016-02-25 03:21:29,2,3,1,你猜呢
21740,348,徐镜春,2016-03-01 02:43:21,7,8,1,他说作业缺了一两次是没什么的，然而最后还是挂了。
22064,348,徐镜春,2016-03-02 08:34:11,6,9,3,事情巨多实验超麻烦和考试完全无关给分差讲课不做评论因为不能集中注意听~
22996,348,徐镜春,2016-03-16 02:41:29,-2,5,7,渣，程设烦，讲课差
23579,348,徐镜春,2016-04-07 03:36:31,6,8,2,作业多到你怀疑人生::>_<::
26261,348,徐镜春,2016-06-16 12:19:34,4,6,2,大计基确实事多，但是好好学了不至于坑啊。而且老师态度很好讲得也还可以，求不黑。
27008,348,徐镜春,2016-06-22 06:46:56,4,8,4,一个字：坑！\n\n大计基被坑了
28094,348,徐镜春,2016-06-28 08:06:11,0,0,0,讲的很不错，作业还可以
28538,348,徐镜春,2016-06-28 09:58:53,-1,0,1,很认真，很有意思
30327,348,徐镜春,2016-07-01 09:24:11,3,4,1,数据结构讲的还可以
31448,348,徐镜春,2016-07-04 02:26:23,6,10,4,腊鸡老师 C程都做出来了 给什么破分
31456,348,徐镜春,2016-07-04 02:37:32,-1,2,3,事虽然多，但是给分不错啊，反正也都是靠自学的
31626,348,徐镜春,2016-07-04 09:35:26,-1,3,4,上课确实很笼统但是给分蛮好
31938,348,徐镜春,2016-07-05 08:02:52,2,4,2,讲挺好，事儿特多，绩杀
32288,348,徐镜春,2016-07-06 05:50:11,0,2,2,讲得很好，很有条理，但给分不高
32610,348,徐镜春,2016-07-08 04:49:22,2,3,1,不知道大计基怎么样，c大程还好。
34136,348,徐镜春,2017-06-17 14:05:22,-8,4,12,事情多，不尊敬学生。
34284,348,徐镜春,2016-09-30 00:29:46,0,2,2,作业贼烦
34362,348,徐镜春,2017-01-11 08:15:07,66,97,31,可能这个老师讲课不好作业较多 但是老师人绝对是个善良和蔼的人，你问的所有问题都会详细解答。作业可能多了点，规则可能繁琐点，但是人是真的为学生找想的那种老师。
34523,348,徐镜春,2018-01-05 02:36:41,-10,10,20,不配为人师
35250,348,徐镜春,2017-01-10 08:22:04,22,29,7,可爱一老头
37111,348,徐镜春,2017-01-04 12:48:07,1,2,1,
37801,348,徐镜春,2017-07-03 12:08:24,9,14,5,老师讲的很有趣！而且很负责任'欢迎大家积极选课
39992,348,徐镜春,2017-01-22 12:10:28,0,4,4,辣鸡！
40029,348,徐镜春,2016-12-29 01:31:59,40,50,10,什么是最好的老师呢？就是像徐老师这样，负责任，希望学生学到更多东西。喜欢认真的老师，一味追求事少分高的同学谨慎。。
40240,348,徐镜春,2017-01-19 02:06:11,0,3,3,给分垃圾。。估计是把所有人分往下调了
41016,348,徐镜春,2017-01-08 05:16:00,6,7,1,数据结构讲的还不错啊 挺可爱的老师 平时作业也还好吧 成绩还没出来 不知道给分怎么样
42440,348,徐镜春,2017-01-14 08:30:14,4,7,3,认真听就很有意思 老师是一个暖男 喜欢！
45356,348,徐镜春,2017-01-19 12:38:26,9,9,0,数据结构基础 讲得挺细致 上课也不算无聊 问问题时也会认真解答 点赞～最后的成绩平均可能不如其他老师 但也对得起自己
45785,348,徐镜春,2017-01-20 05:37:11,0,0,0,老师怎么还不出成绩呢
45961,348,徐镜春,2017-01-20 10:53:15,1,2,1,大计基给分神坑，不知道这个均绩是怎么来的
45967,348,徐镜春,2017-01-20 10:04:50,0,1,1,课上的一般吧节奏还行不知道为什么给分特别低完全脱绩点明明认真上课认真做作业认真复习了
45969,348,徐镜春,2017-01-20 10:08:44,1,3,2,作业超级多，给分超级低，嗯，知道自己的命运了吧
46032,348,徐镜春,2017-01-20 12:40:31,1,1,0,虽然事多 但是会调分的\n\n哈哈哈哈哈哈哈哈哈哈哈哈哈哈哈哈哈哈哈哈
46058,348,徐镜春,2017-01-20 14:01:14,7,12,5,大计基没有前面说的那么差呀，虽然老师上课有点无聊，但是像这种课本来就没多少人听的，至于作业和实验，据我所知所有老师都差不多，也没有特别多多少啊，像这种课主要还是靠自己，不努力还想拿高分，怎么可能
46064,348,徐镜春,2017-01-20 14:11:22,1,4,3,基本没听过课 老师其实还蛮可爱的 虽然我差点挂了
48061,348,徐镜春,2017-02-28 08:03:42,-3,0,3,作业太多 给分太差
48204,348,徐镜春,2017-03-01 07:52:56,0,2,2,选上不死 算我输
49355,348,徐镜春,2017-04-07 07:08:47,2,4,2,作业真的超级多，多到怀疑人生→_→\n\n而且布置的都是些你看不懂，写不到的题。。。\n\n
55430,348,徐镜春,2017-07-01 13:12:46,1,1,0,选过的课里，事情最多的老师。
57212,348,徐镜春,2017-07-06 04:50:06,1,2,1,呃。。。其实平时分给的还不错的，期末考的好还可以覆盖期中考
57225,348,徐镜春,2017-07-06 08:30:14,10,12,2,数据结构基础上的不错，满了。高级数据结构与算法分析课难、有几个project难、考试太难，pj的助教评分似乎都是按满分给的，多做的pj全都按2分一个bonus给的，最后总评还不错。老师对课程内容很熟悉，偶尔还有一点小幽默。
57580,348,徐镜春,2017-07-10 04:10:23,-1,0,1,给分比较尴尬
58959,348,徐镜春,2017-09-19 01:16:50,3,4,1,hlq课上的死胖子怎么跑这来了\n\n
60559,348,徐镜春,2018-01-09 01:53:54,16,22,6,评分只是作为参考，因为往往是成绩差的人打低分，好的人打高分，这是不可避免的。作为对这门课零基础的人，学习这门课算是用心了，但是问他问题的时候，老师却没有耐心给你讲。可能是因为我的问题太简单，太低级了吧。但不是所有人都是有基础的。一学期下来，大部分知识只靠自学，最后成绩很不好。我觉得自己一学期的努力白白浪费了。最后说一点，没有基础慎选。
60924,348,徐镜春,2017-11-03 02:22:40,3,3,0,事超多，还喜欢突击测验，坚决不要选啊
60925,348,徐镜春,2017-11-03 02:22:58,0,1,1,事情多 有随堂kuiz 作业基本靠自己去上网站发现
62427,348,徐镜春,2017-11-25 07:19:16,3,4,1,上课没意思，作业多，而且自己不把作业说清楚，作业要求含糊，根本不知道怎么做，真想打零分
63365,348,徐镜春,2017-12-01 16:12:52,0,1,1,为什么作业这么多还麻烦，上交还要用别的软件
63492,348,徐镜春,2017-12-05 07:15:41,3,3,0,作业多  但是人很好
63522,348,徐镜春,2017-12-06 02:53:32,3,4,1,Ds课讲的很有激情很清楚啊
64140,348,徐镜春,2018-02-02 04:36:55,4,5,1,ds还行
64356,348,徐镜春,2017-12-23 02:04:32,4,4,0,上课十分生动，看得出是对计算机很有激情的好老师……但是大计基让我头疼的是作业基本得自学...（太耗时）——到崩溃。
65041,348,徐镜春,2017-12-28 10:29:22,-2,0,2,超差的～～～～
65109,348,徐镜春,2017-12-29 02:16:04,3,3,0,我觉得大计机并没有评论里说的这么差啊
65183,348,徐镜春,2017-12-30 08:19:11,3,3,0,作业多，而且需要你用各种方法找作业到各个地方交作业。作业要求描述的我特么还看不懂。醉了。
65386,348,徐镜春,2018-01-03 13:40:26,0,2,2,大计基事情超级多，而且老师不拉群，作业布置了都不知道有啥作业，讲作业也讲得不清楚。而且老师的理论 你不知道作业是什么就是你翘课了。
65583,348,徐镜春,2018-01-06 13:51:39,0,2,2,程设真的还可以
65692,348,徐镜春,2018-01-08 08:54:03,4,6,2,作业超多...每天都在追赶大计基DDL\n\n但是用心做还是能学到东西的。老师很负责任，感觉他是真正希望学生能学到东西的。追求事少的慎重
66591,348,徐镜春,2018-01-17 11:57:27,1,3,2,我这个学期就上了他两节课\n\n
67436,348,徐镜春,2018-01-21 07:56:48,9,10,1,好老师，鼓励选
68609,348,徐镜春,2018-01-23 12:59:36,14,22,8,如果你想多学点东西，建议选徐镜春老师。因为他有期中考（不水），还有bonus ，认真做下来收获很大，还有N次练习题...想水的建议别选    。人挺好的
70047,348,徐镜春,2018-01-26 04:55:32,3,4,1,就希望大计基别挂，，，其他别无所求。。。。。??????
70861,348,徐镜春,2018-01-30 04:01:43,3,10,7,感谢徐镜春老师！！！C程满绩
70922,348,徐镜春,2018-01-28 00:23:00,0,1,1,就希望大计基别挂，，，其他别无所求。。。。。??????
71631,348,徐镜春,2018-01-28 19:34:56,3,4,1,大计基只求不挂…\n\n一整个学期没建微信群，啥都不知道只能问同学；作业十分奇特，计算机小白平均每个作业6小时，至少为机房奉献了30元；期末考试什么复习重点都没给，考试的时候觉得学的很认真也不会-_-||基本全靠自己摸索…\n\n也不是说老师人不好，还挺和蔼的，但就是教学方法出了点问题，明明很想教会我们，但我们还是啥也不会-_-||\n\n大计基只求不挂…
72368,348,徐镜春,2018-01-30 03:42:19,1,2,1,老师特别特别特别萌 群里的表情 让你发现一个不一样的徐老师 不错的老师 希望你学到东西 讲解也耐心
72438,348,徐镜春,2018-01-30 06:27:38,2,2,0,。。。。
72689,348,徐镜春,2018-01-31 01:39:22,2,3,1,大计基老师都不遭人待见，老师人还不错，课是很讨厌，过了就好，成绩什么的咱不在乎！
72750,348,徐镜春,2018-01-31 04:32:44,2,4,2,上的大计基，并...没有觉得是绩杀。这个学期作业和别的班比也没有更多啊，认真做也要不了多少时间。老师上课水平还是可以的吧。
72821,348,徐镜春,2018-01-31 06:32:39,0,1,1,我上课也没听 但是期末把知识点捋了一遍 考的不错 分还可以
72983,348,徐镜春,2018-01-31 13:22:26,2,3,1,其实老师是很不错的，认真负责，可能要做的作业有一点复杂，至于给分，个人觉得意料之中，没有特别满意，也没很不服气
73072,348,徐镜春,2018-02-01 01:01:35,2,4,2,程设课很好，讲得很细致，事真的不是很多，真的是很不错的老师
73849,348,徐镜春,2018-02-03 08:56:03,6,7,1,上的老师的ds课。感觉老师讲得很清晰，不是照着念类型，能听懂。\n\n期中和姥姥班一起考，比其他班难得多。\n\n助教哥哥人超好！\n\n虽然我的绩点不高是因为期中期末都崩了，但是不得不说助教哥哥平时分给得真好！\n\n（奉劝后来者，虽然期末复习不易，但是别不睡觉，不然绩点容易爆炸。。。）\n\n\n\n
73997,348,徐镜春,2018-02-04 04:12:23,1,2,1,下学期有他的ds，不知道怎么样
74552,348,徐镜春,2018-03-03 11:34:39,1,3,2,人很好，很负责，和蔼可亲>.<
74680,348,徐镜春,2018-03-05 05:29:11,2,4,2,真的很棒，给分也是尽力的
75238,348,徐镜春,2018-03-08 06:40:47,3,4,1,ds讲的很有激情
76381,348,徐镜春,2018-04-11 00:57:01,1,2,1,老师态度可能有时候死板，有时候也为学生着想
76451,348,徐镜春,2018-04-09 15:33:16,6,7,1,一言不合就让你挂科！很不责任！\n\n
76452,348,徐镜春,2018-04-09 15:35:50,6,7,1,太坑了，辣鸡！ddl和要求什么的都说不清楚，还死板地不让你补救，很不负责任！毁绩点！事贼多！！！
76503,348,徐镜春,2018-04-11 16:07:38,3,3,0,在pta上出的题输出样例是错的！\n\n害人对着调了半天都不对
80239,348,徐镜春,2018-06-22 10:12:43,0,0,0,无语了
80244,348,徐镜春,2018-06-22 14:54:59,0,0,0,呵呵? 浪了
80380,348,徐镜春,2018-06-26 01:04:55,6,6,0,ads一共3次project，3次中的其中一次project上台展示.3人一组，每节课课上有1～2次小组讨论（有签到作用），课后在PTA上有习题，一般4～6题选择判断，偶尔有编程题.有期中考，占总分20%.徐镜春老师的课对概念的理论阐述可以说相当透彻，往往算法导论30～40页的内容浓缩在一堂课上，缺点很明显就是特枯燥?不过ppt最后一页有参考文献，课上不懂的翻翻书就能基本弄懂.
80482,348,徐镜春,2018-06-27 03:41:16,8,8,0,很棒的老师啊~不知道为什么分这么低
83904,348,徐镜春,2018-07-11 13:21:46,1,1,0,理论崩崩，谢老师不挂之恩
83918,348,徐镜春,2018-07-11 13:50:28,1,2,1,老师不给挂，我就给十分
84270,348,徐镜春,2018-07-12 11:50:33,3,4,1,ads讲得很好
84304,348,徐镜春,2018-07-12 13:25:26,1,2,1,很凄凉
84499,348,徐镜春,2018-07-13 04:07:11,0,1,1,c程讲的有点无聊，不过是很好的老师啦，作业和期中考里的题很有用，给分也不错
84511,348,徐镜春,2018-07-13 04:29:14,2,2,0,上课讲的不清楚 理论考感觉完全靠上学期的老本和自学 project的互评机制也很坑 第一次给了别人高分结果惩罚扣分就扣了3分 这样的互评搞的好的报告不敢给高分 差的不敢给低分 最后没有区分度 然后project还存在着恶竞 看到好几组同学写了二三十页的报告 自己的报告写了就几页 有的组看都不看评价就说报告太简短 exm 报告的字数不是越多越好 真心希望下学期老师能够改善下这个评分机制
84529,348,徐镜春,2018-07-13 05:33:54,9,11,2,ads拿了4点8，全班第一。平心而论，徐老师讲ads讲的还是不错的，考试真的太！难！了！（diss一波yds和cy）感觉完全是在考计算理论，大家都是蒙着做的。最后总评有部分bonus加在总评上（不是平时分上），这个相对于其他班是非常大的一个优势。助教哥哥人很好，project泄露信息也只是意思上扣个两分，不像其他班分扣光。建议ads多教一点写代码的，比如高级的数据结构比如线段树，trie之类的实用数据结构？然后dp和贪心可以多一点占比？因为毕竟这个才是真正锻炼学生思维的方面。至于后面的近似算法（sat问题），局部搜索，并行算法等等，要讲就细讲嘛，把那么多内容压缩到ppt十几页里，没基础谁能听得懂，反正我是听不懂。考试大部分人都是蒙，这不就是个看脸的考试嘛，为什么不能多一点技术性的题目呢。最后考试函数题考avl的插入全代码，还好我考试之前自己写了一遍，一次ac，开心?
84926,348,徐镜春,2018-07-14 11:36:54,4,6,2,讲课自己能糊涂 平时分也低 期中也难 期末考的比别的班同学高 绩点还比别人低 很迷
88139,348,徐镜春,2018-10-23 03:02:57,3,5,2,C程讲的比较细，而且充分利用了课堂时间，对于C程初学者非常有帮助
88188,348,徐镜春,2018-10-23 13:33:10,3,5,2,作业简直不要太多了，一节课20左右lab，hw判断加单选加多选加填空加函数加程序填空，让一个没有基础的人用了三四个晚上才能做完布置的作业
89276,348,徐镜春,2018-11-18 03:47:56,2,4,2,选了老师的c程，很可爱的一个老师，讲课非常细，虽然是对着ppt讲但里面会穿插很多自己的理解，举实例帮我们理解。也很负责。不明白为什么分数这么低，感觉捡到宝了。
92702,348,徐镜春,2019-01-04 01:08:54,0,2,2,一般般
96564,348,徐镜春,2019-01-21 06:34:16,7,8,1,上的ds 平时上课老师讲的还是蛮清楚的 我本身基础不是很扎实 就课后自己看看书百度一下再理解了然后做题  虽然pta上的题错的也不少  三个project总感觉自己做的不怎么样orz 每次都是磨出来的 应该有被同组大佬带了一下子这样   然后三次小测也是不难的 老师会在给题的时候解释得很清楚（大概起个点名效果hh） 最后平时分比预想的高好多 本来期末考完以为炸了结果问完助教发现居然没凉  平时一定要好好学！
97901,348,徐镜春,2019-01-23 01:26:35,3,6,3,老师的ds，老师讲课很清楚，ds作业也是每个班都一样的，人也很和蔼。小测作用是签到。最后给分比我预期好
101349,348,徐镜春,2019-01-28 05:11:27,0,2,2,给老师疯狂打call！！给分超级好，平时作业成绩排名60+期末期中发挥的不是特别好，但绩点还上了4。非常感谢老师！！答疑的时候讲的特别仔细！！c程小白学到了很多，选了老师的大程，希望下个学期能学到更多。
101483,348,徐镜春,2019-01-28 09:38:26,-1,2,3,今年上的老师c程和ds，虽然课上没听过，但老师很幽默慈祥（有点像高中班主任），给分很好，会给有c程基础的同学bonus加平时分，就是ds算总评的时候平时成绩会算成百分制四舍五入一次，算分办法可能导致跟自己算出来的分不一样，但是这也是规则吧。助教也很好
101566,348,徐镜春,2019-01-28 12:57:31,-2,0,2,老师真的超级好！特别和蔼，虽然平常上课慢点但是习惯了就会发现讲的挺清楚的！老师还记得班上同学长什么样，感动的要流泪了！
102861,348,徐镜春,2019-02-24 11:40:37,4,7,3,一朝绩被杀 十年怕镜春
103721,348,徐镜春,2019-03-04 14:29:49,-1,1,2,评分可能是被大计基拉低的，徐老师讲的很好呀，而且ADS对我们也很和蔼(懂？)虽然当年程序设计基础爆炸，也大概是因为自己太菜了。
103774,348,徐镜春,2019-03-05 10:05:41,2,4,2,徐老师挺好的呀，上课清晰易懂，人也挺和蔼，除了作业略多没什么缺点，为什么分这么低?
104134,348,徐镜春,2019-03-12 16:21:36,2,5,3,C讲的挺好的，上课体验不错
105347,348,徐镜春,2019-04-10 08:41:57,0,2,2,上课不行，讲规则的时间超长，讲课程内容时又没有重点，课后面对作业简直无所适从
107689,348,徐镜春,2019-05-08 09:53:29,0,2,2,人是真的好，很和蔼可亲，题是真的难，真的真的难\n\n别的班的题半小时+半小时写完90+\n\n我们的题……
108076,348,徐镜春,2019-05-14 05:55:25,0,2,2,老师很好
109618,348,徐镜春,2019-06-18 02:40:14,0,2,2,老师很负责，讲课会拓展
111413,348,徐镜春,2019-07-01 11:01:08,-1,1,2,上的老师的C程。感觉是讲课很认真，很负责的一位老师，能把各种概念讲的通俗、有趣，推荐选课。
112085,348,徐镜春,2019-07-03 12:48:27,3,4,1,经历考试之后，作为平时作业极少的别班同学，非常羡慕你们能有足够的练习量来及时巩固知识、认识到自己的问题。在考场上暴露问题实在是太痛苦了，还不如过程辛苦，结果美好。
112484,348,徐镜春,2019-07-04 11:32:02,1,3,2,性格很好的老师，积极回答同学问题
113624,348,徐镜春,2019-07-07 01:23:50,2,3,1,无聊，作业还好，给分。。。一言难尽
113806,348,徐镜春,2019-07-07 16:37:08,-1,0,1,人很好，不知道给分如何，坐等
113835,348,徐镜春,2019-07-07 17:23:48,4,5,1,我真搞不懂老师评分怎么这么低了。上课干货满满，问的问题也都很仔细解答。虽然作业多了一点点，但是计算机这种专业不就是要多码多刷题吗。我觉得这学期选到徐老师真的是自己捡到宝了
113863,348,徐镜春,2019-07-07 21:56:31,-2,0,2,虽然被卡了，但是比预期要高了好多了，老师真的很nice\n\n
113866,348,徐镜春,2019-07-07 22:08:40,2,3,1,c小程，平常上课有3次quiz，都是选择题，很简单，平常作业留的比其他老师少，期末老师捞人很强，满分推荐
113876,348,徐镜春,2019-07-07 22:46:35,0,1,1,感谢老师不杀之恩！我这种学术垃圾都能捞上来，这是什么绝美社会主义师生情啊！
113933,348,徐镜春,2019-07-08 01:24:05,1,2,1,不懂为什么评分都给这么低，绝对是好老师啊
113939,348,徐镜春,2019-07-08 01:35:09,0,2,2,天哪！我理论34实验11分都能被捞起来嘛！这师生情简直感动中国啊我爆哭！10分没的说了，老师我爱你QAQ
113965,348,徐镜春,2019-07-08 03:54:15,2,3,1,给分太棒啦，感动到哭
114827,348,徐镜春,2019-07-12 01:25:54,2,3,1,超级温柔的老师，互评泄露了自己姓名也就意思一下扣三分，微信里水群像个老顽童，给分也超级好把我卡上去了。表白老师和助教。
115392,348,徐镜春,2019-07-21 01:32:24,-1,1,2,态度极好，虽然作业多，但捞人强的一批
116836,348,徐镜春,2019-09-16 10:23:42,2,2,0,废话太多，1/3的话就能讲好的东西非要给你解释一下子
116944,348,徐镜春,2019-09-17 13:05:20,0,3,3,很好的老师
117417,348,徐镜春,2019-09-24 05:47:57,3,4,1,老师把PPT音效关一关吧\n\n? \n\n
118068,348,徐镜春,2019-10-20 06:58:18,0,3,3,我只说我的感受，我不管老师是什么心态，为了学生好也好，没耐心选题也好，你告诉我一天12到编程题是什么玩法，还一堆一模一样改数据的，我求求你选题目的时候能不能睁大眼睛看看，这样很浪费学生的时间啊，别的班一个学期的作业还没我们一个月的多，说真的我觉得c语言基础根本没必要用这么多题来打基础，慎选，除非你异常喜欢做作业，要不然建议你退课
120160,348,徐镜春,2019-11-18 01:45:08,0,3,3,作业多到你怀疑人生，一周上一次课，然后布置十几个编程题。
120711,348,徐镜春,2020-01-15 17:15:47,0,3,3,垃圾绩杀 千万别选
120715,348,徐镜春,2020-01-15 20:12:42,0,4,4,sb东西，绩杀，平时分低
120730,348,徐镜春,2020-01-16 02:47:43,-2,1,3,老师和助教都很有水平，给的分数还可，捞人感恩
120740,348,徐镜春,2020-01-16 04:32:51,-1,3,4,可能有一次上机没去 他就会把你平时分搞没 垃圾绩杀 千万别选 选了自杀吧
120878,348,徐镜春,2020-01-18 03:00:12,2,2,0,超级好的老师，知道了每个绩点对应的分数段后，在满足正态分布要求的前提下会尽量给你高分！90分以下的很多89
120988,348,徐镜春,2020-01-19 07:37:17,0,0,0,感觉徐老师教的挺好的，不知为何给分这么低
121026,348,徐镜春,2020-01-19 09:18:45,0,0,0,平时分真的低。。。不过老师人是真的好。
122048,348,徐镜春,2020-02-07 14:53:38,0,0,0,C程讲的很好！
122167,348,徐镜春,2020-02-18 13:03:31,0,0,0,很耐心 给分也不错
122334,348,徐镜春,2020-02-24 10:00:22,6,7,1,1.点名用两次课堂小测代替；\n\n2.平时作业量大是共识，不过也要注意一点：期末考一般被扣在理论题，平时题库大了复习会更有把握一些，大概。\n\n3.上课讲解还可以，C程毕竟是一门需要自学（看书补充概念和编程练习）的课程。\n\n4.老师很和蔼，态度也很好，有事找他都会回复和帮忙，包括我是机房课冲突补选，他也帮我调了机房课时间（到另一个教学班的机房课时间）\n\n（补充一点：机房课时间冲突问题，我问过老师，老师说他是不会来扣不上机的平时分的，但是教务处可能会来查，可能扣分，也正因如此他帮我调了机房课时间让我能够得到上机的签到）\n\n5.给分问题，老师在第一堂课就把课程给分方式讲清楚了，并且给得也很公正。不清楚有无捞人，但不会故意扣你是肯定的。\n\n（注：平时作业不要求全对，错题不要多得太离谱，基本上平时分就满了）\n\n\n\n最后：\n\n我选的时候学长就推荐他，而我的个人体验也是，不应该只有（我现在看到是7.1）这点分数。说句题外话，查老师打分不要太有戾气，尤其是成绩不理想就骂人的。C程学习需要概念理解和编程练习，很多时候老师讲得比较慢，如果想要这门课的绩点的话，建议多看书，多理解，教材的pta习题去练一练（老师的习题很多直接摘自教材的pta题目，你如果敲掉了的话作业遇到这道题直接把代码复制粘贴就可以了）。一般来说，大家死在理论题，一定要注意理论题，血与泪的教训。\n\n
122533,348,徐镜春,2020-03-03 10:19:00,0,1,1,人挺好的，平时也会偶尔轻松一刻，最后后还尽量让我们压绩。编程还是要自己多试试吧。作业虽然多，但是，体验极好（毕竟，我自己课外不会刷题。。。）。正常题量外的，就当是我自己的课外练习了(=_=)
122680,348,徐镜春,2020-03-17 10:33:16,1,1,0,老师答疑很有耐心，晚上很晚发过去的问题都会立刻回复，人真的很好很可爱
123216,348,徐镜春,2020-05-21 00:00:08,3,4,1,我的天什么垃圾老师 发消息根本不回好吗
123307,348,徐镜春,2020-06-02 04:13:44,2,2,0,C小程讲的好给分也好啊 微信群里会回复大家的问题 为什么分这么低
123366,348,徐镜春,2020-06-06 08:00:22,2,2,0,老师布置的作业很全面，对巩固自己的知识体系作用挺大的，但是最无语的是对学生提出的问题总是敷衍了事。。。。枯了
123588,348,徐镜春,2020-06-10 09:31:19,1,3,2,这么好的老师评分怎么会这么低？果断十分！给分很好吧！反正我是给高了，有一次lab大作业没做真是慌死了，还好遇到了徐老师！
124276,348,徐镜春,2020-06-28 10:40:23,4,4,0,ADS出分了来评一下，卷面五十来分最后总评4.2还是满足了...徐老师讲课挺清楚的，准备很充分，老师人也很好。线上每一节课都有一次课堂练习，平时作业就年级统一的ADS作业，然后Project、互评啥的也是跟着标准来。最后平时分给分也蛮好的，有一周作业漏做、课堂练习错一堆的情况下还拿了接近满分，大概是做了4个Bonus加了些分。但是这个期末考真的太离谱了...卷面及格线降到了35分、期末考比例下降...某老师的6道题除了一道能直接做的判断其他全部猜错也是绝了...
125729,348,徐镜春,2020-09-13 15:51:42,0,0,0,大程考的不太好，希望老师能捞一捞。还有网课时候考试挂个照片在角落真的很神秘。
125951,348,徐镜春,2020-09-16 03:31:18,0,0,0,C程网课讲的不错~
126109,348,徐镜春,2020-09-17 15:11:19,1,1,0,竟然会捞人，给分不错的。
126110,348,徐镜春,2020-09-17 15:12:49,1,1,0,大程不同场次的考试应该把难度系数调平了，吹爆！
126112,348,徐镜春,2020-09-17 16:27:14,-2,2,4,真的垃圾，看我考得差，就把我平时分扣完补给好的？
128801,348,徐镜春,2020-12-25 12:15:07,4,4,0,老师讲得很好，思维清晰，通俗易懂。同时考核标准明确，给分也挺不错。遗憾的是徐老师下学期就退休了，c大程只能换个老师了。
130448,348,徐镜春,2021-01-30 18:59:26,0,1,1,老师退休啦！以后再也不教了。真的挺好的老师。我的平时分被下调了一分，结果总分本来还差0.5分满绩，老师给我四舍五入，拿到了大一的第一个满绩，真的很感谢徐老师！说别的也没什么意义了(毕竟退休了嘛))感谢老师退休前的仁慈！！！
131789,348,徐镜春,2021-01-29 02:54:35,3,3,0,感谢老师，让我没有丧失对编程的信心。老师和蔼可亲，认真负责，也会很耐心的回答问题。老师要退休了，好可惜
132088,348,徐镜春,2021-01-30 07:46:57,1,1,0,老师上课比较负责，作业有点多，但认真做的话收获会很多
132345,348,徐镜春,2021-02-01 02:58:38,2,3,1,老师毕竟教了40年了，辛苦了。ds觉得讲的还是挺清楚的，谢谢老师的满绩
132472,348,徐镜春,2021-02-02 00:38:19,1,2,1,好老师，感动ing
133359,348,徐镜春,2021-02-26 09:37:32,3,3,0,好老师，可惜学弟学妹们没机会选到徐老师的课了，他要退休了。本来我他在查老师的分数不高就没报太大希望，但是他讲课特别细致特别认真，真的希望你能多学点实用的技巧，最后给分也不错。就是作业多点，而且讲课速度永远比作业进度慢，相当于作业需要自己预习，每节课都是复习课。
133799,348,徐镜春,2021-03-05 12:43:05,10,10,0,祝徐老师退休生活幸福
134850,348,徐镜春,2021-04-18 23:38:44,2,2,0,很不错
135845,348,徐镜春,2021-05-29 07:05:42,0,0,0,徐老师很好，助教也很好
140426,348,徐镜春,2021-09-11 07:10:23,0,0,0,老师挺负责的，对同学们也很好
200148,348,徐镜春,2024-10-14 03:24:12,1,1,0,就你让我们写验证哥德巴赫猜想是吧
923,350,沈睿,2015-03-19 02:42:02,120,195,75,老师很温柔很善良。而且很美丽。很负责。大计作业几乎没有。很为学生着想。但是可能老师经验不够，毕竟年轻，讲课有点沉闷，而且照本宣科占大多数时间。不过是个好老师。
1047,350,沈睿,2015-03-21 17:11:08,8,12,4,不错\n\n
1174,350,沈睿,2015-03-21 16:24:52,29,39,10,作业很少啦，毕竟不用被强迫着去机房是吧。会有quiz之类的变相点名。上课还不错，给分也挺好。有期中考，这个可能和别的老师不太一样。
1383,350,沈睿,2015-03-22 01:26:10,38,47,9,沈睿是我最喜欢的老师！虽然上课基本是念ppt，但是依然讲的很好啊！到了大三很多东西都还记得。
1960,350,沈睿,2015-03-27 02:33:00,71,78,7,只能给赞
1986,350,沈睿,2017-08-29 05:32:45,34,40,6,沈老师超级好啊 在建的课程群里过年还会发红包w   上课比较易懂  人很好~~
2195,350,沈睿,2015-04-07 14:13:57,8,13,5,挺萌的
3008,350,沈睿,2019-01-12 15:16:14,112,130,18,有一个过年在群里发红包的老师是一种什么样的体验？
3716,350,沈睿,2015-06-17 02:38:57,-2,3,5,很棒！
4689,350,沈睿,2015-06-26 05:17:03,2,6,4,很赞的老师
4822,350,沈睿,2015-06-29 08:43:32,27,29,2,大多按照ppt和书上例题讲，可能比起别的老师会没有新意点不过真的很有条理很清楚～老师人也温柔美美哒，大爱～
4862,350,沈睿,2015-07-14 13:06:18,42,50,8,老师我爱你
4871,350,沈睿,2018-08-26 06:44:00,51,72,21,都是老师的课大计基课是很无聊，但是老师平时作业很少。  c程讲的很好。而且上机每次必然自己到！24小时在QQ群答题。大计基满绩。  期待老师的进步。
5074,350,沈睿,2015-07-03 09:29:47,-1,3,4,大赞大赞，绝对的好老师！已经被征服了！\n\n
5124,350,沈睿,2015-07-04 09:12:07,2,8,6,人很好，但是上课真心一般.....
6494,350,沈睿,2015-07-14 12:45:49,6,10,4,赞。讲课很生动 比喻用的很好。
6495,350,沈睿,2015-07-14 12:47:27,0,5,5,好棒的老师，绝逼完爆任何老师
6496,350,沈睿,2015-07-14 12:47:42,3,5,2,c程知识点讲的很细致，很随和，讲知识点很耐心。
6497,350,沈睿,2015-07-14 12:48:21,0,4,4,真的很棒很棒！！！
6498,350,沈睿,2015-07-14 12:51:40,1,3,2,老师人很好，上课虽然有点沉闷但是讲题很细心。给分很好，赞一个！
6501,350,沈睿,2017-12-23 12:08:56,8,12,4,很详细，很负责
6523,350,沈睿,2015-07-14 16:48:05,-1,2,3,老师人很好 很负责任
7097,350,沈睿,2015-09-02 03:36:10,-1,2,3,老师很温柔 讲课很nice
7339,350,沈睿,2015-09-14 00:40:07,-1,3,4,很温柔的老师，给分很好～上课也不错
8417,350,沈睿,2015-09-21 06:12:10,1,4,3,很好的老师
11409,350,沈睿,2015-11-30 12:18:27,-3,2,5,难得的好老师
11925,350,沈睿,2015-12-21 10:46:28,1,3,2,浙大好老师
12545,350,沈睿,2015-12-23 12:35:00,0,3,3,老师很温柔，很耐心。作业少，棒棒哒。
13453,350,沈睿,2015-12-28 06:13:33,2,3,1,我是来打10分的，真心好老师
13650,350,沈睿,2015-12-30 08:32:51,29,35,6,快选这老师，快选，快选！
13663,350,沈睿,2015-12-30 09:04:12,-2,1,3,老师超好
13743,350,沈睿,2015-12-30 13:29:59,0,3,3,好好好\n\n
13804,350,沈睿,2015-12-31 05:44:51,6,7,1,平易近人，讲课不紧不慢，听着挺舒服的。
13964,350,沈睿,2016-01-03 06:12:25,-3,1,4,很棒的老师
13971,350,沈睿,2016-01-03 07:23:51,0,1,1,老师是不会点名的啦 不过会利用小测试来变相点个名
14351,350,沈睿,2016-01-06 12:38:01,4,4,0,人很好，讲课有些照本宣科的感觉
14437,350,沈睿,2016-01-07 05:42:24,5,7,2,那么多年了，我哈哈记着这个老师
15027,350,沈睿,2016-01-11 14:42:38,-2,2,4,老师很温柔很体贴！会在qq群里答疑 还在四级考试之前提醒我们带好证件 期末大作业因为网在ddl那天崩了还延期了五天 真的很棒的老师！
15077,350,沈睿,2016-01-12 02:08:37,2,6,4,一级棒，老师人特别好 ，作业不多，给分不错，讲课条理清晰
15350,350,沈睿,2016-01-14 03:47:27,4,5,1,老师很温柔，善良，虽然有时候会有quiz但是quiz的成绩不计入总分只要考了就有。虽然讲课挺无聊的，但老师真的超好！！！！
18532,350,沈睿,2016-01-22 02:18:51,3,6,3,点名方式是平时QUIZ，平时在群里会答疑，期末专门有一天问问题，期末综合作业因为系统原因还会给你延期，很好的老师
19892,350,沈睿,2016-01-25 14:11:37,1,3,2,有耐心的女神老师
19893,350,沈睿,2016-01-25 14:11:40,0,2,2,好好哈
19894,350,沈睿,2016-01-25 14:12:03,-3,1,4,讲的很好
19895,350,沈睿,2016-01-25 14:12:06,2,4,2,给分相当不错\n\n全力推荐
19897,350,沈睿,2016-01-25 14:12:42,-1,3,4,大计基完全没好好学居然还4.2 除了老师好还能怎么解释\n\n
19899,350,沈睿,2016-01-25 14:12:59,1,3,2,三个字
19900,350,沈睿,2016-01-25 15:00:50,3,4,1,老师给分很好，很亲切。声音温柔，答疑也很细心。好老师！
19901,350,沈睿,2016-01-25 14:16:13,-1,2,3,老师人很好答疑很耐心
19902,350,沈睿,2016-01-25 14:13:41,-2,2,4,超级好，老师漂亮，说话温柔，脾气好，给分好！
19903,350,沈睿,2016-01-25 14:14:20,0,4,4,sad
19904,350,沈睿,2016-01-25 14:15:12,0,2,2,老师真心好 真的
19907,350,沈睿,2016-01-25 14:16:39,-1,2,3,老师脾气很好，有时候讲课还是蛮有趣的，虽然打过瞌睡，但还是自己的原因
19909,350,沈睿,2016-01-25 14:17:17,1,4,3,真好赞\(≧▽≦)/\n\n
19910,350,沈睿,2016-01-25 14:18:55,1,4,3,好～好～好！
19912,350,沈睿,2016-01-25 14:19:29,-1,3,4,好！hhh\n\n
19916,350,沈睿,2016-01-25 14:22:27,-2,2,4,听老师的课是种极好的体验 重点是给分好好好
19919,350,沈睿,2016-01-25 14:24:44,2,5,3,老师对学生很好，期待老师的进步！
19930,350,沈睿,2016-01-25 14:36:37,2,5,3,给分好
19968,350,沈睿,2016-01-25 16:48:38,-2,5,7,老师人很好，很温柔，作业超级少！期末差一分满绩的我真是对不起老师。。。
19985,350,沈睿,2016-01-26 00:18:40,9,11,2,简直不要太温柔 群里回答简直不要太可爱 总之 老师棒棒的 上课节奏也很缓 至于大计基复习 我能说考试周前花了三天下午认认真真地看了一遍书就完全不虚了嘛
20803,350,沈睿,2016-02-01 02:25:41,0,4,4,沈老师女神！
20858,350,沈睿,2016-02-02 14:15:17,0,3,3,很好的老师，会耐心答疑
21150,350,沈睿,2016-02-22 09:05:28,2,4,2,作业不多，但都是需要认真思考的那种，很锻炼人
22801,350,沈睿,2016-03-12 02:52:42,-1,3,4,12121212
23049,350,沈睿,2016-03-16 13:33:55,1,4,3,除了赞还是赞
25795,350,沈睿,2016-06-08 11:18:05,-1,2,3,上课很有收获，能够理解透彻
27034,350,沈睿,2016-06-22 10:38:03,-3,2,5,温柔 讲课也很好 基本不用下课看书都能做
28002,350,沈睿,2016-06-28 07:58:35,3,5,2,上课条理清晰，认真负责
28975,350,沈睿,2016-06-29 04:57:00,1,4,3,老师人很好 很温柔 虽说上课枯燥了一点
29195,350,沈睿,2016-06-29 11:18:20,4,6,2,很贴心，很理解学生。而且讲解很透彻，选了不后悔
29455,350,沈睿,2016-06-30 00:14:12,1,2,1,老师很温柔。
30027,350,沈睿,2016-06-30 23:49:48,0,3,3,c讲的很清楚有条理，人也特别好呀，很庆幸遇到这样的好老师。
30202,350,沈睿,2016-07-01 05:12:00,2,4,2,讲课很清楚
31738,350,沈睿,2016-07-04 16:12:46,15,21,6,C程老师，现在成绩没出，赶紧先给10分（万一出完成绩想给12分怎么办？）。\n\nquiz没有吧，只有一次考试须知当点名hhh。年前的老师，女神范。相对来说，上课已经好生动了，例子举的很有趣，内容讲的很全很细，毕竟枯燥是C程。课后答疑很细心，上机课每次都在，解答很赞的说。最友爱的是那个群啊，简直不要太棒——有问题也来问问万C啊→_→理论题，代码问题都有大神随时解答（真的是随时啊）。。。C群里都是dalao，群风东南西北吹，暴膜之风甚重。我唯一被佩服的是我的胆量——这种问题都不匿名，佩服hhh。。。可能在万C群里，有种当学渣的快乐(^_^)
31855,350,沈睿,2016-07-05 04:28:38,0,3,3,就是讲得清楚，有条理能抓住重点。\n\n
31858,350,沈睿,2016-07-05 04:30:57,0,4,4,好棒的老师，而且感觉还会卖萌(๑•̀ω•́๑)
31859,350,沈睿,2016-07-05 04:30:58,1,4,3,作业少，不强制上机，讲课也不错
31865,350,沈睿,2016-07-05 04:36:26,-1,3,4,给分很好，而且上课也很负责。
31866,350,沈睿,2016-07-05 04:38:44,-2,3,5,老师很棒
31867,350,沈睿,2016-07-05 04:46:29,5,9,4,老师太赞了 给分超级好 上机只做出一道最后有89！！！ 大爱
31878,350,沈睿,2016-07-05 04:56:28,-8,2,10,不开心\n\n
31887,350,沈睿,2016-07-05 05:17:25,15,20,5,老师长得很像我妈妈，从大计基开始选的沈老师，大计基给了我一个很高的分数，C程差一分满，还是我自己的问题。在C程群里回答了半年的问题，对自己帮助很大，真的真的十分感谢沈老师，女神！
31972,350,沈睿,2016-07-05 09:46:32,-1,2,3,真的好 负责开明
32005,350,沈睿,2016-07-05 10:59:48,1,3,2,上的c程，感觉挺好的
32292,350,沈睿,2016-07-06 05:57:48,0,2,2,讲得很清楚
32316,350,沈睿,2016-07-06 06:56:14,-1,3,4,上课清晰，态度可亲，超级好的一个老师！！！！
32348,350,沈睿,2016-07-06 08:04:41,-2,1,3,沈老师人很好，讲课也非常清楚，偶尔还会在群里答疑，棒棒哒
32678,350,沈睿,2016-07-09 09:00:50,0,4,4,老师不仅人炒鸡好，给分也超级棒！
35898,350,沈睿,2016-11-10 08:47:16,2,3,1,老师人很好
38504,350,沈睿,2016-12-07 07:57:23,10,13,3,老师人超好的，不点名也没有期中考，有时会在上机课让我们限时做练习。上课讲解很细致，在群里发言也很亲和，超爱沈老师，大家可以选一选哟，回答问题也很耐心  :)
39268,350,沈睿,2016-12-22 01:36:09,0,2,2,老师超级好，平时作业一般不用上机，预留时间也很长。。上课也很好的，打比方很生动
39279,350,沈睿,2016-12-22 02:20:29,6,6,0,很好的老师，感觉没有架子，平时作业给完成的时间挺长的，这不知算不算好，有些人可能会拖
39739,350,沈睿,2016-12-27 08:04:46,4,6,2,很好很萌很可爱的老师，重点是上机课可以不去在寝室做，而且平时分很好得
40513,350,沈睿,2017-01-04 02:40:18,3,3,0,超级棒！！！很温柔 人很好
42958,350,沈睿,2017-01-21 02:13:09,0,2,2,老师超温柔啊！特别棒！作业也很少！向老师抱怨作业时间太紧做不完，她还会把时间延长！！
43081,350,沈睿,2017-01-15 16:00:57,3,4,1,老师很温柔，讲的也很好！
46019,350,沈睿,2017-01-20 12:05:16,-1,1,2,超级超级棒，赶快选吧，超级棒！
46021,350,沈睿,2017-01-20 12:10:36,4,4,0,很棒\n\n
46134,350,沈睿,2017-01-20 16:08:02,2,4,2,老师很温柔很好，上课讲的很清楚会用各种比方和例子来让你理解，可惜我是早课基本都是昏睡的。会有小测之类的变相点名，总之不要翘课，期中简单准备下，期末好好复习，满绩get！
46474,350,沈睿,2017-01-22 00:27:14,2,6,4,沈姐姐！
46618,350,沈睿,2017-01-22 04:10:50,2,4,2,老師人超級無敵好～～～～～作業也不多 人有很溫柔
46740,350,沈睿,2017-01-22 08:57:49,3,6,3,老师很温柔，作业也比较轻松，不强制去机房，只要规定时间内做完就好，还会很耐心地答疑，给分也很不错
46796,350,沈睿,2017-01-22 10:26:02,9,10,1,有一次期中考试，保底4分，按分数段给分满分七分。有两次用于点名的小测，不记成绩。平时作业基本都在寝室可做比其他老师强很多，解答问题很耐心，期末大作业会有展示可加分。老师特别特别温柔，认真学了差一分4.8，有点点小遗憾。
47075,350,沈睿,2017-01-23 14:20:47,1,6,5,啊大学第一个满绩！老师人真的好，很温柔，每节上机课还都去答疑，还经常在群里和我们互动，我爱沈姐姐！
47401,350,沈睿,2017-01-26 04:27:22,3,3,0,OK\n\n
47469,350,沈睿,2017-01-27 13:40:09,0,3,3,不点名，发红包，给分特别高，看谁抢到咯
48273,350,沈睿,2017-07-05 14:15:34,5,8,3,老师给分太好了！竟然没挂！而且……不低啊！
48655,350,沈睿,2017-03-09 02:42:05,8,9,1,沈姐姐不教大程了 上了其他老师的课越发的想念沈姐姐了
48891,350,沈睿,2017-03-16 00:27:38,2,6,4,老师很温柔，上课的时候讲得很细致，课后不看书也可以做题目的，超级喜欢，平时在群里可以问老师，并且群里还有各种大神可以解答问题，给分也很好，本来这学期是沈姐姐的课，可是沈姐姐身体好像不是很好，调到了肖少拥，真的很痛苦啊，上课讲什么也不知道。 \n\n    ?好想你啊沈姐姐
52023,350,沈睿,2017-06-14 08:03:11,-2,1,3,棒棒哒
54250,350,沈睿,2017-06-29 01:47:59,3,4,1,非常棒的老师，女神！考前会在群里答疑，很负责！
54414,350,沈睿,2017-06-29 09:44:34,-14,10,24,趁没出分还冷静打个分，我觉得老师对c语言的理解不够深刻，上课打的许多比喻都不知道在说什么，考试重点也不讲，完全没法和之前代课的老师比
54464,350,沈睿,2017-06-29 10:48:52,1,3,2,老师人超级好，讲的也清楚，认真负责，批改作业时还给我的评语好多的回复，超级感动
55828,350,沈睿,2017-07-02 12:30:47,-2,3,5,老师很好很温柔，萌萌哒的姐姐，只是怪我下午的课比较困有点懵逼，慢慢坚持就会发现自己的理论基础还是很好的。
57108,350,沈睿,2017-07-05 14:17:11,2,5,3,老师给分真的好！讲的也特别好！
57110,350,沈睿,2017-07-05 14:21:36,-1,4,5,老师人很好，上课很仔细，每次问问题都很耐心解答，期末给分也不错，萌萌哒的老师！！！力荐！
57135,350,沈睿,2017-07-05 15:46:30,2,5,3,沈老师很温柔 但是讲课可能没有那么清晰 但是认真听是可以听懂的\n\n
59414,350,沈睿,2017-09-21 07:56:16,13,14,1,女神老师
63605,350,沈睿,2019-01-10 02:02:17,-153,10,163,垃圾老师，上课没有重点，资历太浅，一些要紧的问题同学问也讲不清楚，c n m b
67816,350,沈睿,2018-01-22 07:46:42,-1,3,4,老師女神不解釋
69065,350,沈睿,2018-01-24 07:57:49,0,3,3,超级棒的老师！
69719,350,沈睿,2018-01-25 09:11:44,11,13,2,大计机考完有点崩，我想知道老师看重师生情吗
73435,350,沈睿,2018-02-01 14:37:03,5,5,0,跪谢老师o(^o^)o
73451,350,沈睿,2018-02-01 14:44:35,4,6,2,老师很棒，平时作业也不算多虽然有些确实有点花时间但是真的想应用到生活中就该好好去做，虽然绩点还没出先给老师点满先。期末考试有点看运气看你抽到怎么样的题目吧，有些确实看都没见过。这是题库的锅不怪老师
73455,350,沈睿,2018-02-01 14:49:19,5,5,0,hin温柔hin温柔～也很耐心～强推老师
73558,350,沈睿,2018-02-02 03:21:31,1,4,3,虽然我上课不怎么听抑制不住走神，但老师还是很棒吖QQ群答疑真的很亲民了！作业还很少，考前还会很为学生着想地教你怎么复习，帮你勾画重点！总之很棒了！大计基考试还是主要看自己刷题刷书吧像高考一样复习会有好成绩滴！
73619,350,沈睿,2018-02-02 06:41:35,7,7,0,得赞一个
73679,350,沈睿,2018-02-02 14:37:45,4,6,2,女神！再生父母！论文认真写要结合生活 立题不能很空 考试的话大家复习应该套路都差不多  说实在话我上课蛮水的 但是作业认真做了 复习认真复习  老师真的人很好  大计基理解加记忆 最后4.8   满分好评！！！！
73687,350,沈睿,2018-02-02 15:53:41,4,5,1,老师简直女神啊啊啊啊\n\n给分超级好，上课超温柔啊啊啊\n\n不选跟自己过不去啊啊啊
73867,350,沈睿,2018-02-03 09:27:22,2,4,2,我上的C重修班 只能说这个老师太好了 讲课超级细致认真 很负责 超级好超级好的老师啊
73872,350,沈睿,2018-07-11 11:10:24,-1,2,3,老师超好，给分也很棒，平时多花点时间绩点就更好了！
74010,350,沈睿,2018-02-04 05:20:56,0,5,5,老师人很和善，但讲课有点无聊。
74035,350,沈睿,2019-02-23 13:03:49,8,11,3,C程讲的还好
78034,350,沈睿,2018-05-09 05:27:32,7,9,2,老师蛮可爱的
85001,350,沈睿,2018-07-15 02:38:44,2,3,1,真心好老师
85008,350,沈睿,2018-07-15 03:05:40,0,3,3,老师讲课有逻辑重难点会重复讲。很温柔！！
85010,350,沈睿,2018-07-15 03:18:53,3,4,1,老师人好，值得推荐
85020,350,沈睿,2018-07-15 04:07:10,5,6,1,老师真的太太太太好了！c程讲的非常清楚，即使是很难的指针都能听的很懂。超级温柔超级有耐心～\n\n期末考试的时候电脑自动关机心态崩了，然后就考崩了。以为c程要阵亡了没想到出分的时候这么高！！真的太太太太爱老师了！
85023,350,沈睿,2018-07-15 04:34:55,-3,1,4,老师讲的很细，可能偶尔会瞌睡，但是基本跟着老师走成绩会很不错的
85024,350,沈睿,2018-07-15 04:40:49,6,6,0,感天动地好老师 没让我挂
85059,350,沈睿,2018-07-15 07:34:32,4,9,5,c程真的非常容易满?至少比微积分啥的容易多了…… 我也没怎么认真努力学 感谢老师给分好 稀里糊涂的满了 我爱老师。我超级爱老师!
85164,350,沈睿,2018-07-16 01:16:21,1,3,2,超棒的老师！上课很有条理，讲得很细致。对同学很温柔很nice。建了QQ群，答疑都是一个一个亲自答的。最后给分真的好好！比我预想的高太多
85216,350,沈睿,2018-07-16 06:24:13,0,1,1,上的老师的c程。因为以前都学过了，所以上课几乎不听，声音甜美可催眠，老师的课睡得特别香，感觉挺对不起老师的。平时的作业和室友别的老师比起来少很多。只有一次写考试须知的回执作为点名。偶尔听了几句感觉老师讲的也都是重点要点。关于课程进度，老师有自己的顺序，不是按课本安排来的。所以跟紧老师，认真听课肯定是没问题的，当然也要自己自觉学习与思考。
85333,350,沈睿,2018-07-17 05:26:42,-26,4,30,完全联系不到这个老师，QQ不回，邮件也不回。
86390,350,沈睿,2018-09-14 14:08:13,2,4,2,我爱老师
86393,350,沈睿,2018-09-14 19:09:05,3,5,2,虽然挂了，但是十分，都怪自己，老师完美
91468,350,沈睿,2018-12-11 05:40:08,1,4,3,老师讲课挺细致吧，对小白较为友好，就算听不懂做做计科也就ok，期中考试真的良心评分啊！！！
91957,350,沈睿,2018-12-25 06:12:10,1,3,2,老师好棒啊，还很萌
92331,350,沈睿,2018-12-28 01:24:48,10,12,2,讲课清楚作业少!\n\n沈睿老师真是好!\n\n是我的大计基老师，每当室友熬夜肝作业我就觉得有沈老师这样不事儿的老师也太棒了!有一次小测形式点名，提前一周告知，还在群里提醒，还给大家调分呜呜呜
93929,350,沈睿,2019-01-14 10:37:58,6,8,2,老师超温柔 长得也很可爱 平时事情也很少 在别人拼命赶报告的时候 我们只需要做网络题目 任务不多 并且要是有人忘记的话 老师还会给我们延长时间 真的大爱沈老师 我们课程群也可以说是最温馨的一个群了 虽然大家脸名字对不上号 但是在群里气氛很活跃 问题目永远有人回答 共享复习资料 共享在网上搜到的答案 在群里刷屏啥都超温馨 很幸运大计基结束后又选上了python 善解人意好老师吹爆！
97439,350,沈睿,2019-01-22 09:00:41,0,3,3,很认真负责的老师，在此给好评，希望不要挂科
98317,350,沈睿,2019-01-23 10:10:21,3,4,1,老师真的很好，十分贴心，关注同学们的各种问题。
100368,350,沈睿,2019-01-26 03:53:41,4,4,0,好棒棒
100928,350,沈睿,2019-01-27 06:42:15,-2,1,3,老师太好了。
101195,350,沈睿,2019-01-28 01:52:32,1,3,2,老师超级超级好！！！！
101562,350,沈睿,2019-01-28 12:33:12,2,3,1,好好好
101652,350,沈睿,2019-01-28 22:51:21,-2,1,3,老师超级好呀！
101653,350,沈睿,2019-01-28 23:25:16,4,6,2,真的太好了，提醒大家补完作业再出分，见过最善良的老师
101658,350,沈睿,2019-01-28 23:58:22,2,4,2,作业是最低限度了，考试前开了三次线下答疑，出分前还会拼命捞人。还有谁！！满绩路过。
101660,350,沈睿,2019-01-29 00:10:34,8,11,3,吹！爆！！！刚开始觉得讲课有一点点枯燥还不是太喜欢，但是后来真的发现老师太好了…而且群里的气氛真的很棒答疑总会有热心的小伙伴帮忙，助教也很皮，大家玩匿名简直是一群戏精。老师事很少很少，别的班都要写论文我当初以为是自己忘了作业…出分虽然不是很，是因为老师在等所有人把作业补完…给分也超棒啊！虽然大计基麻烦了点，学的时候不停吐槽。考试最后差不多啃书和ppt背了两天，还是满了qvq强推
101700,350,沈睿,2019-01-29 01:41:47,3,7,4,最好的老师，平时作业很少很少很少，做了就给满分!上课很随意，没怎么听。然后期末背下书，给分超级好。大计基群里也很活跃，同学们都很友好，会相互解答疑惑!最好的一门课，最好的老师
101707,350,沈睿,2019-01-29 02:01:47,4,6,2,老师很好呀，最后补作业还会捞人～但是这次期末考 不同的人卷子难度差别很大 觉得有点不好 但这个不是老师的锅 只希望以后这样的事不再发生吧 绩点不高不低 也满足了( ̀⌄ ́)
101733,350,沈睿,2019-01-29 03:00:03,0,3,3,老师人超好哇，吹爆老师哈哈哈
101740,350,沈睿,2019-01-29 03:07:13,2,4,2,吹爆老师!人又温柔给分又好。最后还为了挽救平时作业漏做的同学推迟了出成绩的时间。怎么会有这么棒的老师
101794,350,沈睿,2019-01-29 05:28:56,5,6,1,老师真的太好了吧，人温柔，课也好，对于没有完成作业的同学还会特意通知，最后出分的时候还会专门留出时间补作业，对于被正态的同学更是感到很抱歉，10分不足以表达出老师的好啊啊啊
102393,350,沈睿,2019-02-01 11:33:53,-1,2,3,老师人很好，有人没按时完成作业会给他们补的机会，期末时会提醒作业没做全的同学补交作业。我平时作业都按时完成，合格以上尽量刷满，最后绩点不是很满意，可能是期末考炸了吧呜呜呜呜
102522,350,沈睿,2019-02-04 07:59:07,-1,3,4,上的大计基，沈老师很负责，要交的平时作业会提醒很多遍，给分也很好很清楚，讲的内容比较浅，可水可听。
102525,350,沈睿,2019-02-04 15:22:26,6,8,2,大计基水是通病吧，老师真的很好。ddl快到老师会提醒，期末的时候还可以补交，老师会不厌其烦地帮你重新调整系统开放，还会在群里对被正态的同学说抱歉，还会在新年发红包。总之好到没话说，这样的老师不得十分真是没道理！！！
102758,350,沈睿,2019-02-22 10:13:56,3,4,1,老师上课讲的很细致（然而大计基本身还是很无聊），有时还会放视频；有什么问题，老师，助教以及同学们都会在群里解答
103068,350,沈睿,2019-02-26 01:14:48,1,4,3,讲的好，给分更好
103946,350,沈睿,2019-03-08 00:23:14,0,1,1,爱老师\n\n
104883,350,沈睿,2019-03-29 11:01:09,1,3,2,很负责的一位老师～
105702,350,沈睿,2019-04-18 15:24:29,3,5,2,老师很温柔，过年红包是真的? ，每周大计基都会有一点作业，但不会有5000字大论文（听说别的班有），上课有些迷迷糊糊，期末认真复习，拿了4.5超开心。
111455,350,沈睿,2019-07-01 14:52:37,3,4,1,明天考试\n\n10分压场\n\n老师讲的很好，希望能有个好绩点！
112843,350,沈睿,2019-07-05 05:40:59,-20,5,25,nice c程轻取4.8 还算满意
113013,350,沈睿,2019-07-05 17:32:24,2,4,2,爱老师，期末理论考30，实验一道题 都被老师给捞回来了 爱您！
113015,350,沈睿,2019-07-05 17:35:03,5,5,0,感谢老师不挂之恩！！！
113019,350,沈睿,2019-09-19 03:11:22,1,3,2,感谢老师不挂之恩！！
113031,350,沈睿,2019-07-05 18:07:22,2,4,2,虽然绩点不是很高，但还是特别感谢老师捞了我一把，几天的担心终于能放下来了。实话实说，沈老师上课讲的挺细致，并且明确告诉我们出题的范围，我们复习有重点。可能唯一有点遗憾的是沈老师没有什么题库能给我们练手，因此最后复习还是以看课本和做错题为主。其他班的同学可能或多或少在考试中见到过平时的题目，这可能是老师作业少的一点不好吧。
113068,350,沈睿,2019-07-05 22:27:15,5,7,2,其实我还是想知道老师48了？？？(QQ上的年龄显示
113085,350,沈睿,2019-07-05 22:56:42,3,4,1,谢谢老师不挂之恩！！真的太感谢了！！
113142,350,沈睿,2019-07-06 00:17:29,4,6,2,老师人很好，讲课思路清晰，作业不多。只要上课认真听，绩点不会低
113273,350,沈睿,2019-07-06 03:31:21,17,21,4,理论43都捞到七十多，真海底捞，这种老师，活该9.9
113287,350,沈睿,2019-07-06 03:59:40,2,3,1,沈老师我爱您
113578,350,沈睿,2019-07-07 00:25:32,6,6,0,我感觉我的才华配不上这分数哈哈哈哈哈哈哈哈
113818,350,沈睿,2019-07-07 17:07:57,0,3,3,好！！爱了
113918,350,沈睿,2019-07-08 00:37:39,5,6,1,感天动地好老师\n\npython小菜鸡把平时分算满了也只有85 被老师拉到87了 哈哈哈哈哈哈\n\n爱了爱了 课讲得又好给分又这么好的老师真的吹爆！！\n\n上学期大计基也是沈老师的给分真的好！\n\n
115594,350,沈睿,2019-08-06 09:46:46,-2,2,4,沈女神！女神！女神！
117696,350,沈睿,2019-09-29 04:33:52,-34,6,40,辣鸡老师\n\n
120100,350,沈睿,2019-11-17 12:20:59,3,5,2,一个可以在课程群里玩匿名的class
121803,350,沈睿,2020-01-22 03:02:38,2,3,1,听课感觉不错
121935,350,沈睿,2020-01-24 08:48:23,0,2,2,是好老师，但是大计基下午67节每次都会睡着😂
122391,350,沈睿,2020-02-26 05:39:21,1,2,1,老师上课讲解很详细很清晰，奈何本文科生对计算机这门课程本身实在不感冒，上课一直没有认真听真的很愧疚，期中考也只考了六十多。考试周背书，背模拟题，背历年卷，背计科练习，真是女娲补天。最后4.8，谢谢老师！
125810,350,沈睿,2020-09-14 11:42:41,-1,3,4,本小辣鸡python出分前来许愿，希望沈女神能捞捞我让我过
126135,350,沈睿,2020-09-18 04:59:49,0,2,2,woc真的海底捞我，我Python都准备1.5的人给我抬上3了，激动到失去言语能力！！！
126141,350,沈睿,2020-09-18 06:38:33,1,2,1,由于我自己期末考并不理想最后绩点只有3.3，但按规则计算一下平时分老师应该是给满了。老师讲课非常细致，赞！
126190,350,沈睿,2020-09-18 17:37:46,3,4,1,真捞王，py考了个和ads差不多的成绩(yds出来背锅)，最后给捞上了4
132667,350,沈睿,2021-02-03 08:17:17,-1,2,3,好老师不解释，讲课清楚作业很少，文科生期末自己疯狂背题库最后4.5，感谢老师！
132692,350,沈睿,2021-02-03 10:13:08,2,4,2,老师特好，上智云课堂老师也不建议，还很体谅我们，给分也很好(✪▽✪)
132767,350,沈睿,2021-02-03 13:27:48,-3,1,4,关心学生，上课耐心
132786,350,沈睿,2021-02-03 15:01:27,1,3,2,给人感觉很温婉的一位老师～给分很好！\n\n大计基复习要注意书本和ppt，基本都是书上有or讲过的。期末考意外的简单～
132880,350,沈睿,2021-02-04 09:59:08,4,6,2,吹爆，表白sr老师\n\n老师上课讲得很细致，仔细听还是有很多收获的；作业适中，而且老师会非常仔细地交代到；给分也比较好，我从来没有见过期中考试去参加就有五分的老师，而且是总评成绩的五分；降温以及疫情严重的时候，老师还在群里提醒加衣服戴口罩，非常贴心\n\n大计基选sr老师准没错，绩点出来真的惊喜，希望下个学期老师带我的python飞（手动狗头
132905,350,沈睿,2021-02-04 17:07:55,-4,1,5,大计基上课虽然略显沉闷，但老师人真的很好，很会考虑大家感受，作业跟室友其他老师比起来真的很少了，期末考试不难的，好好复习两天刷刷题完全可以，老师给分超好！
132914,350,沈睿,2021-02-05 02:16:11,1,3,2,老师真的好捞，期中63都能给捞上四
133080,350,沈睿,2021-02-07 14:15:58,-2,1,3,老师人超好！我期末补天最后也被捞上去了！给分真的高！
133596,350,沈睿,2021-03-02 14:06:49,4,4,0,非常好，选不上课就旁听！
133937,350,沈睿,2021-03-10 05:32:11,2,3,1,上课条理清晰，为人和善，很好的一个老师
134889,350,沈睿,2021-04-20 15:18:01,2,3,1,10分 不多说 我旁听不要学分都完成地停下来了！
135958,350,沈睿,2021-06-05 12:15:10,14,15,1,管理学院的沈睿老师，讲课逻辑清晰，愿意与学生打成一片，给分好；果然年轻的女老师比较会换位思考（创新管理）
136160,350,沈睿,2021-06-11 13:42:19,7,8,1,老师真的太温柔了，讲课超棒，有不会的也很耐心的讲解！！打十分是因为满分只有十分！
138935,350,沈睿,2021-07-12 01:09:22,203,212,9,我要当沈姐的🐶，xdm拉我上去
139382,350,沈睿,2021-07-15 03:16:52,0,2,2,老师讲课很细心，很棒
139455,350,沈睿,2021-07-16 01:16:40,3,4,1,老师直接把平时分拉满了哈哈
139600,350,沈睿,2021-07-18 07:02:10,0,1,1,py出分等死我了
142119,350,沈睿,2021-11-06 12:14:42,-1,1,2,dadaasdsa
146855,350,沈睿,2022-01-07 16:33:02,14,19,5,沈睿老师很好。就是大计基b的某助教实在是不行，私信许久不回，询问作业不回，难道老师和助教之间工作交接有误差?群聊里像是读不懂自然语言的样子，还展开说说……
146924,350,沈睿,2022-01-08 05:11:11,6,8,2,老师很好。建议换助教，一周不看钉钉消息是认真的吗
149951,350,沈睿,2022-01-18 03:28:50,3,4,1,沈妈妈超级负责认真！！教得很细致！解答问题也很耐心～每次课后作业都会讲评，也不强行要求我们刷分
149954,350,沈睿,2022-01-18 04:01:17,1,4,3,沈睿老师真的超级好！人特别好，平时分直接拉满了，甚至考试须知也可以算分hhh
149960,350,沈睿,2022-01-18 04:54:19,0,3,3,沈老师很好！作业不多，实验题只有一道是必做，是一个PPT，交了就拿满分。其他平时分也是比较容易拿满的。疯狂捞人的好老师！
150127,350,沈睿,2022-01-19 08:32:54,4,7,3,女神姐姐，4.8的绩点，你给了一个计算机白痴莫大的鼓励和安慰。谢谢您 ！我以后一定会继续努力的！！！
150883,350,沈睿,2022-02-20 14:30:36,-1,2,3,沈老师！！！我爱你！！！
151538,350,沈睿,2022-03-07 05:12:35,10,14,4,老师很好，就是助教不太行。问她东西不是不回就是告诉你B站请，还要分三行，一个字一个字打！
153519,350,沈睿,2022-05-03 12:50:44,7,9,2,不选沈睿白来浙大 yyds 😭😭😭😭😭
158311,350,沈睿,2022-06-28 08:28:17,2,5,3,虽然我是菜鸡听得很费劲但是真的是好老师，同学说我和老师长得像哈哈哈，在这求个捞捞
158509,350,沈睿,2022-06-30 01:56:28,11,11,0,老师超级棒！回答问题非常仔细 虽然别人觉得有点啰嗦 但是我觉得也是正常的 体系构建非常完善 很温柔 给分也很棒 我们班是超级难得那一次考试 理论还行 做了一道 平时小测都是满的 最后4.8！大爱！虽然没有满 但是老师已经很好啦 自己有提升真的很开心！希望学弟学妹好好预习 这样压力小一点！
158527,350,沈睿,2022-06-30 03:55:01,-1,3,4,还没出分，来打个十分～老师是真的好，讲的太棒了，比我大计基老师逻辑清晰多了，强推！
158536,350,沈睿,2022-06-30 05:39:55,1,3,2,老师给分真的好
158554,350,沈睿,2022-06-30 07:37:33,6,9,3,沈睿老师特别好！我愿称之为计算机课女神hhh她讲课讲的很好温柔又有耐心。平时分会给的很高，我python第一次挂科了，然后npy建议我选sr老师。果然特别好🥹第二次我认真复习了。加上改革后考试难度也降低了。最后成绩我觉得挺好。提一嘴npy的计算机基础也选的sr老师，都是高分。我大一预置的xsy老师…..低分飘过1.8。xs 这个故事告诉我们，人菜就要认清现实，选给分好的老师。不然会很惨，没错说的就是我。
158658,350,沈睿,2022-07-01 04:29:40,2,4,2,sr yyds！
158741,350,沈睿,2022-07-01 19:28:57,13,15,2,沈老师是个超级好的老师！这次Python分数有点低，但这是考试（13:30场）的问题，绝对不是老师的问题！
158919,350,沈睿,2022-07-03 09:05:04,3,5,2,沈老师超棒！
160088,350,沈睿,2022-09-13 06:20:21,1,3,2,yyds
161757,350,沈睿,2022-11-12 09:50:25,-18,4,22,经常布置大量作业，而且测验巨多
161763,350,沈睿,2022-11-12 13:30:23,7,9,2,上的是老师的大计基B。我们班的授课内容跟别的班不太一样，但都是很有用的知识，不学白不学，反正那些内容不考压力不大。真的很喜欢老师上课，讲得很清楚、很有逻辑、很容易让人听懂，而且非常的有意思。特别是老师录的视频课讲word，真的好爱。唯一感觉爱可能要消失的时候就是在写作业的时候，看见那个“命题人：课程组-sr”两眼一黑，没得查了。不过错就错了，老师上课会讲作业的。
161945,350,沈睿,2022-11-15 08:47:11,-5,4,9,。。。
164387,350,沈睿,2023-01-14 03:00:28,8,10,2,大学第一个满绩！谢谢sr妈妈！温柔的老师，负责的助教～可惜下个学期没有选上sr的python，好伤心！
164718,350,沈睿,2022-12-24 06:08:46,0,3,3,很好的老师
165243,350,沈睿,2022-12-30 13:26:51,2,4,2,sr!!!虽然我的大计基是依托答辩，但是不妨碍我喜欢srsrsrsr！超级温柔耐心的老师！非常好运的是python预置老师也是沈睿！啊啊啊啊啊啊啊开心死我啦！吹爆沈睿！温柔耐心负责的神仙老师！！！选她一定没错！
166057,350,沈睿,2023-01-15 00:25:43,6,8,2,真的讲编程很清楚，很适合对编程有些小恐惧的同学，快冲
166134,350,沈睿,2023-01-11 07:24:22,4,6,2,适合小白听课
166458,350,沈睿,2023-01-12 09:54:32,0,5,5,沈睿老师温柔贴心，讲课很认真，还会举例子帮助我们理解，助教也是非常好。就是今年出分很慢，我猜老师在海底捞。
166798,350,沈睿,2023-01-13 15:31:55,7,8,1,超级超级温柔负责的老师！助教也很耐心负责！！小菜狗被狠狠捞了呜呜呜
166809,350,沈睿,2023-01-13 16:13:12,5,6,1,啊啊啊sr老师我的神！！！
166813,350,沈睿,2023-01-13 16:33:12,1,4,3,好爱沈睿妈妈55虽然今年大计基课改改得依托答辩但还是被捞到了4.8🥹🥹好喜欢助教gg好耐心地回答问题55🥹🥹入股sr不亏🥹🥹
166820,350,沈睿,2023-01-13 17:08:07,-10,2,12,呵呵呵呵呵
166821,350,沈睿,2023-01-13 17:13:48,0,4,4,老师人挺好的 但是讲课重点不明确 没有想象中的好 djj每节课认真听作业按时做只有3.6 是我太菜
166840,350,沈睿,2023-01-14 01:20:39,3,4,1,啊啊啊啊啊啊啊真的是神仙老师！！讲课细致有耐心，很负责任，给分也很好！！爱了爱了
166843,350,沈睿,2023-01-15 03:47:43,5,7,2,爱死老师了！sr老师真的太能捞了，出分也是最快的，平时会很负责地给我们答疑，选sr真的不会后悔[涩涩]
166865,350,沈睿,2023-01-14 03:34:32,0,3,3,沈睿妈妈好温柔，平时解答也很有耐心
166872,350,沈睿,2023-01-14 04:28:58,-1,3,4,sr老师yyds。
166883,350,沈睿,2023-01-14 05:39:28,1,3,2,大计基B本身是神课一门，但是沈老师很温柔很有耐心，就是考试形式不太方便捞人。总体来说挺好的，给分也不错。
166981,350,沈睿,2023-01-14 13:01:53,-3,3,6,老师真的超好！作业少给分好，上课的时候还有眼神交流，很认真负责！
167161,350,沈睿,2023-01-15 04:29:27,2,6,4,我爱死sr妈妈了啊啊啊，狠狠捞我了
167290,350,沈睿,2023-01-15 11:48:58,-2,1,3,谢谢老师捞我！平时分给的超级大方，讲课和回答问题也很耐心。期末考前身体不舒服，几乎没复习，最后还拿了88分，虽然卡了但4.2也真的超级超级满足了！！
167616,350,沈睿,2023-01-17 15:49:21,12,13,1,感觉没有大家说的那么捞但是老师人还是很好的
167761,350,沈睿,2023-01-19 03:06:39,3,5,2,大计基这门课本身有很大的问题，我也没怎么学，就很烂。但老师人不错，讲得也比较细致。
168197,350,沈睿,2023-02-01 13:27:28,-6,12,18,不知道是不是课程本身原因，sr的djj是真的很无聊，需要在上课的很多句话中去寻找那一点点的知识点，上课真的很无聊啊，完全没有重点，真羡慕以前还有她发红包的学姐学长啊，现在在线上完全是找不到人的，sr可以在群里发消息的时候不会钉钉的私信也是真的迷惑，发的消息一两个月还是未读也是醉的，点到和小测也不像我c的老师会提前告知，签到时间也很短，确实没感觉到作业可以补交，会有提醒（至少我们这个班是这样的），一学期的djj全靠sr有个很好的助教（仅个人想法）
168311,350,沈睿,2023-02-10 13:37:35,1,5,4,她真的好能捞
170245,350,沈睿,2023-03-02 07:21:46,5,7,2,老师上课有点沉闷，但是大计基这个课本身就无趣。没有特别感觉到捞。有个很好的助教，会开答疑直播~
170478,350,沈睿,2023-03-05 13:49:24,1,3,2,很捞，djj和py都是沈老师
170479,350,沈睿,2023-03-05 13:51:45,4,6,2,没上过老师的课，但是智云听老师的大计基补天真的很清晰明白。楼下说老师讲得无聊沉闷的，建议听听sy哥哥，真不是肖老师的黑子，真心听不懂还很无聊。。。
170796,350,沈睿,2023-03-10 01:25:07,-10,3,13,。。。
171302,350,沈睿,2023-03-21 07:20:50,13,26,13,想和助教gg do love的那种地步😍😍😍
172817,350,沈睿,2023-05-08 01:27:57,2,4,2,不错不错
173616,350,沈睿,2023-05-30 08:50:55,3,4,1,老师好温柔好可爱，教函数的时候会用面包机做面包比喻
174104,350,沈睿,2023-06-06 08:32:44,4,5,1,人超级好，上课也很温柔
176982,350,沈睿,2023-07-01 02:55:27,4,4,0,春夏的python程序设计\n\nsr真的好好啊。讲课很适合小白，助教gg也很好。每次机房答疑都很用心。马上要考试了来评一下分，希望sr姐姐和助教gg把我捞上去。推荐程序小白们来选奥
177691,350,沈睿,2023-07-04 09:16:55,7,9,2,sr是我黯淡出成绩周唯一的光😭😭
177692,350,沈睿,2023-07-04 09:28:32,3,6,3,挺好的，后悔djj没选她，讲的挺清晰的
177715,350,沈睿,2023-07-04 11:42:04,4,6,2,大计基和python都是沈睿老师的 老师超级温柔超级好 讲课也很认真负责 给分也不错
178072,350,沈睿,2023-07-06 14:48:56,7,7,0,sr老师永远的神，大计和py都是sr老师班的，助教slksgg和zggg也非常捞。
179426,350,沈睿,2023-09-15 06:32:56,0,4,4,老师讲课非常细致！群里面讨论的氛围也很好
179469,350,沈睿,2023-09-16 12:54:30,3,5,2,捞王！！爱沈老师！！
180229,350,沈睿,2023-09-20 15:38:32,-49,3,52,退吧 我吐了 真的讨厌这个老师
180712,350,沈睿,2023-09-25 08:31:23,5,7,2,很温柔的老师，讲课前会把所有资料准时传到学在浙大上，讲课节奏也很好！上课在下面干干自己的事也没关系
181225,350,沈睿,2023-10-14 06:46:01,-7,3,10,作业贼多
181372,350,沈睿,2023-10-16 04:40:01,4,6,2,喜欢沈老师，很温柔很体谅学生，而且作业不多啊，，，楼下的在说什么
183058,350,沈睿,2023-11-22 02:50:36,0,3,3,【评管理学院沈睿老师-创业管理】\n\n超赞超推荐\n\n老师人很温柔，这个学期没有让我们去实践创业项目就很轻松（相比较其他班）！上课也很有意思会有一些小游戏，给分也很不错
183690,350,沈睿,2023-11-28 15:57:32,2,3,1,管院沈睿老师 创业管理\n\n老师尊都好温柔呀 上课有一些小讨论小游戏\n\n而且老师在评价我们的创业想法都会提很多各种角度的问题 甚至很多问题我们小组都没想过的 在作业完成上帮助我们开拓思路 最后大作业的创业项目老师还很用心的给每个小组一一评价反馈 反正老师真的很用心！赞赞 是个好老师哟 快冲就是了！\n\n作业：2小组 2个人
186038,350,沈睿,2024-01-08 03:40:40,4,5,1,真心好，沈老师很温柔上课也教的不错
189152,350,沈睿,2024-01-22 07:47:34,3,5,2,老师太好了🥰🥰
189154,350,沈睿,2024-01-22 07:58:05,8,10,2,sr妈妈！你是我的神！
189155,350,沈睿,2024-01-22 07:59:25,5,7,2,选选选！！！都选！！！\n\n老师人很温柔，还特别海底捞\n\n好好好真的好
189158,350,沈睿,2024-01-22 08:01:37,8,9,1,我知道沈老师也许不需要我的10分，但我必须狠狠打一个10分！！！！！！！
189188,350,沈睿,2024-01-22 09:37:52,7,8,1,出分了来给sr妈妈打一个满满的10分(≧∇≦)ﾉ上课非常非常认真而且也会很耐心细致地答疑⌯'▾'⌯
189195,350,沈睿,2024-01-22 09:54:07,3,6,3,特别好的老师！！！海底捞 感恩
189232,350,沈睿,2024-01-22 15:08:35,6,7,1,sr妈妈人太好了，简直就是捞王，笨人文科生python听不懂都可以被捞到很高，生病请假可以看直播也不扣分，老师超级关心学生的。平时签到也是早早写在黑板上数字签到。平时分直接拉满。uu们无脑冲！！！
189550,350,沈睿,2024-01-25 10:45:03,-2,2,4,吐槽一下djjB这课，期中考讲的不考考的没讲过，期末考python占很大比重，甚至还有huffman编码的大题，幸亏不开了
189644,350,沈睿,2024-01-26 08:33:08,1,4,3,我只能说捞王名不虚传，我永远的沈睿妈妈😭
189954,350,沈睿,2024-02-03 12:53:51,-14,3,17,靠，挂了我三次了，让我毕业吧，求求你了
190121,350,沈睿,2024-02-23 02:19:37,1,3,2,大计基掌管海底捞的神
190158,350,沈睿,2024-02-24 06:36:29,3,3,0,老师，伟大！！！！！！！
190629,350,沈睿,2024-03-12 08:58:33,1,3,2,菜鸟一枚 考前突击复习了几天 最后82分绩点3.6 泪目 真的是海底捞！！
191967,350,沈睿,2024-05-06 11:55:46,2,4,2,沈睿老师的创新管理！老师人超好！讲课很细致，很亲和，作业不多，一个小组作业，一个个人作业。最后给分超好！！！
193019,350,沈睿,2024-06-02 13:40:19,9,10,1,无可指摘的好老师
193876,350,沈睿,2024-06-20 11:49:55,4,6,2,沈妈！无需多言！
193970,350,沈睿,2024-06-21 06:43:54,8,9,1,沈妈！
194003,350,沈睿,2024-06-21 10:07:18,2,4,2,很认真负责的沈妈妈！
194055,350,沈睿,2024-06-23 11:11:07,29,31,2,---老师，想知道我过了吗[伤心]\n\n\n\n---过了，安心睡觉。\n\n\n\n啥也不说了，对得起10.0的评分
194191,350,沈睿,2024-06-22 12:03:16,8,9,1,好就一个字，我只说一次！
194232,350,沈睿,2024-06-22 17:32:00,10,11,1,预置上sr妈妈就偷着乐吧！真的是本人大一这一年遇到的最好最温柔的老师之一，而且明显有捞过，特别体谅大家
194237,350,沈睿,2024-06-23 00:44:19,5,7,2,好老师配享太庙
194247,350,沈睿,2024-06-23 01:20:17,10,12,2,伟大的神，沈老师上课ppt也做得很好，很认真答疑，最重要的是期末捞人力度超级大
194267,350,沈睿,2024-06-23 04:12:05,5,7,2,伟大，无需多言
194282,350,沈睿,2024-06-23 05:54:28,7,9,2,老师讲课真的深入浅出，基础不好的同学也能完全听懂，而且老师好温柔🥹，期末狠狠捞我🥹🥹
194311,350,沈睿,2024-06-23 07:52:22,7,8,1,闭着眼睛选sr就OK了孩子们
194514,350,沈睿,2024-06-24 08:18:50,1,3,2,很好很好很好
195013,350,沈睿,2024-06-26 09:22:08,9,9,0,现在考完了，一想到沈老师我就热泪盈眶，伟大无需多言，上课条理清晰，作业会认真讲解，不会的题问老师老师也会耐心解答，大爱老师，能选上沈睿老师的课是我上辈子修来的福气
196054,350,沈睿,2024-07-01 10:00:41,6,7,1,妈妈我爱你❤️
196725,350,沈睿,2024-07-05 02:11:36,0,3,3,沈妈妈人好好( ‘-ωก̀ )讲课用心，给分好！
196968,350,沈睿,2024-07-06 06:49:23,3,5,2,超级好的sr！！！选上的人偷着乐吧，期中三道编程一道没做出来，期末编程只做对一道题，最后的分数还不戳。说来惭愧后面的课都翘了（对不起sr），老师特别好，签到码写的大大的，还会提醒看智云的同学签到！总之无脑选sr！
197277,350,沈睿,2024-07-10 07:49:01,1,8,7,沈睿老师真的很好！！！上课踏踏实实地把要考试的知识都教给我们，作业不多且每次上课都会进行讲评。全部都是数字点名，还会提醒大家签到。高中没选技术，平时也没咋努力，但是最后绩点5.0超级感谢老师！选上sr的课就乐着吧！
198209,350,沈睿,2024-09-05 03:32:05,0,2,2,老师人超好！同学快冲
198272,350,沈睿,2024-09-06 04:17:09,3,3,0,超级无敌爱！超级无敌好！
198328,350,沈睿,2024-09-07 06:18:46,6,8,2,呜呜呜呜呜呜沈睿老师😭😭😭我不允许任何人忤逆你！！！
198713,350,沈睿,2024-09-11 05:34:30,2,3,1,沈老师我的女神！上课非常细致，解答问题也很耐心，总之就是十全十美🌹爱她
198763,350,沈睿,2024-09-11 12:02:44,4,4,0,在大计基的课堂上给沈睿老师评分，包10分的啊啊啊，啊啊啊老师好温柔老师好美丽老师我爱你啊啊啊
200512,350,沈睿,2024-10-18 04:11:33,0,3,3,沈睿妈妈捞我
201598,350,沈睿,2024-11-04 15:45:43,0,1,1,我的计算机分是您给的呜呜呜！！！
201599,350,沈睿,2024-11-04 15:56:00,0,0,0,老师我爱你
201600,350,沈睿,2024-11-04 15:56:42,1,2,1,沈睿妈妈！捞捞！
201894,350,沈睿,2024-11-07 08:13:13,6,8,2,不管是计院的沈睿，还是管院的沈睿，都闭眼冲就是了！都是好老师，讲课好，给分也好，什么都好！
202656,350,沈睿,2024-11-13 15:56:37,3,5,2,管院的沈睿仙女～简直是浙大张雨霏，又美又善良，讲课无敌好，给分也超好，无脑冲，沈睿仙女姐姐我爱你！（学生对老师的敬爱哈）
205813,350,沈睿,2024-12-12 06:07:52,-2,1,3,人美课好😭
206166,350,沈睿,2024-12-13 06:55:45,1,2,1,老师超级温柔的，有问题都好耐心地讲给你听，是我学的太烂了（哭）
207186,350,沈睿,2024-12-19 15:21:47,4,4,0,爱您永远
207910,350,沈睿,2024-12-25 02:51:50,2,3,1,我是沈睿小姐的狗
208041,350,沈睿,2024-12-25 09:46:10,5,7,2,是周三九十孟老师班上的同学，打期中之后就一直来蹭沈睿老师的课，老师人很好，讲课有条理，非常清楚，在孟老师课上我基本上是听不懂也学不到什么的，是沈睿老师拯救了我的Python🥺🥺爱你老师😘
208314,350,沈睿,2024-12-26 17:50:13,0,2,2,爱您爱您爱您爱您
209810,350,沈睿,2025-01-07 07:02:53,-5,2,7,轻声细语，美中不足
211307,350,沈睿,2025-01-11 07:22:24,5,6,1,我是沈姐的🐶，谁也别跟我抢哈
212085,350,沈睿,2025-01-13 07:12:47,2,3,1,注意！！创业思维与行动的sr老师和计算机的sr老师不是同一个！！不知道为什么查老师上面合在一起了
212524,350,沈睿,2025-01-14 06:41:14,8,8,0,这个学期同时选上了管院和计院两位sr老师的课，很有趣的经历~两位老师都非常非常好！给分好的不敢想，选到就是赚到！
213287,350,沈睿,2025-01-17 00:41:14,4,5,1,sr妈妈我爱你❤️
213288,350,沈睿,2025-01-17 00:51:16,2,5,3,沈睿老师真的太好了，上课讲得很详细，也易于理解，给分也特别好，必须10分
213291,350,沈睿,2025-01-17 01:03:28,6,8,2,沈睿妈妈神中之神…我不允许任何人忤逆你…大计基b学得稀里糊涂的竟然被捞满了TT 特别温柔的老师，点名都会提前一节课通知，期末周甚至会发思维导图帮我们复习。沈睿你是我永远的妈妈……
213296,350,沈睿,2025-01-17 01:15:17,5,6,1,【计算机科学基础B/大计基B/计科B】老师上课讲的非常清楚，重难点突出，给分非常好。lz前期上课没认真听，一直到数制才认真听，每次小测 95 左右，期末考试认真复习 ，基本都会，最后满绩💪相信老师海底捞
213309,350,沈睿,2025-01-17 01:54:34,5,5,0,讲课娓娓道来，给分神中神！
213370,350,沈睿,2025-01-17 05:33:51,2,3,1,虽然sr麻麻不缺一个10分但是10分10分10分❤️
213392,350,沈睿,2025-01-17 07:27:06,0,1,1,神中神！
213399,350,沈睿,2025-01-17 08:11:38,1,1,0,神中神！
213508,350,沈睿,2025-01-18 02:51:58,13,14,1,|Python|沈睿妈妈是这个世界上最好的老师！我记得有一阵子老师嗓子哑了，上课还一直因为自己的嗓子怕我们坐台下听不清给我们道歉呜呜，很心疼老师。老师特别有耐心，而且助教学长也特别好特别负责。如果选上老师的课真就偷着乐吧。我是重修的学生，老师的魅力和善良让我时刻心存感激，态度特别端正跟着老师学一个学期，总评得了87分，千言万语也表达不出对沈睿妈妈的感谢，老师就是我在编程学习路上的引路人！
213886,350,沈睿,2025-01-21 03:54:39,4,4,0,唯一真神，给我捞完了
214223,350,沈睿,2025-01-29 12:12:55,1,4,3,沈睿是我的，你们别抢！！！🤓👍
214577,350,沈睿,2025-02-13 13:19:54,1,1,0,老师真的很耐心，讲的课连我这种电脑白痴都全部听懂了，小测可以水，最后给分也很理想，太棒了，而且会很耐心的答疑！
214609,350,沈睿,2025-02-14 13:00:32,1,1,0,sr麻麻！
214996,350,沈睿,2025-02-20 02:43:33,2,2,0,妈妈我爱你
215366,350,沈睿,2025-02-25 11:14:56,3,3,0,3.6是我的问题，绝对不是沈睿老师的问题，太贴心了
217837,350,沈睿,2025-04-17 06:18:37,3,3,0,女神级别的老师，非常非常耐心，讲得通俗易懂（只要认真听课的话），机房可以不去，给我了妈生睡眠！！钉钉或者课前课后问问题都会耐心解答，点名什么的也挺为学生着想，有时候睡过头迟到挺久了，老师还开放着点名。如果有100分那就是100分了
19664,361,张彤或,2016-01-25 05:03:34,17,20,3,这老师什么都好，就是比张彤彧差两撇
64138,361,张彤或,2017-12-21 05:20:19,0,0,0,这个名字有毒
127062,361,张彤或,2020-11-04 14:52:32,0,0,0,hhhhhhh
160417,361,张彤或,2022-09-22 00:44:35,3,3,0,这老师比我老师差两撇，有碰瓷嫌疑
1212,373,周昆,2015-03-21 16:41:51,13,17,4,周昆大神脑残粉
22693,373,周昆,2016-03-10 02:48:06,4,6,2,吼啊 最喜欢他了
133560,373,周昆,2021-03-02 06:21:00,7,7,0,周昆大神脑残粉++++++
196409,373,周昆,2024-07-03 08:47:41,2,2,0,计算机图形学研究进展：有可能点名，这门课选的人不多，一旦来的人少了就有可能点。作业是一篇论文的阅读报告，和最后的一篇顶会论文复现 cg cv的都行。最后感觉给分有点低了。
196419,373,周昆,2024-07-03 09:06:49,2,2,0,周老师脑残粉，但这课最后给分是不是有点随性了
197589,373,周昆,2024-07-20 11:26:40,-2,1,3,计算机图形学研究进展：\n\n这门课按专题授课，是很多老师一起上的。如果对图形学方面感兴趣、且具备一定基础的话，听起来会比较有意思。\n\n平时几乎不点名，唯一一次点名应该是期中之后的第一次课，因为那次来上课的人实在太少才点的（虽然平时人也挺少的）。\n\n实验课不用去。作业有两个，都和论文相关，前者是写论文阅读报告，后者是论文复现 + 期末展示。两篇论文不能相同。\n\n一学期下来收获很大，见到了许多 cool 的东西，而且不仅仅局限于图形学，还能学到很多学习、研究的方法。\n\n我是外专业的，选这门课只是因为兴趣。尽力写了阅读报告，尽力做了论文复现，再加上略尴尬但还算完整的展示，最后总评 99，供参考。
220477,373,周昆,2025-06-18 06:42:01,0,0,0,25 年图形学研究进展：说是要点名但只在期末展示前一次课点过；期末项目说要和开源代码进行比对但实际上并不那么严格（笔者有一两个文件照搬没出问题）。中途会有各个方向的分享，对图形学感兴趣的可以冲
30545,416,李莹,2016-07-02 01:50:51,-6,3,9,老师人很和气。
52430,416,李莹,2017-06-20 03:40:24,4,11,7,不知是不是课程本身的原因，计算机专业的我觉得这是我上过的专业课里老师讲课都能让学生听得懂的课。可能以前的课不是课程总人数太多（听课效果不好），就是课程安排不合理，没有足够的时间让老师讲的让一般人容易明白吧。
70269,416,李莹,2018-01-26 10:26:39,-3,4,7,李老师真的是对学生十分关爱的老师。只要态度端正，恐怕没有同学在他手下挂科吧。前提是态度端正，笨不笨没关系。
82354,416,李莹,2018-07-08 03:25:14,-3,3,6,考前给老师打个满分攒人品，出分再来改
84453,416,李莹,2018-07-13 01:47:57,-6,1,7,老师非常平易近人 问问题都会很认真的回答 给分也还好～推荐推荐！
109528,416,李莹,2019-06-16 14:12:30,4,4,0,大程有点恶竞…好在像是按照等级打的分
112694,416,李莹,2019-07-05 00:40:26,-5,3,8,老师的编译原理讲得特别好，清楚，能听懂。但是就是讲的有点快，想思路跟上一节课，还是有点累的。
112721,416,李莹,2019-07-05 01:10:22,-3,2,5,老师水平好上课条理清晰 但是可能我比较菜的缘故 开小差后经常会听不懂 所以适合认真的同学 给分属于正常水平
135869,416,李莹,2021-06-06 20:57:37,2,7,5,上三周课小测两次\n\n一学期上下来几乎节节小测，比其他班老师小测次数多很多，其他班一个学期下来小测也就两三次（不算期中考试）\n\n期末大作业比其他班时间紧，难度高，给分低
137437,416,李莹,2021-07-04 07:15:04,-2,3,5,讲课真的好清晰 orz
138522,416,李莹,2021-07-09 15:29:11,-4,11,15,怎么说呢，李莹老师的编译原理算得上是我3年来上过的质量最高的了！可以听得出来老师对课程内容有很深的理解，而且可以很有调理地讲出来。选课前就看到评论说老师上课节奏比较快，体验下来确实也是这样的，但只要少一点走神还是完全可以跟上的~\n\n\n\n平时作业应该是统一布置的，所以也不存在作业量多少的问题。常规实验有两个，比较水。大程是要做一个编译器，感觉确实有卷的趋势；完成基础验收只有B+，实现两个进阶功能才有A+，个人感觉大程的要求验收评分都还是有待改进的。\n\n\n\n有点遗憾，最后总评没拿到很理想的分数，不知道是因为final没答好，还是大程没卷够。但如果重新让我选一次，是选这几分总评，还是选听李莹老师一学期的课，我当然毫不犹豫地选后者：）\n\n\n\n总而言之，无脑选李莹老师的编译原理就对了！
138844,416,李莹,2021-07-11 07:26:53,0,3,3,老师讲课的结构很清晰，反映在智云课堂复习的时候能够开2-3倍速。开卷，前端的几章作业做了就行，不过后面几个章节比如代码生成和运行时环境在作业中涉及的比较少所以考试的时候还是有些头疼。尤其是这次期末那个符号表，我虽然知道他在干什么但是实际上给一个存储结构真不知道哪个放哪里。
139490,416,李莹,2021-07-16 12:29:52,-5,2,7,老师讲得特别好，给分也不错，小测比较多，但只要平时学明白了不是什么难事。而且个人觉得这也有助于期末复习，反正我期末没怎么看（时间全用来看平时不怎么学的AI了）\n\n本科最喜欢的课程，以及本科最喜欢的老师之一
139577,416,李莹,2021-07-17 13:27:13,1,3,2,老师和助教真的很棒，编译原理的课程进度和实验进度安排真的一言难尽
140041,416,李莹,2021-08-23 14:42:48,-1,2,3,好好好
156642,416,李莹,2022-06-20 13:18:18,-2,1,3,老师讲课很好，助教也很负责
158431,416,李莹,2022-06-29 08:21:40,4,11,7,老师讲课讲得挺好，助教也挺好，小测较多，大程比别的班要求高很多，给分一般
158439,416,李莹,2022-06-29 09:23:48,-3,3,6,算是编译原理里比较不错的老师了
158462,416,李莹,2022-06-29 12:55:46,0,2,2,讲课好\n\n大程要求比较高，大家也都做的很好，如果只是做得中规中矩可能会扣不少分，和别的班比起来就给分差一点
172244,416,李莹,2023-04-23 13:43:05,14,16,2,课改后的编译原理就是依托xx
174883,416,李莹,2023-06-19 09:50:04,9,11,2,建议选刘忠鑫老师，允许完全用llvm，而且展示不是可选项是加分的，作业小测交了就给满，李莹老师讲课算比较用心，但是大作业用llvm要扣分，平时作业、大作业、小测全部都要评级，还必须要求展示，实验报告展示都算分。感觉事情有点多，尤其是展示和实验报告感觉完全没有必要
175341,416,李莹,2023-06-24 05:25:56,3,3,0,不知道为什么感觉上课很催眠但是听回放又会发现讲得很清楚；大程要求挺高，也没有明确的给分标准
176604,416,李莹,2023-06-29 12:04:02,3,5,2,这场考试，击碎了我的保研梦
177424,416,李莹,2023-07-04 03:10:30,2,4,2,这个老师要求有点高，但是讲得又没有很匹配他的要求，给分也不是很高，为了绩点还是选刘老师吧
178366,416,李莹,2023-07-11 03:11:10,3,5,2,说句实话讲的也一般，不如刘zx清楚，给分也一般般，并且离谱的是，助教很抽象
178595,416,李莹,2023-07-16 06:57:12,1,3,2,老师讲课一般，助教是真sb，建议后来的都选lzx，老师讲得好，助教也很好。
180542,416,李莹,2023-09-22 14:30:20,-18,3,21,老师您认识李勇吗？那个出生
191456,416,李莹,2024-04-23 02:05:19,16,18,2,上过课的都说出生，敢选就敢给你低分，主打的就是从评分恶心你，你可用没有做错，但必须给你打低分。\n\n不在乎分数的尽管去选，你想要好看一点的分数再去选我只能说祝你好运。
193227,416,李莹,2024-06-04 17:07:59,20,24,4,事这么多，你对得起这个评分吗？退钱，李嗨下课！\n\n说是讲课讲的好，但也就那样照着ppt读啊\n\n而且事情这么多分还比别的班低，每天还要搞点名，上课点名提问，随堂纸质小题还不算小测，但你一定要交，真的无语了。\n\n别的班3个lab，还各种加分，他说我们班不一样要求比较高，你咋长的比别人矮呢？\n\n助教真是私募了，明年要是lg当助教千万快跑！哦，忘了，他明年要被赶去实习了，没资格做助教咯！交个作业还要白眼你，而且平时态度很不友好，感觉不知道在装什么坤吧，22年硕士敢凶我们21年学长是吧，滚！
193430,416,李莹,2024-06-10 14:47:41,8,12,4,21年那个评论，李格，上大号，还在舔李莹，还上课质量最高？你是不是课都翘完了，听个李莹的课给你听高潮了。\n\n酱紫扣分？实验比别人班多做一个最难的，平时给分还库库扣你，lg考个专硕破防了来搞学生了？\n\n作业分是拿不满的，实验任务是两倍的，期中考试是找地方扣分的。
194397,416,李莹,2024-06-23 15:33:58,8,13,5,我觉得下面同学对于助教lg哥哥的评价完全是误解\n\n虽然他看起来很严格，但是刀子嘴豆腐心，很为同学们着想\n\n找他每次回复都很快而且讲的也很实在，平时分也没怎么给大家扣\n\n其实可能是老师的硬性要求导致的，大家不要再骂助教gg了，要骂就骂ly吧
194719,416,李莹,2024-06-25 05:15:14,10,12,2,你出的卷子？
194786,416,李莹,2024-06-25 11:49:14,2,8,6,感觉很多李莹该背的锅都给助教背上了，尤其是不太公平的教学安排，其实感觉跟助教没什么关系。\n\n助教人还是很好的，期末还给我们整了点复习资料什么的，我觉得助教背负了太多不该有的骂名，但是李莹这个教学安排是否有点那个了？别人少做1/3的实验，感觉有点膈应本班的学生了。
194937,416,李莹,2024-06-26 03:45:46,17,18,1,编译出卷子是这样的，同学们只需要骂 ly 就好了，而 ly 每年变着法折磨同学就要考虑很多了。\n\n\n\n也许有一天，我是说也许，我们会对编译原理失去了信心，因为李莹的宰治在今日为止还在维持。
194938,416,李莹,2024-06-26 03:47:07,11,12,1,以为自己讲得很好吗，以那么高的要求对待学生\n\n先严于律己，再严以待人\n\n学生都怨声载道了还要层层加码，感觉和学生对着干很有成就感吗？
194951,416,李莹,2024-06-26 04:45:37,8,10,2,你看你的卷子自己做的完吗？老谭玩意儿。其实相比之下助教算是挺好了，每次问问题也会比较热心的答复，平时分这个事情估计是莹酱下的指标吧
194960,416,李莹,2024-06-26 05:20:31,11,12,1,不会教，要求多，给分差，期末出卷题量巨大，估计他完全没有做过\n\n之前他的分数高完全是因为其他老师更不会教
195640,416,李莹,2024-06-29 06:40:43,5,6,1,这狗屁编译原理出的什么试卷，真实私募了
195727,416,李莹,2024-06-29 17:53:07,6,7,1,平时分很差
195730,416,李莹,2024-06-29 17:56:23,10,11,1,不是，李莹你平时分这么给要脸吗？我们班做最多的实验，半期挨这么严的扣分，你对得起班上的同学吗？真的是不要脸
195734,416,李莹,2024-06-29 20:50:14,4,5,1,考试题量太大，可能老师认为每道题目十分钟做出来就差不多了，但是编译原理十三个章节全是不同种类的数学题，全都学会的简直是超人，不管复习多久期末考试的时间只能掐着用，难顶\n\n平时分不会给满，跟隔壁班猫猫头老师一比，只能说绩点膨胀这事真把大伙急麻了
195741,416,李莹,2024-06-29 23:52:28,0,2,2,垃圾老师，狗屎助教，谁选谁sb
195780,416,李莹,2024-06-30 02:30:20,5,5,0,千万别选
195798,416,李莹,2024-06-30 03:25:54,3,5,2,平时分要求高的一批，考试题还出这么多，快逃
195842,416,李莹,2024-06-30 08:56:39,9,11,2,事情真的多的要死，给分差的要死，你想想你在大三下，有升学压力，科研压力，各种压力，你在编译原理这门课上付出比其他班跟多的努力，但平时分狠狠给你一巴掌，你甘心吗？\n\n除非你确实很厉害，但凡你看到这条评论还头铁选李莹的课的，绩点被搞了自己躲在被窝掉小珍珠。\n\n专业课肯定是可以补选的，预置了直接退了补选姚培森，跟李莹一比高下立判，少一个目标代码生成的实验，关键实验ddl还可以考试结束交，我的提醒就到这儿了，只有大家都不选李莹的课程，他才能被他恶心的行为给反噬。
195843,416,李莹,2024-06-30 09:16:30,1,4,3,我只能说，李莹是个坏东西，助教不太是好东西，尤其是期中，过程分框框给你扣，生怕你绩点拿高了。\n\n学弟学妹不要被李莹的分数骗了，他现在6点几，你知道吗，他其实是从9分掉下来的，6分不是他的极限。
195869,416,李莹,2024-06-30 12:34:18,2,4,2,学生只要学习就行了，ly要考虑的就多了。什么时候上课开飞机，什么时候开个小测，什么时候期末出8道大题，都需要深思熟虑。
195870,416,李莹,2024-06-30 12:36:01,6,7,1,当你考前一天还在纠结50分的大题是5道还是7道的时候，第二天早上接到卷子发现xx给你准备了8道，幽默
195883,416,李莹,2024-06-30 14:02:51,5,6,1,卡绩，期中改卷严格，平时分相对其他教学班偏低\n\n今年ly班实验改革，单人完成有一定的工作量，并且实验文档还在建设不够完善。确实能够感觉到在实验中能够学到东西，我也并不反对在实验上加作业量，但我希望在我比别的班同学付出更多努力后能够得到更好的成绩\n\n追求绩点想要更高平时分的同学建议移步隔壁班\n\n不过期末考试应该是统一的，改革以后这课题量一直都很大，选其他老师应该也一样
195932,416,李莹,2024-07-01 01:53:51,3,6,3,比不上姚培森一根，任务多，扣分严，实验安排都不一样，这门课还有公平可言吗？
196045,416,李莹,2024-07-01 09:27:59,5,5,0,一个学期吧分从9点几上到5点几，真有你的，你先把各班实验不统一的问题解决一下吧，别到时候两杯任务量还没别班分高
196090,416,李莹,2024-07-01 13:33:57,4,4,0,给分很差，平时分被扣了不少，要求严格给分差
196125,416,李莹,2024-07-01 17:44:14,2,2,0,给分确实很差了
196330,416,李莹,2024-07-03 02:14:24,6,8,2,李莹纯在恶心人
196358,416,李莹,2024-07-03 05:18:55,5,5,0,给分不好，平时事情巨多，隔壁班只做三个实验还是三人一组合作完成，ly是个人单独完成四个实验，给分还巨烂，只能说快逃
196373,416,李莹,2024-07-03 07:03:05,0,3,3,最后一门专业课有被李莹和他的助教恶心到
196407,416,李莹,2024-07-03 08:44:03,9,11,2,老师上课质量非常一般，lab改革成单刷直接给我们这种不太擅长代码的人当头一棒，我是直接放弃了lab2及以后的实验，完全靠平时分 期中 和期末，最后拿了74分。我在放弃完实验后和助教lg谈了很多次，平常有疑问也都问他，其实他对我帮助很大的。看到他被骂我出来说一句，仅此而已。然而李莹是纯纯的出生。
196421,416,李莹,2024-07-03 09:11:49,0,2,2,上课就是念ppt，比别的班多一个实验，但是课改后的实验总体比以前简单了，但是事多分少。今年助教有点逆天，感觉有点装x。
196430,416,李莹,2024-07-03 10:08:36,0,1,1,助力一下李老师查老师评分俯冲一点几
196465,416,李莹,2024-07-03 14:15:02,2,2,0,凭什么我们班单人solo四个实验，别人班组队三个实验；凭什么我们班做的更多平时分更低
196474,416,李莹,2024-07-03 16:14:47,0,1,1,破案了，李莹就是故意卡绩，直言，某些同学期末87不配给满绩，助教都想帮着给满的但是李莹就是故意卡你一下，放姚培森班能给你捞一档就是一档，高下立判了
196547,416,李莹,2024-07-04 04:23:39,1,1,0,你这出卷子出的有点出生
196556,416,李莹,2024-07-04 05:22:43,0,1,1,你出的卷子你自己做过吗？
196646,416,李莹,2024-07-04 13:16:40,1,2,1,好好反思一下实验安排吧，要求严格给分还差，实验多的要死。还是单人solo，关键是都做完了平时分还给我扣了5分
196745,416,李莹,2024-07-05 03:05:10,0,1,1,上课讲到自己都不懂了，不知道之前说讲课好的人怎么想的，况且听课你可以听智云，根本不用选他的课，你选他的课你就等着solo比别人更多的实验吧，有你的好果汁吃
196825,416,李莹,2024-07-05 10:52:55,1,1,0,李莹故意扣你分的，实验活多吃力不讨好，给分还差
197657,416,李莹,2024-07-25 01:22:48,0,1,1,李老师变牢李可还行
197807,416,李莹,2024-08-14 08:10:26,0,1,1,ly真的讲课讲的好吗？这还不如照着屁屁踢念经呢，建议自学看书
218256,416,李莹,2025-04-22 08:38:55,0,0,0,讲课除了念PPT还会干啥？稍微难点的地方连解释都不解释，全靠学生自己猜呗？
44443,437,童若锋,2017-01-18 00:06:01,8,11,3,到处扣分
65725,437,童若锋,2018-01-08 14:04:25,2,3,1,还可以
66493,437,童若锋,2018-01-17 03:46:51,6,8,2,老师真的是是想尽办法给你们扣分
73024,437,童若锋,2018-01-31 15:58:19,9,12,3,老师很严格 上课尽量让每个人都听懂 这个没得黑； 但怎么说呢，童老师有时候有些行为会让学生感觉不太舒服；但总体来讲，童老师的图形学还是能让你学到扎实的图形学的知识的。\n\n当然这学期必须要比心助教，表情包助教大大让这门课的体验好了很多很多！\n\n为助教大大打电话～
73117,437,童若锋,2018-02-01 02:48:46,6,7,1,组里什么都没干的因为刷脸多拿了高分，基本包揽所有工作的拿了低分，呵
76543,437,童若锋,2018-04-13 09:57:42,8,10,2,讲得数值分析很好，能让学生很好的理解。\n\n至于扣分的不大清楚，估计人家大牛也不在意本科生的成绩，只要满足要求就好了\n\n
87094,437,童若锋,2018-09-20 08:34:04,2,2,0,水平高
115471,437,童若锋,2019-07-26 06:50:42,3,4,1,图形学讲的还挺有意思的，偶尔会有课上quiz当点名，小程比较简单，没期末考试，不过大程要好好做。
122007,437,童若锋,2020-01-30 15:05:39,2,3,1,是真的能扣分
122618,437,童若锋,2020-03-09 02:33:10,2,2,0,上课问的问题如果不是他想要的答案，甚至是同个意思但是不是他想要的那个词就觉得你没有回答到本质，有种打哑谜的感觉
123604,437,童若锋,2020-06-10 12:40:00,7,9,2,上过 NA，评分不应该这么低啊，上课讲的很清楚，也没有乱扣分，分数由课堂讨论 + 课堂发言 + 1 次展示 + 实验 + 期末构成，课堂讨论其实就是回答（每组都要，不是抢答）老师课上的给出的问题，都是讲完一个知识点之后的简单应用（所以上课不来这分就没了）；课堂发言（个人，只要举手发言就计分）占几分忘了，应该是5次共5分，预习一下相对更容易回答出来；展示就是在给的几个主题里选一个，也不难，这个是其他同学打分的；实验应该占分挺大，而且感觉是这门课最难的部分，因为某些题的测试点是真的... 但是网上能找到不少题的思路，要实现的算法基本都是 ppt 上有的；期末开卷，不难，真的，开卷的数学考试，只要不是考前没搞懂，即使忘记某些定理细节都能翻书看，还是挺友好的。说扣分的，自己想想上面这五个部分哪里没做好吧，总不能实验没做完反而怪老师扣分吧
124645,437,童若锋,2020-07-04 17:24:21,6,6,0,cg大程好好写，实验、作业好好做，小测不崩，即使发言次数不多也能高分的
127232,437,童若锋,2020-11-16 11:09:45,2,2,0,我觉得非常好，也关心学生，讲的也清楚，课后没作业，做完lab和一次展示就行
131515,437,童若锋,2021-01-28 00:25:32,2,4,2,刚刚上完NA，平时学的时候感觉没有学的很懂，但是老师讲的其实还不错，主要是没有作业巩固。考前把xww班部分习题刷了一下，然后认真把课件理解了一下，期末比较容易就得高分了。其实主要也是在平时，research和discussion也认真做基本就不会扣太多分的。8个Lab写程序容易出现比较搞心态的bug，需要提前做，不要积到周末。谢谢老师的97
147342,437,童若锋,2022-01-12 10:56:44,0,1,1,水平高，给分比较好，但图形学容易温水煮青蛙（老师不太会一直提醒），自己要拿捏好大作业时间。
147905,437,童若锋,2022-01-11 06:35:48,1,1,0,感觉给分有点...小差
147906,437,童若锋,2022-01-11 06:35:26,0,0,0,感觉给分有点...小差
158484,437,童若锋,2022-06-29 15:14:01,0,1,1,坐标数值分析，童老师讲课很清晰，没有作业，只需要完成PTA上面的题目，给分感觉挺好。只是数值分析比较难，需要自己花时间完全搞明白。
168092,437,童若锋,2023-01-26 12:46:43,1,1,0,图形学，给分有点拉
168107,437,童若锋,2023-01-28 02:56:42,3,3,0,图形学，给分意想不到的差，已哭晕ಥ_ಥ
168108,437,童若锋,2023-01-28 03:35:23,4,4,0,坐标图形学，客观来说一下，童老师上课还是讲的不错的，但是会有随机小测当点名（据说到了就给60%），而且上课一定要发言，发言占总成绩5分，这个前期水一水就行了，后期网课而且比较难基本就不听了…\n\n作业一共有6个实验和5选2的bonus，实验感觉就最后一个难一点，但容易温水煮青蛙（两周才验收一个），bonus做了分不会低太多的。\n\n大作业今年多了个ai方向的选择，而且今年换了个新的助教，感觉对以前的实验内容不太了解，对大作业的帮助也几乎没有（本人选的是ai方向）…所以做的时候比较痛苦…
168185,437,童若锋,2023-02-01 07:34:43,3,3,0,图形学，给分真的不行，快逃
177807,437,童若锋,2023-07-05 02:32:49,2,2,0,讲的基本清楚，给分不错，但春夏的期末考试难度比秋冬大太多，题目数是两倍，难度也大，不建议春夏选。
189749,437,童若锋,2024-01-28 09:20:44,1,2,1,数值分析。童老师看上去很严肃，实际上还是挺关心学生的，期末考考的和期中考试、平时练习大差不差，而且只要期末考考好了，平时分也会给高点（我小测和期中都只有60分，最后总评也给了很高）。童老师讲课水平很一般，平时上课一肚子难受，但是期末出分后我愿拜为义父
189787,437,童若锋,2024-01-29 05:41:44,6,6,0,图形学。平时lab全部完成，小测基本也没问题，大作业也完成了全部的基础要求。期末绩点3.3，不知道分扣在哪里。慎选吧
189794,437,童若锋,2024-01-29 09:48:29,-4,3,7,图形学，没有期末考，但最后一节课会有个总的小测试（开卷）。平时lab类似填空，甚至不用很理解就能做，相比别的班简单多了，不过实验报告会看代码，可能会扣个十几二十分。大作业满分40分，其实不用怎么花里胡哨的，完成最基本的要求就能拿到相应的分数。有一次小测没到，发言了几次，做了一个bonus，大作业做满了，最后给分95，供参考吧。
189801,437,童若锋,2024-01-29 14:41:01,1,1,0,老师人很好
190046,437,童若锋,2024-02-16 03:36:22,1,1,0,数值分析。童老师人很好，讲课清晰，难点会从多个角度切入进去讲，不点名，作业不用交，有两次小测（一次在期中，一次在期末，重点都会有涉及很重要）。平时上课会有discussion当做小练习，难度不大，每个组要做一个research topic（题目越往后越难）。期末开卷，难度不大，但要熟悉PPT，然后计算细心点。最后给分很好，比预期好，谢谢老师！
211999,437,童若锋,2025-01-13 04:15:53,1,1,0,这学期图形学体验还是不错的。就上课而言，老师语气有点平，但是其实讲的挺清楚的。而且童老师是真心想让我们学到图形学的一些新东西，在课时不够的情况下直接放弃小测选择讲前沿技术。\n\n课程分数构成：\n\n平时分：30。这30包括了作业、偶尔的小测、发言分（、实验课点名）。其中发言分占5分，只要发言达到五次就行，积极回答一下前期的问题就行了。作业是学期初直接全部公布的，而且基本都是前几章的东西，疑似祖传而且难度不大。小测分平时的简单小测和最后一节课的总的小测，都是到了就给保底60。平时小测可能突击可能通知，难度不大。这学期因为乱七八糟的调休和课时安排，老师只进行了一次很简单的小测，放弃了最后一节课的总的小测，所以这部分显得很好拿（）。老师说小测分是作业分占比的两倍，虽然我怎么分也分不出整数占比。最后是实验课点名。实验课是每节都要去的，因为可能在实验课上突击点名。\n\n实验：30。有六个小实验和五个bonus。小实验做的内容可以让我们熟悉OpenGL的使用方式，除了后两个实验外每个实验基本就十行代码左右，而且网上都有参考（这是可以说的吗。这个学期新助教给分挺好的，只要最后实验效果不错就是100或者95往上，对实验报告的要求并不高。然后一个bonus大概是3分，所以这一部分想拿满是容易的。\n\n大作业：40。三人组队做一个openGL项目，有两种选择，一种是CAD（可能需要一些人工智能基础），一种是做一个小游戏。对小游戏而言，40分为基础部分和额外部分。基础部分35分，都是前面实验涉及过的一些技术，可以参考着完成。额外部分有很多可选要求，每个要求完成就是5分，挑几个比较简单的要求完成一下基本问题不大。整个过程最痛苦的还是最开始的阶段，因为感觉完全无从下手，但是最后还是花了一个星期做完了，虽然很简陋但是五脏勉强俱全了。\n\n\n\n感觉因为没有期末小测，而且换了一个人很好的新助教，这学期的给分还不错。
213664,437,童若锋,2025-01-19 03:22:29,0,0,0,外专业修的数值分析。课很好，上课因为有讨论所以每节课还是要去的，课程本身挺简单的，还是开卷，所以平时把原理搞清楚考前稍微拿个半天过一过就没问题了，考试也很简单，比老师的两次小测简单很多，建议不要打印ppt而是98同学整理的笔记，总之还是很推荐选的
23824,457,叶德仕,2016-06-28 07:31:54,6,8,2,陶醉在自己的证明世界里无法自拔。\n\n在证什么？不知道
25758,457,叶德仕,2016-06-07 02:17:06,11,12,1,每节课花很多时间跟几个大神探讨数学问题，真正的内容基本不讲，一学期就不知道他在讲些什么东西
27273,457,叶德仕,2016-06-24 09:57:18,28,30,2,ads一脸懵逼
48202,457,叶德仕,2017-03-01 07:45:26,-1,2,3,好好好
48843,457,叶德仕,2017-03-14 16:18:26,1,2,1,也许我听了假课
48992,457,叶德仕,2017-03-21 02:34:35,0,2,2,感觉他自己也懵懵懂懂，太年轻！\n\n完全不知道他在讲什么
51210,457,叶德仕,2017-05-24 07:04:26,-1,13,14,很牛的老师，数学系出身大佬，因为对很多概念证明都了解很清楚，能一眼就看穿问题出在哪里，有很棒的科研品质，对于你是自己想的还是参考别人的文字后才想出来的这件事有很深的执念
51221,457,叶德仕,2017-05-24 12:58:23,1,3,2,听不懂的一大堆证明，让我仿佛回到了数学课。
57362,457,叶德仕,2017-07-07 03:48:41,5,8,3,不知道在干嘛，证明个半天
59990,457,叶德仕,2017-09-30 03:13:10,-2,2,4,ads典型的不备课，我觉得很差
75895,457,叶德仕,2018-03-21 05:54:44,-4,2,6,上展示课鸡蛋里挑骨头，平时上课沉迷数学证明无法自拔。
82611,457,叶德仕,2018-07-08 17:05:28,0,1,1,很尴尬的一门课，上课基本听不懂，虽然老师也挺努力但还是全靠自学，考试很难
83181,457,叶德仕,2018-07-10 01:28:37,8,8,0,老师人还是很可爱的，但是真的是那种捡一下笔就啥都听不懂的课，期末复习的时候老师在上面讲我在下面懵逼并感觉自己拉低全班智商平均值，心痛。
84132,457,叶德仕,2018-07-12 06:00:03,0,3,3,师生情真是感动的泪流满面，谢谢老师！
84400,457,叶德仕,2018-07-12 18:13:53,4,5,1,ADS隔壁BJJ班上的，有几周BJJ出差YDS来带的课…是我整个ADS学得最差的几次…真的 每次看到他就脑壳痛
98626,457,叶德仕,2019-01-27 02:26:31,3,3,0,给分很好，考的贼简单，可我又被卡了一分mdf
100895,457,叶德仕,2019-01-27 04:50:34,7,7,0,老师人很好，学术水平很高，对同学很友善，考试卷子良心，给分好
101244,457,叶德仕,2019-01-28 02:38:54,3,3,0,凸优化卷子过于简单了
108950,457,叶德仕,2019-06-04 15:41:03,9,9,0,数学好，好到我听不懂。。\n\n另外他出的ads期末题，成功屠杀14级全体cs，各种np问题，已经是一届同学的恐怖回忆了。
115297,457,叶德仕,2019-07-18 04:10:57,-13,3,16,我是别的班的学生，希望yds下一届能多出几道题
124054,457,叶德仕,2020-06-24 09:30:19,7,7,0,叶德仕 永远滴神。终究还是没逃过他。
124058,457,叶德仕,2020-07-01 02:26:12,3,3,0,在自己
124061,457,叶德仕,2020-06-23 03:38:22,2,2,0,不地道啊
124107,457,叶德仕,2020-06-24 08:18:19,9,9,0,ads今年不仅难而且考试形式恶心……全都是问有几个对的……
124108,457,叶德仕,2020-06-24 08:22:27,1,1,0,tmd
124109,457,叶德仕,2020-06-26 03:01:05,24,24,0,“NP，随机，近似算法，你看这ads出得行不行”
124111,457,叶德仕,2020-06-24 08:37:09,5,5,0,没什么好说的，这样做真的没意思
124116,457,叶德仕,2020-06-24 10:43:37,6,8,2,yds，yyds!
124128,457,叶德仕,2020-06-25 01:59:41,8,9,1,从clrs、kt里边的四个章节挑出四个定理，凑成一道选择题的四个选项，exm？？？猜出答案的人>>真正做出来的人，因为真正做出来的可能只有yds本人。显然违背了基本的选择题命题规则。
124129,457,叶德仕,2020-06-25 02:38:18,7,7,0,讲课云里雾里 思路乱七八糟 出题玄学 而且刁钻 没意思
124136,457,叶德仕,2020-06-25 04:49:59,6,6,0,ads期末心得：尽人事听天命。
124137,457,叶德仕,2020-06-25 04:55:57,5,5,0,出题是真的难，好在他的ads不搞互评，yds，yyds！
124157,457,叶德仕,2020-06-25 18:36:01,10,10,0,一己之力让大家平时分加10分  你还在这抱怨?
125002,457,叶德仕,2020-08-06 06:24:02,54,55,1,fds， ads， yds， yyds
137479,457,叶德仕,2021-07-12 08:48:32,23,25,2,叶德仕老师讲课确实不是特别清楚，有一些定理可能还是需要更加具体详细的说明，但老师讲课态度很好，基本每节课都会说“感谢同学们来上我的课”，能看出他有想努力讲懂（可能是我太菜了呜呜呜），也能感受到他对数学证明的热情QAQ\n\n另外，老师不搞互评这一点真的很好，project和作业也比较友好，期末还可以交笔记补平时课上答题的分，就是ADS确实难，难顶\n\n还有，其实出题也不全是叶老师的锅，就每年总得有老师专门出难题，本来是轮流的，但听说叶老师出了一年之后教学组少数服从多数决定让他继续出哈哈哈哈（指的是除了叶老师自己都想让叶老师继续出）所以大家也不要怪老师了叭哈哈哈哈\n\n很可爱的老师，当然以上所有都是在考试之前的评论，因为担心考试之后心态崩掉所以来提前评论QAQ很难保证考完人会变成什么样\n\n\n\n好了考完来补评论了，平时分给的好低，加上期中考试扣了有将近十分呜呜呜呜，不知道怎么扣的
137965,457,叶德仕,2021-07-07 02:17:26,6,6,0,老师人还是很不错的，看得出来教书很有热情
138231,457,叶德仕,2021-07-08 05:15:26,7,7,0,怎么说呢，老师是那种很想把课上好的老师，每次上完课都会对我们鞠躬，上课会讲拓展的东西，但可能是我水平不够没怎么听懂过。（最后 cy的mooc yyds！
139900,457,叶德仕,2021-08-14 19:03:23,1,1,0,111
153021,457,叶德仕,2022-04-23 17:47:25,3,4,1,作业看到他出的题都觉得头大。。
157220,457,叶德仕,2022-06-22 11:07:25,9,9,0,考前来拜一拜叶老师
157618,457,叶德仕,2022-06-24 04:03:28,11,12,1,到达考试周最后一门，a~d~s！太难了ads，哎呀，介不是yds老师吗？ 看看远处的斩杀线吧家人们
172166,457,叶德仕,2023-04-21 03:57:09,17,17,0,原本我的ads成绩处于悬崖的边缘，现在有了yds老师出的题，我可以高兴地宣布，我的ads向前迈出了一大步
175775,457,叶德仕,2023-06-26 13:48:56,6,7,1,sb出的什么破题
176936,457,叶德仕,2023-06-30 21:43:34,0,0,0,考前来拜一拜叶老师
177616,457,叶德仕,2023-07-04 02:33:06,0,1,1,老师很好，平时分给的很高，考试大家都一样，而且考试的内容平时上课都会讲，虽然可能讲的不是很清楚，但是如果有问题的话他会很认真地回答
177646,457,叶德仕,2023-07-04 04:33:40,0,0,0,老师很负责，人也挺好，讲课内容有太多超纲的东西，期末考炸了但是捞了一把感谢5555
199526,457,叶德仕,2024-09-25 02:47:10,0,0,0,yds老师的ads讲的相当认真，是我在浙大见过的最认真的老师了，可以看出真的想用尽全力给大家讲懂
204931,457,叶德仕,2024-11-28 16:37:47,0,1,1,叶老师人很好。题目出得难可能是因为他觉得不难。
205833,457,叶德仕,2024-12-12 07:00:57,3,3,0,我必须要提醒一下看到这条评价的同学们，人气评价里面的“fds，ads，yds，yyds”的意思不是说他讲的很棒很厉害，而是说yds是比ads更难的一种层次！最后的yyds只是玩梗。就是说这一段话“fds，ads，yds，yyds”是一种从简单到困难的难度排序！上了ADS你们也会发现当你看到一个题目的命题人是YDS的时候你会很绝望。
208302,457,叶德仕,2024-12-26 15:01:52,1,1,0,出什么破题
208611,457,叶德仕,2024-12-30 05:36:14,6,6,0,每次做到yds的题都有一种被支配的恐惧，多年以后，我可能会忘记fds，ads，但我永远无法忘记yds。昨天晚上做了一个噩梦，“听说了吗，这次考试全是yds出题”
208854,457,叶德仕,2025-01-02 14:27:55,1,1,0,考前拜一拜尊敬的老师，ADS也有自己的宫崎英高，哦不，from software有自己的yds
209826,457,叶德仕,2025-01-07 07:44:37,2,2,0,虽然题出的难，但是老师人真的很好，课的深度很足。有问题老师都会耐心解答，每节课开课前会向同学们鞠躬，说“谢谢大家来上我的课”，但有的时候讲的确实有些快和难，得提前先预习一下
210060,457,叶德仕,2025-01-08 04:50:57,2,2,0,上课态度很诚恳，关心同学学习情况，就是讲的有点晦涩，但给分太好了，呜呜呜呜呜，yds我的神～～～～～～
210071,457,叶德仕,2025-01-08 05:49:00,2,2,0,叶老师真的是非常好也非常厉害的一个老师，预置的和想选叶老师课的同学不要看到评分就望而却步，查老师这里打低分的主要是因为叶老师出的题目太难了🥲。可能就像另一个评论的说的，叶老师觉得挺简单的 hhh。\n\n\n\n老师的平时分给得非常好，期末考只有 60 的我总评也被捞上了80+。叶老师上课也很认真，有的他觉得我们没听懂的也还会拿出手写板一点点地推给我们看，平时问问题回答的也很耐心。\n\n\n\nads yds yyds
218295,457,叶德仕,2025-04-22 11:12:20,0,0,0,上课真的非常认真非常用心，虽然我没有获得理想的绩点，但我也要打出一个十分满分，为了他这个认真负责的授课态度！
4342,463,蔡亮,2015-06-19 07:30:04,3,5,2,很有趣
24127,463,蔡亮,2016-04-27 15:21:22,3,3,0,信安课很好玩
24137,463,蔡亮,2016-04-28 00:17:58,1,1,0,信安课好玩，给分也不错，就是发言没到次数估计颇扣了几分＠x＠
30859,463,蔡亮,2016-07-02 16:33:44,0,0,0,讲课很好的系主任。
48360,463,蔡亮,2017-03-02 10:25:36,6,7,1,很好啊上课讲故事
48361,463,蔡亮,2017-03-02 10:25:00,0,1,1,我才是修机噶
48388,463,蔡亮,2017-03-02 15:39:53,0,0,0,很好啊
49409,463,蔡亮,2017-04-11 01:04:02,0,0,0,有趣，后面基本都是展示了
49712,463,蔡亮,2017-04-24 14:20:37,1,2,1,满绩了  课又有趣 又挺水的~ 不知道怎么说 为什么没有二十分？
49715,463,蔡亮,2017-04-24 15:30:42,3,3,0,平时发言基本上就能满
49724,463,蔡亮,2017-04-25 01:04:01,-1,0,1,挺好的可以可以
49759,463,蔡亮,2017-04-25 13:22:53,4,4,0,给十分，虽然没有满绩，但是没有满绩完全是因为懒得上课发言，考试和作业给分很不错，讲课也不错
49817,463,蔡亮,2017-04-26 08:29:48,0,0,0,信安很有趣！
49878,463,蔡亮,2017-04-27 00:00:55,1,1,0,信安课很有趣啊，会在课堂上讲故事和同学互动，该讲清楚的点也讲的很清楚，布置的作业只有一道密文破译题
75307,463,蔡亮,2018-03-09 01:22:36,0,0,0,绝妙的课堂
77545,463,蔡亮,2018-05-06 11:22:04,0,0,0,感觉老师讲的很好 考试的点也都是上课的重点不会偏到哪去 发言真是巨烦 天天希望点名 几道作业题布置的有点迷 感觉做的展示也挺水的 给分不错
77848,463,蔡亮,2018-05-08 06:43:22,1,1,0,非常棒~
81330,463,蔡亮,2018-07-04 18:58:29,-11,1,12,作业水给分好，上课随便发言混点分，上课的时候给我们划重点。除此以外，浙大上课最有趣的老师之一（只有某些通识课老师例如周黎明老师等才可能pk一下），最后94，不开心?
94216,463,蔡亮,2019-04-27 05:05:28,-15,2,17,凭什么软工的课计科不能选，明明一轮有余量为什么不能选，之前不说，最后选上了来说你必须退
109715,463,蔡亮,2019-06-18 23:36:08,0,0,0,除了发言分占10分啥都好
122067,463,蔡亮,2020-02-10 21:32:52,0,0,0,很有套路
123051,463,蔡亮,2020-05-06 03:45:47,5,5,0,今年信安原没考试，但是谜之给分
131806,463,蔡亮,2021-01-29 04:03:59,1,1,0,老师不管是学术界还是行政层面都是大人物了，但是很亲民对学生态度很好，讲课也很有趣。但是给分真的一般。。。。非必修课慎选
14963,528,外聘1,2016-01-11 09:42:48,0,1,1,超叼，讲课超好
38974,528,外聘1,2016-12-20 06:46:00,4,4,0,这个老师教的课好多啊\n\n
39138,528,外聘1,2016-12-21 09:57:06,28,28,0,全才，膜拜膜拜
57166,528,外聘1,2017-07-06 00:45:10,-3,1,4,三个字
64271,528,外聘1,2017-12-22 07:12:27,21,21,0,这个老师横跨各领域\n\n啥课都会上\n\n还会变模样\n\n浙大扫地僧之一\n\n
64451,528,外聘1,2017-12-24 03:57:20,52,53,1,歌手里的群星和教师里的外聘1是我最佩服的人
64809,528,外聘1,2017-12-27 08:10:37,7,7,0,有没有人上过老师的计组？怎么样啊？
65307,528,外聘1,2018-01-03 02:01:17,11,11,0,很厉害的老师，什么都会
76616,528,外聘1,2018-04-16 08:51:33,0,0,0,可以的
76756,528,外聘1,2018-04-21 04:45:39,6,6,0,马德有点水平呀
91356,528,外聘1,2018-12-06 08:00:23,2,2,0,剧本策划一定要活跃哦
98577,528,外聘1,2019-01-23 15:10:22,1,1,0,评一下软测 Joe的爱尔兰风味口音听不懂啊  但考的都是他的东西 可以速成系列 赵晓琼么虽然课讲的还行 但实际上属于听了也没啥用的东西 而且考试也不考 注意下他喜欢在展示课上点名 一打铃就点名而且没法补救的那种
110938,528,外聘1,2019-06-28 15:28:41,0,0,0,练听力
2689,595,高云君,2015-05-05 11:00:54,44,74,30,数据库师生情让我泪流满面！
18869,595,高云君,2016-06-21 07:13:24,13,18,5,感觉并不是很认真在上课
23106,595,高云君,2016-03-18 02:20:31,-1,0,1,不知道
24408,595,高云君,2016-04-30 13:25:20,-2,0,2,很不错
26704,595,高云君,2016-06-21 02:57:57,0,4,4,太良心了各种画重点
28977,595,高云君,2016-06-29 04:57:53,1,2,1,都是套路
31619,595,高云君,2016-07-04 09:23:27,0,3,3,复习课业界良心！！！！！
32423,595,高云君,2016-07-06 16:07:39,1,3,2,师生情啊，期末考试就是听云君的话
32500,595,高云君,2016-07-07 07:37:37,-1,0,1,不错哦
47566,595,高云君,2018-04-23 06:30:10,-68,8,76,当你当时期末拿到好成绩的时候，会觉得这个老师很好。当你过了一个学期实习的时候忽然发现自己都不知道什么是foreign key的时候，你就会开始想为什么自己的数据库学的那么糟糕
49117,595,高云君,2017-03-27 03:49:51,17,23,6,foreign key 那个是你自己没好好学吧。。。上课又不是没讲过
52650,595,高云君,2017-07-10 04:10:37,1,3,2,老师的课挺好玩的，中途有笑点。所有作业期末登成绩前交就可以，可以自己安排时间，然后师生情真的让我泪目。
52733,595,高云君,2017-06-22 10:41:08,3,3,0,water
73755,595,高云君,2018-02-03 05:07:47,0,1,1,讲课一般，给分真好
82202,595,高云君,2018-07-07 11:28:44,6,11,5,下学期是高云君出题，直说不会往难里出了，能选赶快来选
82227,595,高云君,2018-07-07 13:38:35,0,0,0,。。。
82244,595,高云君,2018-07-07 14:36:44,0,2,2,可能是老师觉得内容太简单，讲起数据库的课来没啥意思，但是给分真好…
82640,595,高云君,2018-07-09 01:42:35,1,1,0,。。。
82772,595,高云君,2018-07-09 05:50:16,0,0,0,给分好
85188,595,高云君,2018-07-16 03:35:55,2,2,0,如果你不缺学分的话 不要选他的计算机科学思想史…课无聊 分乱给 没有一点上课体验
105465,595,高云君,2019-04-15 01:43:13,10,11,1,暴躁老哥 只玩真实
111383,595,高云君,2019-07-01 05:35:58,0,2,2,? 考后一拜? 求师生情?
111386,595,高云君,2019-07-01 05:50:12,3,3,0,说好的不往难出的么?
113594,595,高云君,2019-07-07 00:44:04,1,4,3,师生情感动哭了，原来以为期末炸了结果还不是那么难以接受。
113707,595,高云君,2019-07-07 05:06:45,2,5,3,给分挺好，浓浓师生情
114536,595,高云君,2019-07-10 12:07:39,2,4,2,给分好！
123034,595,高云君,2020-05-03 18:07:33,14,19,5,授课是真的垃圾，就感觉没在认真讲课，很多东西都是一笔带过。真的非常花课后时间自己慢慢看:(
125819,595,高云君,2020-09-14 12:18:00,9,9,0,就我觉得这学期给分低吗...而且讲课真心一般...
137997,595,高云君,2021-07-07 04:43:16,-40,3,43,考试考了hash-join和逻辑undo，比较坑\n\n居然被捞满了，爱死老师和助教了
137998,595,高云君,2021-07-07 04:46:14,1,3,2,老师给分实在太好了，感谢老师
138010,595,高云君,2021-07-07 05:06:15,0,2,2,给分挺好 期末考的很糟糕 但最后结果还不错
138029,595,高云君,2021-07-07 05:58:11,2,3,1,虽然期末一般般 但是最后成绩出人意料的好\n\n感觉老师和助教gg真的很努力在拉平时分了 感动！
138064,595,高云君,2021-07-07 08:39:03,9,10,1,楼上鼓吹的给分好是他们考得好，期末阅卷是统一的阅卷，流水阅卷的，不调。平时分会给的比较高\n\n学弟学妹还是要好好复习，不要指望着选上高老师的课就数据库稳了
151205,595,高云君,2022-02-24 12:13:16,0,2,2,给分是真的良心，不过平时确实也忙对课程本身其实不是很投入，但是给分好就够了
152454,595,高云君,2022-04-12 03:43:52,-4,1,5,非常非常喜欢高老师
152595,595,高云君,2022-04-15 11:38:24,-5,1,6,事少分高，就是老师比较忙可能没什么时间答疑解惑
154388,595,高云君,2022-05-31 12:51:11,3,5,2,老师人很nice，但是不花时间在备课上。可能默认学生都什么都会，基本概念讲的错误百出而且模糊不清，拓展内容也草草带过，大概每节课需要配套 3~5 hours 阅读课本才能学到知识。如果希望找一个讲课好的老师的话慎重。
157744,595,高云君,2022-06-24 15:03:59,7,7,0,上课一塌糊涂，还有错误。只能靠自学吧。。
158216,595,高云君,2022-06-27 13:52:21,2,3,1,数据库，虽然对最后成绩还勉强算满意，但1000多页的PPT自学下来真的很痛苦\n\n希望老师能讲清晰一些
158309,595,高云君,2022-06-28 08:27:22,7,7,0,谢谢老师和助教实在说不出口，不为给分，给分很正常，不为上课水，反正可以自学，只为某些宽于律己，严以待人恶心人的人
158322,595,高云君,2022-06-28 09:38:04,4,4,0,上了又好像没上，不仅没学到知识，给分也不是很好～
158359,595,高云君,2022-06-28 16:31:11,8,8,0,讲课垃，自己都不懂，现场看ppt\n\n好几个考点别的班重点讲了，LSM，Aries考了两道大题这边就讲了几分钟，一堆人考场上干瞪眼\n\n今年给分也差，所有东西都认真做了别的班平时分基本能满（甚至做的很差的都接近满了），这边平时扣你六七分\n\n一学期基本什么都没学到，还拉自己绩点，选这玩意简直有病
159272,595,高云君,2022-07-10 07:53:56,0,0,0,讲课一言难尽，给分还行还行
159446,595,高云君,2022-07-20 09:20:39,9,10,1,数据库所有实验的ddl都在期末，本学期5次小测，每次都提前通知，并没有点过名\n\n上课感觉就是，给大家介绍一下自己的ppt，着实没什么内容，像吃空气\n\n基本上靠听隔壁班sjl老师的课挺过期末考\n\n对课堂听课依赖高的同学慎选，dl随意
163094,595,高云君,2022-12-07 08:03:38,4,5,1,网图时代考古
163095,595,高云君,2022-12-07 08:09:27,1,1,0,真会kfc搬砖人
163096,595,高云君,2022-12-07 08:20:17,0,1,1,不要造谣了吧，尤其是在防疫政策这么重大的事情上
163099,595,高云君,2022-12-07 08:38:13,0,0,0,不要搞心态好不好
163104,595,高云君,2022-12-07 09:22:26,0,0,0,从朵朵来围观
163109,595,高云君,2022-12-07 10:48:15,1,2,1,不要因为老师那个发言说老师了\n\n每个人都能表达自己的看法\n\n这和老师上课水平无关
174423,595,高云君,2023-06-12 05:59:42,15,15,0,老师一个学期都挺好的，就是最后一节课人疯掉了，哈哈哈哈哈哈哈。
175679,595,高云君,2023-06-26 07:30:25,0,0,0,老师可能只会在平时分上努力一下，成绩还是得靠自己
175704,595,高云君,2023-06-26 08:48:11,1,1,0,难评。
177080,595,高云君,2023-07-01 14:57:36,1,1,0,很难评，出分几乎没人谢谢老师的程度
178985,595,高云君,2023-08-13 07:55:34,0,0,0,真的糟糕
185461,595,高云君,2023-12-29 15:20:25,0,0,0,会小测，不过别考太差就行，不知道平时分时怎么算的，反正给分不怎样，身边调查法，和隔壁老师对比起来低了大概两个档的样子
6342,639,郑林风,2019-01-21 00:15:06,-2,6,8,给分太低了我去
9742,639,郑林风,2017-05-18 11:38:42,0,3,3,呵呵，听老师的课是什么感觉？这个问题问的，你们想过这家伙的学生吗？老师的课是什么我们都不知道，怎么感觉？
11052,639,郑林风,2017-05-18 11:36:09,0,3,3,课上点两次名自己还贼水，真是秀逗
11395,639,郑林风,2017-04-10 00:41:22,0,2,2,每天都穿一样的衣服，快递寄到学生专教\n\n
17145,639,郑林风,2016-01-19 16:35:06,2,3,1,很喜欢老师对花的感觉，能说出来专业的东西，虽然有一点水～
17352,639,郑林风,2017-05-18 11:36:29,3,3,0,老师很少来，还可以。
17921,639,郑林风,2016-01-21 04:02:44,2,2,0,给分还行。很少来教室。
21027,639,郑林风,2016-02-11 03:58:59,-4,4,8,设计基础千万不要选郑林风！！！别的老师妥妥4+，他给了一大堆3.5，而科代给了满的呵呵
22317,639,郑林风,2016-03-03 12:49:49,0,1,1,给份很好\n\n
40104,639,郑林风,2016-12-29 07:33:52,7,8,1,他身上有烟味和香水味。。。戴帽子的风一般的男子。讲课比较笼统，但是过去问他，他会很认真地点评。不过自己太菜了，老师也无可奈何啊。混熟后感觉老师还是挺可爱的，会开玩笑。不小心被预置了孩子别难过，上他的课没想象中水，但要是可以自己选，还是别选他了吧。。。
44734,639,郑林风,2017-05-18 11:38:21,0,1,1,上课很水
44983,639,郑林风,2017-01-18 16:51:10,2,2,0,绩点不错!上课真的水水过啊
45568,639,郑林风,2017-01-19 22:49:56,2,3,1,个人觉得只要你愿意问愿意主动去学习还是挺好的老师
49338,639,郑林风,2017-04-06 04:00:36,12,13,1,老师给的绩点其实感觉挺良心的，是什么样就是什么样吧。老师本身专业方面就特别厉害，上课的气氛挺轻松的，还会推荐我们去看画展之类的，很喜欢老师。
51096,639,郑林风,2017-05-17 02:00:16,27,32,5,自己动动嘴去找老师好吗 都大学生了还指望老师把食送上嘴吗 你知道这个老师专业水平有多高吗
56301,639,郑林风,2017-07-03 12:33:16,0,0,0,没话讲了 这课开不开都一样
66304,639,郑林风,2018-01-15 03:37:45,19,19,0,跟彭韧那几个混日子的比起来，郑林风算是数媒最好的艺术老师了，珍惜吧……
66423,639,郑林风,2018-01-16 08:25:35,10,10,0,老师人很好啊，就是男神嘛，感觉性格很随和，但对待专业内容又很负责，对待学生很认真的，很希望我们有自己主动学习的意识，学到了很多基本的理念。不懂的得自己问啊，说实在的，真的不明白为什么评分这么低。
71807,639,郑林风,2019-01-21 00:15:12,0,1,1,给分乱来 呵呵
71823,639,郑林风,2018-01-29 03:59:19,2,2,0,踏踏实实画画，踏踏实实学就会有收获
83033,639,郑林风,2018-07-09 13:55:00,9,10,1,老师真的人很好的，不要被评分误导，很耐心，给分是三大构成的老师里最好的一个了
92016,639,郑林风,2018-12-25 12:02:36,3,4,1,和蔼的老师，专业水平很高，只要你多问还是可以学到很多的(感觉比p老师好多了
98224,639,郑林风,2019-01-23 08:18:25,4,4,0,给分很好
98868,639,郑林风,2019-01-24 04:22:48,7,7,0,我爱郑老师！！谢谢郑老师拯救我的均绩！！还有郑老师真的很有艺术气息！每节课也都很负责任地在场了！还会帮同学指点画画！
103776,639,郑林风,2019-03-05 11:38:02,5,5,0,钟不敲不响，多问才有收获。老师专业水平和性格很好，给分是三大构成老师里也是最好的。来自一条突然刷了刷查老师的老咸鱼
104125,639,郑林风,2019-03-12 12:49:04,2,2,0,真的是良心老师了，比那谁好多了
105535,639,郑林风,2019-04-16 08:29:28,5,5,0,上课只要问老师他一定会认真地点评指导做示范，他也会挑几节课给我们讲抽象、美术史什么的，作业要求量相比pr真的好太多了，给分也很好啊！真的是好老师啊！
111564,639,郑林风,2019-07-02 03:33:54,3,3,0,科创基础专业课最好的老师\n\n不像pr真的垃圾
117241,639,郑林风,2019-09-21 04:55:32,0,0,0,好可以
120041,639,郑林风,2019-11-17 07:25:31,0,0,0,老师很温柔～不管最终给分如何，还是喜欢上这样的课的！
54765,641,黄敬华,2017-06-30 07:33:15,6,7,1,e m m m m
75288,641,黄敬华,2018-03-08 15:25:12,3,3,0,不知道
77794,641,黄敬华,2018-05-12 11:53:26,1,1,0,还不错
80015,641,黄敬华,2018-06-19 04:01:20,0,1,1,8错的老师
151912,641,黄敬华,2022-03-20 13:23:02,2,2,0,很nice的老师，人很和善友好
79074,653,章国锋,2018-07-15 10:51:12,3,5,2,计算摄影学挺好的
79188,653,章国锋,2018-05-26 09:55:22,2,2,0,老师上课有点无聊经常听不懂...，会叫同学回答问题
90688,653,章国锋,2018-11-25 09:02:25,2,2,0,挺好的课 给分高
103239,653,章国锋,2019-02-27 02:44:13,1,3,2,还没上课，先评个高分讨个彩头
113627,653,章国锋,2019-07-07 01:25:49,9,9,0,章国峰老师讲课水平需要提高一下
124813,653,章国锋,2020-07-10 08:59:21,1,1,0,讲话有点憨憨，讲课技巧不太行。\n\n不过给分不错。
134718,653,章国锋,2021-04-12 03:24:33,2,2,0,老师讲课有点笨笨的，一句话能讲清楚的要卡半天
138755,653,章国锋,2021-07-10 16:31:59,0,2,2,计算摄影学这门课程其实是很有意思的，内容涉及到一些前沿问题与技术，几个lab都比较有趣。实验课很不错，文档细致，助教也很负责。这棵给分也很好，总体来说是强推的。唯一有点遗憾的是老师的讲课技巧还可以再提高一些
152548,653,章国锋,2022-04-14 10:38:33,3,3,0,移动平台这门课是面向iOS的，开发需要在MacOS上进行，如果确实很喜欢苹果这一套东西的推荐选，否则**慎选**（尤其是对非苹果系统有执念的），因为这门课事情太多了，上机课要去，助教gg会布置当堂任务且盯得很紧；第一个小作业代码量就逼近甚至超过其他课程的solo型大作业（总共有4个小作业，最后还有一个巨型大作业）；助教对于作业的评分也比较严格，稍有不慎就扣分了。前人的血不是番茄酱！！！\n\n如果选了移动平台且你没有MacBook或iPad，老师会发给你，课程结束后归还，不过一般是好几年前的机型。
160538,653,章国锋,2022-09-26 07:08:04,7,7,0,想上计算摄影学的同学其实可以选秋冬学期的计算机视觉导论，周晓巍老师讲得明白很多
174227,653,章国锋,2023-06-08 03:04:01,1,1,0,计算摄影学挺烂的，lab还是典型的老东西，慎选
193094,653,章国锋,2024-06-03 11:21:23,0,0,0,。。。
195893,653,章国锋,2024-06-30 14:35:31,1,2,1,移动平台开发：这门课主要偏向iOS开发（虽然Android也有一点）\n\n这学期选课时声称今年会针对往届学生吐槽问题改革，实际如下：\n\n声称的“每人一套设备”：设备数量不足，mac无法保证人手一台，部分同学拿到的是mini（需要自行外接显示器），部分同学只有iPad。所谓的高性能iPad只能保证没拿到mac的同学人手一台，其余同学每组一台共用。分到的几台设备是21年的\n\n声称的“更合理的作业安排”：应该是将往年必做的WWDC报告改为了bonus。这学期有4个必做项目+1个bonus，工作量仍然非常大。bonus是一个WWDC的报告，估计没人做。4个必做项目分为3个个人小项目（iOS、Android、AR）和一个组队（1-3人）大项目，工作量很大且时间安排不合理，第一个最简单的项目给了近1个月，后面项目难度逐渐增高但时间反而缩短，导致最后一个项目很难有高完成度。事实上大项目很多组的完成度也不高，中期也有很多同学退课。感觉没有比往年改善多少，慎选。\n\n其他感受：\n\n作业没有反馈：分数完全黑盒，今年确实统一了作业提交方式，但未公布成绩\n\niOS开发很痛苦，官方文档上说的跟说了话似的，查询一个组件的函数基本就是把函数名扩写一遍，至于怎么使用以及有什么效果？自己去试吧。个人感觉跟Android及其它文档相比起来iOS的文档真的不完善，也没有足够的最佳实践展示用法，对开发者很不友好，上手起来比较慢。再加上iOS开发需要使用的Xcode完全不像是一个21世纪的IDE，跟Android Studio相比有着巨大差距，感觉非常落后。由于闭源的特性，社区也不活跃，Xcode也没有插件能够弥补它功能的缺失。\n\n\n\n总体来说课程确实是一个接触移动开发的好机会，从项目中也确实学到了不少技术。但是项目周期安排不合理、任务量过大、管理混乱等一系列问题的确很突出。\n\n希望软工的课能越来越好。
215688,653,章国锋,2025-03-04 05:43:20,2,3,1,我觉得很奇怪，计算摄影这门课老师不是每年都要上么？为什么感觉讲课经常让人觉得根本没备过课的样子。ppt也挺依托的，出现一些复杂的公式的时候安全没有对应到的具体概念，我觉得来听课像是在浪费时间。。。。
13872,668,陈奇,2016-01-01 10:59:01,9,12,3,给分极其坑爹
22476,668,陈奇,2016-03-14 00:16:56,14,16,2,和陈琦一样充满情怀
22479,668,陈奇,2016-03-07 00:57:13,13,16,3,这不是编程课...这明明是反人类与反编程...
22480,668,陈奇,2016-03-07 00:58:33,16,18,2,废话连篇
22863,668,陈奇,2016-03-14 00:23:59,27,29,2,各单位注意！他又开始讲了！
22866,668,陈奇,2016-03-14 01:11:03,23,23,0,翁恺老师你在哪里啊
22867,668,陈奇,2016-03-14 01:21:22,18,20,2,历史系陈教授的谆谆教导
23159,668,陈奇,2016-03-20 23:11:42,44,47,3,陈老师不去开个通识课什么的真是可惜了。
23375,668,陈奇,2016-03-28 01:16:31,86,99,13,本人刚上过陈奇国师的第五次课的学生，就目前来看，陈奇在包括但不限于以下领域做到了相应程度：哲学（宗教学方向）（精通），美学（精通），历史学（熟悉），文学（熟悉），数学（精通），物理学（精通），认知科学（心理学、语言学等）精通，艺术学（了解），教育学（神级），计算机工程（面向对象编程技术方向）（神级）。
23563,668,陈奇,2016-04-06 10:15:20,3,4,1,奇哥是个有情怀的人。
25804,668,陈奇,2016-06-08 12:55:14,14,17,3,很难想象第一节爆满，后面人站着听的课，上到期中竟然五分之一都不剩了【doge脸
26035,668,陈奇,2016-06-15 07:16:30,0,4,4,我就想问问以前上过陈奇的学长学姐干啥去了\n\n
27946,668,陈奇,2016-06-28 06:56:37,7,10,3,oop要挂了，没想到第一次挂科如此猝不及防
29645,668,陈奇,2016-06-30 06:11:33,20,22,2,楼上那个说最后五分之一都不剩了的同学，请认真数数。明明最后上课的也就十五个人。不明白为什么会有这样水的老师存在
31166,668,陈奇,2016-07-03 10:14:06,3,5,2,讲课烂 极其不负责任的感觉
31785,668,陈奇,2016-07-05 02:12:19,2,3,1,给分不太好
48515,668,陈奇,2017-03-06 11:22:39,9,10,1,这是讲课还是讲评书呢啊。。
48520,668,陈奇,2017-03-06 11:57:42,3,5,2,实在不行。。。当段子听呗hhh
48844,668,陈奇,2017-03-14 23:30:02,14,16,2,在陈奇老师开设的《面向对象程序设计》课程中，你甚至可以学习到「面向对象」的程序设计知识
49405,668,陈奇,2017-04-10 11:31:03,6,8,2,首先 陈老师确实知识渊博...开头三节课基本没讲c++ 但是后来几节课听了觉得他上课很适合初学者 内容比较简单 他讲的会很生动（举很生活化的例子） 对我这个小白来说很不错 可能还没到期末给分嘿嘿嘿
49545,668,陈奇,2017-04-18 06:41:07,8,9,1,我觉得陈国师讲的挺好的呀
51079,668,陈奇,2017-05-16 07:06:29,5,6,1,说上的不好的就该去上上数学系老师的课
52856,668,陈奇,2017-06-23 08:06:35,5,9,4,其实老师讲的真的不错，很前沿，很深入，除了有的时候废话有点多，也没什么了。他是为了你真的掌握c++，而不是为了应付考试。
74628,668,陈奇,2018-03-05 01:46:21,4,5,1,人文社科情怀
75797,668,陈奇,2018-03-19 00:11:46,2,2,0,有问题
77597,668,陈奇,2018-05-07 01:33:50,1,2,1,爱国主义教育
81585,668,陈奇,2018-07-05 12:51:15,7,8,1,我只想告诉各位，该老师会有一次点名。我认识的全部中招。
85268,668,陈奇,2018-07-16 16:04:15,1,3,2,给分差
85291,668,陈奇,2018-07-16 23:11:21,3,4,1,课不错，分有点点低
102890,668,陈奇,2019-02-25 00:15:07,11,11,0,国师第一节课就秀起来了～
103188,668,陈奇,2019-02-26 13:30:07,4,5,1,善哉，善哉
104032,668,陈奇,2019-03-11 01:02:04,11,11,0,在OOP的第三节课，陈老师终于讲到了“现代艺术走向邪路”，哈哈
108487,668,陈奇,2019-05-27 01:18:40,11,11,0,我记录一下，夏学期第五周。\n\n\n\n陈奇点名了
108533,668,陈奇,2019-05-28 01:52:17,11,11,0,我记录一下，夏学期第五周，我翘课了[?]
110662,668,陈奇,2019-06-28 03:20:53,6,6,0,真的雷出天际
122306,668,陈奇,2020-02-24 01:13:14,28,30,2,今天是网课第一天，国师讲了苏格拉底，马克思，乔布斯，王阳明，唯独没讲c++
123896,668,陈奇,2020-06-16 01:36:23,2,4,2,网课结束....感觉虽然有时候会讲一些玄学的东西\n\n但是总的来说老师对编程技术的理解还是很深入的\n\n
125958,668,陈奇,2020-09-16 04:25:36,11,11,0,两周了还不出分什么意思？公然违反学校规章制度？私信不回发邮件不回，不愧是您。问了助教，助教说早就统计好了，老师一直没决定登。请问您是在调分吗？微笑
126260,668,陈奇,2020-09-21 05:13:12,8,8,0,拖着成绩不登属实离谱
133448,668,陈奇,2021-03-01 01:48:49,14,14,0,第一节课只有最后5分钟写了代码，前面都在讲故事，真有你的 cq老师  :-D
134584,668,陈奇,2021-04-03 08:18:21,17,17,0,国师说：“我讲的都是你们在书本上学不到的”\n\n确实，确实啊
137969,668,陈奇,2021-07-07 03:03:28,4,6,2,啥也不是\n\noop这门课就是恶心人的\n\n结果这些老师除了翁恺都不太行\n\n国师更是首屈一指\n\n上课就是希腊文明不如中华文明\n\n艺术是没有顶的\n\n等等\n\n现在平均评分是4.8\n\n对他来说太高了\n\n简直可以和csp并称双陈
140096,668,陈奇,2021-08-25 11:04:36,-4,0,4,一学期没点名，挺好
145476,668,陈奇,2021-12-30 02:29:51,-9,3,12,老师讲的很清楚，得分也很好，没用下面同学说的那么垃
145477,668,陈奇,2021-12-30 02:31:19,-7,3,10,其实陈老师还是比较好的，最近看大家都说他不好我来反驳一下，主要这门课是自学，老师给分好事情不多，值得的
152664,668,陈奇,2022-04-18 01:50:20,8,8,0,夏学期第一节课，只字未提大作业;课上讲授有效课程知识点3个，其中一个是告诉大家ide有release版本和debug版本;其余从俄乌冲突讲到抗美援朝，同桌的老哥吃了两节课面包，第二节课一半提着包走了
154067,668,陈奇,2022-05-22 07:56:26,11,11,0,作为讲课水平来说，陈奇无疑是zju之耻，日常水时间，动不动就讲各种历史文化，无愧于国师称号，c++知识毫无相关，难得的讲课时间总是试图用一些c和c++的底层逻辑来提高讲课水平，实则对于作业和课程知识毫无帮助。同时助教也极其令人不解，作为程序语言学习课，要求大作业编写开发报告与中期报告，不知道我们到底是来学代码还是学文档编写，文档到底是方便了谁。\n\n总结：选上就跑
154778,668,陈奇,2022-06-05 06:29:33,7,7,0,虽然内心很想用某个傻开头的词骂他，但是一想陈奇为了锻炼大家的自学能力不布置正常的选择填空编程题，用主观题来充数，我真的很感谢他，感谢到想鲨掉他
158739,668,陈奇,2022-07-01 16:50:40,7,7,0,无力吐槽，上课差给分差，大作业要自学图形库毫无意义而且工作量巨大，2022年了上机课还在点名，而且平时上课还会拍照点名，大家如果不幸上了sbcq的课请务必要要去上课，不然平时分会超级难看
158916,668,陈奇,2022-07-03 09:29:16,7,7,0,上课没水平，拍照点名没谁了，幸好我每节课都去了（虽然没听课），还有为什么那么晚出分啊？
158938,668,陈奇,2022-07-03 14:17:37,3,3,0,上课内容匮乏，大作业很难，评分细则不透明且平时分给的很差，别的班老师平时分基本给满，我不知道为什么会扣这么多
158940,668,陈奇,2022-07-03 14:27:57,23,24,1,给分真的不行……总评（86分）比我期末（87分）还低……\n\n我觉得这分数搁cx或xww老师那边应该能90+分的……
158942,668,陈奇,2022-07-03 15:16:38,2,2,0,很不行\n\n建议听wk的课，一定要把期末考好
158949,668,陈奇,2022-07-03 23:19:42,1,1,0,讲课很烂，给分也很垃圾，快跑
158980,668,陈奇,2022-07-04 07:27:12,13,13,0,拍照点名就离谱！我每次都坐前排，拍照的时候我刚好去上了个厕所，隔壁同学告诉我拍照点名了，我去问国师能不能补拍，国师说“只是留个纪念，不用作点名”，md我还真信了！更离谱的是大程验收的时候指出自己的位置，然而第二场验收（周日场）的时候只要组长去就可以了，不就相当于少了指认的机会嘛！总之选上了就快跑吧！
159043,668,陈奇,2022-07-05 04:11:29,4,4,0,这平时分我真的是吐了，为啥不能给0分
170098,668,陈奇,2023-03-01 11:00:43,2,2,0,nt中的nt 上机课需要到场
173165,668,陈奇,2023-07-18 12:16:03,4,4,0,5月15.陈奇终于点名了！这次不拍照，上着上着突然把白纸给到学生，签字点名，国师 ，不愧是你！！！\n\n--------------------\n\n夏学期4次纸质签到，5次拍照。大程还有几个功能没实现。慌得一批。\n\n-------------------\n\n7月7号，考完都一周了，还没出分啊。国师保佑我过w(ﾟДﾟ)w\n\n---------------\n\n出分了，平时分居然没炸。签到记得都去，大程目标尽量做完，考试尽量考高，平时跟着wk班学，国师还是可以选的。\n\n-------------\n\n还有，别全信夸老师的，这一届平时分好可能是助教会捞。
173966,668,陈奇,2023-06-05 09:10:53,0,0,0,一坨大便
176777,668,陈奇,2023-06-30 05:29:04,0,0,0,快逃！！\n\n选了等于没有老师\n\n垃圾中的战斗机
178299,668,陈奇,2023-07-09 16:47:28,2,4,2,好老师！我承认之前喷您的声音有点大了！但是没想到出分居然这么高！我直接哭死！我是所有的pta都按时完成了，但是纸质签到两次都正好翘掉（救命），结果算上大程最后平时分只扣了1分！期末80，总评89，这种老师我就问你来不来！！就上课而言，他最开始的几次课真的全是废话，千万别听！但是到后面讲到核心内容的时候，才发现老师水平之高！反正大家就有所选择的听课吧，废话不听也罢，但是讲到关键的时候听一听收获其实还是挺大的！
178341,668,陈奇,2023-07-10 10:11:15,2,2,0,我承认我开学说话声音大了点，期末客观题就拿了45分，算上主观题大概拿了60左右，期末大程基础要求没做完，高要求只完成了部分，点名还没怎么去，最后还给了3.3
28022,671,庄越挺,2016-06-28 08:00:03,4,6,2,大概老师太忙了所以不能好好备课吧，上课枯燥无趣最后给分还可以
40015,671,庄越挺,2016-12-28 16:40:50,4,4,0,6666
47919,671,庄越挺,2017-02-27 09:38:24,1,1,0,人好，就是讲课能力一般?
49030,671,庄越挺,2017-03-22 03:42:48,1,2,1,很好啊
49397,671,庄越挺,2017-04-10 07:10:33,4,5,1,难点在他嘴里讲出来更听不懂了
49496,671,庄越挺,2017-04-17 05:33:37,19,21,2,讲得挺烂的，一直念PPT，而且没什么调理逻辑
76279,671,庄越挺,2018-04-01 15:34:58,3,3,0,作业好多啊
86651,671,庄越挺,2018-09-18 00:46:29,3,3,0,GG => GBLD
135207,671,庄越挺,2021-05-06 03:09:43,8,8,0,上课讲得不清不楚 动不动就跳过让自己学 讲题目不知所云 小测比较简单而且经常有 事情不算特别多 给分还不清楚
137979,671,庄越挺,2021-07-07 03:30:49,4,4,0,1.讲课真的很难受，有一种让人听着听着就忍不住去玩手机的魔力。\n\n2.事情感觉比较少，实验比其他班好像少一次，验收也比较水。\n\n3.给分不清楚，出分了钉钉群里一片死寂，但这次考试题目也有点阴间。个人4.2，上不去下不来的成绩，不知道怎么评价。
137982,671,庄越挺,2021-07-07 03:32:23,9,9,0,庄老师一直在努力的讲课，可惜效果并不是很好。\n\n上课比较昏睡，容易走神，不知道是我的原因还是授课方式的原因。\n\n下课问老师问题，老师会非常认真的答疑，助教也比较认真负责。\n\n小测比较多，但是不算很难，就算写错了也能拿不少分，主要是点名性质。\n\n实验开始的比较早，但夏学期就没那么多实验(只有一个MiniSQL)\n\n最后给分貌似比较诡异，普遍不是很好
140491,671,庄越挺,2021-09-13 05:15:26,1,1,0,讲课还行，作业不多，经常小测但是不难。给分不知道怎么样，本人考试感觉自我非常良好最后4.2，同小组的另一位同学4.8
158727,671,庄越挺,2022-07-01 14:44:30,-8,0,8,庄老师讲课真的不玩手机对不起他，但是慕姓助教很好，实验比其他班少了一个图书管理系统，平时分应该很高，今年期末考大改，新增加的lsm树庄老师最后一节课特地讲过，最后总评4.8，完全符合预期。
164983,671,庄越挺,2022-12-28 07:46:34,3,3,0,来玉泉看到曹西三楼的墙上才知道庄的研究方向是人工智能，并且学术造诣是可以和陈、吴等院士相提并论的\n\n这下就更能理解努力上课但是又很难讲透数据库知识的他了
174952,671,庄越挺,2023-06-20 11:10:39,-2,0,2,讲课真的烂，但是事情真的少。平时小测是往年期末题，有一些难度，少一个lab5（省很多时间），助教人很好，老师很积极答疑，可冲。
177410,671,庄越挺,2023-07-03 07:40:10,0,0,0,真的垃圾，讲的完全没有任何营养，他的课根本不用听，因为根本没用，此外，助教哥极其摸鱼非常不负责任，消息常常已读不回，分数不透明，给分还垃圾，其他班一个比一个捞，我们班一个比一个破防，周围的人没一个满意的，都和预期差很多
195388,671,庄越挺,2024-06-28 02:23:43,1,1,0,老师人还行，但是讲的东西真听不进去。平时虽然几乎不点名，但还是要去，有随机纸质小测(这届四次)。没有图书管理系统，於助教人很好。最后给分一般
196135,671,庄越挺,2024-07-01 22:59:05,6,6,0,给分不是很好，讲课不太行\n\n点过两次名，并且是传统对着名字点人举手\n\n助教人还好，小测后来开始通知了，不过捞的力度不大，并且自己没写过改版的minisql框架实验指导并不好\n\n再者庄教授很忙，自己是大老板，助教是高年级博士学数据库已经是久远的事情了，一个问问题不回，一个回答的不清楚，而且似乎都是做AI的，为什么来教数据库呢？\n\n唯一的优点是没有lab5，轻松不少，想水的推荐选，给分教学就算了吧
1334,681,冯晓霞,2015-03-22 00:17:41,50,54,4,很认真、负责，像高中老师一样耐心，真正地为学生着想，知识点讲解透彻。不过对于不来上课的、混学分同学非常严格。
1520,681,冯晓霞,2015-03-22 10:19:17,29,30,1,老师超级耐心！讲得很好！
1559,681,冯晓霞,2015-03-22 14:01:28,24,25,1,老师人真的超级好，不懂的去问她她都会解释清楚，大计基上过她的之后c程特意改成了她的课
2111,681,冯晓霞,2015-04-01 12:26:33,15,16,1,讲得特别仔细，挺好的
2355,681,冯晓霞,2015-04-27 04:26:26,10,10,0,很耐心
2717,681,冯晓霞,2015-05-06 04:04:00,7,8,1,细致   给分也不错
3300,681,冯晓霞,2015-05-28 17:03:55,10,10,0,很认真，很感动
3636,681,冯晓霞,2015-06-17 01:56:25,8,8,0,比较严格，但是上课很自习，给分也不错
4813,681,冯晓霞,2015-06-29 06:41:17,13,13,0,老师人很好，很负责
5933,681,冯晓霞,2015-07-10 03:11:36,9,9,0,老师超级超级耐心!讲得很清楚!
6423,681,冯晓霞,2015-07-14 01:56:42,6,6,0,讲得清晰，给分也高。
6468,681,冯晓霞,2015-07-14 07:02:59,14,14,0,演示程序十分仔细，从最基本的细节入手，逻辑清晰\n\n
8434,681,冯晓霞,2015-09-21 08:21:01,1,4,3,课讲的还行，就是脑残作业略多
8958,681,冯晓霞,2015-10-06 07:33:20,5,6,1,人超级好，耐心，讲课也行，作业多了点
8973,681,冯晓霞,2015-10-07 15:36:05,0,2,2,作业炒鸡多，讲的很好，人也好\n\n\n\n
9048,681,冯晓霞,2015-10-11 08:29:28,0,2,2,不预习去听就完蛋了
11035,681,冯晓霞,2015-11-24 03:04:53,7,8,1,c程讲的很棒，满绩了 爱她～～～
13199,681,冯晓霞,2015-12-25 07:05:16,-3,3,6,很幽默很开放有时候讲笑话调侃同学，就是有点基础的去听会感觉略无聊
13477,681,冯晓霞,2015-12-28 08:55:25,0,2,2,作业也太多了吧！
14861,681,冯晓霞,2016-01-10 09:44:42,0,2,2,作业死多\n\n
15242,681,冯晓霞,2016-01-13 03:09:26,1,3,2,老师很认真，但是，作业非常多，而且是一些没有什么实际意义的计算机操作，非常多，不建议选，很浪费时间。
15749,681,冯晓霞,2016-01-16 08:23:49,5,5,0,超超超赞~\(≧▽≦)/~逻辑清晰，而且细致有耐心，课后问她问题她邮件回复的超详细，感动！！
16575,681,冯晓霞,2016-01-18 12:02:55,4,4,0,挺负责的
18186,681,冯晓霞,2016-01-21 08:58:33,4,4,0,挺细致的
19594,681,冯晓霞,2016-01-25 01:07:22,1,2,1,老师很负责啦，作业略多。。。
19846,681,冯晓霞,2016-01-25 11:33:45,3,3,0,平时也没怎么样，感觉没听过课。考试还行。
20009,681,冯晓霞,2016-01-26 01:50:03,3,3,0,给分超级好啊感人感人
20028,681,冯晓霞,2016-01-26 02:33:19,4,4,0,老师细心认真负责，回邮件特别快，解答问题也特别细致。超级喜欢她！！！
20200,681,冯晓霞,2016-01-26 13:43:10,3,3,0,老师讲得很棒，给分也不错，谢谢老师！
20298,681,冯晓霞,2016-01-27 03:13:44,3,3,0,上课很仔细的老师，有时候很有趣，特意选了她的c
20669,681,冯晓霞,2016-01-29 14:45:28,3,3,0,老师讲课很耐心负责
21428,681,冯晓霞,2016-02-29 00:19:59,1,1,0,认真负责讲的细～
22253,681,冯晓霞,2016-03-03 06:14:56,5,5,0,给分不错，事情比较多，但绝对让你学懂，是个很好的老师
22724,681,冯晓霞,2016-07-03 14:00:53,2,4,2,期中没考+期末对两道实验题 居然还上4了
23865,681,冯晓霞,2016-04-19 05:10:12,0,0,0,老师超级好！～
24727,681,冯晓霞,2016-05-27 14:25:40,1,1,0,开心ヽ(○^㉨^)ﾉ♪，老师讲的超好，只要听肯定会的
25105,681,冯晓霞,2016-05-05 09:35:39,1,1,0,大学最喜欢的老师，没有之一
26822,681,冯晓霞,2016-06-21 07:46:19,0,0,0,老师人真的很好，非常热心，上课也很仔细，很有活力，我真的很喜欢她
27125,681,冯晓霞,2016-06-23 05:34:28,0,0,0,非常细致
27163,681,冯晓霞,2016-06-23 09:21:29,0,0,0,很不错
27167,681,冯晓霞,2016-06-23 09:42:01,2,2,0,结课的时候热烈的掌声就能说明一切了，好老师!
27299,681,冯晓霞,2016-06-24 14:33:58,-2,0,2,讲课不错，不过我感觉有点慢，示例内容有点太多，可能是我理解能力强吧hhh
28141,681,冯晓霞,2016-06-28 08:09:30,0,0,0,非常认真的老师，很重视基础，特别喜欢
28246,681,冯晓霞,2016-06-28 08:20:34,0,0,0,回到了高中时光。
28382,681,冯晓霞,2016-06-28 08:45:33,0,0,0,很好！
30833,681,冯晓霞,2016-07-02 15:08:31,1,1,0,很细很赞给分好，偶尔点名
30834,681,冯晓霞,2016-07-02 15:11:19,0,1,1,老师非常负责，还有理论作业所以期末不虚，还有就是某群主还不bg๑乛◡乛๑
30880,681,冯晓霞,2016-07-02 18:18:30,1,1,0,好老师啊！
30964,681,冯晓霞,2016-07-03 04:40:26,2,2,0,C可以选，事多但有利巩固
30965,681,冯晓霞,2016-07-03 04:40:38,1,2,1,老师很棒啊。上课不错，解答问题也不错，打分也不错
30969,681,冯晓霞,2016-07-03 04:53:46,3,3,0,c程很好就不说了。看到大计机平均绩点4.0再想起李峰只给了我3.3我就…
31246,681,冯晓霞,2016-07-03 12:41:16,-4,1,5,老师讲课很好啊，通俗易懂，平时认真学，作业好好做，c程满绩不难
31501,681,冯晓霞,2016-07-04 03:52:20,1,1,0,好好好
38568,681,冯晓霞,2016-12-09 03:26:55,0,0,0,很认真很负责，上课演示很生动
48150,681,冯晓霞,2017-03-01 02:37:46,0,0,0,好\n\n真心好
49226,681,冯晓霞,2017-03-30 03:42:39,2,2,0,老师真心好，讲解很清晰，虽然只是带了一个月的课，但是非常负责。
49646,681,冯晓霞,2017-04-21 10:29:29,2,2,0,感觉比沈睿好
49777,681,冯晓霞,2017-04-26 01:14:39,1,1,0,虽然也很喜欢沈睿老师，但是总感觉冯老师经验很足非常认真负责
11623,685,柴春雷,2015-12-08 06:41:57,13,16,3,超好的老师
81605,685,柴春雷,2018-07-05 13:52:44,3,3,0,很棒棒
90586,685,柴春雷,2018-11-29 15:24:00,6,6,0,作业量不多而且给分比较高
91607,685,柴春雷,2018-12-15 11:47:39,2,2,0,柴老师人挺好的
133227,685,柴春雷,2021-02-19 09:44:05,0,2,2,柴导相当nice了
143622,685,柴春雷,2021-11-29 05:48:27,-4,0,4,专业课正鑈驀太，给分跟醪耈身高一样，我谢谢你
143624,685,柴春雷,2021-11-29 06:05:16,0,1,1,商创的小组合作的成果难以量化到每个人身上，（这也不是这门课的问题，工设的每门专业课都存在）导致成果不出彩的小组成员得分普遍不高（3.3），专业课是没有正太分布的，这成绩属实离谱了
152247,685,柴春雷,2022-03-31 08:04:52,2,2,0,柴老师认真的特别耐斯
168234,685,柴春雷,2023-02-05 02:56:41,-1,1,2,一言难尽
182856,685,柴春雷,2023-11-20 17:46:55,3,3,0,柴老师，大善人！
2189,722,张引,2015-07-15 13:19:19,22,43,21,对平时要求高，作业多，上课会点名提问，平时分和平时作业关系比较大
2493,722,张引,2015-05-04 13:16:02,7,24,17,专题研讨课说多了都是泪
3852,722,张引,2015-06-17 06:25:03,10,21,11,有点无聊
4701,722,张引,2015-06-26 09:38:11,-5,15,20,简直屎\n\n
6542,722,张引,2015-07-15 03:15:15,-1,5,6,讲得比较细，所以有点慢
7517,722,张引,2015-09-15 01:35:44,0,3,3,还好
9276,722,张引,2015-10-20 01:09:22,2,16,14,要干手写程序这种鬼事，还要上交\n\n上课无聊
13667,722,张引,2016-01-02 06:57:12,29,39,10,老师讲得确实挺细的\n\n
13905,722,张引,2016-01-02 07:01:12,-1,4,5,上课老点名提问题
14169,722,张引,2016-01-05 06:34:42,30,37,7,很负责的老师，就是有时莫名其妙的严肃
14170,722,张引,2016-01-05 06:35:45,-4,1,5,上课其实还不错，就是研讨课比较坑…
14322,722,张引,2016-01-06 08:14:56,4,9,5,讲课细，还要随堂上交手写程序。作业不算特别多。研讨课用意是好的，虽然实行起来确实有点坑…其实coding还是靠自己。
19151,722,张引,2016-01-23 11:13:38,56,71,15,期末成绩出来，全班四分一上4.5，老师给分挺好的。
19157,722,张引,2016-01-23 11:22:14,8,14,6,其实挺好的，注重细节，讲的挺细的 上课莫名严肃 考完试就开始逗比\n\n给分不错，对平时要求很高，我老不去好像被扣了很多分，最后还是4.5
21608,722,张引,2016-02-29 10:28:04,16,25,9,很实在，好评
22876,722,张引,2016-03-14 03:33:44,11,13,2,老师讲课虽然严肃，但是真的很细致
22963,722,张引,2016-03-15 07:25:23,12,16,4,讲得细\n\n
23401,722,张引,2016-03-29 07:40:36,19,31,12,不错的老师
23812,722,张引,2016-04-17 22:48:18,3,12,9,程设专题作业多，一般是其他老师的两倍，各种血溅电脑桌
23815,722,张引,2016-04-18 02:35:31,0,8,8,作业其他老师3倍多，每周要写500行代码，给分坑，上课不清楚
24376,722,张引,2016-04-30 03:56:04,13,16,3,蛮细致的\n\n
25543,722,张引,2016-05-25 03:15:52,-3,4,7,软件工程课简直是翔，像根本没有见过项目的
25912,722,张引,2016-06-14 08:46:59,0,2,2,讲得挺好的，就是有点严肃
26562,722,张引,2016-06-20 06:19:53,14,17,3,挺好的老师
26799,722,张引,2016-06-21 06:37:27,-7,9,16,一节课就上一下午，善于浪费学生的时间，垃圾老师
30347,722,张引,2016-07-01 10:43:14,-3,8,11,讲课差作业多，给分坑，1分不能再多\n\n
30865,722,张引,2016-07-02 16:41:35,16,20,4,挺认真的老师。总感觉相处久了能和学生打成一片。
32400,722,张引,2016-07-06 13:25:35,9,15,6,觉得老师是严中有爱，相处久了很亲切。
32526,722,张引,2016-07-07 11:22:36,19,32,13,老师很好，讲课很清楚，给分也不错，某些同学自己不认真学不好c不要怪老师
40217,722,张引,2016-12-30 05:59:40,4,7,3,上机课都要签到，上课时不时写一个测验，老师很认真\n\n
42443,722,张引,2017-01-14 08:31:26,5,8,3,老师考完试说的话好暖心，保佑有个好绩点吧
42452,722,张引,2017-01-19 10:21:09,73,102,29,张老师真的好\n\n平时上课会通过随机提问来代替点名，可能有同学觉得这样压力太大，但问的问题其实都是非常基础的，并且全部都是上节课讲过了的，所以认真听讲真的不用太担心啦～\n\n上机课的话会让助教答疑，嗯，这个比较水，去不去也没有很大的关系，但是一定要认真写编程题，这些题都是很好的。\n\n张老师最让我感动的是她上课时的投入，讲的也真的特别特别特别好，完全没话说，如果搞不懂真的是自己的问题，记得有一次下课铃响后老师才反应过来，说“啊，已经下课了啊，不好意思，我一上课就停不下来了。”真的，当时我特别震撼，那堂课也是我听的最认真的一堂课，这样的老师才是我心目中的大学教授。\n\n快考试了我听说老师有点绩杀，还有点担心，但当时我就想说哪怕我挂了，我还是会给张老师高分，因为真的太好了，可是最后我发现给分还是超好的，程设也成了我第一门满绩的课。\n\n我是学计算机的，张老师是我编程路上的启蒙者，也是这门课让我明确了自己的兴趣、方向，所以我才坚持选了这个专业，我也不后悔，真的，张老师，谢谢你，好老师，强推!
45321,722,张引,2017-01-19 10:19:54,7,13,6,上机作业比别的班少一半，张引老师好厉害的 谢谢老师和助教哥哥姐姐！
45345,722,张引,2017-01-19 11:51:30,20,31,11,期中菜的看不过眼，平时课堂小测都不会，竟然差点满了\n\n老师和助教辛苦了，虽然上机没有怎么向老师请教过，但总复习的时候，还是看“态度”和“功夫”。\n\n祝大家满绩，老师的认真负责绝无第二。
45653,722,张引,2017-01-20 07:44:23,15,22,7,老师人超级好，上课很负责，不明白为同班什么分这么低，和我一起上这门课的三个同学其中包括我有三个都满绩，谢谢老师。
45743,722,张引,2017-01-20 04:11:09,11,16,5,个人觉得很好 平时提问没会 期中考试很垃圾 几乎倒数 上机题做出三道 期末感觉还好些 绩点4，5     觉得给分很好 其实只要认真听课没问题   上机课签到 真的是很负责 编程一定要自己编  多练 老师很幽默 很暖心 对学生很好 就算零基础也没关系 我也是零基础 多加练习就好了 认真 态度端正也会拿到不错的成绩
46564,722,张引,2017-01-22 02:58:07,13,23,10,提问代替点名，总是怕答不出而自觉的去复习。老师的认真让我很感动，不论是上课、答疑还是考试前对我们千叮咛万嘱咐，都特别认真负责。上机题是别的班的一半，上机课就能做完。助教小哥哥小姐姐也很负责，作业系统有问题，提交的作业在老师端看不到，期末发现了也会允许补交。  给分也不错，真心不明白为什么评分会这么低！\n\n
46690,722,张引,2017-01-22 07:18:51,-1,8,9,人生第一个满绩 不给10分说不过去 不过当然 老师的课前提问超恐怖 还会经常凶一下 不过老师的作业特别少（比别班少一半 （可能有人不知道 她是四大名补（逃
47547,722,张引,2017-01-30 08:48:40,5,8,3,讲得很深，上课有各种各样的方法。反正就是不能水啦。。。
48138,722,张引,2017-03-01 00:58:44,2,6,4,上学期程设基础.......嗯，第一节课才知道老师是女的。每节课会点名，叫起来讲讲上节课学了什么。知识点讲的很细致，很负责的老师，助教也非常好玩。唯一的缺点是告诉我其他老师讲课也都不错的，实在排不开课表选其他老师没问题的......虽然专题只上了一节课，可那是什么玩意儿......
48562,722,张引,2017-03-07 08:15:02,-5,8,13,同学们回答问题声音比较小，老师没听见反而责怪同学，说同学态度消极；突然冒出来莫名其妙的随堂练习，还没有理解老师说什么就开始收答卷；下课警告同学:“你们要是再这样我就不讲了，你们自己上去讲去。”难以理解老师的用心。
48628,722,张引,2017-03-08 14:54:32,19,33,14,给张老师打了满分，因为觉得目前评分对她实在太不公平。张老师上课认真负责，思路清晰且细致周到；而另一位上课思路极其混乱的老师，仅仅因为事少分数就比张老师高出近一分，实在是令我相当无语。事多事少仅是个人喜好问题，您是大佬愿意清闲，但您拿着各位老师班级的期末成绩问问想好好学C的小白选哪位？
48890,722,张引,2017-03-16 00:24:46,12,15,3,良心好老师
51235,722,张引,2017-05-25 01:52:39,1,4,3,专题课……不说了自己感受吧
51246,722,张引,2017-05-25 09:51:21,-2,3,5,严格  对学习知识很有帮助
54212,722,张引,2017-06-28 16:50:18,3,5,2,赞\(≧▽≦)/\n\n
54811,722,张引,2017-06-30 08:59:44,6,10,4,老师很负责的，讲课也很清楚，只是上课会希望和学生有互动，我觉得是很好的老师，如果同学能主动一些应该会同意我的看法
56735,722,张引,2017-07-10 15:32:54,3,6,3,平时分水水过，再认真也没什么用，主要还是看期末。
56795,722,张引,2017-07-04 15:43:59,2,6,4,老师比较严厉，但给分还是可以的
57025,722,张引,2017-07-05 08:24:26,9,11,2,认真听真的收获很多，讲的很细，很认真，大爱，我这小白最后满绩，谢谢老师\n\n
58185,722,张引,2017-08-16 14:47:26,2,7,5,有点无聊
60157,722,张引,2017-10-12 01:37:32,12,15,3,基础程设，很负责的老师。可以很严肃可以很滑稽甚至会玩梗。讲课思路很清晰，拿到这样的分我觉得不公平。不点名但是会提问，问题不难，基本上都是上节课用过的知识。作业我觉得不多，课堂练习45分钟就能写完。助教超级棒，你要看到你举手，会直接到你这里来解答问题，不会因为半路有人举手就就近讲题，邻班那个助教，举一次手，一路上给三四个人解答问题之后才到你旁边。总之强烈推荐选张引！！！
60264,722,张引,2017-10-16 07:02:43,20,31,11,建议没有基础而且愿意跟着老师进度走的同学选，有基础或者喜欢自己往后学的真的不要选，讲得慢而且还要问你“我上节课讲了什么”
60518,722,张引,2017-10-23 06:25:08,2,8,6,适合小白，讲得很慢很细。\n\n课前提问代替点名，但有些问题我感觉真是无语……会写代码不就行了，为什么要背出一些概念性的东西。\n\n手写代码也很无聊。\n\n总之就是无聊，慢，细，小白的话强推，有基础的就别来了。
65164,722,张引,2017-12-29 17:06:41,5,7,2,老师和助教都很可爱
69457,722,张引,2018-01-24 17:28:11,14,18,4,老师顶认真顶负责。最最最重要的是，助教小姐姐要不要这么可爱，简直敲喜欢，，，我可以表白吗(｡•́︿•̀｡)
73196,722,张引,2018-02-01 06:48:41,-1,2,3,上机全对，理论考感觉也还可以，最后94卡绩，心痛……怪自己吧
73197,722,张引,2018-02-01 06:49:03,9,11,2,老师人很好 两位助教也超棒超负责！\n\n讲课略慢 适合没有什么基础的同学\n\n没有编程基础上着也很轻松 作业其实并不算多 给分很好
73203,722,张引,2018-02-01 07:13:35,11,11,0,老师超好，就是有一种莫名的严肃哈哈哈哈。老师调分的时候很给力。
73206,722,张引,2018-02-01 07:20:14,8,10,2,老师讲课很清晰，给分也很棒，简直太棒了\n\n
73208,722,张引,2018-02-01 07:23:29,8,12,4,好像高中老师，很负责，给分好，但一定要自己认真学！我是程设基础
73214,722,张引,2018-02-01 07:28:58,1,1,0,作业按时完成考前看看书就行
73217,722,张引,2018-02-01 07:34:55,7,10,3,太棒啦老师挺严厉但是人很好。第一门满基嘻嘻
73224,722,张引,2018-02-01 07:56:51,19,24,5,老师上课讲得很细致，很慢。老师说讲的慢是为了照顾那些零基础的同学，真的让我感动。只能怪自己不努力。
73226,722,张引,2018-02-01 08:02:59,21,28,7,理论讲得很透彻；随机提问能指出一些重点 ；助教哥哥姐姐超级可爱，我把作业交错了也能理解 总之就是很好很好\n\n以及 收获第一门满绩啊啊啊
73233,722,张引,2018-02-01 08:20:31,11,15,4,很棒 负责任 给分很好
73292,722,张引,2018-02-01 09:32:51,17,21,4,老师比较严肃，讲的比较细，挺适合零基础小白（比如我hhhh）。助教哥哥姐姐都特别温柔人特别好。给分也很好，期中感觉特别特别差，上机全对，期末感觉不错，最后满绩～感恩！
73651,722,张引,2018-02-02 09:25:13,0,6,6,老师上课会随机点人提问，而且上的速度有点慢，但还是大爱张引老师
75092,722,张引,2018-04-11 02:13:37,6,13,7,来浙后遇到的上课最有热情的老师
76298,722,张引,2018-04-02 07:30:21,9,25,16,上课测验纸写代码，讲课不清，好好的课被讲的和高中一样的感觉。为什么没有0分？
76299,722,张引,2018-04-02 07:46:59,6,37,31,上课讲得大家昏昏欲睡 上不下去了就直接小测徒手写代码？？？动不动就提问她刚才讲了什么……拜托这是大学了能不要用高中的方法教书！！！1分拿走不谢哦(麻烦各位顶我上前排)
76300,722,张引,2018-04-02 07:39:09,13,38,25,请不要报她的大程，选了会后悔死。
76437,722,张引,2018-04-09 07:42:05,4,7,3,与膀胱战斗
76483,722,张引,2018-04-11 01:20:22,3,5,2,讲的挺好的，但是基本每节上课都点名，小测，上机课也必须要去...课程冲突的话可能非常不友好，中间要跑出来一次专门签个到再溜
76570,722,张引,2018-07-13 12:57:33,-16,6,22,不知道是不是因为这学期只有一个班，老师没有调分，给分非常非常低…非常难受了
76871,722,张引,2018-04-25 03:37:14,-5,7,12,我吐槽一下小测，每节课都有是什么鬼。每个人的学习方法不一样，我不太做得到整节课都专心听讲，课后也往往做不到及时复习、预习，但我保证阶段性会去复习一下。最终的效果不会差于持续做到以上几项的。所以节节课小测很烦人啊！！
77486,722,张引,2018-05-06 03:48:29,2,11,9,大程事情是真的多，感觉讨论课完全没有存在的意义
77766,722,张引,2018-05-07 15:17:13,-2,6,8,脾气暴躁
77809,722,张引,2018-05-08 02:24:49,2,8,6,作业好多
78209,722,张引,2018-05-10 04:05:52,8,13,5,很好的
79039,722,张引,2018-05-21 10:02:04,0,7,7,肺腑之言：大程想活命别选她。除非你愿意在你室友刷剧的时候写project，在你室友不上课的时候上课。
79098,722,张引,2018-05-23 01:20:39,-14,1,15,C程小测又做错了，平时分怕是快被扣光了吧
79278,722,张引,2018-05-30 02:28:28,-7,3,10,自导自演，还要逼着我们参与进来？时代在改变，教学方式能否改进？！！
79279,722,张引,2018-05-30 02:33:52,-3,6,9,上课动不动纸拿出来小测，真的受不了
79605,722,张引,2018-06-14 12:08:32,-4,5,9,作业能不能布置得走心点?就不能和上的内容配套吗？
80417,722,张引,2018-06-26 09:05:38,1,6,5,软工基让全体软工学子天天北街看日出…
82055,722,张引,2018-07-07 03:19:51,1,15,14,很多同学都觉得张老师作业多、点名多、态度不好……其实我觉得，这些问题都是因为张老师从来没有把学生放在合适的位置上。可能她认为自己的学生都想着怎么去蒙混过关，怎么去偷懒，所以她需要“严加看管”，可以说他对学生是没有丝毫信任的。我不知道大家怎么看，但是我个人觉得我无法在接受这样的不尊重，因此我只能给1分。
84462,722,张引,2018-07-13 02:25:13,-4,5,9,不懂有啥好感谢的。别人老师尽量给高你却拼命卡绩。给的分数和作业量哪成正比?\n\n完全不知道展示课的意义何在。
84519,722,张引,2018-07-13 04:49:40,-6,7,13,每节课都有小测，给分还垃圾，喜欢卡绩，呵呵
84544,722,张引,2018-07-13 06:31:55,12,13,1,老师算是很负责了，助教人也很好
84680,722,张引,2018-07-13 13:32:14,10,11,1,C程平时分居然给满了，开心！
84695,722,张引,2018-07-13 14:38:13,17,17,0,我大一c程实验题没有做出来，挂了。大二重修在张老师的带领下4.5，真的非常感谢，学到了很多。
84749,722,张引,2018-07-13 18:42:46,-5,1,6,软工基给分不错 可能是组长加分的原因 堂堂课小测十分可怕 验收怼人超凶被吓哭 软工基刷夜不是闹着玩的 报告什么的超有趣的呵呵
85091,722,张引,2018-07-15 09:33:06,7,8,1,虽然经常小测，不过其实是当签到用。实验爆炸，最后绩点出乎意料，感谢老师和助教小哥哥~
87126,722,张引,2018-09-21 00:15:17,2,6,4,反正大程别选就对，预置的退了补选隔壁陈建海吧.
101553,722,张引,2019-01-28 12:06:27,-5,5,10,c大程前方避雷！警惕警惕！\n\nc大程=比别的班多一个最麻烦的project+四个project都要展测+霸占学生时间补几节展示课+没学生听就小测+喜欢卡绩
101880,722,张引,2019-01-29 11:21:59,11,14,3,C程期末考爆炸，本来以为要凉，结果绩点不低，谢谢老师呜呜呜
101887,722,张引,2019-01-29 12:45:33,8,11,3,说老师事多？我两个舍友平时轻松，考试凉凉。认真学习，老师很负责任的，讲得也很仔细，平时上课有时候会上三节，自愿留下听讲，期末考还在麦斯威答疑，练习量也足够，学c程别想偷懒。
101890,722,张引,2019-01-29 12:48:50,10,11,1,老师上课会以随堂练习的方式点名，非常认真负责，上课内容讲的也很好，本来以为要挂了，感谢老师！
101900,722,张引,2019-01-29 14:49:35,-1,5,6,小测代替点名不是很友好
102670,722,张引,2019-03-31 15:52:49,1,5,4,好老师，讲的很详细，c小程满绩
103740,722,张引,2019-03-05 01:52:18,-2,6,8,大程，魔鬼。(눈_눈)
108056,722,张引,2019-05-14 02:25:07,-6,3,9,想拿高分就别选，
109866,722,张引,2019-06-20 02:09:05,0,3,3,软工基佛了 真是佛了 无法解释\n\n软工基别来
113160,722,张引,2019-07-06 00:50:02,3,4,1,怒打十分 老师和助教小哥哥人都超级好 认真负责 选了绝对不后悔！！
113162,722,张引,2019-07-06 00:51:26,4,7,3,Python：老师上课讲的很细致，PPT的内容也会比书上多，所以复习的时候优先看PPT。平时PTA的题目认真做，一定要有自己的思考，即使不会在看了dl的答案之后也要梳理一遍思路，我想说做到这样其实Python是不难的。最后一定要吹爆侯助教，不仅平时在PPT里给我们划重点，上机课的时候有不会助教一定会讲，平时群里边提问也会认真回答，期末还给我们整理PTA里易错题和所有题目的答案，给我们建议复习的顺序，遇到过的最最好的助教了！
113354,722,张引,2019-07-06 09:37:14,1,3,2,吹爆，Python满绩，真要感谢老师和助教的付出
113485,722,张引,2019-07-06 18:17:38,4,6,2,大程做得不出彩，看到大佬的作品以为自己完了，但是结果竟然挺好的，谢谢老师！助教小哥哥也很棒很耐心！
113512,722,张引,2019-07-06 21:48:52,3,4,1,大程：很有耐心的老师，很负责任，上课会有签到，有时上机也有签到，她的理论课会换到春学期上完，然后夏学期自己做大程。想拿高分就按表格里的要求一条一条做完大程+好好复习考试内容。期末考试占50%，至少我们这一次好几位大佬也只有80+，但是还是有人能上90的hhh
113822,722,张引,2019-07-07 17:14:18,0,3,3,期末分不高，但最后绩点还可以，老师应该是调分了。老师很认真负责~
113847,722,张引,2019-07-07 18:01:02,3,4,1,谢谢老师！老师有点严格，上课比较细致也很认真，但是会有点无聊，不过还是很可爱(๑• . •๑)最后期末考理论凉凉，以为自己要挂了，结果没有，真的谢谢老师！文科生学c真得痛苦，但是老师至少没有让我讨厌c?
113935,722,张引,2019-07-08 01:29:14,-11,3,14,我和我大作业同组的差了3分，明明课有去小测也考了，就期末差了两分，不明白怎么绩点差了0.3？
114691,722,张引,2019-07-11 04:06:18,1,4,3,hyx助教超棒的啊
116586,722,张引,2019-09-12 02:24:45,0,3,3,我觉得讲的特别有调理啊，甚至比很多高分老师还清楚，大程这学期只有第一节课点了两次名，以后都没有点过名了，反正还是认真这种教学很系统清晰的老师更合适自己吧
116883,722,张引,2019-09-17 03:36:34,5,9,4,能不拖堂吗？？？
117395,722,张引,2019-09-24 02:10:10,7,8,1,老师带病也自己讲课，讲学认真负责，能多讲点就愿意多讲点。严肃而活泼。
119299,722,张引,2019-11-12 03:31:52,1,6,5,拖堂厉害
122823,722,张引,2020-04-11 04:07:19,5,5,0,老师还算不错，不过缺点也十分明显，作业量有些惊人，她是将一个长学期的课压缩在前半个学期完成的，导致在前半个学期任务量会很吓人，不过要是有心理准备这样安排那倒还好
123909,722,张引,2020-06-16 06:53:52,2,6,4,软工基，展示的时候只会挑刺，问一些无关紧要的问题和非常显然的问题，毫无答辩提问的技术性可言；上课内容就是对着英文ppt念中文课本。总之毫无任何优点可言，建议尽量避免。
123940,722,张引,2020-06-23 08:12:07,-3,1,4,ㅤㅤㅤㅤ
123974,722,张引,2020-06-18 10:47:48,4,6,2,10分吧，C大程.老师还是很负责的，本来一两个小时可以搞定的展示愿意抽出整整一天的时间为我们指出不足，虽然确实挑剔，但是也给我们修改再次提交的机会了呀.而且估计老师也知道互评不怎么靠谱，所以只占了5分.从这些地方可以看出老师并没有想在分数上为难我们，只是要求高了一些而已，但这作为一名老师也是一件无可厚非的事吧.总之，如果你是计算机专业或者真的想提升自己代码水平的话，张老师还是很值得选的.
124697,722,张引,2020-07-06 12:37:40,0,2,2,软工基很迷很迷，建议避开
125265,722,张引,2020-09-05 04:47:29,12,15,3,大程讲课很差，每次课上都可以墨迹30分钟，一页完全无用的ppt能够讲10分钟，重复‘啊’这个字一节课超过100次，思路非常不清晰，重点不突出，基本一节课下来学不到什么不如自己看书
125302,722,张引,2020-09-06 03:01:40,-1,3,4,老师很好，是我垃圾，推荐选
125343,722,张引,2020-09-07 06:29:42,2,3,1,软工基感觉有毒，但可能是课程本身的原因，虽然最后分数大家都比较高，但和老师关系不大，都是自己大程和考试肝出来的\n\n隔壁似乎也没好到哪里去
126214,722,张引,2020-09-20 00:42:11,4,6,2,大程平时分给分极差，慎选
130644,722,张引,2021-01-24 05:25:13,7,11,4,yysy，张引讲得挺细的，适合我这种没基础的去听，平时作业难度也适中，去找老师问问题也很耐心。还有助教hyx真的良心助教，会整理作业中的易错题、小测解析等等，期末也给出了具体复习方法。最后我理论95，编程满分。确实适合零基础的去选的。
131706,722,张引,2021-02-02 14:18:49,5,9,4,在张老师这里拿下了人生第一个满绩
131812,722,张引,2021-01-29 04:09:37,-1,2,3,软工基讲课真心一般，而且特别能拖堂，事情也很多，答辩的时候对学生态度超级恶劣各种怼人，但是意外的给分挺好，感觉张老师班的软工基给分明显比隔壁王新宇班好很多，同等条件下建议选张老师。
132614,722,张引,2021-02-03 00:37:56,3,4,1,老师上课认真，助教人好，给分不错，唯一的缺点是教学水平还有提升空间，但这依旧不影响我给10分
132891,722,张引,2021-02-04 12:52:16,2,5,3,感谢老师，满绩了
133692,722,张引,2021-03-04 01:48:25,3,4,1,选着就偷着乐吧
134722,722,张引,2021-04-12 06:38:18,0,3,3,编程的启蒙老师
135813,722,张引,2021-05-27 05:17:22,2,2,0,能逃快逃，能选上其他老师尽量其他老师。。。。
136408,722,张引,2021-06-17 15:08:15,2,5,3,讲课讲得太复杂 不清晰 没有重点\n\n和程序无关的事儿太多 为学生着想的意识不足
136409,722,张引,2021-06-17 15:11:45,-3,2,5,太贱啦，上课不知道在讲什么东西，无语
136415,722,张引,2021-06-17 16:19:07,14,19,5,上课讲不清楚，一句话可以嗯嗯啊啊好几遍，中间掺杂一堆语气词，钉钉已读不回，还让助教每次上机课点名，不建议选😅
136433,722,张引,2021-06-18 02:25:27,3,7,4,烂
136557,722,张引,2021-06-23 03:38:09,8,11,3,老师可以，助教拉，10分，互评机制纯属扯淡
136853,722,张引,2021-06-26 02:34:44,-4,0,4,我是上学期上的，现在想起来回来评个分。老师人很好，但是讲课不太到位，总感觉没有讲很多重要的东西，需要自己看书，但c小程，自己看看也无妨。不过还是希望老师上课能多讲一些重难点，和编程实践的操作，以及不要忘了很多同学是完全0基础的。助教哥哥很负责，如果肯主动一点去请教的话会学到很多。然后就是，十分感谢期末捞我，硬是把平时分捞满了。
139213,722,张引,2021-07-13 09:10:00,-2,2,4,求老师捞
139507,722,张引,2021-07-16 16:27:54,4,7,3,只能说，给分真的挺好的……助教人也很好嗷！
139508,722,张引,2021-07-16 16:42:42,-2,3,5,张老师给分真的特别好呀！！！
142302,722,张引,2021-11-10 03:36:48,1,5,4,老师讲课讲得真的很细致，有种高中老师的感觉，上课可以讲到很多平时容易写代码容易出问题的点，上课进度不快，作业不多但是很精，很喜欢张引老师的课
145996,722,张引,2022-01-05 02:41:25,-11,3,14,马上要考试了，特地来给老师10分，没什么别的意思，对吧
146278,722,张引,2022-01-06 06:27:10,8,21,13,绝对的好老师！\n\n在张老师的课堂体会到了高中的感觉！\n\n讲课速度循序渐进，\n\n一开始比较慢让你理解，后面就渐渐回到正常速度啦，特别推荐零基础小白~\n\n我是之前有一点点C程基础的，所以听起来也很舒服，\n\n我们这学期不知道是不是因为疫情封校的原因，\n\n张老师把期中考试改在了期末考试前两周分两次考，\n\n让我们能提前适应期末考试的流程和环境，\n\n真的很不错，\n\n最后理论考试93嘻嘻嘻！\n\nC大程又补选上张老师的课，再续前缘！\n\n选她选她！
146505,722,张引,2022-01-06 17:47:22,-1,3,4,请老师捞捞我吧
149040,722,张引,2022-01-14 07:53:34,-1,11,12,给分还可以，会调分
149048,722,张引,2022-01-14 08:14:59,7,14,7,卡绩！
149088,722,张引,2022-01-14 11:08:45,-10,5,15,老师给分很好，两次小测都很烂，靠期末翻身拿了满绩。就是讲课刚开始速度会比较慢导致后面的难点讲得很快。
149616,722,张引,2022-01-16 08:17:54,2,15,13,卡绩，不捞，不调分，相信我，想拿高分的同学快跑！！！
152537,722,张引,2022-04-14 07:19:14,15,20,5,老师是好老师，课是垃圾课，很多作业项目往往跨步过大，走路都还没学会就让学生跑，这谁吃得消啊
152755,722,张引,2022-04-19 08:33:53,-6,5,11,每节课点名，呵呵呵
154408,722,张引,2022-06-01 04:13:38,11,20,9,答辩太喜欢怼人了。比较辣鸡。
154884,722,张引,2022-06-06 12:42:30,-1,8,9,软工基这课就纯nt。。。\n\n答辩疯狂怼人...
154886,722,张引,2022-06-06 12:51:46,-2,3,5,一分打给软工基这门课
155069,722,张引,2022-06-08 04:47:26,-7,4,11,懂得都懂
155320,722,张引,2022-06-10 18:18:06,4,10,6,C大程讲课讲的很清楚，但是讲的也比较慢，而且上课经常有随堂测验。平时作业倒是留的不多也不少。就是这个大作业事真的多，要互评，要答辩，答辩完了还要再修改报告……总是事就是很多。而且感觉老师好像并没有把大作业的题目搞明白……总之做她的大作业只需要模仿现有的成熟的软件，模仿的越像越好！千万不要选那种乱七八糟的选题，容易最后被怼死！
155613,722,张引,2022-06-14 15:40:01,1,12,11,很烂。可以从老师的电脑看出老师没有什么编程水平。
156093,722,张引,2022-06-17 13:32:18,3,15,12,答辩什么鬼，没有耐心就不要来，不听同学讲，自以为是就开始疯狂怼人
156445,722,张引,2022-06-19 17:45:16,1,7,6,比较严格，但很认真，是位好老师
158106,722,张引,2022-06-28 10:57:49,-16,14,30,师德师风出现了一定问题…\n\n给出了分数并答应了最后的分数比例，并承诺会按照分数比例进行计算。\n\n结果我时候去查分发现这人出尔反尔拒不承认，开始拿一堆别的事情搪塞，和助教一起应付我。（助教不看消息，我一找老师立马已读，笑得）\n\n要是据理力争的话我绝不会输，但既然已经知道人品存在问题，那么就会担心报复性扣分，遂放弃。\n\n为人师表，告诫我们“不负责任的评分会受到反噬”，自己却不能对自己的言行承诺负责。真是可悲！
158138,722,张引,2022-06-27 06:34:41,6,12,6,给分真的好！！！
158225,722,张引,2022-06-27 14:31:08,2,7,5,老师讲的太慢了，我觉得对任何稍微自己花了时间学c的同学都太慢了，不觉得这是浙大的第二个c课程应有的课程速度。这导致上课经常处于听还是不听的纠结中。另外，大程作业要求过于粗略，甚至会引起误解，大程作业的给分不如其它老师清晰合理。
160813,722,张引,2022-10-13 12:10:30,-2,1,3,不错的老师！
163993,722,张引,2022-12-17 06:37:26,2,2,0,好老师 认真学 成绩不会差
164517,722,张引,2022-12-21 11:47:11,10,14,4,22-23秋冬学期总共点名超过2次（机房点过名）小测次数四次，4次小测难度梯度较大，上课有随机抽测（突然布置然后要求全员上交），随机抽测难度较大（po错了2次）目前在等期末考和绩点\n\nc小本身难度和课时不匹配，老师讲课一般，c小终究是靠pta作业和自学捏（ps不要被某些同学装逼吓到了，想了解同学真实水平可以看同学学号并判断名字，有些同学平时作业满分小测扣一半我真不好说😅）\n\n总结：wjjyyds！（图穷匕见）
164847,722,张引,2022-12-27 01:33:39,0,2,2,老师上课还行。
166291,722,张引,2023-01-11 17:29:42,-1,7,8,期末考挂了，但老师是好老师，重修我依旧选你！
166479,722,张引,2023-01-12 10:49:43,-3,1,4,认真负责
167220,722,张引,2023-01-15 06:21:33,5,13,8,这么认真学了3.3？？？呵呵
167224,722,张引,2023-01-15 07:49:13,4,9,5,老师很认真负责，讲的比较细致，但是相应的事很多很严格。经常上课忽然拿出白纸小测，上机课有点名，平时分构成复杂（po应该掉了不少平时分）。出分很慢，应该还是捞过一点点的（po在一档的最低分），虽然算不上给分好，毕竟平时分扣得很多。助教lxf也是很认真负责的助教。总之体验一般，主要怪自己菜吧。
167243,722,张引,2023-01-15 07:51:53,4,8,4,老师讲的是不错，但上课事很多，而且是真的不会捞
167256,722,张引,2023-01-15 08:54:32,-11,9,20,老师应该是捞了的，毕竟出分比较慢而且成绩也挺好看（拿了满绩，朋友零基础的绩点也非常不错）\n\n这种硬课其实是希望老师越认真负责，作业越高质量越好的，老师上课讲的内容还是很贴合考试内容的，虽然有两次突击课上小测试，但是应该是算作点名，作业量不是很大，基础好的同学完全可以上机课的时间就能完成，作业中的题目是有点快于教学进度的，但是题目的质量还是非常高的。\n\n总结：张老师课上的还是不错的，但是老师平时比较严格，捞的程度可能不大，想要好成绩还是要踏踏实实完成作业（csdn这东西还是少抄，我和朋友就没有抄过），我几乎没有自学，所以跟紧老师应该是可以拿到不错的成绩的。
167266,722,张引,2023-01-15 09:43:49,3,4,1,推荐很强的选，不太捞
167347,722,张引,2023-01-15 14:44:04,0,4,4,老师讲课很认真，水平和能力非常好\n\n就是给分确实求是
167445,722,张引,2023-01-16 09:49:17,9,10,1,4分给助教，趣味性几乎没有，讲的和测试的难度是脱节的（可能所有老师都有这样的问题），给分求是。。。
168024,722,张引,2023-01-23 02:59:48,6,6,0,作业相对来说会难一点，但确实适合钻研，适合提升能力
168827,722,张引,2023-02-22 14:13:09,1,5,4,真的不咋滴，本来以为上课讲的慢就是个好老师，其实讲得根本不细致、不清楚，而且老师推责任给学生都上过十大，因为讨厌老师都讨厌这门课了
169485,722,张引,2023-02-26 11:30:57,-3,2,5,老师你快回我啊啊啊啊啊啊啊啊啊啊!!!!!!!!!!孩子想上学啊啊啊啊啊啊啊啊!!!!!!!!!!!!!!
169611,722,张引,2023-02-27 06:17:12,3,8,5,给分一般，讲课也一般
170583,722,张引,2023-03-07 02:50:16,13,19,6,上她的C大程，真的是很难受，讲课效率慢，信息熵很低，喜欢罗列一些没有必要细致讲的东西，比如字符串二级指针翻来覆去的讲，上课效率远低于自学，只是说能讲清楚，给不会的同学一个托底。
171322,722,张引,2023-03-21 15:05:56,-4,12,16,刚开始上C大程， 感觉讲的很不错的，知识点讲的很清楚，很细致，一遍就能听懂，非常好，私聊问问题也很有耐心回答，感觉是很好的老师，毕竟计院预置的老师，不会差的
171974,722,张引,2023-04-23 10:16:03,5,8,3,讲课是讲得真差，一句话不懂要“啊”多少次
174339,722,张引,2023-06-10 01:11:33,14,17,3,我愿称你为新时代之塞翁
174367,722,张引,2023-06-11 02:54:44,6,9,3,无语，大程都截止两天了还要求全体同学按照她新提出的新标准重新修改作业，还有烦人的PPT还有现场展示，我怎么没听说其他的老师有这么烦
175151,722,张引,2023-06-22 02:58:57,11,17,6,纯sb
176831,722,张引,2023-06-30 09:58:26,3,4,1,软工基的话...注意平时讨论。分数的正太会用讨论的正太来做，有些离谱（老师助教不会告诉你讨论是需要卷的，千万别以为讨论就是签到，交了就给分。我们组因为这个最后总评扣了4分）。大程和报告倒是正常就好，不用特地卷效益不高。1分送给课程组
177459,722,张引,2023-07-03 10:31:18,1,2,1,呃呃了
179129,722,张引,2023-08-28 08:18:05,4,6,2,上的C大程，感觉课程安排不是太合理。着太多笔墨在二级指针了，在这一部分信息熵极低，结果其它部分就讲的比较草率，一笔带过。作业量相对较小，至于大程序基本靠自学，也没啥可说的。\n\n总体一般，至少比C小的脚哥好不少。
180051,722,张引,2023-09-20 07:56:00,3,6,3,拖堂？不确定，再看看
181193,722,张引,2023-10-11 07:50:59,13,14,1,上课还要突然纸上写代码是几个意思。。。（还这么水的题）
184465,722,张引,2023-12-20 07:33:46,1,5,4,还可以，并没有那些评论说的不好
185212,722,张引,2023-12-27 05:53:46,0,4,4,老师讲课很有耐心，很仔细，对小白友好。
188681,722,张引,2024-01-19 14:10:50,2,4,2,C小没有课堂上的实践展示，缺少直观体验
188962,722,张引,2024-01-21 01:13:22,5,7,2,c程序设计基础及实验推荐。\n\n个人是计算机小白，之前看了评论有些劝退，但实际上下来体验还是不错的。\n\n讲课比较细致，对重要内容会强调。有时候节奏比较慢，但是是为了把问题讲清楚，室友选的cjh老师也如此，可能是c程老师共有的习惯。\n\n作业量不大且合理，契合考试不乱出作业题，这点很舒适。再加上自己的实操，发现并利用CSDN等网站解决问题，还是能比较好地掌握课程要求的内容的。\n\n最后，老师给分也是相当不错的，感谢zy老师！
189068,722,张引,2024-01-21 14:53:45,5,7,2,上的老师的c程序设计基础及实验。\n\n本人暑假时学习了一点点c语言，大概水平是了解了一下数组及之前的知识，基本上算作是计算机小白。本学期预置百题斩老师被劝退，当时只有张老师的班有较多余量，我就换到了张老师的班。由于老师的评价褒贬不一，所以我一直很担心老师的给分和教学水平。老师上课速度很慢，建议小白来选，可以跟着老师的节奏加深对知识点的理解。但是相应地课程可能会比较无聊，很多时候会比较催眠。不建议大佬来选张老师的课，因为张老师讲的很基础，而且酷爱点名，秋冬学期15周上课和上机课一共雷达点名8次，随堂小测（相当于点名）5次，想划水的可以避雷。老师的作业量比较小，大部分时候基本上是4道编程加上半个小时左右可以完成的理论题，比较熟练的话可以利用上机课的时间全部完成。老师的4次上机课小测契合作业和上课进度，不像有些老师乱出题，很多题甚至是作业题的原题，题量也比较合理，难度也不大。并且感觉到张老师是比较关心学生的，实验考和理论考之前的那节课都嘱咐了我们很多，我有一次因为流感请假了，老师说了不少话来关心我。本学期实验考安排得有些晚，所以实验考之后的内容上的比较匆忙，我期末的时候因此误以为实验考之后除了指针都不是考试重点，结果期末遭到爆杀，卷面分估计只有六十多分。不过我实验考满分，平时分大概扣了两三分，加上老师的捞捞，幸运获得89分。建议以后的同学汲取教训，利用CSDN等平台强化自己的能力（理论题也不要轻视），把这门课学扎实。总之，zy老师对小白来说还是很不错的，但最好不要划水。10分感谢老师。
189325,722,张引,2024-01-23 08:46:30,-1,2,3,好老师，有高中课堂的感觉
192142,722,张引,2024-05-10 02:56:57,7,9,2,其实还行，除了课堂有些催眠。对于新手很友好的，给分也算善了吧。
194881,722,张引,2024-06-25 23:38:53,4,7,3,（python）老师特别特别喜欢点名，上课数字、雷达、学在浙大五分钟小测（网卡的时候怪紧张的）、上机课雷达，总共加起来感觉有十二三次。她上课不太用话筒，然后我自己对程序不太感冒，听课很催眠。但老师应该是捞了的，出分比最快的老师慢了五天，感觉是所有老师里很晚的，我感觉比自己预期的要好。
195924,722,张引,2024-07-01 01:23:55,2,3,1,这学期的软工基给分还是非常好的，感觉和助教有很大关系
196561,722,张引,2024-07-04 05:34:56,6,8,2,讲课细致，适合社科学生；给分求是，务必好好学习。
199445,722,张引,2024-09-24 01:24:15,0,2,2,上的程序设计专题收尾班，老师讲的很仔细以至于不得不拖堂，对重修的学生来说很棒。给分还行，但是程序课程千万不能摆烂
199508,722,张引,2024-09-25 00:06:06,1,2,1,很细致
199570,722,张引,2024-09-25 13:17:35,0,3,3,会拖堂(눈_눈)
199635,722,张引,2024-09-26 12:37:40,-4,7,11,出你个锤子的题，自己题上面的函数全是错，还让学生去做？
199779,722,张引,2024-09-29 15:47:48,4,4,0,老师可以不出调试题嘛(可怜巴巴)
200379,722,张引,2024-10-16 11:44:33,5,5,0,zy老师的课对新手小白还是非常非常友好的，之前零基础跟着老师学，认真听是真的能学会东西的，总体感觉很不错！！好评
201772,722,张引,2024-11-06 05:59:24,0,3,3,zy老师巨好！上课很有逻辑，当时的助教老师也很负责，给分也特别好
202537,722,张引,2024-11-13 04:04:22,17,17,0,Python\n\n助教艾哥是我蝶
205026,722,张引,2024-11-30 01:10:11,5,9,4,不说讲课水平 但是作业相对真的少 编程题每周平均3-5道\n\n可能是每周作业都要硬凑成100分的缘故（）
205031,722,张引,2024-11-30 03:57:47,3,4,1,好老师，讲的很细，强调重点
205285,722,张引,2024-12-04 01:29:47,7,7,0,又是一堂让人昏昏欲睡的课
205401,722,张引,2024-12-05 16:59:57,0,5,5,她的C大程千万别选，可能因为我们班是最后一届，作业随心所欲。简单的题目说往年做的多，所以直接去掉，只能选难的，最后给分也非常差。追求分高或者事少的同学千万别选，只能说基础差，不要求高分的可以选，讲课还是很细致的。
206767,722,张引,2024-12-17 12:33:34,3,4,1,8分吧。10分打给作业少，-2…她真的好爱点名😇一学期下来没点名的课不太有😇😇😇老师人不错。
207103,722,张引,2024-12-19 08:52:02,6,8,2,Python\n\n想给azx助教哥哥一百分，人帅心善，能理解学生的困难，会主动减轻作业量和难度，有任何问题找他都可以解决。\n\nZy老师也是好老师，适合人文社科同学选，讲的很细致。不过酷爱点名，几乎每节课都点，而且喜欢在两堂课课中点（lz因为下课睡觉曾经错过了一次点名）但是对学生也很友好，好好学都没问题，推荐！
207933,722,张引,2024-12-25 03:56:28,5,7,2,azx我们喜欢你
208082,722,张引,2024-12-25 13:25:27,0,4,4,老师真的很认真负责，很可爱。
209299,722,张引,2025-01-05 10:58:45,2,2,0,我觉得老师挺不错的，很耐心，年龄比较大了，人很和蔼，也算是通情达理的
209704,722,张引,2025-01-06 17:14:43,3,6,3,考前半夜复习Python才知道，PTA上好多作业题题干都被改了，原来对的现在都变成错的，好多次作业都比原来少个几分，服了啊😭但是azx助教哥哥很好😍
211190,722,张引,2025-01-11 03:53:02,2,7,5,感觉今年老师平时分给的挺高的
211256,722,张引,2025-01-11 05:33:19,-1,6,7,c程被卡了😨
211296,722,张引,2025-01-11 07:00:33,0,3,3,老师超级好 助教也超级好
211316,722,张引,2025-01-11 07:43:24,4,4,0,愛點名但會撈 期末估分只有40左右 作業全靠gpt\n\n小測也挺拉的 總評還有70\n\n想擺爛可以選 但記得點名
211452,722,张引,2025-01-11 13:03:35,-1,2,3,上的C尖，老师讲的比较细致，挺适合跟着她思路学的。点名比较多，基本每次都有。作业量正常，小测是理论题＋编程，我觉得有一点难，不是很容易拿满（后两次的编程题压力还挺大的）。但最后给分挺好的，我觉得可以选。
211479,722,张引,2025-01-11 15:01:59,7,9,2,讲得很细，但一点不捞，成功被卡绩，慎选
212115,722,张引,2025-01-13 09:28:15,2,4,2,给c尖qjj猪脚满分☺️助教gg很忙，但是平时回复问题超级超级认真，回答得很专业，我一看就懂，而且超级超级有耐心😘！！！助教gg好厉害ヾ(Ő∀Ő๑)ﾉ
212368,722,张引,2025-01-14 02:18:51,-2,6,8,老师是很好的，讲的都很细很认真。azx助教很难评，疑似对女生比男生上心很多，反正问问题都感觉他很不耐烦，爱理不理的。
212377,722,张引,2025-01-14 02:29:42,0,4,4,u1s1，zy老师的课确实一般，早八的课极度催眠，还酷爱点名。\n\n但是但是，azx助教哥哥简直是我的神!!!\n\n回答问题温柔耐心，我最后也是被捞上了4.5！！
212383,722,张引,2025-01-14 02:42:52,2,3,1,被卡了www😭😭😭😭
212541,722,张引,2025-01-14 07:14:59,-7,5,12,省流：上课烂，给分低，别选\n\n具体分析：\n\n1 上课讲了跟没讲一样，催眠，不如自学\n\n2 实验考两道都做出来了，期末理论考感觉良好，最后出分被卡绩82/3.6，看来这个老师平时分给得也不咋地
212729,722,张引,2025-01-14 15:20:48,23,24,1,期末刚结束，看着张老师的最新评价还有些恍惚，两年前自己是学生的身份给老师写评价，现在已经变成助教的身份出现在评价里了......\n\n先说说老师吧，当助教的过程中感觉张老师人挺好，作业和小测难度都不高，但是点名严格执行课程组要求的10次，正课或者上级课凑够10次点名，然后点到8次就给出勤满分，期末成绩也会调整作业分加权比例尽量让同学们不卡绩，最后班上90人大概有四十多人在89分以上，按理给分还算不错，但是调整作业分算比例总还会有七八个同学卡绩，没有办法；\n\n再谈谈自己当助教感受吧，同学们大部分都学的很努力很认真也很有礼貌，眼里都是有光的哈哈哈，看到钉钉有提问的时候，比较容易的会直接手机打字回了，难一点的就等用电脑时再回，我发现回答完问题后偶尔的一句鼓励同学们可能就会很开心，我也很乐意为同学提供些情绪价值，当然也没什么好装的，也有少数同学会丢几张题目截图过来再加一句冷冰冰的“这几个题怎么做？”，哥们你但凡有个称呼，助教都愿意尽快回你消息，如果你都没有表达一些交流时的尊重，怎么能指望助教温柔耐心地回答问题加上提供情绪价值，当然问题最后都回答了，这是助教的工作，也理解有些同学刚从高中过来不太懂怎么和人交流......算是从助教的视角给后来的同学提供一点新的信息吧
212736,722,张引,2025-01-14 15:57:26,2,3,1,老师还是挺负责认真的
212746,722,张引,2025-01-15 00:02:31,5,6,1,人文的学生误入python，纯摆烂式学习，小测和期末都是六十分出头，期中实验考也是补考通过，期末考完以为死定了最后被捞上了70+🥰感谢张老师 顺便表白azx助教 很温柔的学长🥺
212924,722,张引,2025-01-15 09:16:44,1,2,1,C程序这门课本身难读就比较大，而且好多同学之前可能未曾接触过，这门课考核是相当多的，有平时小测，实验考，理论考，老师讲课也是比较仔细地，并且会指出很多容易犯错的地方，是一个非常不错的老师
214175,722,张引,2025-01-27 01:55:41,2,3,1,老师讲得很细，不过可能不适合“应试”？给分求是，可能卡绩，人还是很好的。
214532,722,张引,2025-02-11 11:30:01,2,2,0,表白助教老师，人超级好
214625,722,张引,2025-02-15 06:52:07,1,1,0,好老师，讲得很细，小测和作业难度合理，给分也不错，会帮我们复习高频考点和易错点，适合想要拿高绩点但零基础的同学
214841,722,张引,2025-02-18 07:48:06,1,1,0,表白助教qjj，很不错的学长
216842,722,张引,2025-03-26 13:46:04,0,0,0,出题太恶心
217331,722,张引,2025-04-08 14:32:00,0,0,0,助教学长真的很好，老师很细致
217558,722,张引,2025-04-13 06:47:25,0,0,0,qjj助教真的超好www~每次问完问题都会给你发个大拇指hhhhhh~
218984,722,张引,2025-05-16 09:11:34,0,0,0,test
219099,722,张引,2025-05-21 11:06:49,1,1,0,其他的不说了，下面都讲的很清楚了，就是不知道是助教的问题还是老师的问题，这学期出现两次题目在发布后再加题目而且没有发通知，都是在我做完pintia后，导致作业分数莫名少了一部分。。。真的很无语。
31773,755,卜凯,2016-07-05 01:46:08,14,17,3,本以为60分就不错了，结果给了80多
32733,755,卜凯,2016-07-12 07:07:47,18,23,5,老师人超级好！对学生超级好！！大学见过的对学生最好的老师，没有之一！给分也超级好！
32861,755,卜凯,2016-07-19 07:25:07,12,15,3,卜老师真的是难得的对学生负责的老师，大概是年轻老师，上课的补充内容也很丰富。收获颇丰！重点是！！！ 大家分数都超级高
32877,755,卜凯,2016-07-20 14:03:30,5,9,4,\(≧▽≦)/赞的
48454,755,卜凯,2017-03-04 17:38:52,9,12,3,卜老师人超级好，但是对实验课不太了解，理论课还行
59623,755,卜凯,2017-09-25 03:20:24,8,11,3,超级好的班主任
60618,755,卜凯,2019-04-24 14:06:51,-62,14,76,老师和学生都是中国教育制度的牺牲者。不适合当老师的人就不该让他来讲课
60812,755,卜凯,2017-10-30 15:19:15,1,6,5,新生之友老师，很负责
61001,755,卜凯,2018-12-17 08:05:20,36,41,5,韬，你吃了吗？
63668,755,卜凯,2017-12-12 07:11:05,4,7,3,人超级好
63676,755,卜凯,2017-12-12 11:07:11,3,7,4,超级好的老师 很关心学生
66939,755,卜凯,2018-01-19 11:16:59,25,30,5,xwt你平时分那么高你怕什么
69105,755,卜凯,2018-01-24 08:30:43,3,7,4,凯哥对学生是真的好 讲课也很认真 点赞
74314,755,卜凯,2018-02-10 11:26:21,3,7,4,非常好的
88638,755,卜凯,2018-11-05 01:52:36,3,5,2,ppt顶端和底端的字在课室里看不到……
91186,755,卜凯,2018-12-03 01:56:43,7,8,1,浙大灵魂讲师
91611,755,卜凯,2018-12-15 17:15:07,4,9,5,上课没压力，凯哥超好的，尽力而为嘛。我超喜欢凯哥的。
97416,755,卜凯,2019-01-22 08:46:03,9,13,4,考完体系评价一波，凯哥真的是好老师啊。很认真很负责很良心。虽然看起来很幽默但是也是个比较害羞的人呐hhhh，真的很在乎每个学生的想法，希望上课和同学积极互动，虽然是全英文但是不要有压力。最重要的是人超级超级好～
100114,755,卜凯,2019-01-25 15:16:08,15,18,3,圣诞平安果很好吃，夜宵很好吃，凯哥也很好吃！2333   是个计算机学院为数不多的良心好老师了 就这样！爱您！
100115,755,卜凯,2019-01-25 15:16:22,4,8,4,好像一直没和凯哥夜宵过
100121,755,卜凯,2019-01-25 15:19:06,5,9,4,凯哥基本是来浙大你能遇到的对学生最好的老师了\n\n\n\n分数也比想象中高很多。。。
100123,755,卜凯,2019-01-25 15:21:45,7,9,2,dztz
100141,755,卜凯,2019-01-25 15:37:34,4,8,4,凯哥我tm吹爆。人超好，感觉就像学长一样，努力和同学们打成一片。圣诞节还送我们平安果！！成绩也是尽量让各位同学满意！
100180,755,卜凯,2019-01-25 16:49:28,3,6,3,真真正正从学生角度出发的老师，或者说，凯哥
100278,755,卜凯,2019-01-26 01:56:07,3,6,3,我爱凯哥 就这样
103726,755,卜凯,2019-03-04 15:55:24,3,7,4,凯哥好老师，难得的好老师
105501,755,卜凯,2019-04-15 13:58:23,2,6,4,超棒的老师
105639,755,卜凯,2019-04-24 11:24:47,12,16,4,卜懂hhh
106046,755,卜凯,2019-04-24 14:08:46,4,8,4,凯哥人真的超级好
106136,755,卜凯,2019-04-27 03:09:42,2,6,4,好老师好老师
106342,755,卜凯,2019-04-26 12:23:57,-12,11,23,凯哥人是好，但是他自己对课程的内容都不熟。反正我网安啥都没学到，感觉就是把之前上过的信安原理、计网、区块链，各拿一点东西拼凑过来。
106487,755,卜凯,2019-04-28 01:06:17,2,5,3,kg一定要给高分噢
106720,755,卜凯,2019-05-06 09:34:30,6,9,3,网络安全这门课给分好，考试开卷。
106722,755,卜凯,2019-04-29 05:42:54,6,8,2,这老师真的蛮不错的
106723,755,卜凯,2019-04-29 05:45:13,2,5,3,老师人真的很好！
106724,755,卜凯,2019-04-29 05:49:56,5,9,4,KG备课超认真的
106727,755,卜凯,2019-04-29 05:58:36,8,9,1,老师真的很不错！（一条一块，随机发，括号里的字去掉）
106729,755,卜凯,2019-04-29 06:27:23,8,11,3,wow，kg是在计院里遇见过的最贴心的老师了，就像一个和你一起成长的大男孩，亲切自然
106734,755,卜凯,2019-04-29 07:06:47,12,15,3,之前跑去蹭凯哥的课发现是个好老师。之后经常和凯哥水群，凯哥人真的超级棒。之前看凯哥的简历觉得南理工和港理工phd在zju老师里面一般，但之后听别人讲kg的故事之后觉得挺惋惜。凯哥属于那种很聪明又谦虚的人。凯哥带科研水平还不错，身边同学都发出paper了。凯哥喜欢和学生水群，挺热闹的。我觉得凯哥是zju年轻老师里面对学生最好的。zju青年才俊里面有些非本校出身得对浙大本科生是有点呵呵呵，当然whz不算，whz也很好。
106795,755,卜凯,2019-04-29 14:28:50,6,8,2,Wow!
106840,755,卜凯,2019-04-30 04:17:03,3,6,3,他的眼里闪着光
106843,755,卜凯,2019-04-30 04:25:55,4,5,1,dztz，yyy
107079,755,卜凯,2019-05-01 11:13:32,2,5,3,这学期旁听的信安，虽然不是每节课都去了，但还是能感觉到老师非常认真，科研能力也在线。听卜老师说是第一次开这个课，希望以后能越讲越好~
107272,755,卜凯,2019-05-03 01:40:57,2,5,3,卜老师讲课很认真，也很关心同学，很能和同学搞好关系。老师也给了我很多帮助，我十分感激
107274,755,卜凯,2019-05-03 02:15:54,2,5,3,与学生非常亲近的老师，没有架子，为人和善，乐于帮助学生，给分也大方
107476,755,卜凯,2019-05-05 13:52:09,2,4,2,友善认真。网安课经常尝试和同学们互动，染鹅经常只有 zdl 回应
110113,755,卜凯,2019-06-23 08:31:35,3,4,1,很好的老师
115437,755,卜凯,2019-07-23 15:10:49,3,4,1,老师特别好，很认真负责！
121054,755,卜凯,2020-01-19 10:49:13,7,8,1,vote for kg
124018,755,卜凯,2020-06-20 13:47:48,10,11,1,kg真的是我见过最好的老师。人太好了，而且也很关心学生。喜欢水群和大家聊天讨论。最最最最重要的还是人好吧，如沐春风的感觉。给分也很棒，师生情满满，对我们的评价也很高（都有点不好意思了）是会花时间交流的老师，当时assignment给我写了一页纸的评论让我很感动。
129694,755,卜凯,2021-01-11 03:29:43,5,8,3,kg，选过都说好
129695,755,卜凯,2021-01-11 03:31:06,4,6,2,真不戳，谢谢老师
129703,755,卜凯,2021-01-11 05:29:26,3,4,1,浓浓师生情
130512,755,卜凯,2021-01-23 07:48:47,11,14,3,体系满了，谢谢凯哥
130523,755,卜凯,2021-01-23 11:29:16,5,6,1,虽然自己考的不好，但是kg真的很好\n\n感谢kg一学期来的陪伴
130864,755,卜凯,2021-01-25 04:47:53,9,11,2,kg超好的！能上kg的体系超幸运的呢！xixi
131010,755,卜凯,2021-01-25 14:12:27,6,8,2,超真诚的老师了！不仅仅是课程学习，还在未来发展、待人处事方面从kg那里得到了许多帮助！\n\nQ25回复泪目！
134870,755,卜凯,2021-04-19 14:23:50,-13,5,18,如果真的想降低课程水度，为何不布置一些有挑战性的实验呢？又不是为科研训练而开课，以做研究为project，再怎么提高形式上的要求，不是对这一特定方向有研究兴趣的同学，不都是会实质上弄得很水？即使是科研训练，一个短学期内，从ctf签到题的水平，直接跨越到复现顶会论文，不觉荒唐吗？
134968,755,卜凯,2021-04-25 11:14:57,-14,3,17,老师很好，但选网安真的要做好心理准备，事情真的太多太麻烦了
135393,755,卜凯,2021-05-09 15:24:54,0,2,2,nmd kg yyds!
135413,755,卜凯,2021-05-10 03:36:53,0,2,2,xxkg，kgyyds，wa课才艺表演环节可真是太棒了
143618,755,卜凯,2021-11-29 03:54:48,-20,3,23,英语不流利，听着难受，还经常拖堂
145793,755,卜凯,2022-01-02 10:55:28,3,4,1,体系结构：\n\n1. 实验课偶尔点名\n\n2. 和同学们关系特别好，可以从老师那里了解到好多学长经验啥的\n\n3. 平时分给分特别好（平时作业布置的也蛮合适的）\n\n4. *实验验收没有那么的“求是”（咳咳），给同学们“回旋”的余地。当然了如果你很热心的讨论问题老师也是会认真和你探讨的\n\n5. 理论课准备的特别认真与充分，考前专门给我们准备了复习PPT，呜呜\n\n综上，老师的评分10分起步，但可惜最高只能打10.\n\n现在还没出分，也没考试，不过成绩不重要，如果我成绩辣鸡那一定是我摸鱼摸多、太混了，和老师没有任何关系。
145956,755,卜凯,2022-01-04 15:49:02,10,11,1,kg，我滴神!
145957,755,卜凯,2022-01-04 15:49:53,2,3,1,yyds
145959,755,卜凯,2022-01-04 15:52:08,0,1,1,kg yyds
145962,755,卜凯,2022-01-04 15:55:03,5,6,1,妓院上了三年课，第一回见到对学生这么友好的老师，虽然是纯英文授课，我听的不是很明白，但是体系更多的还是要考前大力背，强烈推荐，强烈推荐，强烈推荐，验收很友好，平时分都给满，人非常有趣，强烈推荐，强烈推荐，强烈推荐，kg 我滴神
145965,755,卜凯,2022-01-04 16:01:28,0,1,1,yyds，kg，我滴超人
145967,755,卜凯,2022-01-04 16:03:46,0,1,1,kg yyds
145971,755,卜凯,2022-01-04 16:29:33,0,1,1,老师非常可爱，讲课非常认真，给分很好
145974,755,卜凯,2022-01-04 16:59:50,-14,1,15,什么都不懂也能捞到4.8吗。。。
149453,755,卜凯,2022-01-15 11:42:34,6,7,1,kg真的是我这三年来遇到最负责的老师了，能看得出他备课有多认真，也能看的来他有在和学生交朋友，真是不可多得的好老师！
151054,755,卜凯,2022-02-22 10:45:16,-11,5,16,。。。
161819,755,卜凯,2022-11-14 04:17:04,1,2,1,卜凯老师对学生认真负责
172238,755,卜凯,2023-04-23 10:42:18,1,1,0,凯哥我男神！
181245,755,卜凯,2023-10-12 05:38:37,3,3,0,vote for kg
181358,755,卜凯,2023-10-16 02:39:20,5,8,3,凯哥是非常认真负责的老师，对学生也非常亲切没有距离，水平也非常好，吹爆\n\n全英授课，只会在不得已要解释清楚的时候才会用中文说；\n\n课件和其他班的都不一样，风格简洁，相对和其他平行班相对不那么详细，必须辅助听课才能用于复习；\n\n凯哥英语口语在众计院老师里肯定是头部水平了，但是可能对于一部分人而言可能还是会很难习惯，如果听不进去的话还是建议跟着看看别的班的智云+自己看教材
183524,755,卜凯,2023-11-27 04:42:41,9,10,1,进入大学以来我真的第一次遇到拖堂20分钟的老师，中午12:44下课
183931,755,卜凯,2023-12-04 03:57:10,16,17,1,老师人很好，但是验收很墨迹，超级爱拖堂。\n\n“我们已经拖堂15min了，有人有意见吗？那我们再拖一会把这几道题讲完。。。”
186754,755,卜凯,2024-01-13 02:51:29,7,7,0,表白凯哥，非常关心学生很温暖的一个老师，期末考监考的时候主动确认试卷可能表达不清晰的地方，提醒同学对试卷的表达有疑问尽快提。拖堂是会拖，本人感觉无所谓，其实拖的也不久，只是因为是中午可能影响一些同学吃饭。反正非常喜欢凯哥，每次点不点名纠结半天，有时候最后也没点，超可爱哈哈哈
186937,755,卜凯,2024-01-13 16:13:26,1,2,1,凯哥真的超好，自己水平过硬，如果真的想学，能学到真东西，老师真的懂。讲课很好，只是我不配听，全英文有点难懂，不过如果预习了应该可以，PPT会提前发，有注释，能看懂。给分超好，超好，超好，硬件课最高的一集！
186952,755,卜凯,2024-01-14 01:31:52,8,8,0,凯哥人真的很好，英语非常流利标准，很适合体验全英文课程，凯哥也很乐于课上和大家讨论（不过有些high level问题讨论时候真挺难想到hhh）；除了一次展示以外，没有工作量很大的内容，整体都很友好；因为体系考察的时候有点各个老师授课取并集的感觉，可以和其他班的同学交换下课件看看，学期内只要认真学了分数都不会差
186958,755,卜凯,2024-01-14 02:04:54,7,7,0,对学生好，给分也好，选到就是赚到
186959,755,卜凯,2024-01-14 02:23:05,4,4,0,老师很认真负责，对同学们都很关心，是好老师
187536,755,卜凯,2024-01-16 12:45:50,2,2,0,表白kg！
206423,755,卜凯,2024-12-15 05:35:16,3,3,0,kg怎么不开网络安全原理与实践了
208910,755,卜凯,2025-01-03 09:56:58,5,5,0,10分无需多言！
208959,755,卜凯,2025-01-03 15:00:19,10,10,0,1、人很nice，会听同学意见进行教学安排上的修改\n\n2、考前组织无数次答疑，真正的朋辈辅学\n\n3、教学方式是根据课本做的ppt，因此在大题的细节方面应该会比其他班的学生更清楚（因为很多老师各讲各的，不按课本来，期末复习时什么托马斯络的具体做题细节你就老实了，评分高的几个班的老师都能教会，但是在细节上不出错不如多多问问凯哥）\n\n4、真正热爱教学、热爱学生的老师，很乐意跟学生聊问题，以及聊未来的职业规划等等，作为一个大哥哥的形象给你讲\n\n5、平时分给分方式应该类似沈丽萍老师的军理，只要quiz到场、作业按时提交，签到到场，不打满但捞到能捞的最高一档，近似认为给满\n\n6、计院新晚翘掉“德育老师”颁奖去给学生上上机课，真正的德育老师，真正关心学生而没有那么在意虚名的老师，伟大无需多言\n\n7、期末复习会给各位同学一些复习提示，比如“多去做做别的老师班的作业”，亲测很有用\n\n最后，他值得10分！！！
208966,755,卜凯,2025-01-03 15:55:32,1,1,0,表白kg
208997,755,卜凯,2025-01-04 06:47:05,6,6,0,老师超级好，上大学以来遇到的最好的老师（没有之一），跟同学们关系也非常好，平安夜还送了大家苹果，平时有问题也非常欢迎大家去找他（凯哥人真好，太感动了），还会询问大家对课程的意见，并且会耐心的回复（哭）\n\n强烈推荐，学弟学妹们快去选凯哥的课！！！\n\n但不要过于热情，凯哥是个i人（划重点）\n\n最后再夸一下我自己，我居然一次都没缺过课哈哈哈
209775,755,卜凯,2025-01-07 05:07:01,3,3,0,真的担当得起好老师之名。\n\n上课全英文听稍微有一些累，但是体系的知识点全都覆盖到了，第一次发现硬件课能够这么有意思。
210100,755,卜凯,2025-01-08 06:50:41,6,6,0,超棒的kg，试问哪个老师平时分能给这么慷慨！！！\n\n平安夜kg送的平安果是我在杭州吃到最好吃的苹果！！！\n\n就是全英文讲课有点难跟得上，可以辅助hsb老师班的智云！！！\n\n会和我们一起聊成长的烦恼，聊前途未来，感觉点醒了我这种喜欢摆烂的人！！！\n\n爱水qq群！！！（这是可以说的吗？）\n\n出分巨快的神！！！\n\n没出分时，为什么都说卜凯是神？出分之后，卜凯真的是神！！！\n\n“Where are you? Here.\n\nWhat time is it? Now.\n\nWhat are you? This moment.”\n\n“Old urges continue to arise， but urges do not matter; only actions do.”\n\n“A warrior is as a warrior does.”
210284,755,卜凯,2025-01-08 17:17:23,3,3,0,体系平时分基本都给满，事情也不太多，处分很快，给分很棒，体验非常好。上大学后遇到的为数不多的好老师。
212384,755,卜凯,2025-01-14 02:44:22,1,1,0,老师人很好！讲课基本是全英文，口语很好，听课不管听不听得懂的至少听起来比较舒服。还给大家送了平安夜的苹果。以及盲猜一手老师的mbti是infj/infp
214096,755,卜凯,2025-01-24 03:11:19,3,3,0,苹果好吃😋，谢谢kg
216055,755,卜凯,2025-03-10 04:28:43,6,6,0,kg无敌！！！在浮躁的计算机学院里少有的用心教学的老师，真的为学生着想，他真的我哭死
220682,755,卜凯,2025-06-19 08:11:12,0,0,0,kg是我的神！平时超温柔（就是上课全英文确实有些困难啦）~助教也很好！改卷也是中国速度，赞(^3^)
220754,755,卜凯,2025-06-19 14:21:13,0,0,0,bk老师特别平易近人，对学生很好，对于学生也很宽容，很幽默，问问题会认真解答，kg是我大学以后遇到的最好的一位老师，给分也很宽容，老师人超级超级好，大家都来选kg的课
220756,755,卜凯,2025-06-19 14:05:18,0,0,0,老师儒雅随和，幽默风趣，真的能和学生打成一片\n\n水平极高，回答问题很快\n\n这学期因为自己的原因（英语不好。。。）学期中一度摆烂，期末狂补\n\n但最后出成绩结果还是出乎意料的好，没想到曾被数逻和计组轮番折磨的我硬件课还能有这样好的成绩！\n\nand出分速度也很快，今天上午考试下午提交成绩（）\n\n在这里写评论突然又有些感伤，这应该是大学里为数不多会让我留恋，不舍的课程和老师吧\n\n伟大，无需多言！
220757,755,卜凯,2025-06-19 14:08:57,0,0,0,凯哥永远的神！！！冲凯哥绝对不会后悔！！！凯哥还会发苹果给同学们，给分真的太好了！
220765,755,卜凯,2025-06-19 14:39:35,0,0,0,体系满了！凯哥你是我的神！！
220773,755,卜凯,2025-06-19 15:15:34,0,0,0,神！无需多言，平时分基本给满，防止大家卡绩
220862,755,卜凯,2025-06-20 07:28:33,0,0,0,kg就是神
220873,755,卜凯,2025-06-20 08:47:12,2,3,1,计院唯一真神\n\n\n\n99分拿下大学最高成绩
220875,755,卜凯,2025-06-20 08:48:52,0,0,0,对学生真的好，处处为你着想的那种\n\n\n\n给分也很好，会把平时分拉满让你绩点上一个台阶\n\n\n\n选到就是赚到
220977,755,卜凯,2025-06-20 14:06:12,0,0,0,神中神中神
229,770,胡敏,2015-03-14 17:13:22,4,16,12,C程讲的那叫一个条理清晰。。。
686,770,胡敏,2015-03-15 11:58:59,19,27,8,挺好的，很耐心地处理同学们的问题！
2156,770,胡敏,2015-04-03 04:03:53,50,65,15,很喜欢提问
2248,770,胡敏,2015-04-13 16:11:54,-3,7,10,不怎样，讲重要的事时总讲不清楚
2309,770,胡敏,2015-04-19 11:56:52,30,43,13,条理有些不清
3734,770,胡敏,2015-06-17 02:50:36,18,24,6,讲的很耐心，但是不知道为什么每次她上课提问的时候总是怕怕的。气氛稍微沉闷，但是平心而论讲的还算透彻
3847,770,胡敏,2015-06-17 06:15:01,111,152,41,老师喜欢抽座位，我一个学期几乎每节课都坐在五十号座位，被叫了一个学期，每节课都点五十号，就一次五十号被人占了。。。然后那个人就被叫起来了
3951,770,胡敏,2015-06-17 11:00:46,2,4,2,这个你懂的，大家都会～
4144,770,胡敏,2015-06-18 02:00:50,13,15,2,讲得不错(づ ●─● )づ\n\n但是很喜欢抽座位，发邮件给她都会回答的
4331,770,胡敏,2015-06-19 04:33:21,0,2,2,讲得不错，会点名\n\n
4397,770,胡敏,2019-08-19 05:22:16,26,39,13,优点:邮件提问都会回复。\n\n缺点:个人觉得C程讲知识点讲的并不太清楚。还有会提问座位号，回答不出来时不会给你台阶下的。
4771,770,胡敏,2015-06-28 08:55:26,-9,8,17,调理不清，对学生不够平等和尊重
4952,770,胡敏,2015-07-01 12:16:58,8,11,3,讲得并不是很差啊，6分的评分是不是太低了点。只是点座位回答问题不会点名。不过声音略尖，不是我的菜。
5013,770,胡敏,2015-07-02 04:48:21,4,9,5,很有耐心的好老师
5306,770,胡敏,2015-07-06 12:03:55,-1,5,6,呵呵呵呵
5693,770,胡敏,2015-07-09 07:17:01,43,59,16,平心而论，6分不公平，老师人挺好的，讲课调理也不错，有责任心会督促我们的感觉，只是感觉有点怕怕的，尤其点人，随堂考试感觉自己什么都不会，都是错的(´இ皿இ｀)
6282,770,胡敏,2015-07-12 15:14:30,7,10,3,好老师！会盯到你上课不敢水手机的！好好听课会收获很多。听了她的课以后爱上c了。
6385,770,胡敏,2015-07-13 12:25:18,1,7,6,讲课有重点
6738,770,胡敏,2015-07-20 07:54:26,-2,6,8,重点不清的感觉，有些东西反复说啊说的，有些重要的反而是大家都知道吧，不讲了。。。\n\n
7392,770,胡敏,2015-09-14 06:54:23,1,9,8,讲课没条理
9014,770,胡敏,2017-06-05 09:29:55,57,67,10,其实单个知识点讲的不错，就是整体没条理，而且不知道她为什么有种自己讲的很慢的错觉……
9075,770,胡敏,2015-10-12 07:04:10,0,2,2,爱点名
9532,770,胡敏,2015-10-29 08:25:19,0,13,13,她会很认真地回复同学的邮件，我向她反映了大计基考试的不公平现象后她说会向上级反映。估计以后考试不会再有人抽到原题了
9544,770,胡敏,2015-10-29 16:35:13,1,1,0,抽座位问问题
10381,770,胡敏,2015-11-18 10:25:24,8,12,4,好玩 老师并没有看起来那么凶 但回答问题真的是惊心动魄！
10870,770,胡敏,2015-11-23 07:57:43,4,6,2,回答问题的时候很耐心，邮件都会回，讲的一般，总有种“这些你们肯定知道我还要讲啊”的感觉
11642,770,胡敏,2015-12-09 05:33:24,1,8,7,讲的有些凌乱
11776,770,胡敏,2015-12-15 06:06:08,-1,5,6,条理不清
13111,770,胡敏,2015-12-25 02:09:34,-1,6,7,数据库讲得条理不清。
13869,770,胡敏,2016-01-01 10:56:47,4,4,0,我重修给了97
14090,770,胡敏,2016-01-04 07:54:59,2,3,1,还不错，6分多略低
14373,770,胡敏,2016-01-06 14:22:05,3,5,2,很耐心，很棒
14591,770,胡敏,2016-01-08 01:57:14,0,5,5,数据库讲不清就不要用英文课件和课本了好吗？
14774,770,胡敏,2016-01-29 23:12:17,21,30,9,浙大良心啊，太负责了，感动！！！
14935,770,胡敏,2016-01-29 14:54:41,6,8,2,给分超级好！ 有耐心！ 每封邮件都会！ 超棒！
14947,770,胡敏,2016-01-11 07:35:24,-8,4,12,讲的混乱不堪\n\n
15672,770,胡敏,2016-01-24 01:49:46,0,0,0,还好啦
17178,770,胡敏,2016-01-19 23:53:41,6,8,2,很负责任很棒的老师
18643,770,胡敏,2016-01-22 07:45:11,-1,2,3,太慢了
19136,770,胡敏,2016-01-23 10:21:24,3,4,1,老师看起来有些严厉，让人怕，其实是很棒的～
19218,770,胡敏,2016-01-23 14:22:45,20,27,7,大计基可以逃课……我觉得给分很好，考试略难但成绩好得意外。老师人也很可爱啊，不存在为难同学。
19222,770,胡敏,2016-01-23 14:38:01,5,6,1,蛮好的
19300,770,胡敏,2016-01-23 23:58:49,28,32,4,老师很负责很认真好不好！！！能感觉出来她对学生的负责与认真！这是我的第一个跟计算机有关的老师，能遇到这样一个慈祥与严厉并包的老师，感谢都来不及好不好！！！
19589,770,胡敏,2016-01-25 00:40:21,-5,3,8,讲课不是很好，跟不上。其他还不错。
20100,770,胡敏,2016-01-26 05:34:26,1,1,0,虽然上课不太听得懂但给分不错
20342,770,胡敏,2016-01-27 05:24:06,35,43,8,老师挺好，不过常常以为我们都懂了
20616,770,胡敏,2016-01-29 04:47:09,0,4,4,上课没太听懂过，可能是自己总是水手机没有好好听课，不过大计基最后突击的，给了90分还不错哦
20681,770,胡敏,2016-01-29 16:24:33,-24,5,29,垃圾老师我给零分
20682,770,胡敏,2016-01-29 16:34:24,1,2,1,给分还不错
20742,770,胡敏,2016-01-30 16:45:56,3,4,1,棒棒哒 每次发邮件问老师问题 回复都很即时且都很中肯
20775,770,胡敏,2016-01-31 10:24:21,-4,3,7,呵呵呵
20883,770,胡敏,2016-02-03 01:41:49,19,20,1,老师上课是会提问，但是只要在听课就答的上来，而且仔细听听大机基也挺有意思的也不难。老师很认真，迷之喜感，课间会放万万没想到
21042,770,胡敏,2016-02-13 07:08:08,1,2,1,给分好，点名有点可怕
21563,770,胡敏,2016-03-01 05:06:22,1,1,0,还不错吧
22010,770,胡敏,2016-03-02 05:47:18,2,2,0,喜欢点座位号提问。
22368,770,胡敏,2016-03-04 03:02:57,-14,5,19,给分好 讲的烂
22590,770,胡敏,2016-03-08 08:35:27,1,2,1,给分真的好
23004,770,胡敏,2016-03-16 03:38:36,6,8,2,我只想说姓肖的助教很好
23349,770,胡敏,2016-03-25 13:47:44,2,6,4,其实挺好的，看你自己努不努力了，除了经常叫错名字，反正最后满绩。
23560,770,胡敏,2016-04-06 09:43:41,18,22,4,认真听的话收获很大 不认真的话会很尴尬
23894,770,胡敏,2016-07-06 01:46:31,7,9,2,我去年是她的大计基，今年退了预制课选了她的c程。
25329,770,胡敏,2016-05-15 04:36:39,12,16,4,胡老师是我很喜欢的老师，人很可爱，下课会放视频给我们看，一般是万万没想到，给分也不错，不会点名，只是点座位，尤其感动的是会学期开始就督促告诉我们该怎么学习，大一选了大计基，大二选了数据库给分都不错也很有收获！
25524,770,胡敏,2016-05-24 11:23:52,6,7,1,提问很多  一定要认真听
26665,770,胡敏,2016-06-21 00:18:26,6,7,1,的确挺好的呀
27932,770,胡敏,2016-06-28 06:00:28,3,4,1,老师会抽座位，讲课还是可以，但总感觉某些地方老师的表达却不够清晰，可能对于完完全全的小白来说听懂课有一些难度。
28403,770,胡敏,2016-06-28 08:50:50,4,5,1,被点到的时候想哭，又想看别人被点起来问问题。上课的时候很需要动脑，谁知道下一个点的是不是你，哈哈哈哈。被点起来要是不会就说不会也可以。
28754,770,胡敏,2016-06-28 13:59:42,0,3,3,呵呵呵
28756,770,胡敏,2016-06-28 14:00:31,3,3,0,挺负责任的老师，虽然经常按座位号点人回答问题，上课不懂就可以直接问，老师直接解答。就是声音有点尖。
28787,770,胡敏,2016-06-28 15:10:46,8,9,1,老师挺好的，挺认真的，c程课听得超认真，助教也很棒！
29685,770,胡敏,2016-06-30 07:38:16,15,18,3,老师讲课不错的，会主动督促你好好学习，这点就很棒。讲课有自己的条理，为了让同学们能更好理解，当然有时候速度稍微有点快，不过能接受。我感觉提问很有助于我们主动学习啊，虽然每次都是有点怕怕的，但是老师很好的，答疑也超耐心，平时也很幽默
30575,770,胡敏,2016-07-02 03:59:13,5,8,3,c程上课抽座位是很有趣的事情，当然前提是自己不被抽到。老师讲的很认真，也很关心我们的学习情况，挺好的。
30619,770,胡敏,2016-07-02 05:18:18,4,4,0,等成绩ing，紧张
31400,770,胡敏,2016-07-04 00:46:05,3,3,0,还不错
31573,770,胡敏,2016-07-04 06:44:14,12,12,0,虽然还没出成绩但还是想说老师挺负责的。就算成绩不是很好也蛮感谢老师的  毕竟是自己的问题。
32092,770,胡敏,2016-07-05 14:57:45,5,6,1,好好好好好好
32104,770,胡敏,2016-07-05 15:37:35,12,16,4,真的是难得一见的好老师哦，一直关注每一个同学的情况，教的东西也很实用对考试帮助很大。私下里也很有亲和力亦师亦友！！助教也有趣超级学霸还经常水群开玩笑总之很棒的老师和助教。
32126,770,胡敏,2016-07-05 16:28:15,6,7,1,棒棒的老师！人超级好！
32182,770,胡敏,2016-07-06 01:39:50,4,5,1,老师挺好的，讲课很细致
32374,770,胡敏,2016-07-06 10:08:24,4,4,0,很爱讲sizeof！\n\n
33280,770,胡敏,2016-09-17 16:07:45,7,9,2,C程强烈推荐  几乎每节课都会讲考试难点和易错点  把这些掌握理论考应该没有太大问题 94分飘过
33564,770,胡敏,2016-09-20 06:27:31,3,4,1,客观，真诚，亲切的老师
34266,770,胡敏,2016-09-29 09:59:53,1,3,2,虽然上课无聊，但是很和蔼啊，课间还放视频
34935,770,胡敏,2016-10-26 17:04:51,-2,3,5,对小白很没耐心
35064,770,胡敏,2016-11-01 06:20:56,-2,2,4,人不错 但是讲课有点讲不清楚 拎不清重点
35067,770,胡敏,2016-11-01 06:54:19,19,22,3,万万没想到╭(°A°`)╮
36355,770,胡敏,2016-11-12 07:31:27,64,74,10,万万没想到，啦啦啦啦啦！
38245,770,胡敏,2016-12-19 06:24:35,-3,2,5,数据库讲课 太太太抽象了
38466,770,胡敏,2016-12-06 04:32:01,20,21,1,51号座位同学！
38766,770,胡敏,2016-12-18 12:56:36,4,5,1,老师人很好，很温暖\n\n
38803,770,胡敏,2016-12-19 06:18:37,-5,4,9,我评了1分
38973,770,胡敏,2016-12-20 06:36:05,-1,4,5,条理不清，跳的快
39291,770,胡敏,2016-12-22 03:22:02,3,3,0,认真吧！
40624,770,胡敏,2017-01-04 10:50:51,2,3,1,讲的还可以的
40756,770,胡敏,2017-01-05 08:45:57,11,12,1,最后一次上她的课了，老师真的很有耐心很负责哇，怪自己平时不认真听课现在只好开天地了。下个学期是她的c，立flag一定要认真听课
43209,770,胡敏,2017-01-16 03:41:02,15,17,2,来浙大以后，目前为止我最爱的老师，没有之一，明明是我的程设老师，在半夜十二点也能为我大计基答疑....太感动了！而且很认真很负责，对每个学生很关心。虽然成绩还没有出来，?也不影响我对老师的爱！
43304,770,胡敏,2017-01-16 06:14:44,1,2,1,教的感觉一般，老师很难听懂学生要表达的问题的意思。
43469,770,胡敏,2017-01-22 00:28:52,6,7,1,老师很好啊，听不懂的话，老师会在在群里给同学们答疑，给分也超级棒
44289,770,胡敏,2017-01-17 14:19:10,4,4,0,老师上课前会开点窗，细心懂生活，课间还放万万没想到
44374,770,胡敏,2017-01-17 16:20:28,7,9,2,满了听说要来感谢一下老师qaq，每次上课都是都对万万没想到记忆深刻。
44522,770,胡敏,2017-01-18 02:20:22,6,7,1,非常好\n\n
46026,770,胡敏,2017-01-20 12:16:16,11,11,0,C小程\n\n上机课可以不去\n\n老师课间喜欢放万万没想到\n\n凌晨2点不睡觉 怕是在码代码\n\n很有计院风范
46229,770,胡敏,2017-01-21 03:24:44,4,4,0,人挺好的，喜欢叫座位号，不会回答问题也不会把你怎么样。
46472,770,胡敏,2017-01-22 00:23:24,0,1,1,上课虽然听不懂给分却如此好感动
46478,770,胡敏,2017-01-22 00:34:37,1,1,0,一点：打分好！！！
46488,770,胡敏,2017-01-22 01:06:10,13,13,0,老师其实很温柔啊给分也很棒  助教超可爱超认真
46494,770,胡敏,2017-01-22 01:12:49,0,0,0,迷迷糊糊但是不错
46495,770,胡敏,2017-01-22 01:13:13,8,8,0,上的大计基。讲真认真听的话会有收获吧，老师会划重点，划重点！！别的老师似乎都没有的样子呢。而且是真重点噢。因此选上胡敏老师就请珍惜吧，考试周会感受到美好的。以及，平时事情相对少，期末给分相对好，总之我是很感恩啦。祝超nice的老师新年超happy～
46505,770,胡敏,2017-07-07 05:17:10,7,8,1,想起高中化学老师上课问问题的感觉\n\n但认真听，都是不错的\n\n怪我平时没好好练上机实验\n\n唉:-(
46548,770,胡敏,2017-01-22 02:35:08,6,6,0,老师很温和很细心，给分超棒！但喜欢抽座位有点紧张??
46589,770,胡敏,2017-01-22 03:25:58,6,9,3,非常好，程设和大计基都是这个老师，一门满绩一门4.8
46802,770,胡敏,2017-01-22 10:57:18,9,9,0,老师很好，特别是助教，超级好
47055,770,胡敏,2017-01-23 12:00:42,17,18,1,老师给分挺好，就是讲得快了点(尽管她自认为讲的挺慢的)。很耐心，认真。至于抽座位，个人认为没什么大不了的，干吗那么恐惧啊！回答不出也不必尴尬。
47402,770,胡敏,2017-01-26 04:50:53,15,16,1,老师有时严格但上课真心负责，良心好老师，感谢！
47474,770,胡敏,2017-03-22 09:24:59,5,6,1,上过wcm的课什么老师都是10分！
48033,770,胡敏,2017-02-28 05:57:22,5,5,0,大计基讲的进程有点慢，给分不错，知识点讲的也很全面。
48046,770,胡敏,2017-02-28 06:21:01,-7,2,9,呵呵呵
48579,770,胡敏,2017-03-07 16:34:45,10,10,0,真的特别感谢老师，在课表爆炸的学期，课后没有多少时间练习的情况下，完全是靠老师上课梳理的易错点
48795,770,胡敏,2017-03-13 06:38:47,-1,4,5,特别喜欢上课提问，抽座位号，几分钟甚至几十秒抽一次…但讲得很好，认真听收获会很大
52297,770,胡敏,2017-06-18 02:40:04,-4,3,7,感觉上课讲不太清楚 大计基还是靠考前突击 会讲重点 给分好
52764,770,胡敏,2017-06-22 15:20:32,10,10,0,老师讲课条理很清晰，很有意思，就是上课提问有种自己上了假c程的感觉，顺便表白主角小姐姐～超认真的，问她问题很快会回复。
54086,770,胡敏,2017-06-28 12:09:57,4,4,0,做好课前预习是有机会享受课堂的，课件放的短视频很搞笑
55286,770,胡敏,2017-07-01 08:12:34,14,14,0,助教很漂亮hhh
55961,770,胡敏,2017-07-02 22:26:57,7,7,0,老师课上的真好，虽然看上去有点凶，但是却很关心学生的
57016,770,胡敏,2017-07-05 07:28:55,10,12,2,数据库\n\n\n\n讲得很清楚，会课后讨论，对学生很包容，答疑很详细邮箱也会回很及时。\n\n\n\n非常好，很友善，很推荐。(⁎⁍̴̛ᴗ⁍̴̛⁎)
57372,770,胡敏,2017-07-07 04:38:03,16,17,1,老师讲课很好，ummmmmm虽然我没有认真听，但是随手记下的笔记都十分有用。上课喜欢抽座位回答问题，每次都跟上战场一样，但题目都非常经典。最后的给分也很好。力荐!
57591,770,胡敏,2017-07-10 09:04:02,4,5,1,虽然上课听不怎么懂，但是老师人挺好的，给分也非常良心。
59068,770,胡敏,2017-09-19 09:58:07,14,14,0,非常负责，非常想让学生过的讲的很细致，我是重修的，上学期沈睿的，我觉得胡老师更适合我，上了第一次课就来给10分了
61012,770,胡敏,2017-11-07 02:47:33,3,3,0,万万没想到，50号座位同学请回答。
63661,770,胡敏,2017-12-12 02:45:54,18,21,3,我觉得这个老师究极好，上课速度不是很慢，但每个人都跟的上。教室的话筒时好时坏，老师会问不用话筒后排能否听清。而且作业系统一直开着，上机不去也可以。一些很细的知识点理得很清楚，课上的问题也很深刻。我打满分。\n\n
64486,770,胡敏,2017-12-24 12:51:59,12,14,2,现在才知道能选上您的课是我的福气
65637,770,胡敏,2018-01-08 02:44:26,11,12,1,万万没想到，感觉还不错，比自己自习学起来快，哈哈哈
66239,770,胡敏,2018-01-14 02:34:43,9,10,1,讲的十分请楚，好老师，不解释。
66551,770,胡敏,2018-01-17 08:34:57,7,7,0,就……挺好的老师，不过总是以为我们都懂了的样子。
66573,770,胡敏,2018-01-17 10:11:43,5,7,2,挺好的老师，会提问
66981,770,胡敏,2018-01-19 13:55:24,9,9,0,很喜欢老师讲的课，略显严肃但超负责
71548,770,胡敏,2018-01-28 15:14:17,-2,1,3,
71650,770,胡敏,2018-01-28 23:54:25,19,19,0,万万没想到，胡老师这么好
71841,770,胡敏,2018-01-29 04:22:15,10,10,0,万万没想到，拯救了我这个菜鸡
71929,770,胡敏,2018-01-29 06:04:04,11,11,0,表白助教小哥哥，太暖了！！！胡老师讲课条理很清晰，语速适中，强推！！！
71970,770,胡敏,2018-01-29 07:07:48,12,12,0,很好的老师，给分很好啊，不点名，很随和风趣。下课还给我们看视频，除了上课点座位号回答问题惊心动魄。哈哈哈，真的是好老师啊，很负责，每次作业、考试都会很细心很贴心的提醒同学注意事项。真心希望每个学生好，不仅仅关心学生的程设，会像班主任一样叮嘱学生好好学习每门课程。
71974,770,胡敏,2018-01-29 07:12:04,-9,6,15,上课还行   主要看自学\n\n满绩飘过～～～
72640,770,胡敏,2018-01-30 15:06:51,6,6,0,老师很仔细
72682,770,胡敏,2018-01-31 00:59:41,9,9,0,上课好，负责任，给分高，力挺！
73408,770,胡敏,2018-02-01 13:56:41,2,7,5,老师给分很不错 人很好 但是上课有点乱 没有条理 主要靠自学
73465,770,胡敏,2018-02-01 15:07:24,1,6,5,老师讲课逻辑是有些问题，但是还是个很可爱很细心很慈祥的老师！万万没想到给分也不差～
74429,770,胡敏,2018-02-22 11:54:33,8,8,0,过年给大家发红包的老师，你见过吗
75337,770,胡敏,2018-03-09 03:50:16,6,8,2,我是重修的上了第一次课就来给10分的那个人， 告诉大家我这次过了 而且成绩还行，大概是当时第一次课就有老师这么好应该能过的预感吧。胡老师和助教哥哥暖哭 ，机考前还在答疑，胡老师还在问我机考能不能过，助教哥哥全程在线帮我答疑，这次能过全靠他们的认真负责！真的强推！良心老师良心助教
75516,770,胡敏,2018-03-13 01:56:39,1,3,2,很负责，教给学生很多
75866,770,胡敏,2018-03-20 08:18:36,-15,6,21,无话可说，上课后在所有人面前把我赶了出来，呵呵呵。。。。。本来都坐在了第一排，由于不是她的学生，直接叫我走。。。本来是看她的评分高来上她的课，没想到被叫了出来，重点是那个班还有人认识我。。人都气死了！！！
76016,770,胡敏,2018-03-24 09:45:40,8,9,1,上学期胡老师的C小程，老师讲的很细致，课间还会放小视频给我们看。还有线上线下都超级超级超级耐心暖心的助教小哥哥。给胡老师打call ，给小哥哥打call~
76157,770,胡敏,2018-03-28 05:09:50,3,3,0,四十四号！
76527,770,胡敏,2018-04-12 09:19:14,-16,6,22,在浙第一个想打一分的老师 上课费话巨多态度极差 不知道是不是欠你了呵呵
78660,770,胡敏,2018-05-14 08:46:32,9,10,1,我叫王大锤，今年十八岁
79112,770,胡敏,2018-05-23 07:28:01,2,5,3,人挺好的，但是讲课是真的不行……
79934,770,胡敏,2018-06-15 11:38:28,0,0,0,万万没想到～～
80335,770,胡敏,2018-06-25 08:18:38,4,4,0,C程 周一78节\n\n上完最后一节课来评价的，还没有考试\n\n开学初我其实是想换老师的，毕竟当时老师的评分真的低而且点座位回答问题好像蛮恐怖的\n\n后来发现其实老师上课挺好的，提问的话，如果你真的在认真听课的话平心而论不算很难，大多数应该都是可以回答得上来的。思考时间对我来说稍微短了一点点（大概这个问题对大佬是不存在的吧），回答错问题确实是不太给面子，但是老师并不会为难你。\n\n上课的话我觉得讲得不能说快吧，但是经常会觉得说自己刚讲过的内容同学们都掌握了（虽说她也经常问大家懂没懂但大家都不理老师），一个学期下来没有很赶也没有提前很多上完课。上课内容很充实，会讲一些不太会注意的小知识，认真听真的会有意料之外的收获。有问题上课直接问，她也会耐心回答。\n\n另外，助教老师人超级好，希望老师可以给他加鸡腿ヽ(*・ω・)ﾉ
82470,770,胡敏,2018-07-08 09:30:24,1,1,0,虽然C程还没考，但是先给老师10分！老师很和蔼呀，助教小哥哥也超好的！
82828,770,胡敏,2018-07-09 07:48:53,2,2,0,最爱的老师没有之一，起码没让我觉得c程是个负担
83299,770,胡敏,2018-07-10 04:59:09,0,0,0,很负责任啦，虽然考的不太理想，但真的满足了。
83389,770,胡敏,2018-07-10 07:53:57,1,1,0,万万没想到，啦啦啦啦啦
84587,770,胡敏,2018-07-13 08:49:36,2,2,0,就冲老师期中期末都给复习资料的份上，能不给10分吗？每次遇到其他老师班里同学，他们都对c程老师还会给复习资料感到了诧异和羡慕。我有少量（真的只是少量）的编程基础，期中期末都是跟着老师给的题翻了一遍书，理论就能拿90%的分。很幸运上了老师的课。
84802,770,胡敏,2018-07-14 02:03:43,0,0,0,虽然上课抽人吧但是觉得老师还是很好的给各种复习资料啊给分也很好
84815,770,胡敏,2018-07-14 02:33:50,2,2,0,各方面都好！！！
84818,770,胡敏,2018-07-14 02:35:49,1,1,0,老师是个负责的好老师，会给我们放万万没想到。上课条例是有些不清晰，但是会给很多例题助于理解。上课会叫位置提问，曾经被连续叫到（一脸懵逼）。给分也不差，毕竟我后期的pta都是百度的。另外，她让我看到了程序媛的有趣灵魂。
84819,770,胡敏,2018-07-14 02:37:15,0,0,0,这老师给分超级好，真的。
84825,770,胡敏,2018-07-14 02:56:24,-1,1,2,给分超级好！！
84843,770,胡敏,2018-07-14 04:29:27,-2,1,3,一般般
84845,770,胡敏,2018-07-14 04:50:32,2,2,0,啊啊啊啊，老师给分超公正。期末的分还高了啊啊啊，期末编程因为有bug只写出了一题，绩点居然还能上4，谢谢老师!
84857,770,胡敏,2018-07-14 05:41:30,-3,1,4,人很好，给分很好，但是有一些知识点讲的有点绕。
84993,770,胡敏,2018-07-15 02:04:59,2,2,0,计科是跟老师上的，收荻还是蛮大的，C程继续跟老师学，绩点4.8，真心觉得老师棒棒的，C程讲得特清楚，每次都跟着老师的讲课顺序，完成作业都没问题，助教也超暖，好喜欢，虽然老师平时挺严肃的，上课会抽位回答问题，但习惯了觉得也没啥，平时只要提问，老师都特别耐心回答，给老师打call，给助教打call。
85033,770,胡敏,2018-07-15 04:59:49,1,2,1,老师人超级好，讲的也很好
85791,770,胡敏,2018-08-10 12:12:25,6,7,1,老师非常负责，大计基和C程都选了她的，结果就是看了两遍《万万没想到》?
86439,770,胡敏,2018-09-16 06:46:23,2,2,0,老师真好\n\n
87408,770,胡敏,2018-09-29 06:09:25,0,0,0,老师挺可爱。有个同学现在还没有来，就把他做掉。。
87462,770,胡敏,2018-09-29 06:08:08,8,8,0,你见过为了学生去和后勤处理论的老师吗，10分不解释
87475,770,胡敏,2018-09-29 08:40:28,0,1,1,一定要集中注意力啊
87945,770,胡敏,2018-10-18 09:55:15,0,0,0,还不错。
88270,770,胡敏,2018-10-25 08:45:25,4,5,1,感觉老师人很好呀，很温柔体贴，下课的时候给我们看小视频（*＾ワ＾*）
91682,770,胡敏,2018-12-18 01:46:36,2,2,0,很可爱，可惜我太菜，不是很懂，师强我渣
92228,770,胡敏,2018-12-27 06:35:59,3,4,1,自学很重要，带着一个简单的框架再听课会好很多
92992,770,胡敏,2019-01-06 16:00:01,6,6,0,我一定要在期末考和出成绩以前来评论一下，老师真的无敌温柔，人非常好，作业也少。本学期遇到最温柔的老师。
93556,770,胡敏,2019-01-10 10:42:29,4,4,0,10分，不解释！
93689,770,胡敏,2019-01-11 16:09:16,6,6,0,老师真的超级负责任啊，真的很把学生放在心上，平常群里也会亲自答疑，回复很快。很多注意事项也会多次强调，还会准备很多自主练习的题目，超级有用啊！真的很棒！
94022,770,胡敏,2019-01-15 02:34:28,4,4,0,太好了＼(^▽^)／
94025,770,胡敏,2019-01-15 02:53:13,4,6,2,人是不错，认真负责，课间还会放万万没想到。但是讲课跳跃，有点没条理，而且莫名的非常看得起学生，觉得我们都会了。（计算机科学基础
95960,770,胡敏,2019-01-20 09:31:30,5,5,0,老师人很好呀
96589,770,胡敏,2019-01-21 07:00:35,8,8,0,考前评论大计基。课前一定要预习，不然跟听天书一样。一个学期上完干货满满的一本书本来就很赶，老师不会慢下来保证每个人都懂。老师很好很好，在群里像个年轻人，经常群答疑，还会提醒我们很多注意事项。我这学期十二门课，胡敏老师的大计基是唯一一门在结课时全教室响起掌声的。
97704,770,胡敏,2019-01-22 13:51:55,5,5,0,不管成绩怎么样，趁着现在成绩没出来，先打10分，就算被绩杀，我也不会改，就是10分不解释
97965,770,胡敏,2019-01-23 02:48:54,4,4,0,10分.老师挺好，很和蔼，认真负责，最喜欢在群里说：这位同学是不是没有来上课呀。考试有点难，但是没过主要是自己的问题，考试前两天考试学真的啃不下这么多内容。
99059,770,胡敏,2019-01-24 08:03:35,2,2,0,好老师\n\n我基本上一个学期没太认真听\n\n靠她的复习题和书本复习\n\n感觉很有效果\n\n考前她答疑时看起来很疲倦\n\n但还是在网上坚持到了十二点\n\n真挺感动的
101225,770,胡敏,2019-01-28 02:22:38,3,4,1,老师很认真负责，又暖心，最喜欢看她在课上笑和那种看着我们恨铁不成钢的样子，最喜欢说：这我不是讲过了嘛？你们都不说话就是默认了。真的很可爱，谢谢老师！！！
101708,770,胡敏,2019-01-29 02:03:08,3,3,0,没出成绩之前先给老师10分，我承认老师上课很好，都是干货是，我自己不努力，老师很关心学生，都会有及时答疑。真的是个好老师，你值得拥有
101810,770,胡敏,2019-01-29 07:05:12,3,3,0,C程。老师讲得不错，不会点名，唯一一次小测当点名。\n\n只是...这个老师好像忘记出分了
101812,770,胡敏,2019-01-29 07:18:17,5,5,0,说老师不好的 我第一个不服 之前查老师看了评论还觉得很慌怕老师不好 可是老师真的很和蔼可亲 除了会diss你问一些上课反复讲的东西 除此之外无可挑剔好吗 只要最后好好准备了 分数不会很差的 总结来说 就是    万万没想到
101815,770,胡敏,2019-01-29 07:20:57,4,4,0,老师人超好！！！
101817,770,胡敏,2019-01-29 07:24:21,8,8,0,感觉我遇到的老师都是特别特别特别关心学生的好老师。胡敏老师平常的课上充满干货（但自己的基础原因实在有点费解），平常在群里问问题@她基本都会回答，在做综合报告的时候还和老师交流了大作业的选题问题，老师非常认真的帮我剖析了选题的利弊。真的非常好的老师。平时按照要求把平时作业完成，考前把认真书看了一遍，把网站练习重新做了一遍（只要上课认真听这些也不用做了），最后出分4.8感谢老师，祝老师新年快乐
101819,770,胡敏,2019-01-29 07:29:04,4,5,1,老师讲的很好，上大基计也会愿意听，平时作业不多，从不点名，会很耐心解答，之前周末同学有问题，老师也会一直在群里解答，真的超级好的一个老师。最后给分超级好，老师真的很好。
101839,770,胡敏,2019-01-29 08:44:53,8,8,0,我永远爱胡老师！！虽然我被卡绩了呜呜呜呜呜胡老师真的好温柔好?️?️！！真的是有魅力的计算机院老师呜呜呜..
101869,770,胡敏,2019-01-29 10:29:47,8,8,0,非常好的老师！！！
102142,770,胡敏,2019-01-30 16:13:24,7,7,0,老师很温柔人超好问问题回答很详细爱她！
102154,770,胡敏,2019-01-31 00:07:24,-7,3,10,不值。
102185,770,胡敏,2019-01-31 08:00:41,4,4,0,很好的老师
102669,770,胡敏,2019-02-18 16:29:47,16,17,1,虽然挂了，还是给10分。因为没挂过科，什么都不懂，老师还是认认真真回答了我的关于补考申请的问题，还特意为我开了个计科账号，延后了题库关闭时间，让我准备补考时有题可啃。真的，大一渣渣表示很暖(T ^ T)要补考了，祝我这次能过
102815,770,胡敏,2019-02-23 13:16:08,1,2,1,，，，
103065,770,胡敏,2019-02-26 00:52:06,4,5,1,很务实，有科研精神，从不扯淡
103134,770,胡敏,2019-02-26 06:23:40,-6,1,7,不谈了djj满了
104034,770,胡敏,2019-03-11 01:03:11,6,7,1,好啊啊
104495,770,胡敏,2019-03-21 15:53:58,13,14,1,万万没想到，啦啦啦啦啦\n\n老师超可爱
104701,770,胡敏,2019-07-06 20:25:21,-4,8,12,我们那场理论比较难，本来以为很差的成绩居然被老师捞了，只能打10分为敬了
105631,770,胡敏,2019-04-17 13:12:49,10,11,1,很喜欢。易错点会细讲。会告诉我们有用的道理❤️
109181,770,胡敏,2019-06-11 07:45:33,14,15,1,大学以来感觉最关心学生的老师，超级暖
110337,770,胡敏,2019-06-25 16:36:37,5,6,1,nice\n\n
110421,770,胡敏,2019-06-26 13:51:12,6,7,1,很关心学生啊
111005,770,胡敏,2019-06-29 05:41:44,7,8,1,剧爆炸好，上学期是她的课，反正很可爱的一个老师
111179,770,胡敏,2019-06-30 10:35:08,5,7,2,老师很好，无论是上课还是答疑都很认真，上课还会讲一些理论的易错点，还会给一些理论题，很有用，跟着老师一学期下来我学到了很多，终于把C程给过了，感谢老师！（确实会抽座位啊，上课还是好好听课吧～）
111188,770,胡敏,2019-06-30 12:14:40,4,5,1,一个极其有耐心的老师
111199,770,胡敏,2019-06-30 13:41:32,3,5,2,C程：胡敏老师真的好可爱呀(//∇//)上得贼好！超级善良！理论易错点讲得很清楚！大家都要来上课呀！
111723,770,胡敏,2019-07-02 16:13:08,4,6,2,老师真的很耐心细致！也好温柔！（感觉老师年轻的时候是个大美人
112457,770,胡敏,2019-07-04 08:52:33,3,5,2,究极无敌好老师o(^o^)o
112555,770,胡敏,2019-07-04 17:38:37,-1,0,1,。。。
112597,770,胡敏,2019-07-04 22:00:24,-3,1,4,程设感觉老师讲课内容和考试重点偏差有点大，而且期末考试的很多细节没有涉及过，老师人很好。
112921,770,胡敏,2019-07-05 11:06:47,3,3,0,好好好\n\n\n\n
113430,770,胡敏,2019-07-06 17:17:59,-2,0,2,人格魅力满分，讲课一般，应该会调分的，期末理论69分，结果绩点4.5。
113453,770,胡敏,2019-07-06 17:31:03,-4,0,4,老师很可爱，虽然我上课从来不听，但每节课课间都会放万万没想到，作为白客的小迷妹，真的是很开心啦⊙▽⊙ but看到最新评论有点小不爽，毕竟我理论77，实验题差两分满分，然而老师只给了我4.2，哭哭(´;︵;`)
113524,770,胡敏,2019-07-06 22:51:46,1,2,1,老师讲的简单清楚\n\n作业还很少\n\n给分也是女神\n\n似乎还有一颗少女心\n\n(小白平时老师的课一定要听，因为老师平时不布置理论作业，考前再耐心把书看一遍理论就没问题了)
113585,770,胡敏,2019-07-07 00:32:13,0,1,1,老师好可爱！！
113683,770,胡敏,2019-07-07 03:52:06,2,2,0,万万没想到，啦啦啦啦啦
113708,770,胡敏,2019-07-07 05:19:12,1,1,0,考完出来就知道应该要挂了，分数挺低的被救回来了，? ? ? 谢谢老师
113928,770,胡敏,2019-07-08 01:02:11,2,2,0,本来是卡绩的分数（差了0.8），老师硬生生给提上去了！第一个让我没有被卡绩的老师！撒花?
114025,770,胡敏,2019-07-08 11:15:36,1,1,0,虽然c程被卡了，但是老师很可爱
115278,770,胡敏,2019-07-17 10:22:07,-6,2,8,我与你无仇无怨，为什么要挂我，对你有什么好处
115511,770,胡敏,2019-07-30 15:14:54,0,1,1,楼下理论77的那个有算过自己分数吗？4.2不应该是平时分已经给你满了?你还想怎样？
117001,770,胡敏,2019-09-18 05:50:51,3,3,0,非常和蔼，而且能照顾到不同水平的同学
118710,770,胡敏,2019-10-31 02:53:48,-3,3,6,有耐心，但讲课超级没有条理，听完以后一头雾水，给我一种计科比微积分还难的感觉。平常喜欢点名回答问题，气氛非常压抑。她总是有 一种我们都理解了的感觉，但其实一问，会的举手的寥寥无几。不管最终分数怎么样，授课过程真的差。
120069,770,胡敏,2019-11-17 09:50:51,3,3,0,我我我真的很喜欢这种优雅的中年女教师！！讲课很细致很清楚，还会在群里分享资料，课后还会留下来答疑，好老师！
120714,770,胡敏,2020-01-15 19:27:56,1,1,0,很厉害
126412,770,胡敏,2020-09-25 07:19:16,0,0,0,细心温柔，分数也比预想中的好，大赞。
129415,770,胡敏,2021-01-05 06:44:17,2,2,0,有点搞不懂你们，老师把课表内容都讲完了，甚至还拓展了不少内容，虽然是C基础，但是也激发我们学习课外的内容，不得不说，其实C很深的，每个常用语句的具体特点有仔细去网上看吗。而且题也给够，我也不是那种特别用功的，期末考试前就只是把给的电子截屏、理论题刷完，编程题、课本都没有看，最后好像97还是多少，理论多刷，编程多去debug
247,776,陈实,2015-03-14 18:06:38,4,6,2,没什么体验，她就没怎么来上课
1257,776,陈实,2015-03-21 17:06:56,17,19,2,很水。老师本身也没什么水平。
6372,776,陈实,2015-07-13 09:44:59,11,12,1,烂，水。
6760,776,陈实,2015-07-22 02:55:43,-15,1,16,老师很负责任的
15613,776,陈实,2016-01-15 17:50:15,4,4,0,呵呵。
22037,776,陈实,2016-03-02 06:38:41,14,15,1,大水母，无趣，耽误学生
23127,776,陈实,2016-03-18 12:39:15,1,1,0,ejdcjfjencjkf
23738,776,陈实,2016-04-14 06:06:52,3,3,0,没话说
36560,776,陈实,2016-11-15 01:36:40,8,11,3,无语，老师讲课好像什么都很陌生，还硬装，装你去死，作业还多，就会瞎搞事情！
37850,776,陈实,2016-11-27 07:17:48,4,5,1,辣鸡?\n\n
38269,776,陈实,2017-01-11 08:35:25,3,3,0,很水的课
39145,776,陈实,2016-12-21 10:51:56,3,3,0,这个老师很迷，会给外系打很低的分数
43922,776,陈实,2017-01-20 03:45:48,11,13,2,只能说用了整个学期没弄明白立体构成是个什么玩意，有点浪费时间，不建议系外的人选，我也真不知道这老师凭什么给分，是自己主观的想法吗，总之水分比较大，这应该是一门手工课，老师知识也很稀薄，试问老师，您是否有认真对待过这门课程？您是否认真对待过这门课程的学生？您是否在这门课程上享受过做老师的快乐？
50875,776,陈实,2017-05-07 16:50:41,4,4,0,要知道，陈实至少是认真备过课的呀～
56976,776,陈实,2017-07-05 05:24:25,2,3,1,好呀挺好呀
66305,776,陈实,2018-01-15 03:40:02,8,9,1,说实话每次上这个人的课都在好奇她这种人是怎么进浙大教书的
79052,776,陈实,2018-05-21 14:21:30,-2,4,6,因为老师强调不要熬夜，我觉得老师挺好的。然后画画么，水平这方面我不好说，因为自己也没有orz。但是在她的课上，我画的是开心的....就是高兴画什么就画什么，我很快乐.orz
81211,776,陈实,2018-07-04 09:49:17,6,7,1,三大构成最水的老师...给分比较随意
94849,776,陈实,2019-01-18 10:15:50,2,2,0,我感觉老师没有很差呀？课后也会很用心的跟我们聊一些人生问题，还给我们一节课去看展，虽然上课内容有那么点水，但是老师人还是很好的，嗯
98906,776,陈实,2019-01-24 04:58:08,3,3,0,没啥感觉\n\n给分比其他专业课老师都低
103777,776,陈实,2019-03-05 11:39:35,2,2,0,别的不知道无法评价 但是真的教课给分大水母
104364,776,陈实,2019-03-19 01:08:44,2,4,2,老师蛮温柔的啊，对学生还是很好的~~~
105402,776,陈实,2019-04-11 16:42:58,7,8,1,美甲一定做得不错。
114088,776,陈实,2019-07-08 19:24:53,2,2,0,没啥好说的，反正我不知道她的评判标准是啥
134656,776,陈实,2021-04-08 01:01:16,2,2,0,大水怪 读ppt。
191506,776,陈实,2024-04-24 04:11:33,0,0,0,求您别教课了
196793,776,陈实,2024-07-06 06:51:12,0,1,1,老师还是很好说话的
201498,776,陈实,2024-11-04 02:27:35,2,2,0,太🐮🐴了
203867,776,陈实,2024-11-21 15:30:39,0,3,3,真以为自己是什么狗屁艺术家\n\n有看到这条评论的，它死的那一天，你打我电话19012770986，我请你吃饭（如果不方便我可以V你50）
208675,776,陈实,2024-12-30 16:40:55,2,2,0,老师温柔漂亮好说话，水粉功底挺强的
70258,802,林怀忠,2018-01-26 10:03:55,13,14,1,虽然选的点名，其实也只有一节课，老师随机点名起来回答问题而已。给分很好，不是很难，开给非计院的同学的，会有大作业，自己做一个数据库系统，也不是很难，看到自己自学新的语言做出来这样一个系统真的很有成就感！可能是自己比较菜，做了一个星期，有的大佬只用了一天，总之看到自己做出的大作业还是很有成就感的，对于我来说真的学到了很多。期末考试也考得比较基础，认真学是可以拿高分的。从上课来看，老师讲课也很清楚，很多细节点，老师一提出来就有种“哦⊙∀⊙！原来如此”的感觉，讲得清楚明白，有提问的老师也会很耐心地回答，当然几乎每个老师都会认真回答的。给老师点赞！
73375,802,林怀忠,2018-02-01 12:45:21,1,2,1,还不错嘛
85179,802,林怀忠,2018-07-16 02:05:07,0,1,1,感谢老师TAT老师人真的特别好！
103930,802,林怀忠,2019-03-07 11:33:31,-4,1,5,助教很好看哦
113931,802,林怀忠,2019-07-08 01:20:32,1,2,1,老师给分真的很好！人也很好！
138867,802,林怀忠,2021-07-11 11:41:36,0,0,0,数据库原理对我来说陌生的概念还是蛮多的，所以有时候课上听老师讲课会有些糊涂；但是过了一遍书再听智云的时候发现老师讲的其实很有条理。
153924,802,林怀忠,2022-06-29 04:06:59,12,12,0,上的沟通技巧，怎么能做到每次课都拖堂的，另外给分很烂
153930,802,林怀忠,2022-05-17 05:21:42,8,9,1,沟通技巧次次拖堂，这也就算了，还留个20分钟讨论作业自己拍拍屁股就走了
154711,802,林怀忠,2022-06-04 05:12:01,16,17,1,数据库我没上过，但上沟通技巧真的很离谱。\n\n讲课内容基本就是念wk的ppt，次次拖堂，作业布置时间不合理，这些我都忍了，给分还很烂，我朋友wk班基本都是给满的。\n\n讲一件事，11:25下课，布置一个11:50交，评价43页毕业设计的作业真的合适吗，草草看完报告还剩六分钟，匆忙提交了八点给我打了个低分。虽然后来延期到了14:05，可你至少也告诉我们一下延期，好让我们去完善一下啊，闷声不响延期，还是在中午，我们大部分人期间又有课，根本不可能去关注他ddl有没有推迟。\n\n整体来说，这个老师给分是大大不如wk的，我问了问我身边的同学，他们基本上获得的均分都是90-92左右。\n\n其次一点，最后做ppt展示，这个老师是让每个人都做一个ppt（问室友他上的wk的课，一个组做一个PPT展示12分钟不用拍视频），还必须要拍六分钟全身出镜的展示视频，在大二下匆忙要寄的考试周，许多大作业的压力下，我们还要借场地找设备拍视频，现在我就是在写PPT的过程中破防，来评价这个老师的。\n\n真的很离谱，希望他是最后一次教这门课，看到下面学长们的评价，我想老师应该在讲授知识型课程上应该更有能力，知识更渊博。老师对迟到也很宽容，有时他抽同学上台分享，同学迟到，后来同学到了找他他也会让同学重新展示，不记过。
154781,802,林怀忠,2022-06-05 07:43:53,10,11,1,沟通技巧本是一门用时间换个成绩的水课\n\n在您手里， 完成基本要求是75， 好一点是80， 是吗?
157432,802,林怀忠,2022-07-01 03:31:09,17,17,0,沟通技巧事多拖堂分少\n\n更新：出分了，班里一个满绩的都没有。我对此的评价是，lhz，狗都不选。\n\n再更新：分数上调了两分，只能说最后能改就好。。。
157500,802,林怀忠,2022-06-23 12:44:12,2,2,0,沟通技巧真的离谱。
158171,802,林怀忠,2022-06-27 09:45:22,3,4,1,数据库系统原理，随堂练习有点多，最后大作业要多花一些时间，期末考考得还是比较基础的，给分不错
158193,802,林怀忠,2022-06-27 11:47:04,1,2,1,数据库系统原理给分很好\n\n助教人也很nice
158346,802,林怀忠,2022-06-28 13:19:02,4,5,1,阿sir 沟通技巧有点离谱的哦 最好改一改
158387,802,林怀忠,2022-06-29 02:22:59,11,13,2,最让我们难过的事情是，基本上付出同样的甚至是更多的努力，我们与另一个班的同学最终的成绩相差甚远。平时分满分60，最高的一个也57，大部分都掉在了55以下，期末成绩在我客观题全对的情况下拿了80出头（客观题也做得很认真，至少不应该扣这么多分，我wk班上的同学大部分都是90+）。最后总成绩最高全班七十个人没一个满绩的，隔壁班几乎是全员满绩，这本来是一门用时间换满绩，不需要什么脑子的水课，最后变成了用时间自讨没趣。\n\n如果考试是我自己的问题，那也罢了，平时，不合理的作业时间安排，比同学互评还低的教师评分，考试周期间依然要做的个人视频，上课时次次拖堂，讨论时间安排在课后15min...\n\n事情更多，给分更烂，名为沟通技巧，这个老师自己也不太会说话，如果能不选，就不要选吧，我估计这个老师也是赶鸭子上架，因为选这门课的人太多，被迫另外开的。\n\n希望他不要再教。
158392,802,林怀忠,2022-06-29 02:49:52,-1,2,3,上的数据库，讲的清楚，学到很多，给分也好
158398,802,林怀忠,2022-06-29 03:52:17,5,5,0,给分也太差了吧 班里一个满绩的都没有
158403,802,林怀忠,2022-06-29 04:18:55,1,1,0,给分太差
158430,802,林怀忠,2022-06-29 07:56:52,0,1,1,沟通技巧太逆天了，全班一个满绩都没有，事还多得要死，互评环境极差
158655,802,林怀忠,2022-07-01 04:13:04,2,2,0,沟通技巧平时分确实不太行，不过最好出成绩调分了，老师还是不错的，给10分
174968,802,林怀忠,2023-06-20 13:07:48,-9,2,11,给老师的计算机系统原理课打满分
175662,802,林怀忠,2023-06-26 05:44:40,8,11,3,教考分离试点课程捏
175696,802,林怀忠,2023-06-26 08:16:08,5,5,0,还未出分，但感觉今年的数据库考试比之前难度大很多，之前据说大部分人都提前交卷，但今年一个也没有
175716,802,林怀忠,2023-06-26 09:46:24,6,6,0,计算机系统原理，老师人很好，讲课还行，无奈期末考试和教的没什么关系，建议刷历年卷
175762,802,林怀忠,2023-06-26 12:27:40,-2,1,3,数据库上的不错，课程轻松，考试时候看不懂题老师也会解答
176954,802,林怀忠,2023-07-01 00:58:25,-4,3,7,言之无物，给分极差，慎选
176970,802,林怀忠,2023-07-01 02:18:46,-7,4,11,原以为会是计原之光，结果是楼sir2.0，远称他们两个为卧龙凤雏
176975,802,林怀忠,2023-07-01 02:29:55,15,15,0,计原出分来评，老师感觉知识很渊博讲课比较有条理，给分也很好，薄纱隔壁楼sir。只是今年的题是楼sir出的，还得面向楼sir复习
177058,802,林怀忠,2023-07-01 10:44:06,12,12,0,计算机系统原理，60%平时分，40%期末，老师平时会有随堂的限时小测，算平时分，也算是一种点名吧。\n\n林老师今年第一次开这门课，平时上课就是照着PPT讲课，感觉是正常水平，今年的期末考试和上课讲的东西关联不太大，更多还是楼sir原来的题目，可能也是两个老师一起出题的缘故。期末考试整体的体验非常糟糕，因为有几道题目上课几乎没有提到。\n\n平时的作业就是课本上的题目，然后有一个mips模拟器的大作业，中规中矩，比楼sir的奇怪作业肯定是好很多的。\n\n给分上评论有点两极分化，我个人觉得给分超级无敌好（可能是期末被大家冲了一波之后，酌情给分的缘故），但是同样有同学觉得很苛刻给分不好。\n\n平时分方面，每次作业都会在学在浙大上评分，分数构成很细致清楚，我觉得不错，但也有同学觉得平时分烂掉了，猜测是大作业组队队友没找好。\n\n总体而言，计原这门课我推荐能选的话尽量选林老师，体验会比楼sir的好一些。
177344,802,林怀忠,2023-07-03 03:23:03,6,6,0,老师，下次你本人出所有题吧，别让楼sir出了，楼sir自有一套
177557,802,林怀忠,2023-07-03 16:20:49,2,3,1,计原非常非常捞，讲课不太行
177956,802,林怀忠,2023-07-05 18:46:36,-18,3,21,计原没满的踩我
185874,802,林怀忠,2024-01-05 06:46:46,4,5,1,林老师的计原真的很好，平时任务很少，作业很正常，就是书后习题，大作业mips模拟器三人组队，只要找到了不太摆的队友最后给分都是不错的，平时问问题答疑非常有耐心，人非常和蔼，讲课也是很不错的，并不是照着ppt念，会讲一些自己的东西，如果一直跟着听是可以对知识掌握的很好的，总之，林老师的计原真的值得你选！！！
186235,802,林怀忠,2024-01-10 02:48:51,4,5,1,考完答一波，lhz完全不点名，平时60分课堂小测（每次1-2道题）+大作业也很透明，这学期考试好像是他出的（风格不像楼sir），比历年卷偏难，但确实很多东西在ppt上，认真听课应该是能考好的
187331,802,林怀忠,2024-01-15 13:20:43,3,5,2,23~24秋冬 计原满了来答。老师人很好，讲课很有条理很清楚，考前对着ppt复习效果很好(今年卷子不像楼sir出的像林老师ppt的风格)。任务就是一个组队的MIPS大程，上课经常有点名性质的小测(但是不去教室只要按时在学在浙大答了也没事)，作业题就是每周3题左右的书上课后题。一学期好好学能收获很多！谢谢老师！！！lhz计原之光！！！
187342,802,林怀忠,2024-01-15 13:52:36,-3,2,5,期末考出的非常好，平时任务不多还不点名，大作业很正常，给分很好。但是讲得不算特别好。
201921,802,林怀忠,2024-11-07 11:37:08,1,2,1,计算机原理\n\n\n\n挺好的，就是语速比较慢+早八催眠，下课去问问题答疑也很细致\n\n\n\n适合倍速看智云，下课问题 的学法（至少我是这样\n\n\n\n给个10
203509,802,林怀忠,2024-11-22 03:09:36,0,0,0,手机塞前列腺里了？一周掏不出一次看钉钉？邮件也不读？
203520,802,林怀忠,2024-11-20 02:34:02,0,1,1,傻逼，你随机分nm的组呢？小组三个人跑路而且其中两个汽修了还不说一声，直接搞的剩下一个人单干，而且这种情况下还不许重新组队，还强行要求单干。你咋不把你秦孖拉出来单干呢？
208834,802,林怀忠,2025-01-02 10:34:23,7,7,0,lhz爷爷用计原击落软工学生
209590,802,林怀忠,2025-01-06 10:12:37,5,6,1,我觉得老师的计原讲挺好的\n\n课下去问问题老师也回答很认真\n\n10
210004,802,林怀忠,2025-01-08 01:24:14,7,10,3,讲课还行，给分太差了，平时分差，考试闭卷难考得差就占60%，有计原这门课软工的学生有了。接近每周一次的一道随堂小测没做出来总评直接-1，作业也很严苛没写对总评就扣分。绩杀但也没得选了，软工的学生默哀吧~
210009,802,林怀忠,2025-01-08 01:57:51,0,5,5,还不错，至少考的东西都是讲的东西
210010,802,林怀忠,2025-01-08 02:04:11,0,5,5,讲课中规中矩，给分相当不错（期末会捞人的）
210023,802,林怀忠,2025-01-08 02:35:44,0,4,4,事少分高，感觉终于不是烂课了
210594,802,林怀忠,2025-01-09 11:47:07,0,2,2,老师人确实挺好的，但是改了期末考试的内容，出题风格和楼sir差别很大。但是现在网上只能找到很久以前的历年卷，所以期末考的东西基本不会，如果可以的话，希望老师给一个历年卷性质的资料出来，有助于学生把握复习方向。
260,835,潘肖煜,2015-03-14 23:30:47,30,39,9,上过她的大计基，讲得比较细致，但是大计基本身不是很有趣，所以显得无聊，给分感觉还不错，尚可。
945,835,潘肖煜,2015-03-20 02:45:08,97,108,11,她的Java讲的很好。只要认真听，肯定没问题。
1571,835,潘肖煜,2015-03-22 15:32:33,0,0,0,讲得细致
4681,835,潘肖煜,2015-06-26 04:45:34,3,5,2,虽然讲的有点快 但认真学给分一定好
5244,835,潘肖煜,2015-07-06 03:32:41,-11,6,17,不知所云
5796,835,潘肖煜,2015-07-09 11:37:50,15,16,1,讲的很细致，java只要认真听就能懂
5867,835,潘肖煜,2015-07-09 15:55:34,37,42,5,潘老师讲课特别认真细致 课堂内容很充实 答疑很积极。真的是位好老师
6284,835,潘肖煜,2015-07-12 15:50:43,1,1,0,棒棒嗒
6354,835,潘肖煜,2015-07-13 07:49:20,1,1,0,上课很不错，会强调重点，人很好
8874,835,潘肖煜,2015-09-29 06:55:26,-6,3,9,太快，云里雾里的
9229,835,潘肖煜,2015-10-18 09:35:29,-27,6,33,垃圾，讲课不知道在讲什么
11093,835,潘肖煜,2015-11-24 06:14:40,-27,3,30,太烂了
11956,835,潘肖煜,2015-12-21 11:32:47,-22,3,25,上课还是别听了，真无语
12097,835,潘肖煜,2015-12-21 23:25:00,3,3,0,老师很亲切 就是语速快
12883,835,潘肖煜,2015-12-24 07:20:05,30,42,12,老师本身懂的东西很多，但是说得太快，好像想一次性讲完所有，来不及消化，上的是她的大计基，有个好处是她的作业是开放地址的，不用一定去机房，很好说话的
13908,835,潘肖煜,2016-01-02 07:38:36,3,3,0,蹭了大半学期潘老师的大计基，不得不说还是很有帮助的。
14233,835,潘肖煜,2016-01-05 13:33:43,3,3,0,老师讲的特别细致，人很温和特别能体谅我们，非常棒！值得推荐！
14537,835,潘肖煜,2016-01-07 13:06:41,1,1,0,好好好
15210,835,潘肖煜,2017-08-07 13:09:42,27,32,5,老师本人很好，但大计基是门异常无聊的课
15229,835,潘肖煜,2016-01-13 01:53:34,1,1,0,好老师！！！
15243,835,潘肖煜,2019-06-30 14:00:34,4,6,2,挺好的，大鸡鸡很认真，讲得细但是有点快。
18820,835,潘肖煜,2016-01-22 15:03:53,5,9,4,老师上课很认真细致，有时还会拓宽下知识面，虽然大计机可本身还是蛮枯燥的
18873,835,潘肖煜,2016-01-22 16:06:02,3,3,0,大计基讲的很全面的。就是有口头禅听着很别扭听不进去。老师还是很负责的打分也不错，好人一枚
18991,835,潘肖煜,2016-01-23 02:13:41,4,5,1,讲的不错，就是整堂课感觉老师一直沉浸在自己的世界里
19560,835,潘肖煜,2016-01-24 16:34:51,1,1,0,老师讲的很全，十分细致。
20334,835,潘肖煜,2016-01-27 04:48:31,0,4,4,给分好差
21086,835,潘肖煜,2016-02-16 08:44:53,-10,3,13,讲的很慢很容易理解，但操作题……微坑
21202,835,潘肖煜,2016-02-26 07:17:02,3,4,1,大计基讲得飞起，爱拖课，给分貌似不错 \n\n
21260,835,潘肖煜,2016-02-27 15:14:21,-11,6,17,口音重  比较死板  主要靠自学  给分……伤心一定要按时交作业做测试  无情面可讲
22040,835,潘肖煜,2016-03-02 06:48:05,-2,1,3,讲课有点快，ppt很仔细，但还是没有白洪欢有意思\n\n
22066,835,潘肖煜,2016-03-02 08:38:06,17,19,2,对不对啊\n\n233333
23054,835,潘肖煜,2019-10-31 07:23:09,20,23,3,助教帅
25668,835,潘肖煜,2016-06-01 06:11:03,0,1,1,超级棒，老师讲课十分紧凑，跟着听能学到很多东西
26714,835,潘肖煜,2016-06-21 03:16:37,0,1,1,语速快 但讲得好
26811,835,潘肖煜,2016-06-21 07:07:12,1,2,1,无意间蹭了一节课！超级认真啊上的 我们沈钦仙考前什么都不讲?
26813,835,潘肖煜,2016-06-21 07:14:24,0,1,1,老师很好 会给很多资料 讲的也很细致 认真听Java肯定没问题的
27647,835,潘肖煜,2016-06-27 06:32:59,29,32,3,非常好的老师，java讲的认真仔细，非常负责。语速很快，干净利落，三节课保持高度集中的精力，下课五分钟还是照常，一上课马上进入节奏，真的非常好啊！上课还会有蜜汁萌点，强推！！！
27808,835,潘肖煜,2016-06-27 16:00:56,0,3,3,java讲得真心不错，认真听躺过。
28931,835,潘肖煜,2016-06-29 03:45:50,3,3,0,java讲的很详细，老师很有耐心，只要自己想学好，上课认真听，课后题认真做，就没问题
30668,835,潘肖煜,2016-07-02 07:29:18,-3,0,3,java讲得很清楚
31693,835,潘肖煜,2016-07-04 13:32:36,-3,1,4,好老师\n\n
31718,835,潘肖煜,2016-07-04 14:56:08,2,2,0,真的是好老师，超级喜欢，高效率，讲的好，又容易理解，跟着她走感觉很安心，收获很大。
31787,835,潘肖煜,2016-07-05 02:17:20,2,2,0,真的很好，讲的好，给分也棒，java强推
31797,835,潘肖煜,2016-07-05 02:34:31,3,3,0,老师讲的很好  口头禅什么的习惯就好
31809,835,潘肖煜,2016-07-05 02:47:00,0,1,1,老师讲得很不错 很安心的感觉 认真学肯定分数不错
31813,835,潘肖煜,2016-07-05 02:58:19,0,1,1,老师超级好(๑≧∀≦๑)！！！
31823,835,潘肖煜,2016-07-05 03:16:27,2,2,0,很清楚
31843,835,潘肖煜,2016-07-05 04:03:16,0,1,1,老师人好  上课效率高 java强推
31900,835,潘肖煜,2016-07-05 06:21:01,17,20,3,java满绩，谢谢她讲得非常细致。
32001,835,潘肖煜,2016-07-05 10:53:50,-3,0,3,讲的很细且有逻辑，认真听课就不难
32025,835,潘肖煜,2016-07-05 11:44:54,0,1,1,老师很耐心 讲得很清楚 给分可以
32065,835,潘肖煜,2016-07-05 14:06:50,0,0,0,上课从来没没有废话，讲的很快，也很清楚，会强调重点，给分也还好
32344,835,潘肖煜,2016-07-06 07:45:12,-6,1,7,哎哎哎啊
32399,835,潘肖煜,2016-07-06 13:10:14,0,0,0,老师讲得很好 但我自己考得不好 可能自己努力不够吧 不怪老师
33389,835,潘肖煜,2016-09-19 04:18:41,0,0,0,很认真的老师
34505,835,潘肖煜,2016-10-12 06:36:16,4,4,0,对不对～对不对～\n\n
34512,835,潘肖煜,2017-03-07 02:54:06,4,4,0,哦哟。，
34894,835,潘肖煜,2016-10-26 08:58:13,7,9,2,什么啊～的话呢～哈哈哈不开玩笑了，别睡好好学就没问题
36668,835,潘肖煜,2016-11-15 09:17:56,2,3,1,老师人不错，就是大计基太无聊
38680,835,潘肖煜,2016-12-14 08:38:24,0,1,1,享受，讲的很好，不是很枯燥
40239,835,潘肖煜,2016-12-30 12:37:28,2,2,0,潘老师java讲得真好
43160,835,潘肖煜,2017-01-16 01:28:13,7,8,1,一开始听不是很习惯，有口头禅加上语速太快...下午上课容易困...但是老师人很好！作业不用必须去机房，也会提醒我们补交～
45187,835,潘肖煜,2017-01-19 06:20:55,10,12,2,今年考的如此的难但老师仍以最大努力帮助学生了
45188,835,潘肖煜,2017-01-19 06:23:42,5,6,1,老师很棒！
45452,835,潘肖煜,2017-01-19 14:41:04,1,2,1,课上得太快了，不过大计基这还是靠自学的。老师人好的，作业不多，认真完成，考试前背一下书，还是不错的。
45779,835,潘肖煜,2017-01-20 05:20:31,-8,7,15,满绩啦满绩啦 真的是好老师 考试把题库刷一遍就没问题了
45842,835,潘肖煜,2017-01-20 07:12:41,5,5,0,JAVA程序设计她讲得很细致，重点突出，如果认真听一定没问题，当然平时翘课也是没问题的，没点过名，但是可能期末就惨了。平时不要偷懒，期末会不错的
45859,835,潘肖煜,2017-01-20 07:39:58,2,2,0,java真的好，认真听没问题
45883,835,潘肖煜,2017-01-20 08:17:51,-4,0,4,挺无聊的，不过成绩还好
46199,835,潘肖煜,2017-01-21 02:01:01,1,1,0,老师上课特别细致，但大计基真的还是要靠自己好好学啦
47662,835,潘肖煜,2017-02-15 04:12:51,4,5,1,作业好像是按规定布置的，不过大计基这门课事就是比较多，老师讲的真心细，考前还会开放资料，给分我觉得老师还是不错的，成绩高低与个人关系也挺大吧
48864,835,潘肖煜,2017-03-15 04:54:24,7,9,2,给分巨好
49340,835,潘肖煜,2017-04-06 06:47:58,8,9,1,助教哥哥好帅哇！我喜欢你！
50783,835,潘肖煜,2017-05-05 09:21:41,5,5,0,java讲的非常细致，好老师
51209,835,潘肖煜,2017-05-24 06:28:07,5,6,1,语速快，适应以后就可以好好听了
52724,835,潘肖煜,2017-07-07 15:15:58,5,8,3,谢谢老师的99!
55524,835,潘肖煜,2017-07-01 23:22:40,5,5,0,翘了一节课的java，结果之后就再也没听懂过，orz天呐 ，事实告诉我：一定要认真听啊
57106,835,潘肖煜,2017-07-05 14:15:21,18,20,2,老师超级超级好，有点口头禅习惯了就好，上过大计基给分不错，就把c退了选了她的java（我不会说这是我上过妹子最多的一节课了），超级细致，学得很容易，考试那天还答疑到12:30连饭也没吃，超认真，重点给分超好啊（助教也超帅。。。我是男的）
57116,835,潘肖煜,2017-07-05 14:36:58,4,5,1,哈哈哈哈军训第一天最好的消息大概就是java满?了！ 老师上课很细致，上课认真听，作业做了，考前再过一遍书，就能拿到好成绩的。
57152,835,潘肖煜,2017-07-05 23:37:25,5,7,2,很棒的老师 上课讲的特别清楚 零基础也能学到很多 每次作业认真做考试肯定没问题的 给分也很棒
59143,835,潘肖煜,2017-09-20 02:36:51,3,4,1,老师很漂亮\n\n
59407,835,潘肖煜,2017-09-21 07:20:28,3,8,5,她的Java讲的真的很好，总之我满绩了，你呢
64438,835,潘肖煜,2017-12-23 15:27:10,5,5,0,大计基，有一个十分显著的特点是老师几乎不在qq群里说话，虽然群主是老师，这使课下交流不便。
65415,835,潘肖煜,2018-01-03 17:29:49,1,1,0,老师超好，无奈大计基课程本身太有毒，还是给老师满啦。
71737,835,潘肖煜,2018-01-29 02:17:13,3,3,0,java课基本没去几次还是满了 老师讲的还算仔细吧 无点名无小测作业量一般
71874,835,潘肖煜,2018-01-29 05:01:21,1,2,1,讲课讲太快了 跟不上\n\n复习花了很多时间 最后给分依然惨
72010,835,潘肖煜,2018-01-29 08:03:35,0,0,0,老师很认真
72015,835,潘肖煜,2018-01-29 08:09:52,0,0,0,老师讲课很清晰，讲作业也很明确
72031,835,潘肖煜,2018-01-29 08:38:37,-1,2,3,上课好好听，作业好好做，复习的时候把ppt认真看，计基拿高分不难的。我最后差一分满绩
72041,835,潘肖煜,2018-01-29 08:47:31,3,3,0,老师讲的不错，给分也还行。就是卡绩有点难受。。。
72218,835,潘肖煜,2018-01-29 14:43:00,1,1,0,。。。
72463,835,潘肖煜,2018-01-30 07:10:32,2,2,0,好老师！
72810,835,潘肖煜,2018-01-31 06:06:51,2,3,1,实验作业可以自己在寝室做还蛮好的，其余……全靠自学啦！
73494,835,潘肖煜,2018-02-01 16:56:28,5,5,0,卡绩真难受\n\n
74259,835,潘肖煜,2018-02-08 07:06:00,5,5,0,我也是上了她的大计基以后退掉c选了她的java。讲课速度偏快，但是清晰。ppt做的很棒，对复习很有帮助。作业布置特别人性化，不注重形式，效果达到就行，允许在自己电脑上做。
75219,835,潘肖煜,2018-03-08 05:16:36,1,2,1,心态爆炸
81925,835,潘肖煜,2018-07-06 13:23:15,3,3,0,感觉java真的是我这个学期上的课中的一股清流了，真的爱上java了，也是因为老师这么好，每次听老师上课就很享受！
82205,835,潘肖煜,2018-07-12 17:04:56,5,5,0,真的好老师，上机实验随时随地可以做，上课虽然节奏略快，但是不至于跟不上，最最最重要的一点，ppt无解，我没有见过这么好的ppt，知识点简洁凝练同时覆盖面广，整个排版也赏心悦目。对学生负责，好老师当之无愧
82420,835,潘肖煜,2018-07-08 06:50:34,1,1,0,毕竟Java博大精深，但是这门课基本只要求面向过程，且这方面的难度略低于c程。
82911,835,潘肖煜,2018-07-09 09:54:00,-4,0,4,大计基着实无聊，但是老师讲得比较细致。不过最后我也不知道怎么就3.6了。
84086,835,潘肖煜,2018-07-12 03:44:02,1,1,0,很棒！讲课详细易懂，认真负责的好老师。
84113,835,潘肖煜,2018-07-12 04:45:11,0,1,1,人生中第一门满绩，感谢老师！
84130,835,潘肖煜,2018-07-12 05:54:07,0,0,0,上课认真听一定能学好
84244,835,潘肖煜,2018-07-12 10:26:31,0,0,0,干货满满，超多收获，有问必答，细心负责。大学很少遇到讲课如此争分夺秒的老师了，然后出分后群里都在说没想到自己这么高（包括我）
84257,835,潘肖煜,2018-07-12 11:08:47,0,2,2,我要谢谢老师和助教！！！自己的计算机基础怎么样还是有点数的，但是老师讲得非常非常好，助教也会帮忙解答问题。本来以为要挂科的结果差一分满绩！\n\n最最最最最最感谢的还是我的室友A.J.K，比十个助教都厉害！！！！！！！
84269,835,潘肖煜,2018-07-12 11:46:42,4,5,1,大计基和Java都是潘老师的课，老师特别温柔，而且最舒服的是实验作业都不强制在机房做。不过讲课语速略快，我不太跟得上节奏。考试我觉得还是比较反映真实水平吧，我这种上课不是特别认真靠课后自学的，拿4.2就觉得差不多了:D
84514,835,潘肖煜,2018-07-13 04:37:44,0,1,1,老师上课讲得很细，只要认真听考试不复习也问题不大，实验作业只要认真做就一定能考好。
86873,835,潘肖煜,2018-09-19 06:41:33,6,7,1,对不对ei~
92066,835,潘肖煜,2018-12-26 00:09:08,4,6,2,大计基本来就比较无聊吧\n\n老师讲课，我睡觉(/∇＼*)\n\n口头禅:的话呢，\n\n双绞线的话呢，有两种类型……\n\n所以一般的话呢，局域网的话呢，一般用网线～\n\n同轴电缆的话呢，分成两种，一种的话呢，是……\n\n老师的知识储备很多，讲的也很详细（曾经上课手把手教怎么用Word）
92070,835,潘肖煜,2018-12-26 00:46:39,5,6,1,我们的“的话呢”小姐，讲得很快很好，“对不对啊”
93288,835,潘肖煜,2019-01-09 00:39:38,4,5,1,老师大计基讲的很清楚，每节课前都会对上一节课内容进行复习。实验基本上都会先给大家讲一下。经常会看到老师在麦斯威买咖啡，买学霸餐，老师辛苦啦～老师人真的很好：）
93355,835,潘肖煜,2019-01-09 06:46:01,27,28,1,这位老师的话呢，讲课的话呢，挺详细明了的话呢，但是的话呢，她在JAVA课上的话呢，有个口头禅的话呢，就是每说一句的话呢，都要加上无数个的话呢
100494,835,潘肖煜,2019-01-26 08:01:15,-1,1,2,相当和蔼，作业量也不大。考前稍微背了下书，最后拿了4.8，蟹蟹老师！
100506,835,潘肖煜,2019-01-26 08:16:27,-3,2,5,挺好的，不过上机全做了，感觉理论也都会。只有4.5是咋回事呀？
100537,835,潘肖煜,2019-01-26 09:14:12,3,3,0,老师超好啊！大计基讲得很详细，偶尔一本正经开个玩笑，ppt也归纳得很好，还不用写小论文！当然个人觉得，大计基课本身就没法上得特别有意思(老师这样就很好
100566,835,潘肖煜,2019-01-26 10:08:12,6,7,1,没怎么听课，感谢老师不挂之恩。
100590,835,潘肖煜,2019-01-26 11:10:37,2,2,0,超级温柔好说话的老师！
100598,835,潘肖煜,2019-01-26 11:21:40,-23,2,25,老师的课事情很少，从没听过课，25号晚上考，25号白天看了一天最后4.8。这课闭着眼也能考好
100617,835,潘肖煜,2019-01-26 12:09:07,0,2,2,潘老师的ppt真的很细致 作为平常基本不听课 只做课后作业 期末看书和ppt的选手最后能拿4.5已经很满意了 而且还没有卡绩 就是偶尔听课的时候老师的口头禅真的很催眠……
100657,835,潘肖煜,2019-01-26 13:57:25,1,1,0,老师讲的挺好，给分也很好，就是这课…你懂的，大计课本来就很无聊。
100695,835,潘肖煜,2019-01-26 14:52:14,0,0,0,老师人很好，很想教更多东西给我们，有时就有点快，一般没有小测，作业要认真做，难一点的她会一步步讲解的，人很好。
100776,835,潘肖煜,2019-01-27 00:03:14,15,18,3,我就是来给个10分顺便表白沙雕计基群
100842,835,潘肖煜,2019-01-27 02:25:35,-2,2,4,潘老师超好!超级喜欢潘老师!\n\n平时基本没有小测!不点名!\n\n上课认真负责细致，PPT做的很好!\n\n最后4.8的? 点拉我均? ＠(￣-￣)＠
101007,835,潘肖煜,2019-01-27 09:00:49,5,6,1,Java上课不点名 没小测 老师人很好  给分也很好 最后满了
101496,835,潘肖煜,2019-01-28 10:10:12,-2,1,3,魔鬼大计基，我也不知道我的试卷为啥这么难，明明有好好复习，闲着无聊还是别选吧。\n\n
102320,835,潘肖煜,2019-02-01 01:48:15,0,0,0,java很不错，强推
102953,835,潘肖煜,2019-02-25 06:02:35,6,7,1,潘老师真的太棒了！！！尽心负责，感觉就像大姐姐一样，特别心疼她老是喝奶茶，但是讲的特别细，害怕我们听不懂，有时候有些小的代码码错，是一个特别可爱的体验，潘老师，希望以后多吃饭啊，别喝那么多奶茶了！还有，助教也是特别好！
109197,835,潘肖煜,2019-06-11 14:24:25,-3,0,3,无聊
109743,835,潘肖煜,2019-06-19 03:26:45,1,1,0,此用户没有填写评价，系统默认好评！
109784,835,潘肖煜,2019-06-19 07:34:06,2,2,0,上课上的很仔细知识点讲的很全面，期末会给实验考注意事项，非常棒的一个老师！
110008,835,潘肖煜,2019-06-21 06:13:40,0,1,1,讲得很好但是作业真的太多了，比别的老师题量大题目还难，考试周还布置一堆要算平时分的作业完全打乱复习节奏
111402,835,潘肖煜,2019-07-01 07:15:26,0,0,0,老师课上得很好\n\n我java差一道题我要哭了这么啊啊啊啊啊
112246,835,潘肖煜,2019-07-04 00:06:46,0,0,0,讲的不错 理论考好难啊 实验考比较水
112338,835,潘肖煜,2019-07-04 02:12:04,0,0,0,很不错
112397,835,潘肖煜,2019-07-04 04:02:18,3,3,0,老师java讲的很好 讲实验的时候非常通俗易懂 但是讲到理论知识的时候我就有点容易走神 听不太下去 最后没考好也是因为我四题实验题只做出来两题 理论也不怎么会 老师人是很好的 选上的不要退呀
112456,835,潘肖煜,2019-07-04 08:46:39,1,1,0,老师java课讲的很细很好，重点细节都会强调很多次，就是会有口头禅听多了就习惯了
112463,835,潘肖煜,2019-07-04 09:15:32,1,1,0,超级好的老师！！！讲的很细语速快！我就喜欢语速快的老师！上课不会睡觉！java教得很好！！
112814,835,潘肖煜,2019-07-05 03:54:45,0,0,0,真的好老师
121710,835,潘肖煜,2020-01-21 04:18:51,0,0,0,4.5大计基谢谢老师爱您
121730,835,潘肖煜,2020-01-21 08:54:32,1,1,0,讲的很细但是有些快，如果脑子转得比较慢就会有点吃亏，作业和我的室友的老师比多一点，但是课件和资料挺齐全的，老师给分也挺好（大机基
121760,835,潘肖煜,2020-01-21 17:44:51,0,0,0,上课有点快，作业有点多，讲课还不错
122279,835,潘肖煜,2020-02-22 08:03:39,1,2,1,大计基，本身这个课很无聊，其实老师讲的非常好，但是因为课的本身原因很容易睡着，到后来我就上课打斗地主了...4.2很满意，期末复习看课件+课本+题库就可以，基本不会挂
122439,835,潘肖煜,2020-02-27 12:28:44,1,2,1,大计基真的好老师上课非常细致拓展也很多会给我们减少负担没有奇怪又没用的作业这种老师我吹爆满了满了
125529,835,潘肖煜,2020-09-11 04:02:46,0,0,0,就很好
126062,835,潘肖煜,2020-09-17 04:05:37,3,3,0,java讲的很好
129518,835,潘肖煜,2021-01-06 14:08:50,3,5,2,老师事少，人好，不解释，只是这门课比较无趣，选她吧
132488,835,潘肖煜,2021-02-02 02:45:50,5,6,1,大计基 我有一次计科忘了做，期末考感觉也不好因为很多题背混了，出分前一直提心吊胆，但是分数真的好得完全没想到！！！！老师的PPT也很好很清楚，复习特别方便！！！！吹爆这样的老师！虽然大计基这门课真的很无聊，但是老师真的很好！！！！！！！！！！
132502,835,潘肖煜,2021-02-02 04:17:56,9,11,2,老师不点名，人很好，讲话虽然有点口头禅，但是口头禅的话呢，这样的话呢，也不是不可以接受，对不对？给分的话也很不错，讲课的话呢也很详细，作业的话呢也没乱七八糟的论文，可以说是非常的棒，10分！！！
132506,835,潘肖煜,2021-02-02 04:32:18,3,4,1,老师的话呢，不点名不小测，上课的话呢讲的挺仔细，但是我没听，给分的话呢，谢不挂之恩
132518,835,潘肖煜,2021-02-02 05:36:41,1,2,1,老师太棒了！
132527,835,潘肖煜,2021-02-02 06:09:11,-20,2,22,神仙老师！一次计科作业错过截止时间没交，期末考试一大半题目乱蒙，心惊胆战的以为自己要炸了。结果！4.8！这是什么神仙！
133211,835,潘肖煜,2021-02-18 04:04:05,0,1,1,大计基给分真的好，平时作业认真做，考前认真刷刷题库，不会太差
135634,835,潘肖煜,2021-05-17 12:05:29,5,5,0,老师讲JAVA非常清楚，值得选！！
137468,835,潘肖煜,2021-07-04 09:31:50,0,1,1,老师java讲得真的好 最后实验只搞对了一道是我自己的问题呜呜
141226,835,潘肖煜,2021-09-27 02:01:54,1,2,1,如果无法接受老师有严重的口头禅(意思是每句话都会说某些助词)，建议不要选
141580,835,潘肖煜,2021-10-15 12:34:02,0,1,1,大计基 讲课讲的永远比作业慢 作业也不讲 导致平时作业做的非常煎熬！！
141877,835,潘肖煜,2021-10-29 07:24:28,6,7,1,大计基A，老师上课不点名，平时讲课很仔细，实验题不用写实验报告，我感觉计算机实验都要实验报告的话就太离谱了吧（我室友就要写，很麻烦)，作业也很少，认真听课，作业都能做的。老师人很不错!
143108,835,潘肖煜,2021-11-19 04:46:20,1,2,1,楼上那位同学，你如果到计院的话就会觉得计算机实验要写报告不离谱了，啥实验都要写报告呜呜
146064,835,潘肖煜,2022-01-05 09:49:02,3,3,0,老师上课很仔细（虽然我都在睡觉）
149833,835,潘肖煜,2022-01-17 07:35:46,5,6,1,表白沙雕qq群和助教giegie
149834,835,潘肖煜,2022-01-17 07:35:47,4,4,0,表白沙雕qq群和助教giegie
149857,835,潘肖煜,2022-01-17 09:55:28,0,0,0,老师上课感觉有些紧张，不过讲的蛮清晰的，给发也贼好
154373,835,潘肖煜,2022-05-31 08:10:07,1,1,0,老师讲课很细致，这学期Java程序设计点了几次名。
154662,835,潘肖煜,2022-06-03 03:41:38,0,0,0,说话听不懂哇
156282,835,潘肖煜,2022-06-18 16:09:39,1,1,0,很少见到这么负责的老师了，选她绝对不会后悔
157066,835,潘肖煜,2022-06-21 22:47:37,0,0,0,老师上课感觉有些紧张，但总体还是蛮负责的，最后给分也很好
157776,835,潘肖煜,2022-06-24 20:00:12,4,5,1,是那种，很像以前高中讲课老师的那种了。相比于很多老师其实对自己讲的东西重点不清楚，老师能很有条理地帮你梳理知识，每节课也会做内容回顾。讲课的话，我给10分。也希望老师期末给我一个好的分数哇
157855,835,潘肖煜,2022-06-25 06:47:46,4,4,0,真的很有条理，难点也会反复讲，还会带着复习上节课的内容，棒！
158287,835,潘肖煜,2022-06-28 05:40:04,5,5,0,老师和助教还是很好的，但也务必认真对待每次小测和最后的期末考试，平时作业尽量独立完成，不然实验寄了那就是真的寄了。
158299,835,潘肖煜,2022-06-28 07:12:47,1,2,1,话不多说，好老师。
158448,835,潘肖煜,2022-06-29 10:24:58,0,1,1,老师讲课很好，还有很好的助教老师和答疑群。\n\n感觉改革了之后，java就没法捞了，给分很求是，认真对待每一次作业和小测叭～
158586,835,潘肖煜,2022-06-30 11:03:40,0,1,1,老师和助教都很好
158587,835,潘肖煜,2022-06-30 11:05:14,0,1,1,好耶！
164248,835,潘肖煜,2022-12-20 02:11:02,0,1,1,真的非常负责
164619,835,潘肖煜,2022-12-22 08:46:05,0,3,3,老师讲的非常好，认真负责，但钉钉上的消息百分之百已读不回（至少我的经历是这样），不知道说什么好，先做好心理准备。
164809,835,潘肖煜,2022-12-26 08:04:52,0,3,3,大计基，平时听得不多，全靠期末补天，因为大计基最后一门考，复习时间很充足，个人学下来感觉还行，然后老师人也不错，每节课好像会先复习，跟着老师上课听的话，收获应该也有不少
165161,835,潘肖煜,2022-12-29 12:28:40,3,6,3,吹爆潘潘！事少人好！上的是大计基，老师对待教学真的很上心，非常非常负责，讲的非常非常清楚易懂，上课会先复习上一讲内容再往下讲，听课效果很好，PPT简直就是神仙PPT，很清楚哇塞，作业布置的少而有条理，且而且这学期期末复习的时候其他老师班的会出现吐槽要写论文大计基复习不懂啥的，潘老师班的同学就很幸福。
165368,835,潘肖煜,2023-01-03 08:32:47,0,1,1,老师，菜菜，捞捞
166760,835,潘肖煜,2023-01-13 12:58:21,0,4,4,上课讲得比较快，最开始的几节课根本没听懂（也有可能是在下午比较困的原因吧）。\n\n本来对计算机完全不了解，上了计算机基础还是对计算机完全不了解。\n\noffice三个实验，内容不算少，pta上也有课后作业，不过这门课好像就是这样的。\n\n作业答疑什么的都是助教，老师在上完课后基本上就不在群里出现了。\n\n哦有一次上完课想问个问题，结果老师比我跑得还快。\n\n课不喜欢，老师总得来说还可以。
166929,835,潘肖煜,2023-01-14 09:00:50,-9,4,13,老师超好，事少分高！
166933,835,潘肖煜,2023-01-17 17:58:35,-37,13,50,你tm的全家死绝了，作业认真完成啦，每节课都仔细听了，最后绩点太tm感人，你吖的是个傻逼
166944,835,潘肖煜,2023-01-14 10:09:09,-9,3,12,事少且分高 老师私信会回 宝藏老师快冲！
167012,835,潘肖煜,2023-01-14 15:08:42,12,15,3,上过大计基，感觉作业都有交，期末考期中考也感觉还行，但是绩点很差，问了老师说平时分只有六十几，无语了，求是过头了吧。。而且平常钉钉给她发消息问问题也未读，无语死了。。
167296,835,潘肖煜,2023-01-15 12:05:36,9,10,1,给分不好
170337,835,潘肖煜,2023-03-03 02:49:20,9,10,1,给分真的差
170985,835,潘肖煜,2023-03-13 23:23:22,8,9,1,给分不好，大计基绩杀
175577,835,潘肖煜,2023-06-25 14:42:07,1,2,1,美丽！
177640,835,潘肖煜,2023-07-04 03:57:28,0,2,2,很不错的老师，很负责任，讲课细致，纯文科生java只要认真听课+运气不是太差 会有不错的分数的
185705,835,潘肖煜,2024-01-03 15:53:53,1,1,0,我的大计基不至于那么差叭……
186140,835,潘肖煜,2024-01-09 04:04:23,1,1,0,大计基考前祈福
186512,835,潘肖煜,2024-01-11 12:07:07,2,3,1,已读不回的老师，来个好评一星
189522,835,潘肖煜,2024-01-25 07:47:17,0,0,0,老师讲得挺好，今年djj绝对是bhh的锅
638,850,季江民,2015-03-15 09:28:02,4,7,3,人很好，但是一定要按时交作业
759,850,季江民,2015-03-16 11:40:17,7,11,4,很有资历的老师，讲课还可以吧，没有感觉很好的方面，但是也还不错。会有quiz之类的来变相点名
2965,850,季江民,2015-05-12 02:14:34,93,112,19,他是作为一个长者，每节课给我们传授一点人生的经验
3630,850,季江民,2015-06-17 01:54:55,-7,2,9,几乎每节课有quiz或者写一两道程序题。。。醉了；除此之外老师人不错
4855,850,季江民,2015-06-30 00:28:24,1,6,5,被翘了李峰的课来听课（详见李峰评论）老师人挺好，就喜欢讲故事的老师。
4858,850,季江民,2015-06-30 01:42:10,5,7,2,很好的老师，可能课比较麻烦，老师还是很好的
10367,850,季江民,2015-11-18 09:12:06,0,5,5,有点水
23852,850,季江民,2016-04-19 00:09:12,-1,2,3,老师讲的比较好
25270,850,季江民,2016-06-18 12:32:09,1,11,10,讲真，我觉得他的课不咋的，人老了上课讲得更多的是经验，丧失了教学的热情，这样课也比较无聊
25825,850,季江民,2016-06-10 06:45:14,-1,4,5,其实还是比较水的。
27072,850,季江民,2016-06-22 15:50:46,11,13,2,很和蔼 很可爱的老师 助教也很棒
28747,850,季江民,2016-06-28 13:52:00,14,15,1,老师人很好，会讲人生道理。助教也特别帅气负责人
31529,850,季江民,2016-07-04 05:21:09,5,9,4,给分棒
31613,850,季江民,2016-07-04 09:15:46,9,14,5,不是我针对谁 我是说在座的各位 只有我是腊鸡
31688,850,季江民,2016-07-04 13:22:56,0,3,3,老师说的很慢 很适合小白，认真听会有回报。另外助教认真负责 好评～～
31850,850,季江民,2016-07-05 04:17:40,0,6,6,老师一般，只是助教特别好，很负责任，还很帅气。
46823,850,季江民,2017-01-22 11:28:21,3,3,0,良心好老师
47430,850,季江民,2017-01-26 09:26:20,3,4,1,老师人很好，会分享一些人生经验。
48754,850,季江民,2017-03-11 15:47:12,27,29,2,老师很好，助教很帅，都很负责，助教叫Jerry
48755,850,季江民,2017-03-11 15:51:58,32,37,5,季老师人很好，思路清楚，内容有条理，非常关心学生，有了老师的帮助，这学期是以满绩为目标的。\n\n另外，助教很帅，很有责任心，还是单身，替助教征女朋友，不用谢谢我了。爱你们。
48803,850,季江民,2017-03-13 07:42:52,6,7,1,助教帅
51932,850,季江民,2017-06-13 15:35:42,-1,1,2,学的很扎实
56100,850,季江民,2017-07-03 05:16:08,1,2,1,老师很好哇 讲的清楚而且有自己的想法 会经常讲一些他对大学的看法 还有傻白甜助教哥哥真的炒鸡可爱的啦 还想再上一遍了都
56815,850,季江民,2017-07-04 16:19:43,2,4,2,上课真的很无聊\n\n不过助教很帅很可爱，可撩
58681,850,季江民,2017-09-14 10:24:53,5,6,1,报到前一天Linux短学期出分。季老师属于人不错，讲课明白，水平也足够的老师。但有一点需要大家注意，他短学期的作业量比较大，12号结课，我属于中等效率，天天写，写到了7月下旬。那个假期有安排的谨慎报名
58687,850,季江民,2017-09-15 01:13:02,5,7,2,Linux小学期挺简单的，最后给分也很好
60416,850,季江民,2017-10-19 11:06:25,2,3,1,上课确实不怎么样
61491,850,季江民,2017-11-17 15:40:00,6,6,0,助教哥哥真的很严格，哈哈哈哈?
67186,850,季江民,2018-01-29 00:13:52,1,4,3,和蔼的老爷爷，很有资历，讲课也挺清楚的。明天就考OS了先来给老师打个10分，哈哈哈
69527,850,季江民,2018-01-25 02:43:13,3,3,0,操作系统复习课比较良心 只比伍赛差一点\n\n讲课还行 一个和蔼的老爷爷慢慢讲自己的经验\n\n这学期助教相对严格\n\n最后的考试实验占比太大了 复习实验不够很吃亏\n\n最后给分不差 但卡分就很难受了\n\n总之 这学期还是很感谢季老师～
69680,850,季江民,2018-01-25 08:07:47,3,3,0,OS 的给分充满了师生情 ...
75116,850,季江民,2018-03-07 11:22:24,38,39,1,“各位在坐的同学很多都要从事IT工作，生命周期是很短的，换句话说，死得很快”
78072,850,季江民,2018-05-09 08:36:43,0,2,2,老师真好
79932,850,季江民,2018-06-15 10:55:25,8,9,1,也不知道计算机学院的同学到底做错了什么
85311,850,季江民,2018-07-17 02:05:57,22,25,3,'你把你学号写一下，考试不用考了，我给你满分。'\n\n长者用行动告诉了我们要多做善事。
98582,850,季江民,2019-01-23 15:17:18,3,7,4,os讲的其实很一般 毫无重点 三次小测可以在寝室做 从不点名 研讨可以用两次发言换 助教有点凶 这张考卷出的题完全像是十分钟内糊出来的一样 实验占分还是挺多的 A4上还是要多抄点 甚至连linux细节也要考 给分一般般 可能是考的不好
98755,850,季江民,2019-01-24 01:40:57,9,12,3,os讲课不好。还不如我上去讲
99055,850,季江民,2019-01-24 08:00:51,9,9,0,诶这给分一言难尽
103401,850,季江民,2019-02-28 02:24:40,0,1,1,老师很好的，会讲一些人生哲理
105778,850,季江民,2019-04-20 10:25:09,6,12,6,老师和助教非常不负责任 尤其是助教 不考虑基础差的同学的感受 打算蹭别的老师的课了
113041,850,季江民,2019-07-05 20:01:17,10,11,1,上课讲干货很少，一节课全是“如果你们学过C啊，JAVA啊……”每五分钟说一次
113109,850,季江民,2019-07-05 23:34:31,25,29,4,怎么说呢，感觉老师不太在乎基础差的同学。在课程中，编程题永远超前布置，上课内容与编程内容往往不相关，后来了解到别的老师上课内容与当次的课都是相关的，就很不明白为什么要超前。其次，老师和助教都不耐心，记得有一次问老师课后习题答案被翻了白眼，去机房多问了助教两声就不耐烦了，可能是我基础不好吧。。。可是非计算机专业有些内容真的搞不明白啊，哪怕高中学过VB，最后看到成绩还是有点失望的，哪怕我期末复习非常认真看完PPT摘抄笔记复习完pintia题目，哪怕我期末考实验做出三道，哪怕我平时编程认真做，期末还是获得了所有成绩的最低绩点。
113559,850,季江民,2019-07-07 00:00:24,4,4,0,体验不好
116238,850,季江民,2019-09-06 12:54:29,4,6,2,屁事巨多，给分贼差
122552,850,季江民,2020-03-04 02:14:59,4,4,0,心态学崩了。没学过大计基的听他一直在讲这些你们基本都学过的就不讲了真的崩溃。课后小测也是很懵
124314,850,季江民,2020-06-29 05:19:02,0,1,1,Linux技术应用基础给分不错，上课讲的也挺轻松，三个实验也算比较简单的了。:)
124316,850,季江民,2020-06-29 05:40:27,-3,0,3,Linux给分不错出分快
124449,850,季江民,2020-07-01 10:28:09,4,6,2,Linux课比较基础，主要是一些入门知识，作业量不大，难度适中，比较实用\n\n至于给分，这门课有正态的要求，计院大佬又很多，想拿4.5+是有难度的，但是混个4.2还是比较容易的                         ——外专业选手亲测
125172,850,季江民,2020-09-02 22:07:11,-17,0,17,小学期随便满
125249,850,季江民,2020-09-04 13:33:09,2,2,0,小学期，给分不错
126003,850,季江民,2020-09-16 11:43:16,2,3,1,虽然老师节奏没有照顾到所有人，但是讲课很好，安排也合理，给分我真的强推，室友c理论没过直接挂了，我居然还能比微积分考的还好！谢谢老师！\n\n
130889,850,季江民,2021-01-25 06:27:40,-22,4,26,os随便满
130916,850,季江民,2021-01-25 08:36:08,0,6,6,老师os给分很好，平时作业有很多选择题考试的时候会有类似的题目出现，推荐选课
131009,850,季江民,2021-01-25 14:08:38,4,5,1,jjmyyds！！！！！！好可爱的老师嘻嘻
132071,850,季江民,2021-01-30 05:51:18,6,9,3,不怎么样
136563,850,季江民,2021-06-21 06:13:39,-1,1,2,讲课不错 作业量也还行~
139421,850,季江民,2021-07-15 10:36:04,0,1,1,老师表面看着很严肃，但人超级好。我们那场大力捞人，濒临挂科的我竟然被捞到了未曾预想的分数~！
139434,850,季江民,2021-07-15 12:54:42,2,2,0,小测虽然多但有回报，而且给分很好
139437,850,季江民,2021-07-15 13:40:06,-1,0,1,老师上课很认真负责 平常有小测
139458,850,季江民,2021-07-16 03:19:19,3,3,0,老师虽然平时严格，但还是很善解人意的，感谢老师捞我!
139549,850,季江民,2021-07-17 07:41:09,0,1,1,看到朵朵校友圈上超多吹爆季江民老师的，我也来吹一吹，老师超级认真负责，是那种超可爱的“小老头”的形象。之前一个折腾了我好几天的数据可视化最后以尝试的心态去问老师，没想到老师回得这么快，解答还超耐心。\n\n老师给分超好，很能捞！
140253,850,季江民,2021-09-07 03:34:44,0,1,1,Linux短学期只要认真做就能拿个比较理想的分数\n\n(不过作业还是有点点多)
140376,850,季江民,2021-09-10 09:03:13,2,4,2,短学期钉钉群里都没看到谢谢老师，看之前评论给分很好，反正实际体验一般。\n\n也确实没学好，没学明白
140762,850,季江民,2021-09-16 00:58:42,1,1,0,虽然小测很多，但是很认真负责！谢谢老师捞我！
145518,850,季江民,2021-12-30 06:44:55,-2,2,4,好老师！！！考前就来给季老师打call！
149145,850,季江民,2022-01-14 14:04:14,20,22,2,操作系统给分不错，平时挺照顾学生，小测放得很宽（当点名用），上课会讲解例题，作业题贴近考试和考研，专业水平高（历史亲历者，从UNIX大型机一路用过来的，熟悉Linux内核），讲课清晰有重点。\n\n如果第一次听季老师讲课可能会困（语速慢，语调太平了），但习惯了发现真得很有条理，平时认真听考试轻松裸考4.5。\n\n上课经常会分享人生经验，对学生寄予厚望，希望大家能够去沉下心突破核心技术，很有家国情怀的老师！
149163,850,季江民,2022-01-14 15:05:45,3,9,6,感觉给分一般，可能是自己期末考得不太好吧。。。
158698,850,季江民,2022-07-01 11:59:14,1,4,3,感觉给分一般，可能我确实也在python上没太花时间吧。但是他的小测真的比别的班难好多，后面两次都是题库随便抽的不是原题而且闭卷😰认真学应该还是能学的不错，但这样会不会比别的班单就平时分而言给分要差呢😭
158699,850,季江民,2022-07-01 12:06:46,1,1,0,同感觉给分一般，没有评论里说得那么好，不过也有可能是我没有竭尽全力去学吧
158749,850,季江民,2022-07-01 23:54:44,1,3,2,除了体育第一个满绩呜呜呜
158853,850,季江民,2022-07-02 17:51:06,0,2,2,给分不错，老师负责
159074,850,季江民,2022-07-05 15:01:00,-1,2,3,老师很好！！！
159457,850,季江民,2022-07-21 09:41:45,28,31,3,linux短学期上课还可以，然而shellscript写editor真是好活😅😅😅
159595,850,季江民,2022-08-21 13:14:18,5,7,2,上课讲的很不清楚，需要课下花很多时间自学，给分很迷，最后理论考的还不错实验对一道结果3.3，暴风哭泣了，十分不推荐
159796,850,季江民,2022-09-05 05:13:52,2,5,3,老师人很好，对同学们很宽松，也是老教师了，教学确实没法和年轻教师一样那么通透，但是知识也教授的很扎实，总体还是很好的老师\n\n短学期出分评:正常做了作业，myshell尽量写，前一个编辑器只完成了很普通的一点。满了，身边认识的同学都是4.8和5.0
159833,850,季江民,2022-09-05 10:01:11,0,3,3,给分很好哇 可惜os预置的不是季老师的课
159865,850,季江民,2022-09-07 03:12:00,0,4,4,给分很好呀\n\n作业只是让你好好写\n\n其实没严格要求全部做出来的
160519,850,季江民,2022-09-29 10:59:20,4,5,1,我觉得季老师有一种两级分化的评论趋势\n\n一种是高年级的计院学生 对于上课能不能听懂\n\nemmm懂得都懂 主要看老师打分、助教指导好不好\n\n这方面老师绝对很棒 浓浓师生情\n\n但是对于低年级的同学的话\n\n不想额外花时间就比较那啥了\n\n所以就是 大二及以上无脑冲\n\n大一等年级要慎重比较一下
163560,850,季江民,2023-01-05 13:24:09,4,7,3,Linux\n\n两周上一次课，因为上机课不用去\n\n事情很少，但是常有小测\n\n小测非常奇怪，开卷，会考各种概念细节，来不及挨个查\n\n就算你会用指令你也答不对，很多题目没有任何实用价值，所以学不到什么东西\n\n给分感觉不会很好，毕竟平时分被小测丢干净了，希望期末别也这么出题\n\n---\n\n考试前来补充一点\n\n平时上课准备感觉不算很充分，上课经常会出现各种失误然后当场找bug\n\n考前问考试范围已读不回，不知道为什么
166316,850,季江民,2023-01-14 04:50:04,5,8,3,jjm我的超人！\n\n平时分好，期末小捞一丢丢\n\n作业题网上有答案，而且和考试很像\n\n作用超好\n\n多补充一点 出分好快\n\n相比于这学期其它专业课
166363,850,季江民,2023-01-12 05:35:13,3,7,4,Linux\n\n上机课不用去，自己做实验题，两周上一次课，事情很少，给分超好\n\n平时认真做实验题，期末多看看历年卷，绩点随便上4.5
166450,850,季江民,2023-01-12 09:38:43,0,1,1,linux课来答一波，3.9，怪我没有好好学，老师人是不错，但是讲的确实不是很精彩，大一需要花时间如果没有接触过linux的话还是要时间和精力学习才会有高绩点的
167213,850,季江民,2023-01-15 05:54:01,5,8,3,这学期给分没有预想中的好啊
167468,850,季江民,2023-01-16 13:57:37,-4,2,6,中规中矩，一般般，ppt照常念，感觉人还不错，但感觉对操作系统的理解并没有那么深，写的书就是一坨，搞一堆没有意义的指令细节，真用的时候有个印象google就好了，何必每个参数都记清呢？建议对操作系统有想法的同学选swb老师的课，可能能对整个系统有一些课本之外的理解。
168563,850,季江民,2023-02-19 13:17:24,-1,3,4,给分好
169495,850,季江民,2023-02-26 12:23:00,-4,3,7,老教师了，一个有点可爱的老头，给分还行，最后总评捞到了4.8，很高兴
177365,850,季江民,2023-07-03 04:48:01,2,5,3,差的要死呵呵
178323,850,季江民,2023-07-10 04:53:09,-3,3,6,上课念PPT而且现场编程上课效率低的要死，今年理论考想办法看了原成绩，发现给分极差
187574,850,季江民,2024-01-16 15:35:58,2,2,0,这学期的操作系统，总体来说体验还是不错的，老师很和蔼，有随机抽人，但是都是加分，抽到你你回答问题可以加分你没来上课也不会扣你分\n\n平时有做ppt和回答问题的加分，还有做lab7的加分，想卷的可以做，但是实测不做lab7平时分也能基本加满，平时给分挺不错的，作业小测都是以前的题所以都能满，验收也不会扣分，回答问题的加分足够弥补报告扣的分了。可惜我考试考烂了，不过这也怪不了他。
205159,850,季江民,2024-12-02 08:53:01,-20,6,26,老师是好的，助教是傻逼，验收花样卡人
208217,850,季江民,2024-12-26 09:35:23,12,13,1,冲着助教卡天天找人要代码啥都不干吸别人血的同学我就给10分
210509,850,季江民,2025-01-09 09:35:08,8,12,4,爽，就喜欢助教卡住那些不认真写实验的人
212731,850,季江民,2025-01-14 15:36:45,2,2,0,24秋冬操作系统，好老师，上课速度不快，讲的内容其实还是蛮清楚的，给分好，必须赞\n\n这个课感觉相比计院大三同学期的其他课其实难度不算很大，主要是量很大，概念多，而且实验需要仔细理解和学习，所以花时间还是不少的\n\n期末复习的时候参照jjm的作业题和小测还是非常有必要的
1145,865,吴春明,2015-03-21 16:18:27,23,27,4,逗比老师
1281,865,吴春明,2015-03-21 17:25:06,16,21,5,不知道别人怎么想，反正是很讨厌这个老师上课。一学期没听。
1529,865,吴春明,2015-05-08 11:03:03,52,67,15,调侃学生的智商。。。2课时被他硬拖到3课时。\n\n
1871,865,吴春明,2015-03-26 03:07:51,22,24,2,太差了，千万别选
2202,865,吴春明,2015-04-08 05:42:55,54,57,3,今天你洗脚上床了吗(>﹏<)
2417,865,吴春明,2015-04-29 13:53:37,36,41,5,全靠自习，上课只讲学过的东西，讲完了布置作业发现这个作业已经布置了，刚才讲的课都是同学们预习过的。。。
2419,865,吴春明,2015-04-29 23:49:07,26,29,3,洗脚课
2859,865,吴春明,2015-06-18 03:10:30,44,51,7,sb老师，又没有讲知识点，又假装自己是好老师，所谓“引导学生学习”，呵呵。。讲了跟没讲一样
2982,865,吴春明,2015-05-12 07:50:52,39,41,2,傻逼老师，不负责任
3205,865,吴春明,2015-05-21 00:57:19,28,33,5,这课上的简直是在逗我\n\n
3261,865,吴春明,2017-12-20 15:34:42,16,19,3,超垃圾的老师
3438,865,吴春明,2019-08-19 07:40:27,137,168,31,特地赶来骂他，却发现来晚了。
3473,865,吴春明,2015-06-16 09:02:10,32,40,8,学弟学妹千万不要选这个老师，太坑了。上课瞎比比，根本不知道自己讲到哪里，作业布置下节课的上课内容。
3724,865,吴春明,2015-06-17 02:41:16,20,22,2,真的是他妈在逗我，啊，什么鬼老师我去。
3733,865,吴春明,2015-06-17 02:50:16,12,17,5,辣鸡水平
4059,865,吴春明,2015-06-17 15:39:42,12,14,2,傻逼...
4068,865,吴春明,2015-06-17 15:50:24,14,17,3,洗脚狗
4206,865,吴春明,2015-06-18 05:40:49,25,26,1,完全靠自习 本来蛮喜欢C程 在他教导下 C程成功成为我最讨厌的课
4317,865,吴春明,2015-06-19 03:11:40,12,13,1,身心俱疲，不知所云
4643,865,吴春明,2015-06-25 10:50:11,5,8,3,无聊
4762,865,吴春明,2015-06-28 02:59:08,4,11,7,开心就好，天天洗脚
5767,865,吴春明,2015-07-09 09:17:39,3,7,4,巨坑，陨石坑
5979,865,吴春明,2015-07-10 06:17:36,6,14,8,天坑，不过建议选他的课，然后去蹭白洪欢的课，可以拿高分
6064,865,吴春明,2015-07-10 14:43:59,4,7,3,全靠自学，没有基础，不是大神，自己又不会找资料的，慎报
6597,865,吴春明,2015-07-16 04:56:20,-9,5,14,给分好，讲得确实有点模糊
6962,865,吴春明,2016-09-19 05:01:49,-18,9,27,好老师，真的
6965,865,吴春明,2015-08-23 10:11:03,-6,4,10,为了让学弟知道什么叫老师
7036,865,吴春明,2016-09-19 05:01:57,-24,8,32,讲的真好
7290,865,吴春明,2015-09-13 04:02:43,16,19,3,上第一节课就讲书上150页的东西。。尼玛我们是零编程基础的孩纸好嘛。。。
7358,865,吴春明,2015-09-14 03:33:28,3,7,4,我的天。。。我是听到了些什么
8796,865,吴春明,2015-09-28 03:00:43,5,9,4,真tm是个好老师 培养学生的自学能力和良好的生活习惯（洗脚）
8799,865,吴春明,2015-09-28 03:03:40,4,7,3,特地赶来给他往下拉分
9119,865,吴春明,2015-10-13 12:42:55,4,8,4,洗脚改变世界
10481,865,吴春明,2015-11-19 05:06:04,11,15,4,如果你要在他的课上学到东西，请不要预习，如果你想学好，跟着助教跑。。。。就这么多
11750,865,吴春明,2016-09-16 02:21:50,-16,3,19,很赞啊
12513,865,吴春明,2015-12-23 11:52:33,-16,6,22,这么好的老师你们竟然还嫌弃，我不服
12562,865,吴春明,2015-12-23 13:21:20,3,6,3,我就呵呵了，最后几节课班上有没有20个人？
12815,865,吴春明,2015-12-24 05:51:50,3,5,2,除了不点名，找不到一点好处。
13139,865,吴春明,2015-12-25 02:52:51,10,11,1,心疼助教。
13416,865,吴春明,2015-12-28 02:45:44,3,5,2,呵呵呵呵
13568,865,吴春明,2015-12-29 09:20:19,-18,3,21,感觉挺好的其实
14908,865,吴春明,2016-01-11 02:40:26,3,6,3,让我丧失了对C程的兴趣
15033,865,吴春明,2016-01-11 14:57:55,6,9,3,洗洗脚 不点名 给分好
17931,865,吴春明,2016-01-21 04:14:05,10,13,3,洗脚课。课后洗洗脚。考试前老师赠予了我们一把武器。“擦脚布”
21190,865,吴春明,2016-02-26 03:02:48,-12,2,14,非常棒的老师
21681,865,吴春明,2016-02-29 15:25:35,7,12,5,宋晨助教好萌！好心疼他啊！
21683,865,吴春明,2020-02-25 09:52:43,118,167,49,我要跟宋晨助教啪啪啪
22043,865,吴春明,2016-03-02 07:05:39,1,4,3,呵呵呵
22991,865,吴春明,2016-03-30 03:19:04,5,7,2,只会把责任推给上学期老师，没学的东西硬要说学过。\n\n
22999,865,吴春明,2016-03-16 03:21:06,1,5,4,自称大师级
23000,865,吴春明,2016-03-16 03:17:30,1,4,3,呵呵哒 懵懵圈
23218,865,吴春明,2016-03-22 04:05:07,-7,6,13,绝世好老师！\n\n
25320,865,吴春明,2016-05-14 02:41:48,2,3,1,根本什么都学不到
27962,865,吴春明,2016-12-23 16:25:31,15,18,3,这个10分是送给助教宋晨的。\n\n真心好助教(๑•.•๑)\n\nand助教是个有故事的人
28706,865,吴春明,2016-06-28 12:40:58,0,3,3,。级转西北风哪个
32412,865,吴春明,2016-07-06 15:02:32,1,2,1,烂兰兰
32483,865,吴春明,2016-07-07 05:28:33,-3,2,5,虽然讲课方面没讲多少知识，靠自学，但给分是真心不错
33344,865,吴春明,2016-09-18 13:54:50,7,8,1,洗脚大仙只给不给自己洗脚的人洗脚，问他给不给自己洗脚\n\n
33410,865,吴春明,2016-09-19 06:57:02,-4,3,7,好老师\n\n
33411,865,吴春明,2016-09-19 06:58:09,1,2,1,选上的趁早退了吧。后悔死
33419,865,吴春明,2016-09-19 07:40:18,1,2,1,呵呵，想睡觉
33421,865,吴春明,2016-09-19 07:45:45,1,2,1,真的很无聊，总算知道评分怎么出来得了。\n\n\n\n
33500,865,吴春明,2016-09-20 00:40:24,0,3,3,无敌洗脚大仙\n\n
34424,865,吴春明,2017-03-01 08:50:27,2,4,2,真无聊
34427,865,吴春明,2017-01-09 06:05:33,6,7,1,能不能让宝宝安静地上会儿自习？
34824,865,吴春明,2016-10-24 06:50:32,5,6,1,我只能说，我打一分是因为没有零分。
39197,865,吴春明,2016-12-21 14:27:24,6,6,0,不知道怎么样 反正他的课没去听过 都是蹭别的老师的程设 助教还是很可爱哒
40244,865,吴春明,2016-12-30 13:47:19,8,9,1,助教棒棒哒\n\n和同学们互动很多\n\n//其他课基本没怎么见过助教，是我太学渣了吗= =\n\n讲课很走心\n\n布置project很用心\n\n为吴老师的课付出了很多\n\n2017新年快乐\n\n@wlc\n\n@其他默默付出的学长/学姐们
40839,865,吴春明,2017-01-06 02:16:16,18,22,4,老师渣众人皆知，但是这一届很幸运，wlc助教，sc助教，cty学长，以及萌萌的学姐都很棒，上机课的上座率极高，而且上机课学到的东西很多。只是不知道下一届的助教有没有这么好……
41030,865,吴春明,2017-01-18 06:10:35,-5,2,7,其实挺好的
44622,865,吴春明,2017-01-18 04:42:15,1,1,0,洗脚大师～毫无内容
44624,865,吴春明,2017-01-18 04:46:53,2,2,0,没听过
44630,865,吴春明,2017-01-18 05:02:20,4,14,10,很好的老师，懂行的都知道我的评分是什么意思
44635,865,吴春明,2017-01-18 05:06:16,9,13,4,吴老师虽然上课可能有人不习惯，但人很好，助教gg也这样说\n\n助教gg这学期良苦用心留的3个project让我们提升很多
44649,865,吴春明,2017-01-18 05:25:24,8,10,2,为我自己打满分\n\n老师虽然课讲的不好，但是给分好，人也好\n\n其实程设主要得自己努力吧
44868,865,吴春明,2017-01-18 12:02:52,1,1,0,讲的一点都不好、只会瞎逼逼、全靠自学
48272,865,吴春明,2017-03-02 00:48:41,-1,3,4,上课轻松，助教gg棒棒。
48529,865,吴春明,2017-03-06 15:37:04,5,8,3,强烈建议有基础或自学能力的同学选，上课不点名，作业少，给分高，真良心老师！
49031,865,吴春明,2017-03-22 03:58:18,-1,3,4,其实吴老师蛮不错的，课都可以水过去。（上了大程换了老师才醒悟过来）
51049,865,吴春明,2017-05-15 07:06:55,4,4,0,这个老师跟牛逼助教配在一起简直绝了，project永远比教学进度快的多...
51302,865,吴春明,2017-05-29 19:13:59,2,2,0,。。。
51303,865,吴春明,2017-05-29 19:14:06,5,6,1,垃圾老师，啥都不讲，只能自学。。。。。
52435,865,吴春明,2017-06-20 04:12:37,5,5,0,给分挺好，上课有时候可能会突然点名，洗脚水平很好
56555,865,吴春明,2017-07-04 03:30:44,3,4,1,助教特别好，谢谢老师没给我挂，感恩，么么哒
57002,865,吴春明,2017-07-05 06:36:36,3,3,0,10分全是给助教大大的@WLC
58046,865,吴春明,2017-07-26 11:19:01,0,0,0,......
58761,865,吴春明,2017-09-16 15:54:39,1,1,0,给助教gg10分@wlc
58886,865,吴春明,2017-09-18 08:57:32,3,3,0,洗脚的时候写程序，不得了了
59644,865,吴春明,2017-09-25 07:34:09,2,3,1,还行吧
59937,865,吴春明,2017-09-28 12:10:03,1,1,0,天花乱坠，不知所云。全靠自习，不如不上。
59940,865,吴春明,2017-09-28 13:05:35,1,2,1,自学加助教，666
60062,865,吴春明,2017-10-09 06:42:11,1,2,1,刷低分。渣
60269,865,吴春明,2017-10-16 09:00:59,5,6,1,脑子是个好东西，希望他能有
65211,865,吴春明,2017-12-31 12:55:01,10,11,1,给助教小哥哥疯狂打call，没有助教小哥哥完全就不想上这个课了Q_Q
65394,865,吴春明,2018-01-03 14:44:16,7,8,1,为助教小哥哥打call
65532,865,吴春明,2018-01-05 08:38:16,3,3,0,说真的，没有基础的人千万不好选，除非你自学能力极强。
65690,865,吴春明,2018-01-08 08:46:25,1,1,0,其实也还行
66153,865,吴春明,2018-01-12 07:16:08,1,2,1,还好吧 来为老师正名一下
67437,865,吴春明,2018-01-21 07:57:11,1,1,0,好老师，一定要选
71170,865,吴春明,2018-01-28 05:33:38,25,27,2,给沈泽弘助教疯狂打call，人很好，讲题很仔细，人也特别有趣，每次去教室的上机课都很有收获啊，因为助教爱上c语言～重点是助教真的是超级无敌帅啊～
71298,865,吴春明,2018-01-28 09:04:05,17,17,0,助教沈泽泓真的超级帅～全靠助教
72323,865,吴春明,2018-01-30 02:02:48,0,2,2,讲成一坨，出分慢得一批
72692,865,吴春明,2018-01-31 01:49:20,4,6,2,这十分是给助教的
74526,865,吴春明,2018-03-03 03:04:24,1,2,1,老师上课不讲课，总是调侃，不过助教还是挺好的。
74745,865,吴春明,2018-03-05 11:25:30,-2,2,4,很自由
76080,865,吴春明,2018-03-26 09:36:59,1,1,0,讲课好不好是另一回事，但是拖堂的老师永远不受人欢迎，尤其是下午最后一节还拖堂。
76453,865,吴春明,2018-04-09 16:02:22,2,2,0,我觉得挺好的，特别是最后五分钟讲一章内容的时候
79547,865,吴春明,2018-06-09 01:44:53,2,2,0,要是被选上他的课就自求多福吧。。。(用“被选上”是因为没有傻子会主动选他的课)别指望他上课能讲清楚什么东西，多用点时间自学吧
81289,865,吴春明,2018-07-04 14:40:59,5,6,1,10分给助教，老师扣9分
82151,865,吴春明,2018-07-07 08:40:14,4,4,0,助教真的超级棒！见过最好的助教。没有之一。其实吴老师也不是不能选。跨专业没有优先级选课，基础专题都选的他。虽然都在别的班老师那上课了。不点名，助教最后都尽力调分，基本都不卡绩，这就是0.3啊！
85040,865,吴春明,2018-07-15 05:34:36,7,8,1,十分给助教。老师扣九分。但说实话。我感觉是可以选的。助教十分给力。可能我比较适合自学吧。助教随时都会在群里解答我感觉效果是非常棒的。最后给分真是助教拼了命的给高分。讲真老师是真不行。但助教让这门课也没那么差。
86712,865,吴春明,2018-09-18 06:00:11,2,4,2,挺好的啊
86713,865,吴春明,2018-09-18 06:00:58,-4,2,6,老师上课真的是太棒了\n\n
86727,865,吴春明,2018-09-18 06:45:25,9,10,1,上第一节课我以为走进了相声课的教室
87398,865,吴春明,2018-09-28 03:52:15,4,4,0,什么事都交给助教了......
87788,865,吴春明,2018-10-13 10:31:32,3,3,0,3.1分真的是名副其实。作为一名老师而言，吴老师真的是非常差，讲课没有逻辑，真的很难学到东西。如果选这名老师的话，做好自学的准备吧。
91752,865,吴春明,2018-12-19 09:53:28,9,11,2,吴老师才是助教\n\n本届助教也超级给力，竺院工高班的学霸
94232,865,吴春明,2019-01-16 02:43:11,1,7,6,吴老师真的是我最喜欢的c程老师，建议大家都选\n\n
100561,865,吴春明,2019-01-26 09:53:00,5,5,0,头一次遇见什么事都抛给助教的老师\n\nc程基础还是要靠自己吧，多注重一下理论知识，别到期末做理论题的时候栽倒
102092,865,吴春明,2019-01-30 11:27:23,1,2,1,基本全靠助教所以下一届听天由命吧。希望学弟学妹们有个好助教。老师水平的话只能说这分数实至名归吧。
102317,865,吴春明,2019-02-01 01:44:47,1,2,1,老师不怎么教学，但助教很棒，也几乎不点名。选上他的话建议多和助教打打交道，多问问题，争取自学成才（滑稽）
102662,865,吴春明,2019-02-18 09:54:54,4,4,0,emmm可能老师讲课方式有问题吧\n\n但是助教都很棒\n\n也看了下面的评论\n\n助教真的都很棒！\n\n最后出分数时比较慢\n\n因为老师要改一下分数（肯定是往高改）\n\n（谢谢老师）\n\n我觉得最起码给分还是很公开透明的\n\n
104374,865,吴春明,2019-03-19 03:28:18,1,2,1,其实老师人很好吧……私下问问题很耐心也很热心
109727,865,吴春明,2019-06-19 02:19:37,3,4,1,为啥就您非得整个互评？
110395,865,吴春明,2019-06-26 10:06:05,5,5,0,爷怕了，选他属实铁憨憨
114257,865,吴春明,2019-07-09 11:33:37,3,3,0,我爱助教项yfxgg，都别跟我抢我是他男朋友
118180,865,吴春明,2019-10-22 07:21:30,2,2,0,课很无聊，适合自学
119267,865,吴春明,2019-11-12 01:05:15,0,0,0,洗脚课
121399,865,吴春明,2019-12-16 10:45:49,0,1,1,从他那你学不到有用的，靠自己
122928,865,吴春明,2020-04-21 15:42:44,2,2,0,请你早点退休不要误人子弟
126297,865,吴春明,2020-09-22 03:49:35,2,2,0,强烈安利，在课上能锻炼自学能力和忽略废话的本领，相比在现实派老师课堂上时不时有重难点解析，这位亲爱的理想派老师全程创造云雾(还有唾沫雨)，可以沉下心自学，因为你知道别人听完课和来时一样朦胧。
126510,865,吴春明,2020-09-29 02:06:11,8,10,2,我的脚真的不够洗
126719,865,吴春明,2020-10-15 03:39:38,1,1,0,大不自多
128866,865,吴春明,2020-12-26 07:26:05,2,2,0,非常好的课，可以培养自学能力，上课抗干扰能力和翘课能力
129319,865,吴春明,2021-01-04 06:34:04,7,11,4,怎么办，预置课是他，挣扎了两轮都换不掉，我已经开始慌了
129775,865,吴春明,2021-01-12 07:54:36,4,4,0,如果你很强，那无所谓；要不然还是跑吧
132607,865,吴春明,2021-02-02 16:39:30,3,3,0,上课不点名，但是确实真的听不懂..不过c程自学还是可以的，看看书做做题吧，作业布置的还是蛮负责的。
133651,865,吴春明,2021-03-03 08:49:35,20,20,0,飞机打大炮，大炮打飞机\n\n天天不洗脚，简直最刺激
133941,865,吴春明,2021-03-10 08:00:54,1,1,0,洗脚洗脚
135805,865,吴春明,2021-05-26 15:15:57,4,6,2,上课图形库部分讲的是TC的库，大作业要求必须libgraphics，请问不能用你讲个der呢!（这一分是给助教的，老师还是早退休吧）
137113,865,吴春明,2021-07-01 09:06:08,2,2,0,刘佳琪姐姐人好！
139698,865,吴春明,2021-07-20 08:23:05,3,10,7,老师从来不点名，很和蔼。上课听不懂是真的（单指图形部分，链表部分老师讲的还是很清楚的），但是老师会很耐心的回答问题。助教真的好有耐心，有时候我问问题问的太多自己都有点不好意思了，但是助教还是会很耐心的回答。上吴老师的课对图形库一头雾水，也不懂怎么配置环境，怎么画图，这些在课上基本学不到，全靠自己摸索，不过实际上自学也不是很难。吴老师没有期中考试！（这个太感激了，给我省出了大笔复习vjf的时间，而且没有期中平时分应该也会高一点，感谢老师）\n\n给分很不错的。我感觉小组作业完成一般，没有特别亮眼的地方，但是拿了4.8，基本满意了，感谢王紫兆助教，感谢老师
140601,865,吴春明,2021-09-14 06:58:45,-4,1,5,老师我爱你，你最帅了
140650,865,吴春明,2021-09-18 01:32:36,-7,7,14,吴老师yyds！希望能逢到这样的好老师！10分已给！
141284,865,吴春明,2021-09-28 07:46:05,0,1,1,给一分。因为最低只有一分
141447,865,吴春明,2021-10-09 07:34:07,6,6,0,零基础小白千万别选，厚基础大佬选来积德。上他的课基本靠自学，大佬可以把其他好老师的名额让出来，然后上课划水（bushi）
142062,865,吴春明,2021-11-05 04:21:24,2,2,0,不想吐槽，作业比课程进度快，全靠自学，上课没有重点，想听的都过了
144303,865,吴春明,2021-12-21 05:04:45,4,4,0,他的C语言课非常建议不要选，不要选，整个就是照着书本配的PPt在讲，什么都没学到，全靠自己自学。如果已经会C语言的可以选下他的课，因为他的课很水，你干什么他都不会管。但像我一样的C程小白千万不要选他的课，真的很痛苦。
152327,865,吴春明,2022-04-04 07:43:14,7,8,1,我很好奇他的评分为什么高于一分。
154110,865,吴春明,2022-05-23 09:56:55,1,2,1,只能说大部分老师都讲不了什么东西 但是老师人很好
155445,865,吴春明,2022-06-13 03:06:58,2,3,1,这老师讲课完全听不懂 就是给学生增加难度 本来c大程已经够ex了 又摊上这么一个老师 别指望从他的课里面有一点点收获，不如自己看书，他起的全是反作用。期末还有什么诚信作业 真的无语了 考试周白白浪费学生时间，不知道这样的老师怎么能在浙大教书。
157964,865,吴春明,2022-06-26 00:12:09,0,0,0,成绩出得太慢了，有病吧
157995,865,吴春明,2022-06-26 04:02:44,0,2,2,期中考89 大程90多 平时作业基本也没扣几分\n\n结果88 还卡绩 麻了
158096,865,吴春明,2022-06-27 03:37:12,0,3,3,从C大程而言感觉体验还是不错的，上课而言老师链表和函数讲得还是比较细致的（虽然自己用的PPT上都有问题），图形库这种反正都靠自己学。期中考难难度偏低，大程没有展示，总体感觉舒适
158177,865,吴春明,2022-06-27 10:24:48,1,5,4,纯纯的垃圾，上课什么都不讲，搭配智障助教，最后大作业做得爆杀别人、考试也满分、作业一次没漏都是满分，结果出来分我只能呵呵，1分是因为没有-1分
160660,865,吴春明,2022-09-29 14:28:21,1,4,3,在浙大，有这么一位老师：\n\n他姓吴；\n\n他学的是计算机；\n\n他评分很低；\n\n他的名字里有关于光亮的字；\n\n他就是……我们的吴春明老师！
161223,865,吴春明,2022-11-22 03:32:03,3,3,0,傻逼东西，上课讲的全是几个周以前作业做过的，说话一抽一抽的，重点讲不到，快跑。\n\n再来补骂一次，cnmd，wcm什么时候4
162730,865,吴春明,2022-12-05 10:19:26,5,5,0,纯靠自学，希望以后被预置了wcm的c小程的同学快跑
164120,865,吴春明,2022-12-18 08:02:33,4,4,0,C大程还行，上课就别去了，反正都是自学
164245,865,吴春明,2022-12-20 01:13:32,1,1,0,上课PPT就是书本统一配的，布置的作业远远提前于讲课，全靠自学，建议没有基础的同学快跑
164680,865,吴春明,2022-12-23 08:40:30,0,0,0,1分给助教
167057,865,吴春明,2023-01-15 09:05:15,1,2,1,出分了，助教是好人，真的会捞。这个老师的课给分应该跟助教关系挺大的，很多事情也是助教在弄。
167074,865,吴春明,2023-01-15 01:30:09,3,4,1,10天了还不出分，等死鼠鼠我了，学了这么久c，python、Java全修过，但都没过，每次选课的时候都义正词严“老子必过”，现在只盼着助教高抬贵手，别一刀砍死我……
167262,865,吴春明,2023-01-16 04:37:41,4,5,1,基本自学，全靠助教，快润。助教是真的好，爱助教zzygg
167298,865,吴春明,2023-01-15 12:14:51,1,2,1,上课离谱，PTA作业题目往往比上课进度前置几周\n\n我身边的全靠自习\n\n但是不点名，事少，自习巨佬可以尝试
167306,865,吴春明,2023-01-15 12:55:09,4,4,0,“洗脚洗脚！！！”\n\nwcm的课，怎么说呢，特别喜欢讲习题，认真听讲得还可以。但是，最大的问题在于布置的题目远远快于他上课进度，上课讲的又都是我们两三周前做过的题目。因此几乎没人听课。比如说，这个学期数组还没开始上，指针的作业就已经截至了。完全依靠自学。不过之后我们向他反映之后很快就调整了截止日期（因此我几乎一个月不用做新的作业）。可能是由于老师评分较低，所以大家也自学，没人提意见；老师平常也不关注作业的截止日期，形成恶性循环。所以以后学弟学妹如果遇到这种情况一定要及时反映，多与老师沟通，可能会有所好转。如果作业与讲解时间匹配，那么我觉得他的分数不止三分，当然应该也不会太高。\n\n助教人特别好。学习上的问题都会即使答复，还会帮助我们debug。\n\n最后，上了他的课就知道“洗脚”什么意思了。（手动滑稽）
167884,865,吴春明,2023-01-19 21:17:58,-2,3,5,真的无语了=_=，**，平时作业基本满了，考试都是80几，最后tmd总分才57，也不知道怎么来的。
167902,865,吴春明,2023-01-20 04:25:08,2,2,0,老师讲课进度太慢了！作业进度太快了！不过C小自学一下也还可以，上课大家基本后排自习。个人不太喜欢老师的智商歧视，不过老师还是挺关心学生的，消息都会回复，还会问学习进度怎么样
168244,865,吴春明,2023-02-06 02:29:23,2,2,0,纯纯的垃圾
169855,865,吴春明,2023-02-28 06:26:15,0,0,0,教学进度缓慢，知识点讲解不够清楚，不如自己看PPT
170501,865,吴春明,2023-03-06 03:14:52,-2,0,2,还可以
170568,865,吴春明,2023-03-06 15:48:54,3,3,0,wcmnb\n\nwcnmb
170886,865,吴春明,2023-03-11 09:34:32,1,1,0,千万别选！
174039,865,吴春明,2023-06-06 00:59:24,-1,0,1,666
178975,865,吴春明,2023-08-10 09:28:39,-1,0,1,c大还行😀
179340,865,吴春明,2023-09-12 05:14:14,3,4,1,垃圾。
180352,865,吴春明,2023-09-21 07:48:09,8,8,0,上wcm的课可以有效提高自己的自学能力
180355,865,吴春明,2023-09-21 07:51:49,10,10,0,洗脚仙人实至名归
180372,865,吴春明,2023-09-21 09:09:40,7,7,0,选这个老师可以培养你的能力，可以培养你上课自学的能力，老师同时还会督促你每天洗脚
180923,865,吴春明,2023-09-28 07:39:39,0,2,2,吴老师人非常好，会愿意听取同学的意见
181447,865,吴春明,2023-10-18 05:14:14,4,4,0,地中之帝，脚中之皇
181491,865,吴春明,2023-10-19 05:35:42,4,4,0,诸般兵械，皆随我意！
181877,865,吴春明,2023-11-03 03:39:36,3,4,1,小测测的什么b玩意儿，别测那个了，测尼玛得了
182150,865,吴春明,2023-11-10 16:46:21,2,4,2,吴老师呢，主打的就是一个洗脚，这洗脚，多是一件美事~~\n\n建议有信息基础的同学选吴老师，可以减轻负担，作业量不多，可以合法旷课，只要为吴老师服役（助助教）就行了\n\n但是如果基础不行，就要考虑一下：习题进度偏快，很可能需要自学或者call吴老师的批发助教。\n\n3分太低了，吴老师完全值6分，甚至可以给7分
182439,865,吴春明,2023-11-16 04:31:39,4,6,2,在吴春明老师的教室里，大家争着坐教室后排的座位，会听他讲课的一只手都数得过来，上课的时候没什么正经的内容，等到需要讲重要内容的时候又很快带过，他的课上我都是自学，助教给我们讲反而是要全程认真听的。有好几次说到一个什么问题，吴老师就说“以你们的智商，…”，意思是说我们智商太低无法解决，让人听着觉得他真没什么教师应有的素养。我会上他的课完全是因为一开始选到了李际军老师的课，ljj老师大家懂得都懂，没想到这位吴春明老师也让人挺失望的
184166,865,吴春明,2023-12-11 15:00:07,2,2,0,表白助教黄恩浩哥哥～人很负责～题目也很负责～回答我的白痴问题也炒鸡负责～
185345,865,吴春明,2023-12-28 05:37:55,1,1,0,今天你洗脚了么
185443,865,吴春明,2023-12-29 10:55:06,0,0,0,有基础可选，可合法旷课（要联系他/助教）
186224,865,吴春明,2024-01-09 15:28:20,1,1,0,傻鸟洗脚课，全靠自学到期末，才想到来骂他，大家请擦亮自己的眼睛，谨慎选课！
188655,865,吴春明,2024-01-19 13:03:28,0,0,0,垃圾老师，
188863,865,吴春明,2024-01-20 10:14:59,3,4,1,老师人不错，讲课真不行，每次想听一下课，坐下去煎熬不到10分钟就跑了，不如自己看PPT，然而他的PPT又很粗糙，开始以为PPT所有老师都一样，考前看别的老师的智云的时候才发现别的老师做的那么好，本来看他评分低，这学期就靠自学，几乎没听课，发现c尖真的学不来，提了个3.6，我自诩自学能力还可以，但c真的是炸裂直接把我从4.6几的绩点拉到4.4，既然只有c尖这么一门4分大课，后来人一定要好好选老师，不要像我一样这么重要的课炸裂了。
188988,865,吴春明,2024-01-21 04:52:20,3,4,1,认真自学 结果3.6 均绩被拉0.15  这门课为什么有两个助教 因为没有老师
190869,865,吴春明,2024-03-23 01:24:42,0,0,0,呵呵，辣鸡
192276,865,吴春明,2024-05-13 09:07:39,2,3,1,预置的c程是ljj的，退了再选只选上他的，没办法只好认了，上课内容空洞无趣，自以为幽默，最后绩点4.8和老师没有任何关系，全靠看书自学，上课可以带耳机不听
198485,865,吴春明,2024-09-09 07:41:46,2,2,0,第一节课讲了半天，自己都不知道自己在讲什么，逆天
198621,865,吴春明,2024-09-10 09:11:00,5,5,0,洗脚仙人果然名不虚传…第一节课讲了和没讲一样，全靠自学🙏🏻
204374,865,吴春明,2024-11-25 13:47:17,0,0,0,没听过不知道
205147,865,吴春明,2024-12-02 07:04:21,-1,0,1,还可以
205511,865,吴春明,2024-12-08 11:09:01,5,5,0,评了一分给程助教，助教人很好
205512,865,吴春明,2024-12-08 11:08:59,5,5,0,评了一分给程助教，助教人很好
207443,865,吴春明,2024-12-23 07:45:09,4,4,0,老师上课很烂，这届助教飞哥人超好\n\n另外就是会有本科生助教，基本是学过C然后联系打工的，联系了过后好像是可以旷课\n\n\n\n2024/12/23 Update\n\n“你不要管他怎么做，你相信他可以做出来就好了”
209975,865,吴春明,2025-01-07 16:13:29,1,1,0,懒得喷
210632,865,吴春明,2025-01-09 13:27:15,4,4,0,这一分是给助教打的 老师不好评价，但是助教真的特别好
213018,865,吴春明,2025-01-15 15:17:18,1,1,0,wcm我只愿给1分，不知上课所云，但是飞哥助教我给10分，超级好很负责任。\n\n虽然最后被卡了4.2但是我相信飞哥已经尽力在捞我了
28321,869,陈岭,2016-06-28 08:32:41,2,4,2,上课听起来很舒服
28748,869,陈岭,2016-06-28 13:52:58,1,4,3,上课讲的很仔细，期末给分非常好
48866,869,陈岭,2017-03-15 06:21:35,18,18,0,讲道理别坐n*n的位置！
56023,869,陈岭,2017-07-03 02:54:12,9,9,0,n*n那个我笑了
56622,869,陈岭,2017-07-04 06:02:14,7,10,3,上课略无聊。但是很照顾树莓的同学。\n\n人很好_(:з」∠)_好的没话说\n\n会看了考卷再给划重点（嘘
56834,869,陈岭,2017-07-04 23:42:40,0,1,1,很棒～
56847,869,陈岭,2017-07-05 01:04:00,0,2,2,还行吧
79966,869,陈岭,2018-06-17 06:55:22,0,1,1,讲得不是很清楚。可能课堂人太多了也有关系。数据库设计还是挺难的。
81777,869,陈岭,2018-07-06 07:27:17,2,5,3,陈老师的数据库挫败感真的太强了…project要求高，课程容量可以算海量了，期末还考得深…最后不调分???平时认真听课，考试周前刷了三天夜外加一个通宵复习，最后还是绩点惨淡，均绩狂掉…真的太打击人了???
81781,869,陈岭,2018-07-06 07:23:05,3,5,2,昨天沟通技巧被卡绩 今天db被卡绩 这习真是没法复了 感觉老师讲的还行 没点名没小测倒不错 只是不调分的么
84287,869,陈岭,2018-07-12 12:37:12,0,2,2,给分差
85168,869,陈岭,2018-07-16 01:25:44,1,4,3,事情少不应该给分好吗，有点迷
85186,869,陈岭,2018-07-16 03:13:02,3,3,0,数据库设计的部分本身就难，总评低也正常，考试前复习下PPT刷刷历年卷也是可以上4的。
93455,869,陈岭,2019-01-10 00:52:47,0,2,2,辣鸡，给分也差
113902,869,陈岭,2019-07-08 00:15:30,1,2,1,无点名无小测，人很好～
125527,869,陈岭,2020-09-11 04:01:58,1,1,0,好，要主动学习和思考，能拿高分
138120,869,陈岭,2021-07-07 11:52:25,0,2,2,陈老师讲的其实还行。就是自顾自的讲，后面快了就很难跟上了。\n\n然后分数有点低，平时的作业和实验也都认真完成了，期末考感觉还行。但是绩点确实不行，也可能是自己的问题吧。
152522,869,陈岭,2022-04-14 02:59:24,6,9,3,ppt reader
158936,869,陈岭,2022-07-03 13:39:44,7,7,0,数据库系统：虽然读ppt，但是数据库内容真的很多，上课不读ppt基本讲不完。ppt很详细，复习起来也很方便，而且关键地方还是会详细讲的，最后一节课也会带着复习考试重点。体验还不错。
174267,869,陈岭,2023-06-08 12:31:34,6,7,1,给分挺好的呀，老师人也很和善
195307,869,陈岭,2024-06-27 17:19:42,1,2,1,老师感觉人还不错，没有小测不点名，平时可以自己学，就是今年这个题太逆天了直接炸了，吐了
196147,869,陈岭,2024-07-02 01:07:33,2,3,1,无小测无点名无期中，事少到飞起，而且讲课其实挺清晰的（就是有点无聊，但是这门课本身就比较无聊而且内容很多，想要讲生动一点的话就讲不完了）给分也不错，这学期平时作业好像是交了就给满（可能是因为期末太变态了，但是期末分数明显捞了不少）
196801,869,陈岭,2024-07-05 08:06:33,4,5,1,陈岭老师班的数据库可能是事最少的，不点名，不小测，不期中。\n\n数据库这课本身就挺无聊的，隔壁sjl老师讲的稍好一点
220855,869,陈岭,2025-06-20 06:37:55,2,2,0,无点名无小测无期中，期末总评更是把我带到了不属于我的高度
221188,869,陈岭,2025-06-24 04:57:55,6,6,0,岭哥DB真神！\n\n岭哥讲课很清晰，重点突出，尽管来的人特别少也从不点名，出卷子也很善良！
221488,869,陈岭,2025-06-24 04:45:26,1,1,0,上课讲得很快，最后好像多了三周课复习。今年考试很基础很常规，给分也很好
221591,869,陈岭,2025-06-24 17:06:39,0,0,0,无点名无小测无期中，给分不错
20914,872,张泉方,2016-02-03 21:27:23,1,4,3,讲课超级无聊，给分其实也很一般，唯一的好处是每次提前下课。
33646,872,张泉方,2016-10-12 00:34:42,13,22,9,就是就是就是就是就是就是就是就是就是就是就是就就是就是就是就是就是就是就是就是就是就是就是就是就是就是就是就是是就是就是就是就是就是就是就是就是就是就是就是就是就是就就是就是就是就是就是就是就是就是就是就是就是就是就是就是就是就是是就是就是就是就是就是就是
36231,872,张泉方,2017-01-21 14:20:19,9,12,3,听跟没听一个样...
46321,872,张泉方,2017-01-21 08:26:35,-1,4,5,老师人挺可爱的，上课一般，蛮水的，测试不用做，有时候会做课堂小测当点名，课堂小测都很简单，助教很很好，给分好，浓浓师生情
46418,872,张泉方,2017-01-21 13:48:05,2,4,2,老师上课挺无聊的  不如自己看一遍书  不去也没什么关系  但最后给分还不错哦
47700,872,张泉方,2017-02-19 05:34:37,3,9,6,张老师真的是很认真、很认真地在讲课。。。(当然听不听是自己的事情orz)，平时作业认真做，考前突击一下，给分就很不错。
59826,872,张泉方,2017-09-27 08:49:13,4,5,1,听和不听一样
60614,872,张泉方,2017-10-25 09:12:41,2,3,1,这老师蛮好 （对于大计基这门课而言）课下不经常给我们布置作业（主要是他自己也懒）所以我们的作业压力小 至于学到什么东西嘛 不存在的 你在底下最自己的事他也是无所谓的 所以是一节没什么课后作业的自习课 而且作业遇到问题吧还有贴心的助教小哥哥！！人真的巨好啊！！！比一万个心！！！
65351,872,张泉方,2018-01-03 08:01:56,2,3,1,上课很水  不如当自习看看书  给发邮件也不回  上课喜欢讲计算机领域的故事  但是助教真的超级好啊啊啊！群里一直不厌其烦地回答问题 找他也是及时回复 浓浓师生情/滑稽
66749,872,张泉方,2018-01-18 23:56:38,2,4,2,说实话老师讲课水平一般，一上去可能会有一段时间不适应完全听不懂，但是好好听的话还是挺有意思的。但是真的是事很少，别的班期末还有论文什么的我们都没有～实验也少，嗯，总体来说还是很不错的一个老师。
67237,872,张泉方,2018-01-20 13:35:21,0,2,2,没有上老师的课，但是答疑的时候过去问老师。很耐心讲完了。态度超级好。还给我拷了PPT。
79045,872,张泉方,2018-05-21 11:10:57,3,4,1,\n\n真的自学万岁\n\n
83699,872,张泉方,2018-07-11 04:29:33,4,5,1,计网浓浓师生情 \n\n给助教姐姐笔芯
84016,872,张泉方,2018-07-11 23:24:42,0,1,1,张老师很努力地讲课 但是效果似乎并不好qwq\n\n靠自学吧！尽早开始复习哦，计网这门课真的是越学越有趣。\n\n最后表白师生情，给分很nice
84123,872,张泉方,2018-07-12 05:17:54,0,1,1,高云君
101646,872,张泉方,2019-01-29 01:33:24,3,6,3,为什么没有零分？\n\n为什么没有零分？\n\n为什么没有零分？\n\n教你?呢
131253,872,张泉方,2021-01-27 00:25:46,0,2,2,讲课很一般，这次考试很多考研原题！希望能拿到满意的分数
132707,872,张泉方,2021-02-03 11:36:15,1,4,3,本以为这学期最低分是毛概，没想到居然是计网，出分之后群里没一个人谢谢老师还挺真实的
132839,872,张泉方,2021-02-04 05:19:21,12,13,1,讲课很烂，不需要听，听课建议看邱劲松老师的。\n\n作业题要认真做，今年的考试很多都是作业题，我考前晚上背了一下，很有帮助。\n\n课程质量很低，但课程本身重要。
132864,872,张泉方,2021-02-04 08:27:05,8,8,0,堂堂课点名 听和不听一个样
133415,872,张泉方,2021-02-28 02:46:09,1,1,0,看这个名字第一眼想到泉此方…………
141474,872,张泉方,2021-10-11 06:04:27,1,1,0,就是就是
142508,872,张泉方,2021-11-12 11:00:22,-1,3,4,烂死了，我操，python不讲让我们自学，你拿着工资干啥吃的？每回作业都那么多，六十几道作业题，真尼玛无语了，天天上课刚讲完就小测，草了，无语了，浙大怎么会有这老师
142700,872,张泉方,2021-11-15 08:14:07,3,4,1,作业好多╯﹏╰
143892,872,张泉方,2021-12-10 11:04:51,4,4,0,真牛啊，python考试范围讲不清楚就算了，教也基本不教，直接说“网上都有的，教得比我好”。既然这么有自知之明还点名干嘛呢？学生来上课不也是浪费时间
144589,872,张泉方,2021-12-22 12:56:58,5,6,1,每节课都点名 屁事贼多
144730,872,张泉方,2021-12-23 10:56:07,6,6,0,老师每节课都会点名，不过其实是数字点名。理论都靠自学。8分给助教yyrxgg，实验讲解特别清楚容易理解，也特别用心。有问题基本秒回。感谢TA。
148499,872,张泉方,2022-01-12 16:45:24,7,7,0,节节课点名，隔一次课有课堂练习，考当堂的知识。\n\n不过老师个人性格十分温柔。\n\n助教很强，他讲Lab7的Cpp多线程编程的那一夜，那些类，信号量结合的技巧让我能回味到现在。。。
149305,872,张泉方,2022-01-15 04:38:10,6,6,0,每节课会点名，但是是数字点名也不会管你是智云还是什么。隔堂会有小测，都是作业题和上课讲的内容，可以提前把作业题做了。\n\n表白助教xgg，实验讲的真的好，lab7的例程看得我直接下跪。\n\n考试很多是作业题和王道上的题，最后给分也是浓浓师生情。\n\n不太好的地方大概是上课有点枯燥也有点急，可能是计网这门课本身内容就很杂乱，没有学完很难独立地明白上课内容。如果想要学好的话建议先过一遍王道，有了初步认识后再上课。体验会好不少。
149472,872,张泉方,2022-01-15 13:29:47,0,0,0,（计网）1.每节课都要点名，不要错过签到；2.作业记得按时完成；3.个人感觉预习/复习效果：看王道408>看课本；4.考前刷一遍王道选择题是个不错的选择；5.助教gg非常nice；6.有能力的话，实验八的bonus最好做掉；7.给分的话，感觉主要还是看期末；
149793,872,张泉方,2022-01-17 03:36:36,0,0,0,我只想说快跑，听他的课和没听一样，还不如自学，作业多，每节课都点名，我是学的他的大计基，已经感到无语了
150182,872,张泉方,2022-01-20 02:11:29,2,2,0,老师人还是挺好的
150286,872,张泉方,2022-01-21 12:08:26,3,3,0,“就是...、就是...”
154919,872,张泉方,2022-06-07 01:58:16,0,0,0,大计基上老师的课其实学不到什么与考试有关与作业有关的干货，用的PPT和课本不太一致，但是平时看题库作业认真做还是有不错的分数。秋冬选的，回来补评分。
161005,872,张泉方,2022-10-23 16:22:11,0,1,1,可能老师有点巨吧，他上课有点听不进去。不过老师还是很负责的，就是作业和小测有点多
162464,872,张泉方,2022-11-23 02:53:38,0,1,1,老师可以打8分，助教可以打10分！
166319,872,张泉方,2023-01-12 02:30:55,0,1,1,老师明年退休了\n\n出分前评价一下\n\n讲课确实有点催眠\n\n但是人真的很好\n\n助教也很棒\n\n希望老师最后一届能小捞一丢丢
168708,872,张泉方,2023-02-21 09:22:28,0,0,0,。。。
169494,872,张泉方,2023-02-26 12:21:15,0,1,1,助教虽然负责，但是给分确实一般，小测全满的，但是实验的平时成绩还是扣了总评的三分
169516,872,张泉方,2023-02-27 00:26:37,3,6,3,出的什么几把试卷\n\n还不捞人\n\n还好退休了\n\n快滚吧
169538,872,张泉方,2023-03-02 07:21:57,2,4,2,试卷出成什么b样子你们心里真的没点b数吗\n\n还给这么差的分\n\n操你妈
170112,872,张泉方,2023-03-01 11:41:20,2,3,1,实验也太严了吧，平时作业几乎满分平时分比舍友少好几分
170308,872,张泉方,2023-03-02 15:36:01,3,4,1,整个计算机网络课程组都是傻逼
170674,872,张泉方,2023-03-08 02:42:38,3,3,0,傻逼计算机网络课程组\n\nnmmsl
177451,872,张泉方,2023-07-03 09:54:42,1,1,0,时隔半年再来骂一下\n\n还好这个b退休了
108820,876,陆系群,2019-06-03 02:50:11,0,0,0,我是沙发？
120557,876,陆系群,2020-01-12 22:23:56,0,1,1,无语，不知道什么标准
133003,876,陆系群,2021-02-06 05:49:48,6,9,3,大家一定不要去选qjs的计网，赶紧跑！
134317,876,陆系群,2021-03-23 12:20:07,7,9,2,苦口婆心的陆奶奶，你们现在不学习，难道到了我这个年纪再学吗？！实验课的课件是老师很用心自己做的，希望大家可以学到知识。另外助教xgg人超好，还录做实验的视频传到B站给我们看
147617,876,陆系群,2022-01-10 10:03:03,0,4,4,等所有实验做完之后才说lab8不算分（bonus都没有）。\n\n期末考试最后一道题5个空，没写单位KB就各扣一分。（不知道是所有班的标准还是只是陆老师班的）\n\n不太能接受。
147624,876,陆系群,2022-01-10 10:26:43,1,4,3,老师人是挺好，但是平时分被莫名其妙扣了挺多，有点难受呜呜，还是要慎重
147858,876,陆系群,2022-01-11 04:20:15,0,4,4,1. 平时分本来以为很好，但是没有bouns，实验报告她又喜欢扣分，所以给分实际上很差\n\n2. 考试喜欢抠一些无关细节，平白无故扣5分，似乎只有她这样扣，分数会比别的班低很多
148002,876,陆系群,2022-01-11 09:48:46,2,4,2,老师人挺可爱的，但是平时分不知道为什么被扣了好多分（小测，作业，实验一样没落下）
149636,876,陆系群,2022-01-16 08:47:12,2,2,0,老师是一个完美主义，对学生要求挺严的。上完课会发很多参考资料。
150348,876,陆系群,2022-01-23 02:22:15,0,2,2,给分奇差，作业报告都交了，报告就是按模版写，也能在平时分里扣8分，考试也才扣9分。嘴上说着希望我们都能考好学好，结果给我们到处扣分
159872,876,陆系群,2022-09-07 07:32:10,5,5,0,其实挺好的，期末考试一开始多扣的分寒假又给大家加回来了
165726,876,陆系群,2023-01-09 12:40:10,4,4,0,我说两句公道话，去年有好多骂陆老师的，因为单位扣分，这个确实该喷，但关键是最后给大家都加回来了。\n\n关于实验报告的话，陆老师自己亲自改确实分给的不高，但是今年有助教了是助教改实验报告，给分还是挺好的，只要你是自己认真做的不差步骤都基本会给满实验分（不要从别人实验报告里截图应付）。\n\n陆老师的HW和quiz是不论成绩交了就给满。\n\n大家自己考虑吧
165734,876,陆系群,2023-01-09 12:44:34,7,7,0,2022年秋冬学期：陆奶奶绝对是计网这几位里面教的最好的。想认真听课建议选陆奶奶，虽然平时会要求严格但是都是刀子嘴豆腐心。这年头自己做ppt和写代码的老师不多了，大家珍惜一下吧！只要认真听课，实验作业做完，平时分差不多就满了。期末的话陆奶奶会讲的很全面，考试最大的感觉就是庆幸听了课，该讲的知识点全到位了，真的很感谢也真心推荐好老师。
165736,876,陆系群,2023-01-09 12:55:31,4,4,0,讲课真的非常认真，你绝对找不到计网讲课更认真的老师，踏踏实实在教知识
187364,876,陆系群,2024-01-15 15:22:11,9,9,0,出分前：我们班这么多lab平时分估计扣很多\n\n出分后：lxq牛逼
187564,876,陆系群,2024-01-16 14:50:32,10,11,1,陆奶奶讲课很细很认真，课后还会经常给大家发补充的参考资料，只要认真听是能学到很多东西的\n\n实验虽然数量不少，但模拟机/编程实验不需要去实验室做，而且只要认真完成都能取得不错的分数
207699,876,陆系群,2024-12-24 02:27:46,4,4,0,先给老师打个满分，上课认真程度真的拉满了，老师人也好沟通，助教wxbgg更是神中之神🥺强烈建议专业课助教都让上一级本科生来当，真的人好又热心负责
213204,876,陆系群,2025-01-16 09:54:21,1,2,1,老师很严苛，给分一般吧，但上课很认真，助教特别特别好，是三年来遇到最好的助教，考试前一晚通宵答疑，平时有问题也帮忙debug
56770,886,郑扣根,2017-07-04 14:51:32,7,7,0,第一次写老师的评价...\n\n建议就是别选这个老师\n\n会后悔的
56934,886,郑扣根,2017-07-07 03:39:51,5,5,0,垃圾老师，毁我青春
57113,886,郑扣根,2017-07-05 14:24:41,0,0,0,老师上课自己上的很开心 是个绩杀 慎选
57162,886,郑扣根,2017-07-06 00:34:16,7,9,2,第一次在查老师里骂老师。所有计网老师里给分最低，mmp怎么劝也没用，就是要给全班低分。学弟学妹！慎！选！好了，说完了，凭良心讲，计算机水平很高，上课讲的其实不错，英文应该是全计院最好的（不在意分数的话也可以选）。
78763,886,郑扣根,2018-07-13 01:59:29,10,13,3,英语还行，上课一般，有点自嗨，说话一股土脏味:本小姐blabla，老子blabla...  训斥学生:你这个土人...\n\n 给分极差，差的意思是比其他班低2-3档的样子。选之前想一想，为什么不对自己好一点呢？
81715,886,郑扣根,2018-07-06 03:06:26,0,0,0,出卷子超级难\n\n
82522,886,郑扣根,2018-07-13 08:40:06,3,4,1,给的十分攒人品 算了还是给1分吧
84346,886,郑扣根,2018-07-12 15:21:47,6,6,0,上课一般，给分所有老师里最差，别选他
84449,886,郑扣根,2018-07-13 01:29:44,3,3,0,lj老师，别选
86061,886,郑扣根,2018-09-01 10:05:53,2,2,0,不怎么样
103085,886,郑扣根,2019-02-26 02:28:24,0,0,0,.\n\n.\n\n.
113170,886,郑扣根,2019-07-06 01:02:54,0,0,0,辣鸡玩意儿
114618,886,郑扣根,2019-07-11 01:05:49,0,4,4,上课一般，但是谁再说老师绩杀我跟他急哦！认真学的话没问题的
150211,886,郑扣根,2022-01-20 11:06:24,0,0,0,我考的很烂，但老师给分不错
150854,886,郑扣根,2022-02-19 22:57:56,-1,1,2,来评分
152541,886,郑扣根,2022-04-14 09:20:06,3,3,0,坐前几排也是听不清老师讲话。。
166693,886,郑扣根,2023-01-13 08:49:32,16,16,0,我也来说说老师的优势吧。郑老师班比较轻松。上课不点名，不上实验课，作业不多，ddl前公布作业答案，而且不查重实验（老师可能觉得教改以前的实验确实不值得做），所以适合打算水过的同学。\n\n老师个人知识储备丰富，上课的时候会有些发散，所以学长学姐们会觉得上课一般吧。但是我本来就不太喜欢听课，上课就是低头写自己的代码，所以这学期体验也还好。\n\n（另外，老师说他说的“烂”“土”这些都只是口头禅而已，没有攻击谁的意思，他说自己的什么东西也会说是“烂”+名词，他自己的网名也是“土人”。）
189141,886,郑扣根,2024-01-22 06:11:35,1,2,1,老师今年退休了，最后一年给分还是不错的。
189273,886,郑扣根,2024-01-22 17:51:36,1,1,0,给分就暂且不论了，毕竟老师要退休了，这个也没什么参考价值了。老师很用心，而且挺认真教书的，希望他退休愉快！
206616,886,郑扣根,2024-12-16 13:49:16,10,11,1,不是很懂为什么单独交了pdf但是zip里还要交pdf，格式分占了一大半。不过可以补交还算不错。\n\n但是课上说平时做的非常好也就45，大部分人还不错的也就40分，希望最后别真是这样、、、\n\n最后一年了，也没有给后人参考的意义，单纯吐槽一下
207615,886,郑扣根,2024-12-23 08:56:29,8,8,0,“老子机枪扫死你们这群烂人”
212812,886,郑扣根,2025-01-15 03:19:58,3,3,0,啊啊啊啊kg！能不能补药扣我平时分😭😭😭
212849,886,郑扣根,2025-01-15 05:04:58,3,3,0,好老师！
213308,886,郑扣根,2025-01-17 01:54:00,3,3,0,老师真的挺不错的，说实话挺为学生着想的，今年给分也挺好，不过老师退休了，祝老师退休快乐吧！
34,936,翁恺,2015-03-14 15:29:45,12,26,14,良心老师！老师我爱你！
45,936,翁恺,2015-03-14 15:31:39,93,126,33,翁恺脑残分！如果从最初的编程语言基础课都是这样的老师的话一定能学到很多东西。
382,936,翁恺,2015-03-15 01:44:09,82,104,22,不会照本宣科，不会念ppt，即使ppt做的很简洁有趣，不会空谈理论……是一门可以水但你不会去水的课
440,936,翁恺,2017-09-01 19:56:34,229,280,51,上翁恺老师的课收获很大，老师上课也很有趣，很能讲故事。即便是上一门基础编程语言课，所学到的也不仅仅是一门编程语言，而是对计算机科学技术更综合的认识。
527,936,翁恺,2015-03-15 04:19:49,30,46,16,翁老师虽然教计算机，但是知识面非常广博，而且声音超好听!上课非常有乐趣！
572,936,翁恺,2015-03-15 05:39:07,66,83,17,我在网易听的 也现场听过老师的课 非常好 老师真的是想把计算机内部的原理将给大家 让大家更透彻的理解一些语言 还有 老师的声音简直让人听了停不下来！！
623,936,翁恺,2015-03-15 08:17:33,13,20,7,超萌的老师，很有人格魅力。
922,936,翁恺,2015-03-19 02:29:53,54,70,16,脑残粉怒赞！！！！！恺哥哥的课一个都不放过！！
1105,936,翁恺,2015-03-21 16:10:22,10,17,7,水平高，有时自己会跟不上，不过讲得确实挺不错\n\n
1210,936,翁恺,2015-03-21 16:40:42,5,12,7,不能再棒！男神的魅力
1322,936,翁恺,2015-03-21 23:56:11,0,6,6,好老师啊好老师\n\n
1672,936,翁恺,2015-03-23 07:19:53,31,42,11,第一次上课就爱上这个老师了。上课一点也不枯燥。瞬间爱上java课。变身脑残粉。
1852,936,翁恺,2015-03-26 02:08:33,3,10,7,脑残粉
1993,936,翁恺,2015-03-28 06:06:12,2,8,6,声音超好听，当然课也很棒
2063,936,翁恺,2015-03-31 06:42:06,7,10,3,老师说话不要太好听 人也超级有趣
2733,936,翁恺,2017-03-20 03:35:03,134,154,20,听MOOC最大的感想就是……他的两只剪刀手Y(^_^)Y\n\n
4256,936,翁恺,2015-06-18 10:55:29,1,8,7,男神
4747,936,翁恺,2015-06-27 07:57:06,6,13,7,fm脑残粉路过(≧3≦)
4949,936,翁恺,2015-07-01 11:03:34,4,8,4,让你了解现在的前沿计算机科学
5050,936,翁恺,2015-07-02 14:53:53,8,16,8,上得很好，但不适合小白学习……
6007,936,翁恺,2015-07-10 07:38:45,-3,3,6,超级好的老师
6185,936,翁恺,2015-07-11 16:16:50,0,6,6,简直棒！
7629,936,翁恺,2015-09-15 06:53:53,-1,3,4,舒服，讲的清楚，云课堂也不错
8645,936,翁恺,2015-09-23 12:36:41,8,16,8,恺哥的mooc救了我的java 另外怎么没人说恺哥帅
12033,936,翁恺,2015-12-21 14:30:01,0,5,5,MOOC上完赶来点个赞\n\n
12691,936,翁恺,2015-12-24 02:05:53,0,3,3,让汉子都喜欢的老师
13856,936,翁恺,2016-01-01 10:41:15,-11,3,14,好久不去上课了。。
19184,936,翁恺,2016-01-23 12:00:02,-1,3,4,讲得很好很透彻
19292,936,翁恺,2016-01-23 23:31:11,2,6,4,人好水平高给分好≥﹏≤
19848,936,翁恺,2016-01-25 11:53:20,-2,3,5,男神不解释\n\n
20684,936,翁恺,2016-01-29 17:16:46,5,12,7,脑残粉+1 超级超级超级超级棒的老师 希望以后还可以听他的课～
20879,936,翁恺,2016-02-03 00:08:03,1,6,5,翁恺老师的授课体现了思维的灵活性和广度，受益匪浅
20927,936,翁恺,2016-02-04 08:28:56,-1,4,5,良心老师！赞
21252,936,翁恺,2016-02-27 13:50:05,0,4,4,想去课堂听他上课
21634,936,翁恺,2016-02-29 11:09:10,2,5,3,超级棒！！！！
21887,936,翁恺,2016-03-01 12:14:37,2,5,3,声音狂好听 人格魅力 男神！！
22158,936,翁恺,2016-03-02 23:37:37,1,4,3,声音超好听啊！人很帅！讲的很棒！MOOC视频收藏了！！！
22204,936,翁恺,2016-03-03 02:38:37,-10,15,25,并没有传言的那么好，给分异常不客观，没有依据的低，非常看人
23205,936,翁恺,2016-03-22 01:30:11,0,4,4,mooc大赞
23282,936,翁恺,2016-03-23 12:30:12,9,15,6,浙大最帅男老师fat mouse
23960,936,翁恺,2016-04-22 17:10:23,1,4,3,很好，
25542,936,翁恺,2016-05-25 02:34:25,21,29,8,mooc太棒了…声音超有磁性，普通话字正腔圆，听起来就是一种享受，关键是声音好听就算了还循循善诱，讲解细致，ppt简洁有重点，太棒了????????
25802,936,翁恺,2016-06-08 12:06:21,1,5,4,老师的脑残粉啊啊啊啊啊 颜好低音炮 幽默有水平 慷慨大暖男 第一次这么热爱编程
26050,936,翁恺,2016-06-15 08:33:40,2,6,4,不说了，男神。
26229,936,翁恺,2016-06-16 10:10:40,1,7,6,大赞，上他的大C很有收获
27406,936,翁恺,2018-02-06 10:10:09,14,21,7,不适合小白\n\n
27640,936,翁恺,2016-06-27 06:09:12,-1,5,6,绝对是男神啊 老师超可爱 六一节还在群里给大家发红包 而且平时作业超级少 人灰常灰常好
27813,936,翁恺,2016-06-27 16:23:42,-1,4,5,声线迷人！帅气挺拔！讲解清晰！有不爱恺恺的理由么？！
29239,936,翁恺,2016-06-29 13:12:55,0,5,5,体系结构有点难啊
29311,936,翁恺,2016-07-05 05:40:05,-20,27,47,我看老师好不好，从不单看他教的好不好，还要看他的师德师风如何，一个不关心学生的老师永远不是好老师。若你真情实意地给老师发邮件，他只用冷冰冰的几个字否定，你还会叫他男神？装什么高冷，他只是普普通通的一名教师，并不比任何人高贵。
29558,936,翁恺,2016-06-30 03:20:21,-1,4,5,老师超级好，声音好听。讲课也讲得很有趣。
31524,936,翁恺,2016-07-04 05:11:44,0,4,4,老师是真的很好
31963,936,翁恺,2016-07-05 08:37:00,3,6,3,翁男神的声音！简直让我没法不听课！！
32555,936,翁恺,2016-07-07 17:06:30,12,22,10,翁恺老师师德，我没有发现问题，每次有什么事情都很耐心帮你解决，而且第一节课去补选的人老师都满足了需求。冷冰冰三个字是事出有因，翁老师较真，不签“小”学期的条子，只能说老师太有个性了，指责师德是不是有点草率和无端？还是要给耐心的老师给个高分。
33094,936,翁恺,2016-09-12 15:00:45,-1,3,4,一种享受，让人爱上计算机
34280,936,翁恺,2016-09-29 15:27:00,1,5,4,可以 很清真\n\n
34857,936,翁恺,2016-10-25 09:17:11,1,2,1,厉害了我的男神
38478,936,翁恺,2016-12-06 13:18:16,0,3,3,真的很棒，没选上的同学可以看mooc
39704,936,翁恺,2016-12-27 04:52:31,4,9,5,只在慕课上听过翁恺老师的课，脑残粉一枚，好想见一下本尊，然而没选上他的课，不开心
40434,936,翁恺,2017-01-03 09:24:51,-21,6,27,全计院最水老师之一，平常没事给发高
40521,936,翁恺,2018-09-17 07:27:41,13,30,17,这个绝对男神呀～～讲课可以听得出来老师是真的自己彻底理解，然后用学生最容易理解的方法讲给大家。平时萌萌哒，唯一一次说话超级严肃是告诉学计算机竞赛的同学要忘掉当年应试的坏习惯，要为自己将来的industry生涯打好基础。不仅只是讲得好，而且会讲人生态度的问题。上节课讲期末考试，告诉大家考场上什么问题都可以问，不要因为觉得老师可能不会回答就不敢提问，真的有在国外上学的感觉～还有发现一个小现象…当我炫耀微积分、线代等等的老师时大家一般都是一脸羡慕或者嘤嘤嘤…但是等我炫耀翁恺老师的时候…基本对方都是默默不说话…还有说不适合小白的…我们是全英文上课，学好英文再来说呀!老师确实个性，这才是男神的萌点呀～
44840,936,翁恺,2017-01-18 11:14:36,5,10,5,浙大最爱的老师系列之一～\n\n可惜为什么我下学期选不上了啊～……
44864,936,翁恺,2017-01-18 11:55:55,3,4,1,非常棒
44973,936,翁恺,2017-01-18 16:34:49,2,4,2,男神一生粉，对计算机内部结构讲解的透彻至极，学他的c真的是一种享受，就算之前自己会，也绝对会跟着听，收获真的特别大
45082,936,翁恺,2017-01-19 02:52:16,1,2,1,很棒\n\n
45840,936,翁恺,2017-01-20 07:12:00,2,2,0,好老师，没话说\n\n
46145,936,翁恺,2017-01-20 16:29:22,0,2,2,男神男神超级
47322,936,翁恺,2017-01-25 08:54:02,2,4,2,体系给分不错 java给分一般
47323,936,翁恺,2017-01-25 08:54:23,3,5,2,老师人好好啊哭
47583,936,翁恺,2017-02-03 00:48:48,-1,2,3,好老师啊
47910,936,翁恺,2017-02-27 08:43:10,2,3,1,讲的不能再好 认真负责有耐心～～～说起来光听他的声音就可以怀孕?
50765,936,翁恺,2017-05-05 05:01:35,-5,6,11,给分比较看熟人……
51738,936,翁恺,2017-06-09 02:32:53,3,8,5,互评界的一股清流
51740,936,翁恺,2017-06-09 02:38:14,7,9,2,互评界的清流
51742,936,翁恺,2017-06-09 02:55:55,1,3,2,互评界一股清流
52043,936,翁恺,2017-06-14 09:49:45,1,4,3,人很好\n\n
52089,936,翁恺,2017-06-14 14:20:29,6,8,2,翁老师真男神！上课很有趣，你想水都不会去水～收获的不仅是选课内容，还有各种计算机知识，各种课外话题，这学期有幸能在java生日上java 课，翁男神破费给我们吃蛋挞以祝贺～总之强推男神的课！
52644,936,翁恺,2017-06-22 01:28:10,-2,2,4,男神没的说
52845,936,翁恺,2017-06-23 07:17:59,1,4,3,感觉很棒
52872,936,翁恺,2017-06-23 09:08:31,4,6,2,提醒大家一声关注微博
52894,936,翁恺,2017-06-23 11:34:02,-6,3,9,一般般
55238,936,翁恺,2017-07-01 05:17:19,4,6,2,老师讲的很好，是我拖累了均?，只求老师不让我挂，爱您
55837,936,翁恺,2017-07-02 12:41:54,2,3,1,挺好的吧
57271,936,翁恺,2017-07-06 10:21:46,-3,9,12,只上过沟通技巧  一堆事，没卵用不说，辛辛苦苦忙了一学期，一个小组都是2+的绩点，我们没比别的小组做的不认真，只能说给分真的不合理，辣鸡
58123,936,翁恺,2017-08-03 00:13:55,0,2,2,慕课过来的。老师太好了太良心了，赞(｀･ω･´)ゞ！
58846,936,翁恺,2017-09-18 05:30:40,2,2,0,相当值得一听！
59123,936,翁恺,2017-09-20 00:11:10,0,2,2,讲得好，人也幽默，已成为脑残粉。
59250,936,翁恺,2017-09-20 11:08:07,1,2,1,我觉得很好
59332,936,翁恺,2017-09-21 02:23:31,4,6,2,每次上翁男神的课，一边觉得自己好low，一边觉得灵魂得到了升华和拯救～不说了，我去速成Java了（捂脸）
59399,936,翁恺,2017-09-21 06:45:03,1,4,3,短学期课太开心了，有趣有收获有分数，谢谢老师
60717,936,翁恺,2017-10-28 02:12:44,0,2,2,感觉很棒，平易近人
61016,936,翁恺,2017-11-07 03:20:42,3,3,0,男神啊
61120,936,翁恺,2017-11-08 23:54:10,1,5,4,老师真的棒，我忘交了一次pta，跟他说了之后，他专门开了一次补分题，好感动啊！
63258,936,翁恺,2017-11-29 14:20:26,19,22,3,程序设计方法学拍拍脑袋设计了一个 mua 语言让学生写解释器，文档非常不清楚，语言有歧义。要写能不能选个成熟的语言啊...
63612,936,翁恺,2017-12-09 10:16:03,2,2,0,感谢翁恺老师，老师的课程对我来说不仅帮助很大而且重新唤起了我对于计算机的热爱～
64029,936,翁恺,2017-12-20 14:52:59,0,1,1,幽默生动，知识广博，因为上节有课，所以每回都只能坐最后几排，即使这样也根本水不起来
64385,936,翁恺,2017-12-23 06:02:19,1,2,1,。。。
64523,936,翁恺,2017-12-25 02:37:13,36,41,5,一觉起来两个作业一个大程岂不是美滋滋
65379,936,翁恺,2018-01-03 12:32:16,20,30,10,真的不怎么样\n\n主要是乱布置作业\n\n一点都不上心
65581,936,翁恺,2018-01-06 13:20:04,-1,3,4,好老师。上课思维清晰，表达流畅，讲解清楚，穿插不少计算机科学方面的知识，能感受到老师的专业素质与学者风范。
65989,936,翁恺,2018-01-10 18:48:19,25,32,7,这学期大概是完全心不在焉了吧。简单说说他这学期的三门课。\n\nppl:自己设计了一门语言，然而bug不断，各种小毛病，要求不清楚，我们实现期间也动不动改需求(程序员最最最讨厌的事情了)，一不小心就要把辛苦写的东西推倒重来，对于同学提的问题甚至能直接称之“弱智”。java;大半个学期过去了只布置了一个小作业，期末临近了大家最忙的时候一股脑把一学期的作业全放出来，呵呵呵。体系:这个不太清楚，但是听说和java一个尿性。
66277,936,翁恺,2018-01-14 13:23:51,31,42,11,讲课还行 作业布置真的很迷 要求从来不清 ddl前改要求 官网挂的要求什么时候更新了也不知道 还有期末突然一坨作业
68365,936,翁恺,2018-01-23 05:14:34,2,6,4,编程语言原理建议和Java配套食用
70316,936,翁恺,2018-01-26 12:27:01,7,9,2,翁恺男神救我oop！！！QAQ
71111,936,翁恺,2018-01-28 03:11:52,-34,9,43,oop还没出分，不过应该是满了。在男神手下拿下第二门满绩（第一门是arduino），男神上课真的很有趣，会和我们分享他曾经的故事，比如什么不检测printf函数的返回值导致u盘损坏啊，超有意思，希望下学期的沟通技巧，大三的java技术和程序设计方法也能在男神手下拿到满绩！
71388,936,翁恺,2018-01-28 11:29:23,1,4,3,天哪怎么会有长得又帅 专业知识有丰富 脾气又好 上课又风趣的而且很博学的老师 给分也很好诶。我以前不喜欢计算机的 但是上了fm的课 真的......哇
71389,936,翁恺,2018-01-28 11:30:02,3,4,1,天花乱坠
71390,936,翁恺,2018-01-28 11:31:07,0,2,2,翁恺男神！！！！！
71393,936,翁恺,2018-01-28 11:34:34,2,3,1,超级好，人生阅历丰富，既有学者风范，又有暖男气质，浙大好老师。
71394,936,翁恺,2018-01-28 11:34:44,0,1,1,知识面广，很有收获
71396,936,翁恺,2018-01-28 11:35:34,0,2,2,非常好的一个老师，虽然我是一只菜鸡，但是老师的课真的很好
71402,936,翁恺,2018-01-28 11:45:31,3,4,1,fm的课真的超级好，虽然专业不是计算机相关，但是fm却能让我在他的课程中感受到计算机的美学，甚至有转去学计算机的想法（手动捂脸），老师的课绝对值得一上！！
71436,936,翁恺,2018-01-28 12:37:24,1,3,2,男神，男神，男神，没有更多的话，真的是男神！
71452,936,翁恺,2018-01-28 12:59:40,4,8,4,学的时候一直跟不上，花了好多时间，最后理论考46分，真的很难受，结果最后关门分45分！超级感激翁老司！顺带建议大家从头开始就要好好学，多看慕课，不要抄作业！
71498,936,翁恺,2018-01-28 14:06:45,2,3,1,666
71505,936,翁恺,2018-01-28 14:10:52,-1,3,4,老师上课更注重实际的运用而不是课本上一些十几二十年前传承至今低效率繁文缛节的套路，总的来说，老师很实在，心肠很好，比心心。
71761,936,翁恺,2018-01-29 02:49:01,0,1,1,特别棒\n\n
72167,936,翁恺,2018-01-29 13:45:33,55,74,19,翁恺三连，苦不堪言
72288,936,翁恺,2018-01-29 22:26:23,2,6,4,没选上翁老师的课，很难过……不过翁恺老师的mooc拯救了我，在我错过实体课的很多重点知识的情况下，翁恺老师的mooc救了我。mooc上老师语速适中，知识体系完美，学到很多东西，又不感觉枯燥，创业基础真的应该向翁恺老师的mooc学习（同样是mooc，差距咋就这么大呢）。在mooc层面上，个人给出绝对好评。
72384,936,翁恺,2018-01-30 04:19:19,2,5,3,翁老师教的东西很实际，给分也很求是。能学到东西。
72442,936,翁恺,2018-01-30 06:42:24,7,12,5,计院鹅颈传统不能丢，没讲要求essay也要写个一万字。否则让你总评比考试成绩还要低。hhhh
73660,936,翁恺,2018-02-03 14:28:05,0,5,5,出分了再来评一波。平时上课比较难，建议跟不上的同学及时去看老师的云课堂，那里面讲的比较通俗易懂。另外老师人超级好，很为学生考虑，怒赞一波。
73798,936,翁恺,2018-02-03 06:09:25,1,4,3,讲课超级棒，给分也很好
73873,936,翁恺,2018-02-03 09:36:13,-6,3,9,男神妥妥的！！\n\n不仅声音好听，教的还非常棒，在他这里得到了大学里第一个满分，开心死！
73884,936,翁恺,2018-02-03 10:15:39,3,4,1,还好带病考试没拉低均绩，总评还多给我了一分。\n\n平时教学重点没有在考试中体现，因为填空题不是他出的哈哈哈。\n\n课件做得很不错，对c++的定位也看得很清晰。
74157,936,翁恺,2018-02-06 02:35:12,19,24,5,他不看代码的，大程随便糊弄就好了
74158,936,翁恺,2018-02-06 02:37:21,32,46,14,翁恺的学术精神有着严重问题，对于大程根本不在乎程序表现，完全根据报告瞎给分，使得许多根本没有实现程序只是糊了报告的投机之辈获得了高分。并且对于作业布置非常随意，需求一再改动，模糊不清；对于学生的礼仪严重不足，甚至出现当众群内辱骂学生的话语；发送邮件回复极慢或者不回。总之，上课上的不错没的黑，但是治学精神有误，也是没得洗！
74351,936,翁恺,2018-02-13 07:20:40,36,43,7,翁恺这学期开公司去了吧，感觉完全没关注教学，课讲的还是很不错的，有段子有干货，但是你的作业也太随意了吧。体系结构造流水线cpu，实验三造naive版本的实验四造正常版，结果实验三布置下去一个月后（翁恺说2周一个实验，此时理论上应该实验三ddl已到），实验四上这课的各位小盆友都做完了，去课程网站发现，实验三的实验报告提交端口还没开...\n\n  java直接绝了，9月份开学，到了12月25日，除了一个估计是从隔壁程序设计方法学搞来的一道基础编程题（输入四则运算表达式计算结果），就没有作业，圣诞节起床发现扔下来3个编程作业，当时直接尿了。但是仔细看题以后发现，除了miniCAD可能需要费点时间，其他不摸鱼可以1小时内解决一道，作业感觉就是现场拍脑瓜想的（题干的英语不错，赞一波翁恺的英语）。作业估计是只要交了别太过分都有高分，主要看期末考试
74354,936,翁恺,2018-02-13 17:37:40,-24,9,33,给分厚道，我这么菜的也4.8了
76392,936,翁恺,2018-09-17 10:13:29,27,47,20,别人课五个人一组三选一，ddl两周，我们课一个人一组三道全做，ddl一周，整个清明节两天全天都在写代码，别人都出去玩了或者回家了，现在我还在写第三道题。虽然我知道是我自己太菜了，我现在仍然不能停止抱怨。1分。
77606,936,翁恺,2018-05-07 01:59:07,-2,4,6,他好帅！我好爱他！
77607,936,翁恺,2018-05-07 01:59:29,3,4,1,………
78687,936,翁恺,2018-05-14 12:48:29,-1,2,3,棒棒 MOOC上讲课认真细致
79719,936,翁恺,2018-06-13 03:56:36,-2,5,7,OOP都几乎不布置作业的…感觉学不到什么，别选他的课
80202,936,翁恺,2018-06-21 11:49:50,0,5,5,老师真的很好！
80693,936,翁恺,2018-06-29 10:08:18,14,17,3,(强压怒火)你再好好想想？
82924,936,翁恺,2018-07-09 10:09:04,-1,3,4,看的网课，tai bang le
84097,936,翁恺,2018-07-12 04:07:37,2,3,1,mooc打卡
84327,936,翁恺,2018-07-12 14:52:53,1,3,2,老师上课很好，讲的很到位，也会经常讲一些课外的东西，总之很有收获
84330,936,翁恺,2018-07-12 14:56:34,5,6,1,并不是很喜欢
84335,936,翁恺,2018-07-12 15:00:57,5,6,1,自学吧。会调分，无奈。
84738,936,翁恺,2018-07-13 16:33:40,4,6,2,沟通技巧啊！！！你死的好惨啊！！！\n\n
86007,936,翁恺,2018-08-27 01:16:31,1,1,0,哈哈哈j
86697,936,翁恺,2018-09-18 04:38:01,0,4,4,给分特别好
88045,936,翁恺,2018-10-20 15:31:41,1,2,1,网课。
91610,936,翁恺,2018-12-15 15:47:36,1,4,3,老师的mooc拯救了我的c程序！！٩(˃̶͈̀௰˂̶͈́)و
91898,936,翁恺,2018-12-24 13:25:35,-1,1,2,还不错
91996,936,翁恺,2018-12-25 09:17:09,0,1,1,aaa
95303,936,翁恺,2019-01-19 07:17:26,-2,1,3,good
97237,936,翁恺,2019-01-22 01:07:22,-3,2,5,程序设计基础。收获很大，讲得非常细致，老师人也挺好，具有非常大的亲和力。
98259,936,翁恺,2019-01-23 08:47:56,10,11,1,java开学一个月quiz考了去年期末题。期末考试上午下午两场，难度完全不同，下午的题目各种打印出错，答案出错。PPL大作业也是反复修改要求，不断推倒重写。翁老师可不可以把重心稍微放在教学一点。听了他的慕课之后来实际体验真的太失望了，上过的最差专业课没有之一。
99048,936,翁恺,2019-01-24 07:50:07,6,7,1,特别会扯淡
99049,936,翁恺,2019-01-30 07:48:11,-12,14,26,nmsl? ?
100284,936,翁恺,2019-01-26 02:05:48,13,14,1,就想问今年oop期末的卷子是随便出的吗，各种显而易见的错误以及非常敷衍的题目，让学生找试卷的错误是否有点可笑……老师上课挺有意思，理解也不错，但说实话教学重点确实有点没把握住，不够用心吧，列了很多ToDoList最后都没实施，平时就随便布置几道理论作业（很多还是网上的题），代码量极少，只有期末的大作业突如其来地push了你一下。感觉本来应该能学到更多东西的，毕竟是oop啊
100367,936,翁恺,2019-04-11 07:32:18,-18,13,31,nmsl
100681,936,翁恺,2019-01-26 14:30:21,4,9,5,啥也不讲，最后大家都是自学，不适合讲课
101436,936,翁恺,2019-01-28 07:58:59,2,6,4,听过一节课，翁老师上课水平绝对一流，但考试题目质量确实有待提高，修正答案什么的也给别的老师造成了麻烦。
102412,936,翁恺,2019-02-01 15:22:16,-17,5,22,期末占总评只有40%，然而我期末扣掉了3.2，最后96，平时分基本就是满了，，，不多说了，wknb！
102486,936,翁恺,2019-02-03 09:54:38,54,99,45,浙大过誉的老师之一。
103498,936,翁恺,2019-02-28 14:12:28,-1,1,2,老师是不是浙大教工合唱团的啊
103565,936,翁恺,2019-03-01 07:11:55,0,2,2,C专题，上机课会变成正课，但实验报告可以乱写。会讲很多工程中应用出现的问题。
103629,936,翁恺,2019-03-02 17:08:02,-4,0,4,非常好
104531,936,翁恺,2019-03-23 02:24:37,-10,5,15,还是靠自学吧，c程前面就一直讲些和考试内容关系不大的事，但最后给分很不错，虽然是和求计一起上，但还是满了，感觉班里有一半满绩orz，10分10分
104589,936,翁恺,2019-03-24 14:02:43,8,19,11,垃圾翁恺
104935,936,翁恺,2019-03-31 12:12:11,42,49,7,C大程22天布置四个大作业，其中三个要用到的算法他讲都没讲过，完全要靠自学。可能是我菜，但我真的太想咒骂了。
107094,936,翁恺,2019-05-01 13:57:10,2,3,1,mooc讲得也太好啦吧！受益匪浅
107752,936,翁恺,2019-05-09 05:18:47,3,5,2,事情超级超级超级超级多
107962,936,翁恺,2019-07-05 17:23:00,25,31,6,期末95 平时分扣10分 无fuck说 沟通技巧慎选wk
108197,936,翁恺,2019-05-16 06:43:37,3,4,1,不知道为什么一直很不耐烦……上课感觉没有很认真准备啊
108593,936,翁恺,2019-05-29 07:25:28,1,2,1,嵌入式系统内容很综合，难也是真难…
108907,936,翁恺,2019-06-04 04:01:55,0,2,2,MOOC真的收获超大，即使是小白也能清晰理解！
109048,936,翁恺,2019-06-06 06:50:30,-2,1,3,棒hhhhhhhhh
110151,936,翁恺,2019-06-24 02:43:44,5,5,0,极其讨厌分组互评这种方式
110224,936,翁恺,2019-07-04 16:11:21,20,21,1,慕课是男神，现实中自己体会
110359,936,翁恺,2019-06-26 04:13:12,10,12,2,留的作业多要求严格都不是问题，讲的东西很丰富很深刻，思维也走在前面。\n\n但请问，您在群里回答一下学生的问题会掉块肉吗？
111169,936,翁恺,2019-06-30 08:00:47,7,10,3,扯着扯着就扯远了。。。
111736,936,翁恺,2019-07-02 16:52:35,15,15,0,我觉得\n\nwk的脾气和对学生的耐心没有他自以为的那么好。
113026,936,翁恺,2019-07-05 18:01:21,13,14,1,虚拟与现实见有巨大的鸿沟。沟通技巧最后一节课喜怒无常宛如来姨妈，不知道因为什么事在学生身上发脾气。给分？反正我总分比期末低8分
113051,936,翁恺,2019-07-16 11:56:35,5,8,3,我收回前言，前几天小看它了，这小学期难哭了，天天的一会儿灯就不亮了，debug快哭了，太硬核了
113150,936,翁恺,2019-07-08 11:24:54,2,7,5,私以为沟通技巧不全是老师的问题吧..一门被全计院喷死的课谁上谁倒霉..对外没有什么用，对内做不到公平，机考和往年卷几乎一致?可能老师自己都觉得这课没有意义才会考试卷随便应付吧(机考对比ads ds 每年都是新题..)\n\n
113284,936,翁恺,2019-07-06 03:50:29,8,15,7,沟通技巧真的恶心。最后总分占十分的作业，不小心违规了，没有补交，没有任何补救措施，直接给0分，10分啊，直接从82掉到72。违规的确是学生自己的疏忽，但全部扣完让人难以接受。还有平时分几乎人人扣10分，那还有什么好说的呢。不敢说这门课自己学得多么好，但任务都是完成了的，作业都是认真对待的，最后2.7的绩点让人想问候老师和助教的家人。
113302,936,翁恺,2019-07-06 05:01:35,15,15,0,wk的沟通技巧能把你对上他课的向往变成再也不想上他课的绝望
113328,936,翁恺,2019-07-06 07:11:31,6,7,1,沟通技巧一生黑，完全没有意义的一门课，互评制度极度恶心，给打27的互评分(30满)，被举报互评不认真，但明明评语也好好写了，最后仲裁扣8分，改成绩是不可能的了，呵呵呵，无话可说，再也不想选wk的课了
113811,936,翁恺,2019-07-07 16:46:39,-1,2,3,上的python。水平肯定是有的。平时作业比舍友少，实验课限时4道题还好。给十分，但感觉没有之前听传闻的时候那么神。
113843,936,翁恺,2019-07-07 17:42:00,1,2,1,老师还是蛮好的
113916,936,翁恺,2019-07-08 00:35:31,11,11,0,这认知实习，以为我们都是神仙？
113940,936,翁恺,2019-07-08 01:36:11,1,5,4,翁老师的Python讲的是真的很好了?还爱给同学们讲讲故事?\n\n就是可能翁老师也知道我们太菜了?课程稍微有些简单?同学们要学好，自己最好再多看看官方文档的tutorial吧?
114020,936,翁恺,2019-07-08 10:11:25,9,10,1,敲你妹的短学期，又难又没用还不让人回家
114046,936,翁恺,2019-07-08 13:33:07,-1,2,3,老师很牛的 但你上课听了没用的话 早点自学吧
114055,936,翁恺,2019-07-08 14:07:49,11,14,3,我觉得翁恺非常不耐心，询问他他会用一种让人非常不适的回复怼你再给出答案，我不觉得这是一个值得给9.9分的老师
114216,936,翁恺,2019-07-09 05:12:56,15,17,2,认识实习中的信电学子大概是计院学子之后被wk虐的头秃的一批人了.....求放过
114265,936,翁恺,2019-07-09 13:34:42,10,11,1,小学期真的不用搞这么难
114270,936,翁恺,2019-07-09 15:26:30,22,25,3,wdnmd，考完试小学期比考前还累
114433,936,翁恺,2019-07-10 02:43:08,8,9,1,Python\n\n给分奇怪，平时分扣六分是什么鬼操作，补分集全做满了……
114692,936,翁恺,2019-07-11 04:08:38,-1,1,2,。。。
114837,936,翁恺,2019-07-12 02:12:38,11,14,3,沟通技巧给分真的不行，事情还多。只能说是学院开课的问题吧，期末考试机考和往年卷子几乎一样，所以只要有认识的学长，考试基本上能拿满分。这对于没做过的同学是不是一种极大的不公平？
115018,936,翁恺,2019-07-14 07:34:04,8,8,0,作业要求是真的迷……
115029,936,翁恺,2019-07-14 14:55:18,6,9,3,网红教师
115103,936,翁恺,2019-07-15 15:15:32,7,11,4,网课讲得挺好的。但是老师是真的爱兔人，如果让同学问个问题都战战兢兢，那我觉得不能算满分老师。
116194,936,翁恺,2019-09-06 02:43:44,7,8,1,PPT做的太简单了嗷，别看上课体验挺好，讲的有意思，那是都知道讲的内容情况下。一到考试复习的时候，你就懵逼了，根本没有可以复习的资料，PPT只有框架的哦（上的是嵌入式）
116664,936,翁恺,2019-09-12 14:31:12,6,6,0,好难好难呀
116695,936,翁恺,2019-09-23 17:57:29,0,3,3,给分还不错
116838,936,翁恺,2019-09-16 11:19:28,1,1,0,翁老师是真的强
117133,936,翁恺,2019-09-19 22:35:37,5,6,1,只能说，wk已经变了
117385,936,翁恺,2019-09-23 23:57:20,2,3,1,给分好才是真的好
117389,936,翁恺,2019-09-24 01:00:18,-2,1,3,小学期讲课态度很好，给分超好！
117958,936,翁恺,2019-10-17 02:14:05,-12,2,14,强烈不推荐他的程序设计方法学，MUA解释器居然必须用Java写！Java是不是比其他语言都要高贵呀？为啥不能用Kotlin或者c#？
118033,936,翁恺,2019-10-19 04:04:54,9,9,0,w选上的话还是自学⑧，上课虽然讲很多但是和课程关系不大
118992,936,翁恺,2019-11-09 04:13:36,-15,14,29,为什么没有零分？大学到现在遇到的最垃圾的老师，没有之一。
120805,936,翁恺,2020-01-17 09:44:44,0,0,0,段子手
121632,936,翁恺,2019-12-11 14:41:06,1,1,0,通俗易懂
121679,936,翁恺,2020-01-20 17:46:26,3,3,0,wk的给分……太可怕了点吧……
121960,936,翁恺,2020-01-26 02:27:15,10,11,1,他在群里发自己的油腻表情包，这颠覆了我对这个人的认识。
122173,936,翁恺,2020-02-18 15:47:00,0,2,2,好老师，
122300,936,翁恺,2020-03-05 02:42:39,8,10,2,竺院学渣有苦难言，退院助推剂翁凯！如果你是学渣，竺院C专题千万不要选！你会觉得老师很好但是得全靠自学的！考试全英文，害难呀！
122567,936,翁恺,2020-03-04 06:42:40,0,2,2,好老师！
122575,936,翁恺,2020-03-04 09:44:14,1,2,1,很厉害
122746,936,翁恺,2020-03-29 11:47:42,3,3,0,C专题想高分一定要自学多一点东西orz
122942,936,翁恺,2020-04-23 10:31:18,-1,0,1,嵌入式，建议三思，实验指导基本为0，对小白很不友好。但是上课的确好
123198,936,翁恺,2020-05-19 02:32:12,0,0,0,哈哈哈
123465,936,翁恺,2020-06-09 05:09:41,-1,2,3,9.7分太低了吧，翁恺真的是超级好，对所有同学一视同仁而且非常幽默风趣
123739,936,翁恺,2020-06-13 05:40:37,4,5,1,今年沟通技巧很友好，隔壁被互评虐惨，主观地说还是wk好
124463,936,翁恺,2020-07-01 14:28:50,2,2,0,嘻嘻嬉
124799,936,翁恺,2020-07-11 08:58:22,12,14,2,我敢说今年沟通技巧肯定比cy班友好，作业交了就100，只有互评占每次作业的30%会扣一点分\n\n期末考整个计院一半人能上90，估摸着今年wk班里4.8和5.0不会低于一半\n\n虽然10人一组导致有几个队友摸鱼严重但看到成绩还算是比较满意
124805,936,翁恺,2020-07-10 05:52:44,2,4,2,2020年春夏学期沟通技巧给分好的一比，很容易满，估计是从良了。
124828,936,翁恺,2020-07-11 09:32:59,4,6,2,今年春夏学期的沟通技巧给分好到批爆~~~
125412,936,翁恺,2020-09-13 13:26:00,9,14,5,讲的不考，考的不讲，就是给分不错。
125437,936,翁恺,2020-09-09 02:46:17,4,6,2,亲爱的翁凯老师，你答应的复习直播呢！！？
125449,936,翁恺,2020-09-09 09:03:05,18,21,3,C程专题课，讲了一学期讲了个寂寞啊。考试考到了队列，图形库，堆栈，结果这些东西课上根本就没讲过。考试复习的时候同学在群里问考不考，你不说话。有人私戳询问，你说不考。就这？学了一学期，试卷上大部分考察内容课堂上提都没提过，请问这是不是教学事故？
125736,936,翁恺,2020-09-14 00:33:18,17,22,5,C程序设计专题，一言难尽emm......考试考队列和课本的图形库，为什么平时上课没讲过，课后作业做都没有做过queue和graphic.h呢...考前同学们在群里问也不回复...就这样吧、
125759,936,翁恺,2020-09-14 04:35:51,5,9,4,考的不讲，非大佬慎选。
125839,936,翁恺,2020-09-15 08:58:44,5,13,8,慎选，别被高分迷惑了。只能说分数极其虚高。
125981,936,翁恺,2020-09-16 07:36:41,-5,17,22,真垃圾，根本不调分，分数构成和自己说的完全不一样，讲课完全就是给会的人讲，根本不管你的基础怎么样，作业贼多，看着挺好一个人怎么就这么渣
126060,936,翁恺,2020-09-17 04:01:24,7,10,3,c专题十分难受\n\n讲的不考考的不讲\n\n群里问图形库怎么考也不回答\n\n一言难尽
126644,936,翁恺,2020-10-11 07:31:57,3,4,1,老师很幽默 讲课很清楚 给分好!
126680,936,翁恺,2020-10-13 08:56:22,3,5,2,超好了
127015,936,翁恺,2020-11-03 00:16:11,4,8,4,翁恺的c讲得很好，但是对图灵的同学来说进度还是有点快了，scanf和main上来并无说的很清楚，导致容易犯迷糊，但是后面还行
128099,936,翁恺,2020-12-07 07:36:16,1,2,1,那那那
128103,936,翁恺,2020-12-07 07:40:07,-2,0,2,滴滴滴
128273,936,翁恺,2020-12-16 02:46:35,12,16,4,看到劣评都来自C大程（momo学弟学妹），来评评专业课。确实讲解透彻，上课很享受，大三课程也不存在大跃进的问题，作业量合理。讲课水平我主观认为是计院top1
129424,936,翁恺,2021-01-05 08:03:12,-2,0,2,作业真的很难
131219,936,翁恺,2021-01-26 14:55:40,2,3,1,考完PPL，感觉这课可以改名叫MUA语言程序设计了
131251,936,翁恺,2021-01-27 00:21:28,3,3,0,ppl主观题全是上课讲过的内容，上课建议认真听
131813,936,翁恺,2021-01-29 04:10:58,4,4,0,讲课很有趣，可以看出老师备课很认真。面向信息技术的沟通技巧给分特别好，比起隔壁陈越班好了好几倍，沟通技巧一定要选翁恺。
131987,936,翁恺,2021-01-30 01:27:28,2,5,3,秋冬学期的程序设计与算法基础来的，虽然自学要求比较高，但wk老师教学水平和捞人水平都相当棒（表情包警告
132257,936,翁恺,2021-01-31 10:16:44,9,12,3,别问 问就是体系平时分只要作业都交了 实验都验收了就给满
132465,936,翁恺,2021-02-01 17:18:02,1,4,3,备课认真，讲课有趣，关键的一点是给分特别好，平时分几乎给满而且考试也给调分的，很推荐
132474,936,翁恺,2021-02-02 01:00:09,10,11,1,还不快谢谢wk哥
132983,936,翁恺,2021-02-05 20:11:07,6,8,2,好老师！
133107,936,翁恺,2021-02-08 11:49:03,2,3,1,！！！
133813,936,翁恺,2021-03-06 08:14:01,3,5,2,好耶好耶好耶，老师超级棒，上课新颖有条理，风趣幽默，人还超级好
134111,936,翁恺,2021-03-16 06:47:05,3,6,3,讲冷笑话的大可爱
134155,936,翁恺,2021-03-17 08:21:57,4,6,2,超越人类的存在
134314,936,翁恺,2021-03-23 09:36:22,6,10,4,在线的话真的会秒回消息直接好评！问问题很耐心也讲得比较透彻！好评+++++
135744,936,翁恺,2021-05-23 02:51:34,-5,6,11,呵呵呵
136314,936,翁恺,2021-06-16 07:12:25,0,3,3,永远的神
136506,936,翁恺,2021-06-19 13:50:04,2,5,3,慕课，棒(๑•̀ㅂ•́)و✧
137063,936,翁恺,2021-06-30 07:58:42,1,5,4,棒棒棒！
137064,936,翁恺,2021-06-30 08:06:27,2,4,2,讲课真的很好
137066,936,翁恺,2021-06-30 08:10:48,-1,3,4,课上的巨无敌好！条理很清晰，人很幽默！就是有的时候过分高屋建瓴了hhh我太菜了🙏and老师python捞捞
137822,936,翁恺,2021-07-06 08:44:02,68,114,46,平时作业你乱出题，整一堆垃圾题给我们做就算了，期末考试也这么整？\n\n一套卷子大错小错加起来不下十个，函数编程题还临时改题。看到cout>>的时候我都不想做了，说明你自己都没拿这份放上来的代码跑过。还有各种奇怪的换行，但最后输出样例却一个换行也没有，真是服了。还是求求你对平时作业和考试题目上点心吧，以前辛辛苦苦攒起来的名声，别因为这几年在外面开公司没空就不认真出题，砸了自己的名声。
137827,936,翁恺,2021-07-06 08:51:27,28,31,3,oop重开了，呵呵，你出的题让19级的oop成为了火葬场
137842,936,翁恺,2021-07-15 04:24:51,23,31,8,rnm 退课！
137853,936,翁恺,2021-07-06 11:31:48,21,24,3,OOP平时作业比其他班多，考试出的编程题有问题中途改题，但是直到快结束了才通知。最后延长到1个小时，20分编程题计院学子通过率还是0.01\n\n讲课确实比较清楚，但是实验课内容很恶心，总会出奇怪的测试点卡你一下让你吃苍蝇\n\n诸位自己看着办吧，感觉并没有评价中那么好，更适合大佬秀水平
139067,936,翁恺,2021-07-12 10:54:40,5,5,0,谢谢翁凯老师！
139074,936,翁恺,2021-07-12 12:43:48,5,9,4,C大程。老师给分确实很好，在wk不要组队写大程，平时作业基本200行代码结束，也基本上给满。作业较其他班都少。讲到的知识点也比较清楚。以下是缺点：1，cs专业学子没有锻炼到什么写程序的能力，因为作业太水。2，考的不讲讲的不考，竺院C大程期末要笔试，建议自学图形库队列和栈，做历年题，不然会死得惨（大佬除外）
139093,936,翁恺,2021-07-12 16:00:15,5,9,4,出的破题
139125,936,翁恺,2021-07-13 03:47:30,-3,4,7,平时作业什么垃圾题，非得卡一下
139323,936,翁恺,2021-07-14 10:26:24,1,2,1,吹爆老师，python成绩比我预想的好太多了，感谢老师捞我!
139324,936,翁恺,2021-07-14 10:36:32,1,2,1,我理论考分数超低，还能被老师捞起来，真的太爱老师了！！！
139415,936,翁恺,2021-07-15 08:57:13,8,10,2,题目出的奇奇怪怪
139430,936,翁恺,2021-07-15 11:56:23,0,3,3,最爱wk老师
139431,936,翁恺,2021-07-15 11:58:03,3,6,3,大家要是上过非竺C大程就知道wk老师是什么神仙了
139473,936,翁恺,2021-07-16 09:05:05,10,12,2,讲课水平真的很赞，这次oop 搞得很恶心 希望作业和卷子能上点心
139492,936,翁恺,2021-07-16 12:33:24,6,8,2,可能嵌入式选的同学很少所以没看到评论\n\n这是一门很硬的课，基本每周一个实验，会花每周相当多的时间，但也能从中学到很多，而且摆弄那些东西确实挺有趣的\n\n最后给分很好，考完的时候我以为我凉了，出分的时候我惊了
139713,936,翁恺,2021-07-21 02:40:31,7,11,4,讲课最能听懂的。
139934,936,翁恺,2021-08-21 12:31:15,1,6,5,铁粉报到
140088,936,翁恺,2021-08-25 08:59:58,17,21,4,C大程就一坑，上课讲的不考，期末考的不讲。考试时没讲的就说答案在卷子上，醉了。
140165,936,翁恺,2021-09-01 13:20:17,8,17,9,从慕课上听老师的课，到现在来到了老师所在的学府求学，老师真的是我的偶像。
143449,936,翁恺,2021-11-25 13:06:14,11,22,11,远离翁恺
144018,936,翁恺,2021-12-16 03:14:41,2,7,5,水平很高
144101,936,翁恺,2021-12-17 14:42:22,7,12,5,师强我菜
148411,936,翁恺,2022-01-12 11:19:58,-80,14,94,翁恺，密麻麻石蜡❤给分那么低，还对学生发飙，密麻麻果然石蜡❤
148607,936,翁恺,2022-01-13 03:25:35,0,12,12,程序设计方法学过来的，上课随机点了1~2次名（但其实从OOP以及这次PPL的经验来看点名不算分？）。\n\n大作业MUA很折磨人，主要是工程要求不清楚，还有这学期助教还拍拍脑袋就加了个闭包让我们去写。\n\n代码量其实还好，我的大概1000行，但难受的点是调试花了很长时间。\n\n平时分基本除了综述都会给满，所以要靠期末努努力冲一把。
149584,936,翁恺,2022-01-16 04:49:47,6,9,3,翁恺超人！
150398,936,翁恺,2022-01-24 10:08:46,16,21,5,程算一个班，半个班能满绩
152907,936,翁恺,2022-04-21 13:16:42,26,28,2,小白快逃，对小白极其不友好，变态小测，变态习题，经常都是上课没讲过拿来考，考的和讲的不一样，要用到一堆没学过的，你也不知道去哪里学没讲过的，小白远离wk！！！
153099,936,翁恺,2022-05-11 06:47:12,52,55,3,python作业又多又难，班里有那么二十来个cs图灵混合的就忘记这课是开给人文社科的了
153334,936,翁恺,2022-04-28 07:19:14,7,8,1,老师的课，由浅入深，层层递进，阶梯式教育，让我的知识积沙成塔，感谢您
153790,936,翁恺,2022-05-11 06:50:04,14,18,4,题目都出的是什么鬼，能正常点吗
154999,936,翁恺,2022-06-07 09:35:16,0,3,3,11111111111111
155098,936,翁恺,2022-06-08 08:57:46,3,5,2,课讲的超级好！
156377,936,翁恺,2022-06-22 06:21:29,27,29,2,跟着翁老师上课确实能学到东西，懂的也很多。但缺点有二，c大程考试内容很多上课没讲过，钉钉消息常已读不回。
156574,936,翁恺,2022-06-20 09:49:02,9,10,1,wk老师课程讲得很好，但是他喜欢教书而不是喜欢育人，平时讲课经常会出现上节课说要讲什么，结果这节课什么都没讲全靠自学的现象。期末还有三天就要考试，还要抽出时间去自学graphic库，我佛了。建议自学能力强的来上wk老师的课程吧，我已经听天由命了
156683,936,翁恺,2022-06-20 15:10:26,0,0,0,老师，明天就要考试了，捞捞我
157205,936,翁恺,2022-06-22 09:15:42,1,4,3,wk老师的python对人文社科的同学确实不太友好，因为班里有部分cs、图灵、软工的，所以整体上调了小测和作业的难度。但上课比较有趣，讲的也很通俗易懂。
157287,936,翁恺,2022-06-30 04:42:46,13,17,4,考的好不如选的好，94的被正态到89，平时实验全满，理论83被正态到89，小白远离翁恺
157775,936,翁恺,2022-06-24 19:58:38,7,7,0,平时分很高，讲课也很好，期末靠自己啦
158532,936,翁恺,2022-06-30 05:09:09,17,17,0,。。。。。。。。。。。。。。。。。。。。。。。。。。。。。。\n\n非妓院的同学建议考虑考虑别的老师，不想被正态的话。\n\n上课点名，上机课签到，作业花的时间比其他老师多，自编题难度更是一绝。\n\n另，平心而论，老师教学水平很不错。
158753,936,翁恺,2022-07-02 01:31:36,-1,2,3,不至于不至于，讲的好是老师一贯的风格，有人选也没办法\n\n我觉得比较后悔的是没赶上半正态吧\n\n还是讲的很好的
159959,936,翁恺,2022-09-10 04:31:49,40,46,6,支持翁老师正义绞杀早八
162014,936,翁恺,2022-11-16 03:57:24,4,5,1,作业太多
162033,936,翁恺,2022-11-16 06:52:08,8,11,3,临近期末忽然出尔反尔布置一大堆作业。。。以及对待学生的态度。。。。\n\n只能说做人要有底线
162056,936,翁恺,2022-11-18 07:43:53,19,24,5,千万别选wk的JAVA应用技术！！！\n\n学期中间临时改变要求，对PPT上面的课程安排视而不见，原本的2个大程被他改成了2+4个大程，凭空多出来4个，还认为自己没做错，有同学发邮件礼貌询问还被他反手直接挂在课程群，还美名其曰“忘记打码了”，给同学的邮件回复也就一句话“原本6周还有6个实验题目集，现在变成3个了，你计算一下？”，但事实上是平常实验题目集也在照样布置，而且实验题目集的工作量远小于大程的工作量。之前的第一个project也被他脱了很久，题目有问题一直乱定ddl。总之JAVA课的体验很不好，大家请避雷。
162246,936,翁恺,2022-11-18 07:44:24,11,15,4,千万别选wk的JAVA应用技术！！！\n\n学期中间临时改变要求，对PPT上面的课程安排视而不见，原本的2个大程被他改成了2+4个大程，凭空多出来4个，还认为自己没做错，有同学发邮件礼貌询问还被他反手直接挂在课程群，还美名其曰“忘记打码了”，给同学的邮件回复也就一句话“原本6周还有6个实验题目集，现在变成3个了，你计算一下？”，但事实上是平常实验题目集也在照样布置，而且实验题目集的工作量远小于大程的工作量。之前的第一个project也被他脱了很久，题目有问题一直乱定ddl。总之JAVA课的体验很不好，大家请避雷。
163752,936,翁恺,2022-12-16 05:07:21,4,5,1,是一个好讲师，但不是一个好老师\n\n讲的东西不枯燥，能学到东西，但是对于作业考试等事项确实是很想当然了，不怎么考虑学生的感受
164500,936,翁恺,2022-12-21 09:32:37,1,3,2,讲的很好，非常好。其他课不了解，但程算这里 wk yyds
164614,936,翁恺,2022-12-22 08:27:56,8,9,1,技术沟通，其中一个作业是复现论文。只能说布置作业不过脑子
164659,936,翁恺,2022-12-22 15:42:36,-15,6,21,不觉得wk很酷吗?作为一名理工生我觉得这太酷了，很符合我对程序员的想象，科技并带着趣味。
164984,936,翁恺,2022-12-28 07:51:02,7,8,1,赶上程序设计方法学课改。。怀疑wk都不知道自己在讲些什么，上课ppt都念不顺。。。。。助教都是好助教，但难度设置的不太合理（大佬助教不理解凡人的痛苦）。。。。快逃！！！！
165117,936,翁恺,2023-01-06 11:06:38,5,7,2,脑抽？？？\n\n晚节不保
165172,936,翁恺,2022-12-29 18:21:28,12,12,0,要想选java应用技术 拼了命选lwm 翁恺的话就算了 听我一劝
165350,936,翁恺,2023-01-02 06:10:22,9,9,0,上的技术沟通，很花时间，事情很多，体验也很不愉快，有几个个人作业全部提交了之后才打低分，根本没有再修改进步的余地，感觉很难受。
165670,936,翁恺,2023-01-09 08:04:01,16,16,0,呵呵呵呵呵呵
165674,936,翁恺,2023-01-09 08:13:57,23,24,1,java应用技术极其劝退，作业又多，期末考试又离谱，还只有你们班有斩杀线，真6
165757,936,翁恺,2023-01-09 13:54:54,12,13,1,别选Java应用技术！！快逃
165818,936,翁恺,2023-01-10 04:53:08,18,18,0,还不如cy呢，起码她说什么就是什么不会朝令夕改。。。
165935,936,翁恺,2023-01-10 12:31:12,20,23,3,java应用技术上课胡言乱语，作业乱七八糟，考试题型胡说八道
166351,936,翁恺,2023-01-12 04:50:17,-13,6,19,yyds
166465,936,翁恺,2023-01-12 10:20:05,14,14,0,Java： 不想上可以不上\n\n嘻嘻
166484,936,翁恺,2023-01-12 10:57:29,11,12,1,Java真的好难\n\n远离 会不幸
166553,936,翁恺,2023-01-12 18:50:43,12,12,0,Java 快跑\n\n讲的不考，考的不讲，题又偏又难量还大，纯纯折磨心态
166674,936,翁恺,2023-01-13 08:05:18,2,10,8,程算，助教邮箱私发的成绩，平时分满的正好卡绩，出分的时候发现自己这样都能被抬了一分，翁凯yyds
167518,936,翁恺,2023-01-17 02:50:38,-36,3,39,[Java]平时70%，期末30%，平时作业确实比其他班多了点，但是平时分都基本捞满了，只要project做了就可以满，这是其他班比不上的，wkgg给平时分真的yyds！这次的考试比往年刁钻，但是老师也应捞尽捞了，还不卡绩，综合来说还是很不错滴
167534,936,翁恺,2023-01-17 05:12:36,36,38,2,楼下说翁凯平时分给的不错的人，那是助教做的，应该感谢助教。但这学期的java，不客气的说，整个课题组就是在瞎搞，理论出的什么东西？好意思吗？😅
167740,936,翁恺,2023-01-18 17:18:28,5,8,3,这学期开始沟通技巧从必修变成了选修，也改名成了技术沟通。由于人数原因取消了互评，因为线上上课也取消了期末考。感觉上课内容和之前应该是大同小异。老师讲得不错，算是一门确实能学到东西的课；但是课后作业压力还是挺大的，基本是小组作业，每一节课都要进行小组讨论和展示。恶心的点：1.作为一门面向大二学生的课，相比以前今年增加了一个大作业要求复现论文Attention is all you need，作业说明非常模糊，也缺少必要的引导，感觉布置得有点不切实际。2.几份个人作业在结课以后才出小分和评价，而不是当周批改，这导致第一份作业中出现的错误还是会在后面的作业里出现，批改不及时应该是助教的锅？结课作业是一份个人完成的文献综述和一场小组完成的开题报告，个人感觉对这样的学分的课来说任务稍显繁重。
168223,936,翁恺,2023-02-03 16:54:23,3,3,0,带入门
168811,936,翁恺,2023-02-22 11:02:05,-1,1,2,别选，课间不休息，四五个小时就在那里坐着听他唠嗑
169050,936,翁恺,2023-02-24 06:37:56,6,6,0,快逃 那么多课非要选java？
169231,936,翁恺,2023-02-25 01:30:56,1,3,2,事情好多，但是讲得确实不错，人也很幽默，最后因为自己的原因分比较低，总之还是推荐的
170467,936,翁恺,2023-03-05 09:27:43,2,3,1,wk讲课确实是不错的\n\n但是又很发散 \n\n选之前最好听一下智云判断
170576,936,翁恺,2023-03-07 01:26:23,2,3,1,在上oop，讲课真的好，从程算来看给分也不错
170612,936,翁恺,2023-03-07 06:59:59,-3,1,4,mooc很有趣（心
170943,936,翁恺,2023-03-13 04:55:40,2,4,2,体系结构，有点难言的感觉
171858,936,翁恺,2023-04-08 08:16:55,13,18,5,啊我真的写实验题写到崩溃\n\n本来每周早八实验课必须到场纸质签到就已经比别的班辛苦很多了\n\n为什么要出这么难的题啊\n\n毫无头绪  和上课讲的也完全不一样\n\n\n\nC大程是竺院必修课\n\n班里还是有很多非计科的同学\n\n能不能考虑一下我们的诉求\n\n\n\n真的要挂了\n\n\n\n别的地方发不了疯只能来这里发泄一下\n\n反正实验题的分是要不了了\n\n下周这么多个大程序ddl 还要查重\n\n我还有很多自己专业课的任务\n\n要怎么活下去
172779,936,翁恺,2023-06-06 06:45:48,13,15,2,重新写下评价吧\n\n这学期oop\n\nproject 3 真的挺烂的 应该是助教问题？\n\n期中是真炸裂了 感觉纯纯wk问题\n\n讲课确实还是特好的\n\n\n\n现在临期末开了补分集 \n\n只能说稍微还算合理~~
172868,936,翁恺,2023-05-09 02:47:44,19,22,3,先不说忘记讲一整节内容的教学事故，老师讲课还是不错的。\n\n首先某w姓助教能否不要这么离谱？据我所知您当助教的每门课，尤其是这个oop和ads课，都有很多人感到极其不满。一个project，2.5学分的课里面一个3分的小项目，硬是干出了上千行的效果，而且各种要求也不胜其烦，极其的繁琐。最要命的是，这个pj没有任何诚意——因为完全是照搬的c大的pj。您在过助教瘾之前，能不能先考虑一下不是每个人都是你这么nb的。虽然这里的“nb”可能还要打个引号😄。有nb的学长指导是好事，但是过于卖弄是否就会显得有点逆天了呢？不单单是oop，ads也是如此，学弟学妹们遇到这个学长当助教的课，还是先避雷吧😇
173005,936,翁恺,2023-05-19 06:42:27,11,12,1,看了楼上说大程project的，感觉oop的也不太好做，可能是我是非计院的缘故，五一假期基本没玩全搭进去了...\n\n而且希望要求能更清晰一点吧，很多格式问题都是在群里问助教才知道的
173021,936,翁恺,2023-05-11 11:35:35,-1,5,6,神一般的存在，教父。
173033,936,翁恺,2023-05-11 14:06:02,6,7,1,总喜欢让人猜的一个老师，避雷
173163,936,翁恺,2023-05-14 17:15:56,15,15,0,这个oop的期中出的什么玩意，群里也已读不回是吧，给你打个七分不过分吧
173453,936,翁恺,2023-05-30 11:07:06,9,10,1,体验极差 作业也经常出现没有讲过的内容 甚至期中考试也会出现（分数是已经扣完了）\n\n不过oop好像不能怪w助教，我问他的时候他说他也没见过题目，是wk老师自己拉的期中考试题\n\n整个就是wk开公司了，啥都不管了\n\n上课都不记得自己讲到哪里了 运算符重载讲着讲着突然发现拷贝构造没讲完\n\n怼他问他问题也都是已读不回 避雷！
173780,936,翁恺,2023-06-02 16:18:18,17,21,4,想问一下，程序设计方法学 是不是改名为 编程语言原理 了，如果是的话希望有hxd能在右边顶一下，如果不是的话希望hxd能在右边踩一下，谢谢
174803,936,翁恺,2023-06-18 07:40:59,3,3,0,难绷啊。。。
174805,936,翁恺,2023-06-18 07:50:32,0,1,1,讲课好才是真的好
174953,936,翁恺,2023-06-20 11:11:28,48,50,2,网上的wk才是好wk，线下的体验别抱太高期望
175914,936,翁恺,2023-06-27 06:28:55,4,4,0,上课上的好，听了一个学期真的感觉自己代码水平有所提升。
176114,936,翁恺,2023-06-28 00:29:54,11,12,1,技术沟通：\n\n20个人的班级\n\n90+  9\n\n80+  6\n\n70+  3\n\n60+  0\n\n60-  2
176431,936,翁恺,2023-06-29 01:57:44,0,2,2,挺好的老师
177449,936,翁恺,2023-07-03 09:51:27,0,1,1,讲课讲的很好，好老师，值得推荐
177571,936,翁恺,2023-07-03 18:09:58,7,8,1,大翁老师感觉水平还在，就是没那么上心了，感觉有好多迷之操作，再加上这个oop考试形式极其愚蠢，实验指导也不甚清楚(感觉助教英文指导自己自己都看不明白），总之体验没那么好，但相对于其他烂课好多了
177696,936,翁恺,2023-07-04 10:11:31,5,10,5,上了翁恺老师的Python，感觉就是对新手非常不友好，我觉得如果你是个新手并且想通过努力想拿个好成绩的话千万不要选他的课，感觉这学期的课完完全全是为大佬们设计的，每次小测题出的这么严还是闭卷（因为舍友的其他老师小测都是开卷的），虽然是自己学艺不精考得少（但是自己每次上课都很认真听，下课也认真看了PPT和书），但是平心而论他出的题所涉及的知识点根本就没讲过而且书上也没有吧？最后自己平时分扣了12分，真的很迷惑，但可能是因为自己的小测实在是做得烂。但是心里还是很不平衡难道因为班里一堆学过c的，学过技术的大佬就上调难度吗？他有没有考虑过我们这些之前从来没有接触过的学生啊？\n\n反正就是如果你不想最后得到一个让自己心情十分糟糕的绩点的话建议换个老师吧，其他的老师作业也不难小测也简单，努努力就能得到个好成绩为什么不去选？（我是因为预置没法退课）上了一个学期下来，真的觉得选择远远大于努力。非常失望。
177901,936,翁恺,2023-07-05 10:01:58,7,13,6,C大。\n\n翁恺老师课确实上的好，上他的课感觉就是很有挑战而且能学到很多东西。还记得当时p1看完题目都有点小崩溃，然后自学了命令行等一系列知识一点点做了出来，真的很有成就感。期末公布了平时分和卷面分，我算下来自己是94，最后还被老师捞到95满了。总之，是一门体验很好的课。
178276,936,翁恺,2023-07-09 09:02:20,12,13,1,老师的英语估计全是来自Primer Plus中文版教的🤣
178826,936,翁恺,2023-07-24 16:17:10,-48,6,54,C大。无小组合作＋展示，无互评。但是有四五个大程，p1还是挺复杂的。老师上课的内容还有ppt基本就是他的mooc视频上的内容，上课会抽人上台回答问题，不过答出来了会加分。第一节课的时候突然来了两个小测，错了一题直接扣了总评0.5还是1分，还好最后总评94.5进了上去。
178877,936,翁恺,2023-07-27 07:08:37,-3,1,4,❤️❤️❤️
180514,936,翁恺,2023-09-24 07:46:44,-2,1,3,好的的
182911,936,翁恺,2023-11-21 05:27:42,6,10,4,至少技术沟通上的wk就是个铁nt。站在讲台上一顿输出自己的观点不管对不对反正就得听我的，带着一种对知识莫名的高高在上的感觉搞一言堂。觉得这也不行那也不行，google scholar不行，arxiv也不行，找篇文献要让你找他列的语法，铁脑瘫，不想上课可以不上，要不是20级之前是必修，会有人听你搁那bb吗？真以为自己就代表真理了？
184965,936,翁恺,2023-12-24 18:03:48,1,6,5,技术沟通课纯nt，十几次小组讨论，几次小组作业（还有一份开题报告），三次平均至少3000字的个人作业，一个短学期nm这么多作业？我真的是边写边骂
189561,936,翁恺,2024-01-25 11:13:01,-1,1,2,程算还是可以的，不过想学好课后还是得花时间的
195813,936,翁恺,2024-06-30 04:11:52,4,6,2,oop你布置的一坨作业都在干什么\n\n上课认真一点好吗，别天天做三本题了ok？
196902,936,翁恺,2024-07-06 00:51:12,6,8,2,oop， 虽说事情多了点但是实际工作量还行，并且确实能学到一些工程上的思想，而且给分会捞，个人觉得感受挺好的
196976,936,翁恺,2024-07-06 08:05:23,-1,1,2,oop会捞
197210,936,翁恺,2024-07-09 07:07:56,15,16,1,OOP。老师上课质量很高，节奏把握的很好，每周两节课听下来很有收获。上课会有偶尔抽人回答问题当做签到，作业相对比较多但是不算难，也会开放补分集，大程有一定的工程量但是细节上考虑的不用特别仔细，老师强调过只需要用好OOP的思想即可，所以整体平时分只要肯花一些时间是比较容易拿到高分的。期末考最后一题人工批阅，完成相应类的设计即可。最后总评也会捞捞，感谢翁老师，从C语言入门到C++，带给我们这么多优质的课程。
201577,936,翁恺,2024-11-04 12:25:07,9,9,0,我说你教考分离别太离谱，你让高中没学技术的人怎么活，纯纯给别人当分母吗
203201,936,翁恺,2024-12-16 02:57:47,5,5,0,很通识\n\n我朋友很喜欢
204701,936,翁恺,2024-11-27 11:59:37,28,31,3,PPL，老师用 GPT 出题，学生用 GPT 做题，这辈子有了！
204704,936,翁恺,2024-11-27 12:02:08,20,20,0,PPL届的杨莹春老师👍
205033,936,翁恺,2024-11-30 04:44:08,0,1,1,课程作业和考核题目质量很低。有一次我错了一道题去问他，他给了和我一样的答案……
205127,936,翁恺,2024-12-02 03:06:53,1,2,1,＼wk/
205996,936,翁恺,2024-12-13 02:49:24,-2,0,2,上课讲课很生动，但是课后作业和上课内容没有多大关系，对于新接触计算机的同学不是很友好。有时候会炫技
206349,936,翁恺,2024-12-14 12:37:01,27,28,1,老实说，你也不懂PPL对吧
206375,936,翁恺,2024-12-14 16:08:34,0,1,1,很认真
206438,936,翁恺,2024-12-15 06:22:53,2,2,0,线上听翁凯c语言，结合课本能掌握很多基础知识，对自学的同学有很大帮助
207465,936,翁恺,2024-12-22 05:22:58,1,2,1,自己学，选没选技术都不好过，全是理论
207863,936,翁恺,2024-12-24 14:36:43,14,14,0,PPL快逃!!! 课程质量刷新wk下限，作业和授课完全脱节，上课不知所云，课件满是GPT味儿，作业还会遇到助教狠狠上难度，上课听了也没用，如果就是想凑个学分为啥不上别的，要选PPL难为自己？快逃!!!!
208085,936,翁恺,2024-12-25 13:47:30,3,4,1,PPL 大破防口牙
208178,936,翁恺,2025-01-04 07:26:58,22,23,1,考完试回来：大翁老师你是我的神，试卷简单到考试时间过了一半考场里大半人都走了，你是我的神，大翁老师你百事可乐，千事如意，万事吉祥，PPL万岁\n\n\n\n<u>\n\n想必老师自己都没学会PPL吧（雾\n\n\n\n无论你是想学真本事还是想水学分，都不适合选这门课\n\n\n\n这门课大翁老师有点力不从心了。。。\n\n\n\n现在老师住院了，祝愿大翁老师早日康复🙏\n\n</u>
208492,936,翁恺,2025-01-04 07:10:42,10,10,0,翁老师是全球最懂PPL的人。
208892,936,翁恺,2025-01-03 07:05:06,0,2,2,私信从来不会
209000,936,翁恺,2025-01-04 07:06:31,10,10,0,本人从未诋毁，大翁老师是世界上最懂PPL的人👆🏻
209001,936,翁恺,2025-01-04 07:06:51,8,8,0,对不起大翁老师，没有人比你更懂PPL👍🏻
209002,936,翁恺,2025-01-04 07:08:59,7,7,0,孩子们，没人比我更懂ppl
209003,936,翁恺,2025-01-04 07:09:00,4,5,1,世界上最好的PPL老师
209006,936,翁恺,2025-01-04 07:21:59,5,6,1,我错了，你最懂ppl了😭\n\n你就是ppl之父
209008,936,翁恺,2025-01-04 07:34:56,6,8,2,尽管试题简单，喜欢他的PPL课的这辈子有了👍
209009,936,翁恺,2025-01-04 07:47:34,4,4,0,24-25秋冬 PPL 课程组成：\n\n10%课内（小测、问答、点名）\n\n40%作业 5 次课后作业（不知道为什么没有 PCF 的作业）\n\n50%考试，书面，A4 可打印\n\n评价：\n\n1.就算PPL期末简单也改变不了这门课听课体验差的事实，课程逻辑框架挺差的，很多东西感觉讲来讲去内容重复了很多遍，上课证明后期感觉经常写错或者，再加上今年放教七上课，回放时屏幕反光严重、音质差（杂音多听得很难受， 2 倍速听不清，翻了 23-24 的回放勉强可以 2 倍）。\n\n2.课前小测有七次（六次课前一次课末），AI 出题，比较简单，不过有次小测甚至出现错题（但“正确率”还是几乎 90%，可能像楼下说的老师 AI 出题，学生 AI 答题。。），不知道为什么到现在也没改回正确答案。\n\n3.作业略有点脱节（有和上课内容略无关的题目，不过期末不考），可以看往年的两位助教笔记作答，个人感觉作答时间较长。\n\n4.如果课程来年还是一样难度的考试，建议不要花太多时间在这门课程上，大题面向历年题/ppt就行（比作业简单），尤其是那些老师有写题解的 ppt 内容，太难的不会考（可能大翁老师也不会），选择基本与小测类似，就算你不懂也基本能推断出来，填空其实就是“小大题”，与大题一样的策略即可。
209134,936,翁恺,2025-01-04 15:19:31,2,3,1,本人从未诋毁过大翁老师的ppl......
209504,936,翁恺,2025-01-06 06:32:11,0,0,0,ppl的神
211140,936,翁恺,2025-01-11 01:37:12,1,1,0,ppl thanks
211541,936,翁恺,2025-01-12 01:44:10,1,2,1,老师捞捞我爱你
211824,936,翁恺,2025-01-12 15:18:42,0,2,2,PPL 这个学期有 7 次开课小测 5 次书面作业，小测共占 10%，作业共占 40%，期末 50%。\n\n翁恺不管作业，作业是由助教全权负责，作业难度是比上课难度高的，会有上课和考试不涉及到的部分，做起来会有些痛苦。\n\n翁恺在这门课的讲课完全可以用“人机”二字概括，slide 做的一点都不认真，甚至 GPT 痕迹很重。大翁老师在这门课的讲课水平也是难以恭维，他能讲明白的东西大家都会，大家看不懂的地方他就讲不明白。\n\n唯一能夸的点就是期末考试很简单。总之凑学分可以选，想听翁恺讲课学东西还是算了。
212603,936,翁恺,2025-01-14 09:09:06,-4,0,4,人很好，适合选来凑学分
212903,936,翁恺,2025-01-15 08:08:11,1,1,0,Java真的要挂了......
213101,936,翁恺,2025-01-16 04:37:24,3,3,0,Python:讲课中规中矩，对基础不好的不友好，作业少，考试严重教考分离，给分集齐求是，一分不捞，算出来多少就是多少
213122,936,翁恺,2025-01-16 04:48:06,-3,0,3,py满绩！因为是技术选考生所以上课没怎么听过但是老师讲得真的很好，对于一些难点会用形象有趣的比喻帮助大家理解，课上还会随机掉落一些稀奇古怪的冷知识。10分！
213146,936,翁恺,2025-01-16 06:15:51,-2,1,3,编程语言原理，真的是事情多给分差啊
213325,936,翁恺,2025-01-17 03:21:11,1,1,0,Python讲课会拓展，只不过月考考到没讲过也不少，期末考还算简单，高中没选技术，最后能4.8也满意了
213342,936,翁恺,2025-01-17 04:24:17,7,7,0,我宣布wk老师是最懂java的人！！！我将永远追随拥护！！\n\n没有卡绩，不签到，平时分好好做pta和两个prj（prj不要抄）基本给满（69/70），期末考砸了没考到隔壁lwm班考前说的斩杀线40差点以为要寄了，但好像wk老师没管斩杀线，最后还拿到了对我来说我很好的绩点，太香了！
213381,936,翁恺,2025-01-17 06:42:40,2,2,0,wk老师上java的水平还是很高的，听着不会很无聊。祖传ADIF的各种坑在98上有讨论，聊天服务器只要功能齐全基本给满，给分比隔壁好很多。java这门课的最大问题还是期末考太逆天
213448,936,翁恺,2025-01-17 12:06:24,0,1,1,上过翁老师24年秋冬的python课程，翁老师上课不会用教研组统一的课件，会用自己做的课件，课上会拓展一些有趣的知识，能感觉到老师很有想法也很有水平，总的来说比较适合有一定基础的学生听。老师人很好，虽然忙但是也会及时回应学生的提问和需求。给分比较求是，期末会直接放出理论考成绩和平时分，最终成绩在此基础上几乎不会改。期末不会开放作业补交通道。个人非常感谢老师
213646,936,翁恺,2025-01-18 17:29:22,5,5,0,java给分很好，平时分基本接近满分，但是这门课的期末考试非常逆天，一定要慎重选课，真的要慎重。\n\n大翁老师讲课水平还是有的，但是感觉对这门课越来越不上心了。从期末考试来看，这门课涉及的内容是非常多的，但是上课讲的内容和考试的内容关系不大，或者说很多地方都只是提几句就过去了。这在准备考试的时候就很难受，复习了几天发现历年卷的题还是不会做。\n\n\n\n总之，java一定要慎选。
213821,936,翁恺,2025-01-20 06:40:36,1,1,0,老师很好 给分很公正 就是月考可能有点难，平时也不用学的太认真，偶尔突击下，像我这种没有python基础的也能满绩
213915,936,翁恺,2025-01-21 08:43:23,1,2,1,java 你在出什么题目啊
214172,936,翁恺,2025-01-26 17:01:34,8,9,1,已读不回
214763,936,翁恺,2025-02-17 14:15:51,1,1,0,讲课很有趣啊
216950,936,翁恺,2025-03-30 07:35:25,-9,0,9,为学生考虑的好老师，事少分高
217394,936,翁恺,2025-04-09 12:59:25,8,8,0,别的不说，wk老师的事真的少吗，楼下你摸着良心说说[ac01]
218031,936,翁恺,2025-04-19 10:22:43,4,4,0,上课很好，逼事很多，喜欢水的人别去
221497,936,翁恺,2025-06-27 01:19:50,3,3,0,OOP\n\n怎么能平时分扣成这样呢😭😭😭翁老师啊翁老师，慕名而来跨专业选课，终究是因为实力不够要遗憾离场嘛😵‍💫\n\n\n\n平时事情多，扣的分也多，费力不讨好😮‍💨
1126,994,黄正谦,2015-03-21 16:14:25,4,8,4,很有激情
3073,994,黄正谦,2015-05-13 11:38:49,0,1,1,激情澎湃。。讲的还好
5286,994,黄正谦,2015-07-06 09:50:11,3,6,3,有激情 给分善
7564,994,黄正谦,2015-09-15 04:19:11,0,2,2,讲课有激情，给分很厚道
8804,994,黄正谦,2015-09-28 03:46:04,0,1,1,很有激情
8992,994,黄正谦,2015-10-08 08:27:04,0,1,1,激情，讲课都不带停的
9178,994,黄正谦,2015-10-15 08:53:14,3,6,3,挺有激情的 其实是书无聊 能把无聊的书讲到有激情 已经很厉害了
11152,994,黄正谦,2015-11-24 16:57:23,1,2,1,挺好的 讲课真的很激情
17692,994,黄正谦,2016-01-20 15:49:02,3,5,2,老师讲课很投入很认真，他能用这种热情来给我们上课真的让我觉得很佩服。而且平常不会布置繁琐的实验作业，总说大家掌握就行。是一个人认真的幸福的人。
18338,994,黄正谦,2016-01-21 12:55:12,3,3,0,幽默风趣，讲课很有感染力，干货满满
19617,994,黄正谦,2016-01-25 03:06:06,0,1,1,非常有激情 人很好 平时作业不多 就是期末突然布置了很多… 给分不错的
19671,994,黄正谦,2016-01-25 05:23:35,0,2,2,讲课有激情 给分好 就是期末最后一个星期突然布置了一篇论文。。措手不及。。不过老师人超好～!
20006,994,黄正谦,2016-01-26 01:47:34,4,6,2,超级棒，讲课激情，能把难懂的知识生动化，太喜欢他了！！作业布置也特别合理！
21020,994,黄正谦,2016-02-10 08:36:58,0,1,1,觉得还算可以，讲的比较细
21079,994,黄正谦,2016-02-15 14:16:04,0,1,1,很有激情\n\n
91779,994,黄正谦,2018-12-20 03:01:07,5,8,3,考试要考 但我不讲
91780,994,黄正谦,2018-12-20 03:02:38,28,41,13,八字真言：考试要考，但我不讲。\n\n\n\n一直讲故事，对课程内容不是很上心，包括实验和理论。\n\n能收获他的一万个小故事。
101840,994,黄正谦,2019-01-29 08:47:34,-1,4,5,给分低
102484,994,黄正谦,2019-02-03 08:50:03,13,15,2,"老师讲课很好。虽然经常""这里要考，但是我不讲""，但是这应该是教授计网的正确方法吧。。。毕竟这800多页的鬼书真的能在上课那一点时间都覆盖?老师上课的时候会把一些重点以及框架都说清楚。我的体验是，上课之前啃书速度会很慢，因为对当前要讲的整体内容不了解，看着看着就卡在某个概念上了，虽然每个单词都查了，但就是不明白整体要表达什么意思(可能只是因为我太菜)。但是等上完课再来看书，卡住的时候就少了，因为那些复杂的地方上课都详细的讲过了，没详细讲的地方自己看书也不会有什么问题。\n\n老师对课程内容的安排可谓是非常合理了。"
116878,994,黄正谦,2019-09-17 03:12:39,0,1,1,讲得很有趣 但不下课 /呲牙
131367,994,黄正谦,2021-01-27 08:47:17,0,5,5,只讲故事，温水煮青蛙，快跑
132970,994,黄正谦,2021-02-05 14:57:45,1,2,1,喜提倒数第二低绩点
132973,994,黄正谦,2021-02-05 16:14:25,8,10,2,计网:黄老师是亲历并且精通网络领域的老师之一，上课很有激情，很贴心的把quiz留到课后。平时分相比其他班基本给的都很高，期末想拿高分可以做做考研题。总之很不错~
132977,994,黄正谦,2021-02-05 16:41:16,2,3,1,挺好一老师，虽然本身课程内容比较无聊，但是还是讲的很投入，给分也很好
132991,994,黄正谦,2021-02-06 02:39:48,2,2,0,老师上课很有激情，但是重点内容讲不清楚，需要自学\n\n给分真的很好
132993,994,黄正谦,2021-02-06 03:11:37,3,3,0,给分也太好了吧，黄老师yyds\n\n不过感觉计网讲得有点像通识，选上的同学最好拿一本王道自学一下
133000,994,黄正谦,2021-02-06 05:18:02,1,2,1,給分很好，講課很有激情，考試複習多刷題庫問題不大
133004,994,黄正谦,2021-02-06 05:51:30,0,1,1,老师给分很好，我看我室友是隔壁qjs班的，实验扣了总评四五分，我们班好像平时分基本给满了，lab8还算加分
133370,994,黄正谦,2021-02-26 11:13:09,-1,0,1,老师超级可爱！上课很有激情让人很想听，但是计网这门课就是要自己去看才能懂...给分好，唯一的缺点就是不怎么让人下课qaq
136562,994,黄正谦,2021-06-21 06:12:58,1,2,1,老师实验开始的太晚了，堆在后面就比较难受qwq 但是人很好 讲课有激情 偶尔还会亲自到实验课，给分也不错
144400,994,黄正谦,2021-12-21 10:55:24,2,2,0,讲课细节 口齿清晰，有趣，快冲
147693,994,黄正谦,2022-01-10 13:17:23,2,2,0,计算机基础课，不推荐。\n\n感觉老师水平太高了，不适合入门课，不易理解。\n\n推荐上其他老师的大计基。\n\n但是老师人很好，钉钉答疑非常及时。
148783,994,黄正谦,2022-01-13 13:30:10,2,2,0,大计基周课时要是变成4，绝对是个好老师。两课时的话必须看回放补天，老师讲得很细很快，2课时对菜狗不友好。课后会很认真的解答同学的疑惑。
149692,994,黄正谦,2022-01-16 11:33:57,6,6,0,计网实验一定要提前做，找周末空的时间做掉，别拖到期末考试周再做
149721,994,黄正谦,2022-01-16 14:24:59,3,5,2,[计算机网络] 讲课很有激情， 给分真的很好， 平时认真学， 考前把王道刷一遍就没问题
149731,994,黄正谦,2022-01-16 14:50:58,6,6,0,计网给分太香了吧！可以放心选。\n\n黄老师平时讲课还是很细致的，也很专业，知识背景铺垫非常到位（如楼上所说上课收获一万个小故事，大佬们可以不听，不过对我这种对计网缺乏基础认识的新手还是很有帮助）。\n\n讲课不是以考点主导的，比较随心所欲，很少提示重难点，应试的话可能需要自己结合教材、网络资料和考研资料总结一下。\n\n相比其他教学班实验进度比较赶，冬学期才进实验室，不想最后一个月爆肝建议自己早点开始做。\n\n最后就是课程设计照搬美式教材，对于没有预修通信原理、抽象代数的计算机专业学生很不友好，很多知识点（集中在物理层和数据链路层）没有时间去深入细讲（但是要考），学生往往知其然不知其所以然，非常难受。考试可以用死记硬背解决，想弄明白需要自己课下去下功夫。
149732,994,黄正谦,2022-01-16 14:57:00,2,2,0,计网作业平台设计上有很多不合理的地方，不过练习和小测分不高不要太担心，亲身体验对总评影响不大。
149733,994,黄正谦,2022-01-16 14:57:45,2,3,1,2次quiz没做但最后给分还是很好
149749,994,黄正谦,2022-01-16 16:06:19,6,6,0,老师是好老师 上课用心\n\n提三点：1.实验提前做 2.找陆魁军班同学要考前100题 3.老师给分好是整体而言 具体到个人并不一定 我就是不努力学习的例子 引以为戒
150171,994,黄正谦,2022-01-20 00:30:19,4,4,0,【大计基】老师人真的很好，开学的时候问过他三种编程语言该选哪一种，老师把三种语言利弊都给我分析了一遍，还结合了我的专业给我作了推荐，真的是十分真诚的！平时上课也十分有激情，会举很多很多的例子，能把大计基这么枯燥的课也讲的很有趣。所以我觉得我上课睡着完全就是因为这个教室自带催眠效果，绝对不是老师的问题（手动狗头）。另外，由于我本身落下了一次作业，但最后绩点却依旧上了4，感觉老师确实是很认真在捞人了。这样的老师选了绝对不亏啊啊啊！
150191,994,黄正谦,2022-01-20 04:38:51,1,2,1,大计基这门课本身就不是用来听的，主要靠自学。从老师的角度黄老师是个好老师，给分也不错，就是有的同学计科利用系统bug抄答案挺不爽的。
158507,994,黄正谦,2022-06-30 01:50:10,-1,4,5,不点名 但给分实在一半 大计基讲课不面向考试 跟书本次序不一样 太乱了 听不进去
167289,994,黄正谦,2023-01-15 11:48:38,1,1,0,老师人很好，虽然上课有点催眠，但是同学去问题的会很耐心地讲解，会及时转发学校通知，有点名，但会给足够的时间签到，还有就是给分超好，我的计算机基础接近于零，一百四十多人的班，我平时作业排名在一百开外，小测和期中考也不是特别理想，期末考复习不算充分，考完特别紧张，以为会挂，没想到有八十分，真的很感谢老师！
167302,994,黄正谦,2023-01-15 12:38:54,0,0,0,老师真的超好
167352,994,黄正谦,2023-01-15 15:00:33,0,0,0,djj 老师怎么感觉不太爱回答问题（钉钉私发或者群里发好像不是很爱回，是因为问的是编程题期末不考吗，但是这个是作业啊我不懂python我确实得问清楚啊（苦笑\n\n老师是个好老师，虽然可能不适合我，但是真的真的是个好老师的。祝老师春节快乐！
167367,994,黄正谦,2023-01-15 15:57:34,5,5,0,老师讲课的速度较快，有时和课本的顺序不一样，也会有考试范围外的内容，但这些“范围外”的内容对我们还是有帮助的呀，并且老师布置的作业只有pta，没有各种上机实验、实验报告需要完成（这点可能会让有些同学松懈），小测从作业里抽题目完成，只要小测前认真过一遍作业，基本可以做全对。某次下课我去询问老师一道编程题，老师也很耐心地回答。\n\ndjj改革后的大部分考试内容都需要自学，这和老师没有太大的关系了，认真看自学视频、做笔记（我都是截图、按知识点放word里），边看视频边自己在电脑上操作，多熟悉实操和记忆，期末一般不会挂的，平时作业按时完成，助教老师会捞的。后悔期中前没有复习，什么都是乱蒙，千万不要像我在期末前2天才疯狂补天。所幸上4啦。\n\n在这里提前祝老师和助教新春快乐*:ஐ٩(๑´ᵕ`)۶ஐ:*
167411,994,黄正谦,2023-01-16 06:40:20,1,1,0,大计基真的很棒，问问题都会耐心回答
167584,994,黄正谦,2023-01-17 12:45:30,0,0,0,大计基，上课讲得挺详细（除了要考的python完全不讲），但是语调不变没有互动让人有些无法集中注意力（对我来说是这样的），小测都是作业题，一点不为难人，给分超好！！
168375,994,黄正谦,2023-02-15 04:32:19,4,4,0,【大计基】老师上课真的很有激情 认真听的话还是比较容易听懂的。（虽然语速快但实际上每个知识点都很细很生动）\n\n虽然这门课挺傻*的 但老师真的好 作业比其他老师少 室友的RPA都要做作业，书本上的单元练习也要做，而黄老师只布置PTA上的题目，虽然有些东西他不讲但是他会告诉你如何去自习 可以说是压力比较小的\n\n事实证明只做PTA做懂，并且按照他的要求来复习的话完全够了 多看看课程组统一PPT就很简单\n\n最后5.0
169539,994,黄正谦,2023-02-27 01:09:27,5,9,4,22-23计网，讲课连珠炮重点不展开，实验不给组队（其他平行班交换机和socket都可以组队），助教从来没出现过，实验布置一团乱麻，总之就是别信评分
169694,994,黄正谦,2023-02-27 11:55:23,4,4,0,计网事情其实挺少的，期末捞我一把。总体很好，就是得自学。
170011,994,黄正谦,2023-03-01 03:31:45,4,7,3,给分差，实验给分尤其差，避雷
170310,994,黄正谦,2023-03-02 15:35:26,4,5,1,整个计算机网络的课程组都是傻逼
180817,994,黄正谦,2023-09-29 11:22:22,1,2,1,讲的真jb烂没有任何逻辑可言，在这唱rap呢你妈的。\n\n拖堂还拖nm呢拖\n\n土的是你
189244,994,黄正谦,2024-01-22 15:45:35,0,0,0,计网，个人认为给分不错，实验的事情不算太多，有两个不需要做的。实验要注意自己完整做一遍。\n\n平时的压力比较小，quiz在课后别忘了就行。讲课的话实在是不太跟得上，导致平时去的人也确实不多，如果人太少了老师也会数字点名。
189543,994,黄正谦,2024-01-25 10:48:43,0,0,0,计网，实验ddl基本是在考试前，讲课节奏很快，经典的只要我讲了我就是讲了（bushi\n\nquiz和作业后面会给补的，给分中规中矩\n\n被卡机了，悲
189602,994,黄正谦,2024-01-25 15:20:14,0,0,0,计网\n\n平时不点名，看人很少了就会点名，但是都是数字签到。小测作业最后还有补交，还不错，就是不知道有没有多扣分，最后考试和王道高度重合，建议多刷刷
58741,999,陈纯,2017-09-16 10:41:14,1,2,1,
110149,999,陈纯,2019-06-24 02:32:37,1,3,2,我18级学生，去玉泉听过陈老师的编译原理，很有趣呢！
71584,1002,唐敏,2018-01-28 15:54:17,0,2,2,很可爱
75495,1002,唐敏,2018-03-12 12:08:16,0,0,0,还不错
81990,1002,唐敏,2018-07-06 17:30:57,0,1,1,老师很耐心
86408,1002,唐敏,2018-09-15 08:43:52,11,19,8,“来给大家看一段我写的程序～”
115121,1002,唐敏,2019-07-16 00:38:41,0,1,1,上课挺清楚的
135747,1002,唐敏,2021-05-23 05:14:58,0,0,0,老师挺好的，上课有意思
136482,1002,唐敏,2021-06-18 13:29:24,-1,0,1,挺不错的
152340,1002,唐敏,2022-04-05 11:03:21,0,0,0,好好好
153079,1002,唐敏,2022-04-25 04:13:27,5,7,2,GPU 工程与应用课，算是我研究生收获最大的一门课了。
157540,1002,唐敏,2022-06-23 16:18:49,3,5,2,点名一次总评4分\n\n有发言分，但不知道怎么算\n\n发言了5次最后平时成绩很离谱\n\n慎选，大绩杀\n\n这个学期的助教哥哥很好非常负责任，但是以后就不再当这门课的助教了
157778,1002,唐敏,2022-06-24 20:42:11,2,4,2,平时分一共20分，12分签到，4分课堂发言（一次0.8，五次才给满），4分大作业展示（不展示就一分没有）。真没想过会因为平时分而被绩杀，快逃😅
163045,1002,唐敏,2022-12-07 03:40:28,1,1,0,难绷我只能说
170436,1002,唐敏,2023-03-04 16:07:38,1,1,0,有点小绩杀
198735,1002,唐敏,2024-09-11 07:28:10,2,2,0,上课学不到啥，xl助教人很好
217570,1002,唐敏,2025-04-13 13:19:35,0,0,0,呵呵呵呵
219189,1002,唐敏,2025-06-16 07:46:11,3,5,2,助教大哥哥，我要和你结婚\n\n-----\n\n给后来的同学提个醒，这个课之所以要有这么多bonus，是因为它一个实验的给分是可以在50~100分之间波动的，你如果做得不好是只有50分或者60分的，因为实验没有验收，所以你也不会知道你做得哪里不好。所以有时间还是多做几个bonus吧，要是一个bonus都不做的话可能会比较麻烦
221711,1002,唐敏,2025-06-25 11:11:52,1,1,0,上课学不到什么，但是实验质量还可以\n\n\n\n平时实验给分不高，建议bonus全做，不然得分不高。bonus做了就给满，但是平时实验给分普遍低。\n\n\n\n考勤
107868,1058,万华根,2019-05-10 18:05:34,10,10,0,很不能容忍不同意见，上课很蠢没什么干货，非常偏执。
158412,1058,万华根,2022-06-29 05:19:03,-8,2,10,推荐老师的人机交互与虚拟人，今年开始作业减为一次小组展示和一篇小读书报告，事少给分好，课程内容也很有收获
163192,1058,万华根,2022-12-09 11:00:01,17,17,0,https://www.cc98.org/topic/5483515/1
163193,1058,万华根,2022-12-09 11:29:07,20,20,0,98观光团，来看看偏执狂样本
163197,1058,万华根,2022-12-09 13:08:29,7,7,0,校内撞伤学生后交警判其全责，后对学生破口大骂、出言不逊，并不愿支付医疗费用。详见楼上cc98的链接。
163205,1058,万华根,2022-12-09 20:03:55,5,5,0,就是你小子是吧
163206,1058,万华根,2022-12-10 01:21:12,8,8,0,欺负路人学生的老师能指望对自己手底下的学生怎样么？
163209,1058,万华根,2022-12-10 02:04:07,8,8,0,大家再不攻击他我可要攻击大家了
163215,1058,万华根,2022-12-10 04:09:26,8,8,0,师德存在严重问题
163570,1058,万华根,2022-12-15 09:34:47,3,3,0,还在嘴硬，把责任推到学生身上，拒不认错，垃圾司马玩意儿
163577,1058,万华根,2022-12-15 10:51:05,3,3,0,学或许为人师，行无以为世范
163599,1058,万华根,2022-12-15 13:31:35,2,2,0,甩锅能手
184101,1058,万华根,2023-12-09 06:43:30,1,1,0,看到历年十大过来补个1分，真恶心
210668,1058,万华根,2025-01-09 15:13:05,0,0,0,今天又看到一个交通事故伤害学生然后打死不认责任的÷生上了98十大，想起这位衣冠禽兽，来挖个坟
610,1063,张三元,2015-03-15 07:04:51,12,21,9,英语和中文都很难听懂
1172,1063,张三元,2015-03-21 16:24:32,45,53,8,张老师重新定义了英语
1200,1063,张三元,2015-03-21 16:34:24,2,11,9,朴实的数学老师
1533,1063,张三元,2015-03-22 11:13:44,16,19,3,不太容易听明白他在讲什么
1761,1063,张三元,2015-03-24 05:38:14,-12,5,17,人很好\n\n讲中文很好
2363,1063,张三元,2015-04-27 13:39:44,11,15,4,额(⊙o⊙)…还是自己预习吧…水平据说牛，教课不是很好
3115,1063,张三元,2015-05-15 01:34:05,9,15,6,没逻辑，英语中文都听不懂，前期超慢，后期快。不觉得是个好老师。
5423,1063,张三元,2015-07-07 09:32:43,1,7,6,老师人挺好的，解答问题很耐心
6835,1063,张三元,2015-07-24 00:17:41,5,8,3,一次点名是期中试卷不认领，\n\n给分有点奇怪，主要是期中考试给分太低的缘故，其他都很好，知识也很足，一定要多问问他题目，计科可能将来就用到了
16959,1063,张三元,2016-01-19 10:07:15,4,8,4,没重点，不讲考试的内容，期中考又难，怎么考的好，给分烂的祥。。
22853,1063,张三元,2016-03-13 12:25:44,1,4,3,好好不解釋
23130,1063,张三元,2016-03-19 02:36:40,0,1,1,英语太不标准了，单词大部分都读错了
23131,1063,张三元,2019-07-09 08:59:14,3,4,1,好敬业，腿脚不方便\n\n
24358,1063,张三元,2016-04-30 02:02:26,4,6,2,毒性深重啊
25833,1063,张三元,2016-06-11 02:22:37,1,1,0,不听课
26488,1063,张三元,2016-06-19 04:58:50,1,2,1,只能说上课交作业很水，然而内容和学分不水，能不选的还是进来不选吧
30994,1063,张三元,2016-07-03 05:52:17,2,6,4,除了英文讲的不好之外，绝对好老师
32003,1063,张三元,2016-07-05 10:56:26,0,1,1,老师人不错，但讲课真的。。。\n\n最好还是别选，尤其是周六的课。。给分我也不多说了，自己确实没听过课，不怪老师
32004,1063,张三元,2016-07-05 10:59:47,4,9,5,上张老师课没什么感觉，各种听不懂，快期末用了翁彦琳的ppt复习，真是不要太好用。最后均绩4.2飘过。
32010,1063,张三元,2016-07-05 11:04:30,-3,3,6,。。。这英语这给分去死吧
32045,1063,张三元,2016-07-05 13:04:55,2,4,2,英语不行，中文也不行，给分不行，真的不行。
32166,1063,张三元,2016-07-06 00:25:11,0,2,2,给分烂！同样的水平去翁老师那绩点差距可能有1
44654,1063,张三元,2017-01-18 05:33:11,1,2,1,很低的，呜呜
50290,1063,张三元,2017-05-02 07:50:32,2,3,1,英语不行就不要用英语出卷了嘛。。。other 和the other都弄不清楚。。。
54865,1063,张三元,2017-06-30 10:44:30,1,1,0,今年考试怎么这么难woc。。。
56441,1063,张三元,2017-07-04 00:11:47,0,2,2,老师讲得很好。英语没那么糟糕。
56698,1063,张三元,2017-07-04 10:00:21,5,6,1,好老师，水平很高，就是给分有点求是，不过这样才能认清自己水平。
56846,1063,张三元,2017-07-05 01:02:28,9,9,0,不小测不点
75302,1063,张三元,2018-03-09 00:27:15,9,11,2,想考高分的同学自学吧，听课有点浪费时间。。别看中文书，中文书也挺烂的，一定要看英文原版，看进去了就会发现英文书看起来很快的。
76002,1063,张三元,2018-03-23 14:42:31,3,3,0,觉得老师讲的很好
80034,1063,张三元,2018-06-19 06:14:47,0,0,0,没什么体验
80977,1063,张三元,2018-07-03 06:49:47,1,1,0,觉得老师挺好的，问老师问题都能很好的回答
84458,1063,张三元,2018-07-13 02:15:40,-2,0,2,上课讲的是啥玩意儿？？？
84464,1063,张三元,2018-07-13 02:27:54,0,0,0,讲课还可以，给分相对来说较差。
84966,1063,张三元,2018-07-14 15:54:32,0,0,0,给分是个啥玩意儿？
86963,1063,张三元,2018-10-17 16:01:05,0,0,0,是真的**
92976,1063,张三元,2019-01-06 12:41:11,-1,1,2,很不错
102960,1063,张三元,2019-02-25 06:16:42,13,17,4,第一节课40分钟开场白，之后开始讲学史，嗯我以为我在上通识课。
107611,1063,张三元,2019-05-07 17:56:18,0,1,1,上课基本只有几个同学在听 说实在的 老师讲的还行 就是有点催眠
112112,1063,张三元,2019-07-03 15:15:44,5,5,0,半年前我还是个萌新，看了学长学姐的评论虽然有点害怕但是想了想靠自己也可以的，后来发现大错特错！\n\n首先老师讲得真的烂，讲话糊里糊涂，中英文分不清，上课无起伏无重点；\n\n其次只有期中考，很难，平均分65，其他班五次小测很简单，加上作业轻松拿满平时分！\n\n第三，也是最过分的一点！花了三个星期讲了第四章，而这是根本不考的内容，以至于最后两周，一周讲一章！\n\n第四，翁老师有QQ群，还会进群答疑，非常频繁，考前会讲卷子题型分数分布，而张老师，什 么 都 没 有 ！\n\n总之学弟学妹们千万别选他！如果预置就退课！实在不行就翘课去听翁彦琳老师的！
114155,1063,张三元,2019-07-09 01:46:19,-6,7,13,老师从不点名不小测，这是选他课的最大好处，可能也是唯一好处。老师水平很高，还会讲很多期末不考的内容（然而期中会考），上课讲得比较透彻，然而只是讲给他自己一个人听的。期末预习的时候别看他的ppt，他的ppt基本上就是按顺序把书抄了一遍，推荐直接看书上每个chapter后面的key terms and results，这课的内容太琐碎了，这样能够最快地把章节主要内容预习完。平时从不听课，就这样刚预习完就去考试了，他卡我分91，所以我也来卡他评分9分。
114164,1063,张三元,2019-07-09 02:14:27,1,3,2,不点名，无小测，给分好，自学者必选
114242,1063,张三元,2019-07-09 08:52:55,4,6,2,这么多人吐槽老师讲课？？我觉得语言方面不能成为听课的绝对障碍吧，如果你有预习或者上课完全跟着ppt走我觉得课堂效率并不低。我想如果换作一个外国教授全英文授课，不见得能接收更多吧。\n\n老师不建群是他的教学方式，如果你仔细观察你会发现一些同学下课后和老师讨论，老师思考很细致，讲解很详尽，为什么一定要在群里解答呢？\n\n最后一周讲了一章也无可厚非吧，最后一章确实也不是考试重点。\n\n希望大家客观，这门课学好不易，但不要把一切归错于老师，找找自己的原因吧。
114558,1063,张三元,2019-07-10 16:46:28,5,6,1,其实老师人挺好的，我之前有问题问他他都非常耐心地解答，我期末有一道题写的比较奇怪，我怕老师改错，就发邮件向他说明情况，万万没想到他回复我说查了没改错，还分析了我主要的失分点，我从没想过老师还会这么详细地回复一个普通学生的邮件！关于（可能的）缺点主要有：1.上课不太听得懂，还有点想睡觉。当然想学的人也是可以学的。2.没有微信群，也不太说考点什么的，有些不考的也上，导致我们一脸懵逼。我花最多精力学的第四章居然不考！（但其实对以后的学习有用）3.不管考得怎么样都不调分。真的希望老师可以调分！！！可能老师心里也没有调分这个概念吧，觉得考得如何就是如何，但均绩不到三也太恐怖了！老师如果调分的话，大家对他的评价肯定会高很多！
115079,1063,张三元,2019-07-15 07:33:18,0,0,0,boring
122473,1063,张三元,2020-02-29 04:31:58,0,2,2,人挺和蔼的。中文和英文都说的不好。念ppt。经常结巴。
124373,1063,张三元,2020-06-30 02:20:30,0,0,0,太烂了
125786,1063,张三元,2020-09-14 08:38:59,1,1,0,好好自学才是王道。学弟学妹多看看别的班的ppt叭
134614,1063,张三元,2021-04-06 01:59:35,0,0,0,人挺好 最大的问题就是口音
134632,1063,张三元,2021-04-06 14:24:54,6,6,0,妄想山海
136802,1063,张三元,2021-06-25 01:28:01,2,2,0,为人很好，仔细耐心，但是上课真的不太行……
139601,1063,张三元,2021-07-18 07:12:33,8,8,0,张老师还是蛮负责，挺认真的。\n\n认真学还是能学到挺多东西。但是唯一的坏处就是没有小测，如果你不是期中能考到95加并且期末能考到90加的话。就不要幻想好绩点了 作为cs专业最后gpa基本都在2.4-3.3 之间 这已经算学的好的了 \n\n能去wyl班的赶紧去
139636,1063,张三元,2021-07-18 15:29:54,0,0,0,上课逻辑不够清晰详略也不得当，加之离散学的东西又多又杂，听课和复习都很痛苦。离散这门课统一改卷普遍给分都不行，课友们能跑还是跑吧没跑掉自学也行反正张老师不点名。
152017,1063,张三元,2022-03-23 06:56:41,3,3,0,zsy老师不作妖不整节目效果，就是单纯的讲得不好给分不好，能跑还是快跑，没跑掉的做好自学+拖绩点的准备到也还过得去。
153661,1063,张三元,2022-05-10 00:28:32,3,3,0,考的和讲的有什么关系吗\n\n人挺好，可惜教学质量不是非常理想\n\n但是我被海底捞了 只有感恩
153918,1063,张三元,2022-05-17 01:14:54,0,1,1,快 跑 ！
156448,1063,张三元,2022-06-19 17:47:47,0,0,0,老师自己还是挺负责认真的
156472,1063,张三元,2022-06-20 02:27:22,1,1,0,张老师讲课水平说实话不咋样，但是人是很好的，看的出来努力在讲课，平时成绩基本会捞满，离散这门课还是很看期末的，如果算上了他的课该自学的还是自学吧，反正不点名
157441,1063,张三元,2022-06-23 08:43:21,18,18,0,10分。\n\n3.9。确实基本上靠自学，遇到不会的问题去问老师，老师解答地很认真很详细，也能看出虽是教授但确实是和你去探讨问题。真的是位人很好、尊重学生、热爱教学、崇尚真理的老师。\n\n一次小测答案有问题，老师和大家沟通了快半节课，然后把改错的同学都加回来了~\n\n但老师的教学方式也的确有一定改进空间，让人不是很好理解。更推荐自学——我觉得离散也不是特别深的学科，主要在知识比较广比较细碎，知识点像课程的名字一样：“离散”。所以自学难度不会很高的，加油学弟学妹们！
176201,1063,张三元,2023-06-28 08:24:36,1,1,0,喜提大学最低分
176276,1063,张三元,2023-06-28 08:25:17,0,0,0,喜提大学最低分
185329,1063,张三元,2023-12-28 02:29:25,0,0,0,给分极差无比，快逃
193756,1063,张三元,2024-06-17 14:19:18,0,1,1,这老师会把离散数学讲成数学史，考前自己发了个历年卷，然后点开一看，竟然是03年的，而且不给答案，试卷比学生的岁数都大，属实令人大开眼界，好在不点名
195939,1063,张三元,2024-07-01 02:09:25,0,0,0,3.0烂爆，是自己没好好学，但今年期末是不是有点太难了
219406,1063,张三元,2025-05-26 13:24:28,1,2,1,从不点名，不用去上课
221866,1063,张三元,2025-06-27 03:49:24,2,2,0,张老师教完我们这一届就退休了，老师人还是超级好的
39922,1071,耿卫东,2016-12-28 07:38:14,5,10,5,超棒的老师啊
79468,1071,耿卫东,2018-06-06 10:51:16,1,6,5,古板 的人
125027,1071,耿卫东,2020-08-15 16:25:18,0,2,2,还可以，认真负责
131222,1071,耿卫东,2021-01-26 15:26:31,14,18,4,工设宝今年培养方案的突发事故，上了耿老师的计算机游戏程序设计。其实耿老师自己也是程序员退役下来教书的，对于我们程序小白已经是相当相当照顾啦！每次看见老师西教徒步爬5楼然后面对一问三不知的我们就心有愧疚！
160345,1071,耿卫东,2022-09-19 13:19:40,2,3,1,程序员退役，但好像手底下读研的同学的压力很大。。。
183726,1071,耿卫东,2023-11-29 08:47:14,9,9,0,总喜欢把职场上的一套评估系统放到课堂上，同学们只想开开心心一起合作完成一个完整的游戏，非要要求上报每个人几比几的分工，组内每个人排个上下位次...课堂上学不到任何干货，教的全是又古板又生涩的东西，跟自己设想的游戏设计课相差甚远。没有人想上他的课，为什么他不去思考自己的原因？
183727,1071,耿卫东,2023-11-29 08:51:36,7,9,2,16年看来还是个好老师 23年成为老登了
183815,1071,耿卫东,2023-11-30 10:27:09,5,5,0,脑瘫老师，什么年代了管理学生还用资本家模式，你也配中国特色社会里活着？
185180,1071,耿卫东,2023-12-27 02:48:24,2,2,0,上他的课被气死
205298,1071,耿卫东,2024-12-04 05:54:38,2,2,0,很抽象
214563,1071,耿卫东,2025-02-13 06:53:36,0,0,0,计游程课程大作业是用游戏引擎合作一个游戏，上课主要讲底层原理，但是个人感觉讲的太底层了一点，感觉可以分出一半讲游戏引擎帮助完成大作业。给学弟学妹的建议是这个课可以选，老师给分挺不错的，学到的东西也挺多，但是尽量早点自学unity之类的引擎，大作业要有完成度。
1772,1109,沈钦仙,2019-01-08 02:16:24,59,76,17,讲课中规中矩，略严肃
2192,1109,沈钦仙,2015-04-07 08:45:22,6,8,2,讲课严肃，思路乱
3089,1109,沈钦仙,2015-05-14 02:27:22,9,14,5,长得帅 然而上课听不懂
3372,1109,沈钦仙,2015-06-07 16:43:15,-10,6,16,讲！的！实！在！差！劲！完全没有逻辑。
4794,1109,沈钦仙,2015-06-29 02:32:32,5,9,4,有点懒的老师
4913,1109,沈钦仙,2015-06-30 11:39:49,3,7,4,其实我觉得讲得还不错，就是确实比较平淡
5694,1109,沈钦仙,2015-07-09 07:19:48,-3,4,7,根本上不下去
6405,1109,沈钦仙,2015-07-13 15:54:15,2,2,0,还可以
7679,1109,沈钦仙,2015-09-15 08:32:59,1,1,0,中规中矩
8530,1109,沈钦仙,2015-10-14 00:29:13,-4,4,8,差的不用说\n\n
8854,1109,沈钦仙,2015-09-29 03:21:45,2,2,0,非常爽
12162,1109,沈钦仙,2015-12-22 06:24:56,0,3,3,无聊 听不下去 每次想好好听课发现完全做不到
13035,1109,沈钦仙,2015-12-24 14:45:54,1,4,3,我觉得老师人很好。但是讲的不好。可以自学然后有问题去问他。（从冬学期开始基本只是去看看课前有无测验，然后去图书馆自己看）
14162,1109,沈钦仙,2016-01-05 06:13:41,5,6,1,很好，赞一个
18424,1109,沈钦仙,2016-01-21 15:09:35,10,16,6,老师很好，我从一个电脑小白成长了许多，自己会解决一些电脑故障，多谢老师。
19281,1109,沈钦仙,2016-01-23 21:51:03,28,34,6,大仙。听完他一学期的课忍不住这么叫他了，上课经常说着说着忘记自己在说什么然后跳过去了。课后解答问题很耐心，但是经常被问倒。人好，大计基考试好好复习，给分很棒！
19285,1109,沈钦仙,2016-01-23 22:11:37,-9,1,10,呵呵只想呵呵
19838,1109,沈钦仙,2016-01-25 11:15:38,1,4,3,作业太多。
19956,1109,沈钦仙,2016-01-25 16:08:57,2,4,2,老师问题时态度很好，给分也超好，大赞
19966,1109,沈钦仙,2016-01-25 16:42:51,1,1,0,得靠自学啊！！
20370,1109,沈钦仙,2016-01-27 07:32:16,0,3,3,不知讲的什么鬼，但给分超好！
20533,1109,沈钦仙,2016-01-28 07:42:35,-7,2,9,垃圾。
20660,1109,沈钦仙,2016-01-29 13:06:51,1,1,0,还行吧，上课挺无聊的，不过人挺好的
21162,1109,沈钦仙,2016-02-24 06:11:28,-6,2,8,上课不知所云，全靠自学，但是人挺好，给分好
21703,1109,沈钦仙,2016-03-01 00:30:12,5,12,7,虽然旷了三分之一的课三分之一的上机测验还有一个实验作业，最后考试也迷迷糊糊的但是给分居然还挺高的…感觉完全弥补了讲课听不进去的不足…另外这学期上了QBQ的课才发现 不管沈讲的有多平淡 至少想听的时候还是能听懂他在说什么的…
22932,1109,沈钦仙,2016-03-15 02:49:30,1,1,0,个人认为老师讲得很好的
23213,1109,沈钦仙,2016-03-22 03:02:34,48,61,13,就很帅啊，笑起来蠢萌蠢萌的，都被撩到了，而且，讲得挺好的
23872,1109,沈钦仙,2016-04-19 09:00:02,4,4,0,人应该还不错 就是讲课略无聊 自学就好 业界良心
23889,1109,沈钦仙,2016-04-20 07:33:54,-12,2,14,讲的是特么烂，还有狗屁期中考，上课听也做不来，能选其他老师就不要是他
24649,1109,沈钦仙,2018-03-28 01:51:04,31,60,29,我觉得他很帅啊，又有耐心，讲课不幽默但是他笑起来好看啊，评分怎么这么低。还有那个期中考，他说去了就有分，很多人一道都做不出，没关系的
24656,1109,沈钦仙,2016-05-03 02:43:26,8,9,1,萌到化了的老师。。。。\n\n笑起来真的是萌萌的感觉
25308,1109,沈钦仙,2016-07-04 12:54:51,-8,1,9,大绩杀！别选他！！！！！！！
25863,1109,沈钦仙,2016-06-12 14:00:59,-5,0,5,一般吧
26834,1109,沈钦仙,2019-03-05 02:16:21,15,18,3,给分一般，蠢萌小绩杀。虽然被绩杀了但还是好爱他(＾་།＾)
26839,1109,沈钦仙,2016-06-21 08:59:15,-2,0,2,还好吧
31578,1109,沈钦仙,2016-07-04 07:02:09,13,14,1,虽然 讲课有点 乱，但是人是真的好，帅萌帅萌帅萌，然而已经结婚了。
31674,1109,沈钦仙,2018-06-14 06:56:48,0,6,6,讲的不清楚。能不选尽量别管他。给分差
31678,1109,沈钦仙,2016-07-04 12:50:30,-2,0,2,中规中矩
31753,1109,沈钦仙,2016-07-05 07:12:50,-4,1,5,不会教 课前应该是没准备 问他问题也不懂  水平不够
33364,1109,沈钦仙,2016-09-19 13:33:13,1,1,0,略严肃
34012,1109,沈钦仙,2016-09-26 00:19:00,3,4,1,老师上课会补充很多东西，听课的时候偶尔会不知道他讲的内容书上有没有…讲课略严肃，有那么一些些催眠，不过严肃的人讲起笑话却也是另一番风景～实验课的时候会很细心地给你讲解问题。给分也很厚道（＾_＾）
34018,1109,沈钦仙,2016-09-26 01:13:38,1,1,0,枯燥乏味，认真听也有一些收获
34812,1109,沈钦仙,2016-10-24 02:38:14,2,2,0,还没有考试，但觉得讲课还是很清晰的，只要认真听
35602,1109,沈钦仙,2016-11-10 07:30:58,4,4,0,说不出来什么，他的普通话……
36044,1109,沈钦仙,2016-11-10 10:47:54,2,2,0,帅～无聊～ 
38236,1109,沈钦仙,2016-11-28 02:01:30,4,6,2,会经常用quiz点名\n\n
41243,1109,沈钦仙,2017-01-10 07:35:23,1,1,0,讲的挺好的
45829,1109,沈钦仙,2017-01-20 06:54:22,8,9,1,超有爱啊每次坐最前面都可以看到手上的戒指感觉工科男就是很有爱啊！每次发邮件问问题都回的很快课间问问题也很好的！讲话的口音学不来但是听着很有意思嘿嘿嘿！电脑一窍不通居然还过了平均分⊙_⊙
46993,1109,沈钦仙,2017-01-23 08:47:42,-2,1,3,给分超差
47152,1109,沈钦仙,2017-01-24 05:31:35,4,5,1,上课不怎么有趣，但是每次课前几排几乎没人超心疼老师。给分很一般，我一次课没翘，实验测试都很认真做，最后的绩点比预想中低很多
48780,1109,沈钦仙,2017-03-13 02:34:16,2,6,4,中规中矩，上课不听的那些真的没问题？说给分不行，你大学不会自学？沈老师的课你只要想听还是能听懂的
52362,1109,沈钦仙,2017-06-19 05:51:52,0,1,1,java前五章讲了一学期，后八章三节课，剧毒
55213,1109,沈钦仙,2017-07-01 03:58:09,4,4,0,老师人很好给分很棒而且老师还很萌！
55232,1109,沈钦仙,2017-07-01 05:00:20,4,5,1,老师萌萌哒，虽然讲课比较平淡并且作业多了点，但是有拓展，给分也不错，上了老师的大计基课
58693,1109,沈钦仙,2017-09-15 03:56:40,1,1,0,:）:）:）
58698,1109,沈钦仙,2017-09-15 05:40:17,4,8,4,前面的评价写的好那是因为他长的还可以而且还没出成绩，估计出成绩以后都会很后悔对他好评，给分超差，全班56挂了29。考试时间没变，题量加大了三分之一，真心很坑。
60377,1109,沈钦仙,2017-10-18 11:52:02,0,5,5,说他萌的都是水军吧
63927,1109,沈钦仙,2017-12-19 13:25:19,-4,6,10,那个期末的综合报告真的无语，我们又不是计算机专业的学生，一篇2500字以上的论文真的合适吗？？？？
66263,1109,沈钦仙,2018-12-25 08:07:41,23,27,4,某生：老师，题库是什么？沈老师：考试的试题数据库。哈哈哈哈太萌了超喜欢沈老师～而且越看越觉得帅！上课要认真听，谨防打瞌睡，老师声音比较催眠但是个人觉得内容很丰富呀！作业是挺多的，但是这个课好像就是这样的。希望期末考高点，大仙保佑我！考前膜一发
66306,1109,沈钦仙,2018-01-15 03:41:49,20,23,3,虽然上课有点无聊 但人超好而且超帅啊 考前还帮我们开所有练习而且都在群里答疑
67753,1109,沈钦仙,2018-01-22 06:35:47,5,7,2,老师蠢萌 有点帅 人很耐心很负责 考前在群里给大家答疑 听不懂还会解释好多遍 真的很有耐心 emmm老师声音有点平有点催眠 不过认真听的话还是能学到很多东西哒 emmm听说是个小绩杀？ 不过我觉得可能我们交的作业虽然可能态度好 但是确实质量不是特别够吧… 嗯反正这是个很好的老师啦！
67907,1109,沈钦仙,2018-01-22 09:40:40,22,28,6,说他萌的真的不是水军！！有个人问期末考能不能带计算机，老师回了一句想得美；考完大家问成绩，老师说发言的都通过了，然后好多人出来发言hhh。总之，大计基想拿高分，一定要看书，平时无所谓，期末一定要看。（PS老师平时作业是真的少，又萌又帅！
71643,1109,沈钦仙,2018-01-28 23:30:55,1,5,4,老师很好，讲课中规中矩有点无聊，但是非常细致，如果认真听的话很容易理解。老师会在QQ群里回答好多同学们的问题，非常认真。偶尔开开玩笑也是挺可爱的。
71768,1109,沈钦仙,2018-01-29 02:55:16,11,15,4,老师真的人超级好！！大计基这门课本来就是要靠自己的，老师上课讲得很仔细（虽然我没怎么听过哈哈），下课后还会在QQ群上和大家聊天，炒鸡可爱炒鸡萌！关键是给分很好啊，第一门4.8的课！爱老师！
71774,1109,沈钦仙,2018-01-29 03:00:09,6,9,3,不绩杀！很棒的老师！大计基好好复习大家加油～
71777,1109,沈钦仙,2018-01-29 03:02:21,3,5,2,老师真的很可爱呀哈哈 平时也不点名 事情也还好啦毕竟大计基本来大家作业就都很多 只要期末考认真准备好 老师给分还不错哒
71778,1109,沈钦仙,2018-01-29 03:02:26,2,6,4,认真做作业，课从来不听，认真复习。\n\n4.5嘻嘻嘻嘻嘻嘻嘻嘻嘻嘻嘻
71788,1109,沈钦仙,2018-01-29 03:08:15,7,9,2,老师太可爱啦！给分超好！我爱他！
71802,1109,沈钦仙,2018-01-29 03:22:05,1,3,2,老师超级棒！说实话课没怎么听 因为听不懂 大计基靠自学足够了
71803,1109,沈钦仙,2018-12-28 08:28:53,16,22,6,如果这个老师还不满分，谁还能满分?大爱沈老师，帮我怒拉均绩!以后有机会还会选沈老师的课
71804,1109,沈钦仙,2018-01-29 03:24:54,1,4,3,经常开玩笑很有亲和力的老师。很棒。
71805,1109,沈钦仙,2018-01-29 03:26:42,2,4,2,老师作业少，给分也挺好的，上课认真听不会催眠的。挺好的老师
71810,1109,沈钦仙,2018-01-29 03:29:27,-12,1,13,好老师\n\n没上过课还上4了
71816,1109,沈钦仙,2018-01-29 03:46:55,2,4,2,上课略严肃，但是作业有条理，而且照着书很快就能做完。平时稍微认真点，作业及时交，期末考前多翻书，成绩不会差的。
71842,1109,沈钦仙,2018-01-29 04:22:20,2,4,2,给分超级好的老师！！\n\n可爱的男神老师！！！
71909,1109,沈钦仙,2018-01-29 05:27:07,2,3,1,很好很帅的老师，平时作业好好做，考前题刷刷，看个提纲差不多就可以了，这样上4完全没问题（上课不听也没事，反正也听不懂。。。）
72225,1109,沈钦仙,2018-02-04 04:45:20,-9,3,12,我建议老师您以后课也不要上了，直接最后全班卡着正太上限给分好吧，保证查老师9.8+，看看你们这些人嘴脸我就觉得正态分布还挺对的呢
72453,1109,沈钦仙,2018-01-30 06:58:39,1,3,2,一开始觉得好简单不用听，后来忽然发现就听不懂了~但是老师还是蛮可爱的，考前好好看书，练习按时做，论文态度认真点，总之努力不会被辜负
72537,1109,沈钦仙,2018-01-30 10:27:04,2,3,1,老师讲课超级认真，课下还认真(甚至幽默)地解决同学们的问题，给分还可好啦！打call！
72602,1109,沈钦仙,2018-01-31 13:16:03,0,3,3,将将就就吧 理科闷骚男？ 不至于拉绩点 但也不会高 还行
72979,1109,沈钦仙,2018-01-31 13:19:15,3,4,1,老师真的帅萌帅萌的！！！！
72998,1109,沈钦仙,2018-01-31 14:18:23,4,5,1,很好很萌的老师啊！虽然上课语调平淡有点催眠但是讲得很细很认真，在群里问问题老师总是很快解答，偶尔还会皮一下。给分很棒不绩杀，努力了就有回报。
72999,1109,沈钦仙,2018-01-31 14:20:28,14,15,1,嘻嘻嘻老师果然是典型理工男，外表冷酷话少，事实上人炒鸡好，很热心，在QQ群里很调皮ლ(╹◡╹ლ)比心心，给分也炒鸡好，本来今天说出差去了还在高铁上明天出分，但是今天出了_(:з」∠)_啊啊啊老师是一下高铁回到家就忙活我们的成绩了呀。谢谢老师o(≧∇≦o)
73073,1109,沈钦仙,2018-02-01 01:02:35,4,5,1,老师真的还蛮帅的 讲课是很正规的那种 群里答疑超认真 还会解决一些大家日常用电脑的问题 课程内容我感觉没太搞懂 但是给分已经很惊喜了！
73897,1109,沈钦仙,2018-02-03 11:47:47,2,3,1,老师特好啊 平时讲的蛮清楚的 现在结课了都还会在群里帮我们解决计算机问题 顺便说给分也很好啊
74199,1109,沈钦仙,2018-02-06 13:43:40,1,1,0,真的超棒，从不点名\n\n群里随叫随到，考完后电脑问题全部问他\n\n真的强\n\n虽然只有4.2
74474,1109,沈钦仙,2018-02-27 08:19:46,0,0,0,zei～个
74515,1109,沈钦仙,2018-03-02 16:38:04,4,4,0,\n\n咦……上课真的有点催眠……但是人很好，呆萌呆萌的，笑起来很可爱。ppt有很多干货，会上传到网站，可以自己下载没学习！平时作业认真做，考前认真看书成绩就不会太差。而且课结束后还一直在群里答疑，好到没话说。
74623,1109,沈钦仙,2018-03-05 01:21:26,1,1,0,帅死，给分超棒
75039,1109,沈钦仙,2018-03-07 06:01:56,4,4,0,老师人特别好，很靠谱，很耐心，在QQ群里怼老师老师都不会生气，还很帅！！
75889,1109,沈钦仙,2018-03-21 03:07:49,1,1,0,老师讲课中规中矩，没有什么惊喜，也没有槽点
79983,1109,沈钦仙,2018-06-18 07:57:14,0,1,1,java作业好多啊!老师人还挺好的，不点名，接近期末有一次quiz，还是事先通知的。
80084,1109,沈钦仙,2018-06-20 00:41:51,0,0,0,上课真的有点无聊……卒
82210,1109,沈钦仙,2018-07-07 11:56:11,0,0,0,哈哈哈老师真的又帅又可爱啊～～～
83841,1109,沈钦仙,2018-07-11 09:52:46,3,3,0,老师你是天使吧，期末考真的以为自己要凉，结果分数真的让我惊喜了。抛开分数不谈，本人真的是沈男神啊！萌萌的还在群里跟大家聊天。55555555永不后悔选了老师的课！
83858,1109,沈钦仙,2018-07-11 10:36:53,1,1,0,很好。
83862,1109,沈钦仙,2018-07-11 10:46:41,1,1,0,给分挺不错的
84379,1109,沈钦仙,2018-07-12 16:12:41,1,1,0,虽然上课语速平缓，但JAVA真的还是要靠自己多练习，知识点讲解主要侧重理论，关键还是上机多操作。Q群里的老师好可爱，一点都不像上课时那样沉闷。
84759,1109,沈钦仙,2018-07-13 22:35:07,2,2,0,老师人超棒，课后群里的答疑也很及时，还很幽默，还和我们聊足球聊游戏。给分也不错，讲课确实比较中规中矩，但大学里的课程总体还是要靠自己，考前稍微花点时间看书，拿高分不是问题！
85672,1109,沈钦仙,2018-07-25 02:27:48,1,1,0,Java程设 老师讲课还行，会拿一部分时间讲上一次的实验题，然后讲新课，所以进度和别班比会慢一些，还有点小催眠哈哈哈，不过问题不大，只要自己认真看书认真做每次的作业，代码一定要自己码，就会有好成绩滴。大一唯一的满绩，辛苦码代码总算有回报感到很欣慰。
86019,1109,沈钦仙,2018-08-27 07:46:13,2,2,0,好得很
86265,1109,沈钦仙,2018-09-11 14:31:34,1,1,0,暑假小学期微信程序设计！给分很好呀，老师人也很好，很认真！有时候在半夜还在群里回答问题！但可能有时候老师讲的需要自己下课多琢磨研究学习！
86267,1109,沈钦仙,2018-09-11 15:24:58,0,0,0,真的超好的老师了，我的男神！
86269,1109,沈钦仙,2018-09-11 16:24:12,1,1,0,老师也太好了吧，10天的微信小程序虽然进度有点赶，但是老师在群里的答疑还是很及时的，课后仔细琢磨琢磨还是能学到很多东西的。
86548,1109,沈钦仙,2018-09-17 06:36:51,1,1,0,老师人好啊 新的小学期课做微信小程序 老师额外赠送js课程 助教超热心和友善的～
86582,1109,沈钦仙,2018-09-17 10:18:59,0,0,0,好得很
86652,1109,沈钦仙,2018-09-18 00:52:16,1,1,0,蠢萌是有的，讲课语无伦次，思维天马行空，想好好听课被催眠了，语言混乱毫无逻辑…刚说下课，两秒钟之后继续讲…建议想好好学习的人别选吧，宽容并不是什么好事，好好学习还是需要一个真正能讲好的逻辑清晰干脆利落的老师。忠告。
87465,1109,沈钦仙,2018-09-29 06:26:07,0,0,0,给分超好
87756,1109,沈钦仙,2018-10-11 13:33:36,1,1,0,小学期给分好到让人怀疑他是不是输错了成绩....以及小学期网页讲的还不错，占大头的小程序就emmmmm....
88754,1109,沈钦仙,2018-11-07 10:27:44,1,1,0,小程序给分特别好，感觉讲完了整个web开发的知识
89281,1109,沈钦仙,2018-11-18 04:16:18,0,0,0,给分好
92259,1109,沈钦仙,2019-01-01 02:19:55,2,2,0,没上过老师几节课，感觉是个很好的人啊
92312,1109,沈钦仙,2018-12-27 15:22:46,0,0,0,很好的老师！
93989,1109,沈钦仙,2019-01-14 15:11:57,0,0,0,我觉得超棒
94072,1109,沈钦仙,2019-01-15 06:00:09,3,3,0,老师很和善，大计基作业是真的少（我室友国庆大计基作业可以做几天比起来）……也是看了评论才发现蠢萌这个词这么适合老师：）
99367,1109,沈钦仙,2019-01-24 15:36:11,1,1,0,低调有实力。
101602,1109,沈钦仙,2019-01-28 14:43:28,5,5,0,我爱老师，以为自己要挂了非常忐忑，期末出分群里都在发“老师多给点分吧”把我笑的，结果给分真的不错，刚好往上给我卡了绩，总的说讲的可能有点无聊但真是师生情啊给分好。
101603,1109,沈钦仙,2019-01-28 14:46:15,2,2,0,期末考凉了  给分还不错\n\n
101605,1109,沈钦仙,2019-01-28 14:49:19,2,2,0,不点名，水，老师有点儿帅＋可爱，课无聊，给分好
101609,1109,沈钦仙,2019-01-28 14:59:31,3,3,0,老师很可爱很帅，给分真的给我感动坏了，我本来都以为自己要挂了……不说了，10分好评！
101614,1109,沈钦仙,2019-01-28 15:21:37,2,2,0,挺好的呀，老师回复超级详细，耐心。
101616,1109,沈钦仙,2019-01-28 15:26:24,7,7,0,老师给分超棒，为了给同学们一个满意的成绩连小年都没回家(╥_╥)感谢之情难以言表……虽然，老师上课可能不很生动，但教学态度绝对认真！（其实我觉得大计基本来应该自学更有效果，不该太依赖老师教授……但老师给分真的是太给力了ballball）
101618,1109,沈钦仙,2019-01-28 15:29:20,3,3,0,虽然老师上课会讲很多超出课本的知识，但是大计基岑参就是一个自学就可以的科目，而且老师脾气超好，平时作业没有按时间完成过后也可以补，成绩有电技术含量的也就是最好的上机考试了，这个是老师没办法的，只要上机考合格了上四没有问题！好老师！
101619,1109,沈钦仙,2019-01-28 15:30:46,2,2,0,老师真的很好啊，蠢萌蠢萌的，给分很好了！评分没有那么低的！
101621,1109,沈钦仙,2019-01-28 15:32:51,2,2,0,萌萌哒拥有直男幽默的暖男老师，给分好
101623,1109,沈钦仙,2019-01-28 15:33:19,5,5,0,老师上课会讲很多超出课本的知识。虽然上课跟着有些吃力(可能是自己太渣了吧QAQ……)但老师真的很好，在大计基考试前无私的解答了我的n道问题，而且最后给分也不错，让我的大计基终于脱离了挂科的魔掌，感谢老师！
101624,1109,沈钦仙,2019-01-28 15:34:50,3,3,0,老师给分超好！！善良可爱的理工男！！
101625,1109,沈钦仙,2019-01-28 15:35:10,3,3,0,人狠话不多 分好事不多
101626,1109,沈钦仙,2019-01-28 15:36:04,4,4,0,给分好 都这么帅了上课还挑什么无聊不无聊
101630,1109,沈钦仙,2019-01-28 15:43:03,11,12,1,感人的师生情！！！水了一整个学期的大计基，期末感觉是挂科预定了，结果给分高得超乎想象！！！幸好没退下学期预制的沈老师的python(◐‿◑)﻿
101636,1109,沈钦仙,2019-01-28 15:48:52,2,2,0,上课很枯燥，给分超好，在群里回答问题也很及时，很负责的老师。
101657,1109,沈钦仙,2019-01-28 23:45:47,10,11,1,就凭我不听课他不让我挂科还给我4.2我就给他满分
101661,1109,沈钦仙,2019-01-29 00:11:13,5,5,0,老师超级好的，期末考试会在群里解答问题，绩点也会尽量往高了给，真的超级好的老师！
101669,1109,沈钦仙,2019-01-29 00:37:26,5,7,2,太好了！不给卡绩，往高了给，事少，群里解答很耐心，长得帅！！
101671,1109,沈钦仙,2019-01-29 00:37:58,3,3,0,老师真的好。善良➕萌
101676,1109,沈钦仙,2019-01-29 00:56:09,2,2,0,认真学给分不会差
101678,1109,沈钦仙,2019-01-29 00:57:49,1,1,0,还可以啦！
101689,1109,沈钦仙,2019-01-29 01:13:38,3,3,0,人很好，会耐心回答问题，给分也好
101695,1109,沈钦仙,2019-01-29 01:28:50,3,3,0,大计基给分很好呐，只要认真学。群里会解答问题，有点可爱。
101699,1109,沈钦仙,2019-01-29 01:38:17,3,3,0,沈老师我爱您！！！
101711,1109,沈钦仙,2019-01-29 02:08:49,2,2,0,平常没听，作业超少（还可以延迟交），最后做题没平时发挥得好，4.8飘过，可见老师真的非常萌，给分非常好！
101729,1109,沈钦仙,2019-01-29 02:55:11,2,2,0,给分好 不点名
101786,1109,沈钦仙,2019-01-29 05:18:05,1,1,0,讲课虽然中规中矩，但老师人超棒的
101793,1109,沈钦仙,2019-01-29 05:28:20,3,4,1,每次上完微积分都有第一排坐，挺好的，怪我自己太菜了，大计基3.9我觉得很满意了，老师讲得很多，在第一排听的很认真，但还是不懂，初高中没有上过计算机课? ，是遗留问题了
102938,1109,沈钦仙,2019-02-25 05:10:01,0,0,0,平时上课比较严肃，但是大计基学起来就是比较枯燥的，人很好！！！
103098,1109,沈钦仙,2019-02-26 03:05:18,-6,2,8,超级差
103804,1109,沈钦仙,2019-03-06 01:47:58,17,17,0,python助教小哥哥真可爱(๑• •๑)
104573,1109,沈钦仙,2019-03-24 01:58:04,31,36,5,我主要是来夸python助教邸超氚xgg的，卡哇伊～～\n\n沈老师不是是很爱说话的样子，也会上课一不小心出错，但其实教的时候和课后都是蛮负责的，给10分
104687,1109,沈钦仙,2019-03-26 03:39:49,15,18,3,Java的预制老师，选课的时候6分，查老师更新后变成9分了?
104868,1109,沈钦仙,2019-03-29 04:19:22,3,3,0,讲课比较慢，但是很认真，最后给分也好
105318,1109,沈钦仙,2019-04-10 02:25:58,1,1,0,很棒啊
107011,1109,沈钦仙,2019-04-30 17:16:43,4,5,1,我就喜欢这种工科男
108285,1109,沈钦仙,2019-05-20 05:58:05,1,1,0,很喜欢
108507,1109,沈钦仙,2019-05-27 07:54:09,2,2,0,呆萌理工男～
108899,1109,沈钦仙,2019-06-04 01:28:36,6,6,0,上课中规中矩的，是典型的理工男。个人觉得老师上课的优点是会现场码代码运行程序，偶尔老师会犯小错误，在我们做作业上机的时候就很有借鉴价值。作业会比lf老师班多一份关于理论部分的word作业，如果前面基础没打好，后面做作业就是别人3小时做完作业，你做半天都做不出来... 但这些作业确实能帮我们在平时就把理论和实验部分的内容复习好。不过如果自己上课习惯不好真的会睡着啊呜呜呜
109657,1109,沈钦仙,2019-06-18 07:33:43,2,2,0,陪伴了我一年的男神～ 大计基每周都有作业，但也不算很多，平常会经常在群里答疑。这个学期的Python也是，有助教哥哥答疑，但沈老师还是会翻之前的记录回答漏掉的问题，真的很耐心，时不时还来点冷幽默，今天最后一节Python啦，舍不得他
111354,1109,沈钦仙,2019-07-01 04:32:13,2,2,0,非常非常好。我是他的JAVA课。推荐推荐
112143,1109,沈钦仙,2019-07-03 17:27:39,1,1,0,沈老师很萌，给分也很好！
112152,1109,沈钦仙,2019-07-03 17:44:50,4,5,1,老师经常在群里答疑，有时候凌晨都在，下课问问题，回答很认真，不定期随堂测试，手写代码。java最后5.0飘过。\n\nps:真的没见到几个还在用五笔的老师了。
112166,1109,沈钦仙,2019-07-03 18:21:23,3,3,0,上的是python。让人又爱又恨的老师，一边嫌弃他上课逻辑性不强还总出错，一边又觉得他人很好脾气好耐心足还有点蠢萌。本来有一次quiz作为点名，但因为那堂课人来得比较齐所以quiz被临时取消了。根据最后的总评分数推测，平时分应该是只要pta上的作业做了不论对错及得分都会给满。虽然最后绩点不高（还被卡绩了，主要是因为自己太差了）但却莫名觉得超值？！毕竟选课的时候评分6.0+，结课以后评分9.0+，妥妥的潜力股了。
112184,1109,沈钦仙,2019-07-03 20:03:50,4,4,0,沈老师超帅的
112198,1109,沈钦仙,2019-07-03 22:15:50,4,4,0,课程群里的他和上课时的他是两个人
112203,1109,沈钦仙,2019-07-03 22:36:14,0,0,0,老师又帅给分又好呀
112211,1109,沈钦仙,2019-07-03 23:06:19,0,0,0,老师给分又快又好，回答问题特别耐心，强推
112301,1109,沈钦仙,2019-07-04 01:06:18,3,3,0,上的是python，老师平时分给满直接让我上了一个档！老师太好辽！
112391,1109,沈钦仙,2019-07-04 03:44:24,5,5,0,我就喜欢这种工科男！！从大计基到Java都在老师班上，看着老师的评分一路上升，真是很欣慰了哈哈～老师人真的特别好，看起来像是工科直男类型，但是又会很萌很可爱，羞涩得笑起来真的很撩！！！讲课也很好的，很负责，会在群里很积极很认真地解答疑惑，给分也很好哒！！！
112393,1109,沈钦仙,2019-07-04 03:57:05,-1,3,4,给分是真的好，不但满? ，差点满分了。。可能是课程设计的问题，内容都非常基础，感觉一学期没学到什么东西
112800,1109,沈钦仙,2019-07-05 03:33:54,6,6,0,沈老师，棒棒哒，一个神色严肃一丝不苟的男人，一个喜爱发抠鼻表情的男人。就喜欢这种表面一本正经实际内心丰富的理工男。hhhhhhh，最后分数不高，但也超出预期。
113159,1109,沈钦仙,2019-07-06 00:44:34,23,26,3,有见过考前在q群里边回答问题边水群的老师? ？？？\n\n一群人讨论问题突然开始复读，\n\n老师“刷屏的平时分扣2分”\n\n于是同学1“撤回”\n\n同学2“撤回”\n\n同学3“撤回”\n\n……\n\nsqx“撤回”
114563,1109,沈钦仙,2019-07-10 17:01:14,1,1,0,啥也别说了选就完事了
116564,1109,沈钦仙,2019-09-11 17:07:52,2,2,0,小学期的这个给分真的超级好啊
116566,1109,沈钦仙,2019-09-11 22:54:44,2,2,0,小学期微信小程序，事情相对较少，每节课点名以确定平时成绩。但课程本身内容很多，要一周学会php，js，html，数据库。。。每天留作业。最后大作业就是设计一个微信小程序难度不大，时间也很充裕。老师人很好，有任何问题都会耐心解答，在假期里也会及时回复消息，而且给分真的太好了，给分好给分好给分好！！！计院小学期推荐沈老师！！！！
116571,1109,沈钦仙,2019-09-12 00:18:40,1,1,0,小学期的微信小程序设计能学到一点前端开发的知识，给分也不错 强烈推荐
116582,1109,沈钦仙,2019-09-12 01:36:16,1,1,0,上了老师的小学期！微信小程序给分炒鸡好！！
119000,1109,沈钦仙,2019-11-09 05:29:07,2,4,2,作业太多了吧
121185,1109,沈钦仙,2020-01-20 03:05:38,1,1,0,老师作业是所有大学计算机B老师里面最少的，其他老师还有别的作业呢。助教xgg很负责很好!
121674,1109,沈钦仙,2020-01-20 17:09:36,1,1,0,太感谢了呜呜呜，一个学期都没有听课的人，老师让过了，太感谢了太感谢了
121689,1109,沈钦仙,2020-01-21 01:20:27,3,3,0,老师特别好 事比起其他老师算少的 但做实验作业却还是麻烦的 只要机考不挂 他还是会用心捞人的 给绩还不错！btw老师真的很帅hhhhhh
121701,1109,沈钦仙,2020-01-21 02:24:49,4,4,0,绝世好老师 选吧！
122184,1109,沈钦仙,2020-02-19 16:30:33,0,0,0,开学前来评一评，老师人超好，助教xgg超可爱！！！～
122260,1109,沈钦仙,2020-02-21 11:15:22,0,1,1,上学期大计基B。讲课精简到位，老师人也非常耐心非常体贴（每项作业的完成周期都相对比较长，老师期末还会手动延迟作业ddl哈哈哈哈哈拖延症的福音啊）。助教xgg人真的太好了，认真负责又很幽默，写的作业说明文档很有趣hhhh。
130726,1109,沈钦仙,2021-01-24 11:36:51,5,6,1,老师的课是真得很无聊，但人还是挺好的。\n\n作业比别的班得的早，还多，害\n\n作业比课上交得要难
130913,1109,沈钦仙,2021-01-25 08:27:29,3,5,2,虽然现在还不知道分数，但是老师是真得帅+一丝不苟中透漏着蠢萌\n\n5555好想要这样的理工男朋友
133029,1109,沈钦仙,2021-02-06 15:32:20,8,10,2,出分虽然有点慢，但是海底捞有一手，大计基就选沈老师绝对没错，绩点好到超出你的想象
133035,1109,沈钦仙,2021-02-06 22:29:31,4,4,0,给最好的仙仙刷到10分～
133042,1109,沈钦仙,2021-02-07 02:57:49,-1,5,6,老师真是好老师，也是海底捞大师，我这种python编程好几题不会的（大计b）能给我捞到4.8，呜呜呜呜呜呜
133123,1109,沈钦仙,2021-02-09 03:11:11,2,2,0,从不点名，非常好，还捞人
133716,1109,沈钦仙,2021-03-04 06:58:54,2,4,2,老师真的超级好，上课不点名，期末海底捞，上课非常认真，但不一定能听得懂
136629,1109,沈钦仙,2021-06-22 06:58:22,-17,2,19,老师上课上课不行 也不怎么负责 怎么就高分？花钱买的？
137030,1109,沈钦仙,2021-06-29 22:17:35,5,5,0,老师蛮好的，然后助教邸超氚小哥哥为什么会这么好啊( ﾉωﾉ)！！小哥哥认真负责超级萌，性格好温柔qaq无论如何都非常感谢(๑•̀ㅂ•́)ﾉ➹♡
138461,1109,沈钦仙,2021-07-09 09:58:39,2,2,0,太可爱了这个老师！上课有点催眠但是口音是加分项，很萌～想听的时候完全听得下去，内容我觉得很丰富也很好理解。平时比较严肃吧，所以偶尔开玩笑（可能都不是开玩笑，只是说一些和课程无关的事情的时候）真的超级好笑超级可爱！最后还要怒赞python的助教小哥哥，答疑总结非常有用，感谢感谢～
139097,1109,沈钦仙,2021-07-12 16:56:33,-62,1,63,才4.8，怪我没怎么听课
139108,1109,沈钦仙,2021-07-13 00:39:51,1,1,0,老师上课有点萌萌的，演示时经常会出错，但是很负责，作业中的难题会讲。邸超氚助教小哥哥真的特别好，很负责，很耐心！老师8分，助教10分！
139680,1109,沈钦仙,2021-07-20 01:54:39,2,2,0,Python\n\nsqxgg=帅气小哥哥😄我个人感觉老师是一个非常标准的理工男形象，上课非常认真，总是提前到教室。回答问题也很认真\n\npython这门课好好学不会差的，我个人建议先把书本全看一遍，有个全局观，不然直接听课很容易懵\n\nps:助教xgg的答疑总结很有用
139702,1109,沈钦仙,2021-07-20 11:34:35,7,7,0,我吹爆！选沈老师就是了！
149486,1109,沈钦仙,2022-01-15 14:54:09,5,5,0,老师上课很认真，不管底下同学听不听都很认真地讲。期末也会回答同学们的问题。最后也狠狠捞了一把，感谢老师！
149488,1109,沈钦仙,2022-01-15 15:07:45,7,7,0,感谢仙仙的捞捞😘😘😘守护最好的仙仙😍😍😘大帅哥哈哈哈
149489,1109,沈钦仙,2022-01-15 15:18:24,4,4,0,仙仙男神！！！海底捞！！
149490,1109,沈钦仙,2022-01-15 15:19:03,3,3,0,老师真的好好，又帅又细心！！
149495,1109,沈钦仙,2022-01-15 15:30:31,4,4,0,本人计算机菜鸡，上大计基试图听讲，无奈经常睡着。老师讲课不水，就是板书有点乱，稍不留意就不知道写的什么意思。作业不多，照着实验指导书，都能写出来。最后给分也很好
149499,1109,沈钦仙,2022-01-15 15:41:57,2,2,0,老师很善解人意，作业量也不大，平时课程虽然有点难，但期末补天上四不难的
149502,1109,沈钦仙,2022-01-15 15:54:43,3,3,0,计基pta作业漏了一次 好像不给补 下次选的小朋友千万记得要记住ddl时间 不要追悔莫及啊 最后给的寄是85/3.9 也还行叭
149503,1109,沈钦仙,2022-01-15 16:02:00,1,1,0,仙仙仙仙，老师上课内容比较多哇，回很耐心回答问题，大计基好好复习分不会差，爱仙仙
149504,1109,沈钦仙,2022-01-15 16:03:21,1,1,0,仙仙🤤🤤🤤🤤🤤我的仙仙🤤🤤🤤
149508,1109,沈钦仙,2022-01-15 16:33:51,2,2,0,仙仙🤤🤤我的超人🤤🤤又帅又会捞🤤板书有一点点乱，不过认真听的话没有影响。耐心回答问题，演示时会出错，好可爱哈哈哈。\n\n选他!!!
149514,1109,沈钦仙,2022-01-15 16:37:26,1,1,0,沈老师教学非常用心，人也很好～而且超级喜欢老师的名字，好好听哇🥰，和老师的气质也很符合😘
149527,1109,沈钦仙,2022-01-16 00:39:28,0,0,0,老师人很好，上课很认真，作业也不太多，本人计算机很菜，但老师给分很好！
149533,1109,沈钦仙,2022-01-16 01:42:27,0,0,0,老师人真的很好！就是线上上课声音会有点小，不过戴耳机还是可以听到~大计作业好好做老师会捞人的！大爱老师！
149560,1109,沈钦仙,2022-01-16 02:54:35,0,0,0,老师给分超好
149658,1109,沈钦仙,2022-01-16 09:32:20,0,0,0,未曾想到的分数！老师太好啦！
149674,1109,沈钦仙,2022-01-16 09:53:00,0,0,0,给分超超超超好，作业也不是很多
149704,1109,沈钦仙,2022-01-16 13:39:08,1,2,1,打分：9/10\n\n课程：大计基B\n\n优点：①作业少（没有思科网作业；计科只要做最后4课；PTA只布置过两次python作业，而且题量比起我室友的来说要少得多；平时实验作业和实验课本上的实验完全一样，所以实验作业只要完全抄书就可以），别的老师（我室友的老师doge）动辄“百家姓”程序、实验报告、写小作文，沈老师完全没有这种东西。②虽然不知道为什么最后取消了线下答疑（应该是学校的原因？）但是老师在钉钉群里答疑很认真，回复很快，和助教对比鲜明了属于是（bushi）\n\n缺点：①讲课比较一般。②助教不太负责。（私聊就已读不回，在群里@也很久才回555）\n\n就是说，大学上的第一节课是沈老师的课，当时上完觉得“就这？就这？”，感觉讲得甚至不如高中老师有趣。\n\n但是后来慢慢上下去，觉得老师讲课也还行（因为听了更多更水的课），甚至和别的大计基老师比，作业少了不止一点两点，也就释然了。
149743,1109,沈钦仙,2022-01-16 15:47:47,2,2,0,大计基请毫不犹豫地选择sqxgg好吗？！！！平时不点名，上课严肃，但是就很萌啊！！！最最重要的是海底捞！给分好！只要平时作业都交了，期末好好复习上4甚至是更高完全不是梦！（我两天速成最后4.8）
150036,1109,沈钦仙,2022-01-18 13:12:08,6,7,1,仙宝...世界上最好的仙宝！！！人帅身材好还幽默，事情也少，只有三四次学在浙大的课后题（每次只有十几道），四次实验，两次PTA，四个计科（长学期课，对比其他老师，事情真的已经很少了！！！）还有神仙的海底捞技能！！！\n\n但是文科生学计算机真的学不来，平时上课有认真听还是听不太懂qwq还记错了ddl少做了一次课后习题（当时问了助教，助教已读不回，课后去问仙仙，仙仙说不能补了但影响不大，后面好好学就好，呜呜呜世界上最好的仙宝！）\n\n最后几天一直再补天大计基，仔细看了两三遍书+好几遍计科，最后4.8/94！\n\n世界上最好的仙仙！
151089,1109,沈钦仙,2022-02-23 02:26:09,0,0,0,给分很好
157404,1109,沈钦仙,2022-06-23 06:38:41,0,0,0,好老师o(^o^)o
157753,1109,沈钦仙,2022-06-24 16:13:25,1,1,0,老师很好，还把模拟考放线上进行，真的有很努力学了，但是可能方法不太合适所以结果不太好，第三场的理论做完很崩溃，编程也毫不意外地只写出了一道。没出分，希望老师能捞我一把吧，😞成绩不要太难看就好。
158831,1109,沈钦仙,2022-07-02 13:32:14,2,2,0,超棒的老师，我永远是仙贝！
158836,1109,沈钦仙,2022-07-02 13:51:22,0,1,1,yyds~
158837,1109,沈钦仙,2022-07-02 13:59:44,0,0,0,沈钦现，我的神！
158840,1109,沈钦仙,2022-07-02 15:26:10,2,2,0,理论65实验一道也能捞，真的，我爱仙贝哥哥，哥哥，哥哥，斯哈斯哈斯哈🤤🤤🤤
160511,1109,沈钦仙,2022-09-25 07:15:59,1,1,0,sqx！我再说一遍！你是我的神！
160524,1109,沈钦仙,2022-09-26 01:03:31,2,2,0,沈钦仙！我再说一次！你是我的神！
164561,1109,沈钦仙,2022-12-22 02:00:15,7,7,0,为男神举大旗!!!!!疫情期间还给我们发中药配方～他真的，好可爱
164845,1109,沈钦仙,2022-12-27 01:29:14,-3,2,5,...
165454,1109,沈钦仙,2023-01-06 07:52:47,0,0,0,老师讲课非常详细，对学生的疑问也会耐心解答
167865,1109,沈钦仙,2023-01-19 14:58:50,-6,3,9,老师很温柔 解答很耐心 老实中也挺幽默的 给分好啊关键是 老是不听课的表示自学python入门考试大计基b 4.2
167873,1109,沈钦仙,2023-01-19 15:54:44,-4,1,5,没听过课，pta前几次做得依托答辩，期末考复习三天，最后考试差不多都会，老师给了91，还算满意，老师人很好而且好帅，给分也不错
167878,1109,沈钦仙,2023-01-19 18:57:57,4,4,0,虽然大计基挂了但是老师挺好 来年再战
168362,1109,沈钦仙,2023-02-14 02:04:58,3,5,2,缓考生2.22考大只因只因B  求老师捞捞呜呜~
168749,1109,沈钦仙,2023-02-21 15:36:44,0,0,0,挺好的。
170056,1109,沈钦仙,2023-03-01 07:03:18,3,3,0,谢谢沈仙！！！我永远是仙贝，大计基B真的全靠仙仙捞，没挂科就很爱了！！！帅仙我们Python再会！！！
175603,1109,沈钦仙,2023-06-25 19:45:49,-2,6,8,今年的大计基B感觉没有往届能捞\n\n\n\n期末补天，除了python的冒泡部分和个别理论知识没记住以外，大多数题感觉都做出来了，最后是2.7.大计基60%的平时分，如果要是真的狠捞了应该至少能上3吧？\n\n\n\n当然只是陈述客观事实，大计基还是强推sqx老师。老师人真的很好，去年疫情还给我们发中药配方，真的很感动。至于成绩，更多的肯定还是自己的问题，不能怪老师。
176938,1109,沈钦仙,2023-06-30 22:40:34,1,1,0,啊啊啊啊啊好爱沈老师！！1超级耐心善良！www好多问题都会耐心解答，本计算机小白从此爱上Python~
177509,1109,沈钦仙,2023-07-03 14:11:21,0,1,1,特别特别特别特别特别好的老师！！！狠狠捞我了！！！讲课条理也很清晰！！！
177543,1109,沈钦仙,2023-07-03 15:49:01,1,4,3,我叠\n\n实验考第二题没做出来，最后算上期末应该94，沈老师居然给满了（诚恳推荐没有任何炫的意思）
177576,1109,沈钦仙,2023-07-03 23:40:48,0,2,2,一次上机签到没签 理论92 实验2道 总评93
177605,1109,沈钦仙,2023-07-04 01:59:37,1,2,1,老师人挺好的 给分也很好 平时分基本能给的都会给\n\n不过要注意 上机课会纸质签到 好像计分的！大家不要忘了
178461,1109,沈钦仙,2023-07-12 04:52:49,1,4,3,python课讲得一般，感觉很多内容老师自己也不是很清楚（捂脸），基本全靠自学+小测前恶补+期末考前恶补，给分似乎还行
180511,1109,沈钦仙,2023-09-22 06:50:39,7,7,0,上课与作业无关
187066,1109,沈钦仙,2024-01-14 09:43:32,1,4,3,老师人好，我基本没去上课，期末实验考只对了一道，理论考62分，最后3.3。老师捞人捞的好狠，谢谢老师。
194012,1109,沈钦仙,2024-06-21 11:04:35,2,2,0,仙仙仙仙，我们是你的仙贝呀
194345,1109,沈钦仙,2024-06-23 09:45:28,1,1,0,24年春夏Python把我捞上岸的含金量！
194451,1109,沈钦仙,2024-06-24 03:46:38,1,1,0,上课思路很清晰的好老师(*￣▽￣*)
194539,1109,沈钦仙,2024-06-24 09:26:36,0,0,0,给钦仙gg打call！
194736,1109,沈钦仙,2024-06-25 07:24:02,0,0,0,python掌管捞人的神
195085,1109,沈钦仙,2024-06-26 17:36:49,14,14,0,【Python程序设计】仙仙特别特别好！\n\n点名会提前说，也允许补签，小测客观题基本上都是pta原题，很容易得高分\n\n2024春夏学期python理论考这么难但是还是很能捞，python选他根本不用担心！
195203,1109,沈钦仙,2024-06-27 07:22:43,1,1,0,仙仙！捞人的神！平时分给满了！虽然24春夏理论难，但是真捞吧！讲课也很有思路！（虽然我是自学的）仙仙，我们是你的仙贝呀qwq
195512,1109,沈钦仙,2024-06-28 12:46:21,2,2,0,就点了三次名，而且会在群里提前通知，我哭死
195517,1109,沈钦仙,2024-06-28 13:32:03,1,1,0,24年Python难度激增，如果没有仙仙我必挂科。
199472,1109,沈钦仙,2024-09-24 07:29:48,3,4,1,老师上课很严谨专业，但语言缺乏组织和逻辑，课上时间过得很快，眼睛一睁一闭就过去了
200941,1109,沈钦仙,2024-10-25 05:29:02,4,4,0,上python课老师讲课和AI一样，完全get不到重点，语气平和始终如一，很是严肃，是我太菜了(／(ｴ)＼)
204090,1109,沈钦仙,2024-11-24 03:48:35,0,1,1,10分！老师虽然回问题有点不及时但是还是有求必应的，而且好几次都是在深夜回消息，太辛苦了www\n\n而且助教陈科睿xgg特别特别好，基本上都是秒回消息，太热情了，我为助教xgg扛大旗！！
204480,1109,沈钦仙,2024-11-26 07:08:13,2,4,2,在Python资料鱼龙混杂的情况下，竟然能把板书直接发给学生，减少了超级多学习压力，只能说是神
204482,1109,沈钦仙,2024-11-26 07:13:46,-8,5,13,傻逼老师，讲课昏昏叨叨，根本不知道他在讲什么，全靠自学，点名考试从来不提前通知，有一次小测很多人电脑都没带，也没复习，也不知道范围，他临时说要考，真的傻逼
205679,1109,沈钦仙,2024-12-11 05:40:16,2,2,0,已挂科
207657,1109,沈钦仙,2024-12-23 13:02:31,0,0,0,我爱沈钦仙
210054,1109,沈钦仙,2025-01-08 04:38:26,0,1,1,学的Python。老师又萌又懵的，哈哈哈。\n\n有时候犯小错误（不管是在课上还是群里），但是会很快纠正过来。看见老师盯着Error突然宕机几秒钟，莫名的有趣[捂脸]。\n\n上课有点催眠，但是我感觉想学好还是要靠自己吧，把书上的例子自己吃透，作业自己写，不要交给AI，课堂上讲的和书本上的区别不大。\n\n一个长学期好像是点了一次名，不是每节课签到的。
213041,1109,沈钦仙,2025-01-16 00:56:50,-6,3,9,我只能说，对于Python而言，老师原话是“我不是研究Python的所以犯了一些错”\n\n讲课是乱七八糟的，课件是旧版而且不看的，作业是多得要死而且不讲的，编程是靠自己摸索的，基础题是不会的，下课以后是只能去听隔壁sr老师来救命的，给分是不会捞的，差点上4也要给你刚刚好卡绩的\n\n噫吁嚱，岂有如此烂者耶！\n\n选到的孩子们，如果不退预置课，那我祝你们好运吧😁
213153,1109,沈钦仙,2025-01-16 06:54:09,0,1,1,不点名的好老师\n\n只是python感觉老师自己也不太懂，建议自己预习，身为浙考生觉得蛮轻松的，但非浙没学过python的同学…建议还是换个老师\n\n会捞人，我被捞上了一档，感谢老师，拿到了一个高分
213178,1109,沈钦仙,2025-01-16 08:43:52,2,2,0,老师上课有点混乱，需要自己课后好好消化一下，但是平时分给满了，很满意哈哈
213262,1109,沈钦仙,2025-01-16 13:39:19,1,1,0,sqx老师人真的很好，本人非浙江考生最后绩点也蛮好的，课上讲的点可能只是知识点，但好多易错内容确实是要自己摸索出来的。
213311,1109,沈钦仙,2025-01-17 02:05:22,-4,0,4,会一声不吭小测，小测之前会雷达签到，但是给分好，三天速成4.5。
213366,1109,沈钦仙,2025-01-17 05:07:43,1,2,1,这老师也太棒了，考试前2h速成，平常有时候小测也会不通知，建议临近期末几周带电脑过去，一般那时候小测比较多，上课比较严肃，但是人很好，仙门永存！
213371,1109,沈钦仙,2025-01-17 05:37:03,4,4,0,上课乱乱的很催眠不建议没基础的同学选💔
213481,1109,沈钦仙,2025-01-17 18:40:53,1,1,0,好像没有捞\n\n上课我听不太懂\n\n但是老师人很可爱\n\n有点卡绩但是还是给老师一个好评！
213905,1109,沈钦仙,2025-01-21 06:45:40,-5,0,5,给分很好，速成5.0
214441,1109,沈钦仙,2025-02-04 04:59:14,-2,0,2,捞，海底捞，性价比非常高
214936,1109,沈钦仙,2025-02-19 07:33:44,2,2,0,老师有点像小人机，呆呆的感觉，有点可爱，但课很催眠，没基础的话真的真的听不懂，平时小测很突然，给分很实在，就看你考试考的咋样，我可能计算机太差了，没挂科已经很好了
215718,1109,沈钦仙,2025-03-04 15:48:03,0,0,0,老师讲课其实有点讲不太明白？但是老师从不点名，小测也只测了两次，不过有一次是下午测上午才通知的，但都是作业原题，计算机课自学还挺重要的，老师真不一定能讲明白
215946,1109,沈钦仙,2025-03-08 02:02:54,0,0,0,我，是你的旺旺仙贝！
216095,1109,沈钦仙,2025-03-10 09:31:03,1,1,0,讲课不太适合省外没有计算机基础的同学，全靠自学和恶补，但给分还行。以及喜欢突击小测，但全是原题
219526,1109,沈钦仙,2025-05-29 08:21:45,0,0,0,平时分挺高的
50797,1154,王晓霞,2017-05-05 13:07:48,0,0,0,有干货
516,1161,胡兰青,2015-03-15 03:59:14,11,22,11,很利索的一个老师，有时还很有趣。
1012,1161,胡兰青,2015-05-20 08:23:53,12,21,9,听了不会困，老师好萌，好耐心。
1475,1161,胡兰青,2015-03-22 06:24:53,147,195,48,全靠自学
1657,1161,胡兰青,2015-03-23 06:50:19,10,14,4,进度太慢了，虽然讲得很细致
2462,1161,胡兰青,2015-05-04 06:24:04,23,34,11,讲得很好，企业规范，有深度
2705,1161,胡兰青,2015-05-05 16:27:53,36,50,14,要能从老师的话里读出更深的，那上她的课才有意思，而且，胡老师也很耐心，问题都很完整地回答，甚至给出实例。
3806,1161,胡兰青,2015-06-17 04:54:11,16,23,7,真正教你工程应用与经验，这是最好的。
4070,1161,胡兰青,2015-06-17 15:55:58,-41,16,57,垃圾 上课乱讲 没有条理空口胡诌 根本不知道自己在讲什么 自己对编程的理解就很肤浅
5157,1161,胡兰青,2015-07-05 10:57:20,15,22,7,很注重工程实践的老师
6269,1161,胡兰青,2015-07-12 13:47:13,-2,4,6,睡着了。。zz z
6475,1161,胡兰青,2015-07-14 08:08:14,4,9,5,讲课一般，倒是很负责
6603,1161,胡兰青,2015-07-16 06:49:20,101,126,25,超级好的女老师，上课不点到，但是上机课有小测（会在理论课上说）给分很厚道，老师反应很慢不要欺负她，都有备过课，喜欢对书上程序提出自己改进的办法，虽然有时是错的
6624,1161,胡兰青,2015-07-16 14:21:08,9,13,4,讲课细致，给分善，习惯从实用编程角度入手
6667,1161,胡兰青,2015-07-18 02:16:49,5,7,2,非常好的一个老师
6824,1161,胡兰青,2015-07-23 08:12:26,-1,4,5,呵呵
7096,1161,胡兰青,2015-09-02 03:34:59,-10,12,22,我只能说最后一半以上的人都去听别的老师的课了
8225,1161,胡兰青,2015-09-17 15:20:47,3,6,3,是个好老师
8615,1161,胡兰青,2015-09-23 07:24:15,4,5,1,哈哈哈
8617,1161,胡兰青,2015-09-23 07:22:01,5,7,2,爽爽爽
8977,1161,胡兰青,2015-10-08 02:34:36,4,8,4,全靠自学
9273,1161,胡兰青,2015-10-19 11:48:57,-7,8,15,全班挂了三分之一
9673,1161,胡兰青,2015-11-04 07:24:30,-4,3,7,一塌糊涂
9736,1161,胡兰青,2015-11-06 14:47:34,1,7,6,快，作业多，但是感觉挺好，有基础轻松点，不适合没基础学，上的是计算机基础π_π……
10401,1161,胡兰青,2015-11-18 12:21:15,3,5,2,好老师真的
10511,1161,胡兰青,2015-11-19 10:16:58,3,4,1,很可爱的老师
12032,1161,胡兰青,2015-12-21 14:28:32,6,8,2,老老实实自学吧，思路有点混乱
12056,1161,胡兰青,2015-12-21 15:09:10,3,4,1,很有意思的老师～
12820,1161,胡兰青,2017-12-30 13:12:30,79,88,9,萌翻了…尤其是左右不分和数不清数的时候…虽然嘴笨笨的但是她真的很认真呀你们还舍得欺负她吗？
13682,1161,胡兰青,2015-12-30 10:35:40,3,5,2,可以，老师有时很逗
14282,1161,胡兰青,2016-01-06 05:46:03,0,2,2,上课很认真
14925,1161,胡兰青,2016-01-12 06:20:32,11,13,2,萌 蠢 ，
14936,1161,胡兰青,2016-01-11 06:17:18,1,1,0,认真，嗯。
15679,1161,胡兰青,2018-03-09 07:15:38,0,1,1,认真 善良
16036,1161,胡兰青,2016-01-17 05:01:29,1,1,0,老师人好是真的
16048,1161,胡兰青,2016-01-17 05:12:55,1,1,0,老师人很好，给分也很好
18831,1161,胡兰青,2016-01-22 15:20:40,1,1,0,OOP我那学期上的一团糟
19657,1161,胡兰青,2016-01-25 04:36:31,1,1,0,很负责很认真。
19683,1161,胡兰青,2016-01-25 05:40:00,1,1,0,赞*3\n\n
19708,1161,胡兰青,2016-01-25 06:38:47,1,1,0,注重实践，讲课与企业培训关联。老师很和善，邮件问问题她都认真回了。
19746,1161,胡兰青,2016-01-25 08:17:56,1,1,0,很认真的老师，就平时课程学习有点烦
20304,1161,胡兰青,2016-01-27 03:18:19,24,31,7,老师你讲的太快了我跟不上，不由自主就开小差了，然后就回不来了。感觉计基课最好还是得好好听下。虽然我根本没好好听，后悔死了，靠最后复习还得了4+，感谢老师。
20501,1161,胡兰青,2016-01-28 02:22:55,6,7,1,没基础就别选她的程设！
20779,1161,胡兰青,2016-01-31 10:43:23,0,6,6,时间分配很有问题，在引入知识点勾起好奇心上用大量时间，真正讲有用知识是却经常一带而过，还经常说一些极超前的知识而不加解释。上课给我感觉是在炫耀自己，而非教知识
22645,1161,胡兰青,2016-03-09 06:15:29,78,80,2,嗯，老师课上的挺好，就是第一排一直有个胖子在装逼
22653,1161,胡兰青,2017-05-25 07:20:45,295,347,52,第一排中间右边的胖子你是个傻逼吗 快闭嘴吧 下课想揍他的赞我
22936,1161,胡兰青,2016-03-15 03:12:57,1,1,0,虽然我没考好。。。
22964,1161,胡兰青,2016-03-15 07:38:51,10,10,0,听的一脸懵逼
22980,1161,胡兰青,2016-03-15 16:58:39,13,14,1,永远把class读成坷垃屎，略萌～讲课信息量每次都好大，一走神就感觉漏了好多东西呀……
23263,1161,胡兰青,2016-03-23 06:19:06,82,86,4,我只能说受不了课堂上那两个装B的死胖子吗？去他妈的
23417,1161,胡兰青,2016-03-29 10:08:24,20,24,4,爱她那一包拉面头，穿着打扮很有气质，颇具女人味。讲课虽然有些发音不清，速度也快，但是她非常认真细心负责。
24647,1161,胡兰青,2016-05-03 01:17:07,0,2,2,代码规范要求多，讲的东西乱且少，就靠例程和搜索引擎，例程还有bug写的不咋地
24837,1161,胡兰青,2016-07-05 09:24:40,3,3,0,非常好的老师诶～
25548,1161,胡兰青,2016-05-25 06:04:34,127,135,8,说要打那个胖子的仁兄呢？不是怂了吧？那个死胖子怎么还是上蹿下跳的?
26910,1161,胡兰青,2016-06-21 14:45:28,1,1,0,老师很萌，上课真的很用心，c程全靠自学是对的，和老师无关。
27432,1161,胡兰青,2016-06-26 08:15:35,5,7,2,趁成绩出来前先跟老师表个白 非常非常可爱的老师呀 讲课很认真 解答问题很耐心 自己没考好是我自己没下工夫 最喜欢她吐槽题目了
29931,1161,胡兰青,2016-06-30 14:06:43,5,7,2,真的是一个用心认真的好老师，上课从来都不扯。大程别的班的课件都是一样的，她却认真加上了一些内容。
30871,1161,胡兰青,2016-07-02 16:52:37,0,2,2,啊，ADS上课没怎么听，差点挂了。感谢老师助教不杀之恩。
30997,1161,胡兰青,2016-07-03 05:53:34,1,1,0,虽然稍微有点乱，不过是个很认真负责的老师
31710,1161,胡兰青,2016-07-04 14:37:32,1,3,2,自学是一回事，老师有趣又是一回事。
31999,1161,胡兰青,2016-07-05 10:51:11,1,1,0,老师挺好人的，是我自己没认真学
32008,1161,胡兰青,2016-07-05 11:03:39,1,1,0,老师给分绝对良心，上课的进度较快，同学看过书后再听课会有更好的收获
32032,1161,胡兰青,2016-07-05 12:21:38,1,2,1,讲课不错，作业一般多，给分不错
32189,1161,胡兰青,2016-07-06 02:02:07,0,1,1,上课基本没听，但是给分很好
32276,1161,胡兰青,2016-07-06 05:29:57,3,4,1,胡姐姐超级萌的！是我见过最萌的老师了2333，尤其是一个字母一个字母边读边拼写还写错的时候，简直萌翻！
32424,1161,胡兰青,2016-07-06 16:09:20,1,1,0,上课枯燥，但是该讲的都讲啦
32485,1161,胡兰青,2016-07-07 05:30:25,1,1,0,老师讲c程讲得很清楚详细
32525,1161,胡兰青,2016-07-07 11:16:32,1,1,0,老师讲得挺好，挺细致耐心的，也挺萌
32622,1161,胡兰青,2016-07-08 07:20:24,1,2,1,老师很利索也很贴心，讲的要点也很清楚。不要自己不学怪老师。
34058,1161,胡兰青,2017-12-15 11:20:09,56,58,2,妈的，上次第一排的胖子你不装逼会死吗？\n\n
35793,1161,胡兰青,2016-11-10 08:11:37,1,1,0,有口音
36279,1161,胡兰青,2017-04-09 14:07:03,26,31,5,人确实挺好 就是教学水平真的一般 不适合当老师 适合进企业干程序员
38802,1161,胡兰青,2016-12-19 06:16:42,3,4,1,老师好萌\n\n
39417,1161,胡兰青,2016-12-22 14:11:33,0,1,1,思路是有点乱，但反正知识主要靠自学。\n\n绝对能培养你良好的程序设计习惯。
39481,1161,胡兰青,2016-12-23 04:36:28,0,0,0,挺不错的
40235,1161,胡兰青,2016-12-30 11:19:34,0,0,0,老师挺认真的，讲得还是挺慢的，很细致。
40632,1161,胡兰青,2017-01-04 11:26:31,17,19,2,老师表达不是很清楚，也不是很喜欢会邮件，但是当面问的话她会很努力地讲给你。还有姜助教很温柔，很棒！就助教值得10分，老师的话很有水平，但是教课还差点。
41588,1161,胡兰青,2017-01-12 08:24:43,-4,3,7,全靠自学，完全听不懂在讲啥\n\n
42439,1161,胡兰青,2017-01-14 08:29:20,1,1,0,真是一个好老师
42460,1161,胡兰青,2017-01-14 08:54:56,2,3,1,老师人很萌！挺细致的，对于我这种没有基础的人听着还是不错的。但是自己要自学也是真的
43279,1161,胡兰青,2017-03-02 03:22:58,2,2,0,老师可爱给分高！??????
47116,1161,胡兰青,2017-01-24 02:28:57,3,4,1,呵呵呵呵
47119,1161,胡兰青,2017-01-24 02:41:23,6,6,0,跪谢不挂之恩，感觉花在oop上时间远远不够居然能有3.9我自己都蒙了。上课还是很有趣的(全靠自学doge)
47132,1161,胡兰青,2017-01-24 03:41:34,4,4,0,好老师 给分好\n\n\n\n
47133,1161,胡兰青,2017-01-24 03:48:01,5,6,1,给分好给分好给分好，重要的事情说三遍！
47147,1161,胡兰青,2017-01-24 04:38:30,1,1,0,给分还行
47818,1161,胡兰青,2017-02-25 17:34:43,1,1,0,老师温柔，但是自己不认真，所以期末很痛苦
48047,1161,胡兰青,2017-02-28 06:30:52,0,0,0,节奏快\n\n
48831,1161,胡兰青,2017-03-14 07:45:44,26,28,2,难道胡兰青的课必然有个死胖子装逼吗。。还是那个死胖子挂了这门
49009,1161,胡兰青,2017-03-21 09:05:57,32,34,2,想知道前排说的那个胖子是不是还在活跃在中间的那个胖子
50998,1161,胡兰青,2017-05-11 11:36:57,1,2,1,室友6道题，我26道题，作业真的多
51361,1161,胡兰青,2017-07-06 04:50:38,9,10,1,老师和助教都好好啊。老师上课很认真，助教辅导也很仔细。特别是助教给人一种很亲近的感觉，交流起来完全没障碍和负担。
51481,1161,胡兰青,2017-06-06 07:53:03,88,91,3,所以那个胖子是一直上这个课上好多年都没过么？还一直装逼？
51485,1161,胡兰青,2017-06-06 08:50:44,37,40,3,所以那个胖子是一直上这个课上好多年都没过么？还一直装逼？
52475,1161,胡兰青,2017-06-20 09:36:19,1,3,2,讲解很详细的老师，选她的课特别幸运:)
52746,1161,胡兰青,2017-06-22 12:03:02,1,2,1,感觉老师讲的好认真，但是听不进去，几个网页一直跳。
54359,1161,胡兰青,2017-07-06 01:57:04,1,1,0,为什么我又被正太了……给分也好低啊
55958,1161,胡兰青,2017-07-02 18:40:53,7,8,1,给温柔的姜助教疯狂打call啊啊啊！
56528,1161,胡兰青,2017-07-04 02:46:19,-2,1,3,很萌很可爱的老师，备课也很认真
57165,1161,胡兰青,2017-07-06 00:40:38,-24,1,25,上课不用听，自学就会，考试很简单，第一个交卷也随随便便4.8，到就是不知道为什么没满？
57185,1161,胡兰青,2017-07-06 02:32:02,0,0,0,C程。老师有点口音，不过备课认真，解答也热心，上课往往不仅讲书本，还会提到工程的实际应用。本身有基础的同学强烈安利，老师第一节课就说理论85给满绩。
57218,1161,胡兰青,2017-08-29 04:23:07,16,19,3,有没有感觉老师很像哈利波特里的特里劳妮教授啊？从形象到气质，分分钟让人出戏哈哈……讲的挺快，到指针就有点跟不上了，考试还是要看人品和自己努力。
57233,1161,胡兰青,2017-07-06 05:33:37,1,1,0,刚开始听老师上课，感觉口齿不清……后面就熟悉啦，也就听得很清楚啦。之前有学长很不推荐这个老师，但上起课来感觉蛮好的，也会扩充一些额外的知识。只是进度好像比其他班慢一点，但考试会考的都讲啦。助教也很负责，每次上机课都耐心答疑~
57243,1161,胡兰青,2017-07-06 06:09:49,1,2,1,oop⋯在可怕的计科大二下hlq的oop简直是一股清流，虽然2.5学分拯救不了我爆炸的绩点，但还是要点个大大的赞
57297,1161,胡兰青,2017-07-06 13:08:30,-2,1,3,老师很亲切呀，助教也挺热情，但是老师对上课节奏的把握不是很好，对同学们的讲解不是很清楚，考试全程感觉特别差，然而不可思议的是我居然得到了4.5？？
57464,1161,胡兰青,2017-07-08 07:34:05,-2,1,3,我觉得讲得很好啊。。oop老师从比较简单的代码开始讲起，先让你对这个东西有个初步的了解，然后再会给你讲一些细节和重点。。一点点加深。。认真听下来感觉完全可以跟得上。。
59695,1161,胡兰青,2018-01-23 17:02:28,9,11,2,程设。没有基础的我听的非常费劲不过感觉老师讲的还是很好的，不太注重基础题的练习。听老师的课能轻松过实验考但期末理论考会很麻烦。另外，表白助教。
61010,1161,胡兰青,2017-11-07 02:35:29,2,2,0,超级好，很耐心
61070,1161,胡兰青,2017-11-08 02:11:15,1,1,0,ifmmp笑死
64081,1161,胡兰青,2017-12-21 02:14:19,15,16,1,胡老师讲的很耐心呢，每次讲课都有自己的见解，另外给胡老师的助教小哥哥打call\n\n虽然现在评分还没出，但还是要给10分10分，有木有人赞我
64553,1161,胡兰青,2017-12-25 06:45:17,0,1,1,66666
64645,1161,胡兰青,2017-12-26 02:06:07,4,4,0,超喜欢的老师，有时候笨笨的真的超棒！
64775,1161,胡兰青,2017-12-27 06:00:55,2,2,0,很轻松
65689,1161,胡兰青,2018-01-08 08:39:57,1,1,0,老师很可爱啊\n\n
65701,1161,胡兰青,2018-10-11 01:10:10,4,5,1,我真的看出来老师有很认真的在讲课，努力的把每一个知识点给我们讲清楚，虽然有时会因此拖慢上课的进度，但是我觉得，她的理念就是，不为上课而上课，而是为了给我们更多知识。
67020,1161,胡兰青,2018-01-20 03:18:14,5,6,1,很负责任的老师，还有，表白助教
71999,1161,胡兰青,2018-01-29 07:44:10,8,12,4,感觉老师说话怪怪的，讲话都讲不清楚，一件事情要过很长时间才反应过来，这样很容易让别人生气的好吗？一个学期基本没教什么东西，作业都是下一节课的内容，全靠自学，除了一个好助教以外这个老师真的没有别的可以推荐的了
72064,1161,胡兰青,2018-01-29 09:28:27,1,2,1,切合实际，注重实际的运用、理论与实践的结合，是真正的有求是精神的老师，点赞！
72092,1161,胡兰青,2018-01-29 10:23:39,1,2,1,计基课，事少分高，挺不错的
72164,1161,胡兰青,2018-01-29 13:44:14,1,1,0,大计基给分超好！ 以为机考要挂了！给了我4.2！感激！
72471,1161,胡兰青,2018-01-30 07:38:13,5,5,0,虽然老师讲的不是很清楚但是给分还是不错的+助教小哥哥好评
72474,1161,胡兰青,2018-01-30 07:50:45,1,1,0,给分好，给分好，给分好
72482,1161,胡兰青,2018-01-30 08:20:30,2,2,0,老师给分超好了，我自己也有很认真的学，程设讲课会讲到工程相关知识，不拘泥于课本，还会质疑，不过还是需要自己认真学习补充。真的是超级温柔的老师了，私下问题也很耐心解答，超级棒！！！\n\n\n\n另外，必须疯狂给助教小哥哥打电话，啊啊啊，又负责又会卖萌！！！大佬一只，超棒啊！
72500,1161,胡兰青,2018-01-30 08:46:42,2,4,2,有点讲不清楚 但是老师和助教超nice
72574,1161,胡兰青,2018-01-30 12:29:35,0,1,1,老师很可爱很可爱，给分超棒，我一学期就听了两节课，考试周复习了一天然后绩点还不错
72873,1161,胡兰青,2018-01-31 08:29:17,1,2,1,老师讲课超级认真，不是水水的上课是真的想要教会你东西。还有，表白表白助教哥哥！
72963,1161,胡兰青,2018-01-31 12:31:55,0,1,1,棒棒哒\n\n
73400,1161,胡兰青,2018-02-05 06:07:25,5,5,0,给分好高。。。给老师笔心！
73614,1161,胡兰青,2018-02-02 05:54:52,1,2,1,非常注重实践，讲的很细，任务也不算多，一紧张就有点萌。助教超好
74027,1161,胡兰青,2018-02-04 09:43:43,1,1,0,oop还没出成绩呢……
74126,1161,胡兰青,2018-02-05 11:16:08,0,1,1,给分让我很意外，比我预料的要高不少，很良心的老师了。嗯可能是计院的课给分都很好吧嘻嘻。
75827,1161,胡兰青,2018-03-19 09:29:19,12,14,2,说话说不清晰 上课也不知道按什么顺序上的  学都没学就让人写作业之后才讲解  什么鬼
76338,1161,胡兰青,2018-04-03 11:45:21,-3,4,7,自己在讲什么都不知道，毫无逻辑感，表达不出想表达的意思。你适合去搞研究，来教书就是害人
79257,1161,胡兰青,2018-05-29 06:23:44,14,14,0,个人觉得老师有水平，但是讲课不太好啊……
84445,1161,胡兰青,2018-07-13 01:19:23,13,13,0,听得脑壳疼 发音有些不舒服 函数名～ 类型～ 很标准的后鼻音～
84578,1161,胡兰青,2018-07-13 08:21:10,2,3,1,平时分给的有毒\n\n
84584,1161,胡兰青,2018-07-13 08:41:37,6,9,3,助教0分，虽说是外校的，但什么事都不知道，与同学的互动也不多，出成绩之后就不理我们了，真不知说什么好。
84650,1161,胡兰青,2018-07-13 12:28:27,0,0,0,哈哈哈哈
84655,1161,胡兰青,2018-07-13 12:35:12,-1,0,1,老师人性格很好，比较注重实际应用，理论部分调分了感觉还行。
84656,1161,胡兰青,2018-07-13 12:38:05,0,2,2,老师人很可爱呀，就是作业布置超前有点痛苦。但是给分真的好！理论实验都低空飘过最后居然上3了
84657,1161,胡兰青,2018-07-13 12:42:50,0,1,1,老师很棒啊，教的都不是死的知识，教的很细，期末很为大家着想，调分棒棒的。必须十分！
84663,1161,胡兰青,2018-07-13 12:52:43,-1,0,1,浓浓师生情！谢谢老师！！！
84664,1161,胡兰青,2018-07-13 12:54:09,1,1,0,感谢老师不挂之恩
84668,1161,胡兰青,2018-07-13 12:59:25,0,0,0,感谢老师送上的温暖！
84671,1161,胡兰青,2018-07-13 13:05:17,-2,1,3,经常会讲一些公司里编程的要求，课本内容涉及的不是很全面，但老师上课很认真，给分很好
84682,1161,胡兰青,2018-07-13 13:37:17,0,3,3,10分不解释。如果不是这个老师我已经退学了。感谢胡老师?！！！
84701,1161,胡兰青,2018-07-13 14:49:54,4,4,0,老师力挽狂澜 拯救了我的C程 感人肺腑啊
84718,1161,胡兰青,2018-07-13 15:24:22,3,3,0,感谢老师不挂之恩
84830,1161,胡兰青,2018-07-14 03:16:00,1,3,2,老师上课超级认真 给分也很好 上课的时候经常会教一些书本上没有但是很实用的知识 很好的老师
84880,1161,胡兰青,2018-07-14 07:13:53,-7,0,7,事情比起其他班真的超级少，就是期末考的超级低，绩点只有3对不起老师，因为这门课拿不上奖学金了感觉挺可惜的
84996,1161,胡兰青,2018-07-15 02:12:52,0,1,1,老师挺可爱的，虽然常常说不清楚很着急的样子，但个人觉得只要多百度还是OK的，绩点4飘过。
85073,1161,胡兰青,2018-07-15 08:34:36,0,0,0,oop讲得还可以的，最后给分有一点点低于期待，不过应该与期末考试有关~好评！
85094,1161,胡兰青,2018-07-15 09:41:04,1,1,0,谢老师不挂之恩orz 以后一定改过自新重新做人 谢谢老师！
85489,1161,胡兰青,2018-07-18 12:42:38,-6,1,7,老师上课挺仔细的，就是有点着急，语速会加快，给分挺好的呀，考完感觉自己考砸了，没想到有4.5
86371,1161,胡兰青,2018-09-14 07:50:15,0,0,0,前期听不懂，看网课，后面慢慢就能听懂了，老师是真的萌说话也真的快?
87878,1161,胡兰青,2018-10-16 15:52:30,-29,2,31,开学了两个月记起来了，报复性1分，大程作业都做了，课也都听懂了，期末时间来不及就裸考了，期末考58班里40%-60%，1.5飘过，从小学就开始打信息比赛，没受过这么大委屈
88652,1161,胡兰青,2018-11-05 04:14:25,8,8,0,上课进度跟作业难度不是一个级别啊
88653,1161,胡兰青,2018-11-05 04:15:15,1,2,1,什么都不懂
88664,1161,胡兰青,2018-11-05 06:38:39,6,6,0,讲话太难懂了。英语忒差劲了。讲得又超快，上课及其痛苦。
89816,1161,胡兰青,2018-11-21 02:18:27,4,5,1,讲话听起来不是很舒服，而且有点条理乱。不过确实教的认真。
91202,1161,胡兰青,2018-12-03 07:04:10,2,3,1,本来就是初学者，频繁做超前一节的作业，做不出来不是问题，pta不给过，调试又调试不出来，长此以往，加深了对编程的恐惧
93201,1161,胡兰青,2019-01-08 06:04:30,6,6,0,超棒|･ω･｀)\n\n（就是从来没搞清楚过要做什么作业）\n\n（从来没搞清楚过什么时候是ddl）\n\n（每次ddl前赶着写组队实验报告）\n\n所以我觉得这个老师太棒了
93300,1161,胡兰青,2019-01-09 02:12:36,2,2,0,软测考试上：等会有考试院的人来检查，同学们小心点ψ(｀∇´)ψ真是代表最广大人民群众的根本利益
93906,1161,胡兰青,2019-01-14 08:06:04,2,2,0,c小程前期pta作业进度比教的快，打击自信。后面慢慢会好起来。没有ddl概念。老师上课非常认真，讲话挺萌的，语速偏快，但会确认我们听懂。有时会讲讲实际工作时的要求，也时常关心学生的感受，跟着胡老师是能学到东西的。
95875,1161,胡兰青,2019-01-20 07:15:33,9,9,0,普通话真的听的我很难受，也从来不公布pta上填空选择的答案没法及时订正，理论知识完全懵逼。
98405,1161,胡兰青,2019-01-23 12:06:44,-3,1,4,胡老师太萌了！人很好！喜欢
101353,1161,胡兰青,2019-01-28 05:22:09,-1,3,4,大计基真的很好，事少
101354,1161,胡兰青,2019-01-28 05:23:32,-1,1,2,虽然大计基是一门水课，但是老师讲课很认真。老师课讲的比较慢，而且有的地方讲的不是很清，但是看书也能看懂。最后要说，老师真的很好，我这种菜鸡最后也上4了，谢谢老师！
101371,1161,胡兰青,2019-01-28 06:03:53,1,1,0,
101379,1161,胡兰青,2019-01-28 06:10:18,6,9,3,绩杀，全靠自学，课件学习资料上传不及时，课堂内容跳跃性大，上课内容随性，有时会脱离课本
101442,1161,胡兰青,2019-01-28 08:07:13,3,4,1,其实oop讲得一般，但看得出来很用心在教，很负责任的老师，脾气很好。其实oo完全可以自学，因此问题不大。给分平时助教尽量都给满，还是看期末吧。附:老师应该不给签条子
101487,1161,胡兰青,2019-01-28 09:43:50,-6,0,6,（针对大计基课…）老师讲的很快，内容很多，程序方面感觉讲得很棒，但是前面基础部分因为补充了很多内容，感觉很难抓住重点…有点凌乱。最后根据她 的PPT以及习题突击复习效果还是可以的…看书还是必要的。
101629,1161,胡兰青,2019-01-28 15:42:33,-12,0,12,超级温柔的老师，给分还好\n\n最后期末考一半不会写最后居然4.5\n\n平时事情还比其他班级少\n\n啊，废话不多说，疯狂打call\n\n
101634,1161,胡兰青,2019-01-28 15:44:36,-4,2,6,呜呜呜\n\n感谢老师\n\n(´▽｀)ノ♪\n\n老师超级超级棒
101782,1161,胡兰青,2019-01-29 05:15:00,-6,0,6,老师很可爱，也很认真的上课了！
101827,1161,胡兰青,2019-01-29 08:08:54,9,9,0,作业布置的真的太含糊了，至始至终都不知道思科该做哪部分
101854,1161,胡兰青,2019-01-29 09:36:36,6,8,2,不懂怎么被绩杀得
102026,1161,胡兰青,2019-01-30 05:14:59,6,7,1,惨被绩杀\n\n作业布置的很含糊...\n\n把自己知道的都做了\n\n期末考试也觉得挺顺利...\n\n但就是很惨....
102110,1161,胡兰青,2019-01-30 13:08:25,3,6,3,辣鸡，无道理的绩杀
102476,1161,胡兰青,2019-02-03 06:55:01,3,5,2,无理由绩杀
102902,1161,胡兰青,2019-02-25 02:06:06,2,4,2,没有这么绩杀得?
103615,1161,胡兰青,2019-03-02 10:09:28,2,2,0,虽然经常把break念作black 虽然时间把控上好像有点不够 但给分真的很好很好！本来怎么算平时分都到不了这样的成绩的，谢谢老师
103791,1161,胡兰青,2019-03-05 15:38:43,0,4,4,1分，不解释
103908,1161,胡兰青,2019-03-07 06:59:05,0,1,1,老师讲的很细
104095,1161,胡兰青,2019-03-12 02:46:41,3,4,1,基础不过关，路路一套套。\n\n企业套路乍一听唬人，其实味同嚼蜡。
104096,1161,胡兰青,2019-03-12 02:52:10,1,2,1,坐在教室前面右边的胖子能不能别装b了，看着真得很烦
104372,1161,胡兰青,2019-03-19 02:33:46,9,9,0,听得出来老师很努力在讲……\n\n但是老师讲话没什么条理，一节课听下来感觉听了很多，实则十分混乱\n\n并且老师口头禅有点点多\n\n
104657,1161,胡兰青,2019-03-26 01:49:47,0,0,0,慧话少说，给分好
104668,1161,胡兰青,2019-06-26 09:58:28,13,17,4,群里那几个考完试明明考得很好还互膜卖弱的人真的是非常过分，不考虑别人的感受
104764,1161,胡兰青,2019-03-27 08:30:13,1,2,1,无法理解作业为什么这么多
104998,1161,胡兰青,2019-04-02 03:04:24,1,1,0,太快了
105268,1161,胡兰青,2019-04-09 01:59:03,4,4,0,“名”这个字的发音有点魔性...
105270,1161,胡兰青,2019-04-09 02:16:22,4,4,0,感觉老师人蛮好的，但是讲课不太行，没什么条理，感觉说了一堆还是不知道咋回事。。全靠自学
105275,1161,胡兰青,2019-04-09 03:03:11,2,2,0,难以评价
105519,1161,胡兰青,2019-04-16 03:06:36,3,3,0,表达能力略差啊……
105976,1161,胡兰青,2019-04-24 02:44:59,-2,0,2,讲得真的很细致了！
108343,1161,胡兰青,2019-05-21 11:59:46,0,0,0,很认真，但是早课真的没啥人听，也没很多人不来，为了能有人来后期小测。推荐一下北大的MOOC课程，自学效率upup！
108422,1161,胡兰青,2019-05-23 17:41:26,9,10,1,都9012年了，怎么第一排还是有个可恶的胖子？还是个大胡子，上课老是说话。好烦人！
108781,1161,胡兰青,2019-06-02 04:15:55,0,1,1,哈喽 窝的?
109842,1161,胡兰青,2019-06-19 15:31:52,10,10,0,所以这个胖子都老得长胡子啦？
111502,1161,胡兰青,2019-07-01 23:32:06,4,4,0,跪求不挂
113363,1161,胡兰青,2019-07-06 10:01:37,3,3,0,第一排的胖子还是那么活跃？
113428,1161,胡兰青,2019-07-06 17:17:51,3,3,0,跪谢老师不挂之恩
113444,1161,胡兰青,2019-07-06 17:23:38,1,1,0,老师讲课很认真，但条理有点差，内容很干货，要非常认真听才能记住，老师讲话口头禅有点多，但很好的老师哦
114253,1161,胡兰青,2019-07-09 10:35:13,1,3,2,真踏马受不了第一排的死胖子，装什么逼？闭嘴好吗！！！
114278,1161,胡兰青,2019-07-10 00:47:41,7,7,0,有基础的话 不听课也可以 老师不点名 所以还是挺随意的o(｀ω´ )o 而且老师很可爱噢 在qq群里会解答滴
114285,1161,胡兰青,2019-07-09 17:17:21,-11,2,13,老师人真的很好，期末考试没有完整的做出一道，原本以为会挂科，结果不仅没挂绩点也有3.9，真的很感谢老师
114320,1161,胡兰青,2019-07-09 18:16:38,-17,1,18,胡老师给分真的好！期末实验只做了一道 结果绩点上四了还！
114328,1161,胡兰青,2019-07-09 21:44:46,1,1,0,本来已经做好挂科重修的准备了，但真的很感谢老师的不挂之恩（最近几天一直在担惊受怕，以后一定不能再浪了，要好好学习了）。\n\n
114455,1161,胡兰青,2019-07-10 03:43:34,7,8,1,C程，老师人很好，和蔼可亲，挺可爱的，也经常在QQ群里回答问题。但我觉得讲得不是很好，有些乱，经常说：没事啊我们慢慢来，讲起来却不怎么有节奏，有些地方迷之跳跃，讲不清楚。老师第一节课就说C程是有套路的，但一学期下来她也没有对一些类型进行系统的讲解。另外平时的pta作业真的太多了，远多于其他老师！占据了大部分学习时间，而且枯燥的编程极大影响了我学习C程的热情。最后给分实在是很宽容了，也可能是因为今年三十号的理论考偏难的缘故吧。\n\n感谢老师。
114463,1161,胡兰青,2019-07-10 04:23:43,1,2,1,跪谢老师不挂之恩5555555
114541,1161,胡兰青,2019-07-10 12:36:12,1,2,1,给分不错
114944,1161,胡兰青,2019-07-13 01:37:07,1,2,1,为什么又卡绩？
117004,1161,胡兰青,2019-09-18 06:33:18,5,10,5,讲课一言难尽，语言表达能力基本为零，毫无逻辑，听她讲了半天不知道想表达什么，东扯一句西扯一句，唉，奉劝大家网上自学
120727,1161,胡兰青,2020-01-16 01:42:09,9,10,1,语言表达能力不太好，但该讲的还是讲了。给分不错，而且会捞人。👍🏼👍🏼👍🏼
120985,1161,胡兰青,2020-01-20 17:08:41,-106,3,109,卡绩了，只有4.5，想死的心都有了
121197,1161,胡兰青,2019-12-31 01:25:13,3,5,2,太喜欢这个老师了，从来不点名，作业也很少（其实是稀里糊涂的，但真的是超级少，课程很水，作业很简单）强烈推荐喽，选了她的课后，发现浙大居然还有这个水的课，压根不需要听，期末复习一下就行了
122000,1161,胡兰青,2020-01-29 15:28:03,9,13,4,❶真的是个好老师！虽然她有时候上课会让你觉得“老师老师你真的要讲不完了” 但她讲的很多东西是带有真实的想让你理解进去的目的的！❷讲讲成绩的问题 首先对于卡绩的问题 老师难道要给所有人都压线绩点吗 这样这个班的分数都是一样的吗 所以卡绩不卡绩只是你自己的问题 再怎么好的老师都没有办法帮助你 其次个人认为老师给分很公正了 毕竟这门课老师能自由调整的分不对（好像只有5分）剩下的小组评分和期末考试都是自己打拼来的 所以说绩杀的宝贝们可以想想自己的问题先哦 ❸再建议一下期末考试 刷题库 保留之前做过的题库 然后结合ppt与书本地看题库 总而言之 题库真的很重要重要！
123447,1161,胡兰青,2020-06-09 03:37:45,0,0,0,老师给分很好
125214,1161,胡兰青,2020-09-03 18:59:02,1,1,0,跪求不挂……
125559,1161,胡兰青,2020-09-11 13:38:20,0,2,2,不小心把预置课退了，再想进还有什么办法吗TAT
125975,1161,胡兰青,2020-09-16 06:48:38,-3,0,3,借楼吹赵小琼，上课太逗了，软件测试与质量保证是软工三连里最好玩的了
126136,1161,胡兰青,2020-09-18 05:28:02,2,2,0,感谢老师不挂之恩！
126137,1161,胡兰青,2020-09-18 05:39:56,5,5,0,老师还是挺好的，只要你认真学习、码代码，达到了老师的要求，都能取得不算太差的成绩，学习终归是要靠自己的，不是吗？
126362,1161,胡兰青,2020-09-24 01:22:21,5,5,0,所以周一统一回答等于不回答？
127422,1161,胡兰青,2020-11-23 01:10:35,6,7,1,很适合想要锻炼自学能力的同学
128530,1161,胡兰青,2020-12-23 15:24:14,2,3,1,很可爱，口音听起来很舒服
129611,1161,胡兰青,2021-01-08 14:05:27,7,8,1,老师是好老师，但是思路真的好混乱....常常无法理解她在讲什么，作业也难以理解，就是感觉讲不清楚....除了这点其他都挺好的
130083,1161,胡兰青,2021-01-16 13:52:02,-6,2,8,女神！！！！！！
130260,1161,胡兰青,2021-01-20 09:47:58,24,26,2,胡老师水平是100分，但是由于老师的表达能力我们只能接收到60分
131407,1161,胡兰青,2021-01-27 11:19:41,11,11,0,强烈建议 如果你是要选她的大计基有这么几个优点\n\n1.作业交的时间很晚 你可以有很长时间来补\n\n2.有好多作业是小组内部打分 我就没做也拿到了满分（具体看组长）\n\n3.从不点名\n\n但是如果是想要学点东西的\n\n死都不要选\n\n孩子每次都来了 感觉啥也没听懂
131494,1161,胡兰青,2021-01-27 17:32:48,-2,2,4,好老师！遇见有疑问的程序都会自己写出来跑一遍验证实际效果
131827,1161,胡兰青,2021-01-29 04:23:20,6,7,1,讲课不清楚，对学生态度挺不好的，给分不好
132336,1161,胡兰青,2021-02-02 14:06:36,22,24,2,业务水平有 但是上课上的和shi一样 c程基本靠自学 给分也低
132398,1161,胡兰青,2021-02-01 09:45:14,-2,2,4,评分还是挺公正的，就是不好水，期末考总评％75的考试，剩下25分中3分读书报告基本稍微认真点写都基本能拿满，其余部分就是PTA的分数，所以平时作业一定要好好做
132466,1161,胡兰青,2021-02-01 17:18:57,10,12,2,对学生态度挺不好的，讲课不清不楚，给分一般
132512,1161,胡兰青,2021-02-02 05:11:37,33,43,10,OOP:1分不能再多了，上课思路非常混乱不说，作业也布置不明白，给分也较差。\n\n言已至此，慎选！
132532,1161,胡兰青,2021-02-02 06:18:03,5,13,8,给老师打1分\n\n给大计基这门课打十分\n\n给oop打1分\n\n老师是真的说不清楚在讲些什么 思维极度跳跃\n\n大计基55的平时分真的超级超级容易水满 所以大计基的绩点真的很高 而且考试自学即可\n\nooo我没学 但是让我npy挂了 怎么可能打高分对吧
132688,1161,胡兰青,2021-02-03 10:09:54,15,20,5,老师讲课能力超差 绩点给的低 千万别选
133216,1161,胡兰青,2021-02-19 01:09:24,10,13,3,快跑，别选
133344,1161,胡兰青,2021-02-26 04:20:21,-5,4,9,感觉是一个很负责的老师，会反思自己前几年教学中的问题，讲的很细。
133382,1161,胡兰青,2021-02-26 11:31:56,-14,0,14,讲得挺清楚的
133594,1161,胡兰青,2021-03-02 13:01:35,-4,4,8,老师很亲切，讲的应该也不错，就是我没咋听
134467,1161,胡兰青,2021-03-29 13:24:26,-3,6,9,可能更适合信奥的同学选，上她的课学到了蛮多东西的。也会突然拓展一下企业的编码规范。老师人也很好的，钉钉基本是及时回话。
135662,1161,胡兰青,2021-05-18 08:19:48,7,8,1,助教zz
135913,1161,胡兰青,2021-06-03 02:44:39,17,17,0,上课太快了。。。PTA里的题进度比上课还快，根本不会。。。
136584,1161,胡兰青,2021-06-21 09:21:51,-6,2,8,老师挺好的
136675,1161,胡兰青,2021-06-23 01:33:40,18,21,3,就很离谱，C小程，有基础的可以来，我这种零基础的第一节课直接开始叭叭叭讲，直接干懵了，全靠自学和同学和CSDN，作业还多，根本不会，上课能把自己讲进坑去，讲着讲着开始debug了，课件里的bug，微笑脸，没有基础的想学好的千万别选！！！预置也要退！！！我这个学期最大的错误就是为了大英老师退掉了预置的C程选了胡老师的课……😅😀
136999,1161,胡兰青,2021-06-29 09:22:41,-29,3,32,人最好最耐心的老师，对学生很宽容很细心，就算期末给我0分我都要打10分
139740,1161,胡兰青,2021-08-01 09:29:47,7,10,3,别选她，挂科了……
143887,1161,胡兰青,2021-12-10 07:08:27,7,7,0,作业巨多无比，选了真亏时间。
144140,1161,胡兰青,2021-12-19 13:01:21,10,10,0,作业这么多，计科练习，pta的python练习，思科练习，还有实验报告，5k字课程报告，小组学习报告，什么玩意啊，布置少点作业会④吗😅😅
144682,1161,胡兰青,2021-12-23 06:02:28,6,8,2,作业多，很废时间，尤其是一门偏理工科的课程居然要写5k字AI畅想报告？迷惑。讲课一般。
145246,1161,胡兰青,2021-12-28 12:09:32,-6,7,13,感谢老师捞我 实验一题，理论只有30+，最后还有70+ 老师真的很用力在捞了。老师上课也挺好的，最后一周还会有重点和讲题，只是自己大一不太用功，老师还是很用心的，水平也还可以
146579,1161,胡兰青,2022-01-07 03:28:37,9,10,1,人间极品，作业一堆，讲课讲个什么都不知道。什么都讲不清楚，一个计算机搞什么小组合作学习。不知道分数还。
149662,1161,胡兰青,2022-01-16 09:41:07,-11,4,15,老师不错，上的c小程，最后评分应该有调整比例，我30多分的理论最后也没有挂，感谢胡老师
149966,1161,胡兰青,2022-01-18 05:40:41,12,13,1,一门大计基，要写5000字人工智能报告，还要整体查重（包括概述部分），还只占5分，还要写小组学习报告，上课说的最多的一句话是“同学们不好意思我上节课讲错了”。给分还卡绩，真的差不多得了。避雷避雷避雷避雷！！
150082,1161,胡兰青,2022-01-19 02:03:38,-7,1,8,大计基给分还行，上课讲解得不太清晰（不过可以自己看课件），老师人不错，不过这门课还是靠自学
151603,1161,胡兰青,2022-03-09 06:33:54,7,7,0,听不懂
151695,1161,胡兰青,2022-03-29 08:06:57,2,4,2,老师人很好，但讲课不太行，知识点很不清楚
151845,1161,胡兰青,2022-05-11 11:23:53,9,12,3,谢谢，弃修了
151896,1161,胡兰青,2022-03-19 15:45:42,12,13,1,笑死，真就一句话重复十遍，你上课想走神根本没办法，声音贼有穿透力。。。\n\n\n\n虽然讲得不是很对我胃口，不过老师属于转码友好型，企业里要什么样的程序员每节课都会讲，还蛮有思想的，总之没出分见仁见智吧。。。
152275,1161,胡兰青,2022-04-01 06:57:11,23,24,1,说真的老师自身实力很一般，有问题在钉钉上问她，她也只知其一不知其二。上课令人瞌睡
152955,1161,胡兰青,2022-04-22 08:59:29,8,8,0,作业多
153160,1161,胡兰青,2022-04-26 09:39:48,22,25,3,上课不知所云，想哪讲哪，期中题无聊刁钻。
153268,1161,胡兰青,2022-04-27 08:57:40,-21,3,24,我觉得老师挺好的，该讲的知识有什么没讲吗？作业是挺多的，主要我个人觉得有用所以不觉得有什么，而且我挺喜欢她的上课风格的，仔细又不拘泥于课本
153723,1161,胡兰青,2022-05-09 09:18:15,17,18,1,怎么说呢，有同学在钉钉上问她一道作业上的选择题，她的回答竟然是排除法。
154718,1161,胡兰青,2022-06-04 06:41:04,7,7,0,不知所云
155133,1161,胡兰青,2022-06-08 15:11:57,9,9,0,啥胖子，咋前排都在说胖子
158447,1161,胡兰青,2022-06-29 10:14:20,3,5,2,老师给分很高，期中考试只有七十几，最后大作业做得好甚至会调分
158797,1161,胡兰青,2022-07-02 09:53:16,21,22,1,上课不知所云，有用的信息极少，一直在重复“好我们慢慢来不要急，请同学们看这里，那是为什么呢，也就是说……”。c小全靠自学。给分还特别求是，总评比理论还低。。。
159610,1161,胡兰青,2022-08-22 04:36:11,19,22,3,咱是新来的，一来就看见全在骂死胖子
160203,1161,胡兰青,2022-09-15 02:52:50,-1,1,2,认识实习给分还不错
161035,1161,胡兰青,2022-10-24 12:40:46,5,5,0,作业对于基础不好的同学来说真的超级多
163947,1161,胡兰青,2022-12-16 18:12:32,10,11,1,老师很温柔，不点名，但是！但是！讲的不行，尽管她很认真，可能表达有问题，而且演示的时候经常卡壳。想要好好学的不要选，摆烂比较适合，因为不点名，选大计基还行，C程快跑！！！！！！！！！！！最重要的是，她上课经常跑到屏幕前比划，智云补课一点声音都收不进去……
164468,1161,胡兰青,2022-12-21 06:34:45,6,7,1,大计基 上课真的很混乱，学期最后一星期突然加了个组队学习报告……非常不理解
164469,1161,胡兰青,2022-12-21 06:55:08,-6,2,8,讲的确实快，但是讲的很详细，很有水平
165157,1161,胡兰青,2022-12-29 11:50:10,4,5,1,一言难尽......
166405,1161,胡兰青,2023-01-12 07:26:31,7,9,2,不要选C程...绩杀，无解！(
166408,1161,胡兰青,2023-01-12 07:31:56,4,5,1,被绩杀了
166412,1161,胡兰青,2023-01-12 07:49:41,4,5,1,老师人还是很温柔的，问问题也回答的比较及时。上课的时候会随时打开编译器然后开始debug，可能会让一些同学比较迷惑。上课讲的偏快而且以知识点原理为主，讲的细致但是对没有基础的同学确实不好理解。作业布置的比较多而且难度不小，对一些同学来说确实压力很大，而且虽然作业题我基本上都能过，但是改变不了我期末实验题只做出来一个的事实（笑哭）。小测难度大而且考察细节和逻辑推理十分多。最后给分方面，这学期情况特殊，老师可能稍微捞了捞小测，但总体还是求是的。总而言之，如果有基础的话，胡老师的课可以帮你了解一些企业生产方面的知识，对将来工作是有好处的，但是没基础的同学还是快逃吧。。。
166622,1161,胡兰青,2023-01-13 04:41:03,10,11,1,卡绩气死
166627,1161,胡兰青,2023-01-13 07:39:05,5,6,1,老师真的不行，学弟学妹们选到这个老师的话，赶紧溜吧
167175,1161,胡兰青,2023-01-15 04:41:55,13,14,1,快跑！！！给分特别求是，每次作业和考试的编程题都满了结果绩点出来比一节没听的通识还低？？
168140,1161,胡兰青,2023-01-30 04:48:52,6,7,1,快跑，绩杀
169382,1161,胡兰青,2023-02-26 01:21:57,-1,0,1,呵呵呵呵
170678,1161,胡兰青,2023-03-08 03:18:20,12,14,2,上课好无聊啊，听着听着就得睡着了，我早八物理都没这么想睡。
171745,1161,胡兰青,2023-04-04 01:17:15,9,10,1,（c大程）仅仅个人看法：口音很重，我自己听的有点难受，也有一点催眠；感觉讲课有点不知所云，听不懂到底在讲什么，可能是我个人水平问题；助教不要求上机课，可能是少有的优点吧。
172105,1161,胡兰青,2023-04-20 13:10:53,6,7,1,垃圾东西
172169,1161,胡兰青,2023-04-21 05:37:52,5,6,1,依托使
172215,1161,胡兰青,2023-04-22 13:08:23,3,4,1,考试机子坏了跟我装傻，一点不想负责人，讲课也是水的一批
173974,1161,胡兰青,2023-06-05 10:24:55,9,10,1,期末本来没挂，硬是给我挂掉，真没见过如此之可恶的老师！别的老师不希望学生挂掉，这个老师授课水平没那么高不说，还专门故意挂掉学生，真的很气人！
175532,1161,胡兰青,2023-06-25 11:12:45,3,3,0,建议选上的uu平时作业全去搜答案
176772,1161,胡兰青,2023-06-30 05:10:11,1,2,1,上学期就是胡老师的C小，这学期又上了C大。优点就是她不太管一些作业的东西（甚至这学期直接少布置了一次作业）基本上是给助教操作的因此作业周期长一些时间没这么紧。而且她真的不点名，两个学期只点了一次还是在网课期间。\n\n不过缺点也很明显，讲课真的不太好懂，更多的需要自己去理解ppt上的内容，好好做作业，必要时去网上查资料。c大期中考了很多作业上的内容因此作业很重要。\n\n最后大程，采用的是互评方式，我遇到的同学都还是挺友善的不过不知道其他的如何了（苦笑）
176854,1161,胡兰青,2023-06-30 11:41:50,2,3,1,C大，不点名，不绩杀，总评就是各个部分之和，也不调分就是，该得多少就得多少，不过好像我们小组至少两名是那个绩点的最低分，也许捞了0.5分。\n\n上课有点想让人犯困，不过资料挺多，精神好也能听懂。\n\n总体得一个中等分难度不大，因为考试只占总评约29%。\n\n互评我们组遇到的情况还好，给出的也是基于标准多给了5-10分，也没什么问题。\n\n预置不建议退，然后期中考试一部分出自作业题，可惜我没认真做作业，否则期中不至于炸掉……
177782,1161,胡兰青,2023-07-04 23:44:00,0,3,3,讲课，是稀碎的\n\n进度，是乱来的\n\n课程内容，是自己都搞不懂的\n\n出了教学事故，是装傻的
177866,1161,胡兰青,2023-07-05 06:46:47,1,1,0,磨了十天给了3.6，自我感觉挺低的。只能说给分不算太差吧。
177937,1161,胡兰青,2023-07-05 15:29:32,0,0,0,修的第二遍c小了（但不是重修） 老师上课不点名 对于第二次修的同学非常友好 给分我认为不错 有这种需求的同学们可以放心选哦！
178266,1161,胡兰青,2023-07-09 05:56:58,4,5,1,给分还行，不差的\n\n算了一下，是调过了的\n\n跟同学对比了一下，一定要注意小测和平时成绩，很重要\n\n（同学跟我一样，实验题做出一道，他理论比我高5分，但绩点比我低0.6，我们推测就是平常小测的影响）
178547,1161,胡兰青,2023-07-14 07:43:38,0,0,0,自学者请移步陈建树老师的智云...
178765,1161,胡兰青,2023-07-22 04:45:57,2,2,0,c大是胡老师班的，老师比较注重代码规范，所以最后大作业如果想要那点规范的分是非常痛苦的。讲课的话比较快和零碎，但也还能学到不少。平时不点名，上机课可以不去，最后大作业互评的话就看同学怎么样了，不好评价。选的七巧板，三个人吭哧吭哧搞了好久hhh，这个确实比较有难度，也学到了一些东东，只能说痛并快乐着，感觉当初选的组员也都挺好，最后完成度挺高，互评得分也蛮好。最后的话总评94，看群里谢谢老师的情况老师给分应该还是不错的。
179414,1161,胡兰青,2023-09-15 02:00:56,0,0,0,认识实习的给分有点迷惑
181184,1161,胡兰青,2023-10-11 04:09:14,1,1,0,胡老师我爱你！
181185,1161,胡兰青,2023-10-11 04:09:32,4,4,0,提前15分钟下课，真的神
184456,1161,胡兰青,2023-12-20 04:27:48,1,1,0,感觉挺好的 讲的有深度 但是很快 需要认真听
190556,1161,胡兰青,2024-03-08 10:19:37,0,0,0,上课有时候值得一提但是还是自学比较好
438,1188,刘新国,2015-03-15 02:25:22,82,98,16,很棒的老师\n\n他上课的语气就像是给小朋友上，莫非是因为恰好有小宝宝，特别有趣\n\n很耐心回答问题
4218,1188,刘新国,2015-06-18 06:34:22,24,27,3,很好的老师，你一定要好好学
5832,1188,刘新国,2015-07-09 14:41:28,1,2,1,好老师
7301,1188,刘新国,2015-09-15 01:42:28,5,6,1,(๑•̀ㅂ•́)و✧
7967,1188,刘新国,2015-09-16 09:09:51,9,9,0,讲得很细，
9384,1188,刘新国,2015-10-25 13:33:06,18,19,1,很清晰，很耐心
11038,1188,刘新国,2015-11-24 03:20:17,1,9,8,不预习就等死吧
12044,1188,刘新国,2015-12-21 14:45:07,1,2,1,讲的快了点，但是讲的挺好的，老师人也不错
12120,1188,刘新国,2015-12-22 02:16:18,13,14,1,老师人很好，特别适合以前没什么基础的同学。
12123,1188,刘新国,2015-12-22 02:32:02,1,1,0,萌萌的老师，好说话，解答耐心
12794,1188,刘新国,2015-12-24 05:20:25,2,2,0,很棒的
14340,1188,刘新国,2016-01-06 12:08:13,1,1,0,(ง •̀_•́)ง
18445,1188,刘新国,2016-01-21 15:54:00,8,8,0,男神呀
19201,1188,刘新国,2016-01-23 13:19:24,1,1,0,还没出成绩，先打个高分
19378,1188,刘新国,2016-01-24 03:57:48,1,2,1,除了 好 我不知道还能用什么词来形容
21796,1188,刘新国,2016-03-01 06:28:05,1,1,0,很好的老师
21813,1188,刘新国,2016-03-01 07:11:45,1,1,0,真的是完美\n\n\n\n
22143,1188,刘新国,2016-03-02 13:51:07,1,1,0,非常好
22255,1188,刘新国,2016-03-03 06:16:55,1,2,1,挺棒的老师
30548,1188,刘新国,2016-07-02 02:14:45,22,24,2,先打个10分，希望大程有好结果。。。
31697,1188,刘新国,2016-07-04 13:54:43,1,1,0,耐心细致认真～虽然只有3.9不过我的确很喜欢他～
32081,1188,刘新国,2016-07-05 14:33:54,0,0,0,上课很细心，给分不错。
34976,1188,刘新国,2016-10-27 15:00:39,0,2,2,好亲切啊……
35974,1188,刘新国,2016-11-10 09:28:02,68,70,2,怎么办，觉得他好像张国荣。
36985,1188,刘新国,2016-11-17 02:55:27,1,1,0,
38916,1188,刘新国,2018-08-25 00:56:51,18,19,1,第一次有老师专门三节课复习哎！赞?
39328,1188,刘新国,2016-12-22 05:59:08,16,16,0,超级喜欢老师超级喜欢，人真的超级好，助教哥哥很帅很可爱，选上刘老师的课真的是一种幸运啊，大家珍惜
40042,1188,刘新国,2016-12-29 02:39:30,1,1,0,很耐心
41052,1188,刘新国,2017-01-09 00:53:24,7,7,0,老师真的很棒\n\n虽然有时候经常感觉自己要睡着了 但是老师讲的很好很认真 PPT也很好很有价值 期末还有专门的复习研讨 上机考顺便去问他问题 老师好温柔讲解也很详细 希望自己的程设也能拿高分
42793,1188,刘新国,2017-01-15 05:58:25,0,0,0,真心很好
44740,1188,刘新国,2017-01-18 07:45:08,1,1,0,上课有趣，耐心解答
44758,1188,刘新国,2017-01-18 08:11:42,0,0,0,很幽默风趣
44989,1188,刘新国,2017-01-18 17:45:30,2,4,2,很高兴拿到满意的成绩～老师讲的很好很实用，也很小白，对于新手入门来说实在是再好不过了，但是老师平时布置的都只有上机作业没有理论题，上机题也都很简单，期末之前请一定要买往年的题来刷呀。我第一次做的时候完全懵逼了感觉完全没学过这门课hhhh
45540,1188,刘新国,2017-01-19 16:58:05,0,0,0,虽然后来成绩不是很理想，但老师的的确确很棒！
48283,1188,刘新国,2017-03-02 02:05:04,2,2,0,老师教得非常棒，去问他问题也超热心。而且PPT在一众浙大老师中简直是一股清流（*/∇＼*）我程序设计基础和专题都是他的，基础满了，希望专题好好加油
51499,1188,刘新国,2017-06-16 03:29:39,5,7,2,......
56371,1188,刘新国,2019-09-02 01:57:43,8,13,5,有没有人可以给我留一个刘教授的电话 急需
58183,1188,刘新国,2017-08-16 13:49:16,4,5,1,感觉不是很适合自己吧.....大一上在刘老师的班里学C程感觉并不好，但他的ppt还是hin不错的
58880,1188,刘新国,2017-09-18 08:14:48,-1,1,2,感觉不错，轻松愉快
64257,1188,刘新国,2017-12-22 03:50:51,1,1,0,emmm讲课快地飞起 别人班指针还没学我们就开始学完全部开始研讨课了 不过人超帅又幽默（反正c都是自学嘛
65375,1188,刘新国,2018-01-03 12:22:11,1,2,1,老师讲课真的太快了，没基础的有点跟不上，作业少，不过人很好
65597,1188,刘新国,2018-01-07 02:12:05,8,8,0,打个10分希望自己能有好成绩\n\n
65666,1188,刘新国,2018-01-08 06:24:39,4,6,2,虽然大部分课都翘了，但是听了几节课感觉讲的很清楚，作业可以说非常少了，不错的老师。
68135,1188,刘新国,2018-01-22 15:38:03,5,5,0,刘新国老师真的超好，但是我没上过他的几节课，浪费了大好的老师的机会，平常的作业很少，期中考试考的是上机题，不像其他班都考的理论，很简单。不过还是为老师打call，人超级好的老师。
68995,1188,刘新国,2018-01-24 07:34:58,1,1,0,希望期末能有个还不错的成绩…………打了10分，老师很棒
69386,1188,刘新国,2018-01-24 14:51:58,0,0,0,老师超可爱的！无意识卖萌还能get到我们的笑点！作业不是很多但是资料很齐全！就是很好很好很好啦！！！
70292,1188,刘新国,2018-01-26 11:29:31,14,14,0,虽然前面讲的飞快，但是这是为了后面留下三节的研讨复习课，效果还是很好的，回答问题也很耐心，而且幻灯片详细，总体上是很不错的老师!(ps:一定要自己多做点理论题，因为老师平时作业基本都是实验上机题)
72599,1188,刘新国,2018-01-30 13:21:32,6,7,1,老师很可爱 教课像教小宝宝 \n\n超喜欢举例子的 各种栗子 不管恰不恰当 (´;︵;`)笑哭  \n\n给分应该挺好的吧 \n\n我以为我要挂了 结果还有3 我很感动
72614,1188,刘新国,2018-01-30 13:36:15,0,1,1,老师真的对小白很友好，点都讲的很细，虽然有时候莫名会快一点，但是感觉他是想尽力多讲点，可惜下学期不是他。。
72655,1188,刘新国,2018-01-30 16:07:26,0,0,0,老师很可爱，最后还会说段子，我没有预习，讲课也还行，不过课后一定要好好钻研书本，老师挺不错的！
74283,1188,刘新国,2018-02-09 04:38:52,-1,1,2,上课睡觉很安逸但是后座抖腿贼烦
74475,1188,刘新国,2018-02-27 11:30:38,0,0,0,敲可爱的老师，讲课也很好，稍认真点绝对有好结果。
74754,1188,刘新国,2018-03-05 13:17:00,1,2,1,简言之：人好，作业少，讲课超级快，期中无理论考，大佬带节奏(●—●)
75040,1188,刘新国,2018-03-07 06:15:16,3,4,1,很逗的一个老师，上课就像跟小朋友说话一样～当然给分也超级高，上他的课，要好好听.
76886,1188,刘新国,2018-04-25 09:02:45,3,3,0,什么东西都让我们回去仔细看
82502,1188,刘新国,2018-07-08 11:11:48,0,0,0,卡绩，难受
82503,1188,刘新国,2018-07-08 11:15:28,6,13,7,程设专题慎选
82595,1188,刘新国,2018-07-08 15:36:47,0,0,0,卡绩+1
88389,1188,刘新国,2018-10-30 04:02:23,-2,0,2,举个栗子
88588,1188,刘新国,2018-11-02 06:35:08,1,1,0,快乐。。。
92150,1188,刘新国,2018-12-26 16:18:38,1,1,0,讲课很认真
95654,1188,刘新国,2019-01-29 10:46:19,1,4,3,可爱的老师，满级开心
95938,1188,刘新国,2019-01-20 08:53:27,5,7,2,蛋炒饭和饭炒蛋?
97593,1188,刘新国,2019-01-22 11:46:34,1,1,0,老师非常好
99536,1188,刘新国,2019-01-25 02:22:50,3,4,1,老师很好
101166,1188,刘新国,2019-01-28 00:20:37,16,16,0,老师上课有趣，善于打比方，让你理解知识，尽管有些比方有些牵强。人也很细致，小程上机前多次提醒我们需要注意的事项。回答问题很耐心，人也平易近人，男神！！！不过前面上课好快，拉别的班好多，最后会留下三节课用来复习，遗憾的是，我们用三节课大部分都在复习二级指针，可是，最后老师发现，二级指针今年不考，他当场就愣住了……总之，他是个很可爱的好老师！！！
101845,1188,刘新国,2019-01-29 09:05:36,4,7,3,成绩不理想，还是自己平时不够认真。不过老师真的太好辣！！！老师对小白很友好，会给你讲很基础的东西，很生动，而且作业真的少。但毕竟课堂时间有限，不可能面面俱到，有些东西也需要课后自己了解，c还是需要自己平时多多努力啊。笔芯
109602,1188,刘新国,2019-06-25 10:54:46,5,6,1,大概是计院最好的老师了吧我觉得，群里任何疑问都是秒回，考前夸老师，求保佑
109908,1188,刘新国,2019-06-20 06:15:59,0,0,0,？？？
111150,1188,刘新国,2019-06-30 05:51:10,3,3,0,10分求过\n\n
111830,1188,刘新国,2019-07-03 00:33:24,4,4,0,大程，老师上课还行，可以听听。小组作业队友实力坑人，最后平时扣了5分，不是太清楚是哪里做的如此差。忠告各位不要随便找队友，会死的很难看
111867,1188,刘新国,2019-07-03 01:37:39,1,7,6,老师讲课超棒，十分风趣幽默，上课氛围也很活跃，能收获很多知识（绝对不会犯困）。平时答疑认真负责，完成大作业过程中一直耐心指导，考试前还专门安排复习作业。最后给分巨好！！！应该是给调分的，不然按照期末的成绩应该到不了这么高绩点555，强推！！！
111875,1188,刘新国,2019-07-03 01:47:15,0,1,1,感觉老师给分还是。很客观的。很真实。
111880,1188,刘新国,2019-07-03 01:51:41,0,2,2,老师很强 但是这门课大作业和平时上课完全没有关系 期末考试难度较大而且没有调分
111882,1188,刘新国,2019-07-03 01:52:54,1,1,0,唉唉唉\n\n（为什么要至少三个字）
111914,1188,刘新国,2019-07-03 02:36:44,1,1,0,老师很好，怪自己编程天赋不够
111976,1188,刘新国,2019-07-03 05:17:02,1,1,0,老师给我过了c大程 浓浓师生情！！！！！ 感恩的心感谢有你
112638,1188,刘新国,2019-07-04 23:22:38,1,2,1,为学生着想的老师，期末复习题，重复开了几遍让不同时间段有时间的同学做，感动得一匹。
114442,1188,刘新国,2019-07-10 03:07:34,0,2,2,老师幽默风趣，讲课很有意思，就是自己编程水平不好，感觉期末卷子太难很多同学分数不高，结果真的没有调分。哭了? 。还好没挂。还是很喜欢老师！
123004,1188,刘新国,2020-04-29 09:45:36,2,2,0,老师很好，水平很高，耐心答疑，给分厚道。
123041,1188,刘新国,2020-05-04 11:12:40,4,4,0,刘老师是一位真正的强者，选上他的C程真的是荣幸。老师虽然讲的很快，但条理清晰，人也非常nice。这次大程有幸听建江先生的课，建江先生把我以前在刘老师课上学过并且基本搞懂的指针数组这种东西重新讲糊涂了qwq，才真正感受到刘老师的过人之处，选上刘老师的课的同学一定要好好珍惜！！
123960,1188,刘新国,2020-06-17 17:00:14,4,4,0,老师超级好，讲课很有耐心，干货满满，考前专门抽三节课复习，因为调课没上成的课自己抽时间给我们补，平时分也给得很厚道。就是C程授课进度稍微有点快，PPT下载下来多复习就ok啦。
126195,1188,刘新国,2020-09-19 04:57:17,2,4,2,老师上课比较仔细，但可能是因为线上上课吧，上课的时候总有种准备不足的感觉，给分非常非常求是，完全没调分，想要高分的同学注意规避
129590,1188,刘新国,2021-01-08 05:00:59,8,9,1,刘新国老师真的特别好，我是补选上的，当时很多人申请，补选申请全部都给通过了，老师还会特别仔细地回答问题
130262,1188,刘新国,2021-01-20 10:14:02,10,11,1,考完c小程来打分，10分求过||这是评价：老师上课非常认真，讲课既讲述原理，也能从实际操作的角度给出应用实例和可能出错的情况；讲课节奏安排的很好，对于各内容也是面面俱到。
133513,1188,刘新国,2021-03-01 11:57:56,-1,3,4,老师的程序设计专题要上机课必须去机房吗
136367,1188,刘新国,2021-06-17 03:54:43,9,10,1,水平很高，讲得挺好，给分nice.不过大概是C大程这门课的问题吧😂希望能在如何协作进行大程开发上多给一些指导……
136642,1188,刘新国,2021-06-22 10:46:37,3,4,1,C大程崩了qwq\n\n对不起刘老师呜呜呜呜呜
138405,1188,刘新国,2021-07-09 03:04:12,0,1,1,老师讲的好
139299,1188,刘新国,2021-07-14 06:20:07,7,9,2,c大程任务多，讲课好，给分好，没有互评机制，很推荐
151361,1188,刘新国,2022-03-01 11:01:29,-2,2,4,太帅了，太温柔了，好爱举例，好可爱😊
151702,1188,刘新国,2022-03-13 01:14:37,4,7,3,老师很牛逼，但C大作业很顶（吐血）
153279,1188,刘新国,2022-04-27 11:09:05,1,3,2,为啥我觉得刘老师有点像魏晨哦
154016,1188,刘新国,2022-05-19 06:52:04,-3,3,6,上了其他老师的c大程才知道刘老师的好。
155036,1188,刘新国,2022-06-07 16:12:59,-12,2,14,刘老师的讲课水平是全浙大讲C的老师里第一流的，大程的要求比较高，验收的时候会严格的抠代码，但这也是检验我们学习成功的一种体现。
155063,1188,刘新国,2022-06-08 03:40:48,2,4,2,懂得都懂
155064,1188,刘新国,2022-06-08 03:44:42,2,5,3,懂得都懂
156597,1188,刘新国,2022-06-20 11:17:14,1,6,5,老师值得打十分\n\n但这门课本身如其他人所说，问题很大，完全是在堆代码，很浪费时间，而且有明显的两极分化问题
165463,1188,刘新国,2023-01-06 12:19:39,0,2,2,刘新国大帅哥！！！我爱你
166988,1188,刘新国,2023-01-14 13:18:01,2,3,1,10分。我上的是c小。老师讲得真的很好，他和我们说他的ppt是没有直接用去年的，而是自己新做的！在群里提问也会得到及时细致的解答，我们群里有大佬经常帮忙答疑，老师在上课的时候特意提到了并向那些同学表示感谢。我的绩点不怎么样单纯是因为我摆得太彻底了，老师的给分标准很明确，应该没有什么调分的空间。刘老师的课上，第一排总是坐满的！我有一次走错教室就是凭着这个特点发现自己走错了的。
167069,1188,刘新国,2023-01-15 01:14:46,3,3,0,十分十分
167077,1188,刘新国,2023-01-15 01:58:25,-3,3,6,真心好老师，期末好好考，分数不会低，我平时有一次小测考的不好，班级中游，有几次作业也错了不少，但是期末好好考，最后93，4.8真心不错，还有刘老师的PPT，非常好，有很多拓展，建议如果选刘老师的课，一定要先预习书本，把本节课要讲的书本看一遍之后再听课，效果非常好，推荐！感谢刘老师！
167104,1188,刘新国,2023-01-15 03:35:18,1,3,2,老师讲课真的很好 给分就很求是 菜鸡慎选吧 但是可以听他的课和用ppt补天
168835,1188,刘新国,2023-02-22 14:28:17,3,4,1,老师的ppt做得不错，非常详细
170556,1188,刘新国,2023-03-06 11:52:17,-21,13,34,傻篮子东西，纯纯的初生 我草你亲妈\n\n上课啥也不讲 啥玩意都回去自己看 要你干啥飞舞玩意\n\n作业倒是没少留 怎么恬这个b脸的
171740,1188,刘新国,2023-04-03 15:08:24,-3,0,3,差评 事怎么这么多
171846,1188,刘新国,2023-04-07 14:12:57,2,3,1,要求比较严格。
172092,1188,刘新国,2023-04-19 07:22:46,3,9,6,要求怎么那么高 没见别的任何一个老师事这么多
173880,1188,刘新国,2023-06-06 11:12:07,1,4,3,大程验收被疯狂挑刺，认死理，故意为难学生，特别难沟通。
174150,1188,刘新国,2023-06-06 16:03:13,1,1,0,事情很多，大程要求也很严格
174966,1188,刘新国,2023-06-20 12:55:42,4,8,4,不理解为什么分这么高\n\n这个老师真的很苛刻吧
175369,1188,刘新国,2023-06-24 09:11:08,2,2,0,C大：\n\n上课风格同前面评论，十分友好。口音有意思。ppt非常详细。\n\n大程苛刻，即使完成了全部要求，也会被倒扣十多分。老师解释是要给做了更多额外功能的同学预留一些分数。\n\n总评给分比想象中稍好。\n\nlxg好老师，可以蹭他的课，不过不建议来他的班。很多CS同学预制的就是lxg的C大，竞争会比较激烈。
175388,1188,刘新国,2023-06-24 12:38:41,1,1,0,超棒的老师，强烈推荐老师的程序设计，当然自己回去也要认真学 不然也是白费 老师收作业的时间有点早，但是可以补交 ，用心做分数不会太差而且还可以学到东西。
175708,1188,刘新国,2023-06-26 09:09:44,3,3,0,讲课好，但给分求是，一分不捞，对于有问题的互评也不认真处理。\n\n可以算是一个好老师，但不近人情要求严格。可能是班里CS佬太多了，很卷
175923,1188,刘新国,2023-06-27 06:58:32,0,2,2,老师真的人太好了，我的天哪，我怎么可以遇见这么好的老师。上课非常有趣，偶尔开开玩笑，挺幽默的其实。ppt也很清晰。老师人很负责的！我们小组做大作业有点坎坷，老师也都表示理解，我真的哭死。太感动了好吗。
176614,1188,刘新国,2023-06-29 12:38:26,0,3,3,C大，听说以后就没有了，但老师很好，上课很清晰，CAD实验室的教授，感觉很厉害，话说教师主页上的照片真滴好年轻
184316,1188,刘新国,2023-12-17 02:23:04,0,1,1,老师讲的很好，但是考试有点难，没基础的uu们悠着点。emmm…10分求过。不知道调不调分，但讲课是不错的。
184883,1188,刘新国,2023-12-24 03:16:09,3,4,1,讲课不清楚，答疑没耐心，B站翁恺，我的C语言老师，作业不能补交，认死理，难沟通，他应该很厉害但是真的讲不出来，口头禅：要我一节课给你讲清楚是不可能的。
184943,1188,刘新国,2023-12-24 14:19:21,4,4,0,感觉一般，明明是他讲的太快，还非说我们没有工科思维。平时上课光念ppt，讲的一点不细，不好好讲重难点，光讲一些没用的。下了课作业一道不会。
185671,1188,刘新国,2024-01-03 11:50:13,0,1,1,刘老师讲课讲的很清楚，答疑也很认真，而且莫名可爱哈哈
186089,1188,刘新国,2024-01-08 08:41:08,0,1,1,作业不能补交，作业布置了又一点通知不发，怎么说都没用
187297,1188,刘新国,2024-01-15 12:12:16,1,1,0,求过求过。。。明天上午最后一门期末考试了
188733,1188,刘新国,2024-01-19 17:43:36,0,0,0,老师挺好的。是我太菜了
188774,1188,刘新国,2024-01-20 02:15:03,0,1,1,海底捞，上课好，爱死
189772,1188,刘新国,2024-01-28 14:27:25,0,1,1,C程序设计基础及实验，出分了过来评价。这门课还是适合有编程基础的同学来上，会很轻松。老师上课讲的挺细的，逻辑清晰重点突出，比较认真负责，周一上课喜欢穿粉色衬衫（bushi）。唯一缺点就是答疑遇到若智问题会不耐烦。给分应该还行，或许老师小捞一把，刚好满了，哭了，特此前来10分感谢老师！！！老师您是我的神！！
190315,1188,刘新国,2024-02-28 02:38:40,2,5,3,可能讲得还行，但我是真的不喜欢\n\n对不怎么高级的问题太苛刻了，基础一般的人问问题八成要被说，但怎么可能人人水平高？？？\n\n如果不是后来还上了cjh的课，我的信心几乎要被弄没的
192921,1188,刘新国,2024-05-31 14:29:36,1,2,1,老师捞我一把！本来以为要挂都做好退院准备了，竟然被捞起来了啊啊啊！感恩！虽然这一门课直接把均绩干低了0.5，但是没挂就行。平时作业真的不会写。。。老师讲的我也听不懂，最后期末编程题只写出来第一道，本人实在是没有一点逻辑思维啊，但是老师确实是个好老师。只是不明白我学生物的为什么要学编程，上学期不知道应为这一门崩溃了多少次。。。。
198721,1188,刘新国,2024-09-11 06:08:01,0,0,0,感谢捞我
199015,1188,刘新国,2024-09-14 03:38:00,0,0,0,讲课很有意思，对同学也很耐心.前几节课有点煎熬，后面就好了
199408,1188,刘新国,2024-09-23 04:13:23,0,1,1,好老师，上课好，先打个10之后看看结果。
199960,1188,刘新国,2024-10-09 13:26:49,-3,3,6,我室友问问题时他回应太过敷衍粗鲁，我想知道谁在给十分（但是话说回来我觉得还行，因为我不问问题）
200389,1188,刘新国,2024-10-16 13:06:05,10,11,1,老师人不错，对通义千问有迷之执着
203222,1188,刘新国,2024-11-18 06:49:40,0,1,1,好可爱的老师，会在群里一本正经地回答大家的问题，还会拓展一下（虽然我不怎么看）并且每次上机课都亲自到场！
205750,1188,刘新国,2024-12-12 02:10:04,6,7,1,C语言程序设计：上课用的是自己做的ppt，内容很干练适合拿来预习和复习，上课讲的挺细的脾气也好，会拉一个答疑群一个个回答学生的问题（助教疑似失踪了导致答疑压力给到了老师身上，确实是很负责任的老师），期中前给写了个好几页pdf考点总结，几乎每节课雷达点名，老师原话是只是希望大家可以到现场来听课，实在就不想听课的人也可以签到之后跑路，总体我给10分，作为一个天津考过来的学生我在上课之前对编程了解为0，但是只要好好跟着上课复习，期中包括平时作业成绩可以排进前10%甚至前5%，总之就是无论底子如何，上完他的课都能到达一个很好的成绩。
208902,1188,刘新国,2025-01-12 06:58:45,2,3,1,出分真 tmd 慢
209859,1188,刘新国,2025-01-07 09:08:08,3,3,0,老师课是上的很好的，作业是很多的，没基础的同学听得是吃力的，现在还无法知道我有没有挂掉是可恶的，祈祷不要挂掉🙏
210124,1188,刘新国,2025-01-08 07:54:15,2,2,0,求放过
210819,1188,刘新国,2025-01-10 04:27:37,4,4,0,老师几乎每节课课间雷达点名，没签上可以在下个课间拿校卡找老师补签，实验课不出意外（没错指某次小测）也会每节课亲自来，以至于上了一学期不知道助教长什么样\n\n上课速度适中，ppt非常适合课后查漏补缺\n\n作业答疑也很负责，srds老师似乎不太喜欢一些白痴问题，经常推荐通义千问\n\n总之lxg我男神！！
210877,1188,刘新国,2025-01-10 05:50:46,1,1,0,老师很好，打10分（）就是卡绩了T_T
211893,1188,刘新国,2025-01-13 01:19:42,2,3,1,不怎么捞，老师很负责，机房课答案全是亲自上场，全票打飞助教，完全不回复问题，从来没有见过助教，全靠老师自己回答，点赞点赞
212213,1188,刘新国,2025-01-13 11:51:57,-3,0,3,口齿不清
212392,1188,刘新国,2025-01-14 02:53:16,1,1,0,偶尔会点名，课间可以补签。认真听老师讲的还是很好的，一点基础都没有也可以学会。作业也比较少，难度不大但是效果很好，推荐
212489,1188,刘新国,2025-01-14 05:33:34,1,1,0,老师讲课讲的非常好！很细心，很负责的答疑，老师对待上课也很认真，签到也很认真！零基础，差点以为我要挂了，本来以为被斩杀了，但是没想到最后出来成绩被捞了！虽然说学的不是很好，但是确实学到了很多东西，也算是真正入门了吧。
212676,1188,刘新国,2025-01-14 12:22:54,0,0,0,炒鸡捞！
212714,1188,刘新国,2025-01-14 14:21:01,0,0,0,good
215042,1188,刘新国,2025-02-20 08:45:17,1,1,0,老师很好，有答疑群，细心回答每一个同学的问题
14853,1207,张宏鑫,2016-01-10 06:56:59,3,8,5,挺负责一个老师
34555,1207,张宏鑫,2016-10-13 10:33:10,0,3,3,班主任，很可爱( ⸝⸝⸝⁼̴́⌄⁼̴̀⸝⸝⸝)
37334,1207,张宏鑫,2016-11-18 10:39:29,1,4,3,挺好的老师
60871,1207,张宏鑫,2017-10-31 23:25:18,1,3,2,好烦啊
63671,1207,张宏鑫,2017-12-12 08:21:18,2,4,2,图形学作业量是whz十倍。。。老师人还挺好的
63895,1207,张宏鑫,2017-12-19 00:47:12,4,4,0,不评论上的怎么样\n\n作业比起别人没有减少，实验课必上且验收报告一个不少，建议慎重
66407,1207,张宏鑫,2018-01-16 06:08:09,0,2,2,先给老师10分，但是作业好多
66742,1207,张宏鑫,2018-01-18 16:00:38,1,3,2,老师是好老师，但是助教，emm...
69659,1207,张宏鑫,2018-01-25 07:20:37,17,23,6,老师真的很棒！天真热爱，让人如沐春风。然而助教一泡尿浇灭了我的热情。。。
69944,1207,张宏鑫,2018-01-25 21:43:58,7,9,2,讲课很认真，但是作业太多，仿佛一个学期只需要上这一门课，最后给分也不太好。其他课多的话不建议选。
87559,1207,张宏鑫,2018-10-05 11:31:02,0,1,1,作业有点多，比较烦。其他的还好。
92493,1207,张宏鑫,2018-12-31 09:25:16,12,13,1,2学分的dam，1个短学期，6个小作业，1个大作业。学这个b课肝都要炸了。上课内容和作业基本没什么关系，最后还要强行考试。疯狂鼓励恶竞呵呵呵，最后给分迷得不行？我们组比别人差哪了？辛辛苦苦自己撸前端撸后端撸数据库撸css还比不过别人直接套模板的嘛？吃力不讨好？学nm呢
92499,1207,张宏鑫,2018-12-31 11:44:48,14,15,1,辣鸡课真的垃圾，作业和上课一点关系都没有，期末作业大程大家辛辛苦苦肝了很久，实现了他ppt上的bonus加分项，结果一句大家都实现了就不给分了，只有所谓的基础分？真的恶心，要看明细也不给看，莫名其妙，完全不知道自己扣分被扣在哪，助教还给卡绩点。而且作业延到12月份，给你在年底的最后一天出分，刺不刺激，惊不惊喜，意不意外？忘了说了，这门课叫  数字媒体资源管理。
102860,1207,张宏鑫,2019-02-24 11:39:28,0,0,0,助教。。。把他揪出来。
122366,1207,张宏鑫,2020-02-25 14:15:52,0,1,1,老师的github: https://github.com/hongxin
122911,1207,张宏鑫,2020-04-20 05:22:40,0,1,1,计算机应用数学课，讲课挺用心的，就是作业稍微多了点，要自己写代码实现二次规划之类的算法，最后还有个小论文
133342,1207,张宏鑫,2021-02-26 03:41:46,0,1,1,老师讲课很好，很有趣，确实是热爱图形学这一领域。作业略多不过完全可以做得来。没考试。不过老师有时候稍微有点拖延。。。
145266,1207,张宏鑫,2021-12-28 14:43:28,1,3,2,图形学作业比别的班多了不知道多少，真的就是2.5学分的课上出了10学分课都不一定有的作业量\n\n总之作业太多，跑就完事了
150409,1207,张宏鑫,2022-01-24 15:26:18,3,3,0,拖堂 作业拖到寒假才交，占用寒假很多时间，体验很糟糕
150676,1207,张宏鑫,2022-02-11 16:45:08,1,1,0,感觉给分不怎么好
150678,1207,张宏鑫,2022-02-12 01:59:32,2,2,0,平时作业和大作业挺有意思，课讲的马马虎虎，给分不太好
162066,1207,张宏鑫,2022-11-16 11:47:24,0,0,0,给分一般
186191,1207,张宏鑫,2024-01-09 09:52:50,0,0,0,666
190079,1207,张宏鑫,2024-02-19 10:20:37,1,1,0,特别特别热爱自己的专业领域也能讲清楚，给分略显一般
214531,1207,张宏鑫,2025-02-11 09:28:42,0,0,0,2024-2025秋冬，给分相当慷慨，课上无点名，会随机找同学起来回答问题，回答不上也无所谓，存在互动，感觉实验课今年是不用去的，会有钉钉直播，但是听说今年图形学其他班级给分也很好，可能课程组统一商量过了
214538,1207,张宏鑫,2025-02-11 14:42:54,0,0,0,计算机前沿技术讲座。这两天才出分。印象中老师说他这两天才接手这门课，所以不排除授课情况和给分形式过一段时间会发生改变的情况。讲座课理所当然地比较水，无论是老师自己讲的还是请的其他老师讲的都太浅，也不乏有上课依赖播放影视片段来讲解概念者，所以没什么必要听。点名只有数字点名，按照张老师的说法，这门课是容许同学们线上听课的，所以比较松。期末论文比较简单，按照老师的意思，参考的文献侧重中文综述即可，截止时间今年延到期末考试之后了。给分相当好，不过鉴于这门课就一学分，琢磨给分也没啥必要，平时记得签到和做学在浙大上随便写两句就行的作业，期末别忘记交论文一般就挂不了。
27698,1229,王灿,2016-06-27 08:43:21,27,28,1,ACM挺好的老师
28862,1229,王灿,2016-06-29 01:03:12,18,18,0,挺和善可爱的老师
48600,1229,王灿,2017-03-08 06:02:35,3,5,2,很好哦
55613,1229,王灿,2017-07-02 05:02:29,12,13,1,老师讲的还不错，只是ADS是真的太难了
56525,1229,王灿,2017-07-04 02:43:32,14,14,0,很帅声音很有磁性的老师，水平很高，温文尔雅。
57201,1229,王灿,2017-07-06 04:38:20,11,11,0,很稳的老师
59992,1229,王灿,2017-09-30 04:00:51,3,4,1,超棒！
75454,1229,王灿,2018-03-12 05:17:03,4,5,1,ads好
81088,1229,王灿,2019-06-28 12:13:04,-51,3,54,老师每节课开头总讲些无关的背景知识，课上的还好，自己课下多看，建议这门课选姥姥的，助教就是来搞笑的，人不行
84374,1229,王灿,2018-07-12 16:07:53,-6,2,8,平时分没给满分....为什么.......花了怎么多时间.................\n\n
84510,1229,王灿,2018-07-13 04:27:36,1,3,2,其实还挺好的
84515,1229,王灿,2018-07-13 04:43:53,-6,3,9,给分巨差，平时分迷的不行
116769,1229,王灿,2019-09-15 12:15:37,3,4,1,人超级好
122771,1229,王灿,2020-04-02 03:54:57,2,5,3,讲课非常清晰，有实力，耐心且用心。（在群里和大家一起膜助教也太可爱了！
124739,1229,王灿,2020-07-07 14:00:26,0,0,0,讲课挺清晰的
126184,1229,王灿,2020-09-18 13:20:59,0,0,0,非常好
139216,1229,王灿,2021-07-13 09:44:09,0,1,1,老师太好了，讲课非常清楚！帅气优秀的好老师，给分很好，把我室友都捞上来了！
139217,1229,王灿,2021-07-13 09:44:47,3,3,0,王灿老师讲课思路很清楚，也很有趣，唯一不足的就是声音比较波澜不惊（容易睡着），然后给分超级好（来自一个被老师疯狂捞的菜鸡）
140809,1229,王灿,2021-09-16 08:58:46,1,1,0,好老师！
142901,1229,王灿,2021-11-17 08:08:25,0,0,0,非常好的老师~
146324,1229,王灿,2022-01-06 08:20:47,1,1,0,老师人很好，并且给分非常好。
158791,1229,王灿,2022-07-02 08:27:58,9,10,1,先占个坑\n\n继续等老师出分ing
161304,1229,王灿,2022-11-17 08:09:42,5,6,1,研究生课程：数据挖掘\n\n线上体验巨差，期末周看回放体验巨差，原因可能是老师使用话筒的问题，导致智云课堂的音频音量巨小而且时断时续，根本听不了\n\n\n\n老师上课不点名，考试是闭卷考试，最后一节课老师会划范围，照着复习3天可以应付考试。同时还有一个5000字的数据挖掘领域研究报告，需要阅读5-10篇顶会或顶刊论文。
178565,1229,王灿,2023-07-14 15:17:33,2,2,0,老师学术水平很高，带acm队的，温文尔雅，太温柔了！！可惜就是上课语音语调太过平淡，ads后半段基本上听不进去，都是课后看姥姥b站或者毛哥智云。最后给分还算正常。
183952,1229,王灿,2023-12-04 16:39:38,5,6,1,ACM短学期，确实是大佬云集，如果没有高中能在浙江省至少拿省一的水平会很难受，基本上就成绩会垫底，绩点也会很不好看；如果很强的话自然没有什么问题，纯纯砍瓜切菜。选短学期的同学需要慎重，思考一下自己的实力再来选择
196588,1229,王灿,2024-07-04 06:40:43,0,2,2,给分比较求是
198188,1229,王灿,2024-09-04 04:07:34,4,4,0,如果你只是一般人（弱省省队，没有复健），不建议报acm短学期的课程，给分和其他短学期完全不能比\n\n\n\n如果是acm短学期的，要考虑一下自己有没有进队的水平，没有就赶紧跑，可以参加选拔但是不要报短学期课。\n\n\n\n平常考试大概是提高+往上走的，一场考试基本写一题，偶尔爆种写两道题，排名基本上都是很靠后的，而且acm不能拿部分分还有一堆罚时。\n\n\n\n虽然说出题验题可能能有加分项，但是出题也基本上选那几个比较厉害的人出的题，验题基本上也只能验一下常规题。\n\n\n\n总结，不建议报短学期，对自己实力自信的可以参加选拔，但是不建议报短学期
208167,1229,王灿,2024-12-26 04:46:24,0,0,0,不点名，很慈祥
210373,1229,王灿,2025-01-09 04:14:06,0,0,0,感谢灿哥，就做了两个bonus，还忘记互评了几次，平时分几乎给满了
210591,1229,王灿,2025-01-09 11:42:32,0,0,0,讲课水平应该算中规中矩，上课基本没听全靠自己补天没什么资格评价。\n\n有互评（听说隔壁有些班没有所以专门提一嘴），project除了一头一尾都还算好做，这学期的题目和前面比起来没啥变化（所以可以参考前人）。\n\n给分应该是比较求是，算了一下平时分没满，估计是半期太拉跨了导致bonus都救不回来
8381,1245,张国川,2015-09-20 14:05:34,4,4,0,张老师认真负责，计算机学院不多的几个好老师，上课很认真，很投入。
19385,1245,张国川,2016-01-24 04:30:33,3,3,0,点个赞
21308,1245,张国川,2016-02-28 03:31:34,27,32,5,怒赞，把本应是最枯燥最难的一部分数学知识讲的真的很有趣，张老师是我见过的上课最好的老师。
21491,1245,张国川,2016-02-29 04:48:03,1,2,1,非常好
22587,1245,张国川,2016-03-08 08:05:11,7,9,2,一句话：进大学以来听的最有意思的一门课，ads
32422,1245,张国川,2016-07-06 16:06:04,3,3,0,废话有点多，但是真心是为学生好的老师
32946,1245,张国川,2016-08-15 02:30:52,1,1,0,说真的有点像韩磊
53735,1245,张国川,2017-06-27 12:24:48,2,2,0,哈哈哈
55729,1245,张国川,2017-07-02 09:44:24,6,8,2,人好，风趣，讲法更偏数学而非编程\n\n不过期末出题实在是够难的。。
86939,1245,张国川,2018-09-19 12:29:36,0,1,1,用最简洁的方式讲最难的道理
98938,1245,张国川,2019-01-24 05:25:46,5,5,0,运筹学来答\n\n一学期上下来真是受益匪浅，学到了不少知识，老师讲得很认真。而且任务量适中，给分也好，不可多得的好课！
99321,1245,张国川,2019-01-24 14:50:45,0,0,0,复杂性好课！给分好
103074,1245,张国川,2019-02-26 01:49:43,0,0,0,老师ads好不好啊
114562,1245,张国川,2019-07-10 16:59:01,2,2,0,趁出分前来评论一波。\n\n老师人贼好，会记住大家的名字开开玩笑，讲课也好没有让我想睡觉，就是做presentation关于算法方面可能会比较严格要求。另外吐槽一下ads期末太tm难了。。。
123762,1245,张国川,2020-06-14 01:56:55,0,0,0,很好。
126504,1245,张国川,2020-09-28 15:56:03,5,6,1,可能是大学以来最欣赏的老师了，虽然有时候有些偏激，但真是一位很有傲气，真性情的老师了，比较爱惜羽毛。\n\n虽然我个人因为实验原因课程绩点不理想，但依然很感激一个学期的教导，让我难得地对科研燃起了一些兴趣。
131249,1245,张国川,2021-01-26 23:35:57,1,1,0,看到成绩，宠辱不惊。
132579,1245,张国川,2021-02-02 12:11:45,1,1,0,aor 是真的难 老师也是真的好
132867,1245,张国川,2021-02-04 08:34:42,1,3,2,老师讲的很好，人也挺有趣，就是运筹学难度挺大的，相比之下ads都是小意思
139384,1245,张国川,2021-07-15 03:34:37,9,13,4,张老师真的是计院之光。讲课易懂，体谅学生，给分又好
146771,1245,张国川,2022-01-07 11:53:11,9,11,2,大题小问一把抓，有应有答笔生花；\n\n卧虎藏龙山林静，喧闹井中只有蛙。
147195,1245,张国川,2022-01-09 05:08:24,-1,3,4,jishaa
149766,1245,张国川,2022-01-16 23:20:42,4,4,0,计院之光，浙大之光，最好的计算机老师之一
165562,1245,张国川,2023-01-08 10:12:07,5,5,0,运筹学，好课，好老师，好难
169504,1245,张国川,2023-02-26 13:41:29,11,12,1,运筹学出分来评价：10分给老师，10分给助教，所以最后只有80分作为我的总评（悲）
170156,1245,张国川,2023-03-01 15:13:20,0,0,0,给分蛮好的
172351,1245,张国川,2023-04-25 09:02:28,4,5,1,ads期中恶心人，平时作业又多又难
172378,1245,张国川,2023-05-12 04:21:25,8,9,1,ADS，\n\n老师讲的挺好的，就是真的挺快的，经常跟不上。\n\n\n\n最想让人吐槽的就是助教了。\n\n把平时作业搞的和其他班差的很多，非常难非常多而且不是一个类型。\n\n别的班平时客观题就两三道选择，这边又是判断又是单选又是多选真是做麻了。\n\n可以说花在这客观题上的时间要比别的班乘以3吧至少。\n\n\n\n而且最主要的是我就想问你把期中考试出这么难真的对我们公平吗？\n\n如果期末大家都是一套试卷，你自己这个班这么期中考试还有什么意义？\n\n大家分都低，最后不都会用期末覆盖掉期中？\n\n平时相比别的班硬核这么多就算了，考试也这么搞。\n\n最后就变成了，平时你花了比别人多很多的时间，会的掌握的更深，但你的分却比别人低很多，真的感觉很不爽。\n\n\n\n最后最后感觉老师唯一的一个槽点就是，总是倾向于和助教沟通，而不问我们的感受，所以或许老师并没有特别了解到我们的学习情况，或许觉得我们挺快乐的（？）\n\n另外还要夸一夸每节课的定场诗，还是挺有意思的！
173579,1245,张国川,2023-05-29 09:44:37,2,6,4,张国川真的神吧，蹭了他一学期的ads
185634,1245,张国川,2024-01-03 06:52:07,5,6,1,计院唯一神课，运筹学。\n\n就是期末太难了，希望老师能捞捞55555555555
206202,1245,张国川,2024-12-13 08:17:43,3,3,0,ADS，我觉得神中神
207522,1245,张国川,2025-01-03 15:21:23,1,1,0,永远的神！！！
208066,1245,张国川,2024-12-25 12:05:48,2,2,0,AOR真计院第一神课，除了我太菜没有缺点
208540,1245,张国川,2024-12-29 06:22:57,2,2,0,ADS神
209589,1245,张国川,2025-01-06 10:11:03,3,3,0,ads唯一真神，神级讲课bonus巨捞
209878,1245,张国川,2025-01-07 10:02:06,4,5,1,主观来讲，今年的助教和老师都是我以往上过的所有课中的最佳老师助教，张老师真的值得计院之光的名头，不仅体现在讲课，还体现在待人待物，期末考后他认为出的题不太好，没有体现“教”的作用，要回去反思。期末考完群里全是谢谢老师，助教在期末前会开不计分pta练习，基本都是历年题，而且project也没有互评，算得上是任务始终体验最好的ADS老师了
209907,1245,张国川,2025-01-07 11:21:25,5,5,0,张老师无论是在教学水平上还是在为人师表上都无愧“计院之光”的称号。\n\n\n\nADS 这一门课本身是具有难度的，因为它涉及的方面比较广泛。虽然它在每一方面都只是近乎蜻蜓点水的介绍，张老师的分享与展示算法的魅力一定能引起你的兴趣。老师上课会穿插许多风雅的段子，一些人生的阅历，但最终又能转换为问题的引导。在笔者上过为数不多的计院老师的课中，张老师的课堂是纯粹的享受。张老师也是见过为数不多的堪称“纯粹”的老师，你可以感受到老师的傲气，更可以感受到老师对于自己领域的热爱与深刻的见解，可以看见老师的风骨。\n\n\n\n笔者真想回到秋冬的西教里，在嬉笑怒骂中和张老师一起去听，去感悟，去探索，去发现。在这个教室里，只有传道，授业，解惑而已。
209942,1245,张国川,2025-01-07 13:37:48,1,1,0,张国川老师的教学，尤其是算法部分非常的深入和严谨，算法分析的思路都会有详细的证明和推导，很有启发性。鉴于ADS的课程难度和考核难度都很大，课上如果和老师脱节的话，整节课的学习效率会不佳，所以课后及时的智云课堂是十分必要的。老师的给分也很善良。\n\n最后，谢谢老师的精彩的课堂讲解！
212670,1245,张国川,2025-01-14 12:04:10,1,1,0,aor，非常nb的课，非常nb的老师，深入浅出，娓娓道来，大学以来我唯一能认真听完三节课的一门课。可惜我好像自以为学会了，最后84
212701,1245,张国川,2025-01-14 13:45:14,-2,1,3,绩杀杀杀杀杀杀杀杀，当时为什么要被3.5的学分所吸引，上课难，作业难，考试难，如果不怕时间多给分低，辣么，大胆的选吧
66293,1251,宋宏伟,2018-01-15 02:30:23,0,0,0,不好啊
11564,1263,黄劲,2015-12-05 17:57:43,30,31,1,牛人老师
12866,1263,黄劲,2015-12-24 07:04:30,21,21,0,很喜欢他的上课风格   大概是因为做几何的  讲课都会融会贯通起来   很形象(前提是认真听都跟上了)
18254,1263,黄劲,2016-01-21 10:35:01,16,18,2,讲课的时候会额外讲一些有趣的东西，也很喜欢跟学生交流，私底下聊的时候也是挺有趣的一个老师。
22652,1263,黄劲,2016-03-09 06:56:06,12,13,1,好老师，能学会很多真正对学习有用的东西
24325,1263,黄劲,2016-04-29 11:50:04,15,15,0,老师学术水平比较高
25247,1263,黄劲,2016-05-09 02:08:05,11,11,0,能学到一些和能力有关的东西
31979,1263,黄劲,2016-07-05 10:18:35,5,5,0,良心老师，不仅传授知识，而且传授人生的经验
56625,1263,黄劲,2017-07-04 06:05:25,5,6,1,太牛逼了\n\n传奇人生
57018,1263,黄劲,2017-07-05 07:31:20,4,5,1,以前都说老师教的好，但是最后成绩不理想，学了发现，这门课不仅可以学到很多知识，老师给分也好良心
57588,1263,黄劲,2017-07-10 07:45:54,7,8,1,课很生动 老师也很有意思 很喜欢和学生交流 能学到很多东西 给分也不错（如果认真学了的话）（虽然老师不收作业但是作业不能攒着不写要不期末会挂
76610,1263,黄劲,2018-04-16 06:56:49,1,2,1,今天才知道不写作业期末会挂到底是什么意思……好了我去补天了……老师太好了
84281,1263,黄劲,2018-07-12 12:15:07,0,1,1,没出分前来攒个人品，老师人很好，讲课也很有意思
84605,1263,黄劲,2018-07-13 09:41:53,0,1,1,水印慎选，太难了！！！
84646,1263,黄劲,2018-07-13 12:23:40,2,2,0,老师人好，讲课也很有意思
85166,1263,黄劲,2018-07-16 01:23:21,4,5,1,每节课quiz，一学期认真学了，结果也不怎么样，有点迷
107318,1263,黄劲,2019-05-03 13:22:57,0,2,2,老师很好  但是听不动\n\n作业没有答案  做和不做有啥区别  佛了
109267,1263,黄劲,2019-06-12 13:11:07,3,3,0,数学物理计算机全能
110107,1263,黄劲,2019-06-23 06:09:41,2,2,0,数字水印课比较硬核，但能学到平时很难学到的知识。小测很多。
110118,1263,黄劲,2019-06-23 08:50:16,0,3,3,虽然老师好，但是给分差啊。他的课不调分，几乎每节课都有小测。
111571,1263,黄劲,2019-07-02 03:53:35,3,3,0,非常非常非常棒的老师，老师上课很认真且有趣，老师真的充满了天赋和才华，收获满满。
123603,1263,黄劲,2020-06-10 11:39:13,2,2,0,数值分析这门课东西比较简单但是比较多也比较杂，老师上课会用一些更神奇更本质的理解来讲，因此务必预习复习把基础的掌握。对一些没有深入讲的算法要横向对比。
123706,1263,黄劲,2020-06-12 07:58:01,0,0,0,老师很nice
124660,1263,黄劲,2020-07-05 08:36:39,4,4,0,老师上课很生动，内容讲的也很透，就是数值分析这门课内容真的比较散，需要课后自己学一下。每节课都有quiz，并且占比比较大，需要在下一节课之前复习完成本节课的内容。最后感谢老师给了lab重新做人的机会……
125338,1263,黄劲,2020-09-07 04:30:25,0,0,0,很强。。。。\n\ntog随便发
125379,1263,黄劲,2020-09-08 02:04:56,0,0,0,数值分析的话大概有15次小测，占比挺高的，千万别翘课哦
138878,1263,黄劲,2021-07-11 12:27:34,5,5,0,给分太求是
151090,1263,黄劲,2022-02-23 02:41:47,0,0,0,讲课条理清楚
158693,1263,黄劲,2022-07-01 11:02:13,3,3,0,别听人家说数值分析给分好
158830,1263,黄劲,2022-07-02 13:21:42,6,6,0,黄劲讲课是牛\n\n但是思维跳脱，恶意秀智商，经常用你难以理解的比喻让你理解另一个你不理解的东西\n\n每节课都有小测，声称相当于点到，做的不好没关系，结果期末到头小测扣一堆平时分\n\n春夏数值分析不值得，黄劲班更不值得
159012,1263,黄劲,2022-07-04 12:47:31,7,7,0,客观评价一下黄老师。讲课水平牛体现在思维跳脱、内容高深晦涩（有些与课堂内容不尽相关），老师学术水平高深，paper轻松发发。\n\n但是，从上课体验上来说是比较差的，我经常坐堂旷课，基本上靠回去看书自学或者听xww老师的智云课堂（个人感觉xww老师讲得更好一些，至少更基础）\n\n强烈不建议春夏学期选数值分析，尤其黄老师的课。给分求是 非常求是\n\n临近期末我曾问老师是否考试开卷，老师还说往年都是开卷的 今年应该也一样的，结果考试前一周他才通知A4开卷。很多事情其实可以学期初就跟大家讲清楚，等到大家都做完了才说“游戏”规则，那是很难让人信服的！！另外这门课的助教也让人有些不舒服，有一种作为学长就可以“随意决定”我们分数的感觉。
159948,1263,黄劲,2022-09-09 12:53:55,0,0,0,感觉人并不怎么好诶
160816,1263,黄劲,2022-10-14 01:46:43,-1,0,1,更硬核，愿意多学一些多钻研一些的话还是可以学到很多的
175476,1263,黄劲,2023-06-25 06:38:53,0,0,0,老师的学术水平相当高，但是上课很跳跃，经常一节课这章讲一点那章讲一点，等到下节课再接着讲某一章，很难跟上思路，基本靠网课自学
177760,1263,黄劲,2023-07-04 16:24:22,-4,3,7,给分似乎还不错~\n\n可能这是期末花了两天多基本重学了一下NA的成果\n\n上课真的很努力在跟 但一是下午困 二是真的有点跟不上\n\n导致平时学的一知半解的\n\n最后期几乎把所有ppt重学了一遍 然后做了一两套题\n\n最后4.8 还是很满意啦~~！！\n\n\n\n其实老师人还是挺好的 会问懂不懂 哪里有问题bulabula \n\n虽然大家肯定也是没有回应（我感觉是因为都比较懵）\n\n不过上课可能确实比较跳脱 比较难以catch\n\n\n\n至于说春夏NA 确实肯定和秋冬的估计没法比\n\n但感觉也没有前面说的那么恐怖 \n\nyysy看前面的评价我真的是非常非常害怕的来着\n\n但是最后感觉还是可选 \n\n不过建议肯定还是去秋冬选xww的，可能压力和给分都更小一点
196714,1263,黄劲,2024-07-05 01:38:48,3,3,0,出分了来答一波\n\nhj风评一直都是讲课比较难，也有不少劝退选春夏NA的，上了课也确实感受到了，但是一学期上下来感觉还是很可选的（特别是对数学还算感兴趣的同学），老师的课堂氛围很好，也很幽默风趣，并且不读ppt，认真听课还是能学到不少的\n\n一学期的任务是一次research topic的展示，加上没有预告的十五道小测题（好在小测可以在历年回放找到），再加上pta的作业题（学期初全部布置，期末周截止，时间很充裕，一般都是对应章节上完去做一道题），小测题不难而且能翻书，都是上完课做，有些时候不做，做了就是两三道\n\nhj反复强调不喜欢出简单的题，并且春夏NA找不到历年卷，导致考前压力有点大（贼慌），但是卷子实际上和秋冬的期末回忆卷难度差不多（稍微难一点），而且全开卷，考察的没有非常深入，基本都是对知识点的掌握情况，对于大部分题，把知识点复习一遍，再做点秋冬历年卷，还是能顺利做出来的\n\n补充一下，pta做不出的题不要抄袭，老师比较严厉，查重被查出来会受到严-峻-的-惩-罚！\n\n推荐一下jpgg的NA笔记，无论预习还是复习都很好用——https://note.jiepeng.tech/CS/NA/
3725,1282,吴江琴,2015-06-17 02:42:46,7,9,2,听课没有积极性，左边黑板永远反光
6139,1282,吴江琴,2015-07-11 07:20:12,-13,6,19,老师上课讲的很懂，人很好。
23585,1282,吴江琴,2016-04-07 11:18:33,12,24,12,上课不知道在讲什么，还让学生讲课。血的教训，千万别选。
24289,1282,吴江琴,2016-04-29 07:08:24,8,13,5,超级糟糕的老师，思维很混乱，离散靠自学
25455,1282,吴江琴,2016-05-20 02:24:02,8,12,4,老师人很好，但是课讲得确实不好，逻辑比较混乱，缺少重点和条理，感觉另一个翁老师讲得更好
25456,1282,吴江琴,2016-07-04 13:58:41,6,7,1,为什么要让学生讲呢
25457,1282,吴江琴,2016-05-20 03:21:14,6,6,0,助教满分，然而想能听懂老师讲课建议先自学。\n\n让学生讲课可以刷刷分，虽然没卵用。\n\n点名用做题方法（一题，简单），不管对错。
31618,1282,吴江琴,2016-07-04 09:20:48,5,7,2,上的课根本没有听的兴趣……上课固定座位，第一周千万要早起抢个好座位啊！
32014,1282,吴江琴,2016-07-05 11:11:43,2,5,3,反正我觉得水水的，上课看比赛也不管，人也挺好的，给分是真的不错
32131,1282,吴江琴,2016-07-05 16:34:25,4,7,3,自学吧。。
48510,1282,吴江琴,2017-03-06 08:44:46,4,4,0,垃圾！
48526,1282,吴江琴,2017-03-06 14:09:14,8,8,0,思维混乱...黑板上经常演算错误...唉
49053,1282,吴江琴,2017-03-23 00:07:02,3,3,0,记不清楚还让学生讲课。自学自学
49057,1282,吴江琴,2017-03-23 00:42:28,4,4,0,一脸蒙逼
49125,1282,吴江琴,2017-04-01 07:38:02,1,2,1,。。。。。。。。
49130,1282,吴江琴,2017-03-27 08:55:36,4,4,0,差评  真的差评
49317,1282,吴江琴,2017-06-09 17:13:03,4,4,0,思维混乱
49883,1282,吴江琴,2017-04-27 01:35:02,2,3,1,混乱的思维
51046,1282,吴江琴,2017-05-15 06:49:32,4,4,0,全靠自学
51075,1282,吴江琴,2017-05-16 06:22:07,1,2,1,。。。
51833,1282,吴江琴,2017-06-12 03:33:20,4,4,0,很糟糕。太糟糕了
51846,1282,吴江琴,2017-06-12 09:31:16,6,6,0,“一个不正常的人在跟你们讲课”
52695,1282,吴江琴,2017-06-22 07:29:46,4,4,0,绝壁讲出了“离散”二字的精髓
53113,1282,吴江琴,2017-06-26 02:23:11,4,4,0,超级差
53114,1282,吴江琴,2017-06-26 02:24:54,4,4,0,全靠自己的本事，坐等挂科
56224,1282,吴江琴,2017-07-03 09:33:57,3,3,0,给1分是因为没有0分这个选项好吗！上课不知道在说些什么  虽然人很好  可是最后给分真的无话可说  教的思维混乱  全靠自学
56228,1282,吴江琴,2017-07-03 09:45:11,3,4,1,给分高就是真的好，离散本来就是自学的～
56242,1282,吴江琴,2017-07-03 10:09:30,9,9,0,这老师是真的好\n\n期末调分了很给学生自由\n\n课讲的也很不错的\n\n（ps：你们难道还指望大学好好听老师教？肯定自学啊）
60350,1282,吴江琴,2017-10-18 03:37:23,0,3,3,其实讲得很好
75003,1282,吴江琴,2018-04-11 08:06:07,4,6,2,我知道我这么说有些缺德，但是我真的是用了老师上课的录音治好了失眠。
75601,1282,吴江琴,2018-03-14 02:18:13,5,6,1,老师真的人很好，很可爱\n\n讲课一般不算差，只要好好预习自己再自学一点没问题的
76030,1282,吴江琴,2018-03-25 04:15:35,4,5,1,不知所云，自己很多东西都混乱，难的地方就说，你们都懂了吧，就过了.作业这都几周了，还没讲过，上课很多无聊的地方其拖沓，关键地方不讲，一笔带过.我很无奈，只能坐到后排看看手机，自己看看书.
76260,1282,吴江琴,2018-03-31 12:57:37,-1,3,4,感觉纯粹是在赶进度，ppt连第一行都没看完就一晃而过，就这么一次课强行讲了差不多两整章的内容，也不管你到底懂没懂
78316,1282,吴江琴,2018-05-11 01:16:22,11,14,3,其实老师真的很负责的，上面说的学生讲课不知道是不是老师安排的助教讲习题的。老师会点名，但是听了就能回答，答不出来也没关系。老师人很可爱，和学生关系很好，还想和缺勤的学生聊心来着。至于上课这回事，离散数学真的很离散，不能苛求老师啊。
78317,1282,吴江琴,2018-05-11 01:16:56,8,11,3,这学期不叫同学上课也不固定座位了，人是真的很好，上课经常出现东北味道的谜之喜感，但是希望课件还是能多按照书本的体系不要很多章节跳来跳去也不提示是第几章第几节这样的，觉得分有点偏低了，老师挺可爱的。
79102,1282,吴江琴,2018-05-23 03:16:55,8,9,1,歪个题，感觉老师穿衣风格很森系……
79103,1282,吴江琴,2018-05-23 03:17:53,1,3,2,无聊无趣无序
79151,1282,吴江琴,2018-05-25 12:55:00,0,2,2,老师课讲的确实快了些，但应该和课时数有关系，希望老师上课能重点突出一些
79358,1282,吴江琴,2018-07-14 01:14:24,19,23,4,老师很好很亲切，期中给补考，作业给补交，儿童节还给我们带糖果。虽然讲课逻辑可能有点问题，但是自学一下就没问题了呀。对我们真的很好了\n\n以下是老师在群里原话：致所有孩子!\n\n遇見你們是因爲緣分。\n\n有兩點，特讓我欣慰!\n\n一、期末考試無一缺考。\n\n二、你們最後的成績是你們平時真實努力的結果，無半點虛假。\n\n有一點遺憾：還有若干同學沒有合格，與我的期望（無一掉隊）有些差距。\n\n最後一點期望，期望你們在未來的學業中一定要從平時做起。\n\n祝好運！ 2018年7月14日
79713,1282,吴江琴,2018-06-13 03:15:33,0,1,1,上课靠自学吧，老师人挺好的
79926,1282,吴江琴,2018-06-15 09:38:09,0,1,1,多讲些会更好吧
80071,1282,吴江琴,2018-06-19 14:40:58,1,1,0,给了我做人的机会
80644,1282,吴江琴,2018-06-29 00:43:06,11,13,2,总的来说，最开始对于吴老师讲课感觉很差，听不进去。但是能看出来吴老师对于学生非常负责任，第一次quiz之后还特意约我在北街聊了将近两个小时的天，勉励我好好学，详谈之下发现吴老师还和我是校友。就我所关，计算机类的课程确实自学与预习成分要占很大的比例，并不能说是老师所致，而是计算机课程的特征使然。一些说听不懂课的同学将来接触ds和ads时想要凭听课做作业学好这些课程，只能说接近不可能。所以综合来讲，我打了比较好的分数。
83010,1282,吴江琴,2018-07-09 13:01:10,0,1,1,还行吧\n\n
83248,1282,吴江琴,2018-07-16 13:27:33,4,7,3,拿到了这学期第四门卡绩的课，而且居然没有上4...刚开始心里肯定会有些怨气的吧，但后来仔细想想，还是因为自己没怎么在这门课上花时间。老师人很好，也很用心和负责任，虽然在讲课上可能会有些问题，但我觉得最关键的本来还是靠自己。人品这么好的老师不该只有这么低的评分啊。
84268,1282,吴江琴,2018-07-14 17:43:27,11,15,4,虽然未经老师允许，但我还是想把7月14日出分后老师发的一条说说复制到这里让大家看下：\n\n下午公布分后路上碰到一个学生，他说，老师你这学期好操心。是的，这学期为了让学生能抓紧学习，动用了中学生的教学方法，如考卷更正，期中补考，课堂提问，学生谈话等等方式期望自己的行为对学生不止这科，对其将来都有好的影响！\n\n\n\n老师真的在用心。为了能让我们这群不成器的学生有所改变，老师付出了太多。有人提到老师冒雨印补考卷子，我还记得当时是老师上课提问结果我们回答得不好才说的，说完印卷子的事又说了“你们能像我一样努力就好了”。我能感觉到老师眼里有泪水，但还是无奈的笑了笑。\n\n想到这里，真的是后悔没好好学离散这门课导致绩点难看。真的感觉辜负了吴老师，让吴老师失望了！\n\n但是以后，我不会让吴老师失望。我会努力下去的！
84832,1282,吴江琴,2018-07-14 03:32:27,0,1,1,....好
84837,1282,吴江琴,2018-07-14 04:04:05,-2,0,2,老师人很好，选一波吧！
84893,1282,吴江琴,2018-07-14 08:31:27,9,11,2,"上大学一来第一次被老师夸“真聪明""，其实我只是问了一个上课她强调过的点，超级感动。后来期中考试没有及格，没想到还有补考的机会!老师说她还是冒雨给我们打印的补考卷子。真的，你会感觉不好好学对不起老师。现在也不会让同学讲课了，"
85068,1282,吴江琴,2018-07-15 08:18:35,-2,0,2,
92391,1282,吴江琴,2018-12-28 08:04:57,-1,0,1,hhh\n\n
103735,1282,吴江琴,2019-03-05 01:06:35,4,4,0,讲得真的不好......
103815,1282,吴江琴,2019-03-06 03:33:35,4,4,0,讲得也太差了。毫无逻辑
103953,1282,吴江琴,2019-03-08 02:20:25,4,4,0,讲的是真的不好 自学吧 挺好的 但她还点名
103980,1282,吴江琴,2019-03-08 08:34:06,9,9,0,可能是自己水平不行hhh\n\n反正感觉讲的时候有点逻辑混乱，简单的东西花半天讲，难的却一带而过\n\n想自学来着，可是偏又不时点个人起来提问\n\n真是令人为难
104504,1282,吴江琴,2019-03-22 01:54:45,-4,1,5,老师很好很亲切 留出时间做复习再小测
104508,1282,吴江琴,2019-03-22 03:00:59,4,4,0,差差差
104642,1282,吴江琴,2019-06-18 01:11:19,5,5,0,只讲表面，不讲为啥，问题是这个算法您也讲清楚前因后果啊，怎么就出结论了，为什么这个步骤这么做？有时候老是说车轱辘话，下面同学不听是挺难受，可是您也考虑一下同学啊！学得真的好辛苦啊哭
104692,1282,吴江琴,2019-07-10 03:18:55,6,8,2,就是有点难受 离散自学比较好 考试不是很难
104845,1282,吴江琴,2019-03-28 15:22:59,3,3,0,不好的体验
106032,1282,吴江琴,2019-04-24 12:11:39,2,3,1,太差了。简单的讲很久，难的就一带而过或者索性让同学讲。
106249,1282,吴江琴,2019-04-26 02:42:20,0,2,2,大爱啊。老师很认真负责，关爱学生
108200,1282,吴江琴,2019-05-16 08:26:09,0,4,4,其实，我觉得老师挺好的[捂脸][捂脸][捂脸]
108238,1282,吴江琴,2019-05-17 02:05:29,4,5,1,求求您别开课了\n\n给学生一条活路吧\n\n或者就上课别讲话让我们自学\n\n谢谢
109969,1282,吴江琴,2019-06-20 16:15:23,4,5,1,离散二字精髓体现出来了
110061,1282,吴江琴,2019-06-22 04:56:55,-1,1,2,讲课还好吧，虽有的时候逻辑有点乱，但是每个知识点都能讲清楚。让学生讲题的情况确实也有，不过基本都会自己再解释一遍。老师很负责的，应该不至于只有5分
110158,1282,吴江琴,2019-06-24 03:16:36,1,2,1,为什么没有0分
111196,1282,吴江琴,2019-06-30 13:21:05,1,1,0,老师人真的很好 期中考试填空题三分一个都能一分两分得扣 实在感人 老师真的绝对不止五分 不过做好自学的准备…
111424,1282,吴江琴,2019-07-01 12:31:07,2,3,1,老师还是很亲切和蔼的，但是老师可能讲的确实差了点，要做好自学准备，不过离散数学本身也挺难的
112044,1282,吴江琴,2019-07-07 15:32:35,-1,0,1,吴老师真的很认真负责了，可能上课会有点乱但这和课程本身也有很大关系，而且完全可以听懂的。
113056,1282,吴江琴,2019-07-09 21:53:46,-6,1,7,竟然苟住了，感谢老师。上课体验一般，需要自习否则效率不高。推荐到98啥的先看看重点是啥，帮助学习。问题体验很好，老师会很耐心地解答，夸你聪明，有一次还给我们带了酸奶（虽然上课的时候忘了发）。给分真的会上调一分不卡你，感动。
114291,1282,吴江琴,2019-07-09 17:24:49,0,1,1,虽然吴老师讲课不咋地\n\n但最后貌似调分了？感觉自己本来没这么高
114318,1282,吴江琴,2019-07-09 18:12:36,2,3,1,讲课确实一般比较混乱，基本靠自学，但其实如果提前预习过的话听听还是不错的。人很好，平时对学生很上心，答疑也很细心，给分真心好，最后给调分的
114338,1282,吴江琴,2019-07-09 23:02:34,-1,1,2,老师讲的十分透彻易懂\n\n\n\n天呐 从来没遇到过这么好的老师 感动的我都要哭了
114372,1282,吴江琴,2019-07-10 00:08:17,1,2,1,期末浓浓师生情
114434,1282,吴江琴,2019-07-10 02:46:31,0,2,2,期末给调分，报名工高班的时候还帮忙写推荐信，脾气很好的老师。虽然课程进度快来不及预复习，但是考试周老师在群里和大家一起讨论复习氛围很好，加上一点自学能力没什么问题。从一开始看到900多页的英文书就知道这门课要好好学，平时认真完成作业弄懂每个概念，期末期中和小测前复习起来就不累啦！
114461,1282,吴江琴,2019-07-10 04:16:55,-1,0,1,人品没问题，给分也很好。但是，讲课水平确实有点……自学吧。经常点名，叫同学回答问题，点名性小测。
114511,1282,吴江琴,2019-07-10 09:19:27,1,1,0,浓浓师生情
114674,1282,吴江琴,2019-07-11 03:20:42,0,0,0,给分好，助教好，老师讲课有些混乱，但是人好。有酸奶喝。看得出老师认真地想讲好。
114855,1282,吴江琴,2019-07-12 04:30:21,0,1,1,老师讲的逻辑确实有一些混乱但是课后看ppt\n\n是可以理解他讲了什么的 而且助教非常负责 最后期末考试会调分 相比其他的离散开课老师我觉得已经很不错了
117683,1282,吴江琴,2019-09-29 02:07:32,0,0,0,老师人真的很好，只是我没有认真学习罢了。但老师讲课真的有点...讲不太清楚。
119009,1282,吴江琴,2019-11-09 09:31:17,0,0,0,老师是好老师 期末给调分\n\n就是上课质量实在比较一般
122625,1282,吴江琴,2020-03-09 05:53:34,0,1,1,唉……老师啊，您让我怎么说你呢，离散数学用英文教材我可以接受，教材1000多页我忍忍也就过去了，可是你布置作业的逻辑也太诡异了吧，上完这一节的内容结果布置下一节的作业……
125447,1282,吴江琴,2020-09-09 08:59:17,1,1,0,老师真的很好很好很好啊，怪我疫情在家，生了惰性，没有好好学习。真的很对不起老师😭😭😭
248,1285,陈春晖,2015-03-14 18:07:04,61,157,96,老师完全没有教学热情，上课给人一种消极的感觉，不知道在干嘛，说话的语调也很消沉。总之差评，不过还是给个及格分
589,1285,陈春晖,2015-03-15 06:10:30,-7,5,12,讲的很差劲，给分低！
663,1285,陈春晖,2015-03-15 11:15:00,9,13,4,给分不错
710,1285,陈春晖,2015-03-16 01:11:04,7,13,6,给分好
984,1285,陈春晖,2015-03-20 10:00:53,17,54,37,上课沉闷……完全打击你对计算机的热情
1086,1285,陈春晖,2015-03-21 16:07:21,11,22,11,讲课没重点，也不怎么关心学生，无聊
1622,1285,陈春晖,2015-03-23 02:21:41,7,15,8,睡觉
1685,1285,陈春晖,2015-03-23 08:28:08,8,15,7,无聊 消极
2491,1285,陈春晖,2015-05-04 13:15:57,3,7,4,催眠啊
3339,1285,陈春晖,2015-06-02 11:34:29,3,7,4,讲得一般，偶有幽默，喜爱Python，大计基有一个做视频的作业。
4031,1285,陈春晖,2015-06-17 14:46:10,0,5,5,脾气不好
4582,1285,陈春晖,2015-06-24 16:34:47,3,4,1,讲课让人昏昏欲睡……不过应该是他说话语调的问题，其他倒没什么，群里回答学生问题也蛮热心的
5026,1285,陈春晖,2015-07-02 08:20:30,11,14,3,昏昏欲睡
6692,1285,陈春晖,2015-07-19 04:41:03,7,10,3,不值得听
6758,1285,陈春晖,2015-07-21 16:20:15,2,7,5,老师大好人TT
6899,1285,陈春晖,2015-07-31 15:50:28,-2,1,3,还可以。一般般啦。\n\n
7013,1285,陈春晖,2015-08-28 06:14:45,9,22,13,老师上课让人昏昏欲睡，也不管你听不听，有个做视频的作业，不过说到底计算机类的课还是靠自己
7712,1285,陈春晖,2015-09-15 10:27:26,7,13,6,不喜欢他的讲课方式，给他打电话时满满是一种你快挂吧的口气
8435,1285,陈春晖,2015-09-21 08:35:05,0,2,2,…还可以
8438,1285,陈春晖,2015-09-21 08:56:16,4,4,0,好困。。。
8482,1285,陈春晖,2015-09-22 00:04:35,5,6,1,讲话跟催眠一样
8818,1285,陈春晖,2015-09-28 07:59:23,8,11,3,无聊到爆炸\n\n
9022,1285,陈春晖,2015-10-10 01:36:54,4,5,1,昏昏欲睡
9228,1285,陈春晖,2015-10-18 08:50:24,8,11,3,听不懂 没热情 敷衍
9265,1285,陈春晖,2015-10-19 07:46:11,4,7,3,听他的课就是浪费时间浪费生命
9642,1285,陈春晖,2015-11-03 15:24:27,11,16,5,不如自学
11760,1285,陈春晖,2015-12-23 07:59:26,18,40,22,太困了不知道老师上课是什么样子的
12007,1285,陈春晖,2015-12-21 13:20:57,7,10,3,超级烂！！！！！！
12635,1285,陈春晖,2015-12-23 16:38:27,7,10,3,沒有深入接觸是不能理解老師遺世孤立的境界的，還有⋯⋯⋯應該是個人氣質的問題辣，消沈、不負責任什麼的
12801,1285,陈春晖,2015-12-24 05:36:12,1,2,1,课 超水
12897,1285,陈春晖,2015-12-24 07:51:04,4,4,0,失眠包治…
13016,1285,陈春晖,2015-12-24 13:57:08,14,21,7,水，没什么作业
13705,1285,陈春晖,2015-12-30 11:15:43,3,4,1,上课极容易犯困…有时听到隔壁老师上课声音都比他响很多
14235,1285,陈春晖,2016-01-05 13:45:02,4,5,1,大jj基本没有一节课能听进去……讲的真心不好…
14474,1285,陈春晖,2016-01-07 08:19:20,3,7,4,对学生超级不尊重，简直有点无理取闹
14503,1285,陈春晖,2016-01-07 09:27:08,0,0,0,Dllm
14903,1285,陈春晖,2016-01-20 01:47:22,6,14,8,用最简洁有效的话回答问题，给分也特别不错
15747,1285,陈春晖,2016-01-16 08:21:54,3,5,2,有些呆萌，但上他的课容易犯困~(>_<)~
15796,1285,陈春晖,2016-01-16 09:35:06,1,5,4,我觉得挺好的。自由度很大。
16573,1285,陈春晖,2016-01-18 11:54:21,7,12,5,上课沉闷，不知所云；期末只有卷面及格平时分才有效，否则直接挂科。想要好看的绩点千万别选他，除非你有实力自学。
16833,1285,陈春晖,2016-01-19 05:01:07,17,23,6,可划水，但会有小测验，某一次小测验后会离奇的点个名。平时分就没了。
17975,1285,陈春晖,2016-01-21 05:04:40,1,4,3,老师很耐心，作业不是很多，人还不错。会有个自我介绍的大作业。
19021,1285,陈春晖,2016-01-23 04:47:38,6,12,6,其实很好
20044,1285,陈春晖,2016-01-26 02:56:26,5,10,5,老师很好
21421,1285,陈春晖,2016-02-28 23:39:17,3,4,1,昏昏欲睡\n\n
21583,1285,陈春晖,2016-02-29 08:50:54,0,1,1,偶尔幽默，但总体上，呵呵，昏昏欲睡。
21874,1285,陈春晖,2016-03-01 10:59:55,7,8,1,无聊，就喜欢问学生你们xxx学过吗？这都没学过我不讲了啊  有毒
21916,1285,陈春晖,2016-03-01 15:37:24,3,3,0,困死了
23057,1285,陈春晖,2016-03-16 17:07:14,5,10,5,python讲的还是可以的，上课也照顾大二大三的有编程基础的人。总之感觉他挺热爱python，但这也影响了他教学其他课程。
23534,1285,陈春晖,2016-04-05 07:00:34,6,12,6,差爆了，总是歧视文科，社科生，势利眼，上课就是念课本
24071,1285,陈春晖,2016-04-26 13:04:13,19,36,17,老师头发很帅
24475,1285,陈春晖,2016-04-30 15:01:05,3,6,3,挺好的呀
26236,1285,陈春晖,2016-06-16 10:32:58,83,93,10,老师爱的是python
26479,1285,陈春晖,2016-06-19 01:16:46,22,27,5,python教的比大计基好多了
29407,1285,陈春晖,2016-06-29 17:01:26,3,9,6,感觉上课虽然平淡了些但这样不也挺好的么，挺爱这种平淡的风格的，这样偶尔的幽默就更有意思了，毕竟又不是讲相声，c程上机作业虽然多了点，但是可以在宿舍写啊（至少不用每周去机房了，心疼每周都要去几次机房的舍友），而且平时写的多，期末上机考试根本毫无压力啊。有问题老师也挺耐心的，还会查了资料以后邮件回复，反正我觉得是个好老师。（虽然我大计基直接爆炸。。。）
30960,1285,陈春晖,2016-07-03 05:51:39,4,5,1,其实我觉得老师人挺好的啊 而且给分也不错 而且也没有特别困吧
31312,1285,陈春晖,2016-07-03 15:41:14,0,2,2,平时上课还不错的，就是给分莫名的低……可能是我太菜了吧
31977,1285,陈春晖,2016-07-05 10:16:12,1,2,1,老师的课是有些平淡，不过要点都到了，上机的陷阱题也会给我们讲，总之还是不错的。但我还是想说，C程学好靠自己。
34358,1285,陈春晖,2017-01-05 06:21:33,12,15,3,最最最幸福的就是，没有上机实验！
35194,1285,陈春晖,2016-11-04 11:45:58,2,2,0,上课跟催眠一样，给他打电话随便说两句就挂了，消极
35438,1285,陈春晖,2016-11-10 07:16:23,4,4,0,呵呵，回寝室睡觉了
35521,1285,陈春晖,2016-11-10 07:23:44,2,3,1,呵呵呵
35814,1285,陈春晖,2016-11-10 08:16:57,3,3,0,昏昏欲睡
35825,1285,陈春晖,2016-11-10 08:23:26,3,5,2,睡吧~睡吧~我亲爱滴宝贝~
38652,1285,陈春晖,2016-12-13 10:35:22,2,2,0,连着两个学期上了他的课…给分还不错
38841,1285,陈春晖,2016-12-19 13:50:47,111,158,47,“你上去写一下这题好不好啊？”5:30下课总是会提早5分钟放，比起其他老师的实验报告，感觉自己不用写好幸福。会直接告诉你哪种题型怎么出.我上的是他的大计基，觉得这老师挺好的，困不困其实不在老师。决心下学期要选他的python
39684,1285,陈春晖,2016-12-27 03:19:17,4,4,0,睡觉吧\n\n
39764,1285,陈春晖,2016-12-27 11:22:22,1,4,3,虽然说会困，但是老师人真的挺好的。
40612,1285,陈春晖,2017-01-04 09:53:24,3,4,1,虽然讲课有点无聊，但实际上还是一个好老师的
40719,1285,陈春晖,2017-01-05 06:44:28,6,11,5,虽然没什么激情但是实际上讲的还不错，印象很深的是会用一些比喻来解释概念，而且不用写课后作业和上机实验也不锁IP，很幸福的。就是会叫人上去写题，被叫到过……
43527,1285,陈春晖,2017-01-16 12:32:50,0,2,2,学的是大计基。没有上机实验也不强制去机房，经常提早下课，就是quiz来的猝不及防。我觉得大计基的话这样算还行了吧。
46203,1285,陈春晖,2017-01-21 02:16:50,3,3,0,为蛤还不出分呐
46967,1285,陈春晖,2017-01-23 05:59:06,45,78,33,老師很可愛。 可是喜歡給大家打88 85 82這種分。我和我室友們都是。你知道嗎，最傷心的不是你差，是你差一點就可以好了。哼。給你10分，讓你看看啥叫慷慨！
46973,1285,陈春晖,2017-01-23 06:26:54,1,3,2,分低
47577,1285,陈春晖,2017-02-02 06:59:01,88,100,12,本来大计基就是死记硬背的东西，陈老师又不怎么点名，从来不用写实验报告，节省了大量的时间啊，节省的时间足够把这门课修高绩点了，有什么不好。
47991,1285,陈春晖,2017-02-28 02:19:20,5,6,1,昏昏欲睡，歧视文科生，平时测验可划水，他的大计基是绩点最低的课
48246,1285,陈春晖,2017-03-01 11:40:18,3,4,1,我真的觉得还好啊，不无聊啊，老师人很好，而且大计基也主要靠自己背书吧。
48399,1285,陈春晖,2017-03-03 01:30:53,-4,7,11,大英2.2，大计基4.2路过，搞不懂所谓给分低是什么意思，自己连刷题都懒得做，结果分低怪老师咯？
51901,1285,陈春晖,2017-06-13 09:27:39,0,2,2,蜜汁觉得老师很萌
52467,1285,陈春晖,2017-06-20 09:03:08,0,3,3,老师对python是真爱，其实人也不错，就是不太适合基础差的…因为感觉大家都学过语言比较厉害，所以讲的不是很细致吧，对上课不听的女生也是挺温柔的…嗯就酱吧 上课前预习一下会更好
55734,1285,陈春晖,2017-07-02 09:50:46,0,2,2,没有烦人的大作业，爱老师，可爱幽默。感谢不挂之恩。
57290,1285,陈春晖,2017-07-06 11:47:48,8,9,1,给分差，随便给
57308,1285,陈春晖,2017-07-06 13:59:58,14,27,13,老师爱python\n\n但是理论出得太坑，就是在刁难学生\n\n
57315,1285,陈春晖,2017-07-06 14:37:42,2,2,0,很蛋疼
57328,1285,陈春晖,2017-07-06 16:25:19,11,18,7,老师尚可，但期末理论考巨坑，万万没想到本学期最低分出自Python。
57339,1285,陈春晖,2017-07-06 23:50:04,6,10,4,老师的python真的很没意思。python 语言的强大之处根本没交出来，期末考全考一些没有意义的，实际操作中根本不会遇到的细节问题，想要用python刷分的请回吧
57378,1285,陈春晖,2017-07-07 05:09:02,3,4,1,python给分差
57686,1285,陈春晖,2017-07-12 13:26:10,0,3,3,不错哦，喜欢python
59776,1285,陈春晖,2017-09-27 02:22:47,-1,4,5,超级喜欢这个老师，我反正觉得这个老师超级好的，很有意思，大基机嘛学的怎么样还是看自己的，老师很棒
60544,1285,陈春晖,2017-12-29 10:21:22,-11,3,14,翔一样的体验，人品问题，总是歧视民族生，其实文科生，炫耀自己在美国读书的女儿，走狗！！！！！
61089,1285,陈春晖,2017-11-08 09:05:41,-1,1,2,其实还好，上课很轻松
63364,1285,陈春晖,2017-12-01 15:22:34,2,5,3,必须好评啊，对于我这种比较懂的人来说，没有繁琐的实验报告等作业，节省时间。因此，平时作业更要好好做，上课前抽查（小心你的平时成绩），但是不多。大学课，自学能力很重要
64032,1285,陈春晖,2017-12-20 14:57:34,1,2,1,节奏不紧不慢，讲课有条理，个人还是比较喜欢这位老师的
64052,1285,陈春晖,2018-01-03 05:46:05,3,4,1,挺好说话的，感人
64780,1285,陈春晖,2017-12-27 06:14:08,0,3,3,老师语气平淡，事情少，可以不去机房，还没有实验报告，还会讲以后选课的事情，不是很好吗？
65985,1285,陈春晖,2018-01-10 15:38:02,0,1,1,老师很和蔼啊，虽然讲课比较沉，但是很宽松，事情很少，给分也好，机基课也不是水课，是要下功夫的
67336,1285,陈春晖,2018-01-21 01:05:32,0,1,1,老师人挺好的，作业还好，一般是抽一个同学演示，演示还可以加平时分。最后一次小测说只要参加小测就满分。群里会回答问题上课是有点无聊，不过大计基还是得靠自己背
72234,1285,陈春晖,2018-01-29 15:11:09,2,3,1,成绩出来前先评论一下，老师挺好的，小测是半认真的，没有上机实验，但小测记成绩，期末论文也好写不为难我们，提前五分钟下课（中间不休息）
72723,1285,陈春晖,2018-01-31 03:25:14,1,3,2,上课很水，大计基从来不会布置上机实验，上课也会和你说什么知识会考，而且会把上课的ppt放到网上，自己复习可以下载，也会在群里回答问题，老师还有点可爱，期末有个大作业就是做一个自我介绍的ppt或者word，总得来说大计基很辛福，从来没有做过实验作业，期末考前认真把书看几遍，ppt认真看到最后成绩不会差的
74069,1285,陈春晖,2018-02-04 17:00:57,0,5,5,任务轻 给分高
74690,1285,陈春晖,2018-03-05 06:04:35,-1,3,4,很好的一个老师 给分蛮好的
75184,1285,陈春晖,2018-03-08 01:59:11,1,3,2,在QQ上回复的时候喜欢在句尾加感叹号
75638,1285,陈春晖,2018-03-14 10:14:01,0,4,4,老师真的超好呀！大计基不要求上机实验，事极少，跟室友比起来很幸福。课堂可水，但认真听课的话会发现老师很会抓重点来讲，尤其是近考试的时候，可以靠自己背的不会讲，但需要理解或者掌握计算方法的都会讲，而且讲得很清楚。很棒！
75981,1285,陈春晖,2018-03-23 03:50:00,2,8,6,我觉得老师很好，不像前几年那样，我要告诉大家，晖哥变了，很nice了。课堂轻松，事情不多，个人简历作业很有意思，大计基轻松4.5以上
78569,1285,陈春晖,2018-05-13 07:10:38,8,12,4,人很刻薄
80761,1285,陈春晖,2018-06-30 12:17:36,-1,3,4,老师很好
81582,1285,陈春晖,2018-07-05 12:48:20,7,14,7,老师根本就不懂 python，考试题目漏洞百出，上课讲课就在网上找各种库的教学视频来放。一个学期下来基本毫无收获，不如自学。\n\n给分？说好的 project 给 bonus 好的能有 5 分，花几周时间认真研究的 project 最后 bonus 给多加 1 分。全班不是 1 分就是 0 分。
82170,1285,陈春晖,2018-07-08 16:32:38,5,11,6,傻逼老师，不多评价。
82173,1285,陈春晖,2018-07-12 11:24:00,-2,7,9,完全靠自己，期末考试占70，底下说不好的，都是自己考的差，最后20％的人满绩
82316,1285,陈春晖,2018-07-08 00:42:27,15,27,12,老师还好，群里会和同学们开开玩笑，但是py考试有大坑的！课题组应该反思一下吧，学习好不如运气好，好歹给个说法吧
82320,1285,陈春晖,2018-07-08 01:23:53,10,16,6,希望老师能对考试难度给个说法
82413,1285,陈春晖,2018-07-08 06:31:43,-3,4,7,前面说考题漏洞百出的，基本上都是翁恺出的题目吧。oop也是，考试的时候各种改题也不和同学说改哪里就叫我们刷新。陈老师还是很好的，虽然上课没意思，project可能任务重回报少了一点...不过还是能看出老师是想把这门课教好的，多次问我们喜欢怎么样的上课方式，群里也积极和同学们互动。
82660,1285,陈春晖,2018-07-09 02:30:23,9,15,6,完全不会体谅学生，反正就是给人一脸瞧不起的样子。好处就是不用恶竞，因为你做成什么样，在他眼里也就是一坨垃圾。
84212,1285,陈春晖,2018-07-12 08:50:23,11,28,17,怎么没有零分可以打？\n\n怕同学质疑分数的公平性，一声不吭把群解散了。觉得这次考试一点公平性都没有。想去教务部门举报。
84228,1285,陈春晖,2018-07-12 09:37:46,13,26,13,有一种调分叫减分  怕怨念太多   一声不吭把群解散了才是最令人不爽的操作
84231,1285,陈春晖,2018-07-14 03:38:16,3,7,4,不管怎样，最后一声不吭解散课程群让人很难受。很多好老师会在期末后抛开考试传授最后一次知识。从这一点上，我认为cch不是一个好老师
84236,1285,陈春晖,2018-07-12 10:17:58,-1,3,4,不点名，给分全看平时pta和期末考..反正我觉得挺好的233xD
84263,1285,陈春晖,2018-07-12 11:17:35,11,16,5,分给低了也就低了…一声不吭解散群聊算是怎么回事…想不通
84266,1285,陈春晖,2018-07-12 11:27:26,-1,6,7,老师给分超级好！！平时上课虽然说话语调有一种慵懒感，但在QQ群里经常和学生互动的，也能感觉出老师真的很喜欢python。
84344,1285,陈春晖,2018-07-12 15:13:41,3,6,3,实际给分和按他的算法算出来的分数差了10分，这种减分简直无法忍受好吗？？不给提分也就算了，减分算个什么鬼啊？？ Python大作业没有一点指导，最后几节课全在展示以及不知所云，浪费时间
84404,1285,陈春晖,2018-07-12 18:52:41,0,6,6,按考试排名后正态 没毛病啊 这是门通识课 103＋妥妥满了 教务系统要正态也能怪老师？大作业最后不管怎样都是满分还不够嘛
84929,1285,陈春晖,2018-07-14 12:09:37,6,10,4,我在陈老师手下学的Python，大一零编程基础，上的不是project班。看得出来，老师对自己布置的project作业很自豪。他“让学生找到成就感”的教学理念让我印象深刻。零基础上他的编程课不会听不懂，至少和方宁老师比是这样。把他布置的编程作业认真做完，期末考好不难。他最后给分也是以考试分拉排名，尽力给学生最高的分。虽然他平时给我印象不太好，但最后觉得学Python找他还是可以。
86728,1285,陈春晖,2018-09-18 06:48:55,7,8,1,同意前人评论。上他课时昏昏欲睡。
87341,1285,陈春晖,2018-09-27 06:36:28,5,5,0,真的好困
87346,1285,陈春晖,2018-09-27 07:13:31,1,3,2,老师钟爱chrome\n\n
88590,1285,陈春晖,2018-11-02 07:14:11,1,4,3,98满了
94073,1285,陈春晖,2019-01-15 06:02:47,0,1,1,老师人真的挺好的 虽然上课无聊 但是也不为难学生 基本上有求必应 学不学 还是看自己
96648,1285,陈春晖,2019-01-21 08:33:17,4,7,3,从不点名 一学期有70道左右程序作业占25分(包括helloworld之类的) 60道左右就满 机考25分都是原题 理论50也有题库可刷 刷绩点强推课程
98045,1285,陈春晖,2019-01-23 04:18:27,2,2,0,我只说一句，给老师评高分就怪了……对他无语
98172,1285,陈春晖,2019-01-23 06:52:55,0,1,1,老师太佛系了，上课需要很努力去听不然真的听不进去，本来是懂很多的，但是并不讲出来。果然他最爱的是Python。课程重点基本就是考试，不过人工智能也有侧重地拓展了一下，淼。最奇怪的是从开学开始就劝同学们退课，几乎一有机会就会亲切提醒同学们，这点我很不理解，后来我真的退了Ծ‸Ծ（第二轮专业确认后培养方案无，为了减轻期末考试压力）
101896,1285,陈春晖,2019-01-29 13:59:15,3,3,0,事情少，很清闲，没有大作业，整体还好，毕竟大计基就是靠自学。就是最后突然把群解散，然而成绩还出不来，这就很让人窒息了。
101914,1285,陈春晖,2019-01-29 15:54:17,1,1,0,老师是真的佛?求出分给个痛快
101939,1285,陈春晖,2019-01-30 00:07:16,-4,1,5,上课一般，给分也不好，听好几个同学说都是88，85，82之类的卡绩点的成绩，最后有自动解散群，是我大一课群中唯一一个老师要求自动解散的，真是无语。
101955,1285,陈春晖,2019-01-30 01:12:55,1,1,0,有点无聊，但给分还可以
101957,1285,陈春晖,2019-01-30 01:16:05,2,3,1,出分很慢但给分还好。老师平时不会催你写作业复习啥的，都挂在网站上要'自己去看。大计基不用做实验作业简直太爽了
101961,1285,陈春晖,2019-01-30 01:22:50,-4,3,7,一学期没听课，考前一天刷了刷题，拿了4.5，大计基还是很简单的
102016,1285,陈春晖,2019-01-30 04:01:11,3,3,0,老师人挺好的，但大计基最后还是得靠自己复习。
102049,1285,陈春晖,2019-01-30 07:21:44,2,3,1,上课实在不能集中注意力了，不过也有自己的缘故…没有实验报告，作业就是网上作业简简单单，有三次小测都可以翻书上网讨论，分数平时55考试45，考试真的考前看看书不用记太多就行了，总体还是不错，有两次作业忘记时间没完成以及平时从不听课的本文科生以为要完，结果4.2心满意足?
102067,1285,陈春晖,2019-01-30 09:06:17,5,8,3,老师的大计基不用写报告真的很舒服。平时也没认真听过课，不想去上课的话，卡着quiz的几节课去就可以了，有事都会放网上，很佛系，平时作业及时完成，考前看了一天书做了一点题，最后以为考的不太好还是有4.5，谢谢老师。想问说给分差的同学自己认真复习了吗
102076,1285,陈春晖,2019-01-30 10:30:19,-13,1,14,虽然最后拿个4.5但我还是给老师低分，没见过这么淼的老师，真的，能别选他的就别选
102461,1285,陈春晖,2019-02-03 00:48:32,4,4,0,事情少
103266,1285,陈春晖,2019-02-27 05:40:21,2,2,0,老师挺好，考前背背分就不会低
103607,1285,陈春晖,2019-03-02 07:32:19,25,28,3,一学期没听课考前刷题4.5，事少课水没论文不上机，本来就是佛系偏水没人愿意听的课，说老师上课没激情的不知道怎么想，要是真想学计算机谁会去学大计基？自己都不想学还那么多要求？
104227,1285,陈春晖,2019-03-14 06:52:38,3,4,1,轻松。
105219,1285,陈春晖,2019-04-07 12:33:03,4,5,1,上学期上他的大计基，事情挺少。\n\n这学期不上他的python，却特意打差评。早早做完作业出分却发现题目改了。而且不止一次发生这种情况，什么鬼?
106978,1285,陈春晖,2019-04-30 13:48:05,2,4,2,上的大计基，这个老师事情真的很少，小测可以翻书讨论，只要期末刷过书，考的还行，不会太难看
109071,1285,陈春晖,2019-06-07 05:18:34,1,4,3,我觉得其实还行
111022,1285,陈春晖,2019-06-29 07:31:04,-2,3,5,我就问一句，能不能为学生着想一点，考试时间少了就只能自己担着是吧？
111058,1285,陈春晖,2019-06-29 11:36:56,-10,6,16,我就想问一句，校园卡不能证明一名浙大考生的身份？就算真的不行，为什么“要带学生证身份证”这么重要的一个通知可以只是考前几个小时简单而不正式的一个艾特全体就完事？既然不带两证不具备考试资格为什么不提前查验，而是要通过在考试过程中将学生赶出考场这种丝毫不为学生考虑的方式？我无法认同这种在浙大“特殊”的考试要求和处理方式，也希望后面选python课的同学们吸取教训，考试千万不要忘了带两证，否则牺牲的是自己的考试时间！
111076,1285,陈春晖,2019-06-29 13:02:33,-1,4,5,没听过大计基，但是python相对于室友而言，真的是作业又少，上课讲的又详细。老师其实很专业，还会问大家然后讲一些补充的东西。虽然浙大垃圾的机房和垃圾的网络导致一大堆人期末考强退6、7分钟，题目来不及做，还没法延时，但老师还是可以的。至于前面说没带双证的同学，请在第一单元下载考试须知、提前阅读学生手册以及别翘最后一节课因为老师会强调考试须知。
111077,1285,陈春晖,2019-06-29 13:23:15,25,52,27,老师一直在班里强调 你们都是竺院的学生、那别的不是竺院的学生呢？你有想过吗？区别对待这种事情是一个老师该有的态度吗？叫学生答题答不上来的就问了一句，你不是竺院的吧？ 答上来了就是 你是竺院的吧？ 这什么东西！！！
112983,1285,陈春晖,2019-07-05 17:15:12,2,5,3,初看查老师评分有点慌，第一次接触感觉还好，越接触越感觉不行。教四个班，只在一个班不教额外内容，上课毫无活力，讲课极其无聊，考试不带学生证不让考，好像在我们班还向下调分了？总之很后悔选
113002,1285,陈春晖,2019-07-05 17:22:20,3,5,2,老师Python上的很好，补充了很多知识。室友是另一个老师的，感觉像递归的题目他们就没讲到。虽然他总喜欢强调你们都是竺院的，是不是很简单，非竺院听起来总是怪怪的。上课是很不错的，最最最关键是老师还调分了！
113036,1285,陈春晖,2019-07-05 18:29:36,-22,3,25,Python学不会还是看个人吧，我上课没有去听过，作业也没全做完，全靠期末补天最后4.8，感谢老师的平时分！
113352,1285,陈春晖,2019-07-06 09:33:20,-1,4,5,感觉老师没有什么上课热情，而且一直在歧视非竺院的学生。
113522,1285,陈春晖,2019-07-06 22:41:48,-1,2,3,从不点名，上课是真的水。真喜欢Python别选，浪费时间。
113674,1285,陈春晖,2019-07-07 03:11:39,4,5,1,我觉得老师的python挺好的，讲的还可以，这学期给分炒鸡好，可能各个班不太一样？
113792,1285,陈春晖,2019-07-07 13:51:58,3,3,0,难道陈老师班的都是4.5以上？
114477,1285,陈春晖,2019-07-10 05:16:14,-3,2,5,这是个什么老师啊，上他的课毫无激情，期未考试时系统出现故障，整个考场同学不能及时提交数据。事后在群里咨询，一声不啃，心虚了？怎么没有零分。
116977,1285,陈春晖,2019-09-25 05:35:56,3,5,2,不回答学生问题
118278,1285,陈春晖,2019-10-24 07:37:40,-1,3,4,老师上课真的很无聊，死气沉沉的。然后会因为一些很小的点发火。放假一段时间再来上课自己都忘了自己讲到哪里了。然后跳过一大段开始讲。真的无语。
121118,1285,陈春晖,2020-01-19 16:28:20,2,3,1,喜欢这个老师
121651,1285,陈春晖,2019-12-10 11:33:36,1,3,2,大一秋冬学期，从来没有翘课、请假、缺席，唯独陈老师的大计基是唯一一门让我认真考虑要不要翘课的课
121864,1285,陈春晖,2020-01-22 23:44:11,4,4,0,选的是陈老师的大计基课，需要说明的是：1、没有感觉到很明显的缺少热情，老师个人风格呈现出偏冷淡的态度是事实，但实际上挺热心、幽默的 2、老师无脑划重点，只要上课听就莫得问题 3、老师会对ppt和书本知识进行拓展\n\n大计基可能的复习策略：除网络部分，书本结合教学ppt全部学懂+加刷题，网络（如果时间来不及，大概率来不及）把能刷到的题全部刷一遍。
121897,1285,陈春晖,2020-01-23 07:21:46,22,24,2,现在不是很能理解陈春晖老师的分数为什么会被打到这么低……我上的是他的大计基。①平时会在群里跟大伙儿聊天解答问题，还用表情包，特别逗，人挺好的；②作业的话，有三次小测当点名用，期末有开通道让我们补平时分，没有其他老师班的实验报告，最后的总评也努力帮大家调过分了；③上课的确有沉闷的感觉，但意外的也有笑点。复习的话理论部分拿着他的ppt刷题就可以了，py入门的话还是需要多实践。
122454,1285,陈春晖,2020-02-28 10:03:31,3,6,3,还行，上的大计基，这个老师只有6分多确实感觉略低，横向比较我觉得上课水平和内容应该在8分左右（为了稍微拉高一点我给了10分）老师比较喜欢积极一点的学生，虽然大计基不难，问的问题有时候简单到令人怀疑是不是有坑，但由于课堂氛围不太有人回答，你回答了说不定会给你加点表现分（虽然不清楚算到总分有多少）作业的话Python的内容比较多，算是一个难点，可能会迫使你花点时间多学学Python的内容，但像别的论文之类的玩意是没有的，对PPT、word这种会给视频参考，比别的班自己熬要轻松一些。总的来说大计基这门课本来就这样，自己认真学，这个老师的课还是比较值得选的。
122730,1285,陈春晖,2020-03-26 10:15:31,2,4,2,上课挺无趣，没认真听过课，期末做练习卷很认真，最后得分4.2，还算满意
125263,1285,陈春晖,2020-09-05 04:07:10,-1,2,3,太坑了
125804,1285,陈春晖,2020-09-14 11:11:40,3,3,0,老师太好了！点赞！！！
125805,1285,陈春晖,2020-09-14 11:12:46,4,4,0,陈春晖老师真的很好！！！！蛮可爱的老师，上课认真听讲回答问题就会被记住！没考好还会询问一下情况，反正反正，无比感谢老师捞考最难试题的我！！！
125814,1285,陈春晖,2020-09-14 11:59:00,7,7,0,感谢老师海底捞！！！！！！！那场python特别难，理论过线但实验没对一题谢谢老师捞我！！！！！！！
125841,1285,陈春晖,2020-09-14 23:05:50,-1,2,3,我也是呵呵了，python后考的题目也简单，坑前面考的也都告诉你们了，还几个时间段的一起评分，群里问下这种行为是不是合理直接解散群聊？我？？？
125851,1285,陈春晖,2020-09-15 01:27:34,1,4,3,老师人还挺有意思，但是我是第一场考试，说真的，没感觉到根据难度差异捞人，后面简单卷也捞了，所以考最难卷真的很亏，Python这么低是完全想不到的。而且老师一被问就解散群聊，确实很尴尬
126529,1285,陈春晖,2020-09-29 07:51:37,-2,5,7,听完他的课，我彻底丧失了原有的对计算机科学的热情
127310,1285,陈春晖,2020-11-20 02:45:28,6,6,0,老师真的可爱
130813,1285,陈春晖,2021-01-24 16:55:08,12,14,2,cch老师还是很可爱的，不过他日常上课点人回答问题的习惯真的让本课堂自闭症患者十分不适（其实回答不出也没有什么）如果不想回答问题，一定要坐在教室中间那排，千万不要坐靠走廊座位！！1
131195,1285,陈春晖,2021-01-26 13:11:23,4,4,0,老可爱了，ppt真是补天人士的福音，经常说作业没做不给补，但还是会让同学们补作业
132638,1285,陈春晖,2021-02-03 04:20:54,2,2,0,感觉评分略低了\n\n平时分给的很高的，小测可以说是很开放了。\n\n上课比较佛，但大计基上课也不用很认真听。
133648,1285,陈春晖,2021-03-03 07:39:09,8,9,1,第一节就爱上的老师，可能许端清让我ptsd了
133961,1285,陈春晖,2021-03-10 15:40:48,4,5,1,我觉得还不错。
135957,1285,陈春晖,2021-06-05 10:58:58,1,2,1,平时分给得好，但教得一般，自学能力强的可以选，绝对不亏
136603,1285,陈春晖,2021-06-21 18:37:35,0,2,2,教得真的不太行...跟着他不如看书
137059,1285,陈春晖,2021-06-30 07:47:39,0,2,2,自学成才，然后挂科
137493,1285,陈春晖,2021-07-04 13:08:45,5,5,0,老师挺不错的啊，我感觉对同学也是蛮有耐心的而且很可爱。最后考的蛮烂的希望老师可以捞捞我（*/∇＼*）
139515,1285,陈春晖,2021-07-17 01:32:16,3,8,5,卡绩点，不让你差，也不让你拿高分
145220,1285,陈春晖,2021-12-28 10:06:43,-9,0,9,坑到我了，不喜欢
145729,1285,陈春晖,2022-01-01 04:44:45,26,28,2,客观地说，大计基这门课就是无聊的。\n\n陈老师不会布置那些形同虚设的实验作业和实验报告；\n\n不考的内容上课不讲，也不会多布置作业折磨学生。\n\n期末会开通通道让学生补作业。\n\n虽然课堂有点沉闷，但总体而言也算是为学生考虑了。\n\n个人觉得6.8的评分过低了。
147095,1285,陈春晖,2022-01-10 08:37:13,-14,1,15,不近人情
150318,1285,陈春晖,2022-01-22 09:52:31,5,6,1,计算机科学基础(A)：事情少，课后只有一些习题。上课quiz比较简单，做好了可以提前回去，很爽。讲到python部分会请人到讲台上做个很简单的编程题。每次上课坐在最靠近讲台的位置，最后拿了5.0。
151116,1285,陈春晖,2022-02-23 06:27:40,-5,1,6,就这？
151206,1285,陈春晖,2022-02-24 12:23:28,7,7,0,助教哥哥他好温柔...我哭死...
151407,1285,陈春晖,2022-03-02 13:40:25,8,9,1,期末提醒补交作业，平时作业少，事情少，作业期限长，最后给了4.5，是好老师。
151578,1285,陈春晖,2022-03-08 07:46:43,-11,1,12,这老师……不回答问题啊
152953,1285,陈春晖,2022-04-22 07:55:49,6,6,0,老师人真的非常好，每次都会去找老师答疑，会很耐心的讲解
153841,1285,陈春晖,2022-05-13 02:05:58,0,0,0,Python感觉挺适合自学的。上课讲得有点慢，不过听课也是能收获一些精妙的编程思路的。
154344,1285,陈春晖,2022-05-30 14:37:16,0,0,0,老师超级可爱
154345,1285,陈春晖,2022-05-30 14:37:16,0,0,0,老师超级可爱
154742,1285,陈春晖,2022-06-04 12:34:27,10,10,0,我感觉很好，不明白为什么评分这么低
158492,1285,陈春晖,2022-07-03 02:36:29,8,8,0,老师很好，给分也很好，点名还会提前在群里通知。上课讲课喜欢提问，不过没啥压力。而且讲解一些编程小窍门也很实用。\n\n助教xdb哥哥很帅(doge）
158839,1285,陈春晖,2022-07-02 14:51:40,1,2,1,挺好的，期末理论挂了，但是老师捞起来了
158882,1285,陈春晖,2022-07-03 04:01:58,4,4,0,老师很好的明明
159159,1285,陈春晖,2022-07-07 05:38:11,4,5,1,期末考试错得一塌糊涂，但是总评还是比我想象的高出不少。平时很佛系，期末很能捞，Python程序设计选陈老师就对了！
159167,1285,陈春晖,2022-07-07 09:09:25,2,2,0,认真负责，python教学很适合零基础的同学；上课会讲解习题，答疑很耐心，给分也挺捞的，冲！
159472,1285,陈春晖,2022-07-22 19:52:11,2,2,0,蛇形矩阵做不出来呜呜呜QAQ
160015,1285,陈春晖,2022-09-12 00:30:49,0,2,2,好老师，上课好，分数好
160016,1285,陈春晖,2022-09-12 00:29:33,0,1,1,好老师，上课好，分数好
163950,1285,陈春晖,2022-12-17 01:03:10,4,4,0,真的很好，很关心学生的老师哦
165721,1285,陈春晖,2023-01-09 11:55:35,2,2,0,上的是老师的大计基。老师上课内容有部分课本上的会考的，也有课外的python的内容，所以他的课内容比较多，对初高中以来没接触过信息技术的同学难度会更大。\n\n老师讲课时语速什么的有些慢，另外有一些地方会跳得比较快（小白不一定知道的内容）；课堂氛围会比较沉闷；一学期签到五次，三次是点名，剩下两次是参加小测算签到。大计基这门课还是不要松懈了，多看看课件，及时在pta上做练习。
166234,1285,陈春晖,2023-01-11 13:24:31,2,3,1,老师挺佛系的（个人感觉）建议那些有实力擅长自学的人来\n\n点名也很水，甚至会提前告诉你\n\n小测做的也是pta上的原题，挺水的\n\n还没出分，不知道老师捞不捞，但还是不错的\n\n就是今年改革改的太难了
167444,1285,陈春晖,2023-01-16 09:42:58,-5,3,8,一学期没听4.2，不用做rap 不用做实验
167494,1285,陈春晖,2023-01-16 16:12:31,8,8,0,老师人挺好，比较佛系，上课挺水，作业任务相当少，rpa不需要打卡，总体体验还行。\n\n另外不知道为什么钉钉问问题已读不回？重新问了一遍还是已读不回…\n\n但是前面评论区说的的卡绩是真的…老师还真就是会打85/88/91这种分数。虽然老师没有义务捞人，这样做无可非议，但是今年大计基课改以后事情变得有多又烦，又多了期中考（普遍分数不高），大家学的真的不容易…这种只差一点的感觉还是挺难受的。。
171724,1285,陈春晖,2023-04-03 08:34:35,-23,4,27,傻逼玩意，问他两个问题就开始骂人，从开始问到他起身就走一共不到半分钟，我都会了还来问你干嘛，问了你又不给我解答，你自己题出错了，哪来的脸啊，我在你骂完人直接走时说了声“谢谢老师”我自己问心无愧，你个傻逼玩意，做老师你配吗，活该你这辈子就是个讲师，我去问别的教授问题，别人都是耐心一点点讲，没时间的也都让我回头发钉钉或者邮箱，就你一个，谁上你课谁倒霉，你急着去投胎啊🙂
173243,1285,陈春晖,2023-05-16 13:32:18,2,2,0,最棒的老师！我的父亲！晖门～
174125,1285,陈春晖,2023-06-06 11:27:31,2,2,0,此生无悔入晖门
177967,1285,陈春晖,2023-07-06 01:22:24,4,5,1,老师人很好，但是小测真的很难，，，分数也是直接按小测换算的，，，给分并没有很捞，，，讲课的方式也很看人(我自己是听不懂，，，)能及格但是分数不高
180011,1285,陈春晖,2023-09-20 06:31:34,-4,0,4,最后一届，给分嘎嘎好
183802,1285,陈春晖,2023-11-30 07:34:13,4,4,0,老师看起来不太聪明（bushi），很可爱的，作业很少，点名会在群里提前说，上课只要不听就不会困啦，很好的一节沉浸式自修课（）
184229,1285,陈春晖,2023-12-13 11:27:49,1,1,0,还行。
185362,1285,陈春晖,2023-12-28 10:15:30,5,5,0,超好的上课轻松下课早，点名通知开卷考，快退休，爱喝奶的小老头，wwww
186079,1285,陈春晖,2024-01-08 08:13:27,-2,1,3,无聊，属于自学成才
186231,1285,陈春晖,2024-01-10 00:12:22,3,3,0,他为什么一分也不捞…..
186462,1285,陈春晖,2024-01-11 07:50:52,3,3,0,还有谁不知道老师要退休了嘛~
189262,1285,陈春晖,2024-01-22 16:00:09,0,1,1,上的大计基，老师上课一般不点名，点名会提前通知并使用他那独特的点名方式...虽然最后绩点比较低，但感觉bhh的卷子占很大的原因
189382,1285,陈春晖,2024-01-23 14:46:27,0,1,1,挺好的 不止7分
189540,1285,陈春晖,2024-01-25 14:31:40,0,0,0,无功无过的老师。今年考试题目改革，老师出了一份全是题库的模拟卷，真做期末考试的时候完全傻掉。如果想在python占比如此之高的新考试中获得高分的话还是准备准备自学吧。
190273,1285,陈春晖,2024-02-27 02:26:59,1,1,0,可爱的小老头，点名会提前说，小测也很宽松，平时分给的挺好的
198931,1285,陈春晖,2024-09-13 05:22:41,0,0,0,小老头python事少，点名还会提前通知，平时分给的慷慨，py这门课主要还是靠自己自学和整理，考试和任课老师关系不大；就这个方面看，小老头还是挺好的
10304,1308,金小刚,2015-11-18 03:53:21,5,12,7,有情怀的老师，讲课特别有煽动力(ฅ>ω<*ฅ)
10333,1308,金小刚,2015-11-18 06:12:21,16,22,6,演讲家。。感觉老师读过无数各种类型的书。。讲很多科学史很有副价值收获。。quiz有挑战。。
14931,1308,金小刚,2016-01-11 05:05:50,2,5,3,条理清晰！
15478,1308,金小刚,2016-01-14 14:49:30,1,3,2,长见识
15800,1308,金小刚,2016-01-16 09:51:10,4,10,6,很好的老师，平时做演讲多，讲课也条理清晰，更希望学生不拘泥于课内知识而是拓宽视野，可惜金老师的离散以后可能不开了
18636,1308,金小刚,2016-01-22 07:30:06,2,4,2,下课早哈哈哈，有情怀～
18833,1308,金小刚,2016-01-22 15:23:28,10,13,3,凭心而论，演讲水平是不错…不过到了计算复杂性稍微近一些的结果就无力了，更像是theory这边在做专业科普的
19446,1308,金小刚,2016-01-24 08:40:02,4,11,7,离散两次quiz，其余不点名，给分很好啊，讲的也很好。
30301,1308,金小刚,2016-07-01 08:23:19,3,4,1,思想史给分巨坑啊。慎选！
33822,1308,金小刚,2016-09-22 03:01:51,12,16,4,离散数学及人生理想
41236,1308,金小刚,2017-01-20 03:42:47,3,9,6,怎么说呢…离散数学这种课自己学的不扎实就不要怪老师给分不好了…
41339,1308,金小刚,2017-01-10 16:19:04,9,9,0,quiz难度大。期末占比70%。离散需要注重细节。否则分不会高。
41372,1308,金小刚,2017-01-11 06:03:38,2,2,0,指向哪里亮到哪里
45234,1308,金小刚,2017-01-20 12:36:09,13,19,6,讲得还好 给分也怪我自己比较菜 不过卷子真没必要出这么难呀 心塞 爆炸的?点打消了我出国的希望 …
45322,1308,金小刚,2017-02-09 01:36:02,37,52,15,之前“感恩戴德”那个首赞是我。很抱歉当时过于偏激，自己能力不够不是老师的问题，确实，离散自己没有学透没有人可以给自己背锅。老师的上课还是非常有启发性的，而不是仅仅局限于课本。一些基本的思想和方法都会教给我们，也许相比这门数学课知识本身，未来会更有益处。计算机无法解决所有的问题，从最简单的理论就可以证明。总之学到了很多。
45959,1308,金小刚,2017-01-20 09:55:03,2,4,2,……哈哈哈哈哈哈哈哈感觉自己的努力就是哈哈哈哈哈哈哈笑话
47168,1308,金小刚,2017-01-24 08:09:12,0,7,7,老师讲课清楚明白，还经常讲一些课外的个人观点，唯一就是给分严格，而且大头都在期末考试上。不知道是不是这一点戳中了某学院的g点上，评分直接掉了1.5分
47740,1308,金小刚,2017-02-22 21:30:14,10,11,1,复习计算理论那天差点郁闷到从阳台上跳下去。。怪自己蠢吧…
60104,1308,金小刚,2018-04-11 13:27:17,6,9,3,1.菜是原罪 2.上数学课要有上数学课的准备与态度
63332,1308,金小刚,2017-12-01 02:29:33,2,2,0,233
64956,1308,金小刚,2017-12-28 05:07:41,10,11,1,rebel king!\n\n
67444,1308,金小刚,2018-01-21 08:10:17,-1,2,3,讲的很清楚，给分也不错
67484,1308,金小刚,2018-01-21 09:59:20,-2,1,3,讲课很好 给分该多少就会是多少
67522,1308,金小刚,2018-01-21 12:06:26,5,6,1,演讲家，建议自学离散数学，上课水水手机，作业要认真做
71083,1308,金小刚,2018-01-28 02:39:24,-2,1,3,quiz应该重在参与，大头在期末，全看期末也说不定哦
71786,1308,金小刚,2018-01-29 03:05:53,4,4,0,计算理论应该还是看quiz成绩的 不然不会这么低
73229,1308,金小刚,2018-02-01 08:12:54,2,3,1,老师是好老师，就是拿分数很难。。。
73762,1308,金小刚,2018-02-03 05:13:46,2,5,3,男神老师，是我在大学见过讲课水平最高的一位
77075,1308,金小刚,2018-05-01 11:33:50,9,14,5,喜欢讲自己胜于讲授离散数学，妄自尊大，以为自己的经验能大于离散数学本身的意义
85692,1308,金小刚,2018-07-26 06:28:24,18,20,2,看了上面的评论总觉得不是同一个金小刚老师……给CAD实验室的金小刚老师疯狂打call！男神！有趣又要亲切！
87024,1308,金小刚,2018-09-20 03:27:48,7,9,2,怼天怼地，太能扯了，正式上课再回来改评价！
87972,1308,金小刚,2018-10-19 03:49:04,35,36,1,好，我们回到之前讲的
91592,1308,金小刚,2018-12-14 16:05:14,0,3,3,知识面宽，讲解深入浅出，对人生有影响
92597,1308,金小刚,2019-01-03 05:30:40,3,6,3,反正我是第一次听说有一门课一次quiz占10分的情况?比毛概还厉害
98449,1308,金小刚,2019-01-23 12:52:55,16,16,0,这不只一次quiz占10分，而是一道题占10分，总评的10分，如果这道题你感受不到他想让你干什么的话........? 讲课的重点埋藏在吹逼当中！每节课都能扯到同样的话题上......反正我是不太喜欢?
98553,1308,金小刚,2019-01-23 14:48:01,22,24,2,金老师上课水平是还好的，课外胡扯是巨多的，听一次可以接受，听一学期有点难受
99016,1308,金小刚,2019-01-24 07:03:41,1,1,0,挺好的老师，挺和蔼的233，我最后大作业做不完还打电话安慰我。但是，学计算机动画的学弟学妹记得，最后的大程，不要头铁，只有三四天就老老实实搞个简单的，要高分就提前搞。最后推迟了好久才交，赶脚分基本上都扣在这了吧QvQ心好痛
99083,1308,金小刚,2019-01-24 08:47:23,3,3,0,打个10分攒人品
99084,1308,金小刚,2019-01-24 08:47:46,1,1,0,人还不错
99407,1308,金小刚,2019-01-24 17:19:53,2,2,0,计算机动画很轻松就满了，老师人很好。
100806,1308,金小刚,2019-01-27 01:00:59,8,9,1,离散考试全是陈题……
102563,1308,金小刚,2019-02-08 10:31:34,21,21,0,那个说重点深埋在吹逼中的说的太对了，老师上课确实喜欢扯，但是该讲的东西其实都讲得挺好的，至少比某些老师自己都讲不清楚概念强多了。给了老师9分，1分被上课高度重复的那些梗吃了。
114951,1308,金小刚,2019-07-13 02:56:48,5,5,0,的确，具有批判性思维的老师
116603,1308,金小刚,2019-09-12 03:24:25,2,3,1,批判性思维
116666,1308,金小刚,2019-09-12 15:12:22,8,8,0,离散数学   周勇光
116955,1308,金小刚,2019-09-17 14:35:55,7,8,1,感觉有点杠精属性……
122096,1308,金小刚,2020-02-12 14:31:41,8,8,0,一个很想教我们一些人生道理的老师。内容也讲得比较透彻。但是一个学期都用那么铿锵有力的声音讲人生哲理确实有点难顶。
122830,1308,金小刚,2020-04-11 16:34:57,10,10,0,自命为社会公知的老师，心灵鸡汤式的上课体验，谜一样的小测（一次占总评10分虽然会调分），所幸给分还行。对了，期末考前微博答疑感受一下
130136,1308,金小刚,2021-01-18 02:50:32,3,3,0,演讲有点多但是该讲的确实讲清楚了，不想听演讲就看看书吧hh
132294,1308,金小刚,2021-01-31 14:46:59,-26,2,28,计算理论给分太香了
132310,1308,金小刚,2021-01-31 15:49:09,0,1,1,问了周围一圈都被卡了。。。可能确实不调分吧
132628,1308,金小刚,2021-02-03 03:20:00,3,3,0,DM期末和第二次爆炸，但是被狠狠捞了，谢谢老师\n\n看得出老师是真的热爱数学。唔线问题，希尔伯特，数学危机听了n次hhh\n\n离散数学还是很简单，如果和DS一起上还能互相复习。考前刷刷历年卷，会发现思路很多都类似。\n\n小测就算不会做也要写一点，至少表面你清楚一些基本概念。老师似乎扣分不重
132870,1308,金小刚,2021-02-04 08:48:12,5,5,0,计算理论：两次quiz，期末占比70%，尽量上课就跟着老师的节奏，作业及时做，不然后面的课就听不懂了...不要拖到期末再看\n\n回头看来一学期上的内容不多，不过很合我胃口，图灵机和可判定性那块内容很精彩\n\n老师水平挺高，感觉也没有传说中的胡扯很多，习惯就好，不过平时上课没有课间休息会比较难受\n\n给分嘛，70%都是期末的，自己看着办 ：）
140927,1308,金小刚,2021-11-21 19:14:44,9,10,1,第一次看离散数学：“什么鬼，咋还不讲定义和理论？无xian（一声）能念清楚吗？”。\n\n看去年的计算理论：“额，好像随便谈谈还很有趣，但别老翻来覆去说”。\n\n今年的计算理论：\n\n“逻辑是有边界的！”，\n\n“学习数学是学习思想，线代不仅有行列式，还有线性空间和线性映射！！”，\n\n“Computation不是Computer，深度学习只是逼近非线性函数！！！”。\n\n\n\n2021.11.22更：\n\n我在CFG的PPT里已经检查处三个错误了，怪不得我上课听不懂￣へ￣
141647,1308,金小刚,2021-10-19 03:35:15,0,2,2,其实老师上课确实是有内容的，我比较不喜欢的是他批判时事的时候用做讲座的口吻来回强调那几个观点，上课的时候正式内容跟公知部分大概五五开吧，建议大家上课看书，讲内容的时候抬头听听，这样会比较舒服
141790,1308,金小刚,2021-10-26 03:26:23,10,15,5,讲课的时候讲得是不错的，老师也挺有意思，但是自己看书也挺好；老师公知味很冲，每堂课必回忆往昔、批判社会（教育体系、媒体……）；有些话个人感觉引起不适……
143904,1308,金小刚,2021-12-11 16:01:12,1,2,1,好耶！
148448,1308,金小刚,2022-01-15 10:20:37,15,16,1,金尔伯特，我滴超人
148943,1308,金小刚,2022-01-14 04:03:08,3,5,2,挺多观念感觉和老师很像\n\n可惜不能选他当导师
149211,1308,金小刚,2022-01-14 23:03:30,-7,4,11,有口无心的自由派
149260,1308,金小刚,2022-01-15 01:44:35,9,11,2,刚哥 我的刚哥 为什么给分这么低啊
149540,1308,金小刚,2022-01-16 02:09:45,16,18,2,小金刚，永远的演讲家
153840,1308,金小刚,2022-05-13 01:49:00,-2,3,5,对比之下，小金刚已经是难得的好老师了，给十分，不解释
158400,1308,金小刚,2022-06-29 04:09:59,-27,5,32,上学期秋冬上的离散数学，忘记打分了，就凭他说屡次李云迪“瑕不掩瑜”也要给他打低分，价值观真的震惊我了
161554,1308,金小刚,2022-11-09 02:03:30,5,7,2,3.1415926532
163269,1308,金小刚,2023-02-23 03:01:03,32,35,3,2023挂科前夜，啥也不会但也学不进去\n\n来打个10分攒攒人品\n\n如果挂了，提前做好心理准备\n\n如果没挂，一周后来还愿。。。。。\n\n————————————————————————\n\n更：没挂，金老师神捞！计算理论大家别怕
164853,1308,金小刚,2022-12-27 03:08:57,5,6,1,你说的对，但是数学界三大危机……
168562,1308,金小刚,2023-02-19 13:16:47,2,3,1,。。。
168721,1308,金小刚,2023-02-21 11:26:39,4,6,2,后天考，屁也不会，打个10分攒攒人品
168851,1308,金小刚,2023-02-23 02:03:17,1,2,1,今天考，屁也不会，打个10分攒攒人品
169307,1308,金小刚,2023-02-25 10:44:12,5,6,1,图灵理论计算机科学导引选手，免听了去隔壁毛宇尘班蹭课。论文占10%，期末占90%，我平时也认真学了，期末考也觉得很简单，然后总评3.3。感觉是证明的各种操作没有被认可，如果后面有人选这门课，不建议免听。
169376,1308,金小刚,2023-02-25 17:22:22,1,2,1,老师人不错的，给分也还行，对照历年卷大力拟合完全没问题不用担心泛化性能，不过低调一点别免听
169628,1308,金小刚,2023-02-27 07:55:14,2,3,1,不如myc
169967,1308,金小刚,2023-03-01 00:11:08,1,3,2,感觉还可以吧，但如果不喜欢上课听废话就尽量不选他，给分反正不会特别好，个人感觉稍微有点低，不过可能也是因为两次quiz一次10分，期末70的缘故吧
169974,1308,金小刚,2023-03-01 00:26:52,13,14,1,离散给分和预期差距略大......
169977,1308,金小刚,2023-03-01 00:40:21,15,16,1,小金刚，小金刚，给分为什么这么差啊小金刚！
169978,1308,金小刚,2023-03-01 00:45:22,4,5,1,给分比较差吧，不建议选，助教比较摆烂
169983,1308,金小刚,2023-03-01 01:17:42,9,10,1,小金刚讲课水平还是不错的，但是给分很差，卷子偏向证明题，计院同学慎选，说多了都是泪
169990,1308,金小刚,2023-03-01 02:30:16,-1,2,3,给分一般
169996,1308,金小刚,2023-03-01 06:46:37,12,13,1,绩点杀手，给分烂，判卷子估计随便看眼就过了。我考完还以为能满的 看来是我想多了 这破课不如申请免修去考试 不免修小测占20还贼难 不知道给分如何 稀里糊涂拿个烂分滚蛋，
170102,1308,金小刚,2023-03-01 11:09:47,1,2,1,666
170110,1308,金小刚,2023-03-01 11:40:08,2,3,1,给分是真的不行 讲的也一般 一点都不会挑分 快跑
170111,1308,金小刚,2023-03-01 11:40:18,1,2,1,这平时分是不是有点少啊QAQ
174572,1308,金小刚,2023-06-14 08:11:02,1,4,3,给个5吧，下个学期可能又要小金刚的计算理论了\n\n上过他的离散，一点不会调分，考多少是多少，甚至出分时还被恶心了一下，细节不展开了\n\n讲课嘛不行，小测嘛贼难，总评嘛没有期末高\n\n但平时分似乎还是稍微捞了一下的\n\n但是怎么说比隔壁yyc强，总的来说中规中矩的一个人\n\n来他的课，就要抱着硬着头皮把数学真正搞懂并且熟练掌握、不犯小错误的决心\n\n建议把给分当成高考数学，足够恩币的话也是可以高绩点的\n\n不然就寄了，出分之后没有人谢谢老师是什么水平
183930,1308,金小刚,2023-12-04 03:49:55,-1,1,2,计算机动画，好好好
183951,1308,金小刚,2023-12-04 16:27:48,0,1,1,演说家
185023,1308,金小刚,2023-12-26 01:49:13,9,10,1,---所以我经常讲，我们能解决的东西其实是非常有限的，比如说。。。\n\n---诶，所以我经常建议你们不要想着什么都会，找到一样东西！把它做到最好！\n\n。。。\n\n---好我们回到刚刚讲的
185873,1308,金小刚,2024-01-05 06:46:09,7,8,1,最讨厌的一个事：冬天雪天的早八，在上课铃响的时候进教室（路上还因为着急摔了一跤），非得记我一次迟到\n\n讲课一般，而且很多时候不在讲课，翻来覆去地讲自己那屈指可数的公知观点，批判教育体系，听智云不知道按了多少次快进\n\n考试前3天留作业，不讲任何考试相关，基本得靠自己\n\n小测不提前通知，而且很难，判分又严，不捞人\n\n发消息也不回\n\n不好的老师，但是没有坏到极点，给3分
186482,1308,金小刚,2024-01-11 09:35:42,-1,1,2,被卡了
186483,1308,金小刚,2024-01-11 09:35:59,-6,2,8,期末很捞，要是提前通知一下小测就更好了
186485,1308,金小刚,2024-01-11 09:37:27,3,4,1,被卡了，一点不捞啊。
186489,1308,金小刚,2024-01-11 09:57:18,2,4,2,好吧，我就是因为计算理论得分太差了来差评一个呜呜呜
186490,1308,金小刚,2024-01-11 09:58:22,7,8,1,考完三天，作业都没到ddl就出成绩是吧，xxxxxx？上课谈键政，讲课不如myc的一根。把同学小测丢了，还有脸扣人家分。复习课重点划一堆，同学围着一圈问，说一堆烟雾弹。最后讲的都不考，体型大变。出分还行，但就是想骂人。
186499,1308,金小刚,2024-01-11 11:15:11,2,3,1,计算理论讲的什么玩意，扯皮两节课，期末快最后了还扯皮。
186508,1308,金小刚,2024-01-11 11:52:55,1,2,1,本来还以为给分很差的，结果意外的好。平时作业好像写了都满了，甚至最后一次作业没交已经出分，应该也是都算满的。唯一一次点名没到，但好像也没扣分。小测错了挺多，但最后平时分应该接近满了，可以冲的。
189379,1308,金小刚,2024-01-23 14:13:21,1,3,2,差点把我小测丢了。。
189814,1308,金小刚,2024-01-30 04:30:03,1,2,1,他真的 我哭死 给了我3.3 真的以为可能会挂科的
189817,1308,金小刚,2024-01-30 06:14:29,7,9,2,废物，弱智。
194480,1308,金小刚,2024-06-24 05:47:41,2,2,0,小金刚！！！！捞我！！！！！
196874,1308,金小刚,2024-07-05 17:11:41,2,2,0,总体来说讲的还可以，但是中间穿插了太多反复讲的东西。。。\n\n感觉也不怎么捞
199392,1308,金小刚,2024-09-23 01:13:18,3,3,0,主张用方程来理解经济活动的不是新古典经济学吗？？？
208177,1308,金小刚,2024-12-26 05:02:16,5,5,0,很适合开讲座，讲的很多内容都很有趣且有见解\n\n\n\n但不适合上课，时不时就发动被动技能——上课开讲座\n\n\n\n我上个厕所回来他就从小测答案讲到当今世界宗教冲突的问题了\n\n\n\n老师捞我😭
208581,1308,金小刚,2024-12-29 14:58:53,1,2,1,喜欢听演讲的有福了...\n\n上的计算理论，因此对老师也喜欢不起来，但是也不讨厌就是了\n\n不点名，但是有不提前通知的随堂小测。两节课连着上，中间不休息，但是会提前一点下课
209376,1308,金小刚,2025-01-05 19:09:45,0,0,0,早八考，看不懂一点，睡前打个十分攒攒人品
210015,1308,金小刚,2025-01-12 10:48:59,-12,2,14,非常好的老师！！救我狗命
212390,1308,金小刚,2025-01-14 02:52:20,4,4,0,老师讲课很有激情，但是规约今年没有重点讲。平时分不会捞满，我第一次小测没有答好，第二次应该满的，平时分总共被扣了4分，正好被卡绩了。\n\n\n\n如果想要分高一点还是最好上zq班的，平时分捞满。
212514,1308,金小刚,2025-01-14 06:08:20,0,0,0,7分吧，平时分扣了3分，两次小测都是历年原题居多，但还是扣了一档。期末80多也是3.9，讲课还行，但不如隔壁zq，也没那么坏
215177,1308,金小刚,2025-02-23 16:26:01,1,1,0,挺捞的，考试前一天身体出问题去医院没补天完，结果最后还是捞及格了。有两三次小测，基本就是留作业的下一周
219920,1308,金小刚,2025-06-11 05:56:46,0,0,0,上的离散数学H\n\n有一说一，金小刚在不脱口秀的时候上课还是不错的。但他的脱口秀实在太多，而且都是不着边际的，就比如将什么“AI场景太大”，可能是他演讲习惯了，毕竟外面一场演讲1w出场费\n\n\n\n上课建议：\n\n小测翻历年智云，基本都hit\n\n期末考感觉相似度也挺大的，可以去找几份历年卷（老师期末会发一份，但善于搜索应该能找到4份）\n\n平时不建议听课，建议回听智云，1.5倍速，跳过脱口秀部分（只要看他没翻PPT，干讲的部分，跳过就对了），这样一个多小时听完两小时课，仿佛还赚了
221510,1308,金小刚,2025-06-24 06:10:46,-2,1,3,先打个十分，小金刚捞我
221749,1308,金小刚,2025-06-26 02:43:41,-3,1,4,喜欢卡绩，无语了，捞一分很难吗
221774,1308,金小刚,2025-06-26 07:28:01,0,1,1,坐标离散数学，这门课知识量比计院的离散数学与应用少，最后的期末考试通过历年卷大力拟合也能过。至于给分我自己感觉应该还行，但是不要抱太大期待吧，中规中矩的老师。
222019,1308,金小刚,2025-06-29 02:22:45,0,0,0,xjg给分应该不能说是差，只能说是很随机，你如果分数高往往是不知道什么地方得分了，分数低往往是在你很自信的地方被扣分了，选他的话不要相信一分耕耘一分收获吧
61522,1325,华炜,2017-11-18 08:44:03,0,0,0,听了老师一学期的课！！很感谢！！上课很有激情，干货很多！
72533,1325,华炜,2018-01-30 10:07:47,0,0,0,老师给分不错，4.8还是很容易的
139579,1325,华炜,2021-07-17 13:30:07,0,0,0,总之强推游戏程序设计！
3756,1340,江浩,2015-06-17 03:24:59,4,5,1,忧伤
16273,1340,江浩,2016-01-17 15:45:53,3,3,0,正太心痛
19038,1340,江浩,2016-01-23 06:10:03,4,6,2,讲话温柔的太子爹，给分正常
64853,1340,江浩,2017-12-27 12:16:07,-9,4,13,傻逼老师 发音烂 摆架子 不理学生 问问题每次都不理人 傻逼
65473,1340,江浩,2018-01-04 08:56:34,6,7,1,老师很有见识
84594,1340,江浩,2018-07-13 09:07:55,-4,5,9,sb。
116014,1340,江浩,2019-08-30 05:05:34,0,1,1,老师半个月前就在课程群里发表令人恐慌的言论“大家看到成绩的时候可能会觉得有点surprise” 大家都以为要出分了，这都过了半个月了还没出成绩
117741,1340,江浩,2019-09-30 05:45:25,4,5,1,是个有点絮絮叨叨，又很温柔很耐心的老师。对学生特别好，同时也很宠娃……非常有学术的感觉。
121214,1340,江浩,2019-12-28 08:12:51,1,3,2,"指使人做事真的很强。从来不说一句嘘寒问暖。需求一天改几百回，但是也一直抓不住重点，的确是非常""严谨""的老师。没啥big picture，就喜欢抠细节。服了，学弟学妹千万别觉得老师开价大方就给他做事，不值得。"
47321,1368,陈文智,2017-01-25 08:53:53,0,4,4,很注重开拓学生的思维而不是拘泥于教学内容 很耐心 给分也好
54339,1368,陈文智,2017-06-29 06:21:15,2,3,1,感觉就那样
81213,1368,陈文智,2018-07-04 09:51:39,0,0,0,111
85990,1368,陈文智,2018-08-26 11:53:18,-1,1,2,还行不错
103820,1368,陈文智,2019-03-06 04:48:23,0,0,0,为啥没分
129630,1368,陈文智,2021-01-09 08:45:23,0,11,11,陈文智老师的体系没有上过，但是网上浙大的整个全套体系都是他领头的，可以说极大方便了我们的学习复习
135798,1368,陈文智,2021-05-26 08:15:57,-2,3,5,特别温柔可爱
136564,1368,陈文智,2021-06-21 06:14:42,-2,1,3,很喜欢上课抽人回答问题但是对于教学内容也很有耐心，实验课助教也挺好的！
145842,1368,陈文智,2022-01-09 11:29:15,1,8,7,作业很少，平时分给的很好。\n\n上课嘛，学期初很喜欢上课跑火车，讲的很细又很喜欢提问，所以进度很拖，最后两周讲了6个PPT，很重要的内容混在另外几章只考一两道选择题的内容里。\n\n比别的班少了复习课，要选他的体系的话最好有比较好的信息搜集和自学能力，有别的班的同学跟你分享他们班的复习课资源和练习题会比较好，不然我觉得有点难应付考试，毕竟他自己上最后一堂课的时候都不太清楚期末会考什么，所有练习加起来只有几次上课做过的三道题小测。\n\n\n\n出分了！！！陈老师我的超人！！！
147386,1368,陈文智,2022-01-10 01:55:56,-4,5,9,讲课进度虽然慢但是讲的很清楚，上课喜欢摇人回答问题。最后没有复习课，需要去听其他班老师的。助教人超好，实力也很强。最后给分也不错
147399,1368,陈文智,2022-01-10 02:37:23,0,3,3,陈老师授课感觉听起来不是很清晰，而且喜欢提问让同学回答问题。\n\n但是给分好香啊~
149183,1368,陈文智,2022-01-14 16:05:26,-2,4,6,讲很好 冲！
149580,1368,陈文智,2022-01-16 04:44:24,-5,3,8,陈老师我滴超人!!!
149765,1368,陈文智,2022-01-16 23:19:39,-5,2,7,讲的很细致，会讲解分析例题\n\n没有作业，没有复习课\n\n但是每节课必摇人起来回答问题，轻则三四个，重则二三十个，每周大概率会有课上小测
150053,1368,陈文智,2022-01-18 14:32:12,1,3,2,上课喜欢抽人回答问题，个人感觉讲得没有很好，平时没有作业，但平时分很好拿，社恐别选，社牛可以选
161226,1368,陈文智,2022-12-27 06:01:13,-7,1,8,老师每次上课都会小测。并且有难度。\n\n做小测的时候建议：\n\n1.打开当堂课的PPT，在PPT中查找知识类题的答案。\n\n2.计算题建议尽量往复杂里想（因为不是很清楚），同学回向老师提问一些不清楚的题设或者答案格式，但是老师不一定每次都会答对。\n\n\n\n2022.12.27 更新：\n\n老师在学期初说过点名“不扣分，只加分”。不过他现在点名的时候会登记未签到的情况（扣不扣分，还是把已加的分扣回去还不知道）
163259,1368,陈文智,2022-12-11 12:09:16,21,23,2,傻逼老师\n\n就你想线上是吧
163329,1368,陈文智,2022-12-13 05:48:05,30,31,1,原来是利益相关，难怪坚持线上。。。
163365,1368,陈文智,2022-12-14 02:06:01,24,26,2,傻逼老师\n\n利益相关\n\n不线下\n\n滚
163574,1368,陈文智,2023-01-02 08:17:00,20,21,1,就你想线上恰烂钱是吧
164898,1368,陈文智,2022-12-27 11:46:12,11,13,2,sb老师，能不能去死一死啊
164903,1368,陈文智,2022-12-27 11:58:40,15,17,2,希望你子女也烧到40度被迫参加考试🙏
164904,1368,陈文智,2022-12-27 11:59:12,15,16,1,谢谢您啊花60w买这个好系统🤮
164907,1368,陈文智,2022-12-27 12:25:45,1,8,7,sb老师，找人弄死你全家
164913,1368,陈文智,2022-12-27 13:19:13,6,7,1,花60w买了依托答辩?
165351,1368,陈文智,2023-01-02 08:17:32,3,4,1,？？？？？？\n\n为什么这么懒啊
165354,1368,陈文智,2023-01-02 10:32:58,4,5,1,花了60w就买了坨答辩恶心大家，我真的谢谢您嘞
165367,1368,陈文智,2023-01-03 06:38:12,7,8,1,本来不想来评论的\n\n线上考体系被这答辩系统给整不会了\n\n你没事吧
171184,1368,陈文智,2023-03-17 16:14:59,1,1,0,有点难受
171196,1368,陈文智,2023-03-18 04:40:32,1,1,0,等出分，好慢啊...
171219,1368,陈文智,2023-03-19 09:16:53,3,5,2,给分比较香
171221,1368,陈文智,2023-03-19 11:02:01,1,2,1,体系结构。讲课很一般，但是课上的例题会详细讲，对于考试大题以及理解知识点很有帮助，上课会点人回答问题（加平时分），最后：给分超级无敌好！！cwz我的爹！
171278,1368,陈文智,2023-03-20 13:06:03,2,3,1,满了，给分超人
171281,1368,陈文智,2023-03-20 23:10:36,5,7,2,老师讲课还是比较详细的，考试考的重点部分的例题也会详细讲解，每节课都有学在浙大小测，会随机抽人回答问题。助教也很nice，实验验收很负责。最后，给分太香了～
172687,1368,陈文智,2023-05-04 11:46:09,1,2,1,讲课给分都很好
181606,1368,陈文智,2023-10-24 05:49:59,1,1,0,研究生课程来说，是我见过最认真讲课的老师，讲的也很好很仔细
185098,1368,陈文智,2023-12-26 08:58:29,0,0,0,讲课略显无聊繁琐，但相当清楚，体系前几章计组已经学过，但还是讲了很久，可以不用听，后面可以认真听
188119,1368,陈文智,2024-01-18 08:36:56,2,2,0,给分超人我哭死，所有quiz和发言都是bonus，没有作业，助教gg也超好😭
188129,1368,陈文智,2024-01-18 08:50:11,6,6,0,单论体系这门课，汶潪哥虽然上课比较水，但对体系结构的认识还是很深的。比较多地跟学生互动问问题感觉也是他想确保我们学到体系知识的方式（虽然确实占了不少课堂时间）。最后期末更不用说，浓浓师生情，古希腊掌管体系的神！\n\nBTW，也同样给本学期的宋助教哥哥打65535分，认真负责又全知全能的暖男！！！
188213,1368,陈文智,2024-01-18 12:04:04,0,0,0,我就问，有没有见过quiz算bonus的老师。\n\ncwz老师讲课节奏比较慢，但是举例很多，新手友好，而且给分十分非常好！
189402,1368,陈文智,2024-01-24 02:37:05,0,1,1,给分是超人中的超人
199474,1368,陈文智,2024-09-24 08:01:06,6,6,0,赛博陈文智，没上过他的课的强烈建议看看他每节课智云课堂的前几分钟
199883,1368,陈文智,2024-10-06 11:39:09,12,12,0,上课太水了，一半的时间放在点名提问+赛博生命+脑残quiz上，根本没讲什么内容
201118,1368,陈文智,2024-10-29 04:34:36,3,3,0,研究生课，无话可说，
208659,1368,陈文智,2024-12-30 13:45:08,2,2,0,yysy，老师真的很温柔很负责，很符合我脑子里老教授该有的风度和形象，虽然赛博数字人确实水了一点，但感觉整体氛围还是很轻松愉快的（不过最后几节课就是在飙车）\n\n\n\n很后悔全程摸鱼只能靠智云课堂补。。。下辈子不会了
208785,1368,陈文智,2025-01-02 02:34:04,5,5,0,老师人很稳重儒雅，但是讲的是一坨，难点抽同学讲，上课玩学在浙大新功能，导致进度落后其他班两节。不过总体还行，一是助教人特别好，二是平时分加分很多，三是虽然他讲的不行，但常瑞讲的很行，听她的课就行。
208838,1368,陈文智,2025-01-02 10:46:06,0,0,0,老师和助教都挺不错\n\n期末考是真细啊，把quiz的细枝末叶都搬上来了，其实我都不记得有这个题了
212806,1368,陈文智,2025-01-15 03:11:37,0,1,1,因为平时要签到和提问，每节课都要去现场（）算是平时花费精力最大的课程了（大三）最后出分还是蛮不错的🫡，自己期末也觉得考的蛮好的，最后结果也很满意，推荐大家来选！！！
213774,1368,陈文智,2025-01-19 17:34:36,0,0,0,‎‎‎
214148,1368,陈文智,2025-01-25 15:48:54,1,1,0,每节课随机点名，所以必须线下去教室。上课前半学期节奏很慢，花很多时间玩学在浙大的新功能（话说回来氛围还挺轻松的），后半学期疯狂赶进度。会随机叫人回答问题，不过老师儒雅随和，即使站起来说“老师我刚才没听课”也没问题（大概\n\n但是这些都无所谓了，因为cwz给的平时分是神。实验的stz助教人也超级好。总体下来感觉cwz班的体系还是很不错的。
214432,1368,陈文智,2025-02-03 04:23:03,2,2,0,是本科生的计算机体系结构课。上课天天玩学在浙大，这学期并没有像前人说得那样对某些知识点讲得有条理，全都讲得很一般，因为玩学在浙大导致讲不完的知识点就飞一样的带过。预习作业和讨论题目等等都是AI出的，参考价值极低，不要在这上面浪费时间，问清楚哪部分算分就好。小测一般是课件上的例题改的。但是上课回答问题可以加平时分，这点还是不错的。今年考试应该是cr老师出题，所以复习的时候应该参考她的ppt，也出了很多她的原题，相比之下这学期看cwz的ppt就没啥用。但后面就不一定谁出了，所以在期末复习之前要打听好哪个老师出题，然后看对应的作业、小测、课件等。这学期大部分课程的给分实际上都是靠助教，请各位同学事先打听明白，如果助教里面没有stz学长，cwz就有丧失给分好这唯一的优点的风险了。
853,1372,周建平,2015-03-18 01:05:36,194,206,12,你说你开心不开心\n\n
967,1372,周建平,2015-03-19 15:31:57,29,33,4,好开心啊
1198,1372,周建平,2015-03-21 16:31:45,13,19,6,为学生着想
1797,1372,周建平,2015-03-25 04:12:12,88,91,3,那我成全你
1896,1372,周建平,2015-03-26 04:44:28,22,31,9,老师上课真的很好笑，很负责，讲得比较清楚，尤其复习阶段，给一些资料帮助复习，很喜欢。
1955,1372,周建平,2015-03-27 02:07:59,113,121,8,对此我只能表示遗憾
1988,1372,周建平,2015-03-28 03:09:34,1,2,1,挺搞笑的
2213,1372,周建平,2015-04-09 03:13:46,21,24,3,股市达人
2488,1372,周建平,2015-05-04 13:14:24,57,60,3,你说你开心不开心
2525,1372,周建平,2015-05-04 13:27:56,15,15,0,对此我们只能表示遗憾
2598,1372,周建平,2015-05-04 15:55:55,17,17,0,题好多，你说你开心不开心。
2666,1372,周建平,2015-05-05 04:40:16,50,56,6,今天我的股票又涨了!花了股票挣的钱给你们印了卷子!你说你开心不开心!
2878,1372,周建平,2015-05-10 07:56:16,45,47,2,格式刷，刷一刷\n\nctrl c Ctrl v\n\n你说你开心不开心
3047,1372,周建平,2015-05-13 06:57:23,16,19,3,我口袋里有东西ヽ(´･д･｀)ﾉ
3127,1372,周建平,2015-05-15 08:17:10,18,24,6,楼上们都好搞笑哈哈哈哈 不过周建平怎么说呢。。给分真的很一般很一般 社科生学java最要是为了学分吧 选个别的老师吧
4850,1372,周建平,2015-06-29 17:29:46,1,2,1,人不错
5182,1372,周建平,2015-07-05 14:39:16,29,33,4,你就说你开不开心\n\n\n\n那我只能表示遗憾
6312,1372,周建平,2015-07-13 02:29:58,-1,2,3,很棒的老师，给分我不知道，反正我对我的成绩挺满意的
6313,1372,周建平,2015-07-13 02:40:59,-3,3,6,你说你开心不开心~大计基预置的 就森森的折服在老师的口才下2333java退了预置还选了他 事实咳分数证明不能再正确
6318,1372,周建平,2015-07-13 02:54:46,-24,12,36,我很讨厌他
6320,1372,周建平,2016-12-22 03:59:10,10,13,3,好老师，很逗很认真，虽然我绩点一般，但是很喜欢他
6330,1372,周建平,2015-07-13 04:37:39,0,5,5,是一二两节课 他中途不休息 但是我们好困的说\n\n
6515,1372,周建平,2015-07-14 15:10:49,9,9,0,可爱的小老头
6521,1372,周建平,2015-07-14 15:54:53,-3,3,6,给分好啊锕锕锕锕
6619,1372,周建平,2015-07-16 12:58:24,4,5,1,挺喜欢周老师的，上课很搞笑，你说你开心不开心…
7117,1372,周建平,2015-09-03 05:18:54,-1,1,2,蛮可爱的老师 很认真负责 给分很实在
7259,1372,周建平,2015-09-12 10:17:17,-10,2,12,老师挺逗的，而且经常早下课，不错
7330,1372,周建平,2015-09-13 14:56:34,0,1,1,好玩
8055,1372,周建平,2015-09-17 00:28:56,-1,0,1,好玩的
8057,1372,周建平,2015-09-17 00:44:02,7,9,2,那么我们就说有开这门课的必要
8677,1372,周建平,2015-09-24 02:36:14,-1,2,3,你说你开心不开心
8699,1372,周建平,2015-09-24 07:31:07,0,2,2,你说你开心不开心
8717,1372,周建平,2015-09-24 09:54:34,0,2,2,口头禅：如果你还是听不懂，但我只能表示遗憾。上课还行，绩点靠自己努力。
9342,1372,周建平,2015-10-22 09:25:35,-2,0,2,同志们
9535,1372,周建平,2015-10-29 08:46:24,79,81,2,如果有一天你手机掉了，请买华为
10437,1372,周建平,2015-11-18 18:08:53,15,15,0,同学们，如果你手机掉了，一定要买华为，支持国产，一定要买华为
10711,1372,周建平,2015-11-23 02:38:59,17,17,0,有的同学说没有听懂，那怎么办？那你就当我，哎没有讲过。你说你，潇洒不潇洒
10946,1372,周建平,2015-11-23 12:07:34,8,10,2,几乎每次的大计基作业都要做一天，你说你开心不开心
11259,1372,周建平,2015-11-26 03:33:58,3,4,1,可以拖课到下节课上课\n\n
11296,1372,周建平,2015-11-26 10:40:08,-1,0,1,如果你还是不懂 那就当我没讲过好了～
11561,1372,周建平,2015-12-05 13:20:23,-17,10,27,这tm就是个傻逼，不能再傻逼，原谅我爆一下粗口
12269,1372,周建平,2015-12-22 16:16:47,0,1,1,好开心
12289,1372,周建平,2015-12-24 02:28:45,-1,0,1,好开心\n\n
12587,1372,周建平,2015-12-24 01:59:25,-24,10,34,什么啊！！讲的差！脾气差！还苛刻要求！什么都讲不明白还留那么多作业！讲课没有耐心！问问题不回答还会骂你！！！给分呵呵了！拖堂！上课连PPT都念不明白！！
13060,1372,周建平,2015-12-24 16:20:38,7,8,1,你开心不开心 0椰00椰（01001）对此我只能表示遗憾
13160,1372,周建平,2015-12-25 03:48:08,0,3,3,我就问你开心不开心啊？如果我讲了三遍你还不懂，你就当我，从来没有讲过
14389,1372,周建平,2016-01-06 17:07:19,0,3,3,作业超级少，不写论文不写报告！但是——表示上课时云里雾里根本听不懂好吗？还会时不时的来点小惊喜，抽同学上台做题或者回答问题。超级随意！你说你开心不开心？！
14504,1372,周建平,2016-01-07 09:41:32,3,3,0,不能吃饭了。。没时间
15225,1372,周建平,2016-01-13 01:16:45,-1,0,1,上课很好玩……
15406,1372,周建平,2016-01-14 09:03:15,5,6,1,给分太一般了
15475,1372,周建平,2016-01-14 14:32:51,0,1,1,╭(°A°`)╮
15807,1372,周建平,2016-01-16 10:04:46,1,2,1,我总是心太软，心太软~喜欢调戏360加速球。
17403,1372,周建平,2016-01-20 07:30:43,-1,0,1,用华为，我支持国产。
17404,1372,周建平,2016-01-20 07:31:52,0,1,1,老师很可爱 你说你开心不开心
18224,1372,周建平,2016-01-21 09:58:32,-1,0,1,啦啦啦
19753,1372,周建平,2016-01-25 09:44:31,14,14,0,一个班15%左右的人要补考
19769,1372,周建平,2016-01-25 09:00:22,0,2,2,哦呵呵
20054,1372,周建平,2016-01-26 03:37:46,3,4,1,烦人啊
20066,1372,周建平,2016-01-26 04:18:56,4,4,0,你说开心不开心
20973,1372,周建平,2016-02-06 02:25:43,3,6,3,给分太不好，讲课讲不明白
21553,1372,周建平,2016-02-29 07:31:44,4,4,0,如果你还是没有听懂，那就当我没说过一样，你说你开 心 不 开 心。
22550,1372,周建平,2016-03-08 01:50:02,2,3,1,开心吗
23400,1372,周建平,2016-03-29 02:28:12,4,8,4,笑面虎
25361,1372,周建平,2016-05-16 03:20:12,3,6,3,个人觉得上课效率低，不如自己看书
28066,1372,周建平,2016-06-28 08:03:42,-1,1,2,人很好，讲得也很细
28221,1372,周建平,2016-06-28 08:17:29,0,2,2,我总是心太软心太软~~
31683,1372,周建平,2016-07-04 13:02:37,-3,0,3,好老师，讲的真好
31687,1372,周建平,2016-07-04 13:13:07,4,6,2,难过，学的那么认真，感觉掌握很不错，绩点低的想哭，老师给分能不能好点
31897,1372,周建平,2016-07-05 06:11:43,-8,1,9,认真听觉得他讲的很好，反正我满了
31903,1372,周建平,2016-07-05 06:25:16,0,1,1,记得练平时系统就好
31924,1372,周建平,2016-07-05 07:18:43,0,5,5,超级喜欢老师，听他上课总有一种莫名其妙你就懂了的感觉。课程节奏安排合理，上课氛围也很轻松愉快，让我这个文科生从怕java变成习惯java。人文的孩子真的是要大大地安利。口头禅楼里都有，就不重复了（真的太好笑了）。最后还要夸一下助教，简直是流露出王霸之气。
31965,1372,周建平,2016-07-05 08:48:49,-1,1,2,这老师超萌哒～虽然是室友的老师，但是蹭过课，好喜欢这个java老师^_^所以过来打个十分
31966,1372,周建平,2016-07-05 08:48:51,-2,1,3,怪我辣鸡，拖了老师后腿，但是我们老师拯救了我们全宿舍，我说我很开心
32566,1372,周建平,2016-07-08 00:24:45,1,3,2,老师我猴开心啊！！
32794,1372,周建平,2016-07-14 04:12:18,2,3,1,如果你听不懂我前面说的，就当我没说好不好啊。
32801,1372,周建平,2016-07-14 11:01:33,-4,3,7,就给你94，就不让你满，你说你开心不开心\n\n
32859,1372,周建平,2016-07-19 05:07:34,0,2,2,上课纪律好严，玩手机睡觉都会被点。给分不水。也就这样吧
33263,1372,周建平,2016-09-17 05:14:53,-3,0,3,感觉还好吧
33611,1372,周建平,2017-01-16 11:36:36,-1,1,2,棒棒哒
33613,1372,周建平,2016-09-20 09:26:34,-1,1,2,那些出国的同学，我希望你回来，回来~
33924,1372,周建平,2017-01-20 06:11:08,8,10,2,老师上课很风趣，但是感觉没有基础的话上课根本学不到东西？期末总结复习还是很详细的，可以说是整个学期能学到的东西基本都在了，比起平时课堂要好很多。给分一般，只能表示遗憾。
34461,1372,周建平,2016-12-27 06:25:06,-2,1,3,爽，很可爱
35786,1372,周建平,2016-11-10 08:09:50,3,4,1,不注重形式注重实质，与学生互动性强，经常上课的时候叫人上去演示没学过的东西。讲课内容和课本内容有不同。
36235,1372,周建平,2016-11-11 07:16:21,7,7,0,老师很搞笑，但是上课不用话筒是干啥啊………听不太清
36429,1372,周建平,2016-11-13 11:58:09,6,7,1,你说你开心不开心   我就是心太软 心太软 独自一个人流泪到天亮
36631,1372,周建平,2016-11-15 06:31:34,-1,2,3,他总是心太软，心太软。老师很给力啊！
38731,1372,周建平,2016-12-16 00:19:46,4,6,2,大jj的作业非常多，还说自己作业布置的很少，说自己心太软。上课经常安利华为。觉得氛围很奇怪。
38983,1372,周建平,2016-12-27 07:21:46,2,7,5,辣鸡老师
38984,1372,周建平,2016-12-20 07:28:56,-4,1,5,良心老师。。。搞笑。。。好玩。。。相对而言作业少，可以选哦
39449,1372,周建平,2016-12-23 01:03:07,-1,1,2,开心不开心
39516,1372,周建平,2016-12-23 12:32:07,-2,1,3,你说你开心不开心
40865,1372,周建平,2017-01-14 10:42:49,1,3,2,还比较用心负责，幽默风趣
40897,1372,周建平,2017-01-06 06:40:42,-1,2,3,虽然上课有点云里雾里的感觉，但是期末给你总结的超好
41423,1372,周建平,2017-01-16 13:26:41,4,6,2,事情多死，给分好？
42401,1372,周建平,2017-01-14 06:27:42,-2,1,3,不用写实验报告万岁
43453,1372,周建平,2017-01-16 09:47:30,1,2,1,你说你开心不开心？老师给分宽一点吧～
45742,1372,周建平,2017-01-20 13:31:08,22,28,6,给分奇烂，作业交齐，考试都会，只有2.4。讲课认真倒是认真，但有的关键地方觉得你是文科生就不用学。不会给你讲清楚。除了复习资料挺仔细以外，逻辑性不是很强，给分迷，人好，但看你怎么看。一直说让你把这门课送过去就好，过了就好，感觉有种应付这门课的感觉。以及，给分迷。按照他的计算公式给自己计算分数怎么算都应该在85分以上，已发邮件询问给分理由但一直不予回复。GG。无所谓了，均绩勉强还能承受这个2.4的分数。班里15%还挂了呢。呵呵。
45752,1372,周建平,2017-02-28 02:36:18,10,12,2,上课不错，给分。。。别提了
45760,1372,周建平,2017-01-20 04:41:22,18,18,0,我只能说我挂科了
45764,1372,周建平,2017-01-20 04:57:52,-8,2,10,文科生，上课一直没认真听，最后把书看了两遍刷了模拟题，出来的绩点挺好的。老师上课有口头禅hhh还蛮照顾文科班的感觉，绩点也不知道是不是师生情。平时实验作业多。总体上说老师蛮好的。
45786,1372,周建平,2017-01-20 05:46:08,3,4,1,心累，大计基学科有什么用
46000,1372,周建平,2017-01-20 11:12:16,17,19,2,作业前几个星期几乎没有，然后突然连着好几个星期都有大作业，作业的话主要以实验为主。我觉得他最好的地方就在于他不会像其他老师那样要求又繁琐又没什么用的实验报告，从而为你节省不少的时间。至于上课的话，比较水，但不允许玩手机。可能由于课程性质原因，讲得略凌乱。建议预习后再听，这样可能效果更佳。对学生态度非常不错，经常叫学生回答比较难的问题，但错了也不会怎么样，讲课比较幽默。
47276,1372,周建平,2017-01-25 04:49:33,11,11,0,明明认真学了还拿了个哔了狗的绩点我就hhh
47671,1372,周建平,2017-02-15 12:38:52,8,10,2,笑面虎，给分很烂，上课讲讲故事看这人很好，期末给分真心路人水平。
47979,1372,周建平,2017-02-28 01:06:46,0,2,2,同志们，同志们，你说你们开不开心
48532,1372,周建平,2017-03-07 01:19:10,0,2,2,好烦 要去上机的
48575,1372,周建平,2017-03-07 14:21:13,11,15,4,给分奇烂无比，我一个计科的学生，平时认真做每个作业，最后的大作业ppt也很认真做了，期末考复习了两天（平时也一直有看，而且相关的内容我也都自学过），考试时候四十分钟搞定全做出来了，最后3.9...平时的确讲的不错，但这给分你确定没给错？老师你让我拿什么爱你...（ps：同一学期选的竺院c语言我拿了5.0）
48590,1372,周建平,2017-03-08 03:47:45,5,7,2,看到大计基分数简直傻了.....感觉复习的最认真的一门.....莫名其妙啊感觉。看了评论之后发现好像得分都不高...平时上课根本听不下去，我都是自己好好预习的...幽默...幽默吗？我觉得上课好无聊啊真的。平时下课还会和一些同学聊聊炒股票。
51038,1372,周建平,2017-05-15 03:51:55,8,8,0,拖堂严重，今天拖了半小时
51112,1372,周建平,2017-05-18 01:10:43,-1,1,2,老师看似很逗，其实讲的挺好的。认真听会有收获。
52353,1372,周建平,2017-07-06 00:15:00,1,4,3,很好的老师呀，上课只要仔细听都能听懂，偶尔还会开玩笑逗学生，超棒的老师，一开始还担心老师给分会很随意，担心努力付之东流，最后显然是我多虑了，棒棒哒老师～～^_^
52876,1372,周建平,2017-06-23 09:26:22,-3,0,3,挺好的。。。。
54283,1372,周建平,2017-06-29 03:14:08,1,3,2,挺好的，老师很搞笑………最后的成绩出乎我意料啊
57160,1372,周建平,2017-11-09 08:54:38,12,13,1,垃圾老师 给分太差
57198,1372,周建平,2017-07-06 04:22:02,8,8,0,作业多，给分坑，没依据，不建议
57219,1372,周建平,2017-07-06 04:59:24,6,7,1,java实验过了，59分挂科。呵呵
57229,1372,周建平,2017-07-06 05:28:18,4,4,0,很有意思   但是要靠自己学
58021,1372,周建平,2017-07-23 14:25:40,3,6,3,上过他的大计基和java 从未听过课经常翘课但是期末复习很用力所以考的都不错 老师是看考试成绩给的分   会上传各种习题的答案 自己也会总结知识点   我觉得蛮好的\n\n\n\n其实这些完全靠自学   我们寝室java都满绩
59018,1372,周建平,2017-10-17 06:53:22,2,5,3,你说你开不开心
59731,1372,周建平,2017-09-26 08:28:23,4,5,1,我们关上门来偷偷说
60461,1372,周建平,2017-10-21 07:49:32,14,15,1,表达不清楚，对实验作业要求很模糊，听不懂在说什么，有些不合时代了吧。\n\n
60553,1372,周建平,2017-10-24 03:11:43,12,13,1,垃圾 别选 真的 上课重点讲的很模糊 作业也布置不清楚 废话很多 喜欢拖堂 中间5分钟不下课 去问他题目 态度还很差
60835,1372,周建平,2017-10-31 03:35:44,5,7,2,从来没有休息从来没有准时下课过，课又说得很快，你说灰心不灰心
61033,1372,周建平,2017-11-07 07:39:17,-4,2,6,哎呀我点错了，你说灰心不灰心？
61155,1372,周建平,2017-11-09 08:58:04,5,7,2,垃圾老师，给发太差
64193,1372,周建平,2017-12-28 05:13:26,6,11,5,听他上课真的不舒服，讲课讲不清楚就算了，我理解每个老师能力不同，但是他连作业都布置不清楚，要做哪些实验都没说清楚就卖萌，还经常说我总是心太软，而且上课经常羞辱同学，让同学上台演示然后羞辱，师德也不行，能力也不够，就这种老师在浙大还混得下去，唉
64822,1372,周建平,2017-12-27 08:57:19,0,1,1,你说开心不开心\n\n为此我深表遗憾
64955,1372,周建平,2017-12-29 03:45:38,14,16,2,莫名奇妙布置了一个小测，考前告诉我们要看网上题库，花了四五小时背下题库后，一看试卷完全不一样，结果说不考题库？？？？？我去你的吧！然后还是不记成绩的开卷考，一群人狂翻手机   学弟学妹千万不要选他的大计基  血的教训！大计基老师评分都是虚高的  怀疑跟技术部有py
66271,1372,周建平,2018-01-14 11:40:49,0,2,2,今天发现老师要退休了…\n\n\n\n虽然挂了我的java不过还是很可爱的老师\n\n\n\n祝老师退休生活愉快吧
67238,1372,周建平,2018-01-31 03:33:57,6,7,1,为什么没有零分\n\n
72743,1372,周建平,2018-01-31 04:21:28,-9,2,11,谢谢老师让我强行满绩
72746,1372,周建平,2018-01-31 04:30:40,0,2,2,你说你开心不开心，虽然低飘（因为是机盲的原因再加上不好好学）感谢师生情，但是老师还是很温和的，大计基虽然没听懂过，但是他是肯定很认真的，因事未参加小测验老师也没有对你特别那啥，还很有耐心的给你资料啥的，很不错的，大计基就选这个老师吧
72747,1372,周建平,2018-01-31 04:31:00,3,3,0,平时觉得人也挺随和的 总说这一点学分的课你不要花太多时间blabla\n\n作业实验都认真做了 最后绩点也不高\n\n人还好吧 但是给分真的一般 慎选
72780,1372,周建平,2018-01-31 05:27:35,5,5,0,老师上课很幽默，态度挺好。就是给分太迷，一直不交作业不来上课的分数比一只交作业做思科的还要高，这门课时间花费最多绩点太低让我怀疑以后人生，太不公平了。
72887,1372,周建平,2018-01-31 09:10:55,3,6,3,上课还蛮搞笑，也挺有个人风格的老师，期末有复习和资料，虽然未免派上大用。上课其实真的听得半懂，考前好好复习了一波，绩点还能看，摸着良心说并不绩杀，虽然给分确实不是非常好。作业，略多，略多。不过大计基的作业不少老师都布置得较多。挺注重学生的实际学习和用处，也比较喜欢老师的观念。还行，还行。
72924,1372,周建平,2018-01-31 11:07:41,2,6,4,4.2还行，感觉自己也就这水平，心里还是有点数的。至于对周建平这个老师怎么评价，因人而异，他是上课讲的是有点迷，但复习的时候资料给的还是不错的。如果是你自己没下功夫看书和做习题，烂了，又怪的了谁？
72927,1372,周建平,2018-01-31 11:24:59,6,6,0,只想说，你是挺开心的，我的绩点真尼玛不开心。平时都抄我大作业的同学分都能比我高，我表示非常遗憾啊。
74014,1372,周建平,2018-02-04 06:09:54,7,7,0,同意楼上，这个老师简直是让我无语了，我一个同学课一次没上，最后3.9，我每次上课记笔记，实验认真做，考试也挺高，最后3.3，而且屁事很多，其他老师基本都没的东西他全要求，最后考试又不考，真的是智障
74325,1372,周建平,2018-02-11 03:14:37,-1,2,3,你死了
74949,1372,周建平,2018-03-07 00:15:34,1,2,1,辣鸡，给分差，不清晰，不懂标准在哪里玩，没学就提问，别选
75239,1372,周建平,2018-03-08 06:45:53,0,1,1,我的心不再软……
75264,1372,周建平,2018-03-08 08:40:42,-1,0,1,很好的老师啊
76145,1372,周建平,2018-03-28 02:31:29,1,1,0,给分迷\n\n
82910,1372,周建平,2018-07-09 09:53:08,0,0,0,给分真的迷真的不好啊……
2747,1381,孙建伶,2015-05-06 17:01:46,14,15,1,感觉讲的不错，幽默有趣的老师
3078,1381,孙建伶,2015-05-13 12:10:20,6,7,1,好老师~赞！
4654,1381,孙建伶,2015-06-25 15:51:56,42,49,7,讲课认真生动 助教姐姐特别美( •̀∀•́ )
4761,1381,孙建伶,2015-06-28 02:21:33,10,11,1,老师讲得好！人也好！
10321,1381,孙建伶,2015-11-18 05:28:18,4,5,1,棒棒棒
13738,1381,孙建伶,2015-12-30 13:16:15,1,2,1,棒极了！！！
15717,1381,孙建伶,2016-01-16 07:31:39,0,1,1,不错的
22170,1381,孙建伶,2016-03-03 00:52:46,9,10,1,老师上课像讲相声一样自己讲的很high，所以能把很深奥的概念讲的很清楚有趣。太赞了
27203,1381,孙建伶,2016-06-23 13:24:44,8,10,2,老师很风趣！上这门课感觉很欢乐！
27939,1381,孙建伶,2016-06-28 06:40:15,7,8,1,幽默风趣，深入浅出的好老师！认真讲的又透彻，而且十分文艺！
27953,1381,孙建伶,2016-06-28 07:11:42,7,8,1,讲课超级好，助教姐姐认真负责，实验要求中等的吧，想水右转高云君，但是孙老师是真的讲得好
28204,1381,孙建伶,2016-06-28 08:15:40,3,4,1,老师上课非常认真有趣，给分也很不错，计院难得有这样的好老师了
31015,1381,孙建伶,2016-07-03 06:15:39,6,7,1,老师讲课超级好，而且是个大龄文艺青年（大笑），总之很有魅力
50296,1381,孙建伶,2017-05-02 08:10:33,13,14,1,虽然自己很菜还是打个十分。是专研数据库的，讲起前沿娓娓道来，有的时候也会加些额外的作业，大学老师会做这个，绝对是责任感的体现。另外上课的各种说辞也挺神的。“你们不要笑naive，naive是一种姿态！”“暂时先不能讲了，不行了，我要先 插入 一下，这个插入很重要啊”hhh是我的问题吗……
52126,1381,孙建伶,2017-06-15 03:41:11,5,6,1,前排表白助教GG！
56526,1381,孙建伶,2017-07-04 02:44:42,4,5,1,很帅很文艺的老师，讲课很生动有趣，助教哥哥也很帅很负责任。
57343,1381,孙建伶,2017-07-07 01:22:19,6,7,1,妓院两年来碰到的最好的老师，一个是翁姐姐另一个就是孙老师了
57377,1381,孙建伶,2017-07-07 05:07:25,2,3,1,大学教师的典范！！
74673,1381,孙建伶,2018-03-05 05:09:39,3,4,1,哇 才发现老师是个男的诶（帅一脸
80372,1381,孙建伶,2018-06-25 14:31:02,5,6,1,从来没有期望过计院老师能讲这么生动这么负责的课  跪求老师多开课啊啊啊啊啊
81805,1381,孙建伶,2018-07-06 08:25:57,3,4,1,老师很棒。可惜我一个学期都没怎么认真学，谢谢师生情。
81929,1381,孙建伶,2018-07-06 13:29:25,2,4,2,老师讲的特别清楚 给分也很好\n\n
82639,1381,孙建伶,2018-07-09 01:39:10,2,5,3,出卷子也太坑了
82979,1381,孙建伶,2018-07-09 11:45:34,6,8,2,老师给分很良心了。不过数据库这门课内容真的很多，下半学期老师讲的飞快，需要花很多精力自己巩固。如果你课表很满就还是要慎选的。
112754,1381,孙建伶,2019-07-05 02:14:01,-42,1,43,老师对待学生态度有点恶劣。
112993,1381,孙建伶,2019-07-05 17:18:54,0,0,0,讲得很不错 很有趣 期末考没考好 没看往年卷 一道12分的大题全都错光了...最后成绩还是挺满意的 觉得老师开学quiz对最后期末写一些查询的代数表达式的帮助真的很大
113395,1381,孙建伶,2019-07-06 16:18:32,4,4,0,我一直以为评分5以上的老师都差不多，直到我遇见了孙老师。甩其他老师两个大段的讲课水平，给分也超好（minisql被坑逼队友放了鸽子的菜鸡如是说
116196,1381,孙建伶,2019-09-06 02:50:40,4,4,0,讲课很有逻辑，课堂习题也很经典，效果很好
120205,1381,孙建伶,2019-11-24 01:52:15,5,5,0,【数据库】讲的很清楚也很生动，打个分（顺便试试查老师还能不能评论
123371,1381,孙建伶,2020-06-07 13:01:19,2,2,0,今年网课，摸索在线上课的方式花费了很多精力，效果很好。但孙老师总是期盼着同大家见面，直到最后也没有见到。我们又何尝不是如此期盼呢！
123540,1381,孙建伶,2020-06-09 13:50:46,7,8,1,这个还是有点微妙的喔~
123707,1381,孙建伶,2020-06-12 06:01:20,3,3,0,老师讲的很好，人也很好。不过每节课小测和点名实在顶不住;)
123861,1381,孙建伶,2020-06-15 07:27:07,3,3,0,数据库系统，疫情期间在家上网课，每节课点名。不像有些课我看回放好几遍还是似懂非懂，孙老师真的讲的超级清晰细致！！！虽然还没期末考，但课程结束了，特来夸夸讲课质量
125089,1381,孙建伶,2020-08-30 12:23:31,0,0,0,考前复习，听课太舒服
125414,1381,孙建伶,2020-09-08 09:07:30,0,0,0,讲得很好
134447,1381,孙建伶,2021-03-29 03:55:29,4,5,1,非常好！
138332,1381,孙建伶,2021-07-08 14:14:17,17,19,2,孙老师讲课清晰透彻，对数据库开发理解很深刻，每节课都有quiz或者讨论让大家强化理解，大程的实验课会专门安排大家讨论设计方案自己提出修改意见，可以说是自己进入计院以来遇到的第一位讲课水平，技术能力，负责和课程安排都无可挑剔的老师了，期末给分也相当好。虽然数据库这门课的考试可以说完全是八股文现代版（dddd），但从孙老师身上真的能够学到很多东西，真的很幸运这学期能选上孙老师的课！
139386,1381,孙建伶,2021-07-15 03:38:50,9,10,1,计院数据库最好的老师。讲课最好，正常完成任务平时分都能满。隔壁gyj虽然水，但是真的学不到东西，期末很多人白给，sjl yyds
154624,1381,孙建伶,2022-06-02 13:17:56,4,4,0,老师和助教都很负责 特别是在做大程的时候 助教几乎都是秒回和有问必答 老师上课讲的也很仔细和透彻
154905,1381,孙建伶,2022-06-06 15:42:27,12,15,3,孙老师的上课水准大家有目共睹，就不多评价了。但这学期的助教ycjgg实在太强了！以一人之力撑起了整个数据库课程的教改（传说中的minisql），虽然可能给很多同学带来了痛苦，但我相信到最后还是颇有收获的。另外实验报告也不鼓励卷，只要要点写到基本都是给满的。
156087,1381,孙建伶,2022-06-23 09:27:53,12,12,0,sjl老师没10分在座的各位都有责任
157445,1381,孙建伶,2022-06-23 09:01:18,5,5,0,讲课超级认真，给分也好好！！！
157477,1381,孙建伶,2022-06-23 10:56:47,6,6,0,孙建伶老师讲课水平真的没话说！！一学期下来真正学到了很多知识\n\n而且老师人很好，很温暖，给分也超好！！
158307,1381,孙建伶,2022-06-28 08:25:11,9,9,0,楼下的，我给10分了，我没责任（雾\n\n虽然不是孙老师班上的，但是作为忠实的孙老师智云观看者，非常感谢孙老师和智老师一学期的教导\n\n还要感谢今年的助教给我们带来了框架，不得不说复习oop的时候很感谢minisql写了些东西\n\n虽然一学期学数据库感觉是两年以来学过的最让我发困的课了（也许对我来说书上只有最不起眼的sql注入能提起一点兴趣），但是我觉得浙大需要更多孙老师这样负责的老师，老师不仅是大教授，而且对待教学如此认真，真的很值得很多老师学习。希望孙老师退休前还有更多学弟学妹能选到孙老师的课，珍惜这样的好老师吧！
158458,1381,孙建伶,2022-06-29 12:28:04,1,1,0,隔壁班的来评价了\n\n从index部分就跑路到孙老师的智云了www老师讲课特别特别清楚，真是羡慕死了\n\n感觉在孙老师班上能学到很多真东西，而不只是八股文
158659,1381,孙建伶,2022-07-01 04:31:47,1,1,0,孙老师这都不能10分？绝绝子！真是气得我跺jiojio！老师真的好！超级负责超级和蔼给分也很好！
158897,1381,孙建伶,2022-07-03 05:04:50,1,1,0,给孙老师和ycjgg满分！
171798,1381,孙建伶,2023-04-06 02:21:34,8,8,0,上课讲到了CMU和国内课程的差别，正视了差距，很求是，更是浙大少见的在教学上用心的老师。
172178,1381,孙建伶,2023-04-21 14:42:29,13,13,0,UPDATE instructor\n\nSET salary += 114514\n\nWHERE name == 'sunjianling'
174591,1381,孙建伶,2023-06-14 10:11:30,1,1,0,讲课真的很好
174944,1381,孙建伶,2023-06-20 08:57:47,8,8,0,你说得对，但 MiniSQL 是浙江大学数据库的大程，大程框架和文档来自助教的爆肝，在这里，你将扮演一个开发者，逐步发掘“最受计院学生欢迎 Project”的真相
174965,1381,孙建伶,2023-06-27 09:33:18,-103,0,103,评论消失术！\n\n/\n\n/\n\n/\n\n/\n\n/\n\n/\n\n/\n\n/\n\n/\n\n/\n\n/\n\n/\n\n/\n\n/\n\n/\n\n/\n\n/\n\n/\n\n/\n\n/\n\n/\n\n/\n\n/\n\n/\n\n/\n\n/\n\n/\n\n/\n\n/\n\n/\n\n/\n\n/\n\n/\n\n/\n\n/\n\n/\n\n/\n\n/\n\n/\n\n/\n\n/\n\n/\n\n/\n\n/\n\n/\n\n/\n\n/\n\n/\n\n/\n\n/\n\n/\n\n/\n\n/\n\n/\n\n/\n\n/\n\n/\n\n/\n\n/\n\n/\n\n/\n\n/\n\n/\n\n/\n\n/\n\n/\n\n/\n\n/\n\n/\n\n/\n\n/\n\n/\n\n/\n\n/\n\n/\n\n/\n\n/\n\n/\n\n/\n\n/\n\n/\n\n/\n\n/\n\n/\n\n/\n\n/\n\n/\n\n/\n\n/\n\n/\n\n/\n\n/\n\n/\n\n/\n\n/\n\n/\n\n/\n\n/\n\n/\n\n/\n\n/\n\n/\n\n/\n\n/\n\n/\n\n/\n\n/\n\n/\n\n/\n\n/\n\n/\n\n/\n\n/\n\n/\n\n/\n\n/\n\n/\n\n/\n\n/\n\n/\n\n/\n\n/\n\n/\n\n/\n\n/\n\n/\n\n/\n\n/\n\n/\n\n/\n\n/\n\n/\n\n/\n\n/\n\n/\n\n/\n\n/\n\n/\n\n/\n\n/\n\n/\n\n/\n\n/\n\n/\n\n/\n\n/\n\n/\n\n/\n\n/\n\n/\n\n/\n\n/\n\n/\n\n/\n\n/\n\n/\n\n/\n\n/\n\n/\n\n/\n\n还不赶紧去把minisql搞完
175214,1381,孙建伶,2023-06-22 12:28:36,3,3,0,数据库就是看着您的智云学的 讲的真的太好了！！！！\n\n羡慕选上孙老师课的同学 必须10分打上！
176053,1381,孙建伶,2023-06-27 13:51:20,25,25,0,上面刷屏的那个你是不是觉得自己很幽默？？
176075,1381,孙建伶,2023-06-27 14:44:22,2,2,0,老师讲课非常非常清晰，这在数据库系统的老师里面是非常难得的！老师人也很好，给分也很不错！\n\n另外希望数据库系统课程能改进得更合理，MiniSQL可以不再如此折磨众生。
177570,1381,孙建伶,2023-07-03 18:07:20,0,1,1,老师很好，就是minisql太坐牢辣
193090,1381,孙建伶,2024-06-03 11:12:09,5,5,0,又是一学期了\n\n\n\n数据库请无脑选sjl老师\n\n他是我见过的第二位将自己与学生平等看待，非常尊敬每一位学生的老师，第一位是经济法的zlm老师\n\n也是我见过能将这么生硬的数据库知识讲得这么生动的老师\n\n如果没选到sjl老师，也强推听他的智云\n\n计算机学院不可多得的优秀教师
193315,1381,孙建伶,2024-06-06 07:23:56,0,0,0,助力老师10分，讲课很好，实验很有意义，完爆诸多专业基础课念ppt的老师、老旧的实验内容。
194789,1381,孙建伶,2024-06-25 12:03:05,14,15,1,从不点名，quiz会开放一个星期\n\n人善心好，体贴学生，生怕同学们听不懂\n\n喜欢和同学们开玩笑，而且很有文艺青年的风范\n\n他还说，听说同学们把DB期末考叫八股文，很伤心。。。\n\n\n\n\n\n数据库的孙建伶，计组的林芃，ADS的杨洋\n\n三位都是计院难得的真心体贴同学们生怕学生听不懂的老师\n\n三位老师都有要了签名，好幸福
195585,1381,孙建伶,2024-06-29 02:08:24,0,0,0,nice
195891,1381,孙建伶,2024-06-30 14:30:14,1,1,0,Nice
196106,1381,孙建伶,2024-07-01 16:03:10,6,8,2,孙老师认真负责、谦和礼貌，每次《资料库系统》上课前必先问候“同学们下午好”；他水平精湛，对资料库相关知识常有深刻而独特之见解，授课层次分明、架构清晰，而非生搬硬套、照本宣科之方式；他关注学生需求，上课不硬性点名，作业题量不大、且以主观思考类型为主，随堂测基本当堂预留时间思考后会现场分析，后面几周的课后测试会开放直到期末；他思想深刻，曾表示学生称考试为“八股文”使之甚为伤心（此次考试引入不定选，竟去八股之风），并称其开课办学实为学生非惟传授知识、更乃提升对资料库以至计算机科学之Insight，谆谆教诲，久久难忘。此外，孙老师颇有“先生”之风范。该课程给分较为理想，自以为对得起付出的努力。\n\n本课程之Lab是一项非常significant的任务。前四个Lab较为简易；第五个（图书管理系统）开始，难度倏忽增加；第六个（MiniSQL）或是大学期间最大的工程之一，参考CMU CS15-445之BusTub，后来上《资料库》的同学请切莫大意拖延！
216620,1381,孙建伶,2025-03-19 09:43:55,1,2,1,我爸爸级别的
216909,1381,孙建伶,2025-03-28 17:17:10,1,1,0,时间过去了很久，孙老师已经退休了，在此补充一条评论，希望能铭记真实响应同学需求，珍惜毕业生建议，认真课程改革的孙老师和应承峻学长。
221744,1381,孙建伶,2025-06-26 01:17:13,1,3,2,爸爸级别的，应该是数据库上课体验最好的老师。
221750,1381,孙建伶,2025-06-26 02:47:05,0,1,1,10分
221758,1381,孙建伶,2025-06-26 04:41:52,0,1,1,真神，上课有一种长辈的睿智与关怀
221760,1381,孙建伶,2025-06-26 04:46:30,6,7,1,出分了，群里没有人谢谢老师
221822,1381,孙建伶,2025-06-26 12:59:21,0,0,0,数据库真神，计院少数用心讲课，希望同学们学到东西的老师
221897,1381,孙建伶,2025-06-27 08:33:58,0,1,1,老师人很好，但是给分真的不好，期末考试太严格了
221906,1381,孙建伶,2025-06-27 10:17:50,1,1,0,数据库这门课，又要小测又要作业又要随堂测试又要讨论又要小实验又要大实验又要大程还要考试，干最多的事，拿最低的分。老师人还是很好的
847,1387,吴健,2019-06-14 04:21:08,19,22,3,很有趣的老师，会给学生一大堆srtp课题
22738,1387,吴健,2016-03-10 09:50:13,9,10,1,好萌的老师
22740,1387,吴健,2016-03-10 10:37:17,7,8,1,超可爱的语速超快的老师，会讲很多前沿的科技给我们听，希望能让我们找到自己真正喜欢的东西而不只是码代码
25099,1387,吴健,2016-05-05 09:06:13,2,4,2,超爱吴建哥哥!!!!给分特别特别好!!!!
35332,1387,吴健,2019-03-31 05:38:15,-2,3,5,老师很棒！
50761,1387,吴健,2017-05-05 03:08:04,4,4,0,…………
50771,1387,吴健,2017-05-05 06:00:26,4,4,0,无语……
50805,1387,吴健,2017-05-05 15:43:27,3,4,1,好老师，课水但是认真听对未来发展有影响
51004,1387,吴健,2017-05-11 19:03:47,2,3,1,人是真的好，给分也是真的好。就是上课真的觉得有点水，不过感兴趣的话讲到自己喜欢听的还是有超多收获的
78984,1387,吴健,2018-05-18 15:52:44,1,2,1,感觉课讲的挺好 课不点名 上机课也不用去 期末随便做个啥 交个6000字报告 基本就是一个大水课了 感觉听听还是挺有趣的 收获的东西也是非常前沿的 给分还行 但没有觉得很好 可能是最后做的东西被dl碾压了吧 讲道理没有平时分的东西还是很虚的 倒是隔壁信安课以为要崩结果还不错
106657,1387,吴健,2019-04-28 19:25:54,-1,1,2,人很好，助教也很好，课很水，但是愿意听还是能发现不少好点子。给分按照最后的大作业给，果然厉害的人还是很多，我们组水水做了个微信小程序也是允许的。给分超级好～
106921,1387,吴健,2019-04-30 08:45:02,-1,0,1,老师人很好 就是大作业其实比较难 不过感觉的出来大家真的都很厉害做出来的东西都超出老师预期 所以老师可能很开心给分超好
122069,1387,吴健,2020-02-10 21:35:51,-1,1,2,课很水，给人感觉他很有头脑。。
123293,1387,吴健,2020-05-30 08:16:11,2,2,0,这学期服科导不仅出分慢，给分也莫名其妙。。。。。
123708,1387,吴健,2020-06-12 06:02:40,-1,1,2,水水过，为学弟学妹贡献一个4.5数据点
131808,1387,吴健,2021-01-29 04:07:02,1,2,1,服务科学导论大水课，平时完全不用去听，就最后三人一组写一个wx小程序啥的大作业就行，给分超级好
151757,1387,吴健,2022-03-14 23:48:06,0,0,0,1111
153586,1387,吴健,2022-05-05 08:24:14,-2,1,3,给十分！上课内容还是挺有意思的，会给人一些启发，可听可水。最后考核是6000字论文和大程，给分非常非常好，强推！
153587,1387,吴健,2022-05-05 08:31:58,5,6,1,给分很迷，作业量巨多，一个短学期的课要完成小程序+pre+6k字研究报告（不明白前面说水的是怎么个水法...），努力与回报不成正比，over
153594,1387,吴健,2022-05-23 05:15:15,2,2,0,垃圾课，给分迷
153606,1387,吴健,2022-05-05 14:44:12,0,3,3,课程论文大写特写csgo，要求虽然是6k字，但我实际上只写了4k不到，依然给满了（99）。感觉老师确实是更关注内容是否有趣、是否是自己想的，而不是一些其他的形式。
153615,1387,吴健,2022-05-06 03:42:30,3,3,0,可以水水过，但要做好被绩杀的准备。给分完全看作品对不对老师口味，毫无规律可言。在乎绩点的慎选。
153851,1387,吴健,2022-05-13 06:17:49,3,3,0,快跑！
154767,1387,吴健,2022-06-05 01:53:08,1,2,1,感觉老师还行\n\n学期初因为比较闲听了两次课，还是有点意思的，当通识课听就挺好\n\n两个大作业，一篇报告+一个小程序/网页之类的\n\n感觉有的同学做的挺好，我因为没什么时间写网页小程序就直接把自己的个人博客交上去了（\n\n报告写了一个我觉得挺有意思的idea，虽然这个idea在目前是完全没有实现可能的，最后也满了\n\n我觉得老师可能更看重服务模式的创新和商业模式的创新，这两者是我听的那两节课里感觉老师更想传递给我们的东西
158376,1387,吴健,2022-06-29 00:49:23,1,1,0,给分迷，慎选
180572,1387,吴健,2023-09-23 04:03:02,1,1,0,本科生上上课就算了\n\n研究生，特别是直博的，快跑
7872,1417,张明敏,2015-09-16 01:09:17,7,10,3,细节会反复讲，虽然不是很重要的东西就讲得有些乱。实验比较轻松。
32275,1417,张明敏,2016-07-06 05:27:09,2,3,1,讲得超级仔细！还会讲一些应用，比如硬盘为啥要分区，操作系统为啥要在空的硬盘上装之类的...事情也很少，实验也很轻松，给分又好！超级棒的老师！
47741,1417,张明敏,2017-02-22 21:34:22,0,0,0,老师人很好啊，做实验的时候很体贴人。。
52809,1417,张明敏,2017-06-23 04:19:30,1,3,2,学术水平有待提高\n\n
57020,1417,张明敏,2017-07-05 07:43:20,1,3,2,会花式点名，核心知识点我们听不懂的时候给我们再讲一遍，实验任务比青松轻松很多，给分好，总体强烈推荐选张老师的计组
57073,1417,张明敏,2017-07-05 12:00:38,5,5,0,张老师讲课很细，quiz多，虽然网上有答案，但是建议诚实做搞懂，期末会有大收获，最后真的给分很好
57190,1417,张明敏,2017-07-06 03:23:07,11,13,2,客观的说，老师讲得比较乱，听上去容易一头雾水，但可能硬件课就是这样吧。老师态度挺好，给分也不错（虽然嘴上从来不说覆盖还会偶尔刺激下我们，但算是很为学生着想了）最后就是quiz很多，实验的话比较轻松。
57289,1417,张明敏,2017-07-06 11:19:37,11,14,3,老师人挺好的 作业，quiz都对考试挺有帮助的 答疑啊，上课啊什么的都很平易近人。虽然改期中试卷有点严，但最后给分相当良心；不过老师上课有时候会讲不清楚东西 就好像你距离弄懂概念只隔了一层窗户纸，但听老师卖力讲半天之后，这层纸还在那里，甚至可能会变厚。但当你课上或者课下，自己看看书，会发现其实大多数概念还是好理解的 个人感觉课上老师讲的方向也不错，但就是让人感觉不畅快。可能也是我自己的预习不到位吧
61404,1417,张明敏,2017-11-16 10:43:07,24,25,1,计院quiz女王——张mm??
64106,1417,张明敏,2017-12-21 03:51:42,0,1,1,挺不错的
85367,1417,张明敏,2018-07-17 09:08:37,1,2,1,强烈推荐张老师计组！！！
99207,1417,张明敏,2019-01-24 11:51:34,4,4,0,表白实验课助教小哥哥?
104501,1417,张明敏,2019-03-22 00:47:00,0,0,0,来，我们聊聊天嘛
104502,1417,张明敏,2019-03-22 01:10:59,2,2,0,卖挂吗？我反汇编贼6～
105539,1417,张明敏,2019-04-16 09:32:17,15,15,0,老师好像很喜欢火车，特别喜欢
108830,1417,张明敏,2019-06-03 04:57:11,2,2,0,老师好像还很喜欢王者荣耀里的小乔。
114311,1417,张明敏,2019-07-09 17:39:55,1,2,1,老师人还是不错的，注意上课偶尔会点名，本学期无quiz\n\n课有时候讲的不是很清楚，但是讲的其实很慢（计组来来回回也没多少东西）\n\n个人体验给分较为一般\n\nhqj实验给分真的好低……
114342,1417,张明敏,2019-07-09 23:12:25,11,12,1,给分真的很不好 不知道哪来的推荐 隔壁姜晓红班50人20多个90分以上 这个给分真的差的不行
114364,1417,张明敏,2019-07-09 23:49:25,6,8,2,数逻不清楚，计组给分太差了，学习帝显示均绩3.3你敢信这是硬件课的均绩？hqj实验给分巨差
117007,1417,张明敏,2019-09-18 07:08:12,3,3,0,很一般
120957,1417,张明敏,2020-01-19 03:27:25,2,3,1,好评！老师给分太棒了！！！
125490,1417,张明敏,2020-09-10 10:58:15,9,10,1,我本来懂的，听她讲完不懂了
126233,1417,张明敏,2020-09-20 11:04:17,2,2,0,计组给分实在糟糕
126760,1417,张明敏,2020-10-19 04:04:22,1,1,0,机组讲课就中规中矩吧，但是经常答非所问\n\n给分的话感觉认识的同学没有特别差的
139224,1417,张明敏,2021-07-13 10:48:09,0,0,0,老师讲课挺好的，比较清晰，重点也会着重讲，喜欢打一些神奇的比喻。平时有小测，每节课要么随机点名要么按作业本签到。计组给分真挺一般，比预期的低5分...
139597,1417,张明敏,2021-07-18 04:34:30,2,2,0,挺好的 事少分高
141516,1417,张明敏,2021-10-13 03:06:16,5,7,2,不知道在讲什么，很迷惑。
148696,1417,张明敏,2022-01-13 08:42:35,3,4,1,感谢老师捞我，计科菜鸡真的不太会，但老师还是捞了我！上课每次都去，小测马马虎虎，考试不太好，本以为过不了了，没想到老师救了我！感谢老师，事少分好。
150693,1417,张明敏,2022-02-13 11:36:01,1,4,3,和别的班比，事情确实是少的。老师人很和蔼，上课会有一些神奇的比喻，但是必须指出硬件课是需要自己自学领域的，学会了就觉得很简单。实验的话洪老师人很ok，师生情。数逻最后一题没看懂，20分以为自己炸了，最后91分4.5
153793,1417,张明敏,2022-05-11 07:04:56,3,6,3,讲得乱七八糟不如看书，照着ppt都能睁着眼睛说瞎话乱讲半天才被指正，有时候下面听的也被绕蒙了没发现错误，我看着都尴尬
153946,1417,张明敏,2022-05-17 14:31:22,17,21,4,计组，上课爱提问也就算了，回答不上来还扣分是什么意思😅😅😅你不会以为你自己讲的很清楚吧
154396,1417,张明敏,2022-05-31 17:40:58,4,6,2,只能说是遇到的老师中比较讨厌的一位了
155484,1417,张明敏,2022-06-13 12:56:04,-13,3,16,不是吧，提问不会不是自己的问题吗。都到期末复习了看着答案都回答不出，连题目都不知道问的是哪个，也能怪老师？硬件老师其实都差不多，已经算中等讲解水准了。
155901,1417,张明敏,2022-06-22 15:19:11,2,3,1,考后一般般
157257,1417,张明敏,2022-06-22 15:33:20,-3,7,10,老师超好！讲课算得上是比较清楚的，作业不多，事情少，上课会随机提问，但是不难，小测也比较有用，给分超好！计组和数逻都是张老师和hqj，给分好，强推！
157259,1417,张明敏,2022-06-22 16:12:27,2,4,2,数逻计组都是张老师的，客观评价讲得很一般，给分也很一般。当然跟我自己菜有很大关系，但hqj的实验给分比别的班确实低好多，毕竟都是大学分课，刷分慎选。
157262,1417,张明敏,2022-06-22 16:26:21,5,5,0,低分水过，谢谢老师捞捞
158656,1417,张明敏,2022-07-01 04:24:02,1,2,1,讲课差强人意，喜欢打许多奇妙的比喻，对于计组这么抽象的课来说挺好，然而整体效果比较有限。\n\n上课会通过收作业点名，还比较喜欢请人回答问题，不太能摸。\n\n实验老师hqj和张给人感觉差不多，就是人和给分还行，水平有限，因此作业实验绩点感觉都正常。\n\n\n\n评价：不是最好的老师，但对于计组这种很需要靠自己的课，不是不能选。
160103,1417,张明敏,2022-09-13 07:50:44,3,3,0,老师上课讲的啥啊，听的我好迷惑
167724,1417,张明敏,2023-01-18 15:25:02,-5,2,7,上课其实不用怎么听，老师讲的也听不太懂，自己好好学quiz好好做就行。不知道老师怎么捞的，但最后喜提满绩。
167737,1417,张明敏,2023-01-18 16:53:55,6,6,0,数逻：\n\n缺点：讲课包括我在内应该有比较多的人听不下去的，就讲课来说应该不如隔壁的蔡铭和马德老师。上课用中文，考试用英文体验不太好。会用交上去的作业本当点名并随机点人回答问题，上课也不太好摸。除此之外hqj的实验指导近似于没有，还会额外增加一些实验要求，实验课体验也不太好。\n\n优点：给分好，这学期应该捞了很多人；作业少，课后一次只有几题；小测里是历年期末题，质量还可以；人也不错，一直笑眯眯的，该通融的都会通融。\n\n总结：上她的数逻很容易就抱着“混一混”的心态然后一学期过去没学什么到期末心态爆炸（比如我），但是如果能借助各种资源自学的话其实还是比较好拿高分的。上她的课注意寻找和利用资源自学（比如两倍速听老师的回放然后看别的老师的复习ppt进行梳理）就行，分不会差
169892,1417,张明敏,2023-02-28 08:49:47,5,5,0,一坨shit，典型的计算机学院的老教师。能力，视野，教学，科研，都很差。赶上时代的红利才能站到讲台上。
171241,1417,张明敏,2023-03-20 03:15:02,2,2,0,讲课依托答辩，先不说讲的好不好（不好），很多东西还都是不对的，在天马行空的拓展中暴露出缺乏的生活常识，常常前后矛盾怀疑根本不备课。速速我和加入马德神教，听马德智云保平安。
178588,1417,张明敏,2023-07-15 14:55:59,0,1,1,讲课不太行，解决方案是md智云；实验是hqj毫无指导，解决方案是蹭其他班助教；但今年计组貌似给分也不如数逻了，没有解决方案。。。
181994,1417,张明敏,2023-11-07 13:23:03,2,2,0,求求别讲华为了，把那时间用来讲课好吗？你是觉得自己讲的清楚吗？
185886,1417,张明敏,2024-01-09 23:44:25,-4,1,5,挺好的老师，平时上课会有quiz，\n\n但是quiz能帮助复习。\n\n虽然每节课都会点到，但老师人是挺好的
187763,1417,张明敏,2024-01-17 10:17:20,3,3,0,平时分是给的真烂吧，实验报告均分80多，大作业也扣，他妈的扣一点总评就95-了
187807,1417,张明敏,2024-01-17 13:47:48,4,4,0,讲的不好，给分也不好，实验报告和大程换算下来能比别的班低上两三分总评
188037,1417,张明敏,2024-01-18 05:10:04,-1,3,4,老师人不错 讲课还行，确实不如cm和md，但你要听肯定还是有收获的。就是小测评分标准感觉很奇怪，设计电路的有些我设计的没问题还被判错了。\n\n实验是hqj带的，之前还以为老师是那种乐呵人给分也好的那种，结果发现这位才是万恶之源。实验报告给分不能超过90，大作业也狠狠扣分，啊米诺斯！你说是要捞最后捞了个鸡毛啊，牛魔的。
190501,1417,张明敏,2024-03-06 06:59:04,3,3,0,张老师教的这门课怎么不改名叫华为专利设计？？？
190832,1417,张明敏,2024-03-20 13:31:51,7,7,0,傻逼老师，上课不明所以，讲的一坨，课都讲不明白还一堆b话，真不知道这种人怎么配当老师的
192203,1417,张明敏,2024-05-11 12:16:00,0,0,0,讲课不好，还花式点名，千万别选这个老师，选上了就退了算数了\n\n1分不谢
192444,1417,张明敏,2024-05-20 06:32:16,0,0,0,第一节课的时候说的4-5次随机小测，最后只有2次。虽然小测次数变少了，但是我其中一次小测没考好啊，不能这么朝令夕改的啊
193515,1417,张明敏,2024-06-12 06:21:26,2,2,0,喜欢举例子 但是自己根本搞不懂自己说的东西和应该讲的东西有什么关系 人还行但是讲课属实一坨 建议一秒不要浪费听其他老师智云
194172,1417,张明敏,2024-06-22 10:13:09,2,2,0,纯辣寄，上课根本不知道讲的什么，只能听别的老师智云。小测时间比期末都长（虽然网上有原卷）。千万别选这个b，配的实验老师hqj更是÷升中的÷升，实验课上讲的话不如放p，实验报告什么要求都不讲，等上交了之后会千方百计扣分，均分总评直接比其他班低三分。既然你不尊重我的努力我也没必要尊重你。赶紧逃千万别选
195385,1417,张明敏,2024-06-28 02:22:09,2,2,0,hqj今年被科普了什么叫做卡绩，于是给分就好了一些\n\n老师人还是好的，就是课困+点名吧。准备好在课上该干点什么，然后蔡铭智云全勤就差不多了。
195565,1417,张明敏,2024-06-28 23:12:52,13,14,1,逆天老师，节节课点名不说，给分垃圾无比，平时分比别的班要低3分！别的班都是满绩，简直离谱
198700,1417,张明敏,2024-09-11 03:38:00,4,4,0,垃圾老师，上课绝对不知所云，只能说睡觉都嫌烦
207764,1417,张明敏,2025-01-16 01:56:15,10,10,0,给1分都是我给这个人的年龄面子。如果打分无下限我绝对给你打到-inf\n\n\n\n上课贼几把爱举例子（我觉得就是他的脑子没法运行抽象概念的推演，于是自己发育出了这么一套教学模式），真不懂你一个大学老师就这点水平好意思给我们上课。\n\n\n\n我记忆最深刻的是，他说如果学生给他发消息他没看到导致这个学生没赶上ddl，不是他的责任，是学生没有反复提醒他，直到他说他收到了才算完。哇你真是一个出生啊，还敢把教师的责任转接给我们学生身上来，搞得好像我们也有工资一样。兼职布什人。\n\n\n\n还有那魔幻的期中考试和小测方式，我真想不出来这么现代的世界能够存在这么出生的考试方式，把题写在ppt上，然后让学生们一道题一道题写，集体过一个题。更别提考试内容什么考研题都出来了，那给的概念和书上写的概念都不是一回事，你让我们写个几把？期末考试能考这玩意吗？平时用英文教的考试给我用中文考（考研题是中文的），我能知道中文翻译出来的是那个概念。\n\n\n\n\n\n吃过最恶心的史，没有之一。\n\n\n\n------------------------------------------------------------------------\n\n\n\n这位学长/学姐说得好\n\n\n\n“一坨shit，典型的计算机学院的老教师。能力，视野，教学，科研，都很差。赶上时代的红利才能站到讲台上。”\n\n\n\n赶上时代的红利才能站到讲台上。
209205,1417,张明敏,2025-01-05 04:30:19,3,3,0,快跑😅
214928,1417,张明敏,2025-02-26 06:40:02,1,1,0,我服了
216195,1417,张明敏,2025-03-12 07:30:52,1,1,0,?天天问问问问问，没事吧？
218772,1417,张明敏,2025-05-04 12:25:38,2,2,0,quiz女王，华为女王，高铁女王，专利女王🙄💅
23238,1422,胡天磊,2016-03-22 15:29:14,8,11,3,据说是个很厉害的老师，网易雷火游戏的技术主管
23915,1422,胡天磊,2016-04-21 02:43:13,3,3,0,超级帅的老师^ω^有为青年！会讲一些在网易的所见所感！
24129,1422,胡天磊,2016-04-27 16:02:26,4,5,1,讲课听好玩的，给分实打实看期末考试。。还有要多发言。。
24133,1422,胡天磊,2016-04-27 18:45:09,4,4,0,老师以后有些地方语速能慢点就好了…老师是很厉害的人讲的很有料
30864,1422,胡天磊,2016-07-02 16:39:56,2,2,0,天磊爸爸，讲课很好。如果可以的话，不想睡过老师的课。可惜大程太多。
48580,1422,胡天磊,2017-04-17 14:24:13,21,23,2,14岁上大学，此人非凡人
49184,1422,胡天磊,2017-03-29 00:11:03,2,5,3,次次第二排，每次课坐我旁边的女生都会被叫，而我0次……
49269,1422,胡天磊,2017-04-01 02:09:14,21,24,3,老师喜欢喝可乐
49718,1422,胡天磊,2017-04-24 16:35:52,5,6,1,老师人挺好的。。。可是课前发言这种计分方式。。。真的好不公平啊。。。
49757,1422,胡天磊,2017-04-25 13:15:50,1,1,0,没有说教感
50153,1422,胡天磊,2017-04-30 11:22:39,8,10,2,鸟叔超棒啊！上完信安秒变迷妹！上课非常有趣，很多实战干货和段子。每次课都带一瓶可乐，（当听说老师14岁上竺混的时候都惊呆了）总之强推！
50157,1422,胡天磊,2017-04-30 11:41:30,-1,0,1,虽然经常点不到名发言\n\n但是还是能学到一些东西 \n\n给分比隔壁班貌似要低， 但是不水 能学到东西
50261,1422,胡天磊,2017-05-02 05:00:27,2,2,0,上课从头举手举到最后 边上的人都被叫了就自己没被叫到 这个体验不好啊 果然长得不如别的小姐姐漂亮啊。最后给分 反正我非常低。可能是基本没发言的原因吧。老师讲的很基础的内容，讲得还不错，虽然可能只记住了段子。
50750,1422,胡天磊,2017-05-05 01:16:09,6,7,1,讲课很棒，但是发言计分太不科学了
51385,1422,胡天磊,2017-06-04 04:30:53,3,5,2,讲课相当不错，给我们认真的讲述了信安的相关知识，完全不水……但平时分有发言10次（一次一分），这个给分当时感觉欠妥。总之就是给分不好但是干货众多讲课不错的课，对绩点不是很看中又想学东西的同学可以选
58138,1422,胡天磊,2017-08-05 17:05:06,1,1,0,一般般
76759,1422,胡天磊,2018-05-07 11:59:54,2,2,0,挺棒的
77134,1422,胡天磊,2018-05-02 14:31:50,-15,2,17,作业迟交1分钟，判0分。
78375,1422,胡天磊,2018-05-11 07:44:17,2,2,0,上课进度太快，作业给分比想象中好（迟交或者不交就没话说了）
78840,1422,胡天磊,2018-05-15 14:59:09,1,1,0,会讲工业界相关的东西，很棒啊
79701,1422,胡天磊,2018-06-13 02:12:02,1,1,0,讲课挺好的 还有故事听。学到了很多东西。就是上课要举手发言记分比较坑，不过也给了一次机会让没发言过的同学都发言一次
79886,1422,胡天磊,2018-06-15 01:56:09,0,0,0,肥宅快乐水
107422,1422,胡天磊,2019-05-05 05:06:38,1,2,1,长得帅
107462,1422,胡天磊,2019-05-05 10:13:27,1,1,0,天磊gg超好的啊，每次回答同学问题时都超级认真der
107485,1422,胡天磊,2019-05-05 22:57:58,1,1,0,挺喜欢信安原理的，老师很厉害and个人魅力超强的
107501,1422,胡天磊,2019-05-06 02:47:44,1,1,0,鸟叔超有个人魅力，信安原理给分还不错，我无脑吹！！
122065,1422,胡天磊,2020-02-10 21:30:28,1,1,0,感觉老师很厉害，喜欢喝纤维+可乐
124674,1422,胡天磊,2020-07-06 01:24:52,4,4,0,sp没有考试，课前发言提问和到课率占10分，作业90分+10分bonus。收获真的蛮大的，相比于某些专业课不知道好到哪里去了。怒给10分！sp
124675,1422,胡天磊,2020-07-06 01:33:11,4,4,0,安全编程技术给分很好，不过前面几次作业工作量有点大。这门课和计院大二下的课程完美联动，第一个实验写网站和数据库期中作业是一致的，如果是软工的还可以先学一下web开发，对同时期的软工基也有好处，linux实验部分装linux虚拟机可以在另一门通识linux应用技术基础里做好，总之如果有空就建议选这门课，发言次数够了可以100
135377,1422,胡天磊,2021-05-09 00:24:43,3,3,0,给分超好，上课发言水到了就行，期末按照ppt好好准备几个主要的知识点
135444,1422,胡天磊,2021-05-10 13:39:32,-1,0,1,给分不错，人也有趣
153029,1422,胡天磊,2022-04-24 02:38:37,0,0,0,所以说作业不能太早做，\n\n不然考试时考作业是啥都记不起来
153553,1422,胡天磊,2022-05-04 15:04:19,4,6,2,好老师，赞
153555,1422,胡天磊,2022-05-04 15:32:24,0,1,1,上课有趣 给分超好
153558,1422,胡天磊,2022-05-04 17:09:43,-6,3,9,今年的助教认真的吗？作业全部按要求认真完成扣我6分，总评比期末考试还低？属实6
153600,1422,胡天磊,2022-05-05 12:08:58,0,1,1,good！！！
154257,1422,胡天磊,2022-05-27 09:02:14,-1,0,1,HTL，我的超人
155156,1422,胡天磊,2022-06-09 02:01:37,1,3,2,单方面宣布是计院最可爱的老师——\n\ntlgg自己是本校毕业的，很清楚培养方案的弱点和一些无用的形式（比如机房上课），所以整体授课很高效；\n\n安编里的很多知识点，之后大三都还会了解到，算是先进行一个整体性的了解，同时这门课和软工基是部分联动的，可以一起写其中的部分作业；\n\n人非常亲切，有问题都会认真回答，上课也有趣，主要是长得也帅（bushi）；\n\n唯一美中不足是作业量确实不小，还没出分，许愿一个好分数，出分了来感谢哈哈哈
158244,1422,胡天磊,2022-06-27 17:26:55,-1,1,2,sp绝对好课啊 老师很可爱 冲就完事
172901,1422,胡天磊,2023-05-09 13:38:00,3,3,0,第五次作业，呵呵。。。。。。
173063,1422,胡天磊,2023-05-12 07:11:52,3,4,1,讲课一般，给分不明确
177458,1422,胡天磊,2023-07-03 10:27:43,6,8,2,安编给分挺烂的
177461,1422,胡天磊,2023-07-03 10:34:50,11,13,2,安全编程技术，和往年描述的给分很好不同，今年变化挺大，身边很多同学表示给分很差而且不明确，学在浙大上提交作业但是得不到一点反馈，没有平时分的具体构成，直接出一个糟糕的成绩让人破防。信安原是软工必修躲不掉，但是安全编程技术是选修课，以后选的同学要三思，给分可能很迷很不明确。
177485,1422,胡天磊,2023-07-03 11:40:47,-1,4,5,感觉tl老师还是很懂技术的，但心思不在教学上。考核方式不太明确，但给分还是良心的
177553,1422,胡天磊,2023-07-03 16:53:36,8,10,2,学弟学妹们快逃，如果你不想在给分标准不明确的情况下喜提不满意的绩点。\n\n有幸这学期连上了胡老师的信安原和安编。我的评价是一个比一个离谱，且周围同学普遍反映逆天。\n\n先说信安原。这门课一直没啥问题，直到出分。好几个同学出分后觉得奇怪，不该这么低，于是去问了问助教，助教回了分，并说胡老师修改了分数构成，由5次发言5分改成了10次发言10分。于是有同学去问了胡老师这是咋回事，两小时后胡老师回应说，助教搞错情况了，实际上并没有改。然后牛逼的来了，助教把和同学们之间询问成绩的所有聊天截图来了个死无对证。最后到查分，成绩构成确实没改，但是老师说作业没有满分的，似乎与同学之前询问助教的说法不一致。\n\n有同学是去年来修的，三个人去年平时分都满的，今年均降了5分左右。另外，这件事逆天之处在于，如果真的是助教搞不清楚情况打胡乱说，他为什么能构想老师改了成绩占比，还能构想出一个5%到10%的精确占比？而且就算是打胡乱说，为什么要删聊天记录呢？是心虚还是什么呢？也无从考证了。\n\n接着是安编。这门课只有发言和lab，离谱的是有些大佬都有没上4的。有同学觉得无语：我都这样卷了，绩点怎么还这么低？\n\n于是去问助教，助教说可能是今年报告改的比较严，具体不方便透露，同学们也不知道自己哪里扣了分。\n\n综上所述，这两门课的成绩构成是不透明的，唯一确定的是发言次数，其他的，比如作业，你是不知道具体作业的分数的，用F12打开学在浙大，可以惊喜的发现每一个作业都没打分，分都不知道哪里来的。\n\n所以这两门课，慎选。最终解释权就在老师那里，成绩怎么构成，你是决定不了的。
177556,1422,胡天磊,2023-07-03 16:19:29,7,8,1,给分极差极差极差，且不公布评分标准，同时也有在期末考试考完之后修改评分规则的恶劣行为。学弟学妹们慎选！！！！
177565,1422,胡天磊,2023-07-03 17:55:03,8,9,1,98上sp的信安原风评都还可以才来上的 但收获确实不多 给分也恶心🤢
177580,1422,胡天磊,2023-07-04 01:58:53,7,10,3,安全编程技术，给分差，助教烂，分数不公布不透明，慎选。
177639,1422,胡天磊,2023-07-04 03:56:25,7,9,2,快逃，慎选\n\n给分不透明，还有临时改评分细则\n\n这学期选了信安原和安编\n\n被双杀！！！
177642,1422,胡天磊,2023-07-04 04:11:29,-15,1,16,可能会被踩，但是我安边技确实满了。发了16次言也不算特别多，作业也就是正常写，没用eclipse用的idea，也没用虚拟机用的wsl（？）可能报告写的比较好？但也就只是把每一步骤都写清楚了，记录了写作业时候做的尝试和犯错的过程
177948,1422,胡天磊,2023-07-05 16:53:47,5,6,1,安全编程技术作业是真的多，上课内容和作业不说是完全脱节吧，至少也可以说是毫无关系了。作业内容基本上是ctf入门的内容，想写好要花不少功夫（最好有个懂ctf的大佬带）。作业给分也很玄学，根本不知道按什么标准打的分。另外上课发言算平时分除了让成绩再不透明一些之外毫无用处。。。如果想学东西建议搞到作业内容然后自己做一遍（反正也是自学），课就别选了。
178018,1422,胡天磊,2023-07-06 08:40:39,4,4,0,呵呵，sb安编，辛辛苦苦做的实验，发了十几次言，最后分奇差。联系助教核实分数也爱搭不理，我的建议是别选了。助教这帮人不知道为什么对待学生的作业的态度这么差，枉为助教
178066,1422,胡天磊,2023-07-06 13:57:44,13,14,1,htl的安编 90%作业 10%发言\n\n然而作业基本都是搬运的\n\n比如 \n\nWebgoat \n\nhttps://www.utc.edu/document/71626 \n\nhttp://staff.ustc.edu.cn/~bjhua/courses/fall10/labs/lab4/\n\n并且教了这么多年作业也没改过 ubuntu还是12.04 \n\n辛苦写作业最后喜提3.x 那我来个1不过分吧
178545,1422,胡天磊,2023-07-14 06:55:29,1,3,2,sb\n\n。
192177,1422,胡天磊,2024-05-11 01:53:17,5,6,1,出分贼慢，没想到还给我憋了坨大的\n\n能不选还是别选了\n\n信安原上课的内容老的要命\n\n多少年也不知道更新一下\n\n既然一门课老师的精力都不在好好准备课程内容\n\n而只会照着陈年老旧的ppt照本宣科\n\n真的没啥选的必要了
192195,1422,胡天磊,2024-05-11 07:11:45,1,3,2,出分慢，给分差，事倒是不多，上课内容可以当故事听还是有点意思的，但每节课都要去卷发言实在是i人不友好
192826,1422,胡天磊,2024-05-31 02:29:38,0,4,4,今年信安原给分我觉得起码我还是挺不错的，所有也选了安编，第一个实验做了也不难，感觉没有去年说的那么差
196126,1422,胡天磊,2024-07-02 09:39:02,1,5,4,安编作业认真写的和学长对过答案的，回答次数也是全班前几的，最后总评是八十多分的，问助教是已读不回的\n\n屎中屎
196159,1422,胡天磊,2024-07-02 02:12:17,1,2,1,安编技给分很一般，建议还是别选了
196381,1422,胡天磊,2024-07-03 07:32:07,3,5,2,认真做≠给你分
196595,1422,胡天磊,2024-07-04 07:37:24,-2,3,5,随机给分，💩中💩
214771,1422,胡天磊,2025-02-18 00:17:43,1,4,3,讲得还行唉感觉
214989,1422,胡天磊,2025-02-20 01:26:17,3,6,3,发言发言  发你妈的遗言   傻逼东西全家皮燕子被操发炎了？
218839,1422,胡天磊,2025-05-08 02:49:49,2,2,0,给分不错，但是10次发言属实令人头秃，给打个9分吧
218840,1422,胡天磊,2025-05-08 02:51:36,1,2,1,感觉听不听都一样
218841,1422,胡天磊,2025-05-08 02:57:18,2,2,0,好！牛逼
218842,1422,胡天磊,2025-05-08 05:12:19,1,1,0,要10次发言但给分好
138920,1444,王锐,2021-07-11 18:41:48,1,7,6,王锐老师，我的超人
139578,1444,王锐,2021-07-17 13:29:14,6,13,7,强推这节课！！！\n\n大作业是组队，所以建议找好靠谱队友再选，不然很痛苦（但和靠谱队友做游戏真的很快乐）\n\n我们有去网易雷火参观的环节，而且也经常会有讲座，对游戏行业的理解大幅度提高了！\n\n\n\n老师和助教都很nice（助教姐姐人美心善！）
196297,1444,王锐,2024-07-03 00:23:58,6,6,0,游程，不是很喜欢做游戏或者没基础的别来。上课讲的啥用没有，纯纯自己摸索，大三下要学全新的技术栈做游戏，游戏从建模到脚本都要自己弄才算自己的工作量（找素材不要时间的么啊喂），还说是为了体现上课讲的知识，你的课谁听啊？总之工作量爆炸，水学分的话绩点很难看，想水学分的别来！
196303,1444,王锐,2024-07-03 00:35:13,3,3,0,喜歡游戲 有基礎的可以選\n\n\n\n我0基礎直接暴斃
196428,1444,王锐,2024-07-03 10:02:32,-3,0,3,做游戏挺好玩的，可能给分确实有些主观色彩，以后选这门的大家注意汇报的时候要详细体现出自己的工作量就好，具体工作介绍的细致一些，应该还是没啥大问题滴！
28573,1453,胡晓军,2016-06-28 10:32:50,8,8,0,不点名
32214,1453,胡晓军,2016-07-06 03:18:01,1,3,2,一节课没去快满了……
48719,1453,胡晓军,2017-03-10 03:35:03,0,1,1,棒棒哒
56823,1453,胡晓军,2017-07-04 17:00:21,0,4,4,BS大概10个里面8个满绩？
56857,1453,胡晓军,2017-07-05 01:26:00,1,3,2,我也不知道听老师的课是什么感觉，但是就很爽。
83784,1453,胡晓军,2018-07-11 08:31:10,-1,2,3,老师BS给分真的给力；均?4.5 认真一点 肝一周就敢给满
83804,1453,胡晓军,2018-07-11 08:47:24,1,2,1,认真做事，随便满绩！好老师！
83828,1453,胡晓军,2018-07-11 09:12:16,1,2,1,没去上过课，满了
84045,1453,胡晓军,2018-07-12 02:28:48,0,2,2,真的是随便满绩
84115,1453,胡晓军,2018-07-12 04:56:48,0,1,1,感动哭 满满师生情
84121,1453,胡晓军,2018-07-12 05:12:45,-2,4,6,B/S，期中报告交一份，期末大程花一个星期好好做。大学第一门满绩，而且我周围认识的就没有不满绩的。
85370,1453,胡晓军,2018-07-17 09:21:53,1,4,3,不点名 只有期末大程和期中报告\n\n两点建议：\n\n1.大程基本功能都有了，前端不丑就不会影响满绩，没有特殊兴趣的话不必投入过多精力\n\n2.作业不要迟交 有比我做得更好的大佬因为迟交没满\n\n\n\n最后安利下spring boot
85426,1453,胡晓军,2018-07-17 17:02:10,1,2,1,不点名，均绩高
85809,1453,胡晓军,2018-08-15 05:17:20,1,1,0,一节课没上，满了
107816,1453,胡晓军,2019-05-10 02:50:04,0,0,0,课上真的有点无聊
114447,1453,胡晓军,2019-07-10 03:46:33,1,2,1,上课很无聊没有什么干货
114500,1453,胡晓军,2019-07-10 07:41:38,1,2,1,绝了…一节课没去过，甚至不知道老师长啥样，然后满了…
114503,1453,胡晓军,2019-07-10 08:29:21,0,0,0,真的好老师！我最终报告文件出了问题，老师发邮件告诉我，但我没在录入成绩前查收，结果给了我不合格。后来我马上跟老师邮件反馈，一天之内就帮我更正了成绩，而且分数也很高，那时真的是相当感动☺️
114537,1453,胡晓军,2019-07-10 12:12:01,3,3,0,努力一周，幸福一生。
116069,1453,胡晓军,2019-09-02 09:23:47,1,1,0,去了第一节课 然后期中花了几天做server 期末花了几天做网页 就满了
116749,1453,胡晓军,2019-09-15 03:08:57,-29,4,33,一节课没去，webserver抄计网，大程找外包，没花一点时间，满了。
124676,1453,胡晓军,2020-07-06 02:02:47,3,3,0,太良心了
136800,1453,胡晓军,2021-06-25 00:41:10,0,0,0,剩一周不到要交大作业，功能还没做几个，来这里许愿希望能做完
138747,1453,胡晓军,2021-07-10 16:01:42,3,3,0,强推bs，工作量适中，给分巨好
138756,1453,胡晓军,2021-07-10 16:32:53,6,6,0,楼下所有夸老师的都是真实的！\n\n这门课没点名没小测没平时作业没考试没论文，只有一个solo的大作业。\n\n我大概一个学期去了去了一半的课，其中认真听的几次可以发现老师是有讲干货的，并不是“无聊，没一点干货”，对某几种语言讲得比较细致，还会课上打开IDE现场给学生展示代码。\n\n不过这都不是重点，重点是！我拖到离ddl还有一周才开始大作业，当时以为自己要完了，web前端没学过，后端稀里糊涂，mqtt物联网服务器更是从来没接触过。没想到硬啃了一个礼拜完成了最基本的要求，界面也没时间美化了，最后有4.8！\n\n以上，胡晓军yyds！
138763,1453,胡晓军,2021-07-10 17:18:21,1,1,0,刚出分 火速赶来！\n\n平常上课老师有很认真地在讲，虽然我并不是很能听得进去（逃\n\n课程考核就是期中的设计报告+期末大作业（一个物联网应用网站），工作量是有的，但基本上一个星期可以完成所有代码的工作（如果完全没有数据库和前端语言基础的话可能需要更多的时间）。虽然不知道具体的评分细节，但我猜像以前的评论说的一样，功能完整文档清晰之余，前端稍微做得好看一点就能满了: )
138783,1453,胡晓军,2021-07-11 00:29:49,1,1,0,不点名，课上不上无所谓，东西大体做出来差不多上90，最幸福的专业课
138843,1453,胡晓军,2021-07-11 07:19:56,1,1,0,虽然工作量如大家所说确实是在一个星期内完成了，但是，因为文档过于简略导致卡在91，只有4.5，软工的课大家一定要将文档写得清楚详细啊。
138896,1453,胡晓军,2021-07-11 15:11:06,9,10,1,查老师均绩假的，大家别信，真实情况比这高多了
139493,1453,胡晓军,2021-07-16 12:35:08,1,1,0,BS才是真正的软件工程！\n\nBS yyds！
139649,1453,胡晓军,2021-07-19 08:05:04,-3,0,3,连学带写肝了一天半，90，只能说自己不努力吧233333
148771,1453,胡晓军,2022-01-13 12:55:11,1,1,0,验收了就满了，好老师
148777,1453,胡晓军,2022-01-13 13:08:39,3,3,0,不验收也满了
148779,1453,胡晓军,2022-01-13 13:18:21,1,1,0,事少，给分好的老师为什么只有9.6？
148788,1453,胡晓军,2022-01-13 13:49:36,6,6,0,老师本身是有水平的 强烈不认同“水课”的称呼\n\n会讲前端 从基础讲起 讲到框架的使用\n\n也会讲后端 会有实例的讲解 也会渗透一些相对较成熟的工业界的实现方式\n\n最后给分也挺好的
148791,1453,胡晓军,2022-01-13 14:28:39,1,1,0,第一次遇到给分这么好的课，无脑选好吧
148887,1453,胡晓军,2022-01-14 01:43:27,1,2,1,不验收、功能有bug也满了
150091,1453,胡晓军,2022-01-19 03:28:58,0,1,1,真就最短可以一周完成的作业，一节课不去也能满，建议选
164871,1453,胡晓军,2022-12-27 05:14:35,1,1,0,hxj yyds！！！
167204,1453,胡晓军,2023-02-23 16:40:25,13,13,0,等老师出分ing\n\n出分了，胡老师yyds
168231,1453,胡晓军,2023-02-22 12:30:52,7,8,1,srds\n\n这学期出成绩好慢啊\n\np.s一个月后更新：还是没出
168946,1453,胡晓军,2023-02-23 15:35:36,2,2,0,出分了，疑惑胡老师为什么不是10分
168947,1453,胡晓军,2023-02-23 15:38:47,1,1,0,放心选 宝藏老师 第一次满绩
168948,1453,胡晓军,2023-02-23 15:41:52,1,1,0,就去了几节课，大作业一周肝完，参考了下github现有的框架，实测能满，hxjyyds！！！快冲
168960,1453,胡晓军,2023-02-24 00:10:48,21,21,0,胡晓军是真的做到的从学生中来，到学生中去。比起那些忙着搞创业公司使劲恶心学生的老师好多了，你说对吧，翁先生？
168978,1453,胡晓军,2023-02-24 02:23:46,2,2,0,不点名；样式就参考网上的后台管理系统模板，只完成要求的功能，文档参考github上学长的格式，多写点，大概率就能满
168984,1453,胡晓军,2023-02-24 02:31:28,2,2,0,非常优秀的老师，讲课有干货，给分很好，可惜的是同学们出勤率不高
168993,1453,胡晓军,2023-02-24 02:54:02,1,1,0,bs满了 谢谢老师
169074,1453,胡晓军,2023-02-24 08:12:08,0,0,0,好！满了！
169162,1453,胡晓军,2023-02-24 13:24:32,0,0,0,老师超级好啊啊啊 肝了一周满了！
169279,1453,胡晓军,2023-02-25 07:50:36,2,2,0,一周冲锋满了，想凑模块学分建议选，讲课的内容也挺新的，可以学学前后端的一些开发技术。
189973,1453,胡晓军,2024-02-04 16:59:26,4,4,0,出分慢，给分神
189987,1453,胡晓军,2024-02-06 01:58:03,1,1,0,给分是真好啊，虽然出分有点慢。老师会认真检查每个人的作业所以别想着糊弄，但是只要认真做了分就会很好
214554,1453,胡晓军,2025-02-13 01:46:20,2,2,0,下个学期报到前一天出分什么水平\n\n给分还是很好的，即使我前端极简陋\n\n不过明年大作业题目里还有爬虫的话建议考虑退课或汽修，太费时间和精力
214555,1453,胡晓军,2025-02-13 02:26:38,1,1,0,给分真的神！
214557,1453,胡晓军,2025-02-13 02:46:47,0,0,0,给分是真神
214560,1453,胡晓军,2025-02-13 04:10:47,1,1,0,上课不点到，大作业课程占比百分百。给分较好，不过由于有爬虫等需求感觉今年课程作业难度较往年更难。大概需要花费一至两周时间完成。
214566,1453,胡晓军,2025-02-13 07:43:19,1,1,0,一节课都不用去听，给分神，唯一缺点就是工作量有点大，建议早点开始搞大作业
214744,1453,胡晓军,2025-02-17 08:20:43,1,1,0,海底捞，我的神 TAT
219887,1453,胡晓军,2025-06-10 03:38:10,0,0,0,给分的神！强烈建议学弟学妹来选
34311,1501,顾宗华,2016-10-01 07:07:20,0,0,0,老师很nice，英语说得挺好，不点名，脾气好。
37454,1501,顾宗华,2016-11-19 02:06:23,1,1,0,超良心的老师
38751,1501,顾宗华,2016-12-17 07:50:41,2,2,0,顾老师前排观光团
40265,1501,顾宗华,2016-12-31 05:49:09,2,3,1,老师人超级好，就是课对于大二的学生来说有点难，不过听说给分还不错？
41476,1501,顾宗华,2017-01-12 02:27:41,7,7,0,完全不点名，没quiz，内容充实，考试简单，你觉得咋样
41713,1501,顾宗华,2017-01-14 15:42:31,12,14,2,男神老师！人又帅脾气又超级超级好！没有见过比他更温和更有耐心的男老师了！英文水平超棒，信安课从来不点名不quiz，老师说凭个人兴趣上课~特别替同学们考虑，很耐心回答大家在群里的各种问题和建议~信安考试开卷，考点基本都在ppt里了，认真理解复习上4不虚，给分超棒！总之不能更赞啦！就是安卓实验对于大二的同学来说会有点小吃力，不过因为是组队完成会相对轻松一点~
41749,1501,顾宗华,2018-04-08 14:18:28,12,13,1,老师真是好人，但某些学生在群里不要得寸进尺好吗？就差直接向老师要满绩了
41750,1501,顾宗华,2017-01-12 13:40:53,17,20,3,老师人脾气真好……但真是看不惯有的同学，课从来也不去上，考完试掰开了揉碎了一分一分地要成绩。本来老师就已经给很宽松就应该知道适可而止了吧。
41754,1501,顾宗华,2017-01-12 13:48:24,1,1,0,好\n\n至少要评价三个字
41756,1501,顾宗华,2017-01-12 13:48:57,4,5,1,人又好长得又帅
41760,1501,顾宗华,2017-01-12 13:54:28,2,2,0,老师真的超级好！！！！
42478,1501,顾宗华,2017-01-14 09:22:17,4,5,1,认真听课、考前仔细看ppt，满?还是挺容易的。就是平时的实验对于没接触过安卓的同学可能有些难度，而且机械化的东西有点多，建议老师调整一下。
42577,1501,顾宗华,2017-01-14 13:18:48,1,1,0,顾老师超级好～讲的棒～内容蛮充实的～就是安卓实验对于大二还是有点小吃力～
42639,1501,顾宗华,2017-01-14 16:00:16,3,4,1,很好的老师，虽然应该不是经常给本科生上课，但是讲的很好啊，而且经常在课程群里和大家交流，解答问题。实验部分主要是Android和java，对于大二同学感觉还是比较难的，不过组队作业还好。期末认真看ppt，应对开卷考试还是很轻松的。第一门满绩的专业课，开心?
42647,1501,顾宗华,2018-04-11 12:41:27,3,3,0,超棒的老师，感受到了浓浓的师生情，就是实验有点难
76389,1501,顾宗华,2018-04-06 13:07:59,0,0,0,不错啊
110138,1501,顾宗华,2019-06-23 15:25:11,0,0,0,老师是个超级低调的传奇人物\n\n自行Google以及Google scholar
239,1539,翁彦琳,2015-03-14 17:26:09,27,37,10,上大学以来遇到的最好老师！！讲的很详细，上课就能听懂，回去就能写作业，赞的不行
4183,1539,翁彦琳,2015-06-18 03:32:27,12,21,9,讲的很详细，但因为是全英课觉得听起来很累，总是走神水手机……不过网站更新的很及时，可以下她上课用的ppt，看一遍也就都会了。到不到课没管过，作业要交
6115,1539,翁彦琳,2015-07-11 03:22:35,8,10,2,老师人好，给分也好，上课时一种享受
22364,1539,翁彦琳,2016-03-04 02:42:10,26,31,5,老师养眼！
22966,1539,翁彦琳,2016-03-15 08:04:42,13,15,2,第一次遇到的给同学一本一本发作业的老师，又温柔又萌，人超级好。上课也好，还能练英语，强推。
25644,1539,翁彦琳,2016-07-04 01:35:36,49,56,7,除了周昆大神，你们谁都不许跟我抢翁姐姐！
26146,1539,翁彦琳,2019-03-19 14:37:17,2,5,3,非常好
26147,1539,翁彦琳,2016-06-16 06:08:19,9,10,1,人超级漂亮 全英文 又会卖萌 很好
26156,1539,翁彦琳,2016-06-16 06:23:05,6,7,1,上翁姐姐的离散课很幸胡 见到老师是上课的动力～
26169,1539,翁彦琳,2016-06-16 06:48:51,15,17,2,当初冲着老师跟室友名字一样选的课，没想到竟然这么美腻又温柔，室友啊……
26202,1539,翁彦琳,2016-06-30 05:33:42,8,10,2,炒鸡好
29445,1539,翁彦琳,2016-06-29 23:58:10,2,6,4,离散很英文，但是大家肯定都能听得懂。讲得很不错，又快又稳，该听不懂的你肯定是听不懂的，不能说是老师的锅。
30390,1539,翁彦琳,2016-07-01 13:05:20,5,5,0,老师好萌
30927,1539,翁彦琳,2016-07-03 03:06:11,14,16,2,很暖心 很女神 能记住每一个同学的名字～工作的时候很认真 课下会在群里调戏小男生
31468,1539,翁彦琳,2016-07-04 02:56:32,3,5,2,女神！
31538,1539,翁彦琳,2016-07-04 05:48:23,6,6,0,炒鸡棒！超级喜欢翁姐姐！
32853,1539,翁彦琳,2016-07-19 01:42:59,3,3,0,堪称大学老师模范
38929,1539,翁彦琳,2016-12-20 02:11:36,6,6,0,好喜欢
40237,1539,翁彦琳,2017-02-28 10:58:59,4,4,0,大概是进大学以来 最喜欢的老师了吧 温柔的声音 温柔的容颜 超级喜欢呀
48604,1539,翁彦琳,2017-03-08 07:39:14,0,0,0,大爱翁姐姐～
48777,1539,翁彦琳,2017-03-13 01:42:44,3,4,1,课讲的不错。但是对英文要求有点太高。英语不好的我有点跟不上节奏。
51138,1539,翁彦琳,2017-05-18 08:49:25,0,0,0,评分居然下降了0.02？\n\n翁姐姐讲课没话说，人美声甜，又负责任
51205,1539,翁彦琳,2017-05-24 05:15:07,0,0,0,棒棒棒
51567,1539,翁彦琳,2017-06-07 07:52:29,0,0,0,只爱翁姐姐啊啊啊啊
52395,1539,翁彦琳,2017-06-19 13:46:20,0,0,0,棒棒棒！
52666,1539,翁彦琳,2017-06-22 05:04:12,1,1,0,超萌！超可爱！
53332,1539,翁彦琳,2017-06-26 11:29:49,0,0,0,超级棒
56244,1539,翁彦琳,2017-07-03 10:15:48,0,1,1,老师好可爱。超级温柔，女神啊啊啊！
56303,1539,翁彦琳,2017-07-03 12:41:37,4,5,1,这是我第一次上全英文的课 有几次被老师叫到回答不出问题 老师都很耐心地教我 最后好好复习得分还挺高的 真的是很温柔很好的老师 要是选上了一定要珍惜呀
56305,1539,翁彦琳,2017-07-03 12:46:53,5,6,1,啊为什么查老师没有100分\n\n啊就头一次因为一门课要结课难过到要死? \n\n真的有点后悔当初有几节课没认真听 ?\n\n期末感冒病得特别厉害老师还在考场上关心我 ? \n\n就到目前为止唯一一门让我觉得老师的人格魅力远远超过其他人的课\n\n遇到这样的好老师一定要珍惜！结课了以后真的很怀念之前上课的时光(#／。＼#)
56315,1539,翁彦琳,2017-07-03 13:07:38,1,1,0,很好，很有耐心！
56330,1539,翁彦琳,2017-07-03 13:24:41,6,6,0,老师太好了\n\n最后考试崩了\n\n一定要记得提前复习
56454,1539,翁彦琳,2017-07-04 00:51:31,2,2,0,小测和期中考试要重视，好好复习一定能拿高分
56796,1539,翁彦琳,2017-07-04 15:44:32,6,6,0,虽然最后被离散拉了均绩，不过还是要表白翁姐姐！以及大家一定要提前复习！
57544,1539,翁彦琳,2017-07-09 12:52:57,0,0,0,爽！！
59514,1539,翁彦琳,2017-09-22 03:25:58,1,1,0,老师超萌，给分超好，很关心学生
59722,1539,翁彦琳,2017-09-26 07:37:32,2,2,0,人美声音甜上课很认真负责
63315,1539,翁彦琳,2017-11-30 10:48:04,1,1,0,有才又有颜
64094,1539,翁彦琳,2017-12-21 03:18:32,12,15,3,打个10，想选上翁姐姐的离散，保佑我吧，求彩票系统调课，ym翁姐姐已久
64521,1539,翁彦琳,2017-12-25 02:02:25,0,1,1,为翁姐姐疯狂打call!!!
65752,1539,翁彦琳,2018-01-09 03:49:37,4,4,0,老师英文口语超棒，自信
75828,1539,翁彦琳,2018-03-19 09:33:01,0,0,0,很温柔
75837,1539,翁彦琳,2018-03-19 14:19:15,8,8,0,Oh my God， terrific class experience ever! You are lucky if you can enroll!
79101,1539,翁彦琳,2018-05-23 03:11:00,-14,4,18,只要我翻PPT足够快，你们就别想听懂。
80483,1539,翁彦琳,2018-06-27 03:48:58,11,11,0,温柔的声音，温柔的容颜，可爱的性格，善良的人品。宽容而负责，温柔而严格。最engaging的 课 ever。不仅学到知识，还感受到了世界上最纯粹的师生情与真善美！！！
83342,1539,翁彦琳,2018-07-10 07:09:45,1,1,0,感谢翁姐姐轻松愉快的离散课
83537,1539,翁彦琳,2018-07-10 14:13:33,5,6,1,翁姐姐人超好超温柔，下课回答同学问题也非常耐心，经常留到教室里都没多少人才走，而且老师会尽量记住班上同学的名字，超感动，课也上的很容易懂 尽量用我们能理解的英语来上课 解答问题 给分也超nice啊 （真的只要quiz midterm final exam前好好回顾下PPT和作业，分数绝对不会亏待你，何况除了小测期中考还有bonus！总之，翁姐姐超棒！
84202,1539,翁彦琳,2018-07-12 08:18:15,2,3,1,翁姐姐真的太好了！感人！\n\n认真负责，课讲的清楚，人好，能记得同学的名字，卷子会保护学生隐私都是一个一个发的，上课会叫人回答问题但不来或者不会都没关系，不想听课回来看一遍ppt也没问题，给分又好，真的无可挑剔啊啊啊啊啊！
84460,1539,翁彦琳,2018-07-13 11:57:33,0,1,1,人好看，说话又好听，超喜欢上她的课的！
104510,1539,翁彦琳,2019-03-22 04:13:33,2,2,0,蹭课了两周课，最后没选上。刚刚被离散老师的蜜汁讲课摩擦，吃完饭到西区找教室，发现翁姐姐还在教室答疑??，太感人了。
104926,1539,翁彦琳,2019-03-31 09:07:22,0,0,0,老师人很细心，很好看，还能记住同学们的名字。好爱呀
105408,1539,翁彦琳,2019-04-12 02:10:09,6,6,0,翁老师简直不能太赞！发小测卷子的时候为了保护隐私，亲自逐个发到每个同学的手里。递试卷的时候还特意把有成绩的那一面向里折。太贴心了！
106366,1539,翁彦琳,2019-04-26 17:53:34,2,2,0,很好哦
108429,1539,翁彦琳,2019-05-24 02:21:53,1,1,0,这个不打十分就过分了！\n\n我也没有回答问题或者坐在第一排，可是两节课老师就记住我名字了（通过交作业）\n\n发卷子的时候我坐在一排中间，老师递过来的时候还特意折了一下面的经过的同学看到分数。天呐！
113338,1539,翁彦琳,2019-07-06 08:00:12,4,5,1,老师讲课很好，复习的时候只要把布置的习题认真做，PPT认真看就没啥问题。不过一定要好好准备小测，老师非常求是。没有师生情。
113853,1539,翁彦琳,2019-07-07 18:38:24,9,10,1,1.离散不像数院课那样不调挂一半，所以整体调分是不存在的，班上只有一两个满绩，但wjj会录入前留时间给大家查试卷，也会尽可能让能上一档的上去，平时quiz误改的也都可以修正。2.wjj基本能把班上人认得差不多，会亲自发quiz试卷到手上，平时学习状态、考试发挥情况其实都看在眼里。3.单从内容来看，wjj讲得其是不算很好(没有横向对比过其他老师，听说jxg老师要强一些，会更集中深入地讲图论等等一些内容)，详略把握不是太好，有很多时间花在琐碎的细节上，经常在举例子时候被计算错误等等打断节奏，值得扩充的内容很多几句带过，缺乏系统性连贯性。可能有离散这门课定位的锅，但的确有时是wjj自己的问题。\n\n总之如果要上离散，选wjj绝不会亏！如果想要掌握更深入的内容，可以考虑秋冬jxg的离散，或者自己找书来看。
114384,1539,翁彦琳,2019-07-10 00:30:10,1,3,2,……就这样
115030,1539,翁彦琳,2019-07-14 14:57:03,2,2,0,老师太可爱了
115031,1539,翁彦琳,2019-07-14 14:57:25,3,3,0,没办法，老师这么可爱就是可以为所欲为的
124021,1539,翁彦琳,2020-06-20 15:24:39,7,7,0,老师是神仙！😭 我不是老师的学生 上的是别的老师的离散课 上网课的期间 由于在国外 学院临时要求不能确定是否能在9月返校的国外同学和毕业班的同学一起线上考 由于当时还有几门课的期末大作业 加上之前延后的期中考 真的没时间复习了 我找了自己的任课老师说明情况 他只说了一句‘这是学院安排，帮不了你’ 我逼不得已就在群里找到了翁老师 她非常细心的帮我 还帮我问了学院负责老师是否有其他的解决方案😭😩😩 天啊这是神仙老师！老师人真的超好！好后悔没选她的课🥺🥺🥺
125480,1539,翁彦琳,2020-09-10 05:41:02,3,3,0,10分拉满\n\n别翻评论了赶紧去选\n\n无奖不亏抽中血赚\n\n（翁姐姐还有别的课嘛QAQ在线等）
135889,1539,翁彦琳,2021-06-01 03:15:44,9,9,0,最好的离散数学老师，今天是六一，翁姐姐给我们巧克力。
137099,1539,翁彦琳,2021-07-05 23:46:45,6,6,0,出分了，我只能说翁姐姐真是人美心善，大学能遇到这么好的老师实在幸福
137132,1539,翁彦琳,2021-07-01 11:07:18,3,3,0,老师人非常负责非常好，不过离散真的考得好难qaq\n\n平时的quiz和midterm一定要重视，这个感觉给分太严了，大题都是没有步骤分的😔
137151,1539,翁彦琳,2021-07-10 02:50:26,0,0,0,吹爆翁姐姐！！！！！！人美心善，给分超棒。\n\n快选！
137189,1539,翁彦琳,2021-07-02 06:21:03,0,2,2,quiz的题期末卷上一模一样有…
151161,1539,翁彦琳,2022-02-23 16:23:38,0,0,0,老师声音好甜！
154694,1539,翁彦琳,2022-06-03 14:23:19,0,1,1,最好的离散数学老师，前天是六一，翁姐姐给我们玉米棒。
156422,1539,翁彦琳,2022-06-19 14:21:29,1,1,0,班群氛围好好~
157275,1539,翁彦琳,2022-06-22 23:09:55,5,5,0,翁姐姐\n\n选上就偷着乐吧\n\n已经不用夸了，把所有能想到的好老师的词都给她还是不够\n\n我的翁姐姐
158137,1539,翁彦琳,2022-06-27 06:34:04,1,1,0,大爱翁姐姐！！！！
161454,1539,翁彦琳,2022-11-07 04:43:50,2,2,0,非常好！温文尔雅的老师，英语发音也好听；\n\n离散数学一周两节课，只要交作业就行，允许线上听课，不额外查点名
171466,1539,翁彦琳,2023-03-25 05:26:21,-29,16,45,名气大于实力，我觉得讲课真的很一般
172221,1539,翁彦琳,2023-04-22 14:43:53,2,5,3,我觉得讲得挺清晰的。不过大部分内容中学都学过
174742,1539,翁彦琳,2023-06-16 13:16:57,0,0,0,翁姐姐🥰🥰🥰
174743,1539,翁彦琳,2023-06-16 13:17:33,3,3,0,讲得很好的老师！课程是纯英文授课，但是翁老师讲得很清晰，除了术语之外也简单易懂！
175039,1539,翁彦琳,2023-06-21 08:25:20,11,11,0,考完来评一下。wjj真的是我大学以来遇见过最好的老师之一，离散虽然是一门比较偏基础的课，但是wjj总是非常耐心解答，下课了也总是留下来答疑。平时上课也是非常鼓励大家回答问题，如果不会的话她也会一步一步提示你，最后回答出来了就有bonus。唯一的困难就是英语授课吧，但是wjj的英语真的很棒，上课认真听肯定可以的。即使实在没跟上，只要课后用点功总能搞懂的，我也是开始的时候有点担忧，后面才慢慢建立信心的。真的非常幸运第一门专业课就能遇到这么好的老师，大爱wjj！
175401,1539,翁彦琳,2023-06-24 15:01:21,-2,2,4,事情少+期末海底捞，而且最主要是很用心！
175712,1539,翁彦琳,2023-06-26 09:27:19,3,3,0,选上你就偷着乐吧（\n\n离散这门课本身不难，（难处主要在于体量大），可以感觉到翁姐姐讲的还是很清楚的，对着PPT肯定能学会。唯一一个小缺点是英文授课的问题QAQ，可能比较难get到老师想表达的意思\n\n翁姐姐人真的超级好！！！每节下课都会留下来答疑，不会点名，很温柔体贴，钉钉沟通起来非常友善，绝对是计院数一数二的体验极好的老师。\n\n最后吐槽一下助教，每次两个人改小测却改卷标准不一样，我三次平时考试每次都有判错的题。。。最后老师还得下课的时候复核了班里几乎一小半人的试卷把分数加回来，简直无语
175913,1539,翁彦琳,2023-06-27 06:28:29,3,3,0,老师人真的很好，ppt非常清晰，讲课说实话真的很棒。但是如果英语真的不好并且是靠老师上课学习的，建议慎选，至少全英文授课对我影响真的很大，上课我是真的不太跟得上，基本是靠课后预习，看书看ppt。如果本来就是全靠自己的话还是很建议选wjj的（如果选的上，笑），答疑很耐心，人美心善好吧。
176249,1539,翁彦琳,2023-06-28 07:04:24,4,5,1,期末覆盖平时分太好了
176377,1539,翁彦琳,2023-06-28 14:57:22,7,7,0,我是翁姐姐的狗！！（bushi
176378,1539,翁彦琳,2023-06-28 15:00:50,1,1,0,感谢wjj不挂之恩呜呜呜，英文授课对我这个英语渣渣来说真的有点难度 期末又因为其他课的好多作业没好好复习。如果能重来我一定好好学呜呜呜
176884,1539,翁彦琳,2023-06-30 14:13:24,2,2,0,上课不敢回答问题 在群里面讨论，翁老师也给加分了🥹 多给了一分bonus多了0.3绩点
185439,1539,翁彦琳,2023-12-29 10:31:22,1,3,2,神。\n\n从来不点名 第一节课说可以看智云 但是上课回答问题有bonus\n\n讲的神中神 选上了你就偷着乐吧 上大学以来没遇到过这么好的老师\n\n绩点给的相当satisfactory 苯飞舞喜提大学以来最高绩点
195790,1539,翁彦琳,2024-06-30 03:04:20,7,7,0,好老师，给十分！就是今年期末考试卷是不是有点太难了。。。
196111,1539,翁彦琳,2024-07-01 16:21:04,7,7,0,翁老师专心授课，《离散数学》课程内容充实；她态度严谨认真、一丝不苟，作业题量适中然不得迟交（遗忘作业本老师会等你回去拿一趟），小测等如果确有该加分者从不推诿拖延，并坚称不会让这门课变成“水课”；她关心学生，课后自己花很长时间为基础薄弱之同学辅导，上课不点名、但出勤并时常回答问题会最后加分，考前在群里回答同学疑问也获加分；她态度和蔼可亲，与学生沟通亲切无碍、亦师亦友。虽然我个人的得分不是很满意、感觉略对不起付出之努力，然确乎有考试前眼花缭乱、复习效果极差之因素，以及自己平时概念不熟不精之问题；老师总体给分应该不差。\n\n本课程以英文授课；老师博士就读于威州Milwaukee大学，发音很标准，课程内容理解即使对不使用英文的同学亦无任何障碍，可以不必为此忧心。
206774,1539,翁彦琳,2024-12-17 13:06:17,3,4,1,离散唯一真神
218600,1539,翁彦琳,2025-04-26 02:54:44,-4,2,6,超级nice！！就是小嘴叽里咕噜不知道在说些什么（
220318,1539,翁彦琳,2025-06-17 08:36:46,4,4,0,老师和助教都很温柔负责，感谢你们！！！
220465,1539,翁彦琳,2025-06-18 04:59:24,1,1,0,没选上但听了智云的课，感觉是目前听过专业课里讲得最好的，讲课思路清晰，不会念ppt，英语口语也很好，听着很舒服
220557,1539,翁彦琳,2025-06-18 13:08:04,1,1,0,翁老师是我永远的神！！！超级温柔超级耐心，上课包售后！！！每一次小测都会评讲，主动去找老师可以得到试卷点评和学习建议（有点像我高中上学（褒义）），老师真的很努力在捞每一个人了，上课发言的bonus到后期会有相对简单的题可以拿，选到就是赚到！！！还有助教小哥哥超级好，期中期末之前都有自己整理的复习题和复习材料，助教天花板！！！但是需要注意的是上课是全英文的，不会有什么很难理解的句子，但是还是需要注意听去理解的。不过翁老师会在课后抽时间开中文的复习课，真的包售后，太好了！！！非常非常幸运能够选上翁老师的课，要是预置了就偷着乐吧。
220809,1539,翁彦琳,2025-06-20 01:44:52,7,7,0,写在出分之前，这次期末比较难，所以分数肯定不是很好看，但是wjj和zxt助教堪称老师和助教界的top！wjj有教学情怀，非常关爱学生，会尽量记住所有学生。zxt助教时常发一些学习总结和自己整理的题目，对于离散数学这种学习资料和题目稀少且难找的科目帮助莫大，总之感恩遇到非常好的老师和助教！
220971,1539,翁彦琳,2025-06-20 13:59:51,9,9,0,粉笔无言写春秋，\n\n春风一度满明眸。\n\n谆谆教诲如甘露，\n\n点点真情似暖流。\n\n常忆案前名姓记，\n\n更思堂上解惑由。\n\n离散曲终情未散，\n\n寸心化作十分酬。
221133,1539,翁彦琳,2025-06-21 11:20:52,2,2,0,好老师！冲！
221175,1539,翁彦琳,2025-06-21 22:32:38,3,3,0,翁老师是真正为我们学生着想的好老师！！！选到就是赚到
221184,1539,翁彦琳,2025-06-22 00:36:18,2,2,0,大爱！！！
221186,1539,翁彦琳,2025-06-22 01:11:13,6,6,0,老师是真的好，但是我成绩差只能怪我没好好学吧，对不起老师。
221189,1539,翁彦琳,2025-06-22 01:37:26,3,3,0,好老师，选上就是赚到，平易近人，zxt助教也好
221210,1539,翁彦琳,2025-06-22 04:05:15,2,3,1,人美心善翁姐姐，助教xtgg也很负责，给分也是海底捞。期中期末xtgg都自己整理了很多资料给我们复习，问问题也是基本秒回，是🐭🐭大学来碰到最负责的助教。离散期末考完原本以为要寄了，没想到翁姐姐给我捞上了4.8。感谢老师和助教一路的辛苦付出。
221252,1539,翁彦琳,2025-06-22 08:41:05,1,1,0,老师满分，助教满分，很认真负责海底捞还不点名（当然回答问题有bonus）\n\n期末难度负分
222048,1539,翁彦琳,2025-06-29 07:24:15,0,0,0,神中神中神中神！！！\n\n- 老师很捞，据说期末是一个个调过来的\n\n- 英文教学，但是很好理解，讲不清楚/听不清楚的地方会用中文再讲一遍，不定期会有自愿参加的中文补习课（用中文把前面的内容再复习一下）\n\n- 从不点名，但是回答问题会有bonus（我社恐没拿bonus也被老师捞满了）\n\n- 24-25春夏的助教xtgg绝对是我进大学以来碰到最最负责的助教！期中期末考试前在群里发了很多资料帮我们复习（可惜xtgg今年毕业了qwq）
13609,1548,施青松,2015-12-30 04:19:19,6,26,20,施青松，非常坑！实验课超级麻烦，一个星期要花好几天在他实验课上，而且学不到什么东西，他自己给的实验都各种bug。理论课必须靠自学
14247,1548,施青松,2016-01-05 16:50:47,-2,3,5,吼吼吼
14982,1548,施青松,2016-01-11 11:41:23,5,13,8,事很多，但老师很负责，讲课很不错。嫌事多的，隔壁还有楼sir呢
15622,1548,施青松,2016-01-16 00:54:32,23,29,6,数字逻辑设计：理论课内容丰富，看得出老师的功底。实验课要困难些，很锻炼人，比如要求画原理图。如果理解实验内容而不是依赖老师给的图或代码，基本不会有什么问题。
15782,1548,施青松,2016-01-16 09:03:41,10,14,4,~~~上课讲得有些不清楚，但给分特别好，前提是你大程做得很棒。施老师绝对是学校做fpga实验最拿手的~~
21198,1548,施青松,2016-02-27 02:08:49,14,19,5,施老师理论课讲的很好，quiz少，没点名。实验课任务是多，讲义上也会有错漏，但照抄才会被坑到（想想还是自己太懒）。感觉学到了很多东西，给分相当厚道
21200,1548,施青松,2016-02-26 06:39:54,0,4,4,良心给分！
25966,1548,施青松,2016-06-14 15:36:58,-8,1,9,不知道啊，还没选上
28231,1548,施青松,2016-06-28 08:18:48,6,8,2,轻松爸爸人很好，但是理论课确实不怎么样…感觉没好好备课，实验要求比较高，能够锻炼自己的动手能力，实验绝壁不水，但是感觉不会像某些老师那样觉得忙得毫无意义
40765,1548,施青松,2017-01-05 10:11:42,4,5,1,勤勤恳恳 无私奉献 真心实意培养学生 为教学做贡献
46638,1548,施青松,2017-01-22 04:43:42,3,4,1,给分超级好，实验课内容更好
46652,1548,施青松,2017-01-22 05:28:32,4,4,0,讲课可能不是很好，ppt的疏漏也很多，但是实验课让我受益匪浅。尽管期末恶竞严重，但最后给分很良心！
48769,1548,施青松,2017-03-12 15:07:50,5,5,0,上学期轻松爸爸的数逻，实验课内容比其他教学班多不少，但到了这学期计组就很轻松了。不建议不修计组的软工同学选他的数逻
48915,1548,施青松,2017-03-16 07:36:17,6,7,1,实在不知道他的ppt在说些什么。比较讨厌这种明明很清楚却还要绕来绕去的感觉。
50644,1548,施青松,2017-05-04 04:26:41,-5,3,8,青松爸爸人超好的啦 助教也很可爱
53112,1548,施青松,2017-06-26 02:23:09,2,2,0,青松爸爸人真的超级好！！是个认真负责的好老师 是那种真心想把一门课教好的  赞青松爸爸！！
56527,1548,施青松,2017-07-04 02:45:39,6,6,0,青松爸爸关爱我们的睡眠，实验教学非常认真负责，可以学到很多东西。
57661,1548,施青松,2017-07-11 18:08:04,0,9,9,施老师真的是良心好老师！数逻和计组都是他的课，上课和课后答疑都很认真负责，虽然实验稍微累点，但很充实能学到很多，最后给分也真的特别特别好！助教也非常耐心负责逗比，不能更赞了！
57683,1548,施青松,2017-07-12 12:16:48,0,0,0,233
57775,1548,施青松,2017-07-15 06:49:59,7,9,2,上课挺好的，但是给分我真的不知道是怎么给的。。。实验麻烦点，期末赶大作业也没什么，但是为什么都好好的完成了最后却只有这么点分数呢？期末也并没有说考的特别差，甚至我觉得除了部分选择题其他都答的不错。。。逻辑和计组都是青松的，真的是给我撞得头破血流。尤其是计组，真的是一万个想不明白
59464,1548,施青松,2017-09-21 13:57:56,1,1,0,我觉得OK
60212,1548,施青松,2017-10-13 04:46:44,0,1,1,实验很有用，真正学到了东西
60789,1548,施青松,2017-10-30 07:05:52,0,0,0,给分很随意，极坑
60790,1548,施青松,2017-10-30 07:07:05,1,2,1,给分莫名其妙，上课一般般，实验太繁琐
74378,1548,施青松,2018-02-16 10:23:17,5,6,1,给分还行，但讲课一般，作业繁琐，任务量大，4学分的数逻上出了8学分的感觉。顺便，这门课考完试过了一个月终于在大年初一这天出分了
85578,1548,施青松,2018-07-20 01:37:43,0,1,1,不得不说，事情是真的多，但给分很好
87595,1548,施青松,2018-10-08 04:26:47,7,9,2,求求你别拖课了行不行
87596,1548,施青松,2018-10-08 04:31:16,7,8,1,上午三节课二三节中间不下课还能拖到12：45。
87629,1548,施青松,2018-12-03 15:11:51,4,4,0,认真负责，好老师
89072,1548,施青松,2018-11-15 06:32:50,1,3,2,实验内容极其硬核，不和你开玩笑的硬核。上课水平客观的说不是特别好，属于常规水准。我的意见是学期里没什么事想挑战自我的人可以选这个老师，很锻炼能力和耐心。
93834,1548,施青松,2019-01-14 03:18:14,6,7,1,sword缔造者，我觉得还行
94642,1548,施青松,2019-01-17 13:34:43,0,2,2,轻松爸爸的实验真的教你做人。。\n\n我以后反正也用不着，干嘛要弄得这么硬核。。我认为真正的好课是你想水可以水过，但如果想认真学也能学到非常多的东西。老师是好老师，但课程本身设计根本不照顾学生的感受，搞的课后要花大量的时间投入，结果学生几乎没有课余时间，去学习自己将来工作真正要用到的东西。。希望能给学生课后时间选择做自己想做的事，而不是把4学分的课上成8学分的内容
100215,1548,施青松,2019-01-25 23:27:32,3,4,1,老师给分真的很好鸭
106737,1548,施青松,2019-04-29 07:23:52,20,23,3,作为浙大硬件三件套和综合实践都修穿的15级学长，我来说说施老师的课。当初我在学数逻学组成也很痛苦，成绩也不大好。但是后来修体系结构和综合实现配合编译原理和计算机网络以后，感觉对计算机的理解发生了升华。这样的课程组合对我日后的发展产生的质的帮助。面试no rej，秋招基本全过。主管都很欣赏我对计算机的理解到了底层，而不是局限于某某热门框架。15级的zzx大佬，xt大佬，lwx大佬. fhb大佬，分别去了cmu mcds. CMU mcds，斯坦福ms，cmu phd。别的也都有很好的归宿，都是名校phd和ms。他们在硬件课上的表现都非常惊艳！\n\n\n\n我看评论里有同学说这门课花的时间很长，以后用不到，没时间去学别的东西。其实这种想法是错误的。os，网络，组成是计算机最根本的东西，如果你以后做软件开发，做分布式系统，做高性能计算等一切非ai的工作，这三门课是最根基的，也是浙大的学生不同于其他普通学校培训班学生出来的优势之一。\n\n\n\n学一门课，用一辈子，很划算。好好学。
111735,1548,施青松,2019-07-02 16:48:21,5,5,0,课上的一般\n\n能学到不少，但感觉都是肝出来的..\n\n还点名，不是很建议选。
118145,1548,施青松,2019-10-21 16:07:30,3,3,0,别选，选了就是掉头发
121987,1548,施青松,2020-01-28 11:18:27,1,4,3,老师人很好，讲课的时候很耐心很和蔼，从老师上课举的各种例子中可以看出老师学识非常渊博，老师的助教小姐姐和助教小哥哥人都很好，如果向老师提问老师会很耐心地为你解答，虽然实验课上的作业比其他班地难度要高，但是如果能理解老师实验的原理和内容对于之后大作业是很有帮助的，在课后实验可能要花比较多的时间，建议希望对自己有所提升，想要真正学到一些东西的人选哦，还有就是老师在教我们的时候是要求最好一个人完成一份大作业的，到期末的时候时间会很赶，建议真的可以事先了解起来（最好的话就是把实验提前几周做完，然后开始大作业的构思，具体可以参考前几届的大作业和老师给的demo小样），施老师给分也很nice，主要看你的学习态度啦！给施老师打call！！
126884,1548,施青松,2020-10-26 15:51:46,1,2,1,作业太多
126975,1548,施青松,2020-11-01 07:33:01,0,0,0,浙大FPGA扛把子，内容直接对接硬件业界技能
128133,1548,施青松,2020-12-08 04:41:03,11,12,1,按时下课是不可能的，这辈子都不可能的。学生又听不懂我讲的，我多讲半小时怎么了？什么，下节课的人全站在外面了？关我什么事呢，我的学生管好就行。
129516,1548,施青松,2021-01-06 12:54:54,2,2,0,上青松老师的课一点都不轻松~
132222,1548,施青松,2021-01-31 04:37:56,1,4,3,施青松老师的数逻虽然辛苦，但能真正学到东西，而且给分非常棒，我的作业和实验报告写的都很差，最后也被捞到4.8，感谢施老师
136215,1548,施青松,2021-06-13 02:37:44,3,3,0,实验要死，但是即使做不出来交了给分就很厚道
136981,1548,施青松,2021-06-29 05:44:08,11,11,0,一个很真诚的老师
139235,1548,施青松,2021-07-13 13:20:02,3,4,1,超级超级棒的老师，可惜退休了呜呜
139819,1548,施青松,2021-07-28 13:10:05,-11,3,14,讲真我觉得上完施老师的课多少都会有点斯德哥尔摩综合征，导致这里的评论和平时上课时同学们对sqs的风评很不一致。所以学弟学妹们，除非真的对硬件超极感兴趣并且愿意投入大把时间，否则真的别选，别折磨自己，有这时间不如去玩玩或者学些自己感兴趣的内容。哦草sqs是不是退休了，草，我成最后一届被折磨的人了
235,1553,许端清,2015-03-14 17:18:55,28,42,14,"还好，讲的不错，认真负责，但是嘴炮无敌ヾ(´･ ･｀｡)ノ"""
1187,1553,许端清,2015-03-21 16:27:22,103,127,24,经常点名，绝对赞
3793,1553,许端清,2015-06-29 04:35:14,15,26,11,超级好的人，讲的也很好
4745,1553,许端清,2015-06-27 06:47:45,3,8,5,讲得很细致，非常负责
5082,1553,许端清,2015-07-03 13:21:13,14,24,10,有时候会觉得他很烦 老讲学习方法啥的。。但其实是个很负责的老师！是真心希望你能学会学习的！用心出了让人摸不着头脑的题目引出他的教学。。。自己还是要努力咯。。
6374,1553,许端清,2015-07-13 10:41:54,2,5,3,老师人很好
6630,1553,许端清,2015-07-16 15:26:08,3,7,4,做题点名，很负责任
8696,1553,许端清,2015-09-24 07:04:20,3,6,3,很不错
8922,1553,许端清,2015-10-01 05:22:11,3,8,5,人一级棒
10848,1553,许端清,2015-11-23 07:11:33,-5,2,7,。。。
12732,1553,许端清,2015-12-24 02:48:18,0,3,3,讲课节奏较快; 很认真！
15318,1553,许端清,2016-01-18 12:58:00,3,8,5,特别好！
15576,1553,许端清,2016-01-15 12:30:49,18,26,8,人很温柔，最大的特点是喜欢在课前出一道题来回顾知识点兼点名，之后会认真讲解，研讨课能学到很多东西，资料全部都会给你，期末也会传复习资料。
16639,1553,许端清,2016-01-18 14:58:31,3,7,4,温柔爱笑的老师～
19220,1553,许端清,2016-01-23 14:24:18,4,6,2,很负责人很好，好老师～
20005,1553,许端清,2016-01-26 01:46:50,1,3,2,老师的助教是上过最好的！
20017,1553,许端清,2016-01-26 02:09:40,3,6,3,老师很负责 答疑很认真 平时任务蛮多的 不过这样也好 期末比重就没那么大啦
20226,1553,许端清,2016-01-26 15:16:00,1,3,2,点名好玩，负责认真
22188,1553,许端清,2016-03-03 01:59:25,0,3,3,细致负责，给分超棒
22727,1553,许端清,2016-05-18 07:01:48,-1,15,16,不要选择许端清，c程课钱徽是唯一的选择
22886,1553,许端清,2016-06-28 13:55:08,-7,9,16,人好讲课差……
24888,1553,许端清,2016-05-04 08:25:08,0,3,3,好的嘛
28199,1553,许端清,2016-06-28 08:15:12,3,8,5,上了两个学期许端清的课，第一学期c程课上经常会用quiz点名，上课还是蛮重要的。第二学期没选上他的课，愣是重新选了一遍，但c程设专题课有点水，他也不点名。总的来说，对于电脑小白的帮助挺大的。另外，助教也真的超级赞！有什么问题在微信群或者私聊就好了！
32173,1553,许端清,2016-07-06 00:47:02,0,5,5,老师人还行，但课堂内容太简单，很容易掌握，要做题时觉得完全不够，实践性太差。助教很负责。给分一般。
32917,1553,许端清,2016-07-31 13:02:39,2,9,7,亲眼见证了许端清老师和钱徽老师的评分逆转……许老师风格适合新人，然而稍稍用点心的话都会觉得课上讲的太少。老师人非常好，助教超级棒。还是得给老师一个好评。可是我还是更被钱徽老师的人格魅力折服的说……
34569,1553,许端清,2017-01-18 15:24:57,2,4,2,没见过比许老师更负责任的老师  绩点也真心感动
38551,1553,许端清,2016-12-08 10:23:17,2,4,2,讲得超级好，超级有耐心很负责的一个老师！
38729,1553,许端清,2016-12-16 00:12:23,2,5,3,不上徐老师的课都不知道什么是认真负责
39949,1553,许端清,2016-12-28 09:21:44,1,3,2,老师人很好，答疑超级耐心～讲解题目非常清楚\n\n助教很负责任，赞～
40273,1553,许端清,2016-12-31 09:26:44,2,5,3,好老师啊，真的超级负责任！
42709,1553,许端清,2017-01-15 03:11:00,1,2,1,声音超好听！很温柔的老师
44776,1553,许端清,2017-01-18 08:33:56,2,3,1,大大真的很棒
44917,1553,许端清,2017-01-18 13:39:43,-11,2,13,大学第一个满绩，感谢老师！\n\n老师很儒雅，认真负责，经常在群里给我们耐心解释各种问题，助教也很棒很负责。
47715,1553,许端清,2017-02-21 04:07:04,0,1,1,老师人很好，很负责
50711,1553,许端清,2017-05-04 12:40:51,1,2,1,老师超级认真负责，而且答疑非常非常耐心。但是我就是跟不上，我真的太差太差了。
51900,1553,许端清,2017-06-13 09:22:11,2,3,1,笔芯，老师很真诚。
52869,1553,许端清,2017-06-23 09:06:52,4,7,3,大叔控福利  萌大叔控绝对要选\n\n声音炒鸡软萌 一直笑着简直秒杀大叔控啊
57242,1553,许端清,2017-07-06 06:05:55,1,2,1,专题课讲得很好，给分不错
57991,1553,许端清,2017-07-21 05:13:32,2,5,3,真正能让你学到东西的老师，最后一节课会点名
60580,1553,许端清,2017-10-24 09:52:15,-4,7,11,对零基础的孩子不管不顾，什么玩意
64456,1553,许端清,2017-12-24 05:13:21,2,4,2,十分负责人的老师！
65682,1553,许端清,2018-01-08 08:02:04,4,7,3,许老师真的是一位超棒的老师，许老师的课是竺院的预置课，要不是课程网上写着双语吓退了很多人，我根本不敢相信自己选上了这门课。老师很儒雅，很有风范，谈笑风生，讲课很细致，虽然我经常不听（这导致我现在学得如此艰难…）老师借小测点名，他很关心同学的学习，嗯就这样，下学期不是他的课了，会想念他～虽然我只是他不起眼的一个学生。
66329,1553,许端清,2018-01-15 06:40:01,3,6,3,老师真的没的说，非常好了。我上他的课也很努力，不过上机考试结束之后，我发现努力了不一定有回报，妈的运气好才是真牛逼
66512,1553,许端清,2018-01-17 05:36:45,2,3,1,又负责讲课还好，不放弃一个问题。
66560,1553,许端清,2018-01-17 09:00:47,1,2,1,emmmm
72278,1553,许端清,2018-01-29 17:32:32,0,4,4,就没认真听过课，最后绩点还上了4，很满足了
72287,1553,许端清,2018-01-29 22:03:40,8,16,8,老师真的负责任，研讨课学到很多东西。\n\nc程大家基础不一，个人是c程小白，一开始老师就会让我们编一些“复杂的程序”（那时循环、判断都没学，我什么都不会），当时我甚至还埋怨过老师，但是后来发现，这些其实如此简单……所以对于小白来说，自学、多下工夫很重要。老师很负责，但毕竟课时安排有限，老师只能讲解一些重点题目，完全依靠老师是行不通的。还有，课前quiz，大家不要害怕，老师只会问一些典型的题目，有时像趣题一样，更多作用是让我们在考试中不虚，保持深刻印象，其实好多时候老师也不会介意你直接在电脑上运行以得出答案的。不过，一定要认真听课，老师讲得很到位，认真听课，收获很大，小白也不要没有信心，坚持下去，是有希望逆袭的。
72351,1553,许端清,2018-01-30 02:54:44,-1,4,5,讲得有点少
75597,1553,许端清,2018-03-14 01:28:57,2,3,1,棒棒棒
81295,1553,许端清,2018-07-04 15:00:54,8,12,4,助教倒是从来没回答过我问题，怕是遇到了一个假助教……\n\n老师回复问题超可爱超耐心！！是不是浙大老师都喜欢用emoji表情包？反正这中年男人口味戳我萌点了\n\n上课节奏见仁见智，是比较细致的老师
84694,1553,许端清,2018-07-13 14:37:15,1,4,3,c大程稍水，不过老师讲课够好了，回答问题细致（进入短学期才知道，后悔没珍惜），给分也好，事情没有wk多。
89191,1553,许端清,2018-11-16 12:26:37,0,6,6,上的大计基，各种课程网站、教材习题、操作实验，搞得晕头转向，还没有答案，令人窒息。
89512,1553,许端清,2019-03-14 14:30:46,15,36,21,作业是真TM多！实验做半年，还要写实验步骤，分分钟1000字。课后练习题还要打成word上交，我真的不想说话。
89679,1553,许端清,2018-11-20 08:26:55,22,36,14,作业贼多...我的室友们大jj都没感觉，就我淹没在大jj作业里，而且作业很杂，又是课后题又是操作，一会儿学在浙里一会儿思科网上课程，反正就是很懵，你知道作业很多但是真的不清楚到底是哪些作业，一会儿这个网站一会儿那个网站，虽然微信群回答问题很及时，有问必答......但是只想说作业很多......不知道大jj这门课的意义何在，学一学理论，然后就没有然后了，我觉得计算机主要重要的还是操作...
92237,1553,许端清,2018-12-27 07:24:26,2,3,1,大神也听课
92510,1553,许端清,2019-01-01 12:02:26,17,25,8,老师感觉人挺好，就是作业贼™多还烦，我们寝室就我一个人一天到晚沉醉在大计基作业里，实验还要写报告，一来就是几千字，人家做例题我们做操作题，一边学例题思考操作题一边打着实验报告，心累，真难
92838,1553,许端清,2019-01-05 05:12:29,-1,6,7,大计基嘛，反正怎么也是听不懂。关键是这个作业巨多，贼麻烦。整天各种操作题实验题，各种课程网站，眼花缭乱。感觉学了没啥用。
93756,1553,许端清,2019-04-04 05:29:52,37,58,21,许老师是一个超超超级和蔼的人。真的超级好。作业不会做，老师会在群里知道你做；ddl过了老师会帮你重开让你完成！有什么要求老师尽量都会满足。最让我觉得感动的是，某天凌晨两点钟一个同学在群里问老师问题，老师秒回了！老师超级棒！
101906,1553,许端清,2019-01-29 15:02:29,-8,2,10,100分
101907,1553,许端清,2019-01-29 15:04:42,4,6,2,程序设计基础课，这段话写给有一定基础的同学：\n\n1.许老师好老师，非常负责，对初学者特别友善（这也是我总翘课的原因23333），听说经常用小测方式点名，搞得我后来慌了，间间断断去了几次，但估计平时分还是凉凉，但最后绩点合情合理，令人感动！（就是有基础其实可以不去的意思2333）\n\n2.大作业很磨练人，不要低估，还是争取做一下，而且最好组队做。我一开始准备写八数码，一通dfs剪枝，算法写好之后实在没时间做图形界面，故放弃...组个队就做出来了啊！大作业一定要组队！\n\n3.期中期末的笔试会考很底层的东西，不能轻敌，考得好不好和你代码打多好关系不大。所以如果之前没听课的话，考前一定要刷题，把许老师发的题刷完，也就差不多了。\n\n4.许老师好人！希望以后还能常和老师交流！
101909,1553,许端清,2019-01-29 15:15:46,4,6,2,老师超好 给分超好  超喜欢听他上课
101910,1553,许端清,2019-01-29 15:17:05,78,100,22,说实话，感觉无论浙大还是中国都需要这种自身很高又能俯下身来搞好本科教育的老师，真的很赞(•̀ᴗ•́)و ̑̑
101912,1553,许端清,2019-01-29 15:45:20,12,15,3,老师真的很好！上课经常会有手机上的小测试，帮助巩固一些易错点，当然也顺带点名了hhh；群里问问题回复很快，解答也很耐心；大作业有难度，但是收获挺大的，做的过程中可以多和老师、助教交流；临近考试周会发历年题目和复习提纲，考试中有上课讲过的题的变形；给分很不错。希望以后能和老师多多交流呀！
101922,1553,许端清,2019-01-29 16:43:56,1,2,1,老师讲的很好，很有耐心，不懂的知识点会一直给你讲到懂为止，并且还喜欢笑，很温柔，最后给分也超级好，绝对赞！
101935,1553,许端清,2019-01-29 23:58:42,3,6,3,吹爆xdq，太棒了，上课对小白极其友好。
101967,1553,许端清,2019-01-30 01:33:15,0,2,2,老师挺好的
101968,1553,许端清,2019-01-30 01:34:50,1,5,4,真的很细致、很负责。各种原理、知识点都会讲解，在群里提问基本是秒回的（不管问题有多蠢）。各种资料、总结也做的很细致，打分也很棒。给老师刷个10分！
101980,1553,许端清,2019-01-30 01:58:41,4,5,1,老师很好，要想考好自己必须努力啊，这门课至少也挂了四个同学呢
102263,1553,许端清,2019-01-31 15:38:20,-24,2,26,老师的程序设计基础，虽然基本没听过，但是感觉老师讲的很认真。哈哈，第一个满绩，10给老师
102427,1553,许端清,2019-02-01 22:43:05,0,1,1,什么也不说了，为老师疯狂打call！！
102428,1553,许端清,2019-02-02 00:52:08,0,3,3,给分超级好！！老师超认真负责
102443,1553,许端清,2019-02-02 08:11:52,3,5,2,给分好 不过作业很多
102599,1553,许端清,2019-02-12 07:27:16,1,1,0,不错不错
103318,1553,许端清,2019-02-27 09:28:48,1,2,1,作业比较多 答题非常非常耐心仔细 给分很好
104757,1553,许端清,2019-03-27 06:42:00,1,2,1,很详细 逻辑也很清晰
104982,1553,许端清,2019-04-01 16:20:25,1,2,1,很好的老师，非常认真负责，遇到许老师真的很幸运
108094,1553,许端清,2019-05-14 23:32:01,6,10,4,作业多得让我想自杀，什么都不讲，就要你做很难的大程序，对非计算机专业的人就是噩梦
108113,1553,许端清,2019-05-15 06:27:30,32,43,11,自学完了再讲有个锤子用
108114,1553,许端清,2019-05-15 06:36:40,7,10,3,全靠自学 经常是做完了作业的下一节课再来讲上节课的知识 都自学完了你还讲有毛线用 又不讲新的内容 新的作业又要自学
109853,1553,许端清,2019-06-19 17:17:32,0,2,2,非常认真的老师！推荐选！
113415,1553,许端清,2019-07-06 17:11:19,0,2,2,老师你就是我爸爸，多谢不挂之恩！\n\n
113429,1553,许端清,2019-07-06 17:17:53,33,54,21,许老师和蔼可亲，温文尔雅，给分超棒，本以为挂了，可老师手下留情，捞了我一把，大爱老师。老师，您是美的耕耘者，美的播种者。是您用美的阳光普照，用美的雨露滋润，我们的心田才绿草如茵，繁花似锦!您为花的盛开，果的成熟忙碌着，默默地垂着叶的绿荫!啊，老师，您的精神，永记我心!啊，有了您，花园才这般艳丽，大地才充满春意!老师，快推开窗子看吧，这满园春色，这满园桃李，都在向您敬礼!如果没有您思想的滋润，怎么会绽开那么多美好的灵魂之花啊，老师，人类灵魂的工程师，有谁不在将您赞扬!传播知识，就是播种希望，播种幸福。您用火一般的情感温暖着每一个同学的心房，无数颗心被您牵引激荡，连您的背影也凝聚着滚烫的目光……亲爱的老师，您那赤诚的爱，唤醒了多少迷惘，哺育了多少自信，点燃了多少青春，摧发了多少征帆。您多像那默默无闻的树根，使小树茁壮成长，又使树枝上挂满丰硕的果实，却并不要求任何报酬。毫不吝惜地燃烧自己，发出全部的热，全部的光，全部的能量。老师，您像红烛，受人爱戴，令人敬仰!您的思想，您的话语，充溢着诗意，蕴含着哲理，又显得那么神奇呵，在我的脑海里，它们曾激起过多少美妙的涟漪!春蚕一生没说过自诩的话，那吐出的银丝就是丈量生命价值的尺子。敬爱的老师，您从未在别人面前炫耀过，但那盛开的桃李，就是对您最高的评价。
113434,1553,许端清,2019-07-06 17:19:51,7,12,5,出完成绩我就想喊一声：爸爸！
113455,1553,许端清,2019-07-06 17:32:44,2,3,1,上课节奏把握不当 主要靠自学 但是作为秒回答疑王真的很耐心很温柔了
113487,1553,许端清,2019-07-06 18:23:29,4,5,1,感谢不挂之恩
113746,1553,许端清,2019-07-07 07:25:00,1,3,2,给老师打call！！！超级认真负责的老师，答疑相当耐心详细，不管多晚问问题老师都会很快回答，真的很感动了！最后虽然卡绩，但给分真的相当不错了（应该是本人水平不够的原因）十分！！！
116799,1553,许端清,2019-09-16 02:29:02,0,2,2,给分不好
117982,1553,许端清,2019-10-17 14:56:31,3,7,4,感觉什么都没有讲。
122685,1553,许端清,2020-03-18 14:14:33,1,2,1,除了常点名，其他都还好。自己预习也不是件难事，问他问题很和蔼，不论是微信群里还是当面问。
126096,1553,许端清,2020-09-17 11:20:49,0,0,0,给分好
128494,1553,许端清,2020-12-23 11:13:53,1,2,1,老师炒鸡好，真的老师一点钟和同学讨论问题，回答问题耐心，感动感动。还有第一学期第一节课的讲解和谈心真的很重要，学弟学妹珍惜，一定要好好去上课，注意自己看看ppt，老师上课很有创意，不念ppt，但是要自己复习
129193,1553,许端清,2020-12-31 04:34:16,0,2,2,没听过老师的C程课，可能大计基都是这样吧，不过老师还是很负责
129834,1553,许端清,2021-01-12 16:10:36,-1,2,3,不知道好在哪里，大计基听着无聊
129871,1553,许端清,2021-01-13 06:30:45,5,8,3,xdq，坑死我了
130175,1553,许端清,2021-01-18 12:08:09,0,2,2,C程课，老师真的特别好，群里有人问问题都会很温和地回答，而且是一步一步引导你发现答案的那种。
130184,1553,许端清,2021-01-18 15:15:25,13,14,1,许老师不管你多晚问问题都会回答的，我自己就有很多次午夜问题老师秒回的经历，我之前学的是basic不是c++，老师讲解问题真的很详细，而且是在培养你思考的能力，绝对不是简单地把知识点灌到你的脑子里就好。其实主专业不是计算机的学生更需要培养这种能力。我觉得多花一点时间自己学习，再结识一个很优秀，真正很关心学生的老师很值得，并不是说老师管理是否严格或者老师布置的任务是否繁重决定了老师的价值与水平。
130185,1553,许端清,2021-01-18 15:18:28,7,9,2,上的老师的程序设计基础课，不得不说老师是真的好，可惜我秋学期没怎么听课，期中考试后意识到了，希望为时未晚。老师非常耐心，一直在群里给同学解答问题，并且是以提问的方式让你自己意识到你的问题在什么地方。上了老师的课后，真的被老师的认真负责，对学生的付出所折服。
132624,1553,许端清,2021-02-03 02:42:30,7,10,3,绩点给的很差。不拉\n\nyysy但是态度很好。有次很晚问问题还是钉钉群里回了。而且实时更进
132652,1553,许端清,2021-02-03 06:42:59,3,7,4,没捞我，我挂了。
132854,1553,许端清,2021-02-04 07:35:45,0,2,2,态度很好，没听过c，djj应该都差不多
132932,1553,许端清,2021-02-07 01:30:41,1,5,4,ball ball老师快点出成绩吧，就算是挂了也给个痛快吧，太煎熬了呜呜呜\n\n---------------------------\n\n出分了，没挂！多谢老师海底捞！老师真的太赞了！虽然出分慢，但是真的太会捞了！
132994,1553,许端清,2021-02-06 03:18:31,6,7,1,出分很慢，不知道是不是在捞人，隔了十多天还没出
133030,1553,许端清,2021-02-06 15:43:19,0,1,1,讲得很清晰，很负责。虽然出分可能慢了一点，但是学习是为了知识不是分数啊！
133038,1553,许端清,2021-02-07 01:02:30,-2,2,4,老师真的太捞了!!!速选大计基，冲!!!
133039,1553,许端清,2021-02-07 02:02:25,-1,3,4,没捞我，但老师很好
133126,1553,许端清,2021-02-09 04:02:39,-1,2,3,感觉中上，c没听过，价值观挺不错的
133657,1553,许端清,2021-03-03 09:48:49,0,3,3,人超级超级好，我到了大学以来最感恩的一位老师！！！！！
133696,1553,许端清,2021-03-04 02:56:23,0,7,7,上课废话多，抓不到重点
134523,1553,许端清,2021-03-31 09:52:16,1,5,4,上课途中，先来评个分。老师讲课很清晰，人很耐心，有一次我的dev出了问题，工程文件全部无法编译，最后老师很耐心地帮我试出了问题，重装了dev，一直到6点，给老师点赞(๑＞ڡ＜)☆
135120,1553,许端清,2021-05-01 09:20:58,0,6,6,必须点赞啊，真心觉得浙大要是有更多的老师像许端清老师一样认真负责，zju世一大真的是迟早的事情
135504,1553,许端清,2021-05-12 07:21:06,3,4,1,靠自学
135729,1553,许端清,2021-05-21 12:01:17,2,2,0,null
136270,1553,许端清,2021-06-15 02:06:08,10,13,3,学的c大程，态度很好，内容给差评，每次写完作业才讲到相关内容，而且教你如何打史莱姆，却给你打boss的任务，project写到吐
136553,1553,许端清,2021-06-21 03:33:20,4,6,2,c程老师给分是真的差，是真的
136944,1553,许端清,2021-06-28 12:00:46,0,2,2,老师真的好好 上课就感觉像一个和蔼的爷爷（bushi）在和你讲话 而且概念讲的很清楚 逻辑清晰 超棒！
137588,1553,许端清,2021-07-05 07:55:33,-1,2,3,C专题。出分前答一波。\n\n主要靠自学，先做作业再上课，两个project也比较辛苦，但也锻炼了很多。\n\n期末理论考主要靠刷历年卷，倒也不难。\n\n问问题老师会秒回，很耐心的解答。\n\n这学期收获最大的应该是最后一次project展示电脑连接出了问题，（大概分数也会因此很差，）老师教导的，以后总会要面对重大场合，多准备一些方案，提前去调试。以后会记住的。
138323,1553,许端清,2021-07-08 13:49:44,9,13,4,虽然这学期python还没出分，但是先来怒赞一波许老师，老师上课很清楚，知识点讲得很详细，人真的很好很和蔼，钉钉上的问题无论多晚都会回。私戳问问题也会很耐心解答。这学期调休少了节课许老师还特意借了教室给我们补课，对学生真的很好。虽然讲课有点慢，最后进度有点赶，但是这只是课时安排的问题。总而言之许老师真的很负责很好！！
138343,1553,许端清,2021-07-08 14:37:37,5,9,4,非常非常耐心的老师，我第一次多文件编程很多不会，他钉钉上给我讲了好久（前后好几个小时），而且有一次12点以后问老师问题老师还回了，我都感觉有点不好意思了
139475,1553,许端清,2021-07-16 09:09:55,1,11,10,许老师yyds！！！
139476,1553,许端清,2021-07-16 09:39:02,-2,7,9,分输出的越慢 捞的越狠 我i许老师
139606,1553,许端清,2021-07-18 10:35:21,48,65,17,没有通知的情况下，C大程采取五级制，别的班是百分制，五级制拿优秀也只有4.5，剩下的是3.5 2.5 1.5和0，直接寄了😅
139607,1553,许端清,2021-07-18 10:36:00,6,15,9,垃圾老师一生黑
139609,1553,许端清,2021-07-18 10:37:13,39,47,8,我真的无语了，其他大程老师都是百分制，xdq给我来个五级制：4.5，3.5，2.5，1.5和0，与百分制相差太大了，甚至没有满绩的人。无语了
139612,1553,许端清,2021-07-18 10:39:26,-12,3,15,好好好
139615,1553,许端清,2021-07-18 10:42:39,35,50,15,五级制？你的工资是不是五级制😅😅
139616,1553,许端清,2021-07-18 10:47:53,25,32,7,选择比努力重要，计科的学弟学妹，建议换老师，即使你做的很好，但毕竟大佬多，C大程是会正！态！的！
139617,1553,许端清,2021-07-18 10:48:52,10,17,7,差不多得了
139619,1553,许端清,2021-07-18 11:06:05,31,36,5,五级制一生黑
139623,1553,许端清,2021-07-18 11:47:45,14,19,5,😅😅😅
139628,1553,许端清,2021-07-19 14:05:11,4,9,5,客观评价 讲课好，有内容
139629,1553,许端清,2021-07-18 13:19:52,3,9,6,五级制确实挺无语的，但是老师确实是好老师。\n\n我相信还是功大于过的。
139632,1553,许端清,2021-07-18 14:51:24,-8,6,14,老师是一个很好的老师，评论吐槽五级制的停停吧
139633,1553,许端清,2021-07-18 15:16:46,8,9,1,这学期C大程其他班都百分制只有他的班五级制导致均绩低人一大截这一点无法原谅。
139655,1553,许端清,2021-07-19 12:38:31,14,18,4,本次c大程给分冲突，根本原因是正态分布，c程居然被认定为通识课程还得强制正态，为后续事故埋下伏笔。主要原因是因为老师未厘清给分机制，草率决策，为了图方便从成绩排名的前百分之二十和后百分之三十处采取五分制一刀切的方式方法，最终对绩点影响十分恶劣。横向对比其他老师，本教学班哪怕期中90+，互评90+，平时全勤也大概率只有3.5的绩点，而相同情况在其他教学班则至少在4.5的水平，作为2学分的课程，目前学分若按照50分计算，对均绩的影响就是1*2/52约为0.01，想必这对于均绩愈发趋于稳定的大家已经不算小了，0.01的差距几乎需要一门2学分的课程满绩才能弥补\n\n因此无论老师之前评价如何，这次都有逃不了的锅，也反应出了诸多问题。\n\n那么我们能否找到一个相对合理的给分方法呢？答案是肯定的，鉴于正态的强制性，其实可以从20%的地方分开，前面的给4.8、5.0，其他原本应该上90分但被正态的人全给89，后30%该按规则合理给分即可，然而事已至此，在此我说的再多也都是徒劳，唯愿我校越办越好，重振东方剑桥之荣光。。。。。
139719,1553,许端清,2021-08-06 13:16:26,25,27,2,四个理由别选这老师：\n\n1.C大程为方便使用一刀切的五级制评分制度，付出的努力与取得的绩点极不匹配；\n\n2.这老师的作业量大，布置的作业需要用到的知识点在下一周才会教到，相当于让你花费时间自学；\n\n3.老师不负责任，在使用五级制评分制度遭到大量同学质疑后默不作声，态度可见一斑。\n\n4.C大程互评规定十分不合理，按bug的数目扣分，造成做台球游戏的组分数比做思维导图、排序可视化的组分数更低的诡异现象（台球游戏的工作量远较另两个题目大，bug自然更多），选做台球游戏的组妥妥的吃力不讨好，干最多的活得最低的分。
140783,1553,许端清,2021-09-16 04:55:30,5,5,0,虽然已经改过来了，不过给后来的学弟学妹们科普一下五级制对应绩点，如下：\n\n100-90 4.5\n\n89-80 3.5\n\n79-70 2.5\n\n69-60 1.5\n\n<60 0\n\n你算一下89分按两种绩点算法相差多大！只有70分这一种分数，五级制会比正常的绩点高！
140823,1553,许端清,2021-09-16 11:49:00,0,2,2,挽回一点评分 老师后来改成百分制了 不容易不容易
140858,1553,许端清,2021-09-17 02:20:05,-3,2,5,真的挺好的
140974,1553,许端清,2021-09-18 23:48:58,6,6,0,最近五级制改成了百分制，但是我看到的是有25%的人在八十分以下，远远高于正态要求的分数，据我所知其他大程老师好多都是捞上一两档，因此尽量大程不要选择许端清，费力不讨好。
140987,1553,许端清,2021-09-19 10:03:41,7,7,0,第一节课就布置三个小时以上的作业，上课就在吹牛，作业根本不会做
141387,1553,许端清,2021-10-05 06:39:00,4,5,1,作业太多了
141419,1553,许端清,2021-10-08 01:47:12,14,18,4,老师上课不讲计算机，讲的是思政和历史，上了两次课什么都没学到。回去作业一大堆，全靠自学和同学讨论。
141584,1553,许端清,2021-10-15 15:17:07,7,7,0,啥都不讲，直接做，没什么话说
141585,1553,许端清,2021-10-16 01:57:35,3,5,2,作业多了要死
141651,1553,许端清,2021-10-19 06:55:14,5,6,1,啥都没教
141885,1553,许端清,2021-10-29 14:51:08,1,3,2,不认真看学生作业。。
142088,1553,许端清,2021-11-05 12:09:29,-1,3,4,上的是老师的python，作为一个大一挂掉py的卑微文科生真的太恐惧编程了……但是老师很耐心很好，布置作业也很人性化，有同学没完成也会延长时间，最重要的是！最后给分真的爆好！！
143669,1553,许端清,2021-12-01 07:39:14,1,4,3,讲课逻辑混乱啊，不如自学
143735,1553,许端清,2021-12-03 09:31:04,-1,2,3,不考虑给分的话，真的是个好老师
143843,1553,许端清,2021-12-08 10:28:32,4,5,1,全靠自学
143959,1553,许端清,2021-12-14 09:04:17,1,4,3,讲课进度偏慢，但是课程质量还不错！
143977,1553,许端清,2021-12-15 02:00:50,5,9,4,自学确实是要自学，讲的慢一点也无所谓，但这是慢得离谱！！被隔壁老师甩了四大章了。。。
143984,1553,许端清,2021-12-15 06:29:20,0,4,4,许大炮，上课挺有意思的，认真负责，给分不知道，人很好
144396,1553,许端清,2021-12-21 10:42:28,3,7,4,怎么会有这么好的编程老师呢
144746,1553,许端清,2021-12-23 12:06:22,0,3,3,讲的内容非常深刻，给人留下很深的印象
144774,1553,许端清,2021-12-23 14:19:02,4,7,3,讲得很有意思，除了慢了一点什么都好
145170,1553,许端清,2021-12-28 03:42:24,17,18,1,许端清老师是我在大学里见到的唯一一个因为讲课太慢讲不完内容而补了课的老师，不知道这是好事还是坏事，平时全靠自习
145343,1553,许端清,2021-12-29 06:30:19,5,8,3,上课太精彩了，真的就是循循善诱，有很多收获!不过在上课前你要先自学一下
145357,1553,许端清,2021-12-29 07:25:33,11,15,4,最后一节课讲五个章哈，选他的c小程好好考虑哈
145927,1553,许端清,2022-01-04 11:28:19,24,30,6,全靠自学，上课进度奇慢无比，前面讲一大堆废话到了期末根本来不及，最难的几章内容反而一节课全讲完，根本不知道讲了啥
146124,1553,许端清,2022-01-05 14:01:19,15,18,3,自学了再认真听会很有收获，如果没有提前学的话会觉得很混乱。老师第一节课就讲了要自学，作业的安排也明显要求你自学。这是许老师的特点，选他的课的话一定要考虑清楚。
147080,1553,许端清,2022-01-08 15:13:32,2,4,2,老师不错，奈何听不懂，也没认真听。考完大计基希望能及格吧
149866,1553,许端清,2022-01-22 12:41:17,7,8,1,算了下平时分扣了四分，点名签到没有一次缺席，pta作业基本都是前20，思科什么也都做了
149919,1553,许端清,2022-01-17 20:29:11,-2,3,5,谢谢老师，教的很好，让人有学习的热情，人生第一个满绩！！
149935,1553,许端清,2022-01-18 01:51:39,1,2,1,许老师是唯一让我感觉有高中老师身影的老师，上课讲得细致、用心，如果自学了会很有收获。
150165,1553,许端清,2022-01-19 23:12:01,0,1,1,真的好
150170,1553,许端清,2022-01-20 00:35:01,10,11,1,对自学能力要求很高。
150181,1553,许端清,2022-01-20 02:08:03,7,8,1,（不针对老师）就是说，理论考真的很重要……就算平时分啥的基本满分，理论考没到90，也要凉……书上一些知识点还是有必要了解的，而且许老师上课进度慢，自学真的很重要。如果不想自学，上课尽量听一听啊……千万不要像我一样上课不听书不看，最后凉凉啊……（当然如果是理论知识扎实的大佬，当我没说）
150205,1553,许端清,2022-01-20 10:17:07,2,4,2,怎么说呢，作业多的一批 分给的少的一批，我怀疑他是不是不给平时分啊
150893,1553,许端清,2022-03-28 00:49:16,23,25,2,全靠自学
150974,1553,许端清,2022-02-21 12:22:30,0,2,2,许老师人很和蔼，很负责，也非常有水平。答疑启发性强
151576,1553,许端清,2022-03-08 07:04:22,8,10,2,上了别的老师的课才知道他少讲了多少😅
151872,1553,许端清,2022-03-18 16:57:26,6,7,1,许老师的作业很多，但是他很和蔼。每个问题都很认真地回答，最后还帮我看了一百多行的代码把错误一个个纠出来了，而且也没有批评我，真的能感觉到老师在身边耐心陪伴且帮助着自己。
152940,1553,许端清,2022-04-22 04:12:05,4,5,1,老师python讲的很好。人和蔼可亲，也很负责，必须10分。python选他的课就对了。
154049,1553,许端清,2022-05-20 13:42:50,2,3,1,态度好，算耐心的，但讲的少，做的多，及格吧，数字点名可云
154751,1553,许端清,2022-06-04 14:28:56,5,10,5,老师很不负责任，学习全靠自己，怎么还不下九分啊，C语言的基础各位一定要自己打好啊
154958,1553,许端清,2022-06-07 05:55:14,1,2,1,讲得非常好！
156110,1553,许端清,2022-06-17 14:49:43,7,8,1,上的c小程\n\n对学生态度好\n\n但课程组织一言难尽……\n\n七分
157665,1553,许端清,2022-06-24 09:25:14,6,8,2,给了老师9分。老师很和蔼，上课也讲得很好，唯一的缺点就是进度没有控制好，导致别的班都上图形库了咱们班还在上链表（但是期末有补课，那次老师开视屏会议一直从下午1：00讲到了5：00）。说实话，C程这门课就是要自己多多实践才能学好的呀，所以很感谢老师一年来的付出，希望下学期老师能控制好进度，这样就完美了！
158298,1553,许端清,2022-06-28 07:08:57,6,7,1,自学成才
158474,1553,许端清,2022-06-29 14:04:22,7,7,0,老师非常负责，学过他的c和Python，就是给分比较求是
158734,1553,许端清,2022-07-01 15:37:50,8,10,2,上的c大，对于2学分的课事巨多，课程进度拖沓导致后期需要补课，出分慢得离谱，截至现在，11天没出，希望老师提高效率。不过老师很博学，解答问题也很及时，给7分吧
158861,1553,许端清,2022-07-03 00:09:00,16,19,3,废话太多 努力了没什么用 绩杀
160829,1553,许端清,2022-10-15 10:10:09,0,3,3,纯靠自学
160952,1553,许端清,2022-10-20 15:25:56,-4,1,5,垃圾老师
160953,1553,许端清,2022-10-20 15:28:11,0,3,3,纯纯自学
161852,1553,许端清,2022-11-14 13:28:41,1,2,1,自学成才
162161,1553,许端清,2022-11-17 07:16:35,1,4,3,全靠自学，我要你干嘛
162399,1553,许端清,2022-11-21 13:34:03,4,4,0,表白助教ly老师！态度很好水平很高！很有耐心！
162548,1553,许端清,2022-11-25 05:11:06,-3,7,10,sb玩意，狗都不选
162616,1553,许端清,2022-11-29 08:08:24,3,3,0,老师回答问题秒回 态度很好 不过上课进度有点慢
163938,1553,许端清,2022-12-16 15:30:33,10,11,1,上过的人都说好......好像得靠自学？
163968,1553,许端清,2022-12-17 03:49:34,7,7,0,老师真的很用心
164095,1553,许端清,2022-12-18 03:59:19,1,6,5,我直接服了，**老师，考完试发复习资料有个锤子用？作业死多，还学不会
164152,1553,许端清,2022-12-18 12:57:38,2,4,2,作业是真的多\n\n讲课很清晰，但是考试重点不会强调\n\n作业多到离谱\n\n每次上完课开二十多道编程题和上百道理论题，每周都开新的，做完作业都精疲力竭了完全没有时间去在自己深入学一点\n\n上课进度有点慢，作业和上课内容脱节，具体表现为上课讲变量作业开指针，疯狂自学\n\n但是上课讲的内容都是很好理解的\n\n不太适合对程序完全没有基础的同学\n\n做题速度上被信竞佬爆杀，于是没有时间写数分和线代
164181,1553,许端清,2022-12-19 02:31:31,5,6,1,老师是很耐心的，提问都会解答，私发也会回，但是这门课好像都是在自学，而且作业有点多，新手真的要花很长时间（程序设计基础）
164236,1553,许端清,2022-12-19 13:45:44,3,4,1,许老师真的是我见过最负责任的老师！虽然我们文科生对djj的要求不高而且我们掌握能力偏差，但是！许老师上课都很耐心细致地把这些抽象的东西认真地解释！真的很好！而且许老师在上课的时候也会和我们讲一些道理，教我们一些学习方法，纠正我们的学习态度问题，人也很温柔！有些人pta没做老师也会重新开放延迟ddl，真的超好！我室友都羡慕我的老师哈哈哈
164268,1553,许端清,2022-12-20 05:28:25,3,4,1,上了老师的计算机科学基础（B），老师非常认真负责，真的很好
164319,1553,许端清,2022-12-20 08:46:11,2,3,1,老师讲课是真的挺好的，态度也好，就是对一个非信息类计算机类专业的学生来说，作业真的有点难完成...高评分是值得的，就是我已经被其他信息类计算机类专业的学生卷死了...嗯我不是和本班学生一块上程设...
165444,1553,许端清,2023-01-05 12:45:48,0,7,7,依托答辩，总是说讲一些新奇的东西，但是最后基础的知识讲不完。\n\n所以说还是得靠自学。\n\n进度跟不上别的老师，最后拿一节实验课的时间来上课补课，结果还是讲不完。、\n\n结构和一部分和文件都直接不讲了，上传学在浙大视频叫自己看。\n\n所以我真的觉得听他的课没有用。
165768,1553,许端清,2023-01-09 14:41:17,5,11,6,为老师抱不平，看到挺多人说课程很多内容靠自学，但是放眼所有老师不都是这样吗？考试范围上也明确写了是自主学习的内容不是吗？老师上课讲过很多课外的内容不假，但是我个人认为课上知识点比重真的很大，那些课外内容不过是更好理解一些需要死记硬背的知识点。而且说真的，作为浙江的选过技术的学生的真实感受，只要投入对待技术高考三分之一的认真态度就完全可以学到一个还不错的水平，更不用说老师平时算得上“随叫随到”——晚上十点钟问问题都可以秒回，后续还会跟进问题解决的情况。上课常常会“同学们要注意自己zju的名号啊”“zju东山再起就看同学们的态度了啊”，事实上是真的很关心同学们学习的态度和进度。本人虽然成绩也没有多好，但是平心而论，稍微认真一点，能学到的绝对比想象的多。
166956,1553,许端清,2023-01-14 10:32:36,3,4,1,上课认真，对计算机很多基础知识都有拓展，讲课进度需要调整，但是老师本身是非常负责的
166976,1553,许端清,2023-01-14 12:54:42,2,8,6,事情多讲课进度慢给分烂，能不选就不选。别人班的作业比他不知道少多少，真的服了。。。学弟学妹快逃！！！
167485,1553,许端清,2023-01-16 15:53:45,0,5,5,给分很求是，作业需要用到的知识点 会出现在半个月后的课堂上，对0基础同学不友好，基本靠自学，期末讲不完。
167488,1553,许端清,2023-01-16 16:01:30,9,11,2,学不会平时肯定没有用心去想学好，非浙江竺院选手，高中没有接触计算机花心思学了一个学期5.0，老师是挺负责的，要说真不一定会捞，但是可以让你获得你应得分。\n\n吐槽:作业真真真的多，为了作业我问了网络、同学，但是会很有收获。\n\n如果是真的想被督促的同学（觉得不学会低分有威慑的话）可以去选老师，如果只是一定要学这门课的话去找qh吧，听说会捞，但是不会太督促你学习
167500,1553,许端清,2023-01-16 17:06:04,7,9,2,C小（H）\n\n老师人是好的，会热心的帮助同学解答问题，但是问问题时总是让人“分析分析”不免会让人有点不耐烦，本身一道一分钟能讲完的题目可能被拖成十分钟，虽然老师可能是想让我们更深入了解一下。\n\n因为浙江技术+信竞，所以知道他上课经常会讲错一些东西，感觉老师对于一些细节的东西没有特别把握，而经常在意一些概念性的东西，在期末考题中亦可见一斑（感觉会有挺多模棱两可的东西），希望他能继续改进（把他上课讲错的都和他说过了）。\n\n讲课进度确实是慢，到最后到指针、文件草草收尾，自行搜索也是可以自学的。\n\n关于作业量方面，可能确实有点多，一周作业实验题多则30+道，本人1h左右写完，没学过的同学大约需要3~5小时甚至以上，这点需要注意（不知道其他老师如何，不过正因为有这么多题训练大家实验题基本上不会被斩杀）\n\n针对“本次作业需要用到下周学的知识”此观点：老师设置提交的ddl是在两三周之后，完全可以等下次上完课再去做。\n\n实验课助教说可以不去，只是用来催促没有写作业的同学。\n\n许老师的分数由pta作业（15%）+点到（5%）+期中（10%貌似不包括期中实验）+期末实验（20%）+期末理论（50%）+附加分（5%额外几道大程）组成，前三者加上额外分为平时分（30%），只要是做了基本都能满的，因为作业正确率不需要很高，附加分都能拉回来（至少是二三分吧），所以还是看理论和实验，不过难度也不大。
167789,1553,许端清,2023-01-19 05:31:23,2,6,4,负责耐心
167819,1553,许端清,2023-01-19 08:49:43,2,6,4,不会捞人+卡绩，想死
167850,1553,许端清,2023-01-19 13:03:59,0,1,1,提前留作业真要命
167853,1553,许端清,2023-01-19 13:25:05,4,4,0,老师很温柔负责，但期末很求是
168027,1553,许端清,2023-01-23 03:43:20,7,8,1,虽然打分很不理想，但确实一方面是我准备得不够充分。老师非常和蔼慈祥，经常帮我们延长作业期限，尽管作业有点多。总而言之，很不错。
168441,1553,许端清,2023-02-16 13:58:24,3,5,2,被无情斩杀挂科力。。。
168885,1553,许端清,2023-02-23 08:39:49,4,5,1,上课慢
171107,1553,许端清,2023-03-16 04:24:10,10,11,1,c小c大都是这个老师，不清楚讲课的水准，但是答疑很负责，关心学生，能俯下身去踏实做本科生教育的老师。
171290,1553,许端清,2023-06-19 02:46:21,17,22,5,好老师，他的课对刚接触计算机的新手及其友好，他太好了
171736,1553,许端清,2023-04-03 13:48:19,4,7,3,本人愿意把马里奥的一颗BULLET分享给敬爱的许老师
171737,1553,许端清,2023-04-03 13:47:39,6,8,2,本人愿意把马里奥的一颗BULLET分享给敬爱的许老师
171958,1553,许端清,2023-04-13 14:53:55,4,4,0,真的是年少不知许老师好啊！太幸运遇到许老师作为我的c小，算是c语言的启蒙老师，讲课深入浅出，认真听其实讲得很清楚，也很有重点，PTA既是复习也是预习，认真完成期末几乎不会扣分，没有一个知识点超出。老师会在凌晨秒回我的答疑，还启发我思考，真的很感谢老师，希望有机会还能够上老师的课！
172176,1553,许端清,2023-04-21 07:20:58,1,3,2,上课认真听，课后及时智云排疑；作业认真完成，大计基笔记整理完整。期末喜提4.5\n\n年少不知许老师的好，现在上了别的老师的Python感觉讲课真的不如许老师清晰明了！
172225,1553,许端清,2023-04-23 02:32:45,-3,2,5,c大上到期中了才发现二进制文件根本没讲，只是上课提了一嘴让自学。
173275,1553,许端清,2023-05-17 11:03:54,21,22,1,私聊答疑秒回；劝学型教师；发型别致
173465,1553,许端清,2023-05-25 13:06:55,10,10,0,大三老人了，大一上的许老师C小程，觉得许老师绝对值得一个9以上的分数，来刷个分。\n\n许老师分低，大概率是因为评论他的大都是大一的同学，还没有经受其他老师的毒打。转眼间，我本科的课程就快结束了，回忆这三年，遇到的抽象老师真是不少（当然主要还是指教学水平上，老师的人品至少我遇到的都不错）。我大一时也觉得许老师教的不好，但此时再想起许老师，真是觉得有幸遇良师。
173466,1553,许端清,2023-05-25 13:06:52,4,4,0,大三老人了，大一上的许老师C小程，觉得许老师绝对值得一个9以上的分数，来刷个分。\n\n许老师分低，大概率是因为评论他的大都是大一的同学，还没有经受其他老师的毒打。转眼间，我本科的课程就快结束了，回忆这三年，遇到的抽象老师真是不少（当然主要还是指教学水平上，老师的人品至少我遇到的都不错）。我大一时也觉得许老师教的不好，但此时再想起许老师，真是觉得有幸遇良师。
173484,1553,许端清,2023-05-26 03:16:10,1,9,8,作业巨多，讲课巨慢，考试巨难，被预置他的人，快跑！！！！
173487,1553,许端清,2023-05-26 03:36:33,-4,3,7,点名 烦死了
173488,1553,许端清,2023-05-26 03:37:00,1,1,0,已完成
173489,1553,许端清,2023-05-26 03:40:03,0,2,2,确实一般
173786,1553,许端清,2023-06-03 01:36:09,-5,2,7,呵呵呵
174345,1553,许端清,2023-06-10 07:02:30,5,7,2,许老师真的是个好老师，刷低分的可能真的没经过别的老师的毒打。至少我觉得他的分数不应该这么低
174762,1553,许端清,2023-06-17 05:56:41,7,7,0,老师还是不错的，就是讲课进度把握的不好，最起码，课后能细心回答我的问题，钉钉秒回已经令我非常感动了😭感觉老师不像是那站在台上讲课的老师，更像是一个需要你自己学，学不懂的地方去问他，他给你答疑解惑的老师
175280,1553,许端清,2023-06-23 07:26:49,3,3,0,还没考试，但老师真的很好，平时上课虽然进度开始有点慢，但讲的还是很细的，钉钉上问的问题都会很快回复，而且非常认真。
176686,1553,许端清,2023-06-29 16:56:54,2,2,0,很好的老师！很恪尽职守的老师 但是我小测错了好多平时分估计死翘翘 但是真的能学到一些东西的
177348,1553,许端清,2023-07-03 03:25:18,2,2,0,没挂，谢谢老师！给了十分
177891,1553,许端清,2023-07-05 09:26:48,1,8,7,一坨屎
178070,1553,许端清,2023-07-06 14:32:01,3,3,0,6这是一点不捞啊
178071,1553,许端清,2023-07-07 05:05:46,0,3,3,实验第一场，理论最后一场，全部最差场次。出分最慢，一分不调，服了。讲课还不错，建议别选。
178074,1553,许端清,2023-07-06 15:02:55,3,3,0,确实有收获，但是想拿高分保研或者的话快跑吧
178517,1553,许端清,2023-07-13 06:07:57,2,2,0,老师上课进度有点慢，出分也很慢，但是人很负责，我两次凌晨零点以后问老师问题都可以秒回，有一次甚至让我把程序发给他亲自debug，可冲
178519,1553,许端清,2023-07-13 07:05:23,6,6,0,1点问问题还秒回的老师，
178713,1553,许端清,2023-07-19 09:18:52,0,0,0,C大\n\n老师非常认真负责，授课和答疑都很仔细，但是期末给分比较求是，对于绩点压力不是很大且真正想学知识的学弟学妹们可冲
178895,1553,许端清,2023-07-29 10:31:24,6,9,3,22届大一C大满绩，来这里说一说上许老师这门课的感受：\n\n先说优点，优点就是我觉得许老师真的很认真负责，是一位真的热爱教学，能够俯下身和同学们交流的老师。老师上课讲的还是很有启发性的，且涉及的一些内容，比如手把手教你如何组织多个文件，比如教你怎么自己写抽象堆栈函数库之类的，都有着很大的启发意义。可以说这门课是一门真的能让你学会很多东西的课。\n\n至于缺点，首先就是这门课的任务量实在是太大了，大的不像是一门只有2学分的课，两个大作业更是十分浪费时间。尤其是第二个大作业，复杂的程序功能想实现太耗时了，而且这其中又涉及几个组员协商的问题，如果组里有人摆烂的话，工程量真的会特别大。\n\n还有一个缺点就是这个老师太喜欢点名了，早八的课几乎一半的时间都在点名，如果不太喜欢上课的话建议选别的老师的\n\n至于很多学长提到的给分问题，感觉今年是好了很多（当然今年题也确实简单），也没有用五级制的给分方法。\n\n综上，我觉得是否要报这门课还是要看情况的，如果真的想好好学C而且时间充裕的话可以报这门课，否则还是该再考虑考虑
181534,1553,许端清,2023-10-25 02:28:02,-12,6,18,感觉课上什么都不讲
184125,1553,许端清,2023-12-10 07:24:27,0,0,0,老师水平很高，讲课很认真细心，内容丰富有趣，课后问问题会很耐心地回复，许老师的课适合认真听课的同学去听，虽然经常点名但我还是很喜欢许老师！
185374,1553,许端清,2023-12-28 12:38:21,1,1,0,虽然是五级制，但我觉得老师是很用心在给我们讲授知识的，特别和蔼也特别负责，是浙大为数不多好好搞教育的好老师，真心来说，讲课也真的讲得很好很细，虽然计算机不好最后可能被绩杀，但是是我自身的问题，还是很想给许老师点赞
185385,1553,许端清,2023-12-28 15:08:00,2,2,0,老师每次上课都会笑眯眯的，有问题问他也是积极回应，对同学很好。但是老师小测难，不好拿分（大计基b）我室友他们都是出原题送分，而且感觉老师挺求是的，没有计算机基础并且想水的最好不要选，不过老师很认真负责就是了。另外发型很美丽。
186595,1553,许端清,2024-01-12 03:57:56,1,1,0,老师虽然不捞人，但是上课讲的很细很慢（大计基课的通病），对于忘记ddl的同学从来不为难，对教学任务很上心，至少我觉得不至于8打头
187542,1553,许端清,2024-01-16 13:25:25,0,1,1,中规中矩
187581,1553,许端清,2024-01-16 16:27:33,3,3,0,大计基点名挺多的 \n\n作业开放比较早且题量大 但是人很好 PTA会重新开放让我们订正\n\n小测喜欢自己出题而不是放PTA原题 所以相比较而来小测得分普遍不高\n\n给分应该是比较求是的 但是上课很认真 讲解很细致 答疑也很耐心
187820,1553,许端清,2024-01-17 13:57:49,0,0,0,讲课认真投入，经常会提出生动的比喻供学生们理解。
188507,1553,许端清,2024-01-19 06:05:59,5,5,0,老师认真负责，深夜发钉钉还会回，PTA到ddl会重开，虽然还没出分，但老师真的挺好的，给10分！
189230,1553,许端清,2024-01-22 12:27:49,3,3,0,老师上课极其认真负责，循循善诱，受益匪浅。美中不足之处在于进度略有些慢，打满分！
189353,1553,许端清,2024-01-23 11:04:01,15,15,0,"许老师非常好。上课经常强调professional和""不仅要work hard，更要work smart!""，已经属于是经典了。讲课讲得非常细，有各种生动的例子，也有补充很多拓展知识，提升思维。凌晨问老师问题也会秒回！一点点小缺憾课程进度偏慢，最后有点来不及，但是老师录制课程发到学在浙大上。平时作业可以看作对知识的预习，小测有一点难度，但是经历过小测对付实验考试轻轻松松易如反掌。老师比较严格，但是绝对是好老师！！！"
189551,1553,许端清,2024-01-25 10:47:13,4,4,0,许端清老师真的是一位好老师，虽然讲课比较慢，但是作为一位C程小白真的学到了很多！
189604,1553,许端清,2024-01-25 16:33:16,3,3,0,出分感觉还可以...比预想的高
189611,1553,许端清,2024-01-26 02:17:38,2,2,0,老师认真负责，上课讲得很仔细
190483,1553,许端清,2024-03-05 13:46:25,1,1,0,还可以
190489,1553,许端清,2024-03-05 14:04:04,3,3,0,很负责的老师，不过也希望老师可以稍微加快点讲课进度～～
190495,1553,许端清,2024-03-06 03:52:39,1,1,0,可以的
190970,1553,许端清,2024-03-26 14:19:13,-15,7,22,依托，讲课进度和作业进度不匹配，上他的课不如看wk
191272,1553,许端清,2024-04-16 09:36:09,7,9,2,讲课慢或许是许老师最大的缺点，但是老师讲得真的很好很仔细很耐心，而且深夜问问题老师也会回，真的是很负责任的老师，点名是数字点名。
192594,1553,许端清,2024-05-24 10:29:45,3,3,0,是一位好老师
193842,1553,许端清,2024-06-20 06:37:09,2,3,1,来给老师打个高分，高分打给爱做好事的老师
194002,1553,许端清,2024-06-21 10:05:22,1,1,0,好好好！！老师人超级好！超级有耐心，讲得也很清晰，上课好好听能进步不少，而且会有重点提示，强推！🥰
194004,1553,许端清,2024-06-21 10:17:44,3,3,0,好老师，很照顾学生，会延期过了ddl的pta作业
194060,1553,许端清,2024-06-21 18:25:31,2,4,2,老师答疑挺负责的，但是补了好几次课，上课效率有点低？他自述是为了讲的更清楚（一定程度上是这样），但是课堂上难免又有一些无关紧要的话。给分非常求是。学习python的同学或许可以有更好的选择。
194156,1553,许端清,2024-06-22 09:06:59,4,4,0,个人感觉非常耐心的一位好老师
194758,1553,许端清,2024-06-25 09:22:39,4,4,0,老师讲课对基础不太好的同学很有帮助，虽然我绩点很低，但是没挂科知足了，感谢老师
195820,1553,许端清,2024-06-30 05:07:48,4,4,0,少见的认真对待学生的老师
196195,1553,许端清,2024-07-02 06:50:12,3,4,1,老师非常有耐心，把你当小白讲，非常适合零基础的同学，虽然讲得很慢但确实是重点（尤其是期末理论的重点），平常数字点名。C程期末成绩占比很大，虽然附加题都没怎么做，期中考得很差，但是期末考得好就能特别高。
197214,1553,许端清,2024-07-09 08:32:52,4,4,0,挺不错的
199581,1553,许端清,2024-09-26 00:21:55,-1,2,3,满绩\n\n上课讲的细讲的慢，挺友好的，钉钉答疑也挺积极，适合初学者\n\n但是要点名，作业也有点多，还有就是讲的慢到最后一节课会讲三章内容，还留了一章让你自学\n\n期末考试和实验难度和评分和其他老师都统一的，平时分就是作业（pta），五次点名（随机的），和四次附加题（不强制做 做了能加分）\n\n总而言之还是蛮不错的
199626,1553,许端清,2024-09-26 10:40:41,2,2,0,讲课挺好的
200507,1553,许端清,2024-10-18 02:36:20,7,9,2,什么是知识的鸿沟？讲第二章做第六章的习题。
200541,1553,许端清,2024-10-18 11:54:18,3,5,2,cs 明明没有课还偷偷布置一堆作业
200888,1553,许端清,2024-10-24 05:47:57,4,6,2,上课进度永远比作业慢，作业还一下子布置这么多……
201331,1553,许端清,2024-11-01 00:53:12,11,12,1,台风天还要雷达点名，其他老师都说可以不用去机房。逆天了
201333,1553,许端清,2024-11-01 00:57:13,7,8,1,崩溃，台风天雷达点名
205415,1553,许端清,2024-12-06 04:17:48,0,0,0,考试废
207909,1553,许端清,2024-12-25 02:51:39,5,5,0,老师人真好，问问题回复超级快，回答的很用心，循循善诱我们发现错点
207911,1553,许端清,2024-12-25 02:57:06,3,3,0,许老师人真的好好，什么时候线上问题他都会耐心的回答，循循善诱，受益良多，真的不知道怎么会有人给许老师打低分，作业写不完完全是自己没有规划，每次作业给的时间很充裕，真的不想让这么负责的老师评分低
208029,1553,许端清,2024-12-25 08:31:48,3,3,0,适合初学者，讲课有点慢
208692,1553,许端清,2024-12-31 03:30:09,5,5,0,理性评价：讲课质量讲得是所有计算机基础课任课老师里数一数二的，作业题是所有老师里最多的，事多小测多作业难，想要磨炼自己的可选。
209949,1553,许端清,2025-01-07 14:05:45,1,1,0,太认真
212788,1553,许端清,2025-01-15 02:23:02,2,2,0,讲课和给分都很好，有问题秒回复。
212805,1553,许端清,2025-01-15 03:03:56,2,2,0,唯一的缺点就是对点名很执着（但最后总评也有人性化改动），老师上课可能有点慢，但回复问题绝对耐心细致😄
212840,1553,许端清,2025-01-15 04:47:52,2,2,0,C大程。老师人很好，讲课深入透彻，有耐心，而且给分好。讲课可能有点慢所以还需要自学一些，但是我实验失误了一道题最后还能满绩真的非常感谢老师了。
213331,1553,许端清,2025-01-17 03:45:35,1,1,0,上课进度超级慢，题外话特别多，链表和指针都没有详细讲，文件更是全靠自学，结果期末考这些又考得特别多😅但是除开这些缺点，老师确实人还可以，私下答疑很快。怎么说呢，可能只是他的授课风格不适合我\n\nPs：作业特别特别特别多
213577,1553,许端清,2025-01-18 10:16:28,2,2,0,讲得太慢了，不过能看出来老师很负责任，一次作业截止后还会开放订正
214617,1553,许端清,2025-02-15 01:36:01,2,2,0,挺和蔼的老师，作业偏多，但课后回复一定够诚恳，也许是最后一届了
214687,1553,许端清,2025-02-17 00:16:31,1,1,0,“今天我一定要让你学明白”这是我在期末复习问许老师问题，许老师对我说的。真的是一个好老师，会很耐心地给你解答，而且善于循循善诱。
214975,1553,许端清,2025-02-19 15:38:51,1,1,0,许老师人很好，回答问题的时候很认真，上课感觉讲的也是很受用的东西，个人感觉认真听收获很大！给分也挺好的，现在不是五分制了，真的是一个很好很负责的老师。（我C尖）
835,1601,黄忠东,2015-03-17 16:05:13,13,28,15,黄老师很有范，因为花痴他的个人魅力活活坚持上了一学期周五一二节课的数据库…
8588,1601,黄忠东,2015-09-23 01:25:14,11,13,2,上课太催眠了...讲得不清楚，没重点，没把概念突出出来
21752,1601,黄忠东,2016-03-01 03:23:27,9,9,0,讲的像一壶白开水，想睡觉
30868,1601,黄忠东,2016-07-02 16:45:49,9,9,0,说实话，数据库夏学期我没上过几节。因为前一天晚上都在赶大程，没那精力再从床上爬起来了。
33309,1601,黄忠东,2016-09-18 03:48:16,2,4,2,恩，声音很有磁性……但是讲的似乎不是很清楚……
48290,1601,黄忠东,2017-03-02 02:42:11,-2,1,3,帅！！！
51237,1601,黄忠东,2017-05-25 02:12:35,4,4,0,很迷的一个老师，感觉老师自己懂得很透彻，但是讲出来让人有点难理解。口头禅是很简单，对吧，是的吧。
52112,1601,黄忠东,2017-06-15 01:53:30,4,4,0,老师说话语调真的很让人觉得难受
77008,1601,黄忠东,2018-04-28 08:27:48,7,8,1,老师人挺好的但是上课没有重点不知道在干嘛助教平时作业也不认真批验收大实验的时候态度很不好还要搞恶竞比谁提前交微信上问问题也不回答不通融基本自学
82223,1601,黄忠东,2019-01-13 05:27:36,7,11,4,数据库系统可以说是我这个学期耗时耗力最多的课了。平时认认真真做小实验大作业。最后的数据库系统的大实验做的不知道多认真，搞了好久好久，还刷夜搞。可是呢，平时实验并不占多少分。课程是两个课合在一起的，内容本来就又多又杂，老师上课水平又不高，平时听课听不太懂，期末认真复习很久卵用没有，考试出的难得一批，绩点低的令人发指。完全不知道这种课的意义是什么？？上课学不到东西，费力又不讨好。为了4.0学分刷个低绩点？？绩点高的恶竞狗别来喷我，去跪舔老师和助教就好。
84315,1601,黄忠东,2018-07-12 13:54:02,2,4,2,别选这个老师的吧...\n\n数据库本身就难 然而这个老师事好多....\n\n讲课也讲不好..........\n\n然后觉得助教给分很严 呵呵 我也是醉了 平时的作业（不是实验）还有分A- A A+ 能想象的到吗\n\n这怎么学.............
112460,1601,黄忠东,2019-07-04 09:12:08,-20,1,21,都考完试了突然布置报告，影响我跟女朋友的约定！！女朋友气哭了！！！
114788,1601,黄忠东,2019-07-11 17:29:42,2,2,0,老师讲课水平迷迷的，期中之后真的再没听过，上课一不小心就会睡过去，所以期末绩点个人感天谢地，数据库事情是真的多，选之前做好心理准备吧。
114818,1601,黄忠东,2019-07-12 00:59:51,0,0,0,前面都说的差不多了吧。澄清一点，老师给分并没有传说中那么差吧……虽然考试周自学一门新课的压力还是历历在目
138527,1601,黄忠东,2021-07-09 15:38:26,0,0,0,2021年上课的体验也很不错，老师绝对没有评分说的这么差
143450,1601,黄忠东,2021-11-25 13:07:39,0,0,0,好老师，课还行
156088,1601,黄忠东,2022-06-17 12:53:05,1,1,0,老师还是很负责的\n\n但是数据库内容真的很多，老师上课还是以读PPT为主\n\n事情相对于sjl班还是比较少的\n\n总的来说也算不错了
156184,1601,黄忠东,2022-06-18 05:52:50,1,1,0,讲课不太清楚，但是老师人没有什么问题给分也中规中矩。大家的不满意更多来自数据这门课本身而不是老师。总之虽然称不上多好但是可选。
157145,1601,黄忠东,2022-06-22 05:13:58,0,0,0,事少，人不错，但数据库这门课评分还是期末考试和大程占大头，想拿高分需要认真写作业+复习，感觉和老师关系不大
158237,1601,黄忠东,2022-06-27 16:32:12,2,2,0,一次课都没去，作业都写了，就考前学了8小时，最终分很低……不过能及格应该不错了
158249,1601,黄忠东,2022-06-27 23:53:04,0,0,0,老师人挺好的，给分也挺求是的
158704,1601,黄忠东,2022-07-01 13:00:30,8,8,0,上的是数据库，上课虽然不点名，但是会有随机随堂小测，主要集中在春学期，夏学期印象中一次都没有。老师讲课语调很平淡，只能靠自学，但是人挺负责的。\n\n另外如果要刷绩点的话，死都不要选，给分很求是甚至偏低，今年数据库题型改革，其他老师平时分基本给满，只有他是一点都不调分的，问了其他几个班的，基本都是4开头，问了我们班的，就没看见上4的\n\n而且这学期的助教wym就纯傻逼，估计是被老师强行拉过来的，不情不愿的，每次回消息都已读不回，然后验收也很水，不在乎你做的怎么样，只在乎你做了没有，连bonus都不给你加，只能说，这门课，碰上这种助教，你认真写实验你就输了，搞不懂有什么意义，辛苦写了一两个礼拜的minisql，把自己状态搞差，结果还没有任何回报的，就纯牛马\n\n本身就处于保研边缘，一个数据库只有3的绩点，出成绩的时候整个人都崩溃了，到今天都没缓过来
196572,1601,黄忠东,2024-07-04 05:59:09,5,5,0,23-24春夏数据库系统，出分后感觉给分还行（？）因为常年听的sjl的智云，课基本上只有开学前三周去上了，后面一直都是不在现场上课\n\n夏学期因为各种ddl所以也基本没有学过内容，完全靠期末周补天补起来\n\nminisql一定要尽早开始做（感谢我非常强的组员一直push，否则期末周真寄）\n\n考试是A4开卷，不过今年刚好卷子改革（还是hzd出的卷），考试内容偏重于概念理解？反正A4甚至基本没用上，连B+树都没考\n\n今年的助教非常好，在春学期做图书管理系统时还为我们延了很长的ddl，他说“只要你们做了就不可能给你挂了”\n\n点名采用课堂的随机小测，小测参加就有点名的分\n\n老师讲的其实也还行，就是咳嗽非常多
21117,1642,徐雯洁,2016-02-18 07:43:02,-6,5,11,为什么不可能打零分
21416,1642,徐雯洁,2016-02-28 16:05:35,1,5,4,评分1、0是什么鬼，，，老师挺好的啊
26073,1642,徐雯洁,2016-06-15 11:06:13,0,4,4,老师很好\n\n
26075,1642,徐雯洁,2016-06-15 11:11:36,5,8,3,“嗯”\n\n“哈哈”\n\n“你觉得呢？”\n\n“挺有想法的”\n\n“你这个边很毛糙啊”\n\n“你这个地方没有粘好”\n\n(甩头发)\n\n红红火火恍恍惚惚很好的老师，人超好懂得多话不多
26423,1642,徐雯洁,2016-06-18 09:03:32,12,21,9,我觉得是超级好的老师啊 还很有个性。可以和兄弟一样相处的吧 真的 反正我是那么觉得的
34848,1642,徐雯洁,2016-10-25 04:48:25,1,3,2,nice
45454,1642,徐雯洁,2017-01-29 00:12:19,10,14,4,作业多
45727,1642,徐雯洁,2017-01-20 03:48:08,8,11,3,老师个性超傲娇(๑• . •๑)，虽然严肃但是，但是觉得莫名的可爱
59305,1642,徐雯洁,2017-09-20 15:34:32,5,6,1,作业多
65472,1642,徐雯洁,2018-01-04 08:54:31,5,5,0,还不错
71434,1642,徐雯洁,2018-01-28 12:31:29,6,6,0,老师 怎么还不出成绩啊?
86381,1642,徐雯洁,2018-09-14 11:40:23,2,3,1,有点可爱鸭！！！
87740,1642,徐雯洁,2018-12-20 14:32:33,-9,4,13,垃圾。
91239,1642,徐雯洁,2018-12-04 03:38:46,1,1,0,我有一个梦想\n\n活的跟徐老师一样刚\n\n\n\n\n\n让人又爱又恨的大姐姐?
102487,1642,徐雯洁,2019-02-03 10:12:50,6,9,3,唔……怎么说呢，作为工设的专业课，这节课确实累得要死要活，我说实话我自己也花了很多心血在上面，这学期一半的熬夜都是为了这节课，该交的我也全交上去了……但是最后的绩点比我的思政课还要低很多就让我怀疑人生\n\n现在有点难受……\n\n应该是我自己菜吧，求大佬们轻喷
103138,1642,徐雯洁,2019-02-26 06:35:30,1,2,1,同意楼上，看了看课程的平均分，再看看自己的分，简直不要太低，后来还找老师查了小分。但查了分之后还是心服口服的，每一项扣两三分，最后出来就是这样的结果，只能感叹自己技不如人。。老师还是很好的，知道我分低之后很耐心的给了我以后学习的建议，还是继续努力吧。。
120453,1642,徐雯洁,2019-12-09 01:42:18,0,0,0,可爱鸭
123741,1642,徐雯洁,2020-06-13 07:04:25,4,4,0,上课能学到东西，这个比啥都强好吗
127396,1642,徐雯洁,2020-11-22 11:14:23,1,1,0,老师超可爱qwq！！！
133194,1642,徐雯洁,2021-02-16 08:19:47,1,1,0,作业多，要求高，但为人很宽松，比隔壁空间构成课能学到更多东西
140662,1642,徐雯洁,2021-09-15 02:33:27,0,0,0,xxxxx经典卡绩点，感觉自己还挺好的但是分不高
150598,1642,徐雯洁,2022-02-03 08:47:06,2,2,0,老徐性格太设计了hhh，实力真的很强，给分也不错，对于作业很随意深得我心哈哈哈哈哈哈
203869,1642,徐雯洁,2024-11-21 15:29:47,-4,0,4,畜牲\n\n有看到这条评论的，它死的那一天，你打我电话19012770986，我请你吃饭（如果不方便我可以V你50）
213938,1642,徐雯洁,2025-01-21 16:35:36,0,0,0,给分不错，就是事情有点多
214534,1642,徐雯洁,2025-02-11 13:29:36,1,1,0,认真学能学到东西，老师人很好
2,1665,楼学庆,2015-03-13 00:57:23,1,4,3,人称楼sir
4,1665,楼学庆,2015-03-13 04:54:46,4,23,19,嘿嘿嘿，楼sir挺萌的，每周写日记挺萌
5,1665,楼学庆,2015-03-13 04:58:43,18,23,5,据说计组和汇编工作量比较大，估计他自己也比较用心。我上的java程序设计和智能终端，真的是上课水到不行。我个人觉得他对这两门课不怎么用心
6,1665,楼学庆,2015-03-13 04:58:51,4,11,7,听说楼sir很认真，很萌，考试。很。。。
83,1665,楼学庆,2015-03-14 15:43:46,8,9,1,随性
127,1665,楼学庆,2015-03-14 16:02:41,45,68,23,毕业都7年了，印象中他长得像张信哲，有没有同意的？
609,1665,楼学庆,2015-03-15 07:03:47,3,7,4,好萌好萌的
760,1665,楼学庆,2015-03-16 11:42:24,0,9,9,课程绝对不水，要花时间，同时也能学到很多东西
855,1665,楼学庆,2015-03-18 01:10:11,89,104,15,这学期是他的java！第一节课教室满人的！今天过来第二周教室里只剩一半了！妈蛋是都退完了吗！你要我咋办！委屈的哭了出来！
1013,1665,楼学庆,2015-03-21 08:58:59,20,23,3,只上过java，很水。。楼sir大概只对硬件课上心，给分感觉也很随意
1298,1665,楼学庆,2016-06-15 16:09:41,3,24,21,一年之前上的楼Sir计组，平心而论，是我在计院上的最有收获的一门课，甚至超过姥姥的数据结构。学弟学妹们不要怕作业多，等你将来工作或者读研，或者去实验室，你的绩点远没有你的能力重要，不要舍本逐末呀
2316,1665,楼学庆,2019-03-07 08:00:49,-170,19,189,楼Sir博学，开课之多，内容之广，院里恐怕没几个人可以比肩。本人有幸从楼Sir手上拿到20+学分，可惜从来都只给4.5
3429,1665,楼学庆,2015-06-12 10:34:20,15,15,0,感觉对java课不是很上心
3613,1665,楼学庆,2015-06-17 01:49:16,4,4,0,并不想说什么
7621,1665,楼学庆,2015-09-15 06:41:49,-4,1,5,好赞呀
9221,1665,楼学庆,2015-10-17 14:41:30,-7,9,16,楼sir很萌你们不要黑他，虽然给分不怎么样，但是可以学到很多东西
9295,1665,楼学庆,2015-10-20 10:40:16,1,3,2,幸福:)
10179,1665,楼学庆,2015-11-17 07:00:32,-2,2,4,超萌啊
12705,1665,楼学庆,2015-12-24 02:15:36,6,10,4,我觉得楼sir长得像福山雅治诶！人其实超好呀 和蔼可亲！就是给分比较随性.....
15916,1665,楼学庆,2016-01-16 15:10:26,8,8,0,一般，听了一节课就退了~~底下有人装逼，谁来管管？
19074,1665,楼学庆,2016-01-23 08:01:50,8,9,1,不负责任好吧
20574,1665,楼学庆,2016-01-28 13:52:09,2,2,0,其他都好，就是给分太随性了(；一_一)
22862,1665,楼学庆,2016-03-13 18:56:12,-5,7,12,很喜欢楼sir。虽然作业描述的不是很清楚，要花好多好多时间做作业，然而收获还是很大的。而且。很帅。
23556,1665,楼学庆,2016-04-06 03:52:29,12,13,1,作业非常多，小心一点，因为妓院大二本来就忙，如果不是真的感兴趣可以不用选楼老师\n\n
24285,1665,楼学庆,2016-04-29 06:14:04,14,15,1,坑爹坑爹
24535,1665,楼学庆,2016-05-01 07:59:08,11,12,1,想学点东西可以来旁听，选课还是不要选了，事情多而且很多和课程无关的作业，很麻烦
25755,1665,楼学庆,2016-06-06 15:05:53,11,11,0,作业太多！！！如果不忙可以选，不然请远离！
25993,1665,楼学庆,2016-06-15 03:12:49,26,28,2,作业真是没法做
26033,1665,楼学庆,2017-01-16 17:37:45,29,45,16,垃圾老师，上课讲得烂，没有正经学术背景，什么都稀里糊涂，根本学不到东西，就会讲些没用的东西，上过楼的课都知道他垃圾，学弟选课慎重，一定避开！
26168,1665,楼学庆,2016-06-16 06:44:24,1,1,0,布置作业突出一个随性...上课还好...
26420,1665,楼学庆,2016-06-18 07:41:40,11,11,0,布置的作业全靠自学
27062,1665,楼学庆,2016-06-22 13:55:12,23,24,1,楼的计组作业特别很多，但楼极少去看，有点不负责
27355,1665,楼学庆,2016-09-10 07:23:33,18,21,3,软件工程必修计原。。没别的话了……
29233,1665,楼学庆,2016-06-29 12:56:54,-4,1,5,考java前膜一发
29238,1665,楼学庆,2016-07-05 10:17:19,8,8,0,…………………
30148,1665,楼学庆,2016-07-01 03:52:23,6,6,0,给一分只是因为没有零分
30359,1665,楼学庆,2016-07-01 11:36:19,1,1,0,乱出卷
30375,1665,楼学庆,2016-07-01 12:28:03,2,4,2,出的什么jb卷子
30870,1665,楼学庆,2016-07-02 16:49:15,5,7,2,楼sir受我一拜，不挂我计原的话下学期再选你课。
31223,1665,楼学庆,2016-07-03 12:00:01,8,8,0,上java与考试无关
31466,1665,楼学庆,2016-07-04 02:53:10,-4,2,6,真的是好老师！上课讲的超棒
31717,1665,楼学庆,2016-07-04 14:55:43,11,11,0,作为文科生不能选他的java！上课很水，不讲考试的东西，平时只有不到一半的人来上课。上课不用ppt，感觉不上心不负责。给分又随意。
31993,1665,楼学庆,2016-07-05 10:34:44,8,8,0,java全靠自学，智商不够请不要选-.-
32026,1665,楼学庆,2016-07-05 11:44:55,-7,0,7,给分可以
32251,1665,楼学庆,2017-01-23 08:15:41,3,5,2,令人失望
32558,1665,楼学庆,2016-07-07 17:50:36,-1,1,2,给分真的很随意
33711,1665,楼学庆,2016-09-21 06:22:53,1,3,2,平时很和蔼…\n\n虽然平时的作业有点多\n\n但最后给分不错
38896,1665,楼学庆,2016-12-19 16:30:00,5,6,1,软工嘛。都要选的
40030,1665,楼学庆,2016-12-29 01:33:09,11,11,0,为什么我没有早点选楼sir的硬件课，这样我就能早点放弃硬件了(。•́︿•̀。)    希望学弟学妹们别去汇编与接口的坑，要选就选首山雄。
41686,1665,楼学庆,2017-01-12 10:55:47,8,9,1,你们尽管复习，考到算我输。\n\n-----2017.1.12汇编考试后
48847,1665,楼学庆,2017-03-15 00:56:03,72,74,2,课程网站透露出迷之审美与迷之趣味
49214,1665,楼学庆,2017-03-29 15:20:43,1,10,9,傻逼老师，只是因为没有零分，我才给他一分。
49297,1665,楼学庆,2017-07-04 10:11:27,-6,1,7,好 居然给我4.5
51603,1665,楼学庆,2017-06-07 12:13:19,3,5,2,讲课没有逻辑性，听不进去还不如自学
51731,1665,楼学庆,2017-06-15 04:48:23,-11,1,12,上了楼sir的计组课，其实还行，没有大家说的那么累。平时实验简单，单周期多周期大程一下午就写完了。汇编器模拟器可能花点时间，不过看你想做多好，有兴趣就多花时间，没兴趣随便做做呗。在施老师班的同学们肝mips大程的时候我们所有项目都验收完了。
51800,1665,楼学庆,2017-06-24 07:38:41,0,5,5,老师是真的好。。。\n\n学不好真的是怪我自己。。。
52956,1665,楼学庆,2017-06-24 07:02:41,1,1,0,但愿今天说的东西有用
55623,1665,楼学庆,2017-07-02 05:14:25,3,4,1,非常不负责任。
56769,1665,楼学庆,2017-07-04 14:48:00,42,49,7,计原给分莫名其妙毫无根据，超级随意。\n\n我是软工的学子，前几周平时作业比较多，几乎我每周花10多个小时，后期没什么作业，每周也得花3小时左右完成小作业，复习一些课堂笔记，我敢说我学的比大部分软工学子都要努力，认真，但是他一眼都没看过，所有作业都显示未批改。\n\n期中考分数应该前20%，期末考分数预测不会低于80，结果绩点低得超乎想象。\n\n结果我身边无数人，平时作业水水过，考试靠考前熬夜突击，结果都4.5、4.8甚至满，请问你评价的标准在哪里？你的随意让无数水的人获利，那么他们当然不会来喷你甚至维护你，但是你让我这种认真学习一个学期到头来血本无归的人如何是好？无力吐槽，一生黑。\n\n
57441,1665,楼学庆,2017-07-08 00:04:47,8,8,0,给分贼差，千万别选
57657,1665,楼学庆,2017-07-11 15:23:21,1,1,0,人好。
59312,1665,楼学庆,2017-09-20 23:53:58,5,5,0,java应用技术讲的还行，感觉对一些东西有自己的理解然后会带动你理解，感觉不错，不过讲归讲还是要靠自学
63140,1665,楼学庆,2017-11-28 15:31:43,3,5,2,想起来评论一发。楼sir作业多，作为渣渣上他的计组每周都要花一个星期六或者星期天写他的作业，平时每周还得抽空上板子（周末实验室不开）。当然如果组队作业你能抱到大腿当我没说。平时上课很棒，是我大一大二两年里最有收获的一门课没有吹。因为稍不留神听我可能就会听不懂（。另外最后给分给我的是3.9，也算是意料之中，总体来说老师人还是很棒的，思路清晰。
75424,1665,楼学庆,2018-03-11 15:00:23,3,3,0,…………
75635,1665,楼学庆,2018-03-14 09:48:31,-2,4,6,计组虽然实验很迷  但是理论课超棒  比sqs好多了
78819,1665,楼学庆,2018-05-15 10:08:28,20,21,1,唉。软工学子命途多舛
79502,1665,楼学庆,2018-06-07 08:22:00,1,2,1,作业和实验全靠自学，很累。
79503,1665,楼学庆,2018-06-07 08:23:44,12,12,0,为什么打1分呢？因为没有0分\n\n只说计组\n\n**讲一堆乱七八糟自认为的重点，考得到个卵\n\n网站永远没有复习重点，不如偷其他老师课件看\n\n每周一个大作业就问你喜不喜欢，期末本来事情就多还扔些屁事巨多的作业，关键大部分做的都是无用功，不是考点\n\n最tm神的是还有个每周周记，老子**，你以为你在教文科生？？？？tm每周就你计组事最多\n\n忙了一学期学了个球，知识不成系统实验随心所欲临时布置，精彩
79744,1665,楼学庆,2018-06-13 08:05:10,-38,2,40,这个老师挺好的\n\n计组实验抱了个计院大腿，只管划水\n\n平时作业就只用随便一个压缩包交上去\n\n后来担心露馅，但是期末恶补别的老师ppt，结果拿了4.8。推荐非计院的来选一选
80553,1665,楼学庆,2018-06-28 00:51:42,1,1,0,什么时候放弃xp?什么时候能教/接受一点新的技术?
82871,1665,楼学庆,2018-07-16 03:16:01,14,14,0,软工学子命途多舛 mmp
83646,1665,楼学庆,2018-07-15 23:42:29,1,4,3,我上的是楼老师的计组课，分为几部分来讲吧。理论课，讲课还是挺生动风趣的，其他班没有讲或细讲的指令集部分讲的很详细，CPU和存储器那部分也很清晰，另外还讲了一些其他内容。实验课，很多是一些很简单的实验，最重要的两个就是设计单时钟、多时钟CPU，但每周作业是真的又多又难，慎选。小组要做四个大程，强烈建议找好大腿再选，否则容易原地爆炸。
85150,1665,楼学庆,2018-07-15 23:42:13,5,5,0,实话实说，比其他机组老师差很远，别人用的是一套完整的实验体系，他都是自己设计，最后我们只能用其他班的东西，上课也几乎不讲题，最后复习也是看别人的PPT和小测，学的好的都是奇怪的人，有大四的，有选过一次重修的，反正很奇怪，建议还是选其他正常一些的老师吧
85162,1665,楼学庆,2018-07-16 01:08:56,8,8,0,计原这垃圾课
85163,1665,楼学庆,2018-07-16 01:14:12,8,9,1,极品 期末校对答案有90+ 最后得分63\n\n绝了
85167,1665,楼学庆,2018-07-16 01:23:58,6,6,0,看到绩点原地爆炸，真不知道下学期楼sir的Java要怎么活
85184,1665,楼学庆,2018-07-16 03:09:48,6,7,1,楼sir计原，推荐看nju袁春风老师的mooc，考试前只复习一些必考的点就可以。
85187,1665,楼学庆,2018-07-16 03:28:21,4,6,2,1分不解释，绩点直接爆炸
85427,1665,楼学庆,2018-07-17 17:05:49,-1,2,3,计原觉得老师上课讲的虽然啰嗦 但其实还行也比较好理解 只是没人听 给我的分其实挺高 但给分组成确实是个谜天天提心吊胆 考前得做一遍计组试卷 还要写感人周记 作业上半学期比较多 下半学期基本就一个FAT 反正下学期的JAVA我是不敢选他
85679,1665,楼学庆,2018-07-25 07:18:59,2,7,5,大二下学期上的计原，之前没有上过汇编、数逻Patt的计算机系统概论，X86汇编的部分学得非常难受，楼sir上课不用课件，所以讲起课来感觉不是很有逻辑，但其实讲得还可以，考试考的也都是上课讲过的东西，所以上课听听课还是很有必要。平时作业如果按照网站要求来做的话会很费事，但其实楼sir应该不会仔细看你的作业内容，有一个期中考试和一个期末考试，期末考试占比70%，考前复习一下他上课讲过的东西就可以完全不用担心，我4.8。
86299,1665,楼学庆,2018-09-12 14:39:31,-8,3,11,为什么老师给分那么好，上个暑期课程实践，我就随便交了点作业就5.0了？
86405,1665,楼学庆,2018-09-15 07:56:09,0,1,1,nice
92722,1665,楼学庆,2019-01-04 03:32:09,1,1,0,不知道
104496,1665,楼学庆,2019-03-21 15:57:52,5,6,1,不能再辣鸡
104578,1665,楼学庆,2019-03-24 05:39:55,3,4,1,计组作业贼多，而且没用
105103,1665,楼学庆,2019-04-03 15:53:29,5,6,1,讲得巨慢，巨没用。\n\n我都怀疑我学的是不是计组。\n\n某些地方变态的详细。\n\n内容与其他老师不一样，完全是另一套理论。\n\n作业多，每周300字周记……\n\n建议选隔壁施青松，任务量接近但是能学到真东西。
106433,1665,楼学庆,2019-04-27 10:43:20,16,17,1,计原。平时作业多到爆炸，两周至少一个大程，还都是那种没什么意义的东西。最烦的是，他从来不会看你的作业，真不知道期末怎么给分。期中考试，群里同学问了好几天了，死也不告诉考试日期，这是逼着我们每天都要复习吗？我们只用复习这一门课吗？学期刚过半，就对一门课产生前所未有的厌烦，学过这么多课也没有之一了吧，呵呵。绩点什么真的无所谓了，只求赶紧过完这学期。软工学子真的命途多舛，mmp！
108079,1665,楼学庆,2019-05-14 07:06:32,4,6,2,告诉我为什么前届的学长学姐没在这里给我们 排雷，java真的是要哭了
108091,1665,楼学庆,2019-05-14 13:44:34,-6,1,7,我挺喜欢楼sir
108522,1665,楼学庆,2019-05-27 14:15:35,-10,6,16,两年前选过楼sir的计组，今年9月去cmu读研，现在看暑课的video满脑子都是楼sir当时的讲解。说实话，楼sir对于整个系统的理解绝对要超过计院大多数老师(他之前好像说过计算机核心的四门课他都教？)，以后想从事硬件工作的话强推楼sir，当然不喜欢硬件的话还是不推荐，作业量实在太大。
108796,1665,楼学庆,2019-06-13 13:53:00,-1,3,4,为什么计原就这一个老师，而且感觉和计组区别不大
108811,1665,楼学庆,2019-06-03 01:06:06,14,14,0,非  常  天  空
108818,1665,楼学庆,2019-06-03 02:39:34,4,4,0,谁能告诉我他Java课在讲什么
109245,1665,楼学庆,2019-06-12 08:50:21,4,4,0,垃圾老师
110985,1665,楼学庆,2019-06-29 03:32:44,4,5,1,如    果    是   J   A    V   A   通    识    ，  快 ，  逃   ！   ！   ！   快 ！
111384,1665,楼学庆,2019-07-01 05:39:51,4,4,0,辣鸡辣鸡
112875,1665,楼学庆,2019-07-05 07:58:12,17,18,1,哭了，短学期讲的东西一点也听不懂
113339,1665,楼学庆,2019-07-06 08:23:06,8,8,0,计原平时这么多作业至今为止一次也没看过，我真不知道他打算怎么给分...
113346,1665,楼学庆,2019-07-06 09:10:22,18,18,0,短学期体验极差，
113550,1665,楼学庆,2019-07-06 23:53:13,6,6,0,呵呵 上课不知道在讲什么 给分还差
113605,1665,楼学庆,2019-07-07 01:09:52,3,4,1,教室空荡荡，上课自己high，课后没作业，考试不复习，课后问题目的话讲的比较好，其他时候一脸懵逼
113921,1665,楼学庆,2019-07-08 07:23:27,6,7,1,上课自嗨
114057,1665,楼学庆,2019-07-08 14:34:43,8,9,1,短学期真的不会...
114169,1665,楼学庆,2019-07-09 02:26:01,8,10,2,讲的都是些啥，前句不接下句的，跟主题也无关，只是在讲自己的，想到啥讲啥，太没水平了。作业还多，根本不是给人做的…非信息竞赛大佬慎选
114173,1665,楼学庆,2019-07-09 02:52:15,13,13,0,硬件基础没有硬件
114175,1665,楼学庆,2019-07-09 02:58:21,17,18,1,这小学期的课上nm呢？放下手机认真听课 听了一个小时发现啥也不动了 还不如ljj\n\n
114206,1665,楼学庆,2019-07-09 04:27:14,-5,14,19,不是，你们为什么说老师短学期课上的不好？难度和深度都有，作业量也配得上这个学分，难道都要像其他短学期一样水一水绩点又高才是好课么？老师对待短学期很认真，和长学期一样的时长作业量，还补充和硬件无关的东西，是能学到东西的。上课不听玩手机怪老师？作业难度高不才体现了短学期的质量么，大家好好努力吧，短学期不是随便水一水的，至少你得通宵写几天程序
114259,1665,楼学庆,2019-07-09 12:04:14,2,3,1,网站瘫了，过了一个下午 回了三个可爱小表情是什么鬼？？？
114582,1665,楼学庆,2019-07-11 00:48:05,24,25,1,计原，上课讲得不知所云，基本上没几个人听，大作业基本两周一个而且他基本不看，考试出的卷子更是随意糊弄，一些题目中大小写都没改，估计就是从课件中直接复制粘贴来的，还有not holds这样的语句，平时作业、小组作业都显示未批改，而且也不知道成绩是怎么组成，最后绩点爆炸，还卡绩，不知道他别的课怎么样，总之他对于计原十分不用心，然而计原是必修课，软工学子真的是命运多舛啊
114586,1665,楼学庆,2019-07-10 23:05:35,3,3,0,计原:希望老师下个学期找个助教
114605,1665,楼学庆,2019-07-11 00:08:01,4,5,1,楼下下下下高级黑，你们不要误伤
114687,1665,楼学庆,2019-07-11 03:58:32,7,7,0,为什么不能给零分\n\n
114716,1665,楼学庆,2019-07-11 05:41:32,9,9,0,我除了无语想不出其它的词。。
114746,1665,楼学庆,2019-07-11 09:09:30,31,31,0,虽然我没上这课，但是舍友气的让我也过来评论带话，他只想一刀把这老师杀了
114748,1665,楼学庆,2019-07-11 09:22:53,10,11,1,什么jb短学期啊，啥也没学到，还要考试，我寻思也没教过啊，强烈建议大佬们学这个短学期，菜鸡就算了，不要为难自己，带着个挂科或者1.5进入下一个学期是个人都顶不住。选课也尽量避免这个老师吧。yeah!
114750,1665,楼学庆,2019-07-11 09:27:05,6,6,0,自问短学期真心学的很糟糕，作业超出能力很多。要做的话就只能天天熬夜。\n\n老师人很好，答疑也很好。但是上课经常讲得我云里雾里，知识有点杂。而且没有PPT没有教材，只有网站上寥寥几张图片。\n\n各位想选千万慎重。现在我已经是在压着不爽码字了。\n\n
114755,1665,楼学庆,2019-07-11 09:38:45,2,2,0,呵（评论咋要三个字？
114913,1665,楼学庆,2019-07-12 17:13:54,3,3,0,计组出分怎么这么慢啊……我都蹲了好几天教务网了
114929,1665,楼学庆,2019-07-12 22:55:20,4,4,0,小学期的上课体验是真的窒息
115037,1665,楼学庆,2019-07-14 18:06:36,8,8,0,计组出分了....我也不知道分咋算的....学弟学妹最好别选，楼sir多时钟实验太糟心了
115138,1665,楼学庆,2019-07-16 04:37:15,4,4,0,首先我想问问为什么他的分数在上升，而且是结课之后
116476,1665,楼学庆,2019-09-11 01:31:48,1,1,0,小学期的成绩两个月都没出..\n\n你还出不出了
116752,1665,楼学庆,2019-09-22 06:39:18,-32,1,33,4.8短学期，既然没满
117206,1665,楼学庆,2019-09-20 09:13:45,0,0,0,今晚一点，谁是守夜冠军
117252,1665,楼学庆,2019-09-21 08:47:48,2,2,0,短学期挂掉了，现在就是后悔，非常后悔
117280,1665,楼学庆,2019-09-22 07:01:04,0,1,1,给分随意得有点过分了吧
117300,1665,楼学庆,2019-09-22 23:58:07,4,5,1,给分随意，希望计原他别再开，软工学子命运多舛
121631,1665,楼学庆,2019-12-11 14:43:40,0,1,1,一个有实力的老师 只是可能教学方式不太容易让学生理解和懂，但是水平可能感觉的出来还是很高的\n\n
122763,1665,楼学庆,2020-04-01 07:43:31,0,0,0,感觉讲课抓不住重点，会在一些奇怪的地方说很久，关键的地方又很快过去了，听不下去又怕错过重点，听课体验实在不好。。。
122839,1665,楼学庆,2020-04-13 12:14:38,12,12,0,大作业太多了，而且他从来不检查，鬼知道用什么来评分，软工学子真惨，计原只有他的课
124494,1665,楼学庆,2020-07-02 03:34:53,0,2,2,楼sir计原的数据表示部分有一些考研老师都没讲过的很便捷的计算方法 感觉还是有所收获的
125251,1665,楼学庆,2020-09-04 14:22:57,3,3,0,看得出来对硬件和系统的理解功力很深，但是教学能力着实不太行
125475,1665,楼学庆,2020-09-10 03:01:18,3,7,4,楼sir这学期给分突然变得很好，完全超出预期。楼sir，yyds
126231,1665,楼学庆,2020-09-20 08:18:47,278,286,8,之前我在学校里大喊一句楼学庆sb被严重警告了，本来其实不需要吃处分，但辅导员说我涉嫌泄露学校机密
131803,1665,楼学庆,2021-01-29 04:01:14,9,9,0,计原。。。平时作业完全不看，期末最后统一给个79分。。。而且前半学期作业还很多，建议不要认真写反正他也不看，糊弄一个交上去就好。最后考试的话倒是不难，但是会考一些x86汇编啥的，建议刷历年卷。给分差。。。平时问他问题也基本不回复，对学生感觉不大上心，但是人还挺有意思的
132885,1665,楼学庆,2021-02-06 12:06:35,68,70,2,曾经我年少无知，因为楼sir课讲得糊涂，平时作业也不管，给他打了1分。\n\n后来，我遇到了xw、qjs、zxq之流，才知道楼sir虽然上课很烂，但平时不会耽误我们的时间在计原上，你只需要把时间放在好好复习期末考试上，平时基本都不用花功夫，不像上述sb，平时花了时间，期末考的也不差，最后比其他班期末卷面跟你考差不多的同学低两档。\n\n我曾经以为楼sir是软工所有课程里面最差的老师，现在看来，进前五都有点困难。楼sir，曾经的神！\n\n\n\n最后补上一些有趣的信息：楼sir的微博@杭州楼，楼sir的知乎@JeepCar。学长们努力找到的东西一定要代代相传😎
133545,1665,楼学庆,2021-03-02 03:36:19,17,18,1,闻到狗肉香，耶酥也跳墙
134410,1665,楼学庆,2021-03-27 07:57:01,17,17,0,我的室友说楼学庆是神经病
134510,1665,楼学庆,2021-07-10 12:43:22,3,7,4,虽然讲课不知道在讲啥 作业也不看，不过今年给分真不错诶
138849,1665,楼学庆,2021-07-11 07:46:22,6,6,0,并行计算今年只有30个人选课，然后退到只有10个人，最后每次上课只来5个人，有时候因为隔壁计算机思想史要签到所以甚至只有3个人，这5个人中有2个是认真听记笔记，有2个是完全不听，有1个是时听时不听。\n\n因此楼人每次上课都会露出无奈的表情，并发出一声轻叹。\n\n毕竟去年线上还有30多个人来着。
138889,1665,楼学庆,2021-07-11 14:24:01,8,8,0,窗口\n\n 人\n\n   手\n\n   白\n\n    “快逃”\n\n          纸\n\n窗口
139080,1665,楼学庆,2021-07-12 13:15:09,9,9,0,快逃！快逃！快逃！快逃！快逃！快逃！快逃！快逃！快逃！快逃！快逃！快逃！快逃！快逃！快逃！快逃！快逃！快逃！快逃！快逃！快逃！快逃！快逃！快逃！快逃！快逃！快逃！快逃！快逃！快逃！快逃！快逃！快逃！快逃！快逃！快逃！\n\n\n\n\n\n\n\n\n\n\n\n\n\n\n\n\n\n\n\n\n\n\n\n\n\n\n\n\n\n\n\n\n\n\n\n\n\n\n\n\n\n\n\n\n\n哦，必修课呀，那没事了😅
144692,1665,楼学庆,2021-12-23 07:38:29,7,8,1,一个会在知乎上跟人为了共产主义事业而吵得面红耳赤的浙江大学计算机系统高级工程师，在知乎上因为力挺汉语编程而被群嘲外行不懂计算机……\n\n\n\n这个被人诟病的上课质量不知道是不是因为网瘾太大导致的……\n\n\n\n楼sir别的不说，就冲心态给个五分没问题！
147245,1665,楼学庆,2022-01-09 08:22:55,6,6,0,java 杭州楼
147254,1665,楼学庆,2022-01-09 09:48:11,10,10,0,昨夜西风凋碧树，看杭州楼，Java做的想吐。
147879,1665,楼学庆,2022-01-11 05:19:44,2,4,2,ads yds\n\noop wk\n\njava hzlou\n\nyyds!!!
151131,1665,楼学庆,2022-03-06 10:29:18,29,30,1,lxq还不如ljj，ljj起码每一年都在听取建议改进，ljj起码布置一百道题还给一个月，lxq直接一周一个带说明文档测试样例的大project第二周就反汇编，还搁那天天惦记着nmd汉语编程，汉语适不适合编程你自己心里没点b数，你是不是其他正经领域竞争不过别人才搁这自我催眠恶心学生啊
151156,1665,楼学庆,2022-02-23 14:45:34,5,5,0,第一次发查老师评论，留下第一节实验课后的评价：计组，快逃！\n\n还有，他好像真的对中文计算机有很深的执念。。。
151259,1665,楼学庆,2022-02-26 13:26:42,1,1,0,上课讲的例子听不太懂，老师自己应该对计算机还是有比较清楚的了解，奈何给分玄学，讲课很飘；\n\n怎么说呢，老师心态挺好的
151419,1665,楼学庆,2022-03-03 02:25:18,12,12,0,第二周就反汇编是吧，越多越好是吧😅
151465,1665,楼学庆,2022-03-04 02:00:27,12,13,1,软工学子很难绷得住。建议参考cc98小角龙的帖子。
151468,1665,楼学庆,2022-03-04 03:27:15,10,10,0,md（一种标记语言）
151593,1665,楼学庆,2022-03-08 14:06:46,23,23,0,汇编是什么呀？😅啥都不讲我写你吗的反汇编？你告诉我怎么写呀？上来就让我们把机器码转成汇编语言，有没有考虑过没学过的人呢？医研顶真，鉴定为：纯纯的脑瘫
151750,1665,楼学庆,2022-03-14 14:32:28,3,3,0,垃圾垃圾垃圾垃圾垃圾😓😓😓😓😓
151767,1665,楼学庆,2022-03-15 03:31:36,23,23,0,lxq，wrnxr😅
151781,1665,楼学庆,2022-06-24 09:40:28,15,15,0,用越大楼越老楼这句话来形容大楼老师真是最老楼不过了
151786,1665,楼学庆,2022-03-15 16:28:18,6,6,0,老哥们都太会骂了，多来点🤤🤤🤤
151787,1665,楼学庆,2022-03-15 16:41:13,9,10,1,只要是骂楼sir的，我都点个赞
151788,1665,楼学庆,2022-03-15 17:22:24,6,7,1,嘻嘻😁翼雁丁真：春春的飞舞
151791,1665,楼学庆,2022-07-01 13:35:54,25,26,1,面向小角龙笔记的复习方法 qwq
151818,1665,楼学庆,2022-03-17 13:02:51,12,12,0,作业量挺盒逝的
151905,1665,楼学庆,2022-03-20 07:55:56,2,2,0,烂烂烂
151906,1665,楼学庆,2022-07-01 13:19:25,8,10,2,这个分数是认真的么。。
151936,1665,楼学庆,2022-03-21 06:14:42,11,11,0,上课没有重点，作业真的多且无从下手，还逃不掉，真的绝了
152028,1665,楼学庆,2022-03-23 12:27:59,9,9,0,老师请问你是不是神经病
152075,1665,楼学庆,2022-03-25 03:11:06,24,24,0,上课是让你传道授业解惑的，不是让你布置从没教过的作业，还在那里输出自己离谱的认知（特指汉语编程）
152195,1665,楼学庆,2022-06-28 12:13:34,41,41,0,计组的实验跟别的班完全不一样，上的东西跟别的班有点不一样，这些就算了，可能是教的顺序不同，但尼玛作业跟计组的知识基本不沾边是干啥？？？？？？用C来实现浮点加减乘除？？来实现汇编反汇编？？来实现汉字花样显示？？？？甚至是来实现汉字编译？？？我都不知道自己在上一节什么样的课程，赶紧爬\n\n妈的大程验收不让仿真非得上板是吧？？？32位输入除了键盘还有啥好方法你说？？？上课答应了找点键盘供我们参考然后结果到现在一点消息都没有，还那么爱指指点点，真是服了，看别的评论貌似他还不是计算机学院最逆天的老师，无法想象更逆天的老师是什么样子\n\n尼玛的上的什么勾八玩意，就你上mips是吧？risc-v自己都不太会，绷不住了，建议不小心选到的直接看别的老师课件\n\n开摆！老师你开心就好，选上你的课就怪我期中考作死没有弃修好了\n\n\n\n终于结束了，给未来学计组的人一个忠告，要么抱大腿，要么赶紧润
152200,1665,楼学庆,2022-03-30 05:06:45,15,15,0,计原学子看见计组学子也来骂楼sir了，很是看到正道的光，顺手给楼sir再打个一分😬
152357,1665,楼学庆,2022-04-06 11:21:51,1,1,0,呃为什么没有0分
152480,1665,楼学庆,2022-04-12 15:55:51,5,5,0,可能楼sir不是老师的话还是不错的，可惜确实是我老师，所以一分不谢😁
152564,1665,楼学庆,2022-04-14 15:12:02,4,5,1,每日一分，早日收敛🤓
152625,1665,楼学庆,2022-07-01 16:11:26,9,10,1,1分收敛
152701,1665,楼学庆,2022-04-18 13:02:10,13,13,0,这学期有希望冲到二点几么
152717,1665,楼学庆,2022-04-19 01:34:38,8,8,0,服了，我真服服的了。\n\n汽修了。
152918,1665,楼学庆,2022-04-21 15:54:06,4,4,0,md第一次见这么离谱的老师
153088,1665,楼学庆,2022-04-25 07:07:41,-7,0,7,太棒了
153360,1665,楼学庆,2022-05-04 10:08:41,6,6,0,听我说谢谢你
153473,1665,楼学庆,2022-05-01 02:47:28,15,16,1,你不刷，我不刷，楼sir何时收敛啊
153756,1665,楼学庆,2022-05-10 07:34:26,59,63,4,上课时间走进教室发现只有老师一个人对着空座位讲😅😅😅
153765,1665,楼学庆,2022-05-10 11:31:45,-3,1,4,好的好的计算机三级
153785,1665,楼学庆,2022-05-11 03:34:57,-38,0,38,2022年首考426能不能进浙大人工智能三位一体啊？能不能啊？能不能啊
154178,1665,楼学庆,2022-05-25 06:51:24,2,2,0,每天上完楼老师的课和实验课我都快得高血压了，就上来看看大家说什么给大家点赞。tmd实验课怎么这么多要求，一堆事，这不对那不对，心态都崩了。
154209,1665,楼学庆,2022-05-26 03:42:32,-42,2,44,真的越想越无语。浙江选考每门科目除去起点分只有60分，根本拉不开差距。北京天津高考生少这么搞没啥大问题，你浙江30多万考生也搞这么高的赋分起点🙄每次选考大把人集中在97分的分数，97分的人比96分的都多
154333,1665,楼学庆,2022-05-30 10:56:24,5,5,0,建议软工学子宁可数逻+计组覆盖也别来计原，快逃！\n\n当然，计组也别选他
154400,1665,楼学庆,2022-06-01 01:10:51,9,11,2,sb天天早八小测早八点名恶心人 讲的烂就别以这种方式浪费时间
154488,1665,楼学庆,2022-06-02 01:49:37,17,17,0,楼sir带给我的创伤要用一生去治愈
155136,1665,楼学庆,2022-06-08 15:16:40,66,66,0,翁恺表明该如何上好课程 ；\n\n姜晓红表明该如何不上好课程 ；\n\n杨莹春试图表明谁都能上好课程 ；\n\n楼sir正在表明课程是根本不需要上好的 。
155172,1665,楼学庆,2022-06-09 04:40:30,-44,4,48,楼sir会挂人吗？如果会挂就踩踩我让我知道一下（）感觉这学期要寄了
157696,1665,楼学庆,2022-06-24 11:15:12,4,4,0,傻逼老师
158229,1665,楼学庆,2022-06-27 15:18:15,3,3,0,不干正事
158561,1665,楼学庆,2022-06-30 07:50:25,3,4,1,最离谱的老师。。。。
158706,1665,楼学庆,2022-07-04 05:34:07,8,9,1,烂中烂
158715,1665,楼学庆,2022-07-01 14:12:33,8,9,1,这个老师有病，跟着他你不仅学不到东西，还会浪费时间在一大堆毫无意义的作业上，更会收获一个离谱绩点\n\n快跑
158718,1665,楼学庆,2022-07-01 14:22:37,14,15,1,重要的事情说三遍：\n\n不要做平时作业！不要做平时作业！不要做平时作业！\n\n复习期末！复习期末！复习期末！
158726,1665,楼学庆,2022-07-01 14:42:42,11,14,3,计原出分了，虽然不高但我很满意了，认真评一波，给了5分。\n\n（1）关于老师，老师人还是不错的，在群里表现的也挺可爱，上课的话确实很难专注听下去，但是看回放其实讲课逻辑还是在的。\n\n（2）关于作业，前半个学期的作业真的想让你崩溃，又多还不知道怎么做，但是后半个学期相对轻松，大程也很水，熬过前半段就好。\n\n（3）关于给分，我觉得还行，不过不代表所有同学，合理怀疑期末考试占比100%，但是考前的程序填空题会发“艺术品”参考，不少空直接往上写，cpu设计也是考前复习过的，计算不多说套公式，判断填空不算难，整体试卷其实不会很难（对比ads简直天壤之别），老师这次还安排考前答疑，挺认真的。\n\n总之，老师上课不是很行，但人不错，没有传说中的那么可怕，学弟学妹不用太害怕。
158731,1665,楼学庆,2022-07-01 15:25:47,1,1,0,寄，原！
159154,1665,楼学庆,2022-07-07 03:32:15,13,13,0,https://www.zhihu.com/people/zheng-jeepcar\n\n看完你觉得他是傻逼，那么快退课。
160395,1665,楼学庆,2022-09-21 08:51:26,6,6,0,上体系课再来评一次……真的别选，硬件三联的阴影，选了他还不如自学
160814,1665,楼学庆,2022-10-13 12:14:01,2,2,0,幸好学计原时同时学了计组
165608,1665,楼学庆,2023-01-09 03:49:23,17,17,0,我只能说期末考试前两个小时通知开卷的一律定义为nt
173096,1665,楼学庆,2023-05-13 09:52:12,0,0,0,好。。。。
176073,1665,楼学庆,2023-06-27 14:28:49,1,1,0,你是真会出题啊\n\n教考分离是吧 能用已经学过的知识推出来 新颖题是吧\n\n如果这个差别也不大\n\n那我和马云的差别也确实不大
178723,1665,楼学庆,2023-07-20 07:37:47,0,0,0,1分收敛
180522,1665,楼学庆,2023-09-22 09:04:37,0,0,0,计原要停开了，来纪念一下楼sir\n\n楼sir我的楼sir啊，你为什么不多带两级啊😭
180767,1665,楼学庆,2023-09-26 02:54:35,2,2,0,听了两周课了，愣是不知道他想讲什么
185305,1665,楼学庆,2023-12-27 16:13:55,0,0,0,???
186245,1665,楼学庆,2024-01-10 05:02:30,0,1,1,老生常谈的问题：教考分离、教学大纲迷惑、作业迷惑，网站里确实有些有用的东西所以有些内容可以参考（上课学还不如看网站学），不知道另一位老师具体如何，但是如果你想认真学到知识就千万不要选这位老师
186505,1665,楼学庆,2024-01-11 11:27:57,2,2,0,这学期期末题不是楼sir出了，那现在选他的课已经毫无优点\n\n上课一如既往地不讲正经东西，导致我后期全部翘掉，期末我面向历年卷复习了半天，考的东西跟历年卷毫无瓜葛\n\n无所谓，挂科大概率了，重修还选lxq，主打一个叛逆
187716,1665,楼学庆,2024-01-17 08:08:36,0,2,2,还没出分是在捞我吗hh
1390,1672,陶黎黎,2015-03-22 01:31:18,59,78,19,JAVA课讲得很细致，让我们班这种大半文科妹子的都能听懂。
1635,1672,陶黎黎,2015-03-23 02:39:30,1,13,12,上课很详细 风度好 评分也挺客观的
2938,1672,陶黎黎,2015-05-11 10:13:06,1,12,11,老师讲课条例清晰
3013,1672,陶黎黎,2015-05-13 00:55:15,37,71,34,上课面无表情想睡觉
5196,1672,陶黎黎,2015-07-05 16:44:03,0,7,7,呵呵  没听过课
5448,1672,陶黎黎,2015-07-07 14:45:30,0,13,13,讲的很好
6550,1672,陶黎黎,2015-07-15 05:01:21,2,11,9,讲课很不错。人很好。给分高。
6586,1672,陶黎黎,2015-07-16 02:05:01,-11,6,17,不想说什么了，总之给分太不好了……
6587,1672,陶黎黎,2015-07-16 02:07:09,2,14,12,老师上课能让我们文科生听懂 ppt做的很好很认真，这门课只要你是有努力的，分数都很不错的
8142,1672,陶黎黎,2015-09-17 06:25:15,9,28,19,有些无聊，没激情
8148,1672,陶黎黎,2015-09-17 06:42:38,4,14,10,无聊啊
9341,1672,陶黎黎,2015-10-22 09:24:57,3,10,7,念一遍PPT...
11134,1672,陶黎黎,2015-12-01 09:26:40,-20,8,28,作业死多，太可怕了，千万别选她的课！！千万！记住是千万！作业太多了
11272,1672,陶黎黎,2015-11-26 06:28:40,-17,4,21,千万别选⋯⋯无语   还不如自学
11676,1672,陶黎黎,2015-12-11 03:08:13,-9,10,19,她是怎么上6点几分的？？？？？？
12285,1672,陶黎黎,2015-12-23 00:33:49,-1,7,8,作业多
14480,1672,陶黎黎,2016-01-07 08:30:41,-14,3,17,不如自学.讲得又快又无聊..
14708,1672,陶黎黎,2016-01-08 11:50:48,-12,2,14,作业死多 真的呵呵哒
20381,1672,陶黎黎,2016-01-27 09:05:28,28,30,2,挺好的老师
20420,1672,陶黎黎,2016-01-27 14:01:29,20,25,5,主要大家态度不好 其实讲的还行\n\n
20427,1672,陶黎黎,2016-01-27 14:15:02,6,11,5,虽然事情很多 上课很无聊 但是给分好啊！！这种老师很不错了！！
20439,1672,陶黎黎,2016-01-27 14:32:37,34,40,6,老师很认真细致，虽然有时候课上的不够有激情，认真听能收获到很多！
20485,1672,陶黎黎,2016-01-28 00:01:07,-10,1,11,无聊死了
20495,1672,陶黎黎,2016-01-28 01:16:57,0,3,3,给分不错，上课就是看ppt，计算机科学基础也就这种上的方法了233
20497,1672,陶黎黎,2016-01-28 01:26:04,7,9,2,上课是有点无聊，但也不能怪老师  课程设置问题。给分很好
20502,1672,陶黎黎,2016-01-28 02:49:58,9,10,1,老师大计基给分挺好，我一节课没听过，期末用两天时间磕了会儿书就有80多分，挺好的
20519,1672,陶黎黎,2016-01-28 05:12:02,7,9,2,老师人还是不错的，下课去问问题还是挺细致的，就是上课略枯燥（大多数想睡觉），作业相比较还是挺多的，但是给分还可以啊。
20894,1672,陶黎黎,2016-02-03 05:28:50,1,4,3,满
21149,1672,陶黎黎,2016-02-22 07:26:19,19,31,12,虽然上课无聊但是给分好啊，上课半个字都没听过期末看了一遍书居然上90了
21354,1672,陶黎黎,2016-02-28 07:47:33,0,2,2,给分还不错，就是上课没激情，听着想睡觉。。。。完全没有语调变化
21459,1672,陶黎黎,2016-02-29 02:10:46,11,11,0,好老师，很喜欢。
21790,1672,陶黎黎,2016-03-01 06:09:45,3,4,1,还可以
22591,1672,陶黎黎,2016-03-08 08:44:38,2,4,2,感觉老师讲的真的很好啊 不知道为什么有人说无聊   特别有耐心   讲的也很清楚！
22699,1672,陶黎黎,2016-03-10 03:27:56,-10,2,12,千万别选
22884,1672,陶黎黎,2016-03-14 05:48:24,41,47,6,其实陶老师将的真的很好，来龙去脉很清楚，对于那些真的想学好这门课的同学来说说一大幸事!
23012,1672,陶黎黎,2016-03-16 06:08:20,24,26,2,很好啊！上学期周建平的大计基啥都听不懂 陶老师java讲的很清楚！还超有耐心！Good！
24478,1672,陶黎黎,2016-04-30 15:30:23,1,3,2,老师上课比较平淡但是给分还是不错的Hh
26581,1672,陶黎黎,2016-12-28 06:32:19,17,20,3,良心老师，讲得很认真细致，非常负责的好老师，给分也很好。上课走神了回去看看她的ppt也都懂了。
26998,1672,陶黎黎,2018-09-28 02:10:46,25,27,2,心疼老师 讲的挺认真的怎么才六点几分 是java这货太难啦
27083,1672,陶黎黎,2016-06-23 00:57:21,1,2,1,老师人挺好，讲的细致
27920,1672,陶黎黎,2016-06-28 05:23:32,-3,3,6,大计基作业巨多…不过给分好
27979,1672,陶黎黎,2016-06-28 07:56:41,-9,1,10,睡觉是最好的选择
28108,1672,陶黎黎,2016-06-28 08:07:05,7,8,1,老师讲的很细致 会容易犯困 但是认真听收获很大。
28596,1672,陶黎黎,2016-06-28 10:49:31,-11,3,14,讨厌这个人
28641,1672,陶黎黎,2016-06-28 11:23:23,58,66,8,真心觉得这是一个被严重低估的老师，上课讲的很仔细，很全面，而且答疑很认真。。我都不懂分数为什么被打这么低。。
28821,1672,陶黎黎,2016-06-28 16:30:57,-14,1,15,照本宣科，课讲得中规中矩。就是对学生太漠视了，在她跟前坐了一个学期都不认识是她班的?除了课间答疑就不要妄想她会帮你什么忙了
30402,1672,陶黎黎,2016-07-01 13:21:26,2,5,3,老师讲的很细致很认真，只要上课认真听，收获很大的
30888,1672,陶黎黎,2016-07-06 08:32:37,0,2,2,谢谢老师
31744,1672,陶黎黎,2016-07-04 16:18:39,-11,0,11,不喜欢她的说话语气(✘﹏✘ა)
31768,1672,陶黎黎,2016-07-05 01:35:18,5,6,1,非常认真的老师，PPT讲课作业都非常细致，没认真听过课的人不要瞎评论
32143,1672,陶黎黎,2016-07-05 21:59:11,2,3,1,虽然老师的作业是多了点，但是讲的细致啊，资料全。而且java这种课感觉没有作业逼迫我动手操作的话，光考试周补天完全补不过来～
32265,1672,陶黎黎,2016-07-06 05:19:55,9,9,0,好老师 ppt很详细 就算不听课看ppt也能懂 除了上课语调有点平 其他都很棒
32387,1672,陶黎黎,2016-07-06 11:39:49,7,7,0,老师讲的很细致，认真听都能跟上，而且重点突出速度适中，不像别的老师上课跟开火箭一样！而且我感觉…也许是略微面瘫…但是老师很关心学生，答疑也很耐心。至于困…我觉得跟上课时间也有关系，虽然老师语速是比较平吧…总的来说，讲课细致易懂，重点突出，给分良心！（不能把java难大计基无聊怪到老师头上！
32393,1672,陶黎黎,2016-07-06 12:22:10,0,0,0,给分好
32586,1672,陶黎黎,2016-07-08 02:26:23,20,21,1,不知道为啥被黑这么惨 上课不错 说觉得面无表情不喜欢的人 你以为上课是来看表演啊 推荐文科生妹子选 最好课前看看书 她讲的蛮清楚的 给分也不错吧 java第二次的时候才勉强做出一道题的 给了3.6 凑活还行 给10分是真的看不下去她被黑的这么惨
32635,1672,陶黎黎,2016-07-08 09:06:30,0,0,0,其实还不错啦
32682,1672,陶黎黎,2016-07-09 09:55:02,2,2,0,老师Java讲得很细致，是一位被严重低估的Java老师，文科生强烈建议选老师的课
32692,1672,陶黎黎,2016-07-09 14:30:44,6,6,0,蘑菇头，好老师
33801,1672,陶黎黎,2017-01-05 02:52:35,0,2,2,不管听不听都一样
34515,1672,陶黎黎,2017-01-23 05:57:51,2,3,1,老师讲课特别细致，有问题回复都超级认真，在非工作时间发送的邮件基本也会在半小时内回复（怎么会这么快??），是那种文科生都能一下子听懂的计算机课，人很好给分也很棒，值得每一个十分。可能因为语调有点平，竟然被黑得这么惨( p_q)
34540,1672,陶黎黎,2016-10-13 03:10:40,0,1,1,好无聊 想睡觉
35900,1672,陶黎黎,2016-11-10 08:58:44,-1,2,3,老师人挺好，就是作业太多
38690,1672,陶黎黎,2016-12-15 01:09:34,0,2,2,清晰负责&无聊事多
39982,1672,陶黎黎,2017-03-30 01:55:55,0,0,0,很棒啊！
40664,1672,陶黎黎,2017-01-05 01:22:32,5,6,1,老师不错的，讲课有调理，但比较单调，作业不多
41352,1672,陶黎黎,2017-01-11 04:02:57,3,3,0,认认真真听过三次课，讲的真心不错
44425,1672,陶黎黎,2017-01-21 06:09:14,2,6,4,老师给分很不错啊，就是作业多了一点，以为要挂的我，绩点竟然3.9   这老师还不好？！
45703,1672,陶黎黎,2017-01-20 03:10:25,2,2,0,讲的真的超级认真
45869,1672,陶黎黎,2017-01-23 06:03:50,26,28,2,上了一学期的大计基课 最后一节课和第一节课认真听了 陶黎黎老师讲的真的很好 真的很后悔大计基课没认真听 平时上课水手机 周末做了实验 但是写测验连书都懒得翻直接网上找答案 最后考试周死磕论文 狂补天背书 过年回家的时候真的差点就把大计基书带回家准备补考了 虽然最后过了 说这么多只想告诉学弟学妹们 请认真对待大计基 陶黎黎老师很不错 跟着她的脚步稳扎稳打最后绩点4.5+肯定没问题的 真的 希望你们能认真上大计基课 老师真的很好 虽然出分有点慢
46949,1672,陶黎黎,2017-01-23 04:50:44,1,2,1,虽然老师的课有点无聊，但是这门课本身就挺无聊的。但老师真的是超级耐心，超级耐心，超级耐心，重要的事说三遍。人也很好，她的PPT做得也很认真，里面内容超级详细，总之，是个很好的老师。\n\n
46955,1672,陶黎黎,2017-01-23 05:19:36,-6,2,8,给分低
46969,1672,陶黎黎,2017-01-23 06:02:10,-8,1,9,无聊，想睡觉，感谢让我大一挂在了这一门上面(微笑)
46972,1672,陶黎黎,2017-01-23 06:17:31,2,3,1,上课细致，对学生态度极好，邮件回复及时，平时作业迟交也没有影响。
47026,1672,陶黎黎,2017-01-23 09:53:58,1,2,1,上大计基无聊是这门课本身的缘故，老师虽说上课没有什么激情吧，但是能把课程内容讲的很细致，也会用比较形象的方法帮助理解，有时也会尽力找笑点，而且态度非常好，从来不发火，很耐心很负责，上课确实是相当好，后悔当时听得不够认真。老师给分也挺好的，只要认真完成任务，按照老师说的做，绩点妥妥的。
47149,1672,陶黎黎,2017-02-28 03:12:46,-2,3,5,大计基挺好
47419,1672,陶黎黎,2017-01-26 06:42:06,1,1,0,djj实在一般，照本宣科只适合一部分人
47823,1672,陶黎黎,2017-02-26 00:49:06,0,1,1,非常认真！认真上课写作业绩点不会低的
48195,1672,陶黎黎,2017-03-01 06:53:11,0,0,0,很温柔，喜欢
48210,1672,陶黎黎,2017-03-01 08:08:43,2,2,0,计算机的讲课方式
48490,1672,陶黎黎,2017-03-06 05:10:13,2,2,0,想水的听谁的课都会水，这么负责任的老师大家就轻点黑吧。
52028,1672,陶黎黎,2017-06-14 08:46:05,1,1,0,超爱的老师！很棒~上课认真听，完全不需要课后下功夫就可以很好地学好java~喜欢老师细致的讲解^_^
52834,1672,陶黎黎,2017-06-23 06:36:00,0,0,0,好老师！
52936,1672,陶黎黎,2017-06-23 16:14:26,0,1,1,讲的很细致，会花很长时间在前5章，最后我都怀疑她能不能讲完，啊抬头45°仰望天空。
55661,1672,陶黎黎,2017-07-02 06:27:33,0,1,1,老师很好\n\n
56317,1672,陶黎黎,2017-07-03 13:09:45,2,3,1,老师人很好，讲课也很仔细耐心，而且！很多次网上交作业的留言都会翻牌！真的很负责！另外陶老师的资料也比其他老师多，课件的内容丰富，期末还会给考纲，对复习很有用！总之很赞！
56576,1672,陶黎黎,2017-07-04 04:07:50,0,2,2,老师很温柔很温柔很温柔。很细心。认真听她上课那么JAVA一点问题都不会有。真的很细心
57224,1672,陶黎黎,2017-07-06 05:10:44,2,3,1,老师人很好，讲的很细致很明白，举的例子什么的也很有趣。最重要的是答疑很耐心，发邮件过去经常秒回。赞一个!
57227,1672,陶黎黎,2017-07-06 05:27:20,0,1,1,好老师，讲课很细致！
57231,1672,陶黎黎,2017-07-06 05:29:47,2,3,1,是个很温柔的老师，上课讲得很清楚，作业认真做还会写评语，你做得很好！平时做好布置的作业，期末题目抽到的不难，给分很好。很感谢陶老师！
57245,1672,陶黎黎,2017-07-06 06:18:09,0,1,1,讲课很仔细 很好的老师！
57384,1672,陶黎黎,2017-07-07 06:07:57,0,1,1,好老师！
57608,1672,陶黎黎,2017-07-10 13:18:10,3,4,1,老师很棒讲课很清楚，很仔细，而且每次都提醒我们期末考试要带双证，讲解题目也很到位。虽然最后几次课因为刚上完生化的原因很困，没有仔细听课，反倒睡着了，这里感到很对不起老师。助教也很棒，在几次上机练习时帮我找到错误，提醒的很到位。那些黑老师的，只是上课没有认真听，没有好好学，这能怪谁！
58171,1672,陶黎黎,2017-08-14 06:58:57,1,3,2,超级超级棒，说老师无聊的，也许是和老师上课方式不合吧，其实老师在讲一些例子的时候看的出来有注意自己要幽默的。而且讲的真的很细心，上课跟着她的思路走，就基本都掌握了。很棒很棒的老师！
58737,1672,陶黎黎,2017-09-16 07:23:35,0,1,1,好好好\n\n
59219,1672,陶黎黎,2018-01-31 16:09:40,2,4,2,感谢陶老师，认真细致，体贴同学，很负责，为同学们分上到很晚，认真听课认真完成作业认真复习不会差的?，感谢陶老师，希望以后还能上陶老师的课！
60159,1672,陶黎黎,2017-10-12 02:00:29,7,10,3,唉，老师是个好老师，上课也是有一些好货的。但是作业真是太太太太太太太多了，秃头了！
60674,1672,陶黎黎,2017-10-26 10:11:23,0,3,3,老师虽然上课有点无趣 但是讲的很细致 容易理解掌握 编程o基础期末4.5哈哈
66003,1672,陶黎黎,2018-01-11 01:59:48,0,1,1,喜欢听，很幸运
66431,1672,陶黎黎,2018-01-17 12:31:01,-5,1,6,好，作业少，不怎么按书上讲。
72759,1672,陶黎黎,2018-01-31 05:01:39,-2,1,3,出分慢死 真的慢
72908,1672,陶黎黎,2018-01-31 10:03:45,3,4,1,老师上课很认真，作业真的比较多，但是给分真的好高啊！我爱老师！！！！
72911,1672,陶黎黎,2018-01-31 10:08:06,0,1,1,给分还好
72970,1672,陶黎黎,2018-01-31 12:58:10,0,1,1,好老师！
72992,1672,陶黎黎,2018-01-31 14:02:05,0,1,1,老师真的很耐心很细致！！！
72996,1672,陶黎黎,2018-01-31 14:11:55,-2,1,3,上课没听过 作业特别多 期末最后几天看书 最后4.2 老师挺好
73010,1672,陶黎黎,2018-01-31 14:30:35,0,3,3,老师给分真的好，期末的题目大半靠猜，考完还在担心会不会挂，结果绩点还上4了。老师真的好
73027,1672,陶黎黎,2018-01-31 16:08:44,7,8,1,虽然绩点只有3.3，还是要给老师满分。一学期没怎么听过课，听过的那几次觉得老师讲得很细致，人也温柔，从没见过生气。平时思科计科作业都是上网搜答案，期末突击复习一星期，很惭愧也很后悔没有好好学习，以为要挂科，得到这个绩点其实很感谢老师啦。选陶老师的课没问题哒。
73030,1672,陶黎黎,2018-01-31 16:43:15,-4,2,6,出分慢但是老师人很好哇很细心的解答第一个满绩感动
73036,1672,陶黎黎,2018-01-31 16:52:55,1,1,0,老师人超级好讲课也很细致有什么遇到的困难测验错过了时间都可以和老师沟通总之就是很值得选择的一位老师啦！
73037,1672,陶黎黎,2018-01-31 16:56:07,1,3,2,老师很好，是真的很好，但是作业真的多，是真的很多
73061,1672,陶黎黎,2018-02-01 00:07:42,1,1,0,客观讲，回答问题超耐心，负责，但上课吸引力一般，我给9分
73062,1672,陶黎黎,2018-02-01 00:09:22,1,1,0,陶老师确实是一个很认真负责很有耐心的老师！
73080,1672,陶黎黎,2018-02-01 01:40:16,1,2,1,突击一下，绩点不会差
73082,1672,陶黎黎,2018-02-01 01:41:25,-4,3,7,老师真的很耐心很耐心，虽然讲课没有什么激情，但给分真心好啊，基本没怎么听过课，考前过了一遍ppt，绩点就4.5了。。。这个老师真心好。
73120,1672,陶黎黎,2018-02-01 03:00:25,1,1,0,老师太好了，给分也很好?
73121,1672,陶黎黎,2018-02-01 03:00:35,-7,4,11,老師給分特別好!我上課基本都是睡過去或者學數學還感覺很愧疚，考前認真複習了兩三天，把大計基的書和PPT背一遍最後拿了4.8，複習的時候才發現老師的PPT做的十分全面，當然平時作業和一篇論文也要好好寫!
73138,1672,陶黎黎,2018-02-01 03:55:27,1,1,0,老师给分真的好
73166,1672,陶黎黎,2018-02-01 05:27:25,2,2,0,老师人很好，讲课语气温柔，耐心解答问题，ppt也做得好细致～有几次在课上的突击小测，算是点名了吧。给分挺好，作业很多，但花下去时间好好学，最后考试的成绩让我觉得还是值得的。
73169,1672,陶黎黎,2018-02-01 05:37:02,2,2,0,给分良心 上课细心 好评
73329,1672,陶黎黎,2018-02-01 10:46:25,7,7,0,陶老师会把作业中可能碰到的问题提前讲解，有反差萌哦，超可爱的老师^ω^
73729,1672,陶黎黎,2018-02-03 04:50:05,5,7,2,给分超级好，选了绝对不会有错，但作业一定要认真写\n\n
73837,1672,陶黎黎,2018-02-03 08:16:44,-4,2,6,给分特别好!课无聊但是内容很详尽。
75421,1672,陶黎黎,2018-03-11 13:47:54,3,3,0,哇擦擦，在浙大学习怎能错过这样的好老师？？？\n\n
76028,1672,陶黎黎,2018-03-25 03:29:22,1,1,0,一个非常温柔可爱的老师，其中会讲一些好玩的事。不过计算机主要还是自学，然后每次老师布置的作业认真完成，考前看两三遍书，多刷刷题，高分妥妥的
76748,1672,陶黎黎,2018-04-20 12:11:49,0,2,2,老师讲的是真好\n\n作业也是真多
77045,1672,陶黎黎,2018-04-29 07:02:31,1,2,1,认真听收获很大 虽然有点多
77569,1672,陶黎黎,2018-05-06 14:25:14,-2,2,4,作业真的巨多
78906,1672,陶黎黎,2018-05-16 12:23:48,9,9,0,怎么会有这么好的老师！说作业多的，C程了解一下。。。作业我觉得挺恰当的，毕竟是一门计算机语言课，课后不巩固一下学不到什么东西吧。。。关于作业难度问题，再次C程了解一下。。。我同时选了Java和C程，知识点有重合的地方，但是都是靠Java辅助理解，感觉老师讲的非常详尽，作业基本可以独立完成。然后C，emmmm基本靠百度完成˃̣̣̥᷄⌓˂̣̣̥᷅
79447,1672,陶黎黎,2018-06-05 09:15:12,1,2,1,希望老师上课不要那么催眠
82077,1672,陶黎黎,2018-07-07 04:39:52,5,5,0,老师上课很认真，ppt也很有条理，让人觉得学java很轻松
82171,1672,陶黎黎,2018-07-07 10:11:03,2,2,0,老师很棒的，讲的很仔细，问问题也会耐心回答，大爱
84474,1672,陶黎黎,2018-07-13 02:46:33,0,1,1,看了其他评论，我想说一下，作业并不算多好吧(然后问一句，怎么还不出分)
84535,1672,陶黎黎,2018-07-13 05:54:48,5,5,0,老师讲课讲得非常细致，人也很和善，认真听课并且复习ppt的话一定会学得很扎实的(感觉ppt比课本更有用，因为重点突出且知识点详尽)。而且老师给分很好，所以强烈推荐。
84539,1672,陶黎黎,2018-07-13 06:07:52,7,7,0,作业不多，讲课很细致，唯一一次小测当做点名，给分超级好！果断10分
84561,1672,陶黎黎,2018-07-13 07:33:11,2,2,0,好老师讲的很好！\n\n会让人感觉学java很简单\n\n平常作业好好做 期末完全不需要补天！\n\n给分棒棒哒 强烈推荐
84579,1672,陶黎黎,2018-07-13 08:26:19,5,5,0,不要喷我功利，就冲这给分一定要选这老师? 。而且讲的也很细致，JAVA认真学是还是可以从课上学到很多的
84617,1672,陶黎黎,2018-07-13 10:33:47,0,0,0,老师很棒！上课认真听 作业好好写 会有好结果的
84634,1672,陶黎黎,2018-07-13 11:49:35,1,1,0,讲得细致，给分好！
85049,1672,陶黎黎,2018-07-15 06:19:06,3,3,0,细水长流，集腋成裘
87386,1672,陶黎黎,2018-09-28 02:13:54,0,0,0,好好好
87766,1672,陶黎黎,2018-10-12 01:14:25,0,1,1,说实话，大计基讲的就那样
90056,1672,陶黎黎,2018-11-22 03:40:20,2,2,0,虽然声音很催眠。但认真跟着老师走就能很好的掌握。老师人特别好，教的很详尽，一步一步跟着老师走肯定没错的?
91084,1672,陶黎黎,2018-11-29 17:06:53,0,1,1,手写作文是真麻烦.....
93405,1672,陶黎黎,2019-01-09 12:09:59,2,2,0,老师很可爱呀！ 上课确实有点平淡，但还是能学到很多的呀！ 特别喜欢老师一本正经地说冷笑话
93607,1672,陶黎黎,2019-01-11 02:11:11,1,1,0,老师人很好，给学生解答问题很有耐心。
93688,1672,陶黎黎,2019-01-11 15:55:32,8,8,0,上的是大计基，就单冲作业量，10分妥妥的，我们报告一页a4不能多，其他班2500起步，恶竞的写了9000，感觉自己很幸运，能选择老师的大计基，想选老师的java，但下学期被预置了c不敢退(非洲人体质)
96106,1672,陶黎黎,2019-01-20 12:56:54,7,9,2,大计基确实比较繁杂，老师上课也讲不了所有的，但已经讲的很详细了。建议坐前排，多在群里和大家讨论。课后及时看ppt等资料，作业认真做吧。这学期成绩还没出，但老师付出了很多，最后的成绩会和自己的努力相称的吧。还有感谢群里的小潘大佬和其他大佬们，帮助大家很多。
96632,1672,陶黎黎,2019-01-21 08:16:55,7,7,0,我爱陶老师！！！浙大怎么会有这么好的老师，上课全是干货，学到很多，还有很有意思的小例子，老师幽默的时候也超可爱，特有别详细的ppt每章放送，作业布置细致规律，还为我耐心解答。如果我的成绩不好肯定是我平时没好好学，虽然还没出分，但是我要给老师十分！！
99746,1672,陶黎黎,2019-01-25 06:18:28,0,0,0,老师真的是好老师，讲的很细致，作业也不多，该给的资料都给了，就是大计基这门课有问题（没听见不吐槽的）。
101663,1672,陶黎黎,2019-01-29 00:22:33,1,1,0,哈哈哈，一科没挂，为什么我要在这里发呢，因为这是最后一科，谢谢老师，老师很高级，高级冷，高级负责，高级细致！！
101664,1672,陶黎黎,2019-01-29 00:29:51,0,0,0,作业基本上只有实验
101674,1672,陶黎黎,2019-01-29 00:47:31,7,7,0,呜呜呜这个老师超级超级好的！我上的大计基，上课很细致，只要你认真听都能听懂，两篇八百字作文和一次很简单的课堂抽测（应该主要是为了点一次名，就两道小题，还挑了交作业那一天），期末没有大作业！！！真的感动到哭555，有同学平时作业没做老师还在算分前提醒他去补上，真的超为我们着想！而且平时问老师问题老师也会很认真的回答（不过老师可能不经常看qq，所以会有时差）然后群里也可能会有dl随时解答问题（这个就看运气啦）\n\n总之，选上就是赚到！
101679,1672,陶黎黎,2019-01-29 00:59:51,1,1,0,讲的很细致认真，而且回答问题也很耐心。老师人很nice
101682,1672,陶黎黎,2019-01-29 01:02:38,7,7,0,讲的很细致很好，偶尔幽默，上课会很耐心宽容，允许我们刷作业的分但是也会告诫我们好好学习（顺便感谢群里大佬带）。最感人的是，出分前一天私戳我来问我思科考试有没有做完，并且开放了思科考试让我补！要知道一个考试三分啊，补了两个绩点瞬间就好看了，吹爆！！！
101683,1672,陶黎黎,2019-01-29 01:04:00,1,1,0,老师讲课真的很清晰的，虽然会有些无聊但是能学到很多，PPT也很好。
101686,1672,陶黎黎,2019-01-29 01:07:04,2,2,0,老师的课讲得很详细很适合基础薄弱的同学（虽然基础特别好的同学听课就会很困），平时作业老师都会好好看的（连本来可以随便敲几个点点的反馈都有好好看，真的感动）
101692,1672,陶黎黎,2019-01-29 01:20:00,1,1,0,老师讲课很细致，虽然一开始会有点犯困，但是习惯之后还是很有收获哒。而且老师有时候真的很萌！\n\n
101697,1672,陶黎黎,2019-01-29 01:32:46,3,3,0,陶妈妈超级超级好呀，备课讲课都非常认真的，像我这种小白也可以听懂。考试的时候虽然一脸懵逼，但是最后分数还是很好哟。平时室友的大计基论文都是几千几千的，而我们只要求一张A4纸，不得超出，避免了恶竞。总之了，能选到陶黎黎老师的课真的太幸福了
101704,1672,陶黎黎,2019-01-29 01:56:24,5,7,2,老师超级棒啊!是预置上的陶老师的课，现在想想真的是超级幸运!还有和老师某些方面还是挺有缘分的哈哈，陶老师上课很细致，可惜我没好好听，可能是没预习的缘故加上大计基实在太多理论，上课有点困，考试前几节课特别后悔之前没认真听老师的课，最后几节认真听发现真的很好!群里dl经常发小测练习答案，作业挺能水的（惭愧ing），考前认认真真地看了一遍书，练了些题，真正领悟了大计基的魅力，但是考试考了好多后面没仔细看的网络部分的内容，考完有点失落，加上平时作业有一次单元测试练习忘记做了，错过了ddl，以为绩点不会很高，结果出来还不错，4.5，老师真的超级友善了，下学期想选陶老师的java，可惜预置课表就满了，选不上陶老师的课，还是挺遗憾的，想着下学期预置老师不怎么样的话就退了再选陶老师的课。老师作业真的很人性化，对我们帮助挺大的，没有那种无聊又没意义的作业，总之，感谢陶老师!
101715,1672,陶黎黎,2019-01-29 02:13:32,2,2,0,超超超好！！！
101716,1672,陶黎黎,2019-01-29 02:16:39,16,16,0,对比才会发现老师的美！\n\n讲课的时候看似平淡如水\n\n却总能在细微处一语道破\n\n少的清奇的作业\n\n高的喜人的绩点\n\n陶老师\n\n真的是天使?！
101717,1672,陶黎黎,2019-01-29 02:16:43,9,9,0,大计基这门课很理论但不用太动脑子，能记住就非常棒。虽然平时上课完全不听吧，而且开学那段时间每节课都坐在前排睡觉，但是靠自学还是能取得很不错的成绩的。主要是老师给的资料非常完整，布置的作业能巩固知识，遇到问题可以下课后问老师，或者在群里问大佬们。老师人很好很温柔，事少给分看个人，付出与回报成正比。
101719,1672,陶黎黎,2019-01-29 02:20:51,5,5,0,吹爆我陶老师！给分超棒棒！
101723,1672,陶黎黎,2019-01-29 02:40:20,5,6,1,一开始听大计基的课 觉得没啥好学的 也就没怎么认真听课 到了期末才反应过来要死了 最后听了几节狂刷PPT和题目 最后老师让我上四了 简直感动哭了 但老师讲课还是很细致的 尽管节奏让人有点想睡觉
101726,1672,陶黎黎,2019-01-29 02:51:38,5,6,1,前半学期没有认真上课，要么睡觉要么农药，过得混混噩噩。后半期幡然醒悟，认真的听老师讲课，真的是收获良多。最后在老师的教导下拿下了满绩，还没有被卡，真的是太感动了(ಥ_ಥ)强烈推荐老师的计算机科学基础课，给10分我都觉得低啦?
101731,1672,陶黎黎,2019-01-29 02:58:33,2,2,0,老师值得我的10分！！！
101744,1672,陶黎黎,2019-01-29 03:16:56,4,5,1,原以为大计基要凉了，感谢陶老师和小潘大佬！！
101747,1672,陶黎黎,2019-01-29 03:28:12,3,4,1,感觉大计基要挂了查分居然86！感谢老师，当然也感谢小潘大佬！
101752,1672,陶黎黎,2019-01-29 03:56:21,8,8,0,大学第一评献给tll老师啦，老师真的超级好！是那种高中老师上课的感觉，讲的很认真很认真，ppt也做得很好，评分方式也很公正公开，所以只要按照老师要求每一次作业认真完成分数是没有问题的。然后老师的人也非常可爱！一本正经讲笑话的样子真是太可爱啦！期末好好看书、ppt复习就算中途有几节课睡过去了还是能补回来哒（小声）
101765,1672,陶黎黎,2019-01-29 04:17:35,0,1,1,作为一个只复习了一天不到的小渣渣，竟然有4.8，要上天了，哈哈。陶老师超级好，讲课很认真，ppt很清楚，都是重点。
101769,1672,陶黎黎,2019-01-29 04:48:41,0,1,1,人挺好，无为而治型。上课听不听差别不大，看ppt非常重要。虽然卡绩但也算很满意了。
101852,1672,陶黎黎,2019-01-29 09:35:39,4,4,0,老师非常的认真负责，讲课很温柔，也可能因为太温柔了大家都很困...但跟着老师的思路一步步来，作业认真做考前过书和ppt，结果一定不会差?
101899,1672,陶黎黎,2019-01-29 14:49:13,2,2,0,老师真的很认真负责，每一次作业都有很用心的批语，课后答疑也很耐心！真心的感激老师
101902,1672,陶黎黎,2019-01-29 14:53:41,1,1,0,谢谢老师的给分！
101918,1672,陶黎黎,2019-01-29 16:15:00,3,3,0,话不多说，和别的班比真的事少人好，考前疯狂问老师老师态度也很好，还有大佬。谢谢大家
101958,1672,陶黎黎,2019-01-30 01:16:28,2,2,0,上课是有点无聊，但老师讲的超细致的，PPT也做的也很全面。偶尔还会皮一下，超可爱的！！
102085,1672,陶黎黎,2019-01-30 11:01:10,1,2,1,只要跟上老师进度 认真完成实验和练习 老师给分是真的不错 4.8把我均绩救回了4 大恩不言谢
102421,1672,陶黎黎,2019-02-01 15:49:52,1,2,1,老师人特别好，给分也特别好，但是真的想吐槽一下计算机科学基础，这门课对于理工科的学生而言，实在是一点用处都没有，还不如程序编程来的实在
102899,1672,陶黎黎,2019-02-25 00:57:36,1,1,0,陶老师人很好，课讲的也仔细，推荐
102952,1672,陶黎黎,2019-02-25 06:00:26,1,1,0,很棒喔！
103625,1672,陶黎黎,2019-03-02 13:32:38,7,7,0,楼下说大计机对理工科一点用处都没有的，真是井底之蛙，怕是不懂什么是微机原理与接口技术吧
106894,1672,陶黎黎,2019-04-30 07:21:53,1,2,1,不说了，mj.
108821,1672,陶黎黎,2019-06-03 02:51:51,2,2,0,陶老师上课极其细致，还有难点回顾和实验问题解析，人又温柔。计算机白痴感觉非常舒适?
110935,1672,陶黎黎,2019-06-28 15:00:10,1,1,0,超级棒，很认真。
112045,1672,陶黎黎,2019-07-03 09:40:02,0,1,1,卡绩4.5但还是好爱老师o(^o^)o
112054,1672,陶黎黎,2019-07-03 10:18:32,0,0,0,老师人真的很好，讲的很仔细。最后因为我们班的优秀率超过要求了，还交申请，让院长签字，就是为了让每个人成绩都好一点。真的感动了，虽然还没出成绩，但是真的好评，老师真的超棒了！
112061,1672,陶黎黎,2019-07-03 10:53:11,0,0,0,老师人真的特别好！
112549,1672,陶黎黎,2019-07-04 17:30:23,1,1,0,我爱陶老师
112623,1672,陶黎黎,2019-07-04 22:57:43,1,1,0,认真的很仔细，就凭课后准时上传ppt与每一次作业答案的条理性，该打满分。讲课也非常清楚，非常适合0基础。有基础的也选，因为不点名，除了最后一节课。
112765,1672,陶黎黎,2019-07-05 02:44:20,3,3,0,老师人很好很负责，上课十分细致也很适合没有基础的学生，给分巨好特别耐心！
112821,1672,陶黎黎,2019-07-05 04:30:01,0,1,1,老师真的讲的很细致了，给分也超好了
112837,1672,陶黎黎,2019-07-15 22:24:59,-1,1,2,谢谢老师，我满了！老师真的教的很好！很容易懂！考前记得刷ppt！
112841,1672,陶黎黎,2019-07-05 05:38:37,0,1,1,文科生，上过老师的大计基和java，老师讲课很细致，ppt做得也很完善，只要平时认真完成作业，考前看看ppt，成绩就很不错。\n\n打分也很好，似乎会捞人但没有正态调分，应该是考几分是几分叭！\n\n
112915,1672,陶黎黎,2019-07-05 10:42:18,0,1,1,陶老师真的是很好的老师！真的，不要被老师平淡的声音迷惑了，老师真的非常好！
113596,1672,陶黎黎,2019-07-07 00:53:42,0,1,1,老师人真的超好，而且上课讲的很仔细，我这种电脑渣渣都能跟得上，强推！
113665,1672,陶黎黎,2019-07-07 02:42:48,-1,1,2,老师真的很温柔，虽然12节课的Java会起来有点困。认真地完成了实验，复习了课本，但是实验考试爆炸只写出了了两道题，最后老师竟然给了4.2，也没卡绩，真的超棒。感谢老师！
114542,1672,陶黎黎,2019-07-10 12:37:09,-1,0,1,上课去的人真的少，java 真的很水，我至今不知道为什么它会出现在我的培养方案上
115151,1672,陶黎黎,2019-07-16 08:14:03,1,2,1,陶老师给分好讲的也超级仔细！！！\n\n平时作业题都会课上再讲一次。这学期学的最好的没想到是java呜呜
115345,1672,陶黎黎,2019-07-19 06:12:14,1,2,1,java讲课很是细致，ppt很有用（当然书也是要过的），给分也不错，喜欢老师。
122020,1672,陶黎黎,2020-02-01 05:59:29,0,0,0,大计基两次纸质作业，线上有计科系统、pta，实验作业
122255,1672,陶黎黎,2020-02-21 08:48:38,0,0,0,大计基真的讲得又耐心又细致，而且老师超温柔！有次作业忘交了还专门给我开了个新账号来交！最后给分也很好！选就对了
125481,1672,陶黎黎,2020-09-10 08:25:37,1,2,1,Java程序设计。看了一学期网课，老师讲课PPT都有点混乱，感觉没有往届说的那么好。
125502,1672,陶黎黎,2020-09-10 14:45:55,0,0,0,谢谢老师✧◝(⁰▿⁰)◜✧\n\n这学期没挂真是太幸福了!!!
125539,1672,陶黎黎,2020-09-11 06:07:45,2,6,4,绩点只有3.6应该是我的问题，讲课死板，如同机器人一样，接受效率差就真的难以接受
132386,1672,陶黎黎,2021-02-01 08:49:16,1,1,0,上课很细致很温柔，ppt很全很有用！！对课后问题的同学也很有耐心！老师超级好！
132836,1672,陶黎黎,2021-02-04 05:00:05,0,0,0,老师特别有气质 听老师讲课很舒服 也会鼓励同学们开动脑筋 解决一些有趣的问题\n\n助教哥哥也特别有耐心 回答问题很及时\n\n给分也好不错\n\n爱了爱了
132911,1672,陶黎黎,2021-02-05 01:04:51,0,1,1,老师给分很好！！上课从未听过，计科也没刷分，小测有一次没满，考前只看了一遍书最后竟然4. 5。要说有点不足的，大概作业偏多（个人感觉比微积分还多），上课无聊，自制力不太强的同学会学不到东西。但如果当做水课的话，可以说是非常不错的了。
133040,1672,陶黎黎,2021-02-07 02:35:25,1,1,0,不多说了，期末突击，老师给捞到4.5，太感激了！
133204,1672,陶黎黎,2021-02-17 05:55:03,1,1,0,上课无聊，但是给分很好而且从不点名，期末突击两天就能有很高的绩点
133528,1672,陶黎黎,2021-03-02 00:31:17,2,2,0,老师大计基给分超级超级好！期末突击两天绩点4.8 ！！虽然上课有点无聊 但是老师蛮可爱的！！
137461,1672,陶黎黎,2021-07-04 08:58:46,1,1,0,老师讲的真的很细致，课程内容都会很详细讲解，让每个学生都能听懂，平常的作业难度也还可以，每次课前都会讲解上周作业较难的地方，对学生很温柔！真的很负责！强烈安利陶黎黎老师！
138311,1672,陶黎黎,2021-07-08 12:45:49,0,0,0,老师超级nice，上课内容特别容易懂，给分也超级好
138380,1672,陶黎黎,2021-07-08 23:34:55,0,0,0,有一个教的好的老师真的很重要\n\n上学期在某老师班学大计基，真的听懂，绩点也只有3.6，当时已经彻底对自己的计算机失望了\n\n这学期学了陶老师的java，才明白，原来真正的计算机课是这样的，老师讲的仔细全面，助教答疑不厌其烦甚至还会在路上和我打招呼，最后绩点4.8，感觉上学期真的掉坑里了
145643,1672,陶黎黎,2021-12-31 02:05:00,0,1,1,陶黎黎老师讲课很仔细很温柔，作业量也不大，给人一种妈妈的亲切感～真的想叫她一声陶妈妈啊！！
149274,1672,陶黎黎,2022-01-15 03:05:17,0,0,0,超级耐心负责的老师，会把一些别的老师会忽略的知识点整理成pdf，ppt也超级详细。\n\n唯一的缺点是讲课缺一点体系感，不过感觉这是大计基的课程特点导致的。\n\n总之，特别感谢她给了我超级惊喜的绩点，也特别感谢她的温柔和负责。推荐！
149356,1672,陶黎黎,2022-01-15 07:08:29,1,1,0,超级好tllyyds
149365,1672,陶黎黎,2022-01-15 07:34:47,0,0,0,早八的课，老师讲课声音没有起伏特别想睡觉，完全听不进去。。。。。但是老师水平其实不低，重要的是给分特别好！
150010,1672,陶黎黎,2022-01-18 09:22:53,0,0,0,给分好会捞人
150020,1672,陶黎黎,2022-01-18 09:46:58,0,0,0,出了分之后更知道tll老师的好
151500,1672,陶黎黎,2022-03-05 08:44:09,0,0,0,超会捞
19590,1676,邢卫,2016-01-25 00:43:04,20,22,2,计院最差，没有之一
19863,1676,邢卫,2016-01-25 12:28:30,29,31,2,满嘴跑火车没一点干货，老老实实的去干行政，别来教书祸害学生
92808,1676,邢卫,2019-01-04 14:14:49,2,3,1,新年的第一声祝福送给这位老师
93155,1676,邢卫,2019-01-07 17:11:51,11,12,1,个人感觉除了喂学生吃?不会干别的事情。一个学期上下来，我觉得我这个评价非常中肯。
93677,1676,邢卫,2019-01-11 13:00:47,16,17,1,真把自己的课当一回事 给个95分都不愿意 占用整个周六的白天不说 还要求全程不让用智能手机、电脑。讲课好不好根本不知道 因为刑卫几乎没讲过课 大部分都是学生授课 花钱上课又不是来听学生讲的。而且组内互评不允许打95分以上 小组互评给别组打高分还可能会倒扣分。评分表更是莫名其妙 我怎么知道他们组有没有提交需求报告？
93681,1676,邢卫,2019-01-11 13:03:06,-1,0,1,。。。
93684,1676,邢卫,2019-01-11 14:43:34,3,5,2,又蠢又坏。
98805,1676,邢卫,2019-01-24 03:02:55,12,13,1,这个13怕不是心理阴暗，一堆坑比规定，上课是不存在的，先吹两节课逼，剩下的全部学生讲，混子典型
100001,1676,邢卫,2019-01-25 12:24:07,5,6,1,emmm。。。邢老师，在下慕名而来，求您讲节课吧。。。手动滑稽
102324,1676,邢卫,2019-02-01 02:17:26,4,5,1,还有四天过年，老人家是不是忘了出分？
102460,1676,邢卫,2019-02-04 07:35:30,3,3,0,整个大学里上过的最傻屌的课 嘲讽的是还要写个课程报告去舔老师 槽点太多都说不完
102497,1676,邢卫,2019-02-03 14:37:21,3,4,1,傻逼邢卫，出分慢且差，逼事多没干货，渣滓
102498,1676,邢卫,2019-02-03 14:43:27,3,4,1,祝您新年原地爆炸
102505,1676,邢卫,2019-02-03 14:58:29,4,4,0,事情多，给分差
108794,1676,邢卫,2019-06-02 14:55:51,3,3,0,把官瘾带到课堂上的神人
116035,1676,邢卫,2019-08-31 18:19:05,-18,3,21,好！摸了两周鱼，居然给我4点8！
118774,1676,邢卫,2019-11-01 01:52:27,4,5,1,mdzz
118775,1676,邢卫,2020-01-18 09:22:15,11,11,0,强制让学生换座位，坐前几排\n\n“我就不懂你们上课为什么要用电脑，好像电脑充电是上课必须的”?\n\n看到今天36个同学里已经有人发了“mdzz”?
121962,1676,邢卫,2020-01-26 06:04:16,6,7,1,一堆奇怪作业，没有评分标准\n\n得分奇低，没事怼人\n\n
121965,1676,邢卫,2020-01-26 07:24:46,9,9,0,头一次这么晚才出分。头一次拿这么低的分。这是专业课啊，哪有专业课给分这么低的？？？
121981,1676,邢卫,2020-01-27 12:15:59,7,7,0,1.在家没事，刷一波低分 2.想知道他给了你们几分你们打了一以上的分数？还能比隔壁yyc还高？ 3.把骂XW的都赞了一遍，咋全都是骂的？
122063,1676,邢卫,2020-02-10 21:22:26,9,9,0,平时从来不讲课，展示后排坐一坐，嬉皮笑脸惹挺猥琐，死不出分把年过
132319,1676,邢卫,2021-01-31 17:20:01,37,38,1,逼事多，水平低，对学生态度恶劣，自我感觉良好，天天带着一副猥琐的讥笑，出分奇慢给分巨差，祝愿这位老师新的一年绿油油
132329,1676,邢卫,2021-01-31 19:35:55,16,17,1,要是能打负分就好了！从没见过这么垃圾的老师！\n\n讲课巨差还偷懒让同学讲一半课、事情巨多占用学期所有时间、辛辛苦苦结果到最后给分巨差专业课还给出正态的分数，明明作业都是九十多分到最后成绩出来把总均绩还能往下拉零点几！\n\n不仅话多破事也太多！笑嘻嘻的就给你再加点任务，整学生很好玩吗？而且永远的已读不回，问什么问题都当作没看到，永远不回答。\n\n太无语了，我只想问一句：xw你是人吗？
132342,1676,邢卫,2021-02-01 02:12:06,14,14,0,sbxw nmsl
132343,1676,邢卫,2021-02-01 02:30:21,1,3,2,hh
132344,1676,邢卫,2021-02-01 02:56:51,16,17,1,我之前一直没懂他为啥老讲他儿子幼儿园老师只给好、很好、特别好三个等级这件事，后来出分的时候我明白了，好=3.0，很好=3.6，特别好=4.2。rip，愿天堂没有病痛。
132383,1676,邢卫,2021-02-01 08:44:05,6,6,0,傻逼，他是真的傻逼，傻逼邢卫nmsl
151679,1676,邢卫,2022-04-06 10:53:38,6,7,1,我是xw，我立刻登录教务网修改你的分数
153971,1676,邢卫,2022-05-18 08:12:19,5,5,0,讲错一大堆
154060,1676,邢卫,2022-05-21 13:46:28,5,8,3,离散讲的不错的，其他课没上过，不多说。\n\n离散讲得好，是因为他该讲的都能讲清楚，不需要我自己看书学，他也都是自己讲；课程进度应该是课题组统一的，没啥问题。\n\n题目布置没啥问题，就是离散该有的量；两次小测可能稍微有点难，但是有小测更好拿分就不多说了；老师给学生的关注度也是有的。
154182,1676,邢卫,2022-05-25 08:03:50,4,8,4,离散课讲得挺好，挺清楚的，其他的课没听过不评价。如果要修离散且英语不好的话，可以选这个老师的课。
165147,1676,邢卫,2022-12-29 10:25:24,3,6,3,老师是中英讲课，其实比有些老师纯英文是要好理解一些的，2022.12月选课看到老师没人选来改一下评论。\n\n没有wyljj教得好这没办法，但是说比不上其他几位老师我是不信的，这门课期末好好考也能覆盖前面的平时分，没有几个老师会去捞你（除了翁姐姐）\n\n老师平时也会关心学生，至于平时分，老师也没有刻意压低分数吗，平时大家上课什么状态心里也都有底，好好听课成绩不差的\n\n我是上学年修的xw老师的离散，最后靠期末拿到了4.8（无炫耀成分，只是说在xw老师班里也能拿到不错的分数），期末认真答得话也不是很难~
166647,1676,邢卫,2023-01-13 06:58:31,-3,2,5,感觉老师改观挺大的，讲得其实在离散的老师里面算不错的
179689,1676,邢卫,2023-09-19 09:32:23,4,4,0,邢卫你真的是啥比
192599,1676,邢卫,2024-05-24 12:56:37,1,1,0,一言难尽
192928,1676,邢卫,2024-05-31 15:45:57,0,0,0,离散数学上课没啥毛病，毕竟那个PPT可以，就照着读也就够了。就是作业时间比较紧
193780,1676,邢卫,2024-06-18 04:09:52,0,0,0,离散真讲的还蛮好的
194007,1676,邢卫,2024-06-21 10:27:31,3,3,0,形式主义严重的傻逼
196688,1676,邢卫,2024-07-04 18:19:54,2,2,0,一点不捞
196752,1676,邢卫,2024-07-05 03:20:28,1,1,0,不怕均绩降0.1就选
196928,1676,邢卫,2024-07-06 02:55:52,1,1,0,一分不捞 像这次期末难的话和其他班分数差很多 出分这么慢我以为至少会捞一下平时分的 不过不点名 分数全看期末 大佬可以选 担心期末炸的话慎选
197038,1676,邢卫,2024-07-07 01:10:40,-2,1,3,不点名，讲的也还行，1分不至于，6-8分是没问题的\n\n但是不捞，出分巨慢，能选翁姐姐还是选翁姐姐，放心补选，这个学期翁姐姐补选-23，能选上还是有概率的
197683,1676,邢卫,2024-07-29 03:58:56,2,2,0,纯nt
198257,1676,邢卫,2024-09-06 02:27:44,3,3,0,完全不捞
202317,1676,邢卫,2024-11-11 14:10:42,0,0,0,。。。
206083,1676,邢卫,2024-12-13 05:12:27,26,27,1,大一的同学可能还不知道如何利用补选.如果你因为预置了邢卫而打开查老师，放心地把他退了然后去联系李晓老师补选.放心大胆地补选翁老师，李晓老师人很好，基本都能补选上的.有的课补选上的同学比正常选上的同学还多.不要因为选了一个错误的老师而影响你的学业，我离散喜提大一最低绩点.
217538,1676,邢卫,2025-06-28 02:42:23,0,1,1,上课水平较之前确实提升了不少\n\n比分现在进化到中规中矩吧
218756,1676,邢卫,2025-05-01 14:44:51,0,1,1,好老师，有大局观
220665,1676,邢卫,2025-06-19 06:24:24,0,0,0,请捞我！
220980,1676,邢卫,2025-06-20 14:34:57,0,0,0,1111
221438,1676,邢卫,2025-06-23 12:40:52,0,0,0,能捞吗老师，隔壁翁jj捞爆了qaq
222076,1676,邢卫,2025-06-29 12:36:00,0,0,0,猛捞 今年开始从良了\n\n个人认为讲课还是很清晰的，对学生也有耐心，可以大胆选
1701,1681,张彤彧,2015-03-23 10:28:55,4,12,8,想睡觉
1759,1681,张彤彧,2015-03-24 05:06:05,-1,10,11,人很好
2279,1681,张彤彧,2015-04-16 08:10:38,15,44,29,大计基读ppt，作业超级多，给分也很差，必须去机房写，累而且分低。哭。。。
2543,1681,张彤彧,2018-09-12 12:07:59,87,103,16,讲的很详细，很清楚，我觉得张老师很棒！
3605,1681,张彤彧,2015-06-17 01:48:04,-6,12,18,大坑。。。。
3873,1681,张彤彧,2015-06-17 07:10:29,182,207,25,你们没觉得长得像吴镇宇吗
4795,1681,张彤彧,2015-06-29 02:46:28,4,11,7,张老师讲的很详细 只怪自己课后project没做好
5542,1681,张彤彧,2015-07-08 06:02:47,41,51,10,大计机没好好听，水了大半学期，觉得无聊。c程认真听了，讲得很细致。实话实说认真听了就不水。
6066,1681,张彤彧,2015-07-10 14:47:34,-1,2,3,还行
6670,1681,张彤彧,2015-07-18 04:01:13,3,10,7,上课认真详细，认真ting的话上四没问题，不认真的话呵呵了..
7012,1681,张彤彧,2015-08-28 05:00:36,27,37,10,讲得非常清楚 尤其是下学期和吴老师对比了之后…
8135,1681,张彤彧,2019-08-19 09:51:13,68,78,10,大计基作业有点多，但是课还是上的不错的…我的C程和大计基都是彧哥教的~ps只有我觉得彧哥其实挺帅的么
8408,1681,张彤彧,2015-09-21 04:55:16,0,3,3,不错的
9125,1681,张彤彧,2015-10-13 15:24:15,22,32,10,作业贼多，感觉是所有老师里最多的，，做个实验还要过程一堆测试无力回天\n\n
9185,1681,张彤彧,2015-10-15 15:45:10,12,17,5,大计基作业很多很多很多
9440,1681,张彤彧,2015-10-27 07:11:59,0,3,3,很有范的老师
9623,1681,张彤彧,2015-11-03 05:56:05,0,4,4,老师很负责\n\n
12196,1681,张彤彧,2015-12-22 09:23:51,0,5,5,老师程设课超级仔细，像我这种渣渣都能听懂，点赞
12654,1681,张彤彧,2015-12-24 00:18:38,19,27,8,大计基作业多。。\n\n不知道为什么听他的课总想睡觉
12668,1681,张彤彧,2015-12-24 00:47:51,5,9,4,作业超级多，但是很负责，讲课认真，略古板，让人想睡觉
13267,1681,张彤彧,2015-12-26 03:04:10,25,32,7,很可爱啊，就是大计基作业真心多  
13299,1681,张彤彧,2015-12-26 10:25:44,0,4,4,超级细心认真
13406,1681,张彤彧,2015-12-28 01:14:12,0,3,3,张老师讲课很细致，像我这样完全不懂C程的人也很容易听懂，讲课进度稍慢，总体来说，是一位很负责的老师。\n\n
15715,1681,张彤彧,2016-01-16 07:27:27,9,21,12,大计基作业奇多，人不是很通情达理，期末考试没带学生证甚至会开考之后还把你赶回去，上了一学期没爱了感觉。\n\n
18441,1681,张彤彧,2016-01-21 15:46:47,11,21,10,讲的是不错，可是作业太多，给分坑
19667,1681,张彤彧,2016-01-25 05:09:54,2,7,5,很帅的老师～讲课超细致！就是作业会要求自己输数据有点烦，quiz就是变相点名 给分也不错～
19681,1681,张彤彧,2016-01-25 05:37:52,-5,4,9,平时他讲的基本没怎么听，作业，测试，大作业挺多的，感觉还可以接受的，重要的是期末必须自己认真看书，看了两遍，考试基本没什么大问题，给分90还行吧不算坑。
19699,1681,张彤彧,2016-01-25 06:11:41,0,2,2,反正不管怎么样我觉得是好老师
19875,1681,张彤彧,2016-01-25 12:57:51,0,3,3,只要你努力，老师一定会负责的给分，很有人格魅力
20101,1681,张彤彧,2016-01-26 05:34:38,-1,3,4,讲课很好
20108,1681,张彤彧,2016-01-26 06:17:30,10,18,8,老师讲课很认真。\n\n但是…没认真听的我期末挂了……\n\n给分真心低\n\n作业超级多……
20278,1681,张彤彧,2016-01-27 01:57:47,-1,2,3,上课很认真讲的很细致，重点会讲好几遍，不点名，给分也比较合理，是个好老师
21039,1681,张彤彧,2016-02-13 05:21:25,-3,2,5,不错的
21495,1681,张彤彧,2016-02-29 05:02:40,23,31,8,讲课一流，长相一流，有小测验，作业略多，给分一分耕耘一分收获
22861,1681,张彤彧,2016-03-13 16:09:13,-1,3,4,遇到过最好的老师，那些给张老师差评的都是因为张老师给分比较严格。
22881,1681,张彤彧,2017-05-25 01:18:36,-4,2,6,付丁5.0卧槽
26482,1681,张彤彧,2016-06-19 02:23:42,0,2,2,讲得特清楚，作业适中，答疑也不错，挺推荐的
26530,1681,张彤彧,2016-06-20 02:25:22,0,2,2,老师讲的很清晰，很通俗！
27066,1681,张彤彧,2016-06-22 14:37:01,0,2,2,很认真
27675,1681,张彤彧,2016-06-27 08:00:01,0,1,1,C程讲得很清楚，认真听课收获很大，人也很好，不过作业都要去机房写挺麻烦的
27761,1681,张彤彧,2016-06-27 11:56:11,0,1,1,老师讲课绝对一流，介绍内容丰富，希望给分好一点~
28616,1681,张彤彧,2016-06-28 11:03:09,2,4,2,进浙大之后第二门上课不怎么跑神的课，老师很棒！
31739,1681,张彤彧,2016-07-04 16:05:47,3,9,6,大计基作业很多很多，C比较水…
31836,1681,张彤彧,2016-07-05 03:52:15,0,1,1,喜欢(｡･ω･｡)ﾉ♡
31899,1681,张彤彧,2016-07-05 06:18:18,1,4,3,讲得细，给分好，颜值高，超棒
32019,1681,张彤彧,2016-07-05 11:38:30,1,2,1,非常好
32415,1681,张彤彧,2016-07-06 15:23:58,0,3,3,教学，问答，给分等各方面算不上超好，但都过得去，合起来就是一名不错的老师
32710,1681,张彤彧,2016-07-11 04:59:57,-1,2,3,给分低
32720,1681,张彤彧,2016-07-11 15:04:15,4,5,1,老师很负责，思路很清晰
33651,1681,张彤彧,2016-09-21 00:39:18,2,3,1,很舒服 讲话很慢
35616,1681,张彤彧,2016-11-10 07:33:56,0,1,1,作业多是应该的，想学好当然要多一点，老师讲课很细，听不懂他会多说几遍，长的是挺帅的啊\n\n
36116,1681,张彤彧,2016-11-10 12:45:22,1,2,1,像黄磊，哈哈哈，张老师很好的，必须10分
37494,1681,张彤彧,2016-11-19 06:27:37,-6,3,9,作业多 太多 非常坑 邮件也半天才回 就会读ppt好吗
38450,1681,张彤彧,2016-12-05 09:02:18,1,4,3,很有范儿的老师！！！ 有一种上世纪领导人的feel！
38968,1681,张彤彧,2016-12-20 06:18:21,0,2,2,讲课无比清晰细致
39271,1681,张彤彧,2016-12-22 01:44:41,0,3,3,作业多吗？不过时间长啊，一言不合作业就是20多天期限，别的老师都是7天好吗
40213,1681,张彤彧,2016-12-30 05:15:24,4,6,2,老师是挺好的，但大计基的作业确实是太坑了！！！我现在正在机房呢！谁来救救我！！！
40414,1681,张彤彧,2017-01-03 07:45:49,3,5,2,张老师讲得很详细，而且很清晰，而且老师人也很好，就算问有点傻的问题，老师也超级温和地回答。
40421,1681,张彤彧,2017-01-03 08:04:12,0,1,1,张老师很棒哦！极其认真，虽然念PPT但是还是有补充的。
40926,1681,张彤彧,2017-01-06 13:40:30,0,2,2,很棒的老师，讲的很细很清楚(c程)
41460,1681,张彤彧,2017-01-11 16:50:14,1,3,2,必然好老师 必须十分 大计基作业的确有点多 但是认真做 期末的时候会轻松很多 上课讲的很细致很认真 好好听讲 认真做作业 真的收获满满 希望不要因为上面那些给分低作业多而吓跑 那只能怪自己
45845,1681,张彤彧,2017-01-20 07:17:56,0,5,5,彧哥真的帅，被他的声音深深吸引①上课讲的英文单词让你考试最后一题完全不怕②上课讲的考试注意点在复习的时候都会发现③上课真的很棒，而且给分好啊，感觉自己期末最多能考80%结果拿到了4.8所以就来给十分啦哈哈哈哈开心。彧哥真的好帅啊！我爱彧哥！
45849,1681,张彤彧,2017-01-20 07:21:16,1,3,2,问问题的时候特别耐心地解答 人很和蔼亲切 讲的很清楚 平时上机也管的松 关键章节的编程题稍微多点 整体布置作业都比较少
45873,1681,张彤彧,2017-01-20 08:09:54,-2,2,4,可能是由于教室空调开的太足的原因，冬学期总想睡觉，老师很帅，c程讲得很好。自己也没有付出太多，能上4很开心。。。
45983,1681,张彤彧,2017-01-20 10:43:33,0,1,1,绩点最高的课，张老师讲的很全面，而且补了很多大计基的知识（上的程设）\n\n
46005,1681,张彤彧,2017-01-20 11:25:12,-11,2,13,人很帅很精神，讲课很有趣，不过我大多数时候在睡觉或玩手机。最后给了4.8，真的没想到。
46461,1681,张彤彧,2017-01-21 16:25:53,12,16,4,绝对好老师，上课满满都是干货，难得的可以记笔记记到手抽的课～期末大计机考到书上没有计算机学院ppt上也没有的内容然而老师上课讲过～就在课堂笔记里⊙▽⊙所以上课一定要认真听（否则期末考题飘过……）
46816,1681,张彤彧,2017-01-22 11:18:09,0,3,3,老师很好。很和蔼。虽然大计基这门课一般是没几个人会去问问题的，但是有同学上去问老师还是会很热心解答的。上课内容比课本要多，一般考试的范围，用课件，上课不睡觉认真听还是挺有趣的。作业比某海来说少了挺多的，测试作业有答案，课程作业是课本课后练习抄到电脑上，实验的作业基本上是每节课后一个，内容是实验那本书的部分题目，时间可能需要一个多小时，这个比较麻烦但是还行。比较感动的是本人这学期最后实验大作业没传成功（绩点会变0），老师在最后机考的时候写了条子过来让我重新传一遍。很负责啊，给分就不多说，这次考试很难没有说服力。
48509,1681,张彤彧,2017-03-06 08:35:16,37,45,8,大叔型老师，颜值上等，声音有磁力，温柔细致，上课从不想睡，大叔控表示根本把持不住‾͟͟͞(((ꎤ >口<)̂ꎤ⁾⁾⁾⁾
56826,1681,张彤彧,2017-07-04 17:05:20,1,2,1,o(￣ε￣*)
57202,1681,张彤彧,2017-07-06 04:40:57,1,3,2,感觉课时很紧张，老师讲得有点快，不过讲得很细，而且给分感觉不错。
57207,1681,张彤彧,2017-07-06 04:47:07,1,2,1,很好，给分不要太好
57211,1681,张彤彧,2017-07-06 04:49:52,1,2,1,给分好~
57221,1681,张彤彧,2017-07-06 05:01:03,1,2,1,感激老师，老师教得好！
57222,1681,张彤彧,2017-07-06 05:02:22,1,2,1,感激不尽~
58184,1681,张彤彧,2017-08-16 13:54:48,1,2,1,老师非常帅！觉得他程设课讲得非常给力，真的很庆幸自己能够上到张老师的课，给老师笔芯啊啊啊啊！
58826,1681,张彤彧,2017-09-18 04:19:33,0,1,1,好老师不解释\n\n
59069,1681,张彤彧,2017-09-19 10:02:18,0,1,1,第一节课hello world整错了。。
59617,1681,张彤彧,2017-09-25 02:38:25,1,2,1,张老师特别贴心，讲课也很细致，上课做笔记根本停不下来啊哈哈，而且老师身上有一种儒雅的气质，讲话不紧不慢，很吸引人
59650,1681,张彤彧,2017-09-25 10:01:54,1,2,1,老师讲的很仔细很清楚，而且感觉人超级好
60510,1681,张彤彧,2017-10-23 03:08:26,1,3,2,不会承认自己的错误，不过讲课挺好的
60752,1681,张彤彧,2017-10-29 11:45:42,0,2,2,老师讲话很温和，但作业很多，脑子都涨了 ，课程作业书都要翻烂了。
62148,1681,张彤彧,2017-11-22 15:12:49,0,1,1,好主意\n\n
63878,1681,张彤彧,2017-12-18 08:28:00,2,3,1,非常好，讲得很清楚!
63879,1681,张彤彧,2017-12-18 09:20:01,0,4,4,我觉得老师上课逻辑十分清晰，不扯废话，都是干货，但可能不感兴趣的同学听久了会觉得小困困吧。老师的作业真的是算少的，而且简单容易哟！
64561,1681,张彤彧,2017-12-25 08:15:17,-2,2,4,我觉得老师讲得很好，作业也少，简直男神。
65229,1681,张彤彧,2018-01-02 00:03:00,2,3,1,他的大计机作业是不少的。。。
72831,1681,张彤彧,2018-01-31 06:55:21,0,1,1,讲得是超级认真 脾气也超好 所有问题都回答很耐心啊超棒的老师
72839,1681,张彤彧,2018-01-31 07:32:11,1,2,1,不点名 作业多 给分不错 \n\n٩(๑`^´๑)۶
72910,1681,张彤彧,2018-01-31 10:07:24,0,1,1,我上的大计基，老师人挺好的，每次发邮件都会回，作业挺多，不过如果没了作业真的想不出来能学到什么，课本是真心看不进去。最后绩点也还好吧，行为觉得老师没考太好，最后这个样已经满足了！
72930,1681,张彤彧,2018-01-31 11:31:21,0,1,1,what?我怎么没收到成绩，是挂科了？
72938,1681,张彤彧,2018-01-31 11:50:49,0,1,1,。。。
73015,1681,张彤彧,2018-01-31 14:54:37,1,2,1,啊哈其实不怎么认真听，但是是很好的老师呐~而且，颜值很高喔！
73176,1681,张彤彧,2018-02-01 05:47:10,0,1,1,很好的老师！平时事情比较多，但给分好啊！儒雅有气质！
73495,1681,张彤彧,2018-02-01 17:08:15,0,1,1,很ok哦，期中考试没考好不要紧哦！
73518,1681,张彤彧,2018-02-02 01:06:04,1,2,1,听张老师的课简直是一种享受，讲的超级细，作业虽然略多但截止日期晚啊，而且不做作业怎么巩固知识呢，所以作业没什么好抱怨的，给分很棒，打call打call
73639,1681,张彤彧,2018-02-02 08:45:26,0,1,1,老师挺好的，但大概我不适合读程设吧，绩点爆炸。。。
73717,1681,张彤彧,2018-02-03 02:41:22,1,2,1,我觉得大计基老师的作业不多啊，至少并不难，和别的老师比一比就知道了。张老师布置的作业期限都很长，而且都是简单容易完成的。其他老师布置在网站上限时答题没答案的我们都不用做，要做的作业答案也是easy to get的啦，你们自己估量吧哈哈
73766,1681,张彤彧,2018-02-03 05:16:31,0,1,1,很棒！给分很好！
74334,1681,张彤彧,2018-02-11 13:39:59,0,3,3,超级棒，这一届的作业比往届要少很多。每节课都认真听，期末复习不会占用很多时间，而且满绩是很轻松的事
74608,1681,张彤彧,2018-03-04 14:48:02,0,0,0,给分不错 作业略多
76619,1681,张彤彧,2018-04-16 09:53:10,-4,4,8,超喜欢拖课
80948,1681,张彤彧,2018-07-03 03:31:51,1,2,1,感觉程序设计专题的作业好少啊，和其他老师一比就发现了，感觉自己这门课就是水水过的。但是上课的确上的很好，希望以后能有研讨课这类的吧。
81083,1681,张彤彧,2018-07-05 03:38:16,0,0,0,作业多少看什么课，要看清
81498,1681,张彤彧,2018-07-12 05:13:36,3,5,2,谢老师不挂之恩
82931,1681,张彤彧,2018-07-09 10:16:02,3,4,1,考完期末赶紧来给个10分?哭了，实验题就做出来两个…希望老师能网开一面…\n\n
83156,1681,张彤彧,2018-07-10 00:23:51,-1,0,1,爱老师！
83508,1681,张彤彧,2018-07-10 12:58:50,0,2,2,救救孩子，理论分数太低了，救救孩子
84724,1681,张彤彧,2018-07-13 15:37:25,0,0,0,1，老师讲课真的超级好\n\n2，我本以为要挂科了，结果老师没给我挂，真的是…真的是给了我希望…
84725,1681,张彤彧,2018-07-13 15:38:53,0,0,0,无敌！
84728,1681,张彤彧,2018-07-13 15:51:44,4,6,2,老师真的不错，讲课讲的很好，期末应该也调分了。(我期末理论81，实验做出来三个，最后总评93)\n\n再次感谢老师!
84736,1681,张彤彧,2018-07-13 16:28:35,-1,2,3,只要期末85以上就满了，大家加油
84780,1681,张彤彧,2018-07-14 00:59:19,0,0,0,很好的老师 帅得呀匹
84782,1681,张彤彧,2018-07-14 01:03:15,0,1,1,老师上课很仔细很棒 期末应该是调分了 理论78实验3道 最后给了92hhhh 真的超级感谢老师！
84803,1681,张彤彧,2018-07-14 02:20:41,0,0,0,讲的挺好，还挺帅的
88084,1681,张彤彧,2018-10-22 03:04:34,2,2,0,张老师讲的非常清楚明白！很有条理，认真听一定有收获，会讲很多课本上没有的东西，记得拍PPT，
88614,1681,张彤彧,2018-11-04 02:13:35,2,2,0,如果认真听就会觉得很不错and张老师挺帅的
91017,1681,张彤彧,2019-01-28 15:55:36,-54,8,62,书么不教，逼么老装
99877,1681,张彤彧,2019-01-25 08:59:02,6,7,1,很好的老师，讲课也很认真，就是进度可能稍稍有些慢，下学期还想补选他的c大程…（偷偷说一句：老师平时分多给点吧2333
100016,1681,张彤彧,2019-01-25 12:43:36,6,9,3,哎我真的超级超级喜欢张彤彧老师，我的男神啊，超级帅，声音也好听，上课讲的很仔细，也不讲其他的，如果认真听认真记能学到很多，虽然平时作业很多，但时间给的比较长，（不过还是很惭愧有几次做不完了只能百度）但还是不妨碍我做他的小迷妹，嘿嘿嘿，总之下学期还想上他的c大程，不过跟其他课冲突了，而且期末考没达到预期……只能怪我自己水平不够吧，不过老师真的超好啊，考试坐第一排老师在前面逛还露出迷妹的眼神来着……不管最后给分怎么样，男神没错了
101478,1681,张彤彧,2019-01-28 09:27:45,7,8,1,为什么出分那么慢，但还是很喜欢老师。\n\n
101871,1681,张彤彧,2019-01-29 10:43:02,18,23,5,老师你一定在努力调分对不对
101925,1681,张彤彧,2019-01-29 17:57:20,4,5,1,啊啊啊啊啊啊啊刚才看到成绩了（我自己的大计基啥样我也是有点数的）谢谢老师不挂之恩 我真的差点以为自己要挂了....我觉得老师给分应该还是可以的 认认真真好好学的同学应该能拿个好分数～
101933,1681,张彤彧,2019-01-29 22:54:54,6,6,0,老师人很好，上课水水的，我期末考试费了很大劲准备。上课认真听能够学到很多东西。长得真的很像吴镇宇。
101944,1681,张彤彧,2019-01-30 00:28:00,2,2,0,给分应该还可以，出分极慢
101970,1681,张彤彧,2019-01-30 01:36:00,1,2,1,期末机考觉得要凉，结果4.5，老师超好超好超好，人长得帅讲的通俗易懂，发邮件绝对回复，耐心解答，总之超好！！！
101989,1681,张彤彧,2019-01-30 02:26:45,1,1,0,谢老师不挂之恩
101994,1681,张彤彧,2019-01-30 02:51:07,-1,2,3,谢老师不挂之恩！本来还以为要挂没想到拉高了均绩！老师又帅又有气质！这学期预置他的大计基真是我的荣幸！
102036,1681,张彤彧,2019-01-30 06:00:52,18,18,0,系统地评价一下张老师叭：1 上课听的话就不水 不听的话需要自己很用力地自学 当然自学也是能学明白的 2 作业均匀地分配在了一个学期的各个时间 平均下来其实压力不大 比我室友ta们老师的期末一下全布置下来要强多了hhh 3 老师应该算是有耐心的那种 会很细致很耐心地答疑 4 老师颜值衣品没的说 是我很喜欢的大叔类型 长得像吴镇宇是真话 5 最后给分不错 我实验按规定完成 课后习题按时提交有一次还晚了几天 期末认真复习刷题 最后绩点4.5还不错啦
102093,1681,张彤彧,2019-01-30 11:51:11,1,1,0,上的老师的大计基，老师人帅，声音磁性，讲的很详细，很有气质，很认真地想让同学弄懂。但是顺便吐槽一下学校的考试系统，卡了半个多小时才顺畅起来，考试体验极差。
102136,1681,张彤彧,2019-01-30 15:27:00,2,2,0,老师人真的很好，上课讲得挺仔细的（虽然课在下午会犯困）而且应该是努力在帮我们调分了，机考还是要多看看书|ω・）
102152,1681,张彤彧,2019-01-30 23:14:39,1,1,0,人美声甜的满分老师
102162,1681,张彤彧,2019-01-31 01:20:16,1,1,0,有磁性的声音，幽默的风格，给分也超好，可惜大程不是zty老师了
102171,1681,张彤彧,2019-01-31 04:47:28,0,0,0,给分不错，作业很多（本身不多，只是和其他班相比）。上课的话，讲的很细，但是可能是我个人问题，这一个学期基本上都睡过去了，课后看书写作业，考前刷题，绩点最后4.5，还是很好的。
102211,1681,张彤彧,2019-01-31 12:17:59,3,8,5,挺好的，平时分给满了，理论96实验三题，总评给了98。
102217,1681,张彤彧,2019-01-31 12:39:40,1,1,0,老师人很好，教学很细，给分也很好
102352,1681,张彤彧,2019-02-01 06:08:29,0,0,0,长得帅，声音温柔好听，讲的很细，但是对我来说有点催眠……作业比其他班多，但是给的时间长，有调分(●'◡'●)ﾉ❤
102449,1681,张彤彧,2019-02-02 10:04:10,1,3,2,给分呵呵 讲课慢
102533,1681,张彤彧,2019-02-05 06:40:23,4,4,0,张男神！男神！男神！\n\nC程是这学期睡得最少的课\n\n（我比较能睡）
102644,1681,张彤彧,2019-02-17 06:18:18,-3,2,5,一般般
104193,1681,张彤彧,2019-03-13 15:38:42,5,7,2,上完李际军之流的oop再来上张老师的大程简直是享受，讲的很好很细致，听课很舒服。一年前上过张老师的大计基，说实话基本都在睡觉以为老师水平一般般?对不起老师我错了呜呜呜
104326,1681,张彤彧,2019-03-18 02:49:35,0,0,0,很好，十分详细负责\n\n
104414,1681,张彤彧,2019-03-20 02:52:30,0,1,1,计科：老师很帅啊，有时候上课还很可爱～讲得很清楚，也很细致。作业的话，嗯，上机实验有点麻烦。给分也合理，就是慢了点。最后呢，表白大机基答疑群，小朋友们都太可爱了，也非常热心～ヽ(〃∀〃)ﾉ
104518,1681,张彤彧,2019-03-22 07:31:26,3,3,0,表白C程助教小姐姐
108279,1681,张彤彧,2019-07-07 21:50:36,5,7,2,老师长得帅就算了，上课讲的还很清晰，面面俱到，最后调分的幅度让人大吃一惊！
111168,1681,张彤彧,2019-06-30 08:00:02,6,6,0,往老师救我狗命
111632,1681,张彤彧,2019-07-02 09:05:16,2,2,0,老师讲课思路很清晰，也经常会讲到一些平时不容易注意但是考试会考的细节，很感谢老师
111932,1681,张彤彧,2019-07-03 03:24:59,2,3,1,老师讲的贼好，希望能捞我一手
113826,1681,张彤彧,2019-07-07 17:15:10,3,4,1,说点和老师无关的，两天考试难度相差太大，调分也难以保证完全合理。\n\n老师很好很负责，调分应该也是做了的
113871,1681,张彤彧,2019-07-07 22:33:05,2,3,1,老师捞我啊啊啊太感动了
113875,1681,张彤彧,2019-07-07 22:43:02,1,2,1,老师帅啊，讲得好，给分好!!!
113879,1681,张彤彧,2019-07-07 22:59:46,0,1,1,非常好
113912,1681,张彤彧,2019-07-08 00:29:29,0,2,2,上课有深度，30号理论太难了，最后给分很好！助教xjj幸苦了！
121866,1681,张彤彧,2020-01-23 01:17:54,-1,0,1,老师超级棒
121974,1681,张彤彧,2020-01-27 07:15:49,-1,0,1,超级好，不水，听课舒服
122658,1681,张彤彧,2020-03-13 02:38:32,-1,1,2,老师超级好，上课讲课真的是有东西的，作业多虽然多，但是c程这种东西，练的多是必须的，一学期下来，虽然很累，但基础真的没得说，c小程满了，可惜c大程没选上，10分好评
123632,1681,张彤彧,2020-06-11 01:45:29,-1,1,2,上的是上学期老师的小c，讲课细致清楚，回答问题热心温柔。我学得挺开心的，基础打得不错。最后应该有调分（往高的那种）老师超好的
125087,1681,张彤彧,2020-08-29 16:23:42,-2,1,3,老师超好！
125294,1681,张彤彧,2020-09-05 17:27:55,-2,1,3,讲的超级清晰！！老师人很好，也经常会在群里答疑！
125397,1681,张彤彧,2020-09-08 06:13:37,-1,2,3,好老师/
126174,1681,张彤彧,2020-09-18 11:30:53,-1,2,3,张老师，永远滴神！\n\n课程内容丰富，题库量大管饱，不会卡人绩点，感谢老师！
126191,1681,张彤彧,2020-09-19 01:17:42,-1,1,2,温文尔雅
126203,1681,张彤彧,2020-09-19 13:10:36,-1,4,5,我想破脑袋也没想明白，为什么我总评是73\n\n因为我怎么算都过不了70
126206,1681,张彤彧,2020-09-19 13:27:30,-2,0,2,感觉C小程给分挺好的，老师讲得很详细。i了i了
126230,1681,张彤彧,2020-09-20 07:55:50,-2,1,3,讲课很好，但捞不动我，是我的问题，刚好卡绩，这就难受了啊！
126664,1681,张彤彧,2020-10-12 11:37:29,4,4,0,作业真的太多了，太多了
126792,1681,张彤彧,2020-10-20 07:10:48,0,2,2,清楚详细
127744,1681,张彤彧,2020-11-26 10:03:01,1,3,2,老师很帅，我好爱，讲的清楚
129018,1681,张彤彧,2020-12-28 14:26:55,-1,2,3,#C程\n\n老师讲课思路清晰，知识点讲的很细！就是作业有时有一点点多。
129145,1681,张彤彧,2020-12-30 11:43:43,0,3,3,张老师讲课认真细致，不能更赞了。虽然作业略多，但还是很感谢老师。C大程没选上张老师，遗憾。
129490,1681,张彤彧,2021-01-06 07:38:04,1,4,3,他上课时自己精神很饱满，老师人也帅！知识点解释得也挺清晰，也会稍微拓展一点点别的！
129854,1681,张彤彧,2021-01-13 04:20:54,5,10,5,大计基作业很多没错 但是看完别班的作业之后 发现其实老师给我们的作业 真的还好 不算多 上课内容也讲的很仔细！ 选他！选到就是赚到！
129897,1681,张彤彧,2021-01-13 10:00:53,-1,2,3,老师上课讲得很清楚呀，作业和别的班也都差不多，老师人也真的超帅！
130554,1681,张彤彧,2021-01-23 15:12:07,-1,3,4,超级帅！
131727,1681,张彤彧,2021-01-28 15:10:35,-4,1,5,专业能力贼强
132531,1681,张彤彧,2021-02-02 06:17:48,3,8,5,谢老师不挂之恩（真的会调分的）！！！
132945,1681,张彤彧,2021-02-05 09:07:00,-1,3,4,给分特别好
132946,1681,张彤彧,2021-02-05 09:08:17,0,3,3,给分好，上课讲的逻辑清晰，也非常认真\n\n男神老师，爱了爱了(⑉°з°)-♡
132956,1681,张彤彧,2021-02-05 11:47:42,0,9,9,超好，计科一半没交，实验两次迟交，平时不听最后考前看了半天就有4.5
134095,1681,张彤彧,2021-03-15 17:30:28,-2,3,5,good teacher
138961,1681,张彤彧,2021-07-12 03:48:09,-1,3,4,彤彧哥yyds！人帅心善，讲得也非常清楚
138970,1681,张彤彧,2021-07-12 04:52:03,-1,4,5,彧哥基本都给满
139010,1681,张彤彧,2021-07-12 07:39:25,-1,4,5,捞的太狠了....
139086,1681,张彤彧,2021-07-12 14:40:12,-2,3,5,zty老师yyds(´∀｀)♡，救命恩人了呜呜呜呜
139316,1681,张彤彧,2021-07-14 09:00:20,-1,3,4,zty老师yyds
139411,1681,张彤彧,2021-07-15 08:47:06,-1,3,4,彧哥我男神！！讲的是真的清楚！给分是真的好！
141598,1681,张彤彧,2021-10-16 11:46:09,0,6,6,张彤彧老师不是满分我理解不了
143332,1681,张彤彧,2021-11-23 12:06:15,-1,5,6,神！就是神！老师是神！\n\n这比高中老师都尽职尽责的劲头真的感动到我 讲的基本都是书本拓展又有用的内容 呜呜
144047,1681,张彤彧,2022-01-14 08:24:24,1,9,8,讲的很细的老师，语调很有顿挫感
144908,1681,张彤彧,2021-12-26 01:48:30,7,10,3,不想说什么了，大计基体验很不好
145297,1681,张彤彧,2021-12-29 03:30:10,-2,5,7,我就是ty叔叔（？）单推人！人帅事少给分好！
146022,1681,张彤彧,2022-01-16 16:44:39,16,19,3,今年给分没有传说中的好\n\n隔壁班理论38被捞\n\n45被挂了😩
146076,1681,张彤彧,2022-01-05 11:14:28,0,3,3,求求老师捞我，C程自己估分在及格边缘
146939,1681,张彤彧,2022-01-08 06:15:38,0,3,3,马上考大计基，老师，菜菜，捞捞，呜呜
147077,1681,张彤彧,2022-01-08 15:06:37,0,2,2,求捞捞
148177,1681,张彤彧,2022-01-11 18:53:58,0,2,2,大计机求捞捞
148534,1681,张彤彧,2022-01-13 00:01:44,0,2,2,老师 菜菜 捞捞
149690,1681,张彤彧,2022-01-28 05:58:38,23,35,12,我和我的同学都认为张彤彧老师给分很差。我的室友跟着王建江老师上C程，他的理论分数比我低，实验一样，最后他66，我的C挂科。看了一下，他的C被王建江老师捞了。在此明确一点，张彤彧老师不捞人。\n\n有关上课，张老师明显很享受上课的过程，这点很好，但是条理不好，而且一直在读PPT，枯燥乏味。\n\n本来，我对这位老师就是不咸不淡地吧...成绩对比一下就有点厌烦了。。。。。祝在张老师这里挂科的同学重修顺利吧。
150164,1681,张彤彧,2022-01-19 20:02:11,6,13,7,从哪里看出细致？细致到跟着ppt一字不漏的读？还声音抑扬顿挫，都是托吗？
150169,1681,张彤彧,2022-01-19 23:38:39,7,9,2,事情巨多，讲课很没意思，给分也挺严苛的
150174,1681,张彤彧,2022-01-20 01:12:06,-1,7,8,虽然作业多但到考试就不怕了呀，不错不错，强推
150176,1681,张彤彧,2022-01-20 01:22:09,0,5,5,大计基给分真的好
150177,1681,张彤彧,2022-01-20 01:33:05,-1,5,6,老师人帅心善声音好听，虽然我刚开始对大计基一窍不通，上课如同听天书，但是到期末补智云的时候才发现老师讲课真的很清楚！期末上机考自我感觉很差，很多题不确定，但是每次实验作业和计科练习认真完成绩点不会差的！老师给分真的挺不错的，快选！
150247,1681,张彤彧,2022-01-21 02:01:03,-5,3,8,老师讲的很细，虽然期末不划重点。但是平时作业题刷过了都能意会。考前看看PPT，有时间看看平时的题，老师就能把你捞上来了。
150735,1681,张彤彧,2022-02-16 08:09:20,0,5,5,好好好
150736,1681,张彤彧,2022-02-16 08:09:20,0,5,5,好好好
151724,1681,张彤彧,2022-03-13 23:41:55,-35,17,52,这个老师分数那么高，我真的不能理解。理论46，实验做出来2.2道，挂科。正值转专业的紧要关头，这踏马******。\n\n\n\n如果上课狂念PPT叫抑扬顿挫，当我没说。\n\n\n\n如果学生问问题不耐烦叫温厚有理，当我没说。\n\n\n\n如果以上称作海底捞，当我没说。我们班今年6个挂科的，5个是C程，其中3个是跟它上的。\n\n\n\n不要问我为什么不尊敬老师，尊敬也要看对谁。\n\n\n\n最后说一下，我不是下面那位理论四十多挂科的同学，我在叙述真实想法，而不是在换个号刷黑评。\n\n\n\n如果有同学预置或选上此老💩的课，请退避。
151895,1681,张彤彧,2022-03-19 15:28:14,2,6,4,讲课细细细！很适合我这种菜菜！
151986,1681,张彤彧,2022-03-22 12:07:07,14,17,3,c小程，作业，真的好多啊，呜呜呜.虽然我以前学过c了，但还是觉得好多啊.
152256,1681,张彤彧,2022-03-31 12:42:42,1,5,4,作业特别多。但如果真的作业每道题都做的话绝对不会挂科，老师不捞也没办发。
152600,1681,张彤彧,2022-04-15 12:40:29,-45,14,59,浙大怎么会有这样的垃圾老师，滚！
152835,1681,张彤彧,2022-04-20 09:27:19,-5,5,10,非常棒啊
154169,1681,张彤彧,2022-06-27 03:45:53,4,8,4,我觉得给分不太好。。。
154287,1681,张彤彧,2022-05-29 05:12:41,-36,15,51,捞人是不可能捞人的，这辈子不可能捞人的。\n\n张彤彧，下辈子记住，不要当老师，不要当人更好。
157932,1681,张彤彧,2022-06-25 16:07:06,1,3,2,我感觉讲的很好很细，适合智云1.5倍速听
158486,1681,张彤彧,2022-06-29 15:28:26,0,3,3,老师c大程讲课比较细致，链表那块讲的挺好，但是给分真的非常迷惑。本人考试换算成百分制接近85，然后大作业互评满分（虽然个人感觉对于互评来说有点奇怪，但确实是这样），然后成绩出来互评部分老师说得分93（总分不说了，反正不高于这个），个人表示不太理解……给分迷惑
158811,1681,张彤彧,2022-07-02 11:35:59,0,3,3,老师讲课很好，给分也还行，理论95 实验满分，总评91，可能是平时作业不太好，总得来说不错
158817,1681,张彤彧,2022-07-02 12:12:53,14,19,5,客观的说，老师人很帅上课也很细致，不是一些同学说的单纯念ppt，会根据ppt补充很多额外的东西。平时作业确实比较多，但是那也是因为老师希望我们学好学扎实，老师第一节课就强调了这门课不是那么简单，所以作业稍微多一点也是可以理解的。最后给分也不错，明显是捞了的。另外，我觉得上面有些人的评论实在是太差劲了，再怎么样张老师也是师长，跟你无冤无仇，干嘛要故意为难你啊，上面有些话确实有辱斯文。建议给自己积点口德
159144,1681,张彤彧,2022-07-06 16:27:37,27,35,8,前面恶毒咒骂老师的，不说学问了，你们人品在哪里?那个说正值转专业却被挂了的，你确定你挂科更多不是因为你自己?说不好听的，C小程都在挂与不挂边缘线游走的，你能选择什么比你现在更好的专业?\n\n张老师确实给分求是，作业很多，但让你们撕破文明的脸露出这副破口大骂的模样是真的令人寒心。我一直对一种说法“学历不能筛选人品”不是很认可，希望不要让我最终相信这句话。\n\n不得不说，竺老做人之问还是未能让所有浙大人明白，为学，更要为人。我恳求大家，不论是否像前面有几位一样失去理智和失去人基本的文明，都再想想。
159236,1681,张彤彧,2022-07-09 02:24:40,7,13,6,c程，个人觉得是一个很好的老师，讲课很细致很适合小白，助教也很好，给分也很好。至于为什么那么多黑的我不理解，不妨问问自己是不是真的好好学了c程。平时作业都有好好做，每次小测也都有好好准备，理论91，实验扣了总评三分，最后也有总评92。上课第一节老师就说过了这门课平时分占比很大，平时摆烂还指望着老师平时分给你拉满的是不是多少有点搞笑了。
159407,1681,张彤彧,2022-07-18 16:39:47,-10,15,25,笑死，你认识那个挂科转专业的同学吗，就在这哔哔赖赖。人家C小挂了均绩照样4.1，解释一下就转走了，你有什么资格在这里叫，嗯？\n\n啊对，谁家狗狗不喜欢叫呢😓\n\n你说我为什么要护着她，那是因为这是她唯一一次骂人，人家是操作失误了才导致挂科的，你倒是看两句话直接懂了对吧？\n\n我没跟张老师上过，但我的同学一致反映张老师给分差。不管怎么说，包括一切情绪不好的同学，人家自有人家的道理，哪里轮得到你这个懂王在这里训斥，呵呵。
159479,1681,张彤彧,2022-07-24 16:40:55,15,21,6,前面的那位同学收一收，大家厌烦的是对待老师的态度。看看同样是评论这位老师给分不好、讲课枯燥的，一个十几个顶，一个近三十个踩，其实无外乎有无尊重人。能力是一码事，待人是另一码事。即使那位爆粗口的是天之骄子，我觉得对待这个言论上我还是会反对。
161799,1681,张彤彧,2022-11-13 14:03:30,-2,4,6,老师很好啊
162351,1681,张彤彧,2022-11-20 14:40:17,6,11,5,私以为张老师不好，嘿嘿嘿，同学们轻喷。哈哈
163758,1681,张彤彧,2022-12-16 05:16:19,-4,3,7,uu们，老师讲课有那么一丁丁枯燥乏味，关于人品嘛…我没问过问题，不晓得～关于给分嘛…课程还没结束，暂未可知～嗯，感觉老师一丝丝帅气～
164174,1681,张彤彧,2022-12-19 00:24:35,5,7,2,到教室开始下载PPT，上课很好睡，作业比较多，实验作业问是没用的，因为跟视频版本不一样/视频没讲问老师永远都是让你看视频，只能靠同学。。。
164732,1681,张彤彧,2022-12-24 11:20:22,10,14,4,快跑，我就是看了查老师的高分被骗进来的，作业巨多巨多。实验作业能花掉整整一天的时间，身心折磨，让人发疯，做过的人肯定懂。而且期末模拟测试分数要计入平时分，其他课测试模拟就是熟悉一下流程，这不就是第三次小测了嘛，纯纯pua。
164733,1681,张彤彧,2022-12-24 11:23:13,11,13,2,快跑！作业多死啦，模拟测试成绩计入平时分
165205,1681,张彤彧,2022-12-30 05:29:46,19,24,5,1分，课下钉钉上态度极差，只能用极差这个词来形容，我没见过一个老师答疑的语气是这么差的，有的人可能会帮老师辩解说这就是他发消息的习惯，那我实在不能想象老师您和家人发消息是不是也是这个态度
165266,1681,张彤彧,2022-12-30 14:43:04,13,14,1,多少沾点 不明白为啥分这么高\n\n面对群里的问题只是一句让同学自己看视频\n\n钉钉说话语气让我感觉我欠了这个老师几百万一样\n\n模拟测试成绩居然要计入平时分 真的很佩服
165600,1681,张彤彧,2023-01-09 01:44:13,11,16,5,非常差的态度，不是机器胜似机器。我不知道2021-2022这段时间发生了什么，但是我还是劝大家相信一点离自己比较近的评论。\n\n老师大计基水平我暂且不说，补充知识还是可以的，上课催眠暂且也还行，毕竟做笔记不会困。\n\n关键是态度。课下答疑的态度让人感到愤怒，包括但不限于爱答不理，已读不回，一律看视频解决，etc。而且不捞人也是真的。语气比铁石还硬，让人感觉几乎没有任何可以交流的余地。\n\n这样的人你愿意反反复复跟他讨论问题么？\n\n所以才说，不是机器，胜似机器。虽然没素质骂人是不对，但是我承认我看的非常爽，因为我也有这样的想法，尤其是在诚诚恳恳发过去一堆消息之后，最后是同学帮我解答的情况下。\n\n逃吧。越远越好。
166776,1681,张彤彧,2023-01-13 14:26:33,0,7,7,烂..
167890,1681,张彤彧,2023-01-20 02:26:30,5,12,7,呵，完全不知道他查老师上分为什么这么高
167898,1681,张彤彧,2023-01-20 03:34:08,-8,4,12,老师人真的超好，长的超帅，大计基讲的超认真细致，小白也能学到很多东西，作业感觉也是正常量，最后期末考了很多python，我考前突击，差点以为要挂了，结果最后老师捞到83，3.9，真的很满意了，谢谢老师
167912,1681,张彤彧,2023-01-20 07:37:59,2,7,5,上的是大计基。\n\n课上的还可以，知识点基本都讲到了，也比较清晰。智云二倍速听课+认真写作业+整理错题+必要的复习，最后满了。\n\n没有正式签到，参加过两次小测和模拟考就算签了。\n\n打了9分 扣掉一分的原因 一是钉钉群答疑态度一般 二是刷了下朵朵，今年没怎么捞人
167933,1681,张彤彧,2023-01-20 11:59:30,-13,5,18,上课从来不听，考前补天，出来4.5
169109,1681,张彤彧,2023-02-24 10:16:21,6,8,2,给分烂 不捞人
169110,1681,张彤彧,2023-02-26 09:06:56,0,4,4,真的不会捞，C小实验过程分不给
170954,1681,张彤彧,2023-03-13 07:43:54,5,9,4,我的天呀，自己挂科了为啥要骂老师不从自己身上找原因啊，我大一上纯摆烂挂了三科都没有想过是老师的问题，评论让我大开眼界
172332,1681,张彤彧,2023-04-25 06:19:20,3,3,0,上的挺好，就是比较犯困
172475,1681,张彤彧,2023-04-27 11:25:20,1,3,2,老师真的好帅！
172622,1681,张彤彧,2023-05-25 07:40:33,0,2,2,秋冬学期老生，模拟考试计入平时分是我没想到的。张老师真乃神人也。
173196,1681,张彤彧,2023-05-15 14:42:35,5,6,1,老师在钉群的态度我只能说极差，完全无法交流
173568,1681,张彤彧,2023-05-29 06:02:51,1,3,2,上课确实有些枯燥，挺干，但我感觉C小如果挂了大部分是自己的原因，要么就是发挥不佳，怪老师的估计是很自以为是吧
173811,1681,张彤彧,2023-06-03 07:39:20,1,1,0,秋冬学期大计基，老师没有捞人，多少分就多少分。老师很认真上课，但是上课念PPT有点枯燥，大计基建议自学
174204,1681,张彤彧,2023-06-07 09:57:03,6,6,0,老师c程作业布置的特别多，别人一次作业四五道编程题，我们动辄十几道甚至超过二十道编程题，有时还有很多函数题。实验考和小测结束了，不会考编程题了还会布置一大堆编程题，而且没有商量的余地。\n\n课后找老师答疑还是很认真耐心的，但钉群里确实很冷淡。\n\n助教姐姐很耐心温柔，有问必答。
177895,1681,张彤彧,2023-07-05 09:35:14,4,4,0,张老师上课还是比较清晰且有逻辑的，虽然张老师不捞，但是据我所知小测的难度一直不大，每次小测最后的编程部分大家基本上都是能写完的，其他老师我不知道，但是比起程建海老师的小测难度已经是简单的不止一点，平时认真完成作业，跟上老师的节奏最后一定是能拿高分的，认真上了一学期的课最后满绩了，十分献给张老师
178691,1681,张彤彧,2023-07-18 05:08:13,1,2,1,老师不错，c小给分挺好，怪我PTA有几次忘写了😢😢😢
179098,1681,张彤彧,2023-08-27 16:15:55,0,4,4,张老师给了我满绩，前来感谢
181140,1681,张彤彧,2023-10-10 02:02:15,2,5,3,从不点名，小测简单，上课细致，作业很多，让学生学的扎实，好老师，大一差一分满绩
181979,1681,张彤彧,2023-11-07 05:58:30,2,3,1,挺好的\n\n只是，板书是真的轻，根本看不见(T＿T)
184109,1681,张彤彧,2023-12-09 14:15:41,-15,2,17,事多分少，上课无聊，死板没有人情味
189110,1681,张彤彧,2024-01-22 02:41:44,0,0,0,作业有点多，但是老师上课挺好（虽然我爱犯困，但是和其他老师对比一下张老师还是讲得蛮不错的），给分还行，实验满分理论80-85左右，总评89，（平时作业写的很一般小测也很一般），老师挺帅人也温和，下课可以问老师题。
191601,1681,张彤彧,2024-04-25 15:45:10,0,0,0,声音很有特点（但本人经常课上犯困），平时作业和小测难度还行，偶尔题量会有点多。
192622,1681,张彤彧,2024-05-25 11:45:06,-11,4,15,史史史
193662,1681,张彤彧,2024-06-14 13:24:17,0,1,1,出分了再回来重新打分，如若不挂，当奉上10分拜为义父
193733,1681,张彤彧,2024-06-17 02:57:59,-9,12,21,不是这老壁灯怎么会有高评分的啊，死板的要死，作业多的要死，周末三天都有考试的布置两个PTA作业又不提醒，很多人忘做了也不让补交，给分差的要死一点人情味都没有，这会有9.7分，真逆天了属于是
193771,1681,张彤彧,2024-06-18 01:31:01,4,4,0,这个学期又选了一节编程的课，考前想起来之前上过张老师的课，来点评一下 张老师真的讲得很清楚，我后来的python甚至还可以吃点大计基的老本 当时上大计基的时候正值疫情开放回家，然后期中考是后来线上补的，刚好阳了，考的时候又吐又折腾，题目根本没看进去几道哎哎，平时有好好做作业，期末也认真复习了，最后结果还不错
196534,1681,张彤彧,2024-07-04 03:06:56,10,10,0,今天C小出分啦，喜提满绩！老师上课真的很不错，虽然有点催眠，但计算机课不都这样嘛。作业量有点小大，但是把花时间把题目搞懂实验考和理论考都很轻松。小测都是作业的原题，认真复习一定没问题！给分比较求是，但是认真努力一定会有好结果。
197216,1681,张彤彧,2024-07-09 09:06:25,1,4,3,喜提满绩。可以说张老师给分不好，但不能说他讲的不好，认真听理论考基本没问题。作业确实很多，认真做了理解了实验考也没什么问题。作业平时分按总得分/所有题目总分来算，总分有个三千多分，最后一次作业分少忘了问题也不大
197412,1681,张彤彧,2024-07-13 10:05:45,2,2,0,喜提满绩，感谢张爹
198525,1681,张彤彧,2024-09-30 03:23:05,1,1,0,好好好
199235,1681,张彤彧,2024-09-19 15:10:46,6,6,0,选到张彤彧的课就偷着乐吧\n\n去年上他的C尖，张老师讲课很清楚不催眠，会捞人给分好。作业比较多但是都很有价值，认真做收获很大，而且方便复习呀～满了，谢谢老师
200906,1681,张彤彧,2024-10-24 10:46:44,9,11,2,作业好多！！！写红温了！！！给个差评以解心头之恨
202904,1681,张彤彧,2024-11-15 05:34:15,1,1,0,作业多到想亖，老师讲课很陶醉，但小测作业是真多。。。
207600,1681,张彤彧,2024-12-23 08:19:25,1,1,0,上课负责、作业虽然多但可以巩固知识点，神老师！
210514,1681,张彤彧,2025-01-09 09:49:37,0,0,0,作业多，一学期点名五次(课间数字点名，可以课下补)，加上期中考小测四次，老师上课很负责，讲解很清楚，给分也可以，值得一选
210520,1681,张彤彧,2025-01-09 09:54:47,0,1,1,喜提满绩，感谢张爹！
210564,1681,张彤彧,2025-01-09 10:58:23,0,1,1,喜提满绩！老师讲的很好平时一些注意点也会有补充（虽然有一点催眠）作业虽然多但只要认真完成就会发现小测的实验题基本都是作业里有的，理论考平时认真听消化了考前翻一遍就完全OK的！
211267,1681,张彤彧,2025-01-11 05:53:15,-1,1,2,老师平时作业多 但是平时分给的是真的好！！！喜提满绩，张sir是我的神
212970,1681,张彤彧,2025-01-15 11:11:49,0,0,0,好好好
215644,1681,张彤彧,2025-03-03 07:22:10,0,0,0,好好好好好好
21471,1703,姜晓红,2016-02-29 03:12:08,9,15,6,思路清晰，666
23466,1703,姜晓红,2016-03-30 14:50:53,-2,4,6,很负责任，亲和，讲课易懂。
23709,1703,姜晓红,2016-04-13 06:23:15,0,10,10,晓红姐姐我女神
25370,1703,姜晓红,2016-05-16 06:18:28,-1,1,2,好好好
25424,1703,姜晓红,2016-05-18 10:26:23,27,29,2,“我都恨不得一次全讲完”
25691,1703,姜晓红,2016-06-24 10:04:48,7,9,2,拟声词非常丰富
27048,1703,姜晓红,2016-06-22 12:34:34,1,5,4,晓红姐姐声音好萌的
29929,1703,姜晓红,2016-06-30 14:02:39,3,6,3,浙大最能拖课老师。没有之一
32552,1703,姜晓红,2017-02-03 04:19:09,2,5,3,讲得很细
32600,1703,姜晓红,2016-07-08 04:07:05,1,8,7,上的计组，晓红姐姐理论课讲得挺好的(虽然很爱拖堂)，实验验收超严格，最后给分很厚道！
32601,1703,姜晓红,2016-07-08 04:07:41,1,5,4,讲得很好！给分很好，虽然拖堂，但是真的是好老师。
47169,1703,姜晓红,2017-01-24 08:11:59,-1,2,3,好老师，好人，实验严格，后悔机组没选她
47209,1703,姜晓红,2017-01-24 13:44:07,0,4,4,体系。给分不太好吧。。但能学到东西。。想要绩点的想要水的还是别选了
57584,1703,姜晓红,2017-07-10 06:39:10,0,4,4,老师讲课很细致，也很有耐心，中间还请了ubc教授来讲课，实验验收很严格但一个学期下来感觉很有收获！
72618,1703,姜晓红,2018-01-30 13:50:04,-2,1,3,挺好的 给分十分厚道
73486,1703,姜晓红,2018-02-01 16:03:22,1,7,6,讲课很棒棒！虽然很能拖堂，但是超负责任。助教给分不能再棒，基本上都是满分，认真干活很容易就能满
73758,1703,姜晓红,2018-02-03 05:09:46,0,4,4,讲课一般
73892,1703,姜晓红,2018-02-03 11:03:15,1,3,2,讲课很细，知识点梳理的很好。非常爱拖堂！T^T实验课验收严格归严格，会陪着学生debug，各种延长验收时间。是个负责（且给分好）的老师
88689,1703,姜晓红,2018-11-06 01:47:16,-2,1,3,给分比其他班好太多了
90773,1703,姜晓红,2018-11-26 03:03:02,1,6,5,感觉老师讲的硬件真的超棒！！！\n\n逻辑清晰老师还很可爱！\n\n验收和实验严格一点确实能学到东西！\n\n（只不过老师热情度太高经常会拖堂让同学们晚吃饭，不过老师也会每次说对不起＞人＜）\n\n给老师比心！
91188,1703,姜晓红,2018-12-03 02:55:46,6,6,0,唉..
104056,1703,姜晓红,2019-03-11 06:30:11,2,7,5,认真讲课的样子让人肃然起敬
104731,1703,姜晓红,2019-03-26 15:06:47,4,8,4,虽然没上过她的课，但听室友说她自己也不懂，讲不清楚，不到半个学期教室里的人数减少一半，于是就开始点名了...
112791,1703,姜晓红,2019-07-05 03:14:16,1,4,3,讲课水准10分\n\n但是…说给分好的出来挨打！！
113351,1703,姜晓红,2019-07-06 09:30:51,-3,2,5,现在已经基本不拖堂啦，而且老师和助教小哥哥都非常认真，给分也很好，50人的班有20多个同学90+
115523,1703,姜晓红,2019-08-01 07:29:09,4,6,2,小学期，怀疑她的能力，ppt真没错……
115563,1703,姜晓红,2019-08-04 07:14:21,0,2,2,整挺好！
116567,1703,姜晓红,2019-09-11 22:57:49,12,20,8,小学期计算机系统概论，当然课程主要是patt教授讲，给分是助教给，所以不清楚老师讲课风格和给分到底怎样。不过单论小学期，patt教授水平十分高，上课过程中真的收获很多，而且助教们也很负责给分很好，强推计算机系统概论！
124903,1703,姜晓红,2020-07-16 16:12:31,13,16,3,有个小建议，小学期计算机系统概论课，lab二次验收和delay一天都扣10分，其实我觉得delay可以多扣点，但验收失败的代价可以小一点（刚刚二验完，10分太疼了……）
125660,1703,姜晓红,2020-09-12 16:40:43,1,4,3,感觉一般吧，没什么可圈可点的地方。但是有时候的语气和态度...心态不好的同学不要选！
125688,1703,姜晓红,2020-09-13 05:14:00,-9,13,22,枉为人师。
128926,1703,姜晓红,2020-12-27 03:46:49,9,11,2,别选，千万别选\n\n实验与众不同，无从借鉴。而且难度高出其他班好多，验收也及其严格。
130534,1703,姜晓红,2021-01-23 13:35:37,-3,7,10,红姐姐太好了，闭着眼睛都能画出datapath，i了！
130535,1703,姜晓红,2021-01-23 13:42:36,-2,5,7,上了姜老师的体系，感觉是人挺好的一个老师。体系课上讲的东西比较全，会有一些不太会考的/其他班没讲的东西。实验上可能确实比其他班难一些，不过今后体系好像是会 RISC-V 教改，不知道教改后会不会消除实验的差别。
135762,1703,姜晓红,2021-05-24 05:19:09,9,14,5,说好听一点就是严格。\n\n说得不好听就是迂腐、死板。\n\n一分差评。
137013,1703,姜晓红,2021-06-29 10:39:45,38,38,0,很难相信计算机学院的老师什么计算机软件都不会用。\n\n实验课全部用来上理论课，逼得学生只能课下做实验。
138279,1703,姜晓红,2021-07-14 08:14:00,104,120,16,在一次计算机系统概论课上，姜晓红说：下面认为实验课应该给学生讲理论的同学坐到教室的左边，认为实验课应该让学生做实验的学生坐到教室的右边。大部分人坐到了左边，少数人坐在了右边，只有一个人还坐在中间不动。\n\n\n\n姜晓红：“那位同学，你到底认为实验课应该讲理论还是让学生做实验？”\n\n\n\n答：”我认为实验课应该做实验，但是我支持上课讲理论。“\n\n\n\n姜晓红 ：“那请您赶快坐到主席台上来。”\n\n\n\n\n\n\n\npatt上计算机系统概论课时，大批同学到现场问问题。姜晓红便问patt：“你是用什么办法让这么多人来问问题的？” 回答：“凡是来问问题的人都能够得到总评成绩的奖励。” 后来姜晓红上下午的实验课时，有许许多多的同学都去了教室上课。patt问姜晓红：“你是用什么办法让这么多人来上实验课的？” 回答：“凡是实验课有第二次验收的，每人扣分20%。”\n\n\n\n\n\n\n\n2021年的一天，patt打电话给助教A，说考虑任命他为计算机系统概论TA。助教A回答：“patt同志，我得向您报告。我有严重缺陷，我没有学过LC-3。” “这是您认为必须报告的唯一缺陷吗？” “对。” “我们的老师连计算机软件都不会用，还照样坚持工作。您不过就不会LC-3，没什么了不起。”patt说。 \n\n\n\n\n\n\n\n实验课。姜晓红发言： “今天我们有两个问题要讨论。第一，我们需要在实验课继续讲理论。第二，我们需要增加两个lab。” 观众席中传来了一个怯怯的声音： “为什么要增加两个lab？” “很好，我就知道大家对问题一没有不同意见。”
139191,1703,姜晓红,2021-07-13 07:49:25,2,5,3,请别选
139212,1703,姜晓红,2021-07-13 08:40:33,4,5,1,验收严格无参考
139518,1703,姜晓红,2021-07-17 02:00:10,-4,10,14,自助者天助。自己没有求生欲还要打口水仗的话，真不想奉陪
139703,1703,姜晓红,2021-07-20 12:12:57,5,12,7,为人和善、工作勤勉、忠于职守、甘于奉献、关爱亲人、关心同志
139758,1703,姜晓红,2021-07-26 01:25:47,-3,1,4,好的呀
139841,1703,姜晓红,2021-07-31 10:40:09,26,27,1,jxh：No one knows LC-3 better than me
140955,1703,姜晓红,2021-09-18 09:10:55,5,7,2,计概，jxh不做人了，还说分太高了，不让调，TA又把分调回去了，光是总评挂掉的就有五分之一，还不包括期末小于五十被斩杀的。
140958,1703,姜晓红,2021-09-18 09:50:13,3,4,1,不能认同她是个好老师，lz上了计租和计算机系统概论。这位老师课讲不太明白，实验是一行一行的看（因为她不懂需要我们一行一行讲）。今年计算机系统概论可能有60人不及格，感谢这位老师！！！！
140960,1703,姜晓红,2021-09-18 10:41:45,5,5,0,计概？寄guy!
140973,1703,姜晓红,2021-09-18 23:09:05,2,3,1,又被她卡绩了，迂腐古板，自己都搞不清楚还来教什么
141001,1703,姜晓红,2021-09-20 13:37:56,-11,10,21,俗话说“既想当婊子，又想立牌坊”，婊子就是妓女，妓女操持的是皮肉生意，而牌坊表彰的是贞女、烈女，二者水火不能相容。那么妓女为什么又称作“婊子”呢？
141520,1703,姜晓红,2021-10-13 05:31:54,16,16,0,lz这学期选了jxh女士的体系。\n\n怎么说呢，感觉非常折磨。\n\n1.在没有讲memory的时候pop quiz（不提前通知），考memory，说是以测代讲。lz考的还可以，但的确挺难的\n\n2.验收试验极其离谱，一小时三组，而且女士对lab1的代码很有意见（这个代码不是我们写的），她要求forward和不是forward代码执行前后结果不一样。lz十分惶恐，因为但凡懂点的人都知道，forward和其他流水线的技术，最后得出的值是一样的（指的是计算结果在memory或者寄存器里）。后来在我们的讲解下jxh女士懂得了看forwarding的信号，但她很不满意，认为我们可以设置一个信号欺骗她。\n\n3.验收只给两次机会，第一次没过扣除10%，第二次没过全扣
141538,1703,姜晓红,2021-10-13 14:20:59,7,7,0,就是别选，不要相信任何人夸她的话。简直十分折磨
142140,1703,姜晓红,2021-11-07 12:50:31,5,7,2,如果没有助教的话，快逃，千万别选。
143565,1703,姜晓红,2021-11-27 06:02:21,4,10,6,Bitch
143868,1703,姜晓红,2021-12-23 12:49:59,88,93,5,某老师去世之后，下了地狱。然而地狱的阎王惜才，想在地狱造一个CPU，这样可以减轻生死簿的负担。于是地狱的阎王给其布置了一个任务，要求一周之内造出CPU，如果造出的CPU可以使用，就特许其升入天堂。\n\n两天之后，某老师造出了CPU。阎王斥责道：我要求forword和不是forward代码执行前后结果不一样，你这个这样一样，是不是抄的？某老师辩白道：两种技术得出的结果是一样的！阎王斥责道：别管这么多，你这么说是不是可以设置个假的来骗阎王？分数扣10%！\n\n五天之后，某老师再一次造出了CPU。阎王发现其中的ALU无法运行，便愤怒的向某老师说道：你这还造ALU呢？回去重做！\n\n一天之后，某老师修复了ALU，再一次提交给阎王。阎王非常满意，并说实现了所有功能。某老师问：那我可以去天堂了吗？\n\n阎王回答：你第二次验收没过，去天堂的机会早就没有了，还想去天堂？
143928,1703,姜晓红,2021-12-13 07:54:53,3,7,4,傻逼！
143993,1703,姜晓红,2021-12-15 08:57:03,0,3,3,头一次见到有老师反向捞人，把学生往水里。\n\n每个学校总有混日子的老师，我相信姜老师一定不会是其中之一
144590,1703,姜晓红,2021-12-22 13:01:32,2,5,3,垃圾，1分
144720,1703,姜晓红,2021-12-23 10:21:43,5,7,2,迂腐死板。千万别选jxh的计算机体系结构！！！！！！！！！！！！！！！！！
146932,1703,姜晓红,2022-01-08 05:50:05,22,23,1,他妈有病吧，考试之后批平时作业并且大扣特扣
146935,1703,姜晓红,2022-01-08 06:05:59,26,26,0,集美们，开扣！
146966,1703,姜晓红,2022-01-08 08:12:45,3,3,0,绷不住了
147269,1703,姜晓红,2022-01-09 10:41:22,4,4,0,我只能给CA这门课打上一个大大的问号？
147420,1703,姜晓红,2022-01-10 03:07:55,5,5,0,体系慎选，这学期没有助教，实验验收和作业都是姜老师亲自负责。验收极为严格，不完全搞懂实验就会被扣分。因为是教改的第一年，每个实验第一组验收的同学要把实验给她完全讲清楚，有一次我给她讲了一个多小时。她对于课程组给的实验框架还不是很满意，觉得太容易了（实际上已经很难了(#`O′)，她还经常提一些很苛刻的要求），和她沟通很困难，实验课有的时候半个班的同学和她辩论都给她讲不明白。作业小测严格扣分，不做bonus平时分会很惨。总之离离原上谱了属于是，慎选慎选！能力足够也要比其他班多花很多时间，还拿不到别的班的分数！
147508,1703,姜晓红,2022-01-10 06:14:22,5,7,2,"体系课姜老师班上期末试卷一片90+，就知道她""押""题有一手；猜测期末高了，要搞班上同学的平时分了，苦了同学们，被恶心实验还要被恶心分数。   --来自计组实验被恶心的怨念"
148031,1703,姜晓红,2022-01-11 11:14:36,7,8,1,体系老师中最负责的，理论课讲得非常清楚。体系课的正确打开方式是，选别的老师的课，听女士的理论课。女士的实验课，快逃！
148646,1703,姜晓红,2022-01-16 15:39:12,-3,3,6,[计算机体系结构]很负责， 讲课也不错， 给分最后也是很好的， 不过验收的确花的时间比较长， 每次验收之前都要花很长时间等， 主要还是没有助教的原因， 如果下学期有靠谱的助教估计会好很多. 验收的压力也比较大， 如果哪里没搞清楚就会扣验收分数(不过就算扣分其实对于总评的影响也很小很小， 主要是精神上的压力)， 不过这也迫使你在验收之前搞明白实验的每个细节， 其实对于理论的学习也有帮助. 不过验收其实也没有那么可怕， 如果她觉得你懂这个实验其实就不会为难你， 很快就会结束， 如果老师发现同学不懂， 那么会事无巨细地把同学讲懂， 可以说是非常负责了. 总之， 对于jxh来说， 验收实际上是她授课的一部分， 推荐想学到真东西的同学来选. 至于给分， 如果你真的把实验做会了， 把理论学懂了， 最后的成绩肯定不会令你失望
149632,1703,姜晓红,2022-01-16 08:42:02,7,8,1,体系真的要慎重考虑，如果老师有助教的话，任务量会小很多。但是这个学期老师没有助教，所以女士在所有实验下发的时候都是对实验效果一无所知的状态，然后她会根据同学实现的结果来更改实验的要求。有的时候在实验室里头改代码、等验收，平均一组实验能验收40min~1h，9、10两节的实验课能上到晚上8点。女士对于上课内容还是走心的，教的比较多，也非常有调理。但是她验收的效率真的导致实验课成为这个学期一个不小的消耗。\n\n女士自己有的时候也过意不去，她也很想教会学生东西，但是她的方法还是有待改进。
150694,1703,姜晓红,2022-02-13 11:46:42,2,2,0,呵呵……
151185,1703,姜晓红,2022-02-24 05:50:32,13,15,2,sb一样把您的课讲好再来提一堆要求吧，你以为自己是谁啊
151683,1703,姜晓红,2022-03-11 15:09:00,-2,2,4,讲课蛮好的
151684,1703,姜晓红,2022-03-11 15:09:32,-4,1,5,讲课水平如何可以参考智云课堂，jxh虽然要求严格，但不至于那么低
154704,1703,姜晓红,2022-06-03 18:42:25,9,9,0,扣！开扣！
155134,1703,姜晓红,2022-06-08 15:16:15,41,41,0,翁恺表明该如何上好课程 ；\n\n姜晓红表明该如何不上好课程 ；\n\n杨莹春试图表明谁都能上好课程 ；\n\n楼sir正在表明课程是根本不需要上好的 。
155401,1703,姜晓红,2022-06-12 07:49:43,-1,4,5,姜女士的计组，单周期CPU， Pipeline CPU和Cache这几部分重点章节都是讲得很有条理的。个人感觉上课水平没有评论说得差。前期二补码花了好几节课讲是真的受罪。老师过分认真，还是很关心学生的，只是大部分同学无法接受老师的较真方式。2022春夏学期计组有助教帮忙验收，体验就还不错。
156992,1703,姜晓红,2022-06-21 13:18:51,3,5,2,助教不负责。\n\n提问课堂问题经常答不上，对课程进度好像一点也不知道的样子。\n\n实验验收标准不清晰，要学生做什么做了还不够，还得学生自己证明自己做了和证明自己做的是对的。实验内容自己不会就让学生帮他验收，那还要助教何用。\n\n作业和实验报告的批改忽严忽松，捉摸不透，冷不丁就扣个几分。
157056,1703,姜晓红,2022-06-21 18:38:13,4,4,0,上了计组。真的煎熬，快逃！
157742,1703,姜晓红,2022-06-24 15:06:18,5,8,3,上课根本讲不明白，整个计组理论和实验部分的授课和评分系统都一塌糊涂，自己也算不清楚，还出来教学生？只能说快逃。
157877,1703,姜晓红,2022-06-25 09:38:43,5,6,1,只能说一句，快逃
158378,1703,姜晓红,2022-06-29 00:56:02,0,1,1,不知道怎么评价QAQ，好像也没有评论说的那么差，雷点也有一些，一般般吧
158417,1703,姜晓红,2022-06-29 05:48:46,-5,3,8,没有评论说得那么差，老师挺好的，给分也很好。
158495,1703,姜晓红,2022-06-29 18:33:59,-1,1,2,讲课还可以的，平时分也基本都给了，最后成绩比较正常\n\n据说今年隔壁分数炸了，这样想其实还不错
158657,1703,姜晓红,2022-07-01 04:28:39,-17,1,18,今年上了姜妈妈的计组，感觉还行呀，实验要求不是特别严格，老师上课也非常认真负责，下学期继续上姜妈妈的体系！
159307,1703,姜晓红,2022-07-12 01:23:24,29,30,1,求你别妨碍patt了\n\n老爷子上课够累了，还得应付你这个sb，想想都。。。
159308,1703,姜晓红,2022-07-12 01:38:27,9,9,0,和patt沟通的好困难，感觉做不到尊重patt，可能是英语水平的问题，xs
159309,1703,姜晓红,2022-07-12 02:38:26,8,9,1,计概搅屎棍
159361,1703,姜晓红,2022-07-15 12:48:19,14,14,0,建议练一练英文再与patt教授合作。。上课听她和patt交流尬的能抠出3室一厅，，，如果我是patt我绝对忍受不了。。
159362,1703,姜晓红,2022-07-14 14:07:22,11,13,2,Professor Jiang确实是patt教授的好帮手，她非常的负责任，就是英语口语似乎还有很大的进步空间，导致其与patt教授进行良好的沟通似乎不是特别顺畅，，实在是可惜，不然patt教授和同学们的上课体验还会更加的good
159397,1703,姜晓红,2022-07-16 02:10:02,0,1,1,想念wjj的每一天。。。
159478,1703,姜晓红,2022-07-24 10:31:25,58,58,0,I'm ...(Jiang's voice)..I'm sorry? Professor Jiang? I don't understand . Are you still there?\n\nJiang :S..so， ac...actually，I just have gived myself a break...
160448,1703,姜晓红,2022-09-23 01:12:22,2,5,3,94.5算94是吧？
160500,1703,姜晓红,2022-09-25 01:09:23,8,9,1,成绩公示好几天，登分数前临时改分数占比？？？？
160501,1703,姜晓红,2022-09-25 00:56:24,3,3,0,姐妹们，开调！！！
160502,1703,姜晓红,2022-09-25 01:38:50,5,5,0,sb，重新定义“最终”成绩，咋不去定义定义你🐴 呢
160590,1703,姜晓红,2022-09-27 13:29:19,-41,5,46,计概是一门好课，但平时分给的是真的差，很大一部分来自作业的正确率。平时作业认真写的还没直接抄答案得的分高。期末卷面成绩92，结果最后都没满绩就离谱
170296,1703,姜晓红,2023-03-02 13:57:14,3,4,1,在我上了另一门国际化课程之后，才知道professor jiang是多么的优秀
174680,1703,姜晓红,2023-06-15 13:06:52,1,1,0,评价是寄
175726,1703,姜晓红,2023-06-26 10:19:33,3,3,0,太不求是
177482,1703,姜晓红,2023-07-03 11:38:23,-15,1,16,女士好可怜，给她个十分好了
177568,1703,姜晓红,2023-07-03 18:04:14,0,2,2,计组 女士的课有一点让我感觉很好，就是实验在理论后面，做实验之前她会先讲完理论，实验会好很多。差评太多主要是实验问题，如果有一个好的助教，那么体验就会很好。总之感觉这门课是大二下课程设计最好的一门课了
178487,1703,姜晓红,2023-07-12 11:25:45,7,7,0,求您不要在计概课上打断Patt了！真的很尴尬。
178563,1703,姜晓红,2023-07-14 14:07:55,3,3,0,练练口语吧。
178680,1703,姜晓红,2023-07-17 06:17:12,16,16,0,我会很好奇你和patt的合作真的顺利吗
178681,1703,姜晓红,2023-07-17 07:47:57,4,4,0,dsb
178729,1703,姜晓红,2023-07-20 12:24:45,6,6,0,jxh:我不做人啦！Patt!\n\nPatt:计概？怎么会……\n\njxh:同学，就用你的绩点，wryyyyyyyyyyyy!
178857,1703,姜晓红,2023-07-26 05:36:48,10,10,0,全班热烈鼓掌，姜举着手机傻笑\n\nP:?\n\nJ:(拍了拍patt的肩）来拍个照\n\nP:What???\n\nJ:Emm， I mean … take a photo …
180521,1703,姜晓红,2023-09-22 09:02:54,9,10,1,纯纯傻逼，出这狗题，吃屎去吧
180552,1703,姜晓红,2023-09-22 15:46:14,5,5,0,非常好老师，爱来自学生
184247,1703,姜晓红,2023-12-14 02:35:25,34,36,2,兰浩轩傻逼
185499,1703,姜晓红,2023-12-31 11:19:09,8,12,4,下头恶心狗篮子，晚上你家里人出门必定嘎嘣死，我嘴巴开过光，恶心玩意，早点死了清净。
185892,1703,姜晓红,2024-01-05 13:51:44,4,6,2,在复习，来评价几句\n\n真的PPT写的和狗屎一样\n\n真的不知道jxh这13哪来的自信
187472,1703,姜晓红,2024-01-16 10:07:30,5,6,1,所有体系结构教学班里任务量最大最牛马的，今年助教也是逆天，仿真要求在pta上过，每个周期都完全一致才能验收，告诉你哪个周期错了但不告诉你哪个信号有问题，没有参考仿真波形，靠自己去猜，一个实验可以调好几天，美名其曰给同学减轻debug的压力，我呸，这波纯纯上压力。一个实验别的班可能就填填空，不超过20行代码，但是在jxh班你要宠幸设计整个控制器，还要严格符合助教的心意。在其他班没有作业，在jxh班你可以做到推荐时长8h以上完成的作业，并且占大额平时分。做实验时刻感到破防，人就是不患寡而患不均的，要是当初勇敢一点退预置选其他老师的课也不会那么难受。整个本科阶段，我选课自认倒霉的有两位，一位是cy一位是jxh
192073,1703,姜晓红,2024-05-08 17:04:53,9,10,1,讲得还是可以的。而且这学期竺院课有了钟梓航这一位非常 nice 的助教，可以说感受比以前好得多。
192477,1703,姜晓红,2024-05-21 11:56:24,4,5,1,369快进来学拉扯
194588,1703,姜晓红,2024-06-24 13:14:32,2,3,1,难道真是助教的问题吗？这学期计组上完感觉体验还行（？）最后给分也不错，总评各部分都有公示，挺清晰的。\n\n最后还是感谢助教zzhgg吧
195001,1703,姜晓红,2024-06-26 08:01:54,1,2,1,这学期计组助教gg非常好！课程整体验感都很好的。甚至最后老师好像还在拼命捞人
195874,1703,姜晓红,2024-06-30 13:29:37,1,2,1,计算机组成与设计。这学期的助教 zzhgg 很认真负责，验收也很人性化，不会像女士一言不合就扣 10%，实验这块体验很好。女士本人讲理论也是比较清晰的，上课体验也过得去。不过女士偶尔会在上课时环视一周抽人回答问题，还是有些尴尬。但是上课回答问题/点名什么的并不占分数就是了。
205503,1703,姜晓红,2025-01-02 03:11:36,10,11,1,计算机体系结构\n\n\n\n考完试回来补充：jxh我的神，其它有的班没怎么讲的东西她都详细讲了，最后还考了好几题，逆天，不愧是课题组组长\n\n\n\n姜女士似乎没听说的那么离谱，单论这门课的话，只给她5分确实低了，除了偶尔上课前来一次非常简单基础的小测、给我们多上了一节课之外也没啥离谱操作，上课讲的也还行，应该在计院平均水平之上，当然也称不上非常好，但是确实是有热情的，课间也能看出在努力关心同学（向同学问各种生活问题），单论点感觉这位老师还是可以的\n\n\n\n说实话CS几门专业课课程体验好不好大多是看助教给不给力，各门课老师上课水平大差不差，与助教的交流远多于老师\n\n\n\n看到了下面的评论，补充一下，我上的2024~2025秋冬学期的姜女士的计算机体系结构，实验现在都是很简单的填空题，线上仿真网站会显示正确波形，会直接告诉你哪错了，已经没有像下面同学那样那么难受了，而且今年的助教对实验框架进行了很多改进和优化，实验做起来舒服多了，我和同学交流后发现其它有些班的难度更大。\n\n\n\n当然这是我个人的体验，欢迎其他同学补充指正。
210022,1703,姜晓红,2025-01-08 02:30:49,1,1,0,出分回来感恩一下
210034,1703,姜晓红,2025-01-08 04:49:17,2,2,0,这学期体系两个助教哥哥都拉满了，至少从学在浙大上的那个成绩组成来看，平时分应该是给满分了。（前提是按时完成作业，小测什么的扣一点分数可以用bonus补回来，4-way cache的bonus应该是最容易做的，我也就做了这一个）\n\n不过遗憾的是我一学期没听过课，只有实验相关的知识是看知乎上南大的那个专栏学的，因为作业也只有四份，前两份是计组学的，第三份是和实验做的内容高度相关的，第四份还没截止的时候助教gg就发答案了，所以这学期没听课也都能完成这些任务。但是还是建议从第四章DLP开始听一下课，因为后面的东西网上资料比较难找，而且其他班老师不一定讲，但是很可能是要考的。最后的一节课老师也会讲一下重点，要听一下，比如这学期这节课上明确讲了要考convoy和chimes，但是其他班其实都没讲过。\n\n再次感谢jyz和hhy助教哥哥们，我们班的作业也都是助教gg们自己收集和编写的，都是面向考试要考的内容，而不是照搬那个书上的\n\n---------------------------------\n\n更新放一下数据，全班四十人左右，平时分满分17人，总评90分以上24人。
210094,1703,姜晓红,2025-01-08 06:37:57,3,3,0,上课讲的其实不错，二倍速也能听清，上课有三四次相当于点名的小测，并且实验验收也是比较好的，可以线上仿真显示波形及错误（虽然我大部分是时间都是直接用vivado仿真debug）。然后老师讲的内容确实比较全面，但也不是完全楼下说的部分内容别的班没讲，比如 chimes，其实每个班都讲了，但是有一两个班的名词/称谓不同，但是姜老师是按照书本内容讲得因而比较规整（同时也有 HW 出了这些题目的原因）。可以说 HW 完全理解了考试大题基本没问题，选择把 ppt 看一遍或者智云听一遍也就 ok 了的。
210164,1703,姜晓红,2025-01-08 09:19:37,1,1,0,2024-2025秋冬学期修了老师的计算机组成与设计课程。老师讲课还是可以的，可以听明白（虽然我不怎么听），态度也是认真负责的，授课这方面我认为可以打到9.5分。\n\n至于实验验收，这学期由于全程是助教zjd学长负责，所以二次验收扣分只存在于名义上，实验文档十分详尽，验收简单，体验很好。\n\n给分也是十分给力，平时成绩拉满，最后的cache bonus最高可以做到平时总评+4，期中考设置了10分还是20分的bonus，整体分数都很好。\n\n唯一伤心的点是pop quiz，前一节没听后一节寄。（不过这个主要还是自己没学好，平时跟不上进度的同学请谨慎。）但最后pop quiz感觉也没有扣多少分，bonus够填了。
210609,1703,姜晓红,2025-01-09 12:22:16,-7,1,8,你是想用透题的方式来骗取高风评吗？不好意思我给你 1 分
211287,1703,姜晓红,2025-01-11 06:34:45,4,5,1,不知道lx说的是哪门课，但体系结构并没有透题，都是按顺序平时讲课有讲到的罢了，考前给了个mesi的图也是因为她发现课上讲错了，而且对考试没有任何帮助。。。而且这学期体系结构jxh班的体验确实很舒服，助教给力且拼命捞人，实验简单，期末前开答疑课，至少教课是认真负责的，何谈通过偷题换风评，让我们求是一点
212790,1703,姜晓红,2025-01-15 02:25:53,2,2,0,24秋冬计组设，总体来说体验很好。姜老师大部分内容都讲得很清晰，课下的答疑也很耐心，实验验收基本由助教负责，而且仔细阅读实验文档并自行认真完成仿真和上板之后基本都能一遍过，我只有中断异常处理第一次没过，似乎也没有扣分。但同时也是有一些体验不好的地方：首先是讲课时是按PPT一页一页过的，有时会出现老师对着一页PPT反应（or 回忆）了一会儿才知道要讲什么，授课逻辑似乎不是很连贯；其次是老师似乎很喜欢（或者是为了赶上教学进度不得不）连堂和拖堂，有一次拖到了12:40左右，即使如此进度依旧慢于隔壁班。总而言之并不需要避雷，如果计组预置的是姜老师也不一定非要换（个人感觉姜老师评分低大概是由于前些年的实验验收和计概）。
214920,1703,姜晓红,2025-02-19 05:58:22,0,0,0,计组 老师人蛮好 给分挺捞的 上课没太听过（老师对不起） 点名几率不高但是由于班上人很少所以还是每次都到课了
5799,1705,王新宇,2015-07-09 11:56:08,0,1,1,好无聊。。时不时来个quiz
13281,1705,王新宇,2015-12-26 07:12:56,2,2,0,产学研结合 实践出真知。
27306,1705,王新宇,2016-06-24 14:57:05,-2,0,2,给分不错，但是后排考试的时候都在看ppt也是醉了
30861,1705,王新宇,2016-07-02 16:36:35,4,5,1,两天速成国际证券市场导论是一种怎样的体验？
57021,1705,王新宇,2017-07-05 07:45:04,0,0,0,还不错
81821,1705,王新宇,2018-07-06 09:03:37,2,2,0,老师讲的一般般 本身对这些东西也不感兴趣（居然是必修课 考试上课听了基本就没问题 反正出的题目全是上课讲的... 然后最后莫名其妙可以用手机是个什么操作
101227,1705,王新宇,2019-01-28 02:25:02,2,2,0,给分不错，不枉我整个秋学期周四晚上蹬自行车到玉泉上课{{{(+へ+)}}好冷啊
108917,1705,王新宇,2019-06-04 07:08:26,12,12,0,软工基无所谓，流立方才是重点，考试必考流立方相关知识点。
109734,1705,王新宇,2019-06-19 02:57:59,18,19,1,教会了大家25个人是如何做出一摊垃圾的
113533,1705,王新宇,2019-07-06 23:37:16,5,6,1,软工基给分还行..当然因为助教好
122068,1705,王新宇,2020-02-10 21:34:40,1,1,0,老师英语不错，不过发音有点东北味
124277,1705,王新宇,2020-06-28 11:10:26,-5,1,6,今年证券导论改成了线上开卷考试，考试题目都来自PPT，导致成绩都比较高，我怀疑大家基本都满了
131807,1705,王新宇,2021-01-29 04:07:56,2,2,0,借楼评国际证券市场导论：大水课，平时不用听最后有一个考试，考的全是PPT上的原题和一些概念对比题，给分超级好
136937,1705,王新宇,2021-06-28 10:58:05,6,6,0,软工基课程上完了，特来评价。老师人超好，班上两个大组的web、应用系统写的跟shit一样，老师让我们在考试周结束后再展示一次，重新打分。助教小哥哥人也比较好。至于这门课，确实sb，但是不是老师的错（这门课最sb的地方在于不教web应用怎么开发，但是大作业是写一个很大的web应用系统；而教web应用开发的课程是B/S，是下个学期的推荐课程，真是吃了屎了）。只能说，软工学子命途多舛吧。
138770,1705,王新宇,2021-07-10 17:56:24,3,3,0,纯nt
155161,1705,王新宇,2022-06-09 03:03:26,1,1,0,有点傻逼
155162,1705,王新宇,2022-06-09 03:03:37,0,0,0,纳老师差不多得了
155315,1705,王新宇,2022-06-10 16:21:52,3,3,0,老师其实还行，软工基这课是真的**
157527,1705,王新宇,2022-06-23 15:04:49,-5,0,5,给分意外的不错，好评
158594,1705,王新宇,2022-06-30 12:44:58,5,5,0,避雷外汇交易系统，避雷外汇交易系统！！！给分极烂，而且一开始不明说分数构成，且分数构成极其离谱，一次小作业居然占了总评的40分，还很多主观题，做不好随随便便扣了20分（总评20分），也不知道老师改主观题的标准是什么；\n\n老师课上公然鼓励内卷，不停地说很多人报名展示来催促大家报名额外展示，同时多次鼓励写两篇论文（事实证明收益极低）；\n\n一开始说好的展示是额外加分，但最后分数出来，没有参加展示的人，就算上课认真做了题目、认真互动，互动分也只拿了1分（满分5分）；\n\n论文只写一篇的人，论文模块基本没有上80分的，写两篇论文模块也才堪堪接近满分，性价比极低；\n\n身边还有正常走完流程，没有卷展示和两篇论文，小作业做得一般，结果拿到1.5，实在是搞人心态。\n\n总之，这门课的老师是外聘老师，借口不清楚学校的分数转换机制，把全班很多人的分都压得很低，称之为“标准严格”，那我确实也没话说了。
158610,1705,王新宇,2022-06-30 16:09:41,3,3,0,今年的外汇交易系统不是水课了，突然把评分标准变得极其严格，基本上是刷新了大部分选课同学的最低绩点纪录。在意绩点的同学千万不要选，可以去选隔壁债券交易系统。除非实在缺学分而且不在意绩点的可以选，因为这课也不挂人。\n\n\n\n好吧，我就是另一条评论里那个拿1.5的，GPA差点被这课创死，人也差点被这课气死了，我以前学得最差、老师给分最不好的课都比这课高多了。\n\n\n\n这课真是刷新了给分“严格”的下限，总之就是极其离谱……这课一上来也不公布分数的组成比例，最后出了分才发现，所谓的平时分占比极少，一个长得像小作业练习题（几乎全是主观题）的东西竟然占40%。老师会想方设法给你扣分，大家的“小作业”动不动就往20分以上扣，反正理由就是你没做对，但是也不公布一题几分、对错的标准是什么。老师不书面通知重要的上机作业的ddl，导致课程冲突的同学错过该作业。顺便说，今年的上机平台换成了一个网站，以怕被美国盯上为由（该理由来自wxy事后解释）只给开放一天……这么担惊受怕为什么不继续用以前的平台呢……论文也一样，即使你投入了不少时间精力，最高也就80吧，而且写两篇的同学这部分竟然还没满，理由还是“总之老师找到了某某扣分点”。\n\n\n\n和扣分相比，这课所谓的bonus那点加分就很微不足道了，做个pre最多加5分，但是做了的同学实际得到的加分都不足5分。然后不做pre的反而在课堂互动里的分数大力扣分，这算哪门子bonus，敢情上课其他的做题和发言互动都被吃了……老师鼓励内卷就更别提了，上课的时候一上来先说“没必要卷”，然后在讲废话的时候就暗搓搓地开始讲自己本科时课程论文别人写一篇他写两篇的故事……一个大无语。\n\n\n\n说真的，最求是最硬核的课程都没外汇给分这么“严格”，反正这课都是外聘老师，他们不会在意你的前途……建议大家以后都别选外汇，直接让这课停开吧……软工同一模块给分好而且能真正学到东西的课也不是没有。
176563,1705,王新宇,2023-06-29 09:07:29,1,1,0,借楼评价外汇交易系统\n\n省流：今年有很大的改观，值得一选\n\n今年在选的时候看到前面的两条评论很害怕，最后由于各种原因还是选了，抱着拿低分能过就行的心态，没想到最后拿到了很不错的分数，而且整体上课过程也很不错。\n\n1.关于上课，虽然显示半学期周内一周三节课，但实际周六上课，而且加起来只需要两天半，很省时间。不过有一说一，每次课需要点名，不点名平时分会有影响但其实也不大。几位老师上课都不算无聊，但是其实不听也可以。特别的是这学期邬老师，还请每一位同学和奈雪的茶，自己点那种，很壕气。\n\n2.关于作业，两个主要作业：\n\n一个外汇习题，计算题老师会在课上讲，问答题我也拿不准，但是事实证明基本没扣分，不存在前面说的一个平时作业扣总评20分的情况。（去年出现那种情况邬老师课上也解释，由于去年新老师打分很严，而且同学们对作业不认真，所以有的分数很难看，今年老师换回来了，而且平时作业分数邬老师说后面也保证会调整，保证不会出现离谱的低分数）\n\n另一个是课程论文，二选一，虽然老师说过鼓励可以写两篇，不过只说过一次，还是半开玩笑，但是事实证明我们没有同学卷两篇，但是给分都不错。\n\n另外就是展示，老师确实很鼓励展示，会多次希望同学们报名，但是实际上内容不限，老师更希望给我们一个展示的机会，在课上他也解释原因，提供机会以后有用什么的，这里不多赘述。\n\n3.这个课程特别的一点是老师的课时费全部用于课程奖励，几位老师都是公益上课，最后成绩优秀的同学可以获得价值不菲的奖品，有意的同学可以努力一下，无所谓的同学不用管，没有也不会影响成绩。\n\n总之，今年上课体验和分数都很不错，我们这次只有20个同学左右上，希望后面的同学可以选起来，确实是不错的课，任务适中，老师友善，给分不错，上下来真的一个槽点都没有，花这么多时间希望大家可以看到，而不是被前面两篇吓到。
176913,1705,王新宇,2023-06-30 16:11:27,10,11,1,sb老师，sb软工基，事多的要死分也是低的要死
177130,1705,王新宇,2023-07-02 00:55:36,4,5,1,软工基改了，没有期末考试了，好；但是没了考试之后平时分和项目分极其无敌之差，很恶心，大家千辛万苦赶一个能跑的网页出来还挑三拣四，对同学抱有不切实际的期待。
467,1763,肖俊,2015-03-15 02:51:54,5,10,5,上课条例很清晰，声音也很好听，人很洒脱
35828,1763,肖俊,2016-11-29 11:43:56,17,21,4,我爱肖俊！男神使我快乐！(•̀ω•́)✧
36594,1763,肖俊,2016-11-15 04:13:28,9,13,4,颜值高，人好，给分好(*ˉ︶ˉ*)
37551,1763,肖俊,2016-11-19 10:58:04,1,3,2,男神 耐心 好老师
62202,1763,肖俊,2017-11-23 06:18:27,0,1,1,肖老师讲课很有趣。能学到东西。
63068,1763,肖俊,2017-11-28 06:23:01,4,6,2,给分超级好啊！
63689,1763,肖俊,2017-12-13 00:35:01,0,2,2,给分真的不要太好！人也很可爱！
65056,1763,肖俊,2017-12-28 11:45:35,0,0,0,老师上课挺好的，给分也高
68013,1763,肖俊,2018-01-22 13:17:26,0,1,1,老师特别帅，助教也可爱
68014,1763,肖俊,2018-01-22 13:17:41,0,1,1,妙啊！面瘫搞笑型的帅哥，给分也超好，媒体信号处理满啦
75621,1763,肖俊,2018-03-14 06:26:50,2,4,2,在学校里课堂体验最好的老师之一，专业课方向来说应该可以去掉这个之一。四个字形容他讲的课：深入浅出。
86542,1763,肖俊,2018-09-17 06:13:09,2,5,3,上了老师的matlab小学期。相比其他小学期课作业不算太难，老师课上得很好，清晰易懂。大作业可易可难可恶竞，给分不错，助教超级棒！不过老师第一次开小学期的课比较乖。。其他班都结课了我们还在上hhh
86625,1763,肖俊,2018-09-17 13:28:08,6,9,3,我爱肖俊老师！！！老师真的很好，很亲切，还会在微信群聊天发表情包，让我们看世界杯23333助教小哥哥也特别好，超级耐心，长的也很帅（大声），给分也很好，学的内容不难，作业不难，project也还好，用心做就好。对小学期特别特别特别满意！最后再来一遍，我爱肖俊老师和助教小哥哥！（破音）
91449,1763,肖俊,2018-12-10 13:02:36,1,4,3,讲课深入浅出，期末简单，给分好，中国好老师
91451,1763,肖俊,2018-12-10 14:36:09,2,5,3,超喜欢肖俊老师，讲课幽默风趣，课程结束学到了很多，是我媒体信号的启蒙老师hhh
91454,1763,肖俊,2018-12-10 15:15:55,3,5,2,老师太好了！！讲得清楚给分公正
91455,1763,肖俊,2018-12-10 15:16:58,1,3,2,肖俊老师真男神！！！！！！声音很有磁性，讲的很用心！好好听课会有收获滴！
91456,1763,肖俊,2018-12-10 17:21:21,1,3,2,感谢男神给辽满绩！
91463,1763,肖俊,2018-12-11 02:39:38,0,1,1,讲课又好给分又好人又帅还会发红包 我吹爆
91479,1763,肖俊,2018-12-11 08:09:42,0,1,1,老师上课清晰明白有条理，听课容易接受新知识，非常喜欢这样的课。最后几节课可以看到神奇的同学们神奇的project。赞。
93633,1763,肖俊,2019-01-11 04:04:15,2,5,3,肖俊老师为什么只有9.3？？我不服！上大学以来最好的老师没有之一，给943782184645700000分我也愿意！
98701,1763,肖俊,2019-01-23 23:46:59,0,1,1,肖老板nb\n\n
99091,1763,肖俊,2019-01-24 08:53:22,0,0,0,必须10分！大好人！课好人好！
109229,1763,肖俊,2019-06-12 05:38:15,0,0,0,希望选上您的课
114749,1763,肖俊,2019-07-11 09:26:23,0,1,1,很舒服啊啊啊啊
116107,1763,肖俊,2019-09-05 07:10:15,0,1,1,这小学期不仅能学到东西 还.....这分也emmm 不敢相信 我也以为登错分了甚至
116156,1763,肖俊,2019-09-05 00:57:43,0,3,3,上的MATLAB小学期，上课确实都是干货，授课方式也让人很愉快。今天出成绩了，嗯？给分好到我甚至怀疑分登错了
116158,1763,肖俊,2019-09-05 02:31:57,1,3,2,男神！上的MATLAB小学期，内容充实，给分巨好！
116160,1763,肖俊,2019-09-05 02:54:18,2,4,2,太爱了男神！很随性，给分太太太太好了！
116175,1763,肖俊,2019-09-05 13:50:32,0,2,2,出分了跑过来给老师一个十分！小学期内容特别充实，老师人也很可爱，大家在群里讨论问题气氛也很好wwww还有给分真的特别好！选就完事了（大雾）
116178,1763,肖俊,2019-09-05 13:58:23,3,5,2,呜呜呜肖俊老师也太棒了，妥妥的男神，风趣幽默，成熟稳重，生病了还给我们上课，群里经常发红包开玩笑，给分也特别好！！！我爱了(⑉°з°)-♡
116195,1763,肖俊,2019-09-06 02:56:46,0,3,3,老师真的超好！超有钱！人超好！给分也好！
116208,1763,肖俊,2019-09-06 08:20:16,0,1,1,男神不仅课上的深入浅出 分还给的好 好到满绩那种
116267,1763,肖俊,2019-09-07 02:13:40,0,0,0,内容充实，给分好，经常在群里和同学们互动，给分太好了！！我哭了\n\n
117008,1763,肖俊,2019-09-18 07:08:50,0,0,0,好老师！
117281,1763,肖俊,2019-09-22 07:33:58,0,0,0,舒服呀
120471,1763,肖俊,2019-12-09 05:15:55,0,0,0,老师真的是男神啊啊啊啊啊啊啊啊啊啊啊！
121421,1763,肖俊,2019-12-16 08:10:08,0,1,1,真正的男神老师！老师本人幽默风趣，会在群里和大家开玩笑；讲课深入浅出、条理清晰，知识点无论难易经过老师讲解后都能被理解透彻。作业量适中，期末的大project虽然比较辛苦但真的收获良多，期末考试丝毫没有为难学生，这门课真的是享受。树莓没了后信号处理基础好像也没了，真的可惜了
128724,1763,肖俊,2020-12-25 05:49:44,3,6,3,cs短学期强推肖老师的matlab好吧！十个左右的小程序，两个pr，跟着老师的思路很容易解决。最后，给分巨好！！！
134535,1763,肖俊,2021-03-31 15:12:35,0,2,2,暑学期matlab图像处理强推，认真去学能获得很多有用有趣的知识\n\n每节课都有小作业，另外有2次project，没有考试，上午理论下午实验\n\n因为课程安排比较紧，压力也会大一点\n\n作业和porject有一些挑战性，需要课后花点时间思考，不过建立在认真听课的基础上，也算不上很难\n\n不建议摸鱼or翘课，就当暑假结束提前适应新学期了（\n\n助教xgg也很nice，解答很耐心，以启发你的思路为主\n\n给分很好（毕竟不用正态，往高了拉罢
134699,1763,肖俊,2021-04-10 07:57:54,-2,0,2,阿哲啊v
139517,1763,肖俊,2021-07-17 01:51:57,0,0,0,老师nice
152452,1763,肖俊,2022-04-12 01:31:09,2,2,0,不是很懂展示的给分标准
159116,1763,肖俊,2022-07-06 12:31:17,0,0,0,老师很好
159802,1763,肖俊,2022-09-01 04:09:09,2,5,3,老师很好，很有启发，给分巨好
159804,1763,肖俊,2022-09-01 04:47:57,0,0,0,顶级老师，顶级助教，matlab短学期轻松快乐，老师不仅脾气好事情少还很幽默，助教也特别有耐心给回答问题，只要不是问代码让人家debug都给解答了
159806,1763,肖俊,2022-09-01 04:51:12,0,0,0,短学期matlab\n\n老师给分巨好
159807,1763,肖俊,2022-09-01 06:04:29,0,0,0,助教哥哥，爱死你了
159815,1763,肖俊,2022-09-02 13:08:54,0,2,2,给分是真的好，10分好评！
174195,1763,肖俊,2023-06-07 08:11:53,2,3,1,妈呀老师你给分要不要这么好！他真的，我哭死
174197,1763,肖俊,2023-06-07 08:38:40,0,0,0,讲课实在且不枯燥，上完课程内容还会给大家拓展地讲一些热门新技术，是真的想让大家成为合格的计算机学子。考核和给分也都很好，只要你每节课都去且听了个大概，大程尽力做了，分数就不会差。\n\n强力推荐计算机学院的学生选课，也很推荐外专业的同学来选多媒体技术来当跨专业。
179302,1763,肖俊,2023-09-08 11:28:48,0,0,0,matlab短学期非常棒，几个项目都很有趣，有动力去做，最后满了！爱了爱了！
180739,1763,肖俊,2023-09-25 13:20:37,0,1,1,好老师！人也好，讲得好，给分好，课程安排也合理，难度适中（指MATLAB），满分！
181667,1763,肖俊,2023-10-27 05:44:36,0,0,0,超有趣！今天有听肖男神的讲座！！
191376,1763,肖俊,2024-04-19 01:58:40,-2,0,2,讲课非常清晰，是计院少有的能讲清楚课的老师。\n\n非常好！！！
192060,1763,肖俊,2024-05-08 11:03:29,2,2,0,多媒体技术：\n\n有大概8次小测，基本在快下课的时候（做不出来可以看往年智云），占 20 分\n\n大程DDL在考试后一周\n\n大程有展示 10 分\n\n考试题目合理推测，每年都一样连数字估计都不改\n\n4.22考完的，现在（5.8）还没有出分\n\n希望给分好一点
192693,1763,肖俊,2024-05-28 10:54:59,3,3,0,多媒体4.21考完 5.24出分 群里有“谢谢老师”
198240,1763,肖俊,2024-09-05 17:05:57,0,0,0,很会体谅学生的一位老师 问问题会很耐心解答 短学期matlab事情不多 认真完成就能拿高分 强推！
198288,1763,肖俊,2024-09-06 06:38:52,0,0,0,课程综合实践 给分很好，肝一肝会有不错的成果，课程内容比较简单有趣（主要是讲matlab的基础应用和图像处理），很值得上
198513,1763,肖俊,2024-09-09 11:09:13,0,0,0,老师和助教人都很好，给分超级捞
211332,1763,肖俊,2025-01-11 08:13:18,0,0,0,好老师，特别好老师，很帅
212131,1763,肖俊,2025-01-13 08:34:54,1,1,0,短学期的matlab非常棒，给分真的不是一般的好，这个学期考试周结束了，补一个评论
219019,1763,肖俊,2025-05-19 05:26:30,3,3,0,多媒体技术的爹 给分好事情少无需多言 赞美xj！！！\n\n可以根据往年智云预测小测时间和题目 考前看一遍资料就够了
219298,1763,肖俊,2025-05-24 10:24:15,1,1,0,多媒体技术最大的难点在于起床\n\n给分讲课都无敌
219888,1763,肖俊,2025-06-10 03:39:07,1,1,0,给分无敌！而且对于未来做多模态的科研也很有帮助，可以入门一些基础知识，就是每周早上的小测有点痛苦qwq
13504,1765,冯雁,2015-12-28 14:59:29,-3,4,7,老师人很好，讲话很温柔
14031,1765,冯雁,2016-01-04 02:02:53,-4,1,5,老师很可爱
20500,1765,冯雁,2016-01-28 02:08:19,0,1,1,很可爱么？我都听不清楚她说什么。
24529,1765,冯雁,2016-05-01 06:20:30,18,20,2,怎么还不出分啊！我李佰余要报警了！！
41182,1765,冯雁,2017-01-10 02:04:30,0,1,1,其实是个挺好的老师，上课挺认真回答学生问题很耐心，就是感觉她讲知识点讲的不清楚，经常听了一节课不晓得她讲了什么
41228,1765,冯雁,2017-01-10 06:14:12,2,3,1,ppt做的水
41234,1765,冯雁,2017-01-10 07:08:45,6,7,1,如果cs专业的学生推荐还是不要选
41321,1765,冯雁,2017-01-20 12:08:25,1,3,2,还行 (为什么现在还不出分?)
41360,1765,冯雁,2017-01-11 04:40:05,0,2,2,人挺好，但是讲课水水的
41755,1765,冯雁,2017-01-12 13:48:40,16,16,0,人超好和蔼 但是课程组无厘头的规定很多 简单的课学的很累 助教人尤其死脑筋 不通人情
46579,1765,冯雁,2017-01-22 03:11:20,4,4,0,再不出分我要报警了
46977,1765,冯雁,2019-11-12 01:23:25,-160,8,168,老师水平就那样吧，反正我是没去上过课，关键是这助教真是厉害了，作业被抄袭也要扣分，讲真这可是我这个学期最容易满绩的课了，就这么给我个94，只有三个字可以送给您，妈卖批
46982,1765,冯雁,2017-01-23 07:45:46,0,2,2,。。。
47005,1765,冯雁,2017-01-23 09:11:34,-17,5,22,完全想不到自己会满……
47134,1765,冯雁,2017-01-24 03:50:49,-7,3,10,评分怎么那么低啊，老师给分还是不错的，就是互评要记得把组名去掉，有一次我忘记去了互评分都没了，不过最后总成绩还不错，意外地有4.5
47232,1765,冯雁,2017-09-18 06:28:08,0,3,3,讲课基本读PPT，很一般
47286,1765,冯雁,2017-01-25 05:25:44,-11,4,15,quiz有一次不去，总评直接少5分，我服
63523,1765,冯雁,2017-12-06 02:54:01,13,14,1,（ds课鹅颈最少的一个班
72740,1765,冯雁,2018-01-31 04:15:37,10,11,1,老师讲课没什么亮点，但是能讲懂，就是很平常的授课，quiz一定要去，一次5分，助教很脑残！！助教很脑残！！助教很脑残！！说三遍
101097,1765,冯雁,2019-01-27 13:05:04,7,7,0,老师还是很通情达理的，班上恶竞程度比某些班还是好很多的。就是出分确实慢了点
101363,1765,冯雁,2019-01-28 12:00:00,5,7,2,客观来说，给分不如zjk，上课不如cy hqm，但人很和蔼，就是出分慢且且不是因为调分。班里互评分相对别的班较高。
101444,1765,冯雁,2019-01-28 08:10:54,6,8,2,恶竞程度确实相对比较低，挺好
117644,1765,冯雁,2019-09-27 11:44:28,4,5,1,老师不错\n\n课程组互评制极其恶心人
117925,1765,冯雁,2019-10-11 15:33:32,1,1,0,还可以。\n\n
118161,1765,冯雁,2019-10-22 02:44:50,1,1,0,感觉老师人还可以
120704,1765,冯雁,2020-01-15 13:53:52,-9,1,10,nmb还不出分
121117,1765,冯雁,2020-01-19 16:06:42,-1,1,2,很不错
122031,1765,冯雁,2020-02-02 11:24:43,0,4,4,呔，果然是我菜，比均绩低好多。讲课挺清楚的，感觉没什么毛病
132499,1765,冯雁,2021-02-02 03:46:19,5,6,1,如果有基础的话建议选，事少，鹅颈程度小，期中还是笔试，随便写写就满了（听说有些班的期中pta上机考难度比较大）。\n\n没基础就算了，讲的不是很清楚。
134983,1765,冯雁,2021-04-25 17:08:24,2,3,1,来帮老师往上拉拉分。ds讲的一般，但是该讲的知识点都讲到了。不拖堂，课程任务讲完了经常提前下课。如果认真学的话平时分不会太差（我c的基础很差平时分也99了），大程也没有很鹅颈。作业第一次查重的时候说算我们不懂规矩，警告了一下，重合100%也没给扣分。期末是我自己考太差了，最后3.9还可以接受。
137438,1765,冯雁,2021-07-04 07:16:38,0,1,1,编译原理大作业很自由，写自己想写的就行
145138,1765,冯雁,2021-12-27 16:16:42,1,4,3,上的FDS，老师真的挺好的，人很和蔼，问问题答疑很耐心，而且讲课真的强调了很多重点，有点基础的话可以注意到老师讲课的很多细节。另外，project真的不卷，互评也不卷，具体怎么不卷选上课就知道了。FDS这门课的课程设置还是很容易高分的，bonus和hard能够补足大部分平时分的不足，大幅降低考试压力。对于想选课的同学有如下建议：1.如果是零基础，在刚开始定义数据结构的时候，比如链表那里，多下点功夫研究一下，不要被劝退；2.想拿高分的话尽量选hard，分级考试25分的题学一下STL会比较有帮助；3.陈越姥姥的mooc方便预习或者复习。
146699,1765,冯雁,2022-01-07 08:25:54,1,2,1,老师很棒，助教gg也很棒\n\n(ps:期末卷子上几道助教gg出的题好难QAQ)
146837,1765,冯雁,2022-01-07 14:44:23,3,4,1,ds好评！\n\n老师上课分多事少，期中考是纸质的\n\nproject互评不卷，大家后来好好做的互评都90+，很和谐\n\n有bonus，作业认真做的情况下，project选normal也是能满绩的！
150333,1765,冯雁,2022-01-22 15:33:52,-1,0,1,老师人很好！帮老师加加分！
150622,1765,冯雁,2022-02-05 12:57:00,1,3,2,我一个不小心大程上漏了个人信息的居然最后没有扣分，可以说是太良心了。总体讲的还行，比较耐心，小测签到交了就有，我这一届因为时间和cs专业课重了，所以同学不是其他专业就是其他年级，基本不卷
155429,1765,冯雁,2022-06-12 15:20:50,4,6,2,上的编译原理，老师和助教都非常死脑筋，尤其是老师，自己说什么就是什么，完全没有平等的师生关系，因为没有遵守她的规定总评直接少好几分，这么有原则为什么不好好批改quiz的题目和作业？为什么不好好准备实验指导课件？只会拿一些自己制定的规则来迫害学生hhh，来上学是为了学到知识，不是为了遵守你那个破规定！
157692,1765,冯雁,2022-06-24 10:46:03,-2,0,2,老师编译原理给分真的不错，大程给分有点迷，可能和展示质量也有关系。老师讲的还算可以，不过还是建议去看xyx大佬的语雀笔记。
157779,1765,冯雁,2022-06-24 20:59:39,-2,1,3,编译原理给分还不错，大程特别自由，没有硬性规定，基本内容完成就能拿到大部分分数。但讲课稀烂，台上电子笔一顿比划台下一脸懵逼
159232,1765,冯雁,2022-07-08 15:20:16,-4,2,6,给分非常不错，大程之间分数差别不是很大（给分大都在25~29之间），而且有小组写解释器都给展示过去了，作业小测什么的感觉她也不咋看直接给满\n\n讲课感觉就是读PPT，建议自学以及期末看xyx大佬的语雀笔记。\n\n另外这门课的历年卷怎么这么少啊！！！
166442,1765,冯雁,2023-01-12 09:29:56,2,4,2,fds平时分给分非常好，整个班级风气也很好，至少我遇到的互评都很友善。
166631,1765,冯雁,2023-01-13 05:36:34,1,5,4,fds虽然讲的一般，但平时分很好而且班里不卷，好评
176674,1765,冯雁,2023-07-03 09:04:49,30,30,0,讲得像被尹建伟抽上去讲的一样\n\n=====================\n\n出分后更新：\n\n译！：编译原理出分了！\n\n误！：看到分数后觉得错怪了yjw老师
177416,1765,冯雁,2023-07-03 08:25:05,5,5,0,虽然讲的一般，但是绩点直接拉跨。。。。。。。。。。。。。。。。。。。。。。。。。。。。。。。
177417,1765,冯雁,2023-07-03 08:27:47,6,6,0,出分了，垃圾垃圾垃圾\n\n打印出国成绩单前的最后一节课，他妈的这就是惊喜是吧？？？？？
177418,1765,冯雁,2023-07-03 08:28:32,8,8,0,逆天老师，2023春夏给分极差，比其他老师低非常多。编译本来就是逆天课了，没想到老师更逆天
177423,1765,冯雁,2023-07-03 08:38:09,5,5,0,以前给分还不错但今年爆大雷，课题组抽风卷子题量巨大，竟然还不调分（别的班据说调分了还不错），上90的屈指可数\n\n另外题外话，ai专业的人别想不开选什么编译原理了，去学思想史不香吗\n\n浙大三年，我大概是明白了选课，选老师永远比你努力更重要，想保研的各位一定三思
177425,1765,冯雁,2023-07-03 08:42:57,4,4,0,[编译原理]虽然fy讲的差，但是她给分也烂。\n\n该老师上课就是嗯读ppt，上课完全不知所云，讲的还不如放一只狗在讲台上翻ppt，让人很怀疑该老师到底懂不懂编译原理。此老师大作业注重展示，ppt做的怎么样和讲的怎么样占了很大的分数比例，在展示的时候还会问出“qemu是你自己写的吗”这样让人难绷的问题。\n\n不但如此，该老师给分很差，其他老师好歹捞点，fy老师好像不捞。\n\nfy你什么时候退休啊？
177426,1765,冯雁,2023-07-03 08:43:58,4,4,0,编译讲得垃圾，给分还巨低\n\n快逃
177429,1765,冯雁,2023-07-03 08:46:50,4,4,0,讲得垃圾，给分巨低\n\n快逃
177430,1765,冯雁,2023-07-03 08:48:05,4,4,0,2023春夏给分极差，保守估计低于其他班5分以上，劝退！！
177431,1765,冯雁,2023-07-03 08:56:47,2,2,0,什么垃圾
177436,1765,冯雁,2023-07-03 09:06:43,3,3,0,不调分
177440,1765,冯雁,2023-07-19 04:31:37,4,4,0,给分差的要死\n\n离谱到家
177443,1765,冯雁,2023-07-03 09:19:02,2,2,0,讲课像是被软工老师临时抽上去讲的一样，完全讲不清楚😅出分贼慢，出的分数又贼差😅今年课改以后讲后端的内容讲的和💩一样
177448,1765,冯雁,2023-07-03 09:47:43,4,4,0,讲课一坨屎，给分更是烂中烂，编译原理最垃圾的老师，千万别信之前的评价，遇上就快跑!
177452,1765,冯雁,2023-07-03 10:44:43,2,2,0,傻逼吧\n\n草泥马
177466,1765,冯雁,2023-07-03 10:45:12,2,2,0,真的垃圾
177467,1765,冯雁,2023-07-03 10:52:31,3,3,0,今晚的操作属实让人大受震撼
177584,1765,冯雁,2023-07-04 00:21:27,1,1,0,编译原理今年给分变差很多，特别是大程部分不像有的班有测试点，没有标准的结果就是嗯卷，不然就少几分总评。讲课水平也一般般，所以我推荐lzx老师。
177625,1765,冯雁,2023-07-04 03:06:40,1,1,0,真的是醉了，今年卷子离大谱，其他班听说会捞，但。。。。。。。。。。。。。。。。。。。。
177638,1765,冯雁,2023-07-04 03:49:13,5,5,0,fy的编译原理毁了我的出国保研梦
177735,1765,冯雁,2023-07-04 14:01:04,2,2,0,不会讲课可以不讲，tm看我自己看书半小时都比听冯雁磕磕巴巴讲3节课有用😓前端讲得还勉强能听，后端讲得依托答辩，自己也不懂编译器（后端更是几乎一点不懂），大程展示的时候只会逮着前端问，连llvm有in memory representation也不知道。\n\n\n\n课上的烂，考试给分也差，没有任何值得我推荐给学弟学妹们的理由，快跑，ly/lzx不香吗？\n\n\n\n课改之前内容少，fy这老师风评还行。课改之后，编译这门课，哪个老师在裸泳，一目了然。
177757,1765,冯雁,2023-07-04 15:45:36,1,1,0,乐色老师\n\n讲成这个b样\n\n给分还这么烂\n\n早知道去选lzx老师了
177853,1765,冯雁,2023-07-05 05:14:14,1,1,0,编译原理：讲课确实差，我算是为数不多认真听课的，但是要费很大力气才能明白她到底想讲什么，还不如自己看书
186175,1765,冯雁,2024-01-09 07:38:37,0,0,0,时隔半年再来评价：\n\n这泼天的垃圾 怎么就被我赶上了呢
186723,1765,冯雁,2024-01-12 18:45:36,0,0,0,老逼登退休了没
19158,1816,李石坚,2016-01-23 11:24:08,2,4,2,讲了跟没讲一样
23247,1816,李石坚,2016-03-23 02:31:22,1,2,1,遇到的计科几位最不用心讲课的老师之一
48921,1816,李石坚,2017-03-16 11:27:28,2,2,0,猪拉拉
72012,1816,李石坚,2018-01-29 08:05:44,1,6,5,老师上课还行，虽然讲的和最后的大程关系不大\n\n但是给分有点炸…三个人肝了那么久做出来的东西，自认是上得了台面的，但最后的分数相当低… 给后来者的建议：大程做个老师上课提到的、他觉得比较好的创意
72070,1816,李石坚,2018-01-29 09:42:17,9,10,1,我需要的是一个解释。。
72300,1816,李石坚,2018-01-30 00:49:18,6,8,2,我不觉得我们的大程值这点分。
73076,1816,李石坚,2018-02-01 01:23:03,9,15,6,计院最差的老师之一(倒数前三)，给分差，还不公平。12月交的大程(10000+行代码，剪辑的视频，60多页报告，队友精心制作的PPT)，1月底出的成绩(压根不在乎这课)，全队都没上4。。而且这老师连大程现场验收的环节都没有，没有答辩，还不如github上抄一个。上课根本学不到东西(我是计科的，虽说别的课老师也不教写代码，但是理论还是有一点点用的)，这课真是屁用没有。作业保守估计是09年设定的，安卓都从3到8了，作业课件都没更新过。我估计他自己对6以后得特性也不了解了，才这样在课上糊弄，真的对某个领域精通的老师，课不一定上的好，但是会吹(带专业知识的吹，不是胡吹)，他连吹对不会。培训班二本老师都比这个李石坚强。不是因为给分差才抱怨，因为平时教学实验要紧导致给分差的老师教授我愿赌服输。子曰，陈力就列，不能者止。请李石坚(不配叫老师)不要再在浙大尸位素餐了！
73727,1816,李石坚,2018-02-03 04:45:51,12,15,3,即使你讲不好课，但请认真对待学生的作品！
99852,1816,李石坚,2019-01-25 08:31:45,4,4,0,18－19年智能终端课。老师见仁见智。课程除了大程有点肝，两个小实验非常水交了就满分。大程稍微创新点给分不错
100002,1816,李石坚,2019-01-25 12:27:21,1,2,1,还行吧，智能终端隔壁班有两个大程，这个班一个大程两个小作业
129836,1816,李石坚,2021-01-12 17:19:46,2,2,0,不知道是不是我的错觉，老师好像不怎么在乎这门课
130247,1816,李石坚,2021-01-20 06:00:56,1,1,0,早八一节课都没去，大程真就随便糊弄一个...反正老师自己都不想上，就别相互折磨了
132476,1816,李石坚,2021-02-02 01:15:50,2,3,1,为啥还不出分啊，都快一个月了
133034,1816,李石坚,2021-02-06 21:10:17,3,3,0,事情挺少的，大作业做得挺累的，运气不错老师给的分很好，就是分数賊晚出
133061,1816,李石坚,2021-02-07 11:52:26,2,2,0,只能说还行，超级水课，靠着小学期的底子+网上找来的轮子自己摸出来一个很简陋的app，基本没去上过课，混了个4.2，只能说互相配合，有安卓底子可以选
138746,1816,李石坚,2021-07-10 15:58:34,2,3,1,数据挖掘导论今年第一次开，上课好像比较水，都没什么人来，不过工作量比较饱满，给分也不错
158493,1816,李石坚,2022-06-30 07:49:35,5,5,0,老师给分很好。虽然有互评，但是今年班级氛围很不错，大家互评都给分很高。平时不点名，任务量其实也还好，最后大作业可以做入门级的。
158559,1816,李石坚,2022-06-30 07:49:11,5,5,0,凑学分刷绩点必备\n\n作业认真点成绩不会差
177950,1816,李石坚,2023-07-05 17:12:34,-4,0,4,感觉今年给分一般，很多都是没有评语就给个80出头的分，虽然互评几乎拉满还是下了90，建议选另外班级的
180732,1816,李石坚,2023-09-25 11:30:49,2,3,1,给分不错，去不去无所谓，所有作业都是一个下午就能搞定的，想混一下拿个教师评分88分左右的大作业也是一天就能搞定，ddl在期末考试后究极好评。这门课没有期末考试，唯一可能需要展示的只有论文阅读，
197062,1816,李石坚,2024-07-07 04:20:58,2,2,0,给分巨巨差 快跑。
605,1832,李峰,2015-03-15 06:40:29,-2,14,16,枯燥地要命。。。
1259,1832,李峰,2015-03-21 17:08:39,-6,10,16,给分极差
1356,1832,李峰,2015-03-22 00:54:54,-2,17,19,上课无聊 作业多且烦 给分也不好\n\n
1702,1832,李峰,2015-03-23 10:29:38,9,22,13,挺好的呀：）
3578,1832,李峰,2015-06-17 01:41:59,0,14,14,讲课很快，但人挺好的
3714,1832,李峰,2015-06-17 02:38:05,-2,7,9,烦
4792,1832,李峰,2015-06-29 02:11:47,2,9,7,讲的很细
4877,1832,李峰,2015-06-30 06:35:53,-4,7,11,常常语无伦次，思维有点乱，人还是蛮好的
5672,1832,李峰,2015-07-09 06:16:08,2,10,8,老师超赞，超负责
5711,1832,李峰,2015-07-09 07:47:28,-5,10,15,迟到关门mlgj
5973,1832,李峰,2015-07-10 05:33:26,23,41,18,人看起来很严肃，课也很快。但老师私下萌萌哒。答疑时虽然一如既往的严肃但很耐心的。觉得计算机类的课程基本还是要靠自己，老师给分再好也没用。
6214,1832,李峰,2015-07-12 05:08:24,0,10,10,给分低
6298,1832,李峰,2015-07-12 23:17:04,2,8,6,还不错吧……
6680,1832,李峰,2015-07-18 11:08:46,0,2,2,我问他问题，他说我翘课了吧，天地良心，问他问题这么多说，平时分看来是要扣光了。。。
8857,1832,李峰,2015-09-29 04:53:57,-6,3,9,做作业在自己电脑都做不了，非要去机房
9582,1832,李峰,2015-11-02 06:24:17,2,4,2,好好好
9789,1832,李峰,2015-11-09 07:13:31,0,1,1,三个字\n\n
10580,1832,李峰,2015-11-20 06:26:45,0,8,8,作业超级爆炸
10788,1832,李峰,2015-11-23 05:19:41,29,44,15,作业真真真是多啊啊啊啊。。。
11755,1832,李峰,2015-12-14 05:24:26,5,7,2,好好好
11856,1832,李峰,2015-12-21 04:56:28,2,5,3,人还是不错的，课后问东西很热心
12084,1832,李峰,2015-12-21 16:14:53,-6,4,10,第一到三章上机实验，照着书都做不出来，我一个作业耗了七小时，最后心情都不好了。其实能上C程就不要选大计基，大不了自己买本实验指导学学怎么用office就好。
12319,1832,李峰,2015-12-23 03:08:00,24,38,14,没有那些评论说的差 挺热心的
12992,1832,李峰,2015-12-24 12:45:47,0,1,1,java跪
13910,1832,李峰,2016-01-02 08:22:17,0,1,1,作业多，花了很长时间，讲课快
14220,1832,李峰,2016-01-05 12:49:25,-8,5,13,为什么没有0分的选项
14326,1832,李峰,2016-01-06 09:09:33,27,35,8,認真負責任。
15014,1832,李峰,2016-01-11 13:25:45,107,130,23,虽然讲课快了点，但是人挺好的，很负责，最后一节课，有点舍不得！
15016,1832,李峰,2019-01-19 08:52:18,31,47,16,你们那些说老师不好的，怎么想的，到了考试周就知道这个老师有多良心了！！！
15191,1832,李峰,2016-01-12 13:59:19,38,52,14,看了看评论，感觉对老师的评价很极端啊。老师上课语速的确快到飞起，但是是要教授的内容太多了。老师上课举的一些例子很贴切。下学期依旧选了老师的JAVA
15271,1832,李峰,2016-01-13 06:55:30,8,9,1,棒棒棒！
15694,1832,李峰,2016-01-16 07:00:50,2,3,1,挺好的嗯嗯
16234,1832,李峰,2016-01-17 14:13:59,0,1,1,人挺好的，大计基作业多。
17263,1832,李峰,2016-01-20 02:59:12,16,26,10,作业很多，上课缺乏生动，但心地很好
18621,1832,李峰,2016-01-22 06:51:16,-10,5,15,看黑板！看黑板！看你个大头鬼啊！上课简直和尚念经！不过嘛，视力变好了，毕竟看黑板看多了，嘿嘿
18622,1832,李峰,2016-01-22 06:53:27,-10,7,17,李峰你不知道那个不是黑板是投影仪吗 \n\n上课语速快无逻辑 给分差
18670,1832,李峰,2016-01-22 09:00:54,5,6,1,自己上课没认真听
18680,1832,李峰,2016-01-22 09:36:47,-9,4,13,烂，简直无以复加
18692,1832,李峰,2016-01-22 10:37:16,5,9,4,人真的很好的，作业略多，只要认真学给分并不低
22926,1832,李峰,2016-04-05 00:07:28,5,5,0,继续评价好老师
24646,1832,李峰,2016-05-03 01:14:47,-6,1,7,看黑板上面 看黑板上面\n\n语速很快 超级快\n\n懵逼中
26927,1832,李峰,2016-07-03 10:21:00,54,69,15,老师挺好的…我电脑盲认真跟他学java拿了4.2…主要是自己弱
28058,1832,李峰,2016-06-28 08:03:03,72,85,13,没有评论里说的那么可怕，老师人很好很负责，只要你肯问问题他会一直讲到你懂为止。\n\n语速快是事实，喜欢说  看黑板上面   也是事实，我觉得没什么好黑的。
28245,1832,李峰,2016-06-28 08:20:29,-6,1,7,只记得老师还挺帅的，然后有一次上课打瞌睡被他敲桌子叫起来了，非常尴尬
28767,1832,李峰,2016-06-28 14:13:44,25,32,7,不知道为什么大家都要黑老师，明明上课认真负责，讲课讲得快那是因为内容多，给分怎样完全靠自己努力啊。喜欢水课的还是不要选老师的课了。看黑板认真听是作为学生必要的尊重啊！
29247,1832,李峰,2016-06-29 13:29:19,21,28,7,认真负责，有个性，让我爱上JAVA，迟到了就不让你从前门进，我喜欢！
30037,1832,李峰,2016-07-01 00:25:51,16,19,3,老师人很好的。上课语速很快，很喜欢说 看黑板啊看黑板。会提醒后排睡觉的同学不要睡觉哈哈。挺萌的。会讲笑话，知识点也讲得很清楚。
30897,1832,李峰,2016-07-03 00:11:25,4,5,1,大计基是这个老师的课 其实老师讲的也挺好的 这类课还是看自己 考java的时候学生证丢了多亏了以前的师生情帮我拖了一会儿拿到了证明 老师人还是很热心的
31088,1832,李峰,2016-07-03 08:08:27,6,6,0,java作业挺少的
31151,1832,李峰,2016-07-03 09:40:38,5,6,1,老师人超棒的啊，并不像评论里说的那么极端。看黑板本来就很正常啦～而且老师特别负责，每次上机都会很认真地亲自辅导，特别棒～
31348,1832,李峰,2016-07-03 17:01:16,2,5,3,老师人真的超级nice的 不管是java和大机基 么么哒！
31559,1832,李峰,2016-07-04 06:28:20,0,0,0,讲课真的很快，但认真听发现很多细节都有。虽然我自己夹瓦成绩不怎么样...不过觉得他不错
32825,1832,李峰,2016-07-16 09:36:52,0,2,2,给分一般 语速快 有种赶课程进度的感觉
34880,1832,李峰,2016-12-27 08:53:36,2,4,2,好老师，大家可以选，真的为学生着想，教的东西都是好东西
35307,1832,李峰,2016-11-08 05:55:23,5,5,0,老师很好
36388,1832,李峰,2016-11-12 16:23:47,-2,0,2,语速是真的超级快
38048,1832,李峰,2017-01-19 01:04:53,-6,3,9,认真负责，给分好，没有那么可怕
38795,1832,李峰,2016-12-19 05:11:08,1,3,2,作业，太！塔！码！多了！
39217,1832,李峰,2016-12-21 15:44:43,5,6,1,超级好的老师，头上的呆毛很可爱。大二了再遇上老师，还能记得我。课上虽然语速快了点，但干货满满，认真听的话绝对收益颇丰！
39305,1832,李峰,2016-12-22 04:05:03,6,7,1,老师人很好啊，作业虽然有点烦但毕竟那些都是很有必要做的嘛，一直逃避的话word，excel什么的以后不会用还不是自己吃亏。而且可以延交嘛。上课给人的感觉很潇洒，语速快，看黑板，这些也没什么不好啊，毕竟内容太多
39399,1832,李峰,2016-12-22 12:13:07,5,7,2,作业不要太多
39636,1832,李峰,2016-12-26 09:14:41,6,8,2,有激情，讲的仔细！
40396,1832,李峰,2017-01-03 06:59:41,-3,0,3,人可以，就是作业系统不太好
40415,1832,李峰,2017-01-19 02:23:46,14,19,5,作业太多了…认真对待了但是最后分数也不高…老师讲得挺好…
41193,1832,李峰,2017-01-10 02:55:29,4,7,3,从不点名，作业不多，开放IP让你可以在宿舍做作业不用去机房，平时作业不看基本满分，上课画重点，最后一节课回顾整本书，迟到不让进我从来没有见过，讲的细画重点，好好听不用复习，10分。
41285,1832,李峰,2017-01-10 11:46:40,10,14,4,是我在秋冬学期里老师讲得最好的了，虽然快，但讲得清楚。老师负责任，认真，最后一堂课才realized已经最后一堂了。谢谢！老师
41448,1832,李峰,2017-01-20 07:45:35,4,6,2,老师人炒鸡好，也有个性，不管有没有基础都能在课上学到很多，平时的作业虽然不少，但是对我这种小白真的很有用，而且上机考有相关题目，这门课确实不好拿高分，老师最后一节课带我们刷完一本书超赞，谢谢陪伴的话好煽情，可惜不教c 以后java还要选他
41449,1832,李峰,2017-01-11 15:35:13,2,3,1,认真听感觉很好
45040,1832,李峰,2017-01-19 01:12:21,0,0,0,。。。。
45048,1832,李峰,2017-01-20 03:08:20,10,13,3,一般般吧，但给分真不咋地，均绩比其他老师低了0.4有吧。
45051,1832,李峰,2017-01-19 15:02:20,-1,10,11,这位老师啊…真不知道说他什么，上课么语速跟华少播广告一样的，有没有干货自己从中去寻找\n\n平时作业来了个烦，实验书里每一题都要做，不过还好不锁ip…我估计老师也不看就乱给分的吧 下面重点来了，给分差 给分很差 给分极差 就说三遍 不行去搜搜计算机科学基础的其他老师 没人均绩比他还低了 差不多算绩杀了 学弟学妹选课时候注意了 要绩点的远离的他 ok?
45069,1832,李峰,2017-01-19 02:26:14,1,1,0,作业很对给分很低
45080,1832,李峰,2017-01-19 02:38:45,0,1,1,作业有点多，倒是比较负责。上课不太能听懂，可能是内容多老师赶进度，好多内容感觉解释不清。给分一般般吧
45083,1832,李峰,2017-01-19 02:53:07,1,2,1,语速飞快，内容充实，认真听不错的!
45093,1832,李峰,2017-01-19 15:56:09,1,2,1,还行吧\n\n\n\n\n\n
45181,1832,李峰,2017-01-19 05:54:53,7,9,2,不是很懂那么认真做平时作业以及课后报告，考试大部分都会做最后只有72分?
45389,1832,李峰,2017-01-19 13:43:59,0,2,2,上课讲的有点无趣，其他都挺好。
45584,1832,李峰,2017-01-20 07:37:42,6,9,3,具体讲得怎样我不知道……因为大计基听不懂……讲真，事情挺多的……可能我本来就渣，大计基是我目前最低绩点。
45626,1832,李峰,2017-01-20 01:19:31,3,5,2,好老师，作业认真做收获挺大的
46241,1832,李峰,2017-01-21 04:34:29,2,4,2,老师人挺好的，认真负责，上课语速是比较快，但是讲得也挺好，虽然我课堂是纯水过去的。平时作业真的多，要按照实验书上一步步来，唯一的好处是不用去机房。不过我估计老师平时分也应该是意思一下的……绩点不好说，我自认期末考得还不算差，平时作业也都完成，但还是比较低。不过有一点！老师讲到汉字编码那一块的时候突然说我要讲点无关的东西！然后讲起了中华汉字博大精深，冲这个我就要给老师高分嘿嘿嘿
46953,1832,李峰,2017-01-23 05:03:14,-22,2,24,给分真的极其一般，以为满绩的，只有4.2\n\n
47917,1832,李峰,2017-02-27 09:29:27,0,0,0,给分一般般，讲课还好，语速快，能学到东西
48209,1832,李峰,2017-03-01 08:08:25,2,2,0,老师讲课挺好的\n\n就是我自己没怎么认真听\n\n速度很快
49784,1832,李峰,2017-04-26 03:08:37,0,0,0,语速飞起，内容丰富，讲解详细
51281,1832,李峰,2017-05-27 08:54:44,0,0,0,好好好
52380,1832,李峰,2017-06-19 08:48:37,0,0,0,每次老师拖课的时候我都很想打人\n\n（其实是这学期课太紧了）
52595,1832,李峰,2017-06-21 09:39:56,2,2,0,我现在还没考试 但是就是很喜欢他啊hhh
56218,1832,李峰,2017-07-03 09:14:59,6,6,0,在大学遇到的超级像爸爸的一个老师。讲课非常认真仔细，让人想到高中老师。除了会有一丢丢拖堂之外简直无缺点！把Java讲的很容易易懂，虽然还没出分但永远感谢老师！
56891,1832,李峰,2017-07-05 02:35:52,1,1,0,3.6。。。心有点痛
56896,1832,李峰,2017-07-05 02:48:46,-1,1,2,人好话不多
58997,1832,李峰,2017-09-19 04:45:09,0,0,0,快快快
60870,1832,李峰,2017-10-31 16:29:09,2,3,1,好老师，很负责任
60952,1832,李峰,2017-11-05 05:02:01,-2,5,7,垃圾老师，做个作业别的班老师都给文本，就李老师不给，一大段文字还得自己录，艹
60973,1832,李峰,2017-11-06 05:56:28,2,5,3,作业也太多了吧\n\n
61311,1832,李峰,2017-11-14 07:46:46,2,4,2,作业贼多
63659,1832,李峰,2017-12-12 01:50:56,2,4,2,老师的呆毛不见了哈哈 感觉老师讲课有点快，不过讲的还是挺好的，也很负责任～
63877,1832,李峰,2017-12-18 08:27:11,16,17,1,这门课要讲一个学期
64545,1832,李峰,2017-12-25 06:05:11,2,5,3,呵 事情特别多 作业一堆 还有论文  给分也很一般\n\n
65580,1832,李峰,2018-01-06 13:17:59,1,3,2,作业贼多
65734,1832,李峰,2018-01-08 15:04:21,-2,2,4,事情真的多，真的多，真的多。不要以为我在骗你们，对自己自信心爆棚的话可以来试试。老师人品是还可以。
66538,1832,李峰,2018-01-17 07:59:15,2,3,1,虽然讲的快，作业多，但是很细心很好说话，很好的老师
66785,1832,李峰,2018-01-19 04:50:23,5,5,0,虽然之前很吐槽老师，但是老师是真的很负责，真的让人很敬佩，而且三观超级正。在讲到GIF的时候还抨击了做22老奶奶表情包的事。虽然老师不苟言笑，但是课下问问题回答的时候都很有耐心。在最后一节课会复习所有的重点，超级有魅力！
67087,1832,李峰,2018-01-20 09:05:29,5,6,1,感觉李老师讲的知识还是可以的，大计基也不觉得他语速有多快，前几节课还看到了他可爱的呆毛（不知道后面为什么就没有了）。另外他的ddl能一推再推再再推，只要系统能改，迟交不是问题。n楼之前有人说大计基实验不给文本，其实你可以问一下老师，随便打就可以的，不用和书上一样的。给分不知道诶～
67458,1832,李峰,2018-01-21 08:43:56,-1,1,2,再好的老师班里也有人挂科，学习靠自己哒(*￣m￣)别虚，就是干！！！
69165,1832,李峰,2018-01-24 09:18:48,6,6,0,作业多但是照着书都能做到去好吗！室友别的老师布置的作业看起来少根本做不下去！查都查不到！
69253,1832,李峰,2018-01-24 11:12:41,29,33,4,我讲一下公道话：作业很多是真的，但是实验作业可以迟交，计科练习有定死的ddl，如果每次踏实学了再做有巩固的效果，个人来说真的没时间这么学，加上很多人会刷分，我比较苦恼；还有很多人在说的开放IP，据我所知很多老师都开放的；老师给的期末考资料没有别的老师多；会划重点，但那远远不够；因为这课本身的原因，上课认真听下来，脑子里还是一团糊，靠最后看书。老师人很好，讲解计算也很透彻，但是概念就不太清晰。成绩还没出，希望不要低，谢谢老师的授课。
71933,1832,李峰,2018-01-29 06:13:30,6,6,0,作业挺多的，期末考试也需要好好复习。这倒不是重点，都还能接受吧。但这个均绩真的要报警了！怎么不去抢，和别的班起码给你往下拉一个档
71935,1832,李峰,2018-01-29 06:17:28,4,7,3,认真学了一学期，本来以为会不错的，结果呢。平时作业贼多，有个鬼用。看来确实要看均绩，这么低的均绩，比别的老师低这么多！生气
71984,1832,李峰,2018-01-29 07:23:26,2,6,4,给分那么低作业还这么多
71995,1832,李峰,2018-01-29 07:37:11,5,7,2,大计基作业是比别的班多，但是不难做，愿意花一些时间就能完成。老师非常负责，找他答疑也很耐心。自己对计算机本来没什么兴趣，但最后绩点比想象的好很多，努力学了就不会太差的！谢谢老师！
72001,1832,李峰,2018-01-29 07:46:41,0,1,1,挺充实，但语速太快，还犯困\n\n
72128,1832,李峰,2018-01-29 11:54:17,-26,5,31,大计基这门课有毒，不怪老师。虽然平时一节课也不认真听，但是考前刷题背书我还是拿了4.5，谢谢老师
72429,1832,李峰,2018-01-30 06:04:35,1,4,3,老师讲课是有点快啦，不过大计基都这样，反正都是到点自学，平时作业好好做就行了，给分还是客观厚道的
72608,1832,李峰,2018-01-30 13:28:19,-1,4,5,老师讲课挺快的，可能概念不太清晰，一学期也没有认真学习，不过最后努力复习也算拿了个还好的分数，谢谢老师
73557,1832,李峰,2018-02-02 03:16:32,5,7,2,作业太多了
73831,1832,李峰,2018-02-03 07:45:15,2,7,5,作业做的超级认真，测试题和思科几乎全满，大作业也很上心，花了3天做大作业。最后两套模拟题做的也不错(说明我大计基学的挺好的)\n\n最后3.3\n\n反正我不服，老师给分是不好，可我觉得怎么也得4.2??这分瞎给的吧?
74774,1832,李峰,2018-03-06 01:14:27,1,4,3,老师人很萌哒！喜欢有一些拓展。爱计科的同学课上就不要错过啦。虽然平时事不算少，不过有些实验还好蛮实用的
75678,1832,李峰,2018-03-15 04:34:29,1,7,6,分数瞎给
75865,1832,李峰,2018-03-20 07:34:05,1,5,4,人还是挺好的，不懂的东西问的话会给出解答，但是讲课有点快。也可能是我渣
76617,1832,李峰,2018-04-16 09:24:45,-10,6,16,垃圾 讲的快
79410,1832,李峰,2018-06-04 03:09:45,-7,6,13,云里雾里，糊糊涂涂，最后自己看书
79412,1832,李峰,2018-06-04 03:19:52,-5,6,11,挺负责任的\n\n但是个人觉得他的课没有逻辑，语速很快，不如自学。\n\n总是拖堂真的很难受
79504,1832,李峰,2018-06-07 08:27:03,8,9,1,老师讲的非常认真 可以感觉到老师很希望我们学好 上课会在意你到底有没有听 在意你下课后有没有去练习 我觉的真的很不错 查老师首评献上
79603,1832,李峰,2018-06-11 06:45:54,-3,4,7,我觉得java这课时实在是少吧...虽然老师很想我们学好但不得不那么快。自学，很难受不过只能表示理解。另外老师好像对我们的能力有什么误解...学过大计基？不存在的...
80326,1832,李峰,2018-06-25 06:44:54,9,14,5,老师人很好，虽然平时经常晒晒所有同学的作业完成情况，也是督促我们抓紧练习嘛；上课重点突出的
80711,1832,李峰,2018-06-29 14:11:49,7,10,3,我觉得老师讲课细致清楚，人也很温柔啊，然后对学生也很宽容，每次上课前把前面的再复习一下。个人觉得他的评分低了
82149,1832,李峰,2018-07-07 08:35:15,13,16,3,"上的Java：老师讲的很清晰啊！照着ppt讲 但是还会告诉你要把书上哪里划下来 ""请你们把书翻到xx页""""请你们把书上xx段xx行划一下"" 而且讲课的时候经常打比方 认真听的话是能省去课下翻书的时间的 我觉得老师讲的很好！语速可能是有点快 但是逻辑清晰啊！而且作业也不多，就只有上机系统的题而已，好像有的老师还会布置课本课后题"
84092,1832,李峰,2018-07-12 03:55:52,-1,7,8,70%挂了是真的吗
84151,1832,李峰,2018-07-12 06:51:02,7,10,3,老师人很好拉，虽然讲课快一点，但确实理论课太少。会经常提醒我们做作业啊考试注意事项啊，觉得老师分低了
84219,1832,李峰,2018-07-12 09:10:33,8,11,3,上学期看了预置课表查了查老师，以为老师对学生要求很多很严，但是一个学期的java课下来，老师还是很好的。虽然感觉他脾气可能有点不耐烦，就是有几次话筒不太好，就很烦，但是讲课的时候一点都不嫌烦，重点难点都是一遍遍重复，上的是有点快，但是每次课前都会有十多分钟的时候帮大家一起回顾，最后一节课也会整本书复习，上课的时候比较喜欢“看黑板上面”“书上这句话划一下”，很认真负责了！java这个课还是要自己多做题吧，实验跟理论都是！
86557,1832,李峰,2018-09-17 07:22:55,5,7,2,真的是很棒的老师啊\n\n认真负责\n\n结束了一个学期突然很想念他的课\n\n真的很棒\n\n在我整个人学习状态很差的情况下\n\n是唯一认真学的一门课\n\n也是绩点最高的一门
87579,1832,李峰,2018-10-07 14:29:55,1,11,10,上课体验极差\n\n
88572,1832,李峰,2018-11-02 01:00:29,1,6,5,作业太多
91598,1832,李峰,2018-12-15 06:10:00,-3,8,11,非常差
92178,1832,李峰,2018-12-27 03:00:44,6,8,2,好喜欢这位老师啊 很热心很负责 不会难为学生 语速快是真的 作业也还好吧
92546,1832,李峰,2019-01-02 10:29:35,4,8,4,真的讲得很棒，比喻鬼才。各种原理上课都用讲得超级清楚，大计基马上要结束了，无论什么绩点都要给老师打10分?
93297,1832,李峰,2019-01-09 01:48:39,4,7,3,很负责的好老师
93309,1832,李峰,2019-01-09 03:05:50,-3,1,4,老师上课很认真 就是说话太快 加上有点重的口音 所以常常会听不太懂
93344,1832,李峰,2019-01-09 05:41:53,8,14,6,李老师真的真的真的只是看上去有点忧郁有点凶，大家不要被吓到了，人真的挺好的，说作业多的，我想问问大计基哪个老师作业不多...
93463,1832,李峰,2019-01-10 01:40:02,7,10,3,超级认真负责的一个老师 而且有点逗比属性
94227,1832,李峰,2019-01-26 12:07:11,-11,4,15,可以给的分非要卡绩 最后还不如那些不去上课的同学 建议学弟学妹们也不用去上课了 就是把书背好就行了
95353,1832,李峰,2019-01-19 08:52:45,2,4,2,。。。。。。\n\n
95417,1832,李峰,2019-01-19 10:53:59,15,20,5,“感谢同学们一学期的陪伴。从同学们身上也学到了很多。祝大家考试顺利。”：)
96143,1832,李峰,2019-01-20 13:28:25,-1,3,4,大计基是什么玄学？？？？？？？？
96415,1832,李峰,2019-01-21 02:37:12,4,8,4,平时啥事没有\n\n很轻松的，期末也水的一批。老师很赞
97708,1832,李峰,2019-01-26 11:25:22,16,17,1,虽然上课确实少了一点生机和活力，但不影响他作为一个认真负责的老师而应该得到尊重和赞扬的事实
97731,1832,李峰,2019-01-22 14:24:13,6,9,3,首先，我得要说清楚。大计基的课讲得快真的不是老师的错，大家都看见了，这个速度讲下来期末也就刚好一节复习课，时间也还是挺紧的。但是，老师人是真的好，无论你问什么问题他都很耐心的解答，就算是自己电脑出问题问他他也会给建议，超级负责。
100060,1832,李峰,2019-01-25 13:30:16,-4,11,15,我给他打一分是因为无法打零分
100580,1832,李峰,2019-01-26 10:50:51,9,11,2,老师讲课是真的不错，善用比喻，一些抽象的计算机概念也讲的很明白。相比我室友的大计基老师，真的平时事情巨少，考试周的复习超级给力。虽然卡绩了，依然给10分不解释
100582,1832,李峰,2019-01-26 10:53:44,12,14,2,①老师人好，问问题很耐心地回答，也会在群里回答同学的疑问。②计科作业有定死的ddl，但都会我有一次忘记做了，发消息给老师，他很真诚地和我做了解释这个不能单独重开，我也觉得OK。③期末大作业必须交，但要求还是松的，可以根据参考文献整合。④老师讲的是好的，但说实话我平时听的不多，是我的问题，但期末认真刷题还是上4了，谢谢老师。总评，7.8还是低了，我觉得老师起码值8.5。
100595,1832,李峰,2019-01-26 11:18:23,10,11,1,李老师是我这个长学期所见过的最认真的老师了 上课语速非常快，想要把尽可能多的知识教给我们，也会涉及一些考点以外的知识，有时甚至会拖堂，可见他非常负责了。问老师问题，也很耐心回答。
100601,1832,李峰,2019-01-26 11:26:11,7,8,1,作业多不是老师的问题，大计基本来就这样\n\n
100621,1832,李峰,2019-01-26 12:27:56,7,9,2,老师是我大一最喜欢的老师啦。虽然计科经常睡着，但每次都坐第一排，因为感觉老师白白暖暖的！后来认真听了很多节，其实上课会举很生动的例子。\n\n唯一一个最后一节课觉得恋恋不舍的
100656,1832,李峰,2019-01-26 13:52:09,13,15,2,大计基这门课就这样，关老师何事？老师特别好，每节课都讲得很拼，什么注意的事都讲得很清楚，会拖堂，大学老师会拖堂真的很少了。
100696,1832,李峰,2019-01-26 14:49:19,7,8,1,老师超好。上次大作业我交错了，他特意发消息让我重新交一篇。最后感觉没影响我的成绩。李老师真的很负责
100807,1832,李峰,2019-01-27 01:01:33,9,12,3,给分还是挺不错的，刚及格，有4.2
100929,1832,李峰,2019-01-27 06:43:46,6,6,0,给分不错
101003,1832,李峰,2019-01-27 08:55:31,7,7,0,上课说实话上得挺好的，讲得也很用心的，问问题都会认真负责地回答，考得不好都是自己的问题，上大计基自己总是在水，和老师没有关系，收获其实也挺大的，谢谢老师！
101339,1832,李峰,2019-01-28 04:41:45,3,4,1,老师上课节奏比较快，内容很详细，也会加入一些扩展的内容，有很多自己的看法。感觉性子比较急，偶尔有点暴躁，但总体还是非常认真负责的好老师。给分也还行。
101790,1832,李峰,2019-01-29 05:25:23,3,5,2,课讲得快不是老师的错
102310,1832,李峰,2019-02-01 01:27:17,1,3,2,本来挺喜欢他的，上课语速很快，如果不认真听就根本听不懂，作业很多，实验特别多，其实这门课都靠自己死记硬背，如果你期末考的不好，老师会让你相信系统，后来就不会在理你了，本来觉得他挺负责的，但是他其实并没有想象中那么好，给大家一个忠告，靠自己吧，别对老师有太大期望
102448,1832,李峰,2019-02-02 10:03:16,7,8,1,很负责 懂得很多 不笑但是很可爱！偶尔冷幽默 绩点居然上四了 感觉是15%的论文的功劳 总之超爱他 想打12分 爱了爱了
103326,1832,李峰,2019-02-27 10:11:16,7,9,2,李峰老师明明超帅好吗！！声音也很好听啊！！讲java讲得很好呀！！
106741,1832,李峰,2019-04-29 07:33:06,2,3,1,虽然讲课是真的快，但非常负责，下课会很耐心解答问题
107651,1832,李峰,2019-05-08 03:17:02,2,5,3,看黑板+看明白了没=看heinba了没
108158,1832,李峰,2019-05-15 23:03:41,-1,2,3,李呆呆
111429,1832,李峰,2019-07-01 12:55:02,4,4,0,超级负责
111431,1832,李峰,2019-07-01 12:59:52,6,6,0,第一个让我怀疑查老师的分的老师\n\n老师真的教得好 思路清晰 认真负责 还帅！\n\n
111456,1832,李峰,2019-07-01 14:53:22,4,5,1,老师真的很负责讲的很好！可惜本菜鸡没有好好听老师的课，只能期末补天好后悔T.T
111463,1832,李峰,2019-07-01 15:28:23,4,4,0,秋冬的大计基和春夏的Java都选了老师的课，超级喜欢老师认真教学的态度！每节课干货满满！男神李峰老师！
112493,1832,李峰,2019-07-04 12:30:24,2,2,0,老师真的很负责，真心想让我们学到干货！
112579,1832,李峰,2019-07-04 18:27:19,2,2,0,老师非常可爱非常负责！！虽然私下从来没有和老师有过交流但还是非常非常喜欢他～～
112618,1832,李峰,2019-07-04 22:48:15,1,1,0,老师讲课很认真，会拖堂，不过是真心很负责的老师。至于给分，比我预期低一点，不过可能是我粗心，理论不小心错得多吧
112799,1832,李峰,2019-07-05 03:33:28,4,4,0,讲的蛮快的，后面基本靠自学，不过上课很认真，问题目也很细致的讲，不过我们之前真的没上过大计基啊啊啊老师对我们的基础有误解? ，自己认真学，JAVA实验考试四题都做对了，理论感觉也还行不知道为什么只有3.9，有一点点失望吧，不过老师还是不错的，JAVA主要还是自己研究多练。
112872,1832,李峰,2019-07-05 13:01:24,2,2,0,老师超帅，Java课超棒！
112937,1832,李峰,2019-07-05 13:31:42,-1,0,1,超级负责的老师 虽然语速很快 但是有时要强迫自己集中注意 老师说的内容干货还是很多的。上课好好听 平时练习好好做 复习把书仔细看一遍  成绩不会差的
117825,1832,李峰,2019-10-04 00:42:06,0,1,1,害行吧
118895,1832,李峰,2019-11-07 11:50:51,0,1,1,老师语速快，刚开始确实不适应，后来觉得完全跟得上(我是电脑盲)，以后选课可能还选这个老师
120586,1832,李峰,2020-01-13 12:30:51,0,2,2,李峰好老师 呆毛萌萌哒
121222,1832,李峰,2019-12-27 03:00:51,0,2,2,老师很负责
121455,1832,李峰,2019-12-16 04:02:32,6,7,1,语速快到你只能自学
121852,1832,李峰,2020-01-22 14:26:02,4,4,0,语速超级快
122497,1832,李峰,2020-03-02 12:26:27,2,3,1,讲课很认真，但是我记不住
123419,1832,李峰,2020-06-08 15:14:43,0,2,2,事情比较多，但是很负责，上课内容丰富。
123876,1832,李峰,2020-06-15 17:04:03,7,8,1,作业真的是多。。。不过讲的其实挺好的
126179,1832,李峰,2020-09-18 12:28:33,4,5,1,上课还不催，就是回顾上一节课要回顾半个多小时
126888,1832,李峰,2020-10-27 00:41:29,4,4,0,大计基，讲太快了，还要扯一些不在要求的内容，作业多
128722,1832,李峰,2020-12-25 05:46:54,7,7,0,每节课都会回顾上一节课的内容，挺认真负责的，就是我听不懂……还有语速是真的快
129021,1832,李峰,2020-12-29 00:43:11,4,4,0,上课语速快，说专业名词尤其是英语的时候吐字不清，讲的东西和书和考试有很多是分割开的，作业多，全靠自学
129638,1832,李峰,2021-01-09 14:06:40,3,3,0,来到浙大后的所有长假都消失在了大计基的作业之中。
129671,1832,李峰,2021-01-10 13:42:14,0,4,4,能别选就别选，浙大老师这么多，何苦把快乐的一天一天都他妈浪费在大计基上
131550,1832,李峰,2021-01-28 03:39:49,-1,0,1,老师上课会讲很多不在要求内的内容，语速比较快，是真的想让我们更多地了解计算机
131798,1832,李峰,2021-01-29 03:55:47,-1,0,1,语速有点快，对学生挺好的，Python课讲得中规中矩吧谈不上多好但也不差，给分的话比较务实不怎么调分
132384,1832,李峰,2021-02-01 08:48:22,1,1,0,毫无计算机常识选手 听课写作业都云里雾里 （是我的问题 我真的不喜欢计算机）不过作业都上交再适度刷刷分，考前好好看了ppt，模拟题和平时作业，理论考抽到一套几乎没有原题的卷子...感觉要完结果4.5。谢谢老师。
132412,1832,李峰,2021-02-01 11:10:06,-1,0,1,老师特别好！！！
132418,1832,李峰,2021-02-01 11:58:44,-1,0,1,李老师给分不错，就是计科练习不给重新开放，忘了几次，考试考的还行，最后也有4.5。
132485,1832,李峰,2021-02-02 02:27:17,2,3,1,（大计基）老师人比较求实，有时候说话可能会给人一种很不舒服的感觉，但是其实是很为学生考虑的。\n\n作业其实感觉并不算多，没有什么ppt展示，也没有网页作业啥的。但ddl定的比较死，超时了就绝对交不了了。另外计科上的题会截止，考试周不会开放。\n\n关于考试的话，并不难。我并没有做到几道原题，好好看书和PPT即可，要适当了解Python的基本概念。
132691,1832,李峰,2021-02-03 10:12:20,2,3,1,峰哥拯救了我的均绩
132959,1832,李峰,2021-02-05 11:54:19,2,2,0,老师讲的很细致，语速是有点儿快，还时而拖堂，但很尽责任！
135884,1832,李峰,2021-06-01 01:08:33,3,3,0,讲课超快，不过不点名就划水，大计基刷题就行
137056,1832,李峰,2021-06-30 05:55:21,6,6,0,选的他的python课，讲课很实在，有些例子也举得很生动，语速偏快但是也容易听明白！而且是真心有想让我们学好python，经常会拓展一些考试不要求但是很有用的干货！而且，他上课不点名！
137057,1832,李峰,2021-06-30 05:58:16,2,2,0,好好好
137909,1832,李峰,2021-07-06 14:10:19,3,3,0,大计基，每次都要睡着，但是给分好好ヾ ^_^♪
137957,1832,李峰,2021-07-07 01:07:57,3,4,1,上课语速节奏有点快，但其实认真听讲不划水真的会学到很多干货！而且老师平时上课的时候会提醒你“书上第几页第几行划一下”或者是“看PPT”，就、、有点像让你集中注意力的初中老师，但其实也是在无形中提醒你重点啦！不过通过和我朋友们的老师对比，好像lf老师班的作业没有答案，而且因为讲课节奏快、进度快，作业一般比其他班级提前一周，然后也不怎么讲评......所以平时作业还是蛮让人头疼的。但是因为老师讲课快，在期末之前至少会留出一周来梳理重点和集体复习，不会像其他班老师一样拖着讲不完，导致最后几章在考试的时候云里雾里。所以上lf老师的课，建议认真听讲！上课真的很重要！！！
139461,1832,李峰,2021-07-16 04:24:44,6,6,0,老师讲的是不错的，而且心里明白大家后半节课容易困，不断提醒大家看黑板。而且上课不点名，又的确能学到东西。\n\n但是，至少个人觉得给分并不算很好，比隔壁陈老师差上不少。本人理论考比陈老师班级的一些同学高出两位数的分，但最后出成绩绩点几乎没差，虽然这个分不违背李老师上课给的评分标准，但是实话说看到考试比我差的同学和我绩点差不多，还是有点失望……\n\n李老师的水平和教学能力对得起他的评分，但是要是想要高绩点的话建议去陈老师班……
139749,1832,李峰,2021-07-23 02:22:37,6,6,0,老师上课语速偏快，但是干货很多，认真付出就会有回报，虽然上课不点名，但真心建议大家不要翘课，老师上课真的很认真
141291,1832,李峰,2021-09-29 00:04:52,14,14,0,很困是怎么回事
144465,1832,李峰,2022-01-14 12:11:12,2,3,1,听不懂，但给分还可以，没想到居然有4.5
144472,1832,李峰,2021-12-21 16:44:38,4,4,0,没看查老师之前一直以为老师的分数会是9分以上，老师真的很认真负责，去问问题也会很耐心地回答，作业ddl每次都会再三强调，总之感觉超nice的
144863,1832,李峰,2021-12-25 08:59:27,2,2,0,语速很快，但是老师很耐心的，只是我听不懂课。
145185,1832,李峰,2021-12-28 06:04:44,4,4,0,老师水平很高，语速是很快但是也是没办法我一开始也没办法接受，但是确实发现是因为课程内容实在多所以不得不加快上课速度，这并不是老师可以决定的。老师真的只是在他的能力范围内做到最好。十分
145284,1832,李峰,2021-12-29 01:31:25,3,3,0,老师很好啊
146712,1832,李峰,2022-01-07 08:53:52,1,6,5,老师平均绩点太低，讲得再认真给分太差，评分标准比其他老师苟刻，对大家极不公平！！
149079,1832,李峰,2022-01-14 10:16:19,5,5,0,大计基A：讲的很快，内容很多，作业多，但感觉不是老师的问题，大计基这门课就感觉不太合理。上课半摸鱼，考前狂补天，最后4.5。
149080,1832,李峰,2022-01-14 10:17:51,0,1,1,4.5结束，老师其实挺好，就是略微有点凶，但是很负责，讲的也很清楚，大计基这个课还是靠自己多一点，毕竟内容多，老师讲课快也是正常的事情
149083,1832,李峰,2022-01-14 10:33:48,7,8,1,绝对满分！上的是李老师的大计基，平时上课确实有点无聊，作业也比较多，但真的超好！作业口头上说到12.17实际上给我们放到12.31怕我们完不成！以及最后考试真的海底捞！本来还在担心挂科最后出来4.8！！选他选他！！！
149084,1832,李峰,2022-01-14 10:34:26,4,4,0,老师讲课很认真负责，虽然严格但最后给分很温柔，选他选他
149091,1832,李峰,2022-01-14 11:10:41,3,3,0,老师！！！！谢谢捞我!大计基虽然没听过课但是期末补完了智云害怕挂了但是最后很出乎意料！！！！老师讲课快但是是清楚的 期末看的也是1.5倍速无压力 很帅气善良的老师作业也很公道不多的好好学收货很大的~
149102,1832,李峰,2022-01-14 11:40:25,3,3,0,作业有点多，但不难，老师人很好，会很耐心回答
149111,1832,李峰,2022-01-14 12:06:41,2,2,0,感谢李老师
149162,1832,李峰,2022-01-14 15:04:43,2,2,0,挺好的，计算机虽然讲的快，但是只要把作业交了，而且作业大多数都能很好完成，考试多看看书多做做题就好了，最后4.5
149187,1832,李峰,2022-01-14 16:12:49,0,1,1,有些人说给分不好，但是我感觉还行，其他大计基好像还有个什么大作业，但是李老师就没有，平时事情挺少，最后几天学了一下期末考正好遇到了份不难的卷拿了4.5，还挺感谢李老师的，平时上课语速挺快，但是讲的很清楚，ppt上内容都很详细
149192,1832,李峰,2022-01-14 16:39:57,0,1,1,老师很细心！每次作业ddl之前都会提醒，还有期末会给复习提纲，太爱了呜呜。
149220,1832,李峰,2022-01-14 23:49:16,3,3,0,老师超级认真负责，最后一堂课会给我们把重点画一遍，听了那堂课收获很大，最后补天成功！感觉老师给分挺好的。
149447,1832,李峰,2022-01-15 11:02:31,2,2,0,很喜欢这个老师，有问必答。
149575,1832,李峰,2022-01-16 04:20:36,1,1,0,老师讲的挺快的，但是人很好
150096,1832,李峰,2022-01-19 04:13:39,0,1,1,很好的老师，就是讲课会混混沌沌听不进去，但是不懂的去问都会讲得很明白，大赞
150804,1832,李峰,2022-02-19 00:44:07,5,5,0,老师讲课真的非常快，但是我觉得他只是想把更多的知识传授给我们。
151122,1832,李峰,2022-02-23 08:11:49,2,2,0,老师很好，但希望提高评分均分，和别的老师差距有点大。还是给10分了
151617,1832,李峰,2022-03-09 23:59:36,0,1,1,很好，很耐心
156779,1832,李峰,2022-06-21 02:58:01,0,2,2,好！上课很紧凑，比那些水课舒服多了
157636,1832,李峰,2022-06-24 07:20:03,3,3,0,李老师真的很好，对于重点强调很到位，而且上课很有激情容易让大家专注。平时分的话，小测是开卷，而且都是作业原题，只要作业认真做基本都能接近满分。这门课的分数都是定死的，不存在什么主观的给分空间
158014,1832,李峰,2022-06-26 08:06:56,-1,0,1,这学期java和C++一起学，相得益彰
158394,1832,李峰,2022-06-29 03:18:44,-1,1,2,朵朵上慕名而来，会给学生手改理论题把卷面分数往上捞的老师
158508,1832,李峰,2022-06-30 01:51:57,1,1,0,哈哈哈
158540,1832,李峰,2022-06-30 05:46:40,0,3,3,回复一下下面那个关于改卷面的评论，是因为那场题目存在一题多解的情况，而且也不只有这一个老师改了，同一场次的都改了。下面说正事，老师真的很不错很不错，无论是上课还是给分，不应该只有这个分，满了！
158544,1832,李峰,2022-06-30 06:57:34,4,5,1,李峰老师讲课很清晰很详细，没有跳步，每一点都讲清楚了，对小白很友好，感谢老师！\n\n最后的分数也在预期内，挺ok的
158545,1832,李峰,2022-06-30 06:55:54,-1,0,1,挺好的事
158551,1832,李峰,2022-06-30 07:31:52,2,2,0,给分一般
158685,1832,李峰,2022-07-01 09:30:24,1,1,0,讲课蛮认真的，给分也还行，值得推荐
159454,1832,李峰,2022-07-21 07:01:17,2,3,1,老师真的负责认真
164922,1832,李峰,2022-12-27 15:50:42,4,6,2,钉钉上找他问个问题，他语气能给你整的再也不想问他问题，还有那个助教于嘉伟，是没气了吗？群里有人问问题你从来不回答，从来没冒过泡，要你有何用啊，同学能在群里问出“助教是谁”这个问题你真的不要好好反思一下吗，无语了。还有那个office三剑客作业，有很多同学在群里问文本怎么办，lf和助教都跟蒸发了一样，是不会回答问题吗，还得靠同学自己互相解答，极品老师和极品助教真是诀绝子，如果还能再选一次不会再选lf了
165194,1832,李峰,2022-12-30 03:43:09,3,3,0,lf老师就是djj的天花板！！！老师讲课很清晰，而且课后问问题也会即使回复，至于楼下说的助教问题，没接触过不知道。
165326,1832,李峰,2023-01-01 02:17:54,2,4,2,已 读 不 回
165993,1832,李峰,2023-01-10 15:48:03,3,3,0,老师讲课讲的还是蛮细的，但感觉他的鼻音和较快的语速确实可能会让我上课不怎么打得起精神，而且感觉布置的作业都很合理，都会留足充分的时间来做，还是不错的一个老师。
166215,1832,李峰,2023-01-11 12:34:02,1,2,1,给个十分求不挂…
166403,1832,李峰,2023-01-12 07:23:29,1,2,1,希望lfgg能在djj改革的现状下给个不错的分
166507,1832,李峰,2023-01-12 12:48:40,0,4,4,千万别耽误他时间，尤其是别给他电话（紧急情况也不行），他每天都处于一个“焦头烂额”的状态。脾气差得很，私下里与多交流几句就知道这人有多自私了。（以上均为本人对李峰老师的主观评价，如果课后没被恶心到不至于给低分）
166615,1832,李峰,2023-01-13 04:14:23,3,3,0,大计基，老师只在小测那节课点名，平常不去也行。感觉期末考考的很差，老师还是挺能捞的，把我捞到那档的最高分领取，我很满足了
166617,1832,李峰,2023-01-13 04:22:01,4,4,0,老师挺好的，可惜绩点有点低
166682,1832,李峰,2023-01-13 08:23:20,1,1,0,楽 楽 楽
166686,1832,李峰,2023-01-13 08:32:09,0,1,1,老师还挺好的，上课一般不过讲的挺清楚的，给分还不错。但是大计基这门课就是杂七杂八的作业多事情多挺令人无语的。
166743,1832,李峰,2023-01-13 11:42:00,7,7,0,没有和老师私底下交流过，起码上课的时候都感觉是个性格不错的老师，事情比起某jj老师也算少的了，而且据我所知，我们平时pta的作业比我一些社科朋友的都友好一点，也没必要觉得老师给分不好吧，感觉这种学科就是看你有没有好好学，djj改革后成绩应该也更能反映大家学习的认真程度，本人高中没选技术，就学过两个学期，自认为是个编程白痴，平时也不会听课（有空会智云三倍速刷一遍让老师的话过一遍脑子），但是考前都有在好好复习整理知识点，不过课本是几乎不翻开，py靠作业题和百度自己摸索，最后绩点4.5也很满意，本来就是抱着拿3.9或是4.2的心态的。总之不要太敷衍作业按时交考前认真复习不会低分吧
166755,1832,李峰,2023-01-13 12:32:12,2,2,0,老师挺好，上课会划重点，每节课会复习上一节课的内容，思路清晰，上课也不枯燥，作业也不多，大计基几乎没有花多少时间，都是小测大考前一个晚上临时抱佛脚，最后给分也还行，4.2
166765,1832,李峰,2023-01-13 13:26:23,3,3,0,djj，老师课讲的比较清楚，而且相对于其他老师在临近考试的时候布置一堆莫名其妙的作业而言，李峰老师的作业量和布置时间已经是相当合理的了，最后给分也不错。
166873,1832,李峰,2023-01-14 04:33:22,4,4,0,给分不错，但回想好像主要还是靠自己复习……反正有次上课迟到30分钟后仍然给我签上了到，评个高分吧
166876,1832,李峰,2023-01-14 04:37:07,1,3,2,老师挺负责任，上课讲的挺有条理，不过大计基还得靠自己慢慢体会
169178,1832,李峰,2023-02-24 13:52:30,-2,2,4,老师很负责也很会捞😍
169612,1832,李峰,2023-02-27 06:18:35,0,3,3,老师讲课很有条理很容易懂，尤其是python那块讲的很清楚，给分也不错的
170121,1832,李峰,2023-03-01 11:59:05,-3,5,8,私下里太傲慢了。。。
171628,1832,李峰,2023-03-30 09:14:25,-2,1,3,老师的讲课水平真的感觉一般般，大计基基本靠自学，最后绩点3.9，没达到预期但也还可以吧
171767,1832,李峰,2023-04-04 11:25:22,2,2,0,作业挺少的，适合摸鱼
173866,1832,李峰,2023-06-04 02:36:40,10,11,1,计科A作业确实有点多，python还是他，相比于其他老师作业很少了，而且很温柔宽容，私聊略显严肃，可能心思不细腻，不太擅长网络交流，小测前会多次叮嘱，上机课无签到，此外，很帅！！！总之，上完大计基，我可能只能给5分，现在在上python，我给了10分
174523,1832,李峰,2023-06-13 15:20:18,9,9,0,上课比较认真，会数字点名，会用很多时间回顾上一节课的内容，事务通知水平也比较高
174901,1832,李峰,2023-06-19 13:08:56,10,10,0,真的是一个很好的老师！\n\n连续两个学期，跟着他学了大计基和python。刚开始觉得他讲课有些吐字不清，还私下里调侃过他的口头禅“看黑板里面”。但是上了好多节课以后，感觉老师讲的真的十分清楚，只要认真听，一定能听懂，而且第二节课会复习上节课的内容真的很有帮助。虽然可能对于作业（PTA）的时间有些严格，但是这个是作业，在ddl之前完成也是应该的吧。再说说小测，python都是pta的原题，虽然闭卷，但是有复习的方向，把作业做好，基本能拿满。老师平时看起来有些严肃，但是到了最后一节课，看到老师微笑着说“感谢同学们的陪伴，祝愿大家期末考出好成绩”的时候，真的感觉十分不舍。
175890,1832,李峰,2023-06-27 05:19:02,4,4,0,值得十分
176119,1832,李峰,2023-06-28 00:46:51,9,9,0,各种通知落实的很到位，深怕我们错过，很负责。\n\n每节课前都会带领我们回顾前一节课的知识，而且讲新知识的时候也很细致，有提醒我们哪些知识点需要着重关注。可能讲课速度会有点快，但在授课知识方面绝对是很踏实的，不会照本宣科！\n\n上课会签到，但都会反复提醒，有时候同学上厕所回来还会特意提醒签到hhhhhhhh。\n\n总体而言老师是不错的，值得选（虽然python课还是要靠自己）。
177328,1832,李峰,2023-07-03 02:28:04,9,10,1,Python\n\nlf老师能捞的空间很小（只有平时分，自己算了一下老师给我平时分捞满了），最主要还是看自己的努力。讲课绝对的一流水准
177334,1832,李峰,2023-07-03 02:51:55,9,9,0,李老师讲课的时候会一直提醒抬头看黑板，每次听到都会条件反射地抬一下头hhh。可能对于0基础的同学来说老师语速偏快，但总体是不错的，课前会回顾上节课的内容~实验课第二题太紧张没做出来最后都有4.8，超级感谢李老师！
177346,1832,李峰,2023-07-03 03:23:40,5,5,0,老师人挺好的，虽然Python学习大部分时间靠自己看PTA
177359,1832,李峰,2023-07-03 04:13:43,4,5,1,是我太菜了，感觉老师好求是。。平时分也没调
177400,1832,李峰,2023-07-03 06:48:40,3,4,1,讲得好 给分求是 10分吧
177772,1832,李峰,2023-07-04 20:26:51,3,4,1,上完lf老师的课，彻底感慨wjj的c小是多么答辩
177867,1832,李峰,2023-07-05 06:47:31,3,4,1,老师不好捞，但很好，是我太菜了
178102,1832,李峰,2023-07-07 02:43:29,3,6,3,老师人很好，但前面说老师把平时分捞满的是认真的吗..？我算了一下平时分被扣了二十多分，作业什么的都及时交了，每次小测也都去了，总之挺求是的
180566,1832,李峰,2023-09-23 02:29:11,2,3,1,上了老师的Python，语速较快，但是也很细致，认真听就能学好
181634,1832,李峰,2023-10-25 02:58:00,7,8,1,很负责任的老师
181738,1832,李峰,2023-10-30 10:59:33,-4,3,7,？？？
184608,1832,李峰,2023-12-22 02:44:10,-12,5,17,gosh
185092,1832,李峰,2023-12-26 07:06:33,16,17,1,对PTA、学在浙大作业、考试等事情的通知叮嘱很到位\n\n关于点名，规律其实非常好把握（
186540,1832,李峰,2024-01-12 01:08:06,17,22,5,真心感觉lf老师是超级负责任超级棒的老师，希望不要因为bhh一厢情愿乱搞教考分离让lf老师讲的东西全都白费
186554,1832,李峰,2024-01-11 16:30:25,14,14,0,不会捞你
188296,1832,李峰,2024-01-19 07:12:01,20,26,6,求是的李峰老师，\n\n你家大计基均绩哪来的3.8？？？？？？？\n\n有2.8吗 有吗有吗有吗？？
188489,1832,李峰,2024-01-19 05:36:08,14,14,0,很求是的老师 不捞人
188498,1832,李峰,2024-01-19 05:47:26,-8,4,12,很捞很负责，回答问题很耐心，但是建议没有python和计算机基础的同学额外好好花时间自学（不过大计基已经大结局了），最后4.5，入坑不亏
188979,1832,李峰,2024-01-21 04:08:07,-9,3,12,分拿到了，给个10分庆祝一下
189060,1832,李峰,2024-01-21 14:00:09,-3,5,8,老师人很好
189086,1832,李峰,2024-01-21 15:33:52,0,4,4,还行吧，讲得挺好，给分比较求是
189961,1832,李峰,2024-02-03 23:58:02,3,6,3,给分求是，讲课挺不错的，对教学富有热情
190314,1832,李峰,2024-02-28 02:14:43,7,8,1,老师很负责，但是最后绩点杀我，可能是我自己的问题😢
190604,1832,李峰,2024-03-11 11:06:41,-9,6,15,真心拉跨，上课效率低，态度也巨差
194150,1832,李峰,2024-06-22 08:44:33,2,3,1,别挂我求你了
194334,1832,李峰,2024-06-23 08:55:43,1,2,1,数字点名\n\n怎么还不出分，怎么还不出分，怎么还不出分！
194357,1832,李峰,2024-06-23 10:40:33,-2,0,2,老师语速偏快，理解能力差的或者容易走神摸鱼的慎选。而且老师也有点冷漠。。。不过讲的内容还可以。希望他给我把分打高点。我先给老师评个高分了球球老师高抬贵手
194422,1832,李峰,2024-06-23 22:58:39,4,4,0,我第一次在大学碰到提醒上课不要玩手机的老师。讲课讲的也很棒，老师人很好，十分推荐选。
194424,1832,李峰,2024-06-23 23:51:02,4,4,0,很捞很负责，签到的规律也很好总结。讲课很认真负责，会把重要信息抄在黑板上。真的很好很用心的老师！
194437,1832,李峰,2024-06-24 02:46:49,2,3,1,很认真负责的老师，上课因为内容多讲很快但会演示例子，没被卡绩
194446,1832,李峰,2024-06-24 03:16:57,2,6,4,这学期学了他的python，讲课特别特别快，有五次数字点名，上机课可以不去，但是作业不能补交。期末理论考试纸质考，斩杀线45我考了44，还是被斩了，没有捞起来，实验考也考过了，小测每次也是七八十，签到每次都到了作业也每次都交了，还要因为这门课担心自己的毕业。。哎。。
194447,1832,李峰,2024-06-24 03:28:11,2,3,1,感谢李老师不挂之恩
194484,1832,李峰,2024-06-24 06:06:22,3,4,1,感谢老师不挂之恩！！
194590,1832,李峰,2024-06-24 13:23:34,1,2,1,老师讲课比较快，但是具体例子的讲解都是很细致的\n\n如果上课走神摸鱼可能会觉得很难适应\n\n点名课上可以补签，错过不可以补签\n\n捞人不好说不清楚
194658,1832,李峰,2024-06-25 01:36:49,6,7,1,今年Python真的好难 感谢老师不挂之恩……\n\n数字点名 老师讲的很细致认真但是学Python实在太容易走神（？？ 老师喜欢冷不丁说“看黑板这里！”hhhhh
195091,1832,李峰,2024-06-26 18:05:43,3,4,1,老师上课确实挺枯燥的，但是如果肯硬下心认真听的话个人感觉在期末和机考上不太会出现特别大的知识盲区（完全不会做的那种）。当然，这可能跟本人是浙江学生，高中学过python相关知识有关（学考生）。不过今年的期末确实恶心，小细节太多了，很容易就翻车了。
195665,1832,李峰,2024-06-29 10:08:06,3,4,1,讲课语速很快，需要有一点python基础，没跟上的同学会感觉在听天书。但自认为跟的下来的话，还是讲的很好的，考点全覆盖。还是有一点点捞的，感觉自己被捞到上一档的下限了
196747,1832,李峰,2024-07-05 03:05:43,3,4,1,人很温柔耐心，是一个特别认真负责的老师。但卡绩了www
197601,1832,李峰,2024-07-21 02:01:42,1,3,2,上过他的计基和Python，都上4了，讲课很投入，至今很不舍
199830,1832,李峰,2024-10-01 01:24:32,0,1,1,很不错的老师
200898,1832,李峰,2024-10-24 07:07:26,8,9,1,在上老师的计基A。老师很认真负责，讲的很详细但速度比较快（也有计基A课时太少的原因在吧），会提醒上课不要玩手机，作业给的时间比较长，题目量正常，给分情况暂时不知道。计基A速度快内容相对比较多，部分内容需要课下自己看视频补（但这部分好像只有作业不考试?记不太清），作为高中学过技术的第一章跟得也有点吃力，后面还好。建议本身课业就比较满的或者计算机基础不好的同学慎选
201969,1832,李峰,2024-11-08 00:54:02,11,11,0,你说得对，但是看黑板边
204884,1832,李峰,2024-11-28 09:53:32,5,6,1,有一点催眠
206770,1832,李峰,2024-12-17 12:51:46,0,0,0,很认真很细致，认真听有很大的收获
207107,1832,李峰,2024-12-19 09:19:47,0,1,1,非常好的宝藏老师，赶紧报名！
208172,1832,李峰,2024-12-26 04:55:23,0,0,0,py：\n\n理论课：会数字签到几次，然后讲课方面确实略微快，最后有一整节课复习，建议有一定基础的人选他的py会好一点。老师人非常善良，问问题非常耐心。但是会提醒各位上课不要玩手机（虽然你可以偷偷玩）总的来说真的不错\n\n上机课：随便翘
209250,1832,李峰,2025-01-12 06:45:23,7,7,0,省流：\n\n1.自学大计基的一学期（作业和上课讲的部分分离，当然大计基这课本来就这样，希望接下来uu们做好准备）\n\n2.真的不捞，需要绩点的同学慎重考虑（转专业和要保研的别来）（那些评论说好的都是C尖C小和python，当然捞你是情分，不捞是本分，只是客观评价）\n\n3.回复很快，认真\n\n4.上课很催眠（下午班）\n\n5.讲的还是可以的（有问题可以朵朵搜一下大计基仙人，建议考试的话python和霍夫曼码好好看一下）\n\n6.如果选上该老师的课：（经验之谈）请认真做作业和小测，因为占比比较多，否则就算期末考好了也很难受（因为平时分不捞）\n\n真心希望能帮到同学们，祝uu们都能拿到好成绩
211160,1832,李峰,2025-01-11 02:54:38,4,6,2,计算机科学基础A，为什么不讲考试要考的啊😊
211648,1832,李峰,2025-01-12 06:02:51,0,0,0,老师讲的知识点很多，但是这次djj可能不是老师出题，考点有点错过（在最后一节复习课上提过一遍，但是练习不多，也没有强调）。总体来说还是很负责的老师，只是同学们的作业分都太高了吧
211771,1832,李峰,2025-01-12 11:22:53,0,1,1,很好的老师，本人一点计算机基础🈚️，本来还在担心python会挂科，结果竟然上80了很开心
211816,1832,李峰,2025-01-12 14:38:51,3,4,1,大学计算机基础A\n\n1. 上课会点名，感觉需要全勤。\n\n2. 上课基本上是按照教学方案来，个人感觉还算清晰有逻辑。也有可能是因为作为浙江考生有相关基础。\n\n3. 教考分离好像是因为这门课教改了，期末考试是另一个老师的风格，lf老师是有讲最后考试内容和提供相关资料的，不过是最后一节课讲的，讲得不多吧。\n\n4. 上课会说不要看手机，看黑板之类的，个人不太在意。\n\n5. 听说老师不太捞平时分，比较求是。个人四次阶测，两次84，两次95，平时作业一般般水平，期末个人感觉还行，最后4.2，仅供参考。\n\n6. 作业给的时间比较长，每次几十道题的样子，个人感觉不算特别多。\n\n7. 会给PPT。
211902,1832,李峰,2025-01-13 01:28:45,6,7,1,大计基的内容相当逆天，教考分离。老师是好的，不捞但课讲得还行，如果你高中选考技术，说实话期末考试还是比较简单的，不过这门课如非必要别选。
213896,1832,李峰,2025-01-21 08:58:30,0,1,1,大计基A秋冬学期出分来评\n\n1点名：每次小测前会数字点名\n\n2上课：因为我是浙江考生，学考考过信息，所以感觉除了第一章之外，内容不算难。老师上课很认真，就是语速太快，我仗着自己有点基础，没有很认真在听（辅以微积分作业）。可以听懂的。但是没有浙江学考基础的话，Python那块绝对是难的。楼下一些说考的内容上课没讲的，其他大计基应该课上也没讲hhh  不过善用搜索可以知道去年也考了霍夫曼编码，可以自学一下（虽然我没有去 摆了 导致整道题是蒙的）不是老师的问题啦（要怪就怪出题的小白老师bushi）\n\n3小测：考的都是作业题里的，而作业也不算多。小测之前把作业题过一遍完全没问题，基本可以满分。\n\n4给分：都说李峰老师求是，但我对这个分还算满意，毕竟一个高中文科生，上课也没好好听，考前复习一下拿这个分对我来说也不错了。个人感觉没什么落差，可冲。\n\n5李峰老师很帅，可以看出年轻时候是那种硬帅的类型😋\n\n楼下补药骂老师了！老师挺好，是大计基的问题～
214894,1832,李峰,2025-02-19 03:05:42,0,0,0,Python……\n\n讲课好快好催眠\n\n给分还行
216162,1832,李峰,2025-03-11 09:41:35,1,1,0,py\n\n首先他会点名，在课上数字签到，但是上机课来不来无所谓，不会点名\n\n其次，讲课比较快速推进，作为浙江学考生，如果认真学考的话，那是非常简单就能听得懂的，这门课期末考的难度远远不及浙江省信息学考\n\n最后，老师人很好，上课会提醒你不要玩手机，但是偷偷玩没问题
220029,1832,李峰,2025-06-13 17:01:55,-1,0,1,py\n\n还没考先来评一下，老师前面会讲的稍快，只要前面跟住后面会很轻松，老师上课很认真，讲课不拘于PPT，会适当进行拓展（所以能到课尽量到），当然定期数字点名也可智云，课上会打开编程用程序展示，这学期的小测比较简单，但老师会监考不让看书，比其他班提前，能为其他科复习留时间，总之想学到东西的同学可以放心冲
3537,1869,邱劲松,2015-06-17 01:29:44,-10,3,13,讲得很清楚
70146,1869,邱劲松,2018-01-26 07:22:10,-1,4,5,。。
72733,1869,邱劲松,2018-01-31 03:58:44,-8,5,13,计网两次quiz只要到了就满分。平时实验只要认真做实验报告认真写就可以满分。只要你平时都有在做，平时分肯定是满的。最后绩点还是看期末，这门课一般不调分，所以想拿高分的话期末一定要好好准备。平时讲课的话老师还是挺好的，时不时会开个玩笑，课堂气氛也蛮轻松的。总之好老师！
74494,1869,邱劲松,2018-03-03 06:52:25,0,3,3,期末不调分伤不起阿。。。老师是好老师没错，嗯。
75871,1869,邱劲松,2018-03-20 10:31:30,-4,1,5,好老师，就是语速有点快，一不注意就跟不上了(눈_눈)
81736,1869,邱劲松,2018-07-06 04:42:17,-1,3,4,求不挂(╥﹏╥)
85807,1869,邱劲松,2018-08-15 05:13:08,-7,3,10,quiz挺多，但是个对学生负责的好老师，给分也好
94689,1869,邱劲松,2019-01-18 00:19:12,5,8,3,明确说了平时分不会给满
111167,1869,邱劲松,2019-06-30 07:43:28,-3,4,7,讲课很清楚
121847,1869,邱劲松,2020-01-22 12:45:34,-5,2,7,占坑一波
121963,1869,邱劲松,2020-01-26 06:48:48,24,26,2,给分不怎么样，也不知平时8次quiz被扣了多少...
132308,1869,邱劲松,2021-01-31 15:43:54,24,26,2,实验给分就离谱，八个实验每次都认真做了，最后光实验就扣掉两档。。。别的班lab8都是bonus，而且前面的实验有很多也是小组完成，我们班就lab2 lab7是组队完成，费力不讨好。吐了。。。为啥这样还能有8+的评分...
132538,1869,邱劲松,2021-02-02 06:58:37,28,29,1,平时分给的很差
132781,1869,邱劲松,2021-02-03 14:29:13,22,29,7,统一回复各位同学的问题：\n\n1. 每个教学班的老师对平时成绩的构成和评价标准有独立的自由裁量权，不宜进行横向比较。\n\n2. 反馈问题应仅限于对本人的成绩判定结果方面。根据反馈意见的处理结果已和本人沟通，结果不再更新到作业系统。\n\n3. 作业总评若在4分以上均计算为满分（结果不再更新到作业系统）\n\n4. 实验评价有不少同学是满分或接近满分的，不能因为本人的评价不高，就轻易得出本班整体评价低的结论。做实验的目的是获取知识，而不少同学只是按照模版机械的进行实验，没有认真地思考和总结，在实验分析部分就暴露出来对实验原理的认识不足。需正确对待评分结果。\n\n5. 某些同学Quiz做的好，就希望Quiz部分占比高点，某些同学实验做的好，就希望实验部分占比高点，这都可以理解，但是这些要求是相互排斥的，不能只为提高本人成绩而进行申诉。不同的班级，计算平时成绩的规则略有不同，这是正常的。\n\n6. 中间计算过程保留小数，最终结果会四舍五入。\n\n7. 反馈截止时间已过，不再接受申述，最终成绩将提交到教务系统。\n\n以上是他出成绩前发到群里的，诸位学弟学妹细品，慎选吧...
132792,1869,邱劲松,2021-02-03 15:31:47,27,30,3,给分可以用神经病来形容，lab跟别的班相比不能组队，大部分都要一个人完成，工作量大而且给分很差，\n\n辛辛苦苦一学期到头来平时分扣一大片，真的很无语，期末考考到的很多东西上课根本没讲过，对学生的态度也不好\n\n总之不要选，快跑\n\n！！！！！！！！！！！！！！！！！！！！！！！！！！！！！！！！！！！！！！！！！！！！！！！！！！！！！！！！！！！！！！！！！！！！！！！！！！！！！！！！！！！！！！！！！！！！！！！！！！！！！！！！！！！！！！！！！！！！！！！！！！！！！！！！！！！！！！！！！！！！！！！！！！！！！！！！！！！！！！！！！！！！！！！！！！！！！！！！！！！！！！！！！！！！！！！！！！！！！！！！！！！！！！！！！！！！！！！！！！！！！！！！！！！！！！！！！！！！！！！！！！！！！！！！！！！！！！！！！！！！！！！！！！！！！！！！！！！！！！！！！！！！！！！！！！！！！！！！！！！！！！！！！！！！！！！！！！！！！！！！
132794,1869,邱劲松,2021-02-03 15:56:09,15,18,3,老师上课在计网老师里面算是比较清楚的 也会回答各种问题 冬学期每周都会有quiz\n\n但是老师明确说了一点也不调分 8次lab也没有其他班有的bonus(其他班认真做实验都满了) 实验五分制打分 扣一分就没了那次的20%（实验占总成绩35%）我们班平时实验扣分比较少的也扣了总评中的3-5分(等于说给分和其他老师平均有1-2档的差别)\n\n如果想认真学计网而且没那么在意成绩的就选吧 别的就逃吧
132817,1869,邱劲松,2021-02-04 00:47:06,-28,5,33,这么优秀的老师就因为自己得分低被说得这么不堪\n\n你们有上过其他班老师的低质量课程吗？有认真思考过自己的实验吗？\n\n知道其他班真实的得分情况吗？
133010,1869,邱劲松,2021-02-06 06:30:39,-3,5,8,讲课不错，lab给分比其他班级低很多
147559,1869,邱劲松,2022-01-10 08:23:46,-2,4,6,邱老师人挺好的，我每次问他奇奇怪怪的问题他都会回答我。lab只要认真做了基本都给满了。给分都是公式算出来的，没啥好说的。上课也挺幽默的，虽然我会听不过来。
147736,1869,邱劲松,2022-01-10 15:05:45,-6,2,8,感觉邱老师今年实验给分好了不少。讲课蛮幽默也蛮清楚的，平时也就是比其他班多了一个lab而且lab不能组队（不过讲真计网的lab组不组队真没啥区别）。老师应该是听了同学们往年的意见不压平时分了，人挺好的。
147929,1869,邱劲松,2022-01-11 07:25:09,-7,2,9,感觉邱老师人蛮好的，平时问一些问题都会耐心回复，平时分给得也很好，lab只要是自己认真完成了基本不会扣分（身边几个人lab都满了），讲课怎么样应该要看是不是喜欢他这种风格吧，总体来说还是能讲清楚的
148137,1869,邱劲松,2022-01-11 15:04:11,-5,2,7,这学期老师平时分给都挺好的，虽然平时quiz和作业要求比较高，但是lab只要认真做了基本都给满了，上课讲的也很好！
149764,1869,邱劲松,2022-01-16 23:13:03,-1,4,5,这学期实验分给分好了很多，实验答的马马虎虎最终老师也给满了，其他的作业和小测则是做多少给多少\n\n最后还是谢谢老师
167450,1869,邱劲松,2023-01-16 10:50:19,-3,4,7,22的评论都是准确的，上课的话老师是认真上的，风格喜好可能因人而异，然后今年实验30分也容易满，作业5分小测15分是求是的，考试很多老师作业小测类似题，总之谢谢老师了
168707,1869,邱劲松,2023-02-21 09:22:09,4,5,1,。。。
185535,1869,邱劲松,2024-01-02 04:10:16,5,8,3,8次小测，每次时间都很短
187527,1869,邱劲松,2024-01-16 12:32:57,3,6,3,老师不点名，但是冬学期每节课都小测，平时分老师不会捞多少（指quiz捞高5%），但是普遍quiz都比期末差，印象贼深，最后一次quiz8，15分钟，10道选择加两大题（每道3小空这样子），相比别的老师师生情还是淡了些（狗头保命）
189272,1869,邱劲松,2024-01-22 17:38:07,13,13,0,快跑啊
201630,1869,邱劲松,2024-11-05 03:50:26,25,25,0,讲课差，实验多，要求乱，给分烂，小测繁，不知道相比计网其他任何老师哪怕有一个优点？六边形战士，不过是缺点的
201717,1869,邱劲松,2024-12-12 07:41:27,61,63,2,lab7 socket 逆天了 没想到还有一个lab8☝🤓\n\n更新：2024秋冬学期开始前 査老师评分8.2\n\n截至2024.12.5 査老师评分5.44 ☝🤓\n\n二编更新：截至2024.12.12 査老师评分4.99☝🤓
201779,1869,邱劲松,2024-11-06 07:18:52,31,31,0,邱讲课，不仅ppt做的烂，讲课还一点重点没有，又快又啰嗦，一个人在那里叨叨一上午，没一个人听的下去，就是他在那里自嗨。。。\n\n小测每次题又多时间又短，还不给调分，第一次考试有人不熟悉也不给调，最后期末给分求是，上他班的总评都一起扣。。\n\nsocket实验要求又臭又长，狗屁学不到，就加那个私人要求，自己做过吗就在那里瞎加，典型的只管提要求不管实现，让这种人当了领导老板，一个学校公司就永无天日了！自己没点b数socket有多恶心还要求8个实验都做，别的班都只做6个，真是逆天了
202313,1869,邱劲松,2024-11-11 13:24:37,17,18,1,事多分少，快跑，快跑啊。
202373,1869,邱劲松,2024-12-17 11:55:34,28,28,0,每次做你那比小测和实验的时候都想给你来一拳
203289,1869,邱劲松,2024-11-19 02:38:56,14,17,3,为什么这么多小测啊啊啊啊，做不完
203460,1869,邱劲松,2024-12-09 14:19:52,23,25,2,😅😥😢😰😭
204128,1869,邱劲松,2024-11-24 13:38:33,19,21,2,逆天lab8目测又要私募了，比别的班多加两三倍构式要求。。。坐等一波狂掉评分
204456,1869,邱劲松,2024-12-21 12:55:16,47,49,2,跑就完了，事太多了讲课也依托，lkj虽然人比较逆天但是实验quiz少啊，这位是实验8个强度拉满，quiz每周都来一次，作业永远不能补交，太难蚌了！！！！！！！！！！！！！！！！！！！！！！！！！！！！！！！！！！！！！！！！！\n\n\n\n燕飞们，我是孩子的爸爸。
204457,1869,邱劲松,2024-11-26 04:27:44,23,24,1,拿研究生入学考试当十分钟小测不调分的神人老鼠
204547,1869,邱劲松,2024-11-26 14:38:24,23,25,2,你妈妈死了，废物东西，加量加你妈了个逼的量啊？工作量是别的班两倍，分数也要比别的班少两档是吧？也祝你全家的寿命比别人少两倍捏
204661,1869,邱劲松,2025-01-20 02:17:16,81,87,6,我真服了，怎么到你这事情就这么多？\n\n上课只会无脑念PPT，讲的什么东西也不知道。你看看有人听吗你就在上面叽里呱啦讲一大堆。还有那个逼小测，先不说你每周搞一次，那小测题目类型见都没见过你就往上面放，还整一个研究生考试题目恶心谁呢？每次小测时间又短，题目只能交一次不能修改答案，真是纯纯拿平时分恶心人的玩意。最后是那个勾使实验，别的班做6个就行了，就tmd我们班8个全做，里面的勾使要求还被你超级加倍，老子做一个gns3都被里面灵异的bug整的痛不欲生，实验的量还被你翻了好几倍。上课是枯燥的，小测是频繁的，实验是加量的，真是花最多的时间，拿最低的平时分。\n\n\n\n我是考古学家，这旧世纪吧。\n\n我是汉语言学家，这就是简笔。\n\n我是虚构史学家，这就是构史。\n\n\n\n出分了，傻逼玩意，我操你妈的你这种畜生也配教计网？老子他妈花大把时间在你这恶心至极的小测和实验上，结果你告诉平时分就这分数？上课明确说了小测会调分，你个SB到最后一点也不调，知不知道你那个b小测系统有多恶心？还小测越多平时分越高，我操死你的亲妈好不好？实验报告不写心得体会就要扣分，是不是老子非要在心得体会里面骂你几句才满意？逼养的玩意，畜生的东西，赶紧去死别恶心我们学生了。\n\n如何分辨狼和狗？看需求，求安逸是狼，求惊悚是狗。\n\nHow do you test wolf and dog? Look their children， children daughter is wolf， children son is dog.
205092,1869,邱劲松,2024-12-01 09:14:59,18,20,2,实验tm又多又臭
205167,1869,邱劲松,2024-12-02 10:42:10,21,22,1,牢邱我阐释你的梦，司马实验这么多。小测还必须要点提交保存答案不行，就给这么一点时间。讲课只会念PPT你也不看看有没有人听。
205168,1869,邱劲松,2024-12-12 14:06:54,21,22,1,老师，既然实验这么多，我相信你实验分给得会很好。
205212,1869,邱劲松,2024-12-03 02:30:12,23,24,1,这狗砸中的b小测没一个不抽象的，讲实验8还好意思说socket只实现了很简单的功能，是不是给你脸给多了啊，燕飞耐撕了
205568,1869,邱劲松,2024-12-09 09:17:30,18,18,0,大家千万别选。讲课犹如念经，没有一点听的兴趣，实验次数比别人多，还自己加了大堆要求，冬学期每周都小测，题目也不简单。事多分少。
205575,1869,邱劲松,2024-12-09 11:15:14,24,26,2,我草你妈，为什么xht班实验实验比我们少两个，然后同样的实验我们的量还是别人的两倍？别人课改是删东西，到你这就是加东西是吧，不如去给你妈骨灰加点鸡精吧
205580,1869,邱劲松,2024-12-09 14:18:45,20,20,0,孩子们快跑，遮沙避风了😰
206284,1869,邱劲松,2024-12-13 14:11:01,23,24,1,不是，你还好意思说lab8临近考试缩减工作量？？？别的班只需要静态文件显示，为什么我们还要搞构式的fastCGI？？？要求也多的逆天，各种错误处理措施以及还有个定时器？？？那报告要求也不在一开始说清楚，后面再一个个加，报告截图也巨多？？？但凡你有一点体谅学生的心呢？
206491,1869,邱劲松,2024-12-15 13:40:08,18,20,2,qqq：计院毒酱疯的含金量☝🤓\n\n你不能只在每周二上完构式机王之后才想起来要给qqq刷差评
206519,1869,邱劲松,2024-12-16 12:29:50,16,17,1,哦耶哦耶，做最多的实验，拿最低的分
206539,1869,邱劲松,2024-12-16 02:46:12,14,15,1,lab8无敌了，搞出来一个√式的fastcgi，考试周一点复习时间不给是吧，上课一个人坐在前面叨叨叨一节课根本不管下面的人听懂没听懂，真无敌了
206597,1869,邱劲松,2025-01-20 01:18:25,21,23,2,先肯定一下，qiu回答问题回答得还是很仔细的。\n\n但是作业是比别的班多的，实验是比别的班难的，小测是冬学期节节课有的，期末考试出题是恶心的，平时任务量是别的班的两三倍，tm的最后一点不捞，诗人啊。
206611,1869,邱劲松,2024-12-26 02:21:54,16,19,3,拿考研题当小测，还猛猛限时，你无敌了
206612,1869,邱劲松,2024-12-16 12:34:46,13,15,2,如何分辨狼和狗？看飞雁，雁盘旋是狼，雁飞罢是狗
206643,1869,邱劲松,2025-01-26 05:53:06,40,41,1,师傅你是做什么工作的☝️🥸\n\n客观评价一下qjs：\n\n- 上课：内容很多，不是照着PPT念，可能需要额外课下时间去重新吸收，而且讲的比较快，有时候不太能跟上，有时候讲到一个点又会扯到其它的内容上去；上课是三节连上，中间的小课间从来不休息，经常出现10点不到开始上课上到十二点半或者更久，总体来说是很有内容但是容易讲的很乱不清晰，导致可能大多数人不太喜欢听他的课\n\n- 作业：6次小作业，都是在网站上\n\n- 实验：最不是人的一集，看24秋冬前的评论都是6次实验，这个学期突然黑化，8次lab全满，并且每个实验都超级加量，比如lab7的socket实验，常规来说其他班也是要做这个实验的，但是基本上只用实现TCP，但是牢邱班除了TCP还要实现UDP，还要实现什么天气预报系统之类的，而且实验报告也是难绷，听同学说如果实验报告里提一些建议还会倒扣分😅\n\n- 小测：8次小测爆改9次，从第8周开始测到期末，都在那个网站上做，每一题必须提交才能做下一题，不提交就没有你的答案了，并且提交后不能修改，时间非常紧，内容非常ex\n\n- 期末：24秋冬的期末是牢邱出的，具体含金量就看下面的评论吧，百题斩\n\n- 总评：无敌的存在，在平时分如此刁难学生的情况下还不调分，平时分可以比其他班低2-3档\n\n综合以上，你不难看出qjs的査老师评分是如何从8.2分一路跌倒1.4分的🥰🥰🥰
206785,1869,邱劲松,2024-12-17 14:10:25,13,13,0,牢邱唯一打赢复活赛的机会就是宣布一个lab占平时分5分🤓☝️😂😂😂😂
206914,1869,邱劲松,2024-12-18 11:38:38,22,24,2,孩子们别怕，quiz越多大家平时分越高🤓☝
206926,1869,邱劲松,2024-12-18 15:13:48,34,36,2,敬laoqiu\n\n任务堆成山，老师是闹弹，\n\n讲课似浮云，听懂属偶然， \n\nQuiz时间紧，实验多且繁，\n\n补交虽可行，扣分定难免，\n\n课件藏玄机，看懂需大贤，\n\n评分争下游，倒一也风流，\n\n你就这么干，未来更灿烂。
206939,1869,邱劲松,2024-12-18 15:07:56,17,18,1,"GPT如是说：\n\n这位老师真是让学生们""欲哭无泪""啊！从一片声讨中可以明显看出：\n\n念PPT的""高手""：这位老师上课依赖PPT念经式的教学方式，简直可以让任何热情满满的学生都昏昏欲睡。能在他课上保持清醒，简直要比完成马拉松还难！\n\n""折磨""专家：作业多得堆成山，小测频频出其不意地来袭，题目怪到让人头秃，实验多到让人想哭。他的教学风格简直是对""多劳多得""这一经济原则的极致挑战。\n\n评分""黑洞""：花最多时间，得最少分，平时分给得像在节食，严苛的评分标准简直让人怀疑这是不是某种高级的逆向激励。\n\n情感""破坏者""：学生们的评论充斥着挫败和不满，这位老师的教学方式和评分制度让学生既爱又恨，更多是一种被束缚的无奈和深深的无力感。\n\n""阴阳怪气""的正义使者：偶尔也有声音说他负责任，可能是孤狼中的忠犬，但这丝毫不影响他在大多数学生心中""魔鬼""的形象。\n\n总的来说，这位老师的课，简直是学生们的""噩梦""，成了学习路上那块绊脚石。要是考虑选课，建议三思而后行，否则，做好加入这场""苦难的盛宴""的准备！"
207071,1869,邱劲松,2024-12-19 06:33:51,13,15,2,Quiz 强度太大 Lab太多
207072,1869,邱劲松,2024-12-19 06:34:15,26,29,3,qjs的计网，socket编程实验和web服务器实验任务量比别的班翻一倍，冬学期每节课都有小测，小测难度大时间短，一道一道做过去一半都做不完，但我仍然喜欢这门课，因为我是m，就喜欢这种被折磨到死去活来不得解脱的感觉
207113,1869,邱劲松,2024-12-19 09:39:54,20,22,2,赤石，爽！赤石，爽！赤石，爽！赤石，爽！赤石，爽！
207334,1869,邱劲松,2024-12-20 13:39:44,14,15,1,lab和quiz安排过于逆天
207414,1869,邱劲松,2024-12-21 11:23:51,16,16,0,为什么没有0分的选项😅
207511,1869,邱劲松,2025-01-10 02:34:36,20,20,0,实验难得要死，作业无法补交，💩中💩\n\n补充:实验给分很不错，基本都是100或者98，但还是太难，没有助教和别的班体验差距极大，吓唬人的ddl也让人不爽
208434,1869,邱劲松,2024-12-27 14:21:30,6,6,0,。。。
208471,1869,邱劲松,2025-01-11 05:31:51,39,43,4,我有巨物恐惧症\n\n我害怕大傻逼\n\n\n\n\n\n朕刚复习的时候以为计网最大的敌人是物理层，\n\n看了物理层，\n\n又以为最大的敌人是链路层，\n\n朕平了链路层，\n\n网络层又成了复习的心头之患\n\n啊，朕收了网络层\n\n传输层和应用层，又成了计网的心头之患。\n\n朕现在是越来越清楚了，计网的心头之患不在外边，而是在qjs。\n\n就是在这qjs！
208506,1869,邱劲松,2024-12-28 13:17:56,12,14,2,8次小测8个lab写完不骂的是这个👍
210220,1869,邱劲松,2025-01-08 12:08:09,11,13,2,你是怎么做到短短一个学期从8分掉到3.08的。
210689,1869,邱劲松,2025-01-20 16:22:22,8,13,5,现在只有宣布实验分数溢出到平时分才能将大局逆转了🤓👆🏻\n\n——————————\n\n出分了，微微捞了1分没卡绩，总结一下：\n\n牢邱事情太多，平时分太求是，唯一的可取之处就是会很认真地帮同学解决问题。可以的话还是选别的年轻老师吧
211111,1869,邱劲松,2025-01-10 22:57:27,6,8,2,跑就对了，千万别选，就他事情最多
211115,1869,邱劲松,2025-01-10 23:26:16,9,9,0,没学过实验的得花三小时考前现学，你是这个
211116,1869,邱劲松,2025-01-11 00:27:43,31,38,7,致敬传奇神人牢邱，考前两小时发给大家一个29页的实验文档说考试内容涉及
211214,1869,邱劲松,2025-01-11 04:37:26,47,48,1,你应该向我支付学习计算机网络的费用
211215,1869,邱劲松,2025-01-11 04:39:55,28,30,2,不想斯文了    我直接开骂    喔超市你哥🐴
211216,1869,邱劲松,2025-01-11 04:40:16,24,26,2,牢邱太幽默了 净惦记你那b quiz是吧 你让别的班的怎么过😅😅😅
211220,1869,邱劲松,2025-01-11 04:45:14,19,21,2,吃大份去吧
211221,1869,邱劲松,2025-01-11 04:48:13,13,14,1,纯cs一个 煞笔玩意
211222,1869,邱劲松,2025-01-11 04:49:40,10,12,2,这真不算教学事故吗
211223,1869,邱劲松,2025-01-11 04:50:22,16,16,0,开根乘十复活母亲~
211224,1869,邱劲松,2025-01-11 04:50:37,11,12,1,出的什么屎题，公共课你能不能出点大家都有的东西
211228,1869,邱劲松,2025-01-11 04:53:01,12,12,0,TM牛魔出卷是爆改自己班小测的，实验是你们班做了就要考的，我日你妈的！
211230,1869,邱劲松,2025-01-11 04:54:37,14,14,0,部分老师缺乏职业道德
211233,1869,邱劲松,2025-01-11 04:56:29,4,7,3,你出的题？
211236,1869,邱劲松,2025-01-11 05:00:23,8,8,0,很会出卷，下次别出了。。。
211237,1869,邱劲松,2025-01-11 05:01:50,5,7,2,真逆天
211240,1869,邱劲松,2025-01-11 05:05:23,7,8,1,神人老师  我在考场上写着写着旁边突然多了一堆超雄哥摔笔摔卷子  不会出题可以找王道的人给你代出
211243,1869,邱劲松,2025-01-11 10:02:21,8,9,1,你个臭出生，傻逼玩意，你还不如墨索里尼，给你他妈的一梭子都不解恨
211249,1869,邱劲松,2025-01-11 05:19:14,6,6,0,考试纯纯恶心人
211251,1869,邱劲松,2025-01-11 05:22:09,11,13,2,这位老师主要训练的是：\n\n\n\n从大量无重点连续授课语音中提炼信息的能力\n\n在大量实验要求和截图中坐牢的耐力\n\n解决gns3和两个大程作业中出现的各种灵异bug的毅力\n\n在符合优势火力学说精神的替代点名的quiz中幸存的智慧\n\n不能补交作业所要求的提交时的守时态度\n\n\n\nu1s1，上它的课不会一无所获，也是能学到有用的东西的↑\n\n\n\n只是他今年期末考试命题时搞的操作过于迷惑（可以参考其他同学的评论），这下不得不与其他班同学站在统一战线谴责它了
211252,1869,邱劲松,2025-01-11 05:23:53,7,8,1,出题人是这个👍
211253,1869,邱劲松,2025-01-11 05:24:00,9,9,0,我很好奇这位老师户口本有几页 好难猜哦
211255,1869,邱劲松,2025-01-11 05:25:53,5,6,1,很好的考试😅
211257,1869,邱劲松,2025-01-11 05:35:18,2,5,3,ntm纯逆天。。。
211312,1869,邱劲松,2025-01-11 07:34:20,9,9,0,学期中恶心教学班学生，\n\n期末考恶心非教学班学生。\n\n学期中小测、实验、作业巨多无比，平时分乱扣.\n\n期末考出题《王道》基本0覆盖，全是lkj100题和班内作业小测题。\n\nwhat can i say？\n\n1分送上，祝牢邱评分早日收敛于1。
211323,1869,邱劲松,2025-01-11 07:54:00,5,6,1,传奇课程计算机网络，每个班实验不一样，牢邱最后出了一个12分大题实验在试卷上
211343,1869,邱劲松,2025-01-11 08:20:44,3,5,2,王道偏运动，qjs 的b题偏商务。
211352,1869,邱劲松,2025-01-11 08:32:27,4,5,1,每节课都点名小测，一学期十次期中考，作业没办法补交，大作业实验又多又长又臭，让他叫计网纯属折磨，助教也不找
211378,1869,邱劲松,2025-01-16 05:37:33,14,16,2,你出题客观了吗？统一标准了吗？傻狗
211398,1869,邱劲松,2025-01-11 10:21:46,4,6,2,逆天计网逆天老师，实验是教学班不统一但是要考的，考纲是考前三小时部分通知的，试卷是自己班quiz原题的，大题是没学过交换机直接送的，你是这个👍
211400,1869,邱劲松,2025-01-11 10:27:06,8,8,0,逆天，出的啥
211415,1869,邱劲松,2025-01-11 10:56:45,3,4,1,吃大份去吧
211416,1869,邱劲松,2025-01-11 10:56:49,6,7,1,star beat
211418,1869,邱劲松,2025-01-11 10:57:38,4,5,1,烂完了
211426,1869,邱劲松,2025-01-11 11:16:02,4,6,2,cs老师
211434,1869,邱劲松,2025-01-11 11:52:32,5,7,2,"""他们的知识都是从哪来的"""
211457,1869,邱劲松,2025-01-11 13:23:21,3,5,2,考试很恶心
211544,1869,邱劲松,2025-01-13 08:46:24,14,16,2,逆天玩意儿，考试这是给人考的?傻逼
211920,1869,邱劲松,2025-01-13 01:51:33,13,14,1,考试出的实验别的班做过吗？太会出题了
212412,1869,邱劲松,2025-01-15 06:34:59,7,20,13,致敬传奇出卷人牢邱\n\n实验是要有8个的，是要用自己写的库的，是要比别的老师要求难一倍的\n\n小测是要考考研题的，时间是只有10分钟的\n\n出卷是要出自己班小测的，是要出别人班没做过的实验的\n\n\n\n真无敌了
212592,1869,邱劲松,2025-01-14 08:57:16,11,14,3,sb老师天天惦记着你那逼交换机，怎么不把你母的骨灰也放到交换机里面交换一下。计网的题目出得更是一坨屎，真他妈逆天。
213549,1869,邱劲松,2025-01-18 07:14:44,6,7,1,事多分少没助教
213738,1869,邱劲松,2025-01-19 11:19:47,15,15,0,牢邱你🐎没了，课上明确说过会根据每次小测平均分调quiz，结果最后是一点没调，事多且分少。回家吧孩子，回家吧好不好，你适合做一滩狗屎，别出来嚯嚯学生了。
213746,1869,邱劲松,2025-01-19 11:41:53,9,9,0,快跑啊！！！！！！！！！！！！！！！！！！！！！！！！！
213760,1869,邱劲松,2025-01-19 13:45:50,11,11,0,小测真的一分没调，牛逼\n\n\n\n别的班就是做 qjs 的题，拿自己班的平时分，无敌了\n\n\n\n第一次小测因为这个狗屎系统没有自动保存，直接50分，没想到最后就变成了总评的1分了，老邱你妈妈没了
213761,1869,邱劲松,2025-01-19 13:41:27,4,5,1,快逃啊
213850,1869,邱劲松,2025-01-20 11:56:03,8,9,1,仅对老师的课程设置进行评价。\n\n实验比别的班多，要求比别的班多，冬学期每节课都小测。这其实都不算什么，但最后评分太求是了。\n\n很难接受明明做的工作比别的班同学多很多，考试卷面成绩也不比别的班同学差，但最后绩点反而低很多这件事呢。
213859,1869,邱劲松,2025-01-20 13:43:20,2,5,3,隔壁lxq班的，考前听qjs的智云，yysy牢邱课讲的是很清楚的，尤其是画图讲解，个人认为比xht和lxq讲的都好\n\n如果之后考试都偏离王道的话，其实最好是选xht/lxq，听牢qiu的课，只能说这老师没有师生情，慎选
214394,1869,邱劲松,2025-02-02 15:00:50,0,1,1,555
214706,1869,邱劲松,2025-02-17 02:24:06,33,33,0,你不能只在上计网的时候才想起给牢邱刷差评
218258,1869,邱劲松,2025-04-22 08:42:17,2,3,1,出题不经大脑
219878,1869,邱劲松,2025-06-09 14:36:15,6,6,0,如何分辨狼和狗？看需求，求安逸是狼，求惊悚是狗
222064,1869,邱劲松,2025-06-29 10:09:36,1,1,0,耷莎吡
16298,1877,吴飞,2016-01-17 23:43:03,18,20,2,虽然语气挺干的，但是人其实很幽默。也很重视教学质量。
17723,1877,吴飞,2016-01-20 18:00:39,6,7,1,很好啊\n\n
18404,1877,吴飞,2016-01-21 14:24:41,8,12,4,考完当天直接出分，老师给分超慷慨！妥妥满绩！
25331,1877,吴飞,2016-05-15 06:55:11,8,8,0,推荐图像信息处理。老师会介绍一些比较前沿的内容 所以值得学 也很有启发性。考试比较容易 虽然有些教学内容挺深奥的。老师人很耐心。
34395,1877,吴飞,2016-10-09 04:18:52,-21,1,22,课堂上公开指责章宏教授，惹人厌烦。
36909,1877,吴飞,2016-11-16 12:30:48,4,4,0,冷不丁地就语出惊人
37773,1877,吴飞,2016-11-21 02:52:52,-3,0,3,给分迷
39319,1877,吴飞,2016-12-22 05:30:55,2,2,0,获益很多
39926,1877,吴飞,2016-12-28 07:50:55,5,5,0,图像信息处理强推 老师人真的超级好 还会分享自己的经历 总之十分的可爱
39934,1877,吴飞,2016-12-28 08:16:05,54,56,2,有两个吴飞，一个计科，一个传媒
43574,1877,吴飞,2017-01-16 14:37:55,3,4,1,老师人超好 尽力给大家加分 有耐心 随和可爱！
54669,1877,吴飞,2017-06-30 03:50:49,5,8,3,老师是很好的，但是人工智能课的内容还有待改进，杂而不精，学来当通识，挺水的给分挺好的
67988,1877,吴飞,2018-01-22 12:19:11,7,7,0,图像信息处理，上午考完晚上出分。大家绩点都挺高的，是我太菜。老师人很好，上课很温柔，但是易睡着。
68024,1877,吴飞,2018-01-22 13:29:43,3,3,0,谦谦君子
69784,1877,吴飞,2018-01-25 11:28:34,1,1,0,完美，图像信息处理绝对好课
73764,1877,吴飞,2018-02-03 05:14:43,2,4,2,貌似科研能力超强
84053,1877,吴飞,2018-07-12 02:52:49,12,14,2,助教刘向宇给这么低的分还不让查分？
84062,1877,吴飞,2018-07-12 03:08:38,-2,4,6,以下言论不针对传媒学院吴飞本身。\n\n\n\n校园媒体实践\n\nnmsl
84095,1877,吴飞,2018-09-19 00:34:30,-22,1,23,想知道到底是得了多低的分才会这么说课程和助教啊？贵传院平常给分太好惯坏了吧？高分理所应当？
84120,1877,吴飞,2018-07-12 05:07:40,-5,0,5,马新观和校园媒体实践，吴飞老师的给分都不错，只要你作业认真诚恳有内容。但校园媒体实践中占40%的工作坊成绩，是由工作坊请的业界的老师打的，他们可能要求都比较高（哭了）。是的，我说的仅仅是指，如果工作坊成绩确确实实是由该工作坊的老师打的话。
90746,1877,吴飞,2018-11-25 15:22:10,1,2,1,上的马新观拼盘课，起初以为会很无聊，但是没想到吴老师上课很有趣！！请来很多学届业界的老师也很大佬很有趣。是意外之喜嘻嘻。
112489,1877,吴飞,2019-07-04 11:56:21,4,7,3,人工智能\n\n我是非计算机学院学生，了解了很多AI领域的知识和基础算法，对于一个AI小白来说还是蛮不错的，老师备课很认真，有一一点萌，但是容易睡着也是真的。\n\n最后给分真的好，谢谢吴老师和助教！
125675,1877,吴飞,2020-09-13 05:13:00,-3,1,4,好好好
127381,1877,吴飞,2020-11-22 01:41:04,0,1,1,看看吧
139160,1877,吴飞,2021-07-13 04:38:33,-3,2,5,人工智能无脑选
139162,1877,吴飞,2021-07-13 05:09:43,5,9,4,给个客观点点评价吧。吴飞老师的人工智能课，上课基本没人听，甚至都没啥人到场。第一节课人是满的，后面全是空的。虽然老师讲的不咋地，但老实说还是能学到一些东西的，课程实验特别不错。最后给分非常好。不过没必要为了学人工智能选这个课，可以为了刷分选。然后自己自学网课就好了～～
139568,1877,吴飞,2021-07-17 10:45:39,1,2,1,给分极好，AI入门，无需听课，自学即可
158112,1877,吴飞,2022-06-27 05:03:01,2,3,1,人工智能，作业少，给分好，老师和助教都挺好
158117,1877,吴飞,2022-06-27 05:21:31,1,2,1,人工智能，实验设计得挺好的，考试水，给分很好，群裡谢谢老师的次数比群总人数都多。
158154,1877,吴飞,2022-06-27 08:18:59,7,8,1,给分极好，和某l软工老师比，高下立判
158256,1877,吴飞,2022-06-28 00:56:33,0,2,2,老师和助教都非常好，给分也很好
176021,1877,吴飞,2023-06-27 12:23:15,2,4,2,出分光速来打10分！我承认我声音大了，年轻时诋毁吴飞，考试时理解吴飞，出分时成为吴飞！我从未见过钉钉群如此迅速如此整齐的谢谢老师，真的哭死
176052,1877,吴飞,2023-06-27 13:50:23,0,0,0,点了一次名，而且提前通知\n\n其余时候不点名\n\n作业设计比较有趣\n\n课的话可以选择性听一下\n\n而且这个给分\n\n我只能说有的老师是超人\n\n完全算不出自己怎么得到的
176062,1877,吴飞,2023-06-27 14:15:21,-1,0,1,给分太好了，感觉能给满的都给满了
176273,1877,吴飞,2023-06-28 08:15:20,1,3,2,人工智能，给分好到不可思议
196519,1877,吴飞,2024-07-04 02:02:30,8,11,3,今年人工智能给分很一般，据说期末考试均分70（占比60%）\n\n老师人挺好的，但是讲课真的很催眠\n\n只点了一次名，老师说不到不影响成绩\n\n实验比较水，认真做的话可以比较容易地拿到32+（满分35）\n\n期末考试比较简单，考前读背PPT即可
196632,1877,吴飞,2024-07-04 11:35:11,8,9,1,上课大家都心知肚明，念PPT昏昏欲睡，PPT和教材的质量不敢恭维，不明所以的引经据典和什么传统文化挂钩\n\n大家都是奔着给分好选的，但今年给分很烂\n\n这课没有选的必要了
196635,1877,吴飞,2024-07-04 11:48:32,10,10,0,给分崩了后AI这课的课程质量是要被喷的\n\n学长们只是被贿赂了罢
212801,1877,吴飞,2025-01-15 02:47:57,1,2,1,给人很好，助教哥哥很捞
212901,1877,吴飞,2025-01-15 08:00:05,0,2,2,ai导给分还行 作业认真做 平时不用听 最后一晚速成 满了 大家可以放心选
214747,1877,吴飞,2025-02-17 08:56:36,-10,2,12,sb 纯纯的出生
221657,1877,吴飞,2025-06-25 06:44:37,6,6,0,今年给分又好了
221729,1877,吴飞,2025-06-25 14:10:39,4,4,0,感觉给分好是期末题目的原因
702,1887,肖少拥,2015-03-15 15:59:39,35,64,29,讲课一般化，无起伏，易睡着，但基本的条理还是清楚的。老师人不错，98上答疑版每次都认真回复，还有一个萌萌哒助教……
1266,1887,肖少拥,2015-03-21 17:11:59,5,12,7,程序员思维
1692,1887,肖少拥,2015-03-23 09:18:03,42,47,5,专业术语 各种听不懂
2654,1887,肖少拥,2015-05-05 03:20:15,5,14,9,上课水，听不懂，助教萌萌哒\n\n
3564,1887,肖少拥,2015-06-17 01:35:00,1,4,3,给分挺好 不过上课有点无聊
3794,1887,肖少拥,2015-06-17 04:34:15,31,39,8,无聊。。。容易睡着
3949,1887,肖少拥,2015-06-17 10:58:18,7,15,8,给分不好，上课听不懂
4774,1887,肖少拥,2015-06-28 10:47:28,2,3,1,呵呵
4929,1887,肖少拥,2015-07-01 07:01:25,48,56,8,老师人很好。但上课听不懂，太高深
5437,1887,肖少拥,2015-07-07 13:14:38,75,91,16,一点基础也没有的人完全听不懂
6368,1887,肖少拥,2019-09-01 11:06:46,85,116,31,讲课真心听不懂，给分还这么低呵呵
6621,1887,肖少拥,2015-07-16 13:25:38,2,10,8,上课一般，但是该讲的知识点讲的都比较到位。人非常好，无论是问题讨论还是最后给分。经常问老师一个问题老师这边直接在编译器上写出代码带我分析。
6789,1887,肖少拥,2015-07-23 02:42:00,1,4,3,给分还可以吧
7414,1887,肖少拥,2015-09-14 09:02:37,203,239,36,同学们都睡得很香
7441,1887,肖少拥,2015-09-14 11:33:52,-14,14,28,老师超帅！！讲课不错！！给分好！！很负责！！
11780,1887,肖少拥,2017-12-23 06:03:00,-1,4,5,无聊\n\n
12364,1887,肖少拥,2015-12-23 05:57:09,29,33,4,感觉老师应该是很厉害的，但就是上课专业术语太多，听不懂啊听不懂
13403,1887,肖少拥,2015-12-28 01:05:17,82,93,11,谜之困倦。神之催眠。但真的很厉害。从来看不懂。
14932,1887,肖少拥,2016-01-11 05:38:15,1,4,3,老师专业知识很强，可以学到很多东西
18756,1887,肖少拥,2016-01-22 13:01:28,24,27,3,老师人很好，98上答疑很热情，考点也会讲好老师啊啊啊啊啊啊
18783,1887,肖少拥,2016-01-22 13:55:01,21,22,1,没基础的听起来有些吃力，但是人很耐心
18940,1887,肖少拥,2016-01-22 23:57:11,-4,6,10,我一点基础没有，刚开始听不懂，自己预习一阵就还能勉强听了，听不懂其实不用太在意，自学也能懂的，老师人特别好，给分也不错的
20503,1887,肖少拥,2016-01-28 03:00:58,22,24,2,人好，耐心，热心，但是讲课太高深
21245,1887,肖少拥,2016-02-27 11:32:08,10,18,8,从第一节课开始不知所云，故放弃之。
21564,1887,肖少拥,2016-02-29 08:05:20,-1,1,2,困
21593,1887,肖少拥,2016-02-29 09:19:58,24,28,4,神一般听不懂。基础不是特别好的话千万别选。
23419,1887,肖少拥,2016-03-29 10:10:35,1,1,0,长得像周董他爸
25369,1887,肖少拥,2016-05-16 06:13:40,-4,3,7,真的很好，听不懂，怪我喽
31153,1887,肖少拥,2016-07-03 09:43:13,6,8,2,不是很听得懂，全程自学。抛却这一点，老师人还是挺热情的感觉。助教马子哥有点萌。
31225,1887,肖少拥,2016-07-03 12:07:43,-1,1,2,给分莫名其妙
31229,1887,肖少拥,2016-07-03 12:17:43,1,2,1,给分 讲课 不说话
31366,1887,肖少拥,2016-07-03 17:42:09,14,17,3,上了一学期的java课 只想说灵魂画师and灵魂催眠师哈哈 其实 我觉得老师还是挺厉害的 但是可能是想尽可能发散给我们多讲一些东西导致结局是什么都没听懂还催困 基础好的同学完全不用担心 没有基础的童鞋 也不要为自己成绩低找借口 那都是自己不认真学 罢了 老师不点名 喜欢去蹭别的老师的课什么的完全可以
32942,1887,肖少拥,2016-08-12 04:53:08,1,1,0,很耐心，就是太发散了些
33638,1887,肖少拥,2016-09-24 15:00:52,-1,1,2,哈哈哈，刷分
34387,1887,肖少拥,2017-01-07 17:02:38,-10,5,15,呵呵，不会leapFTP，试验全挂，等重修吧。。。屁事啊，100系统上面分明有提交的地方，为什么还有自己搞一个网站。。。
35990,1887,肖少拥,2016-11-10 09:39:30,1,1,0,老师很专业，听课要一点基础
36119,1887,肖少拥,2016-11-10 12:53:30,1,1,0,听不懂听不懂听不懂听不懂
37072,1887,肖少拥,2016-11-17 08:36:30,1,1,0,真心听的很朦胧
38446,1887,肖少拥,2016-12-05 08:16:23,7,10,3,从没点过名是真的……但是菜?从来听不懂也是真的……好好自学吧
38707,1887,肖少拥,2017-01-17 16:57:45,2,2,0,听不懂。。。。
38927,1887,肖少拥,2016-12-20 02:00:30,4,4,0,术语很多，一开始不容易听懂，但老师真的很厉害，也很耐心，建议有基础的同学选择\n\n
40027,1887,肖少拥,2017-01-20 06:17:42,17,17,0,知识基本靠自学。不过我问了学许端清的室友，她们也只是上课听得懂、下课什么都不会的状态。而肖老师的98答疑和期末答疑真的很用心。C平时作业也不多。是为良心老师。
40880,1887,肖少拥,2017-01-06 05:03:19,1,1,0,讲课真听不懂……但还好
41108,1887,肖少拥,2017-01-09 07:59:35,23,26,3,老师确实是好老师，可是就是听不懂，感觉老师不应该来上课，应该去做研究，这样既不耽误学生，也不耽误老师！
41147,1887,肖少拥,2017-01-09 13:15:25,45,52,7,中肯地说，老师大机基讲的很好。我承认一堂课八成时间听不懂老师说什么，但作为坐了一学期第一排的人真心觉得老师很用心想让我们了解更多。课堂上很多演示。我基础差到爆，实验将将完成，期末可能还会挂，但我还是要给老师满分，因为真的带我了解了很多。
41730,1887,肖少拥,2017-01-12 12:39:09,2,2,0,上课确实有些平淡了，而且老师讲的很深。没有一些基础可能会觉得无趣。但是可以感觉到他总是在想着让我们多学习点东西…态度还是很认真的。至于FTP的使用我感觉真的不难。
42583,1887,肖少拥,2017-01-14 13:25:04,7,8,1,我觉得很对不起老师啦，因为基础不好，听不懂老师说什么，其实自己也没认真听，总是在98上问问题，老师基本上都会回答，其实我觉得老师还是挺好的
43584,1887,肖少拥,2017-01-16 14:47:47,2,2,0,老师人很好，答疑超耐心……一看就是那种超级厉害的
45261,1887,肖少拥,2017-01-19 08:24:35,-2,2,4,讲道理上课我基本听不懂，但是在期末复习的时候会对课堂内容有所了解，简单来说要有基础或者预习才能跟上节奏，考试的话复习书本就没什么问题，大概3.9到4.2是没问题的
45286,1887,肖少拥,2017-01-19 09:10:33,1,1,0,其实人还不错
45670,1887,肖少拥,2017-01-20 02:33:26,1,1,0,老师超级好，平时分给满分
45757,1887,肖少拥,2017-01-20 04:35:54,4,6,2,太坑了。大计基一定要换掉。事情巨多，上课催眠，要求根本不讲清。会低的莫名其妙。
45977,1887,肖少拥,2017-01-20 10:28:56,-1,6,7,所有老师的c讲的其实都差不多的，本身就是实践性的编程，光说不练假把式，老师cc98答疑很好，人也很好，助教也很不错，理论考哪个老师都讲不全的，期末刷了几年的题。最后期末84分，平时分满分最后也4.8。只要自己认真学，分数绝对符合自己的水平。
46045,1887,肖少拥,2017-01-20 13:26:55,14,15,1,为什么评分这么低呢 很认真的好老师啊\n\n
47082,1887,肖少拥,2017-01-23 15:18:50,1,2,1,大计基的话 还好吧 只要平时做好实验报告 期末的综合实验报告上点心 期末及格的话 上4没什么问题吧
49106,1887,肖少拥,2017-03-26 15:24:59,1,1,0,肖哥哥c程超棒，讲得又好，破事又少。
49440,1887,肖少拥,2017-04-13 00:53:04,1,4,3,我承认我对于肖老师而言肯定是太菜了，反正上了几节课我最大的收获是在FTP中找他藏在各个文件夹里的东西，至于程设知识，抱歉我不是跟其他老师学的就是自学的
49916,1887,肖少拥,2017-04-27 06:29:03,66,82,16,上的c程序设计基础，肖老师是个很厉害的人，但是不知道为什么讲课大家都听不进去听不懂，可能是水平太高了，普通人都无法跟上他的思维。上课的时候经常会调程序出来给我们演示，有的时候会直接在Linux环境底下敲代码，看得出来老师很想让我们听懂。cc98上答疑也很负责的，上课的时候还会把98上的问题拎出来给我们讲。是个厉害的人，也许不是个好老师?但是水平高的同学真的可以考虑考虑去上他的课！！
51032,1887,肖少拥,2017-05-15 01:51:17,-3,4,7,上课根本听不懂，感觉他就是自己全程high。还超级喜欢用windows画图做板书，不得不说鸡爪子蘸墨都比他写的好看。发他一份邮件，问了三个问题，一个也没回答就搪塞过去了。这种人是很厉害，但是不太适合教学生。
51514,1887,肖少拥,2017-06-07 02:39:57,1,1,0,老师很耐心！
52107,1887,肖少拥,2017-06-15 01:17:57,-1,0,1,真的好老师 \n\n
54092,1887,肖少拥,2017-06-28 12:17:23,32,37,5,老师对比向（我自己上的肖的C基础，许的c专题，室友上的钱徽的c专题）\n\n1.听课\n\n肖少拥的课不大听得懂，而且有点困；\n\n许端清的课听得懂一半，但课后还是不会；\n\n钱徽的课对小透明有敌意，完全听不懂，而大佬们都高呼已经会了……\n\n都需要课后自己学自己看PPT；\n\n2.作业\n\n肖少拥作业量居中；\n\n许端清的作业最多，经常熬夜写大作业，这学期一共写了4个homework，4个project，1个大作业，4次研讨课，2次展示。其中有两个程序行数达两千；\n\n钱徽借口网站没弄好只布置作业平时不交期末一下子提交……但你还有上许端清课的室友可以依靠；\n\n3.平时答疑：\n\n肖少拥--CC98答疑板块，是匿名提问，老师会解答；\n\n钱徽-----不知\n\n许端清--微信群\n\n4.考前答疑：\n\n肖少拥：安排了一天晚上三小时，一天9点到下午5点\n\n许端清：考前前一天晚上三小时\n\n钱徽：似乎有两天下午\n\n个人感觉肖少拥的答疑最棒！\n\n5.绩点\n\n肖少拥c基础我拿了4.2，比较满意，有付出有回报。\n\n
55355,1887,肖少拥,2017-07-01 10:36:17,-5,3,8,有知识，但讲起课来就是一个傻逼
56586,1887,肖少拥,2017-07-04 04:30:04,0,2,2,不知所云
56899,1887,肖少拥,2017-07-10 06:00:37,0,1,1,还愿来了
57080,1887,肖少拥,2017-07-05 12:40:37,1,1,0,是我菜了
57399,1887,肖少拥,2017-07-07 08:23:59,1,6,5,推荐老师出国任教，zju学生平均水平低于您的期望了（冷漠脸）
57488,1887,肖少拥,2017-07-08 22:52:46,0,0,0,？？？
58200,1887,肖少拥,2017-08-20 08:57:06,3,4,1,c程\n\n上课不好懂，但挺喜欢老师教方式，不会单单给我们讲书本内容。\n\n老师很耐心的，亲测，特别是实验课，不管多弱智的问题。(๑>؂<๑）
58924,1887,肖少拥,2017-09-18 12:58:56,-3,1,4,特别坑
58974,1887,肖少拥,2017-09-26 02:25:17,10,15,5,希望大佬们别带节奏，菜鸡受不了了?
59413,1887,肖少拥,2017-09-21 07:54:59,-3,0,3,不想说什么
59423,1887,肖少拥,2017-09-21 08:57:17,7,7,0,睡着了，手一松手机摔在地上
59687,1887,肖少拥,2017-09-26 02:22:53,3,4,1,听天书
59688,1887,肖少拥,2017-09-26 02:26:33,5,7,2,完全听不懂，完全不顾及没有基础的学生的感受，太坑了。
59690,1887,肖少拥,2017-09-30 02:16:21,6,6,0,听不懂，但老师人很好
59739,1887,肖少拥,2017-09-26 10:21:32,-1,1,2,听天书
60413,1887,肖少拥,2017-10-19 09:04:26,1,1,0,刚开始听不太懂，后来熟悉了就好了
61015,1887,肖少拥,2017-11-07 03:19:01,2,2,0,老师人很好，但是课程基础不好的不容易听懂
61056,1887,肖少拥,2017-11-07 13:42:10,3,4,1,知识很广，老师不错，上课有点蒙，但之后多看看就好了，感觉老师不错，是个爱笑的老师。
63808,1887,肖少拥,2017-12-15 07:11:45,1,2,1,总能把简单的东西讲的很复杂
64072,1887,肖少拥,2017-12-21 01:54:36,0,0,0,没有基础，完全听不懂。希望别挂。
64736,1887,肖少拥,2017-12-27 04:06:09,5,5,0,别带节奏
68246,1887,肖少拥,2018-01-23 01:34:51,7,9,2,我上的是大计基，客观来说吧，肖老师人很好，很有耐心，作业提交什么的一遍遍地提醒，但是上课毫无起伏的语调真的催人睡，不过就上课内容来看，肖老师是为数不多的能把大计基上得这么充实的老师了，内容广，有深度，没基础的同学估计会睡(听不懂)，另外作业真心多，不仅选择要做，实验操作题也有，很费时间，只不过书上的课后习题没有布置过，这是我唯一庆幸的地方了，在大一大计基绝对是我时间投入最多的课了，我从肖老师的课上真的学到很多，当然这是建立在时间投入上的，想水水的同学另谋高见吧，肖老师大计基在课上可水，自己看书就是啦，作业真的水不了。
71280,1887,肖少拥,2018-01-28 08:38:27,6,7,1,从不点名，实验课不强制到，期中考不计总分，总得来说是自由度很高的老师了。水平挺好，但是上课默认你自己看过书了，不能期望只通过上课就学会C。期中考挂了，平时作业全自己完成，考前刷了两套试卷，最后4.2。
72144,1887,肖少拥,2018-01-29 12:46:25,1,1,0,作为一只找了半学期才找到老师上课常规演示操作平台「命令提示符」的天然呆小白，我对xsy老师的敬佩犹如无解问题的程序运行。然鹅，听不懂，听不懂，听不懂。讲的内容是一门课，实验作业是一门课，考试又是另一门课。选一送三，不可谓不值。然鹅，好麻烦，好累啊，眼睛好疼。/哭唧唧/
72149,1887,肖少拥,2018-01-29 13:04:55,1,3,2,老师人超好上课和答疑都很认真 经常笑 经常提醒作业要交 不点名 大计基 虽然上课听不懂 平常基本不听还翘课 作业都按时交了期末刷了题库 期末考以为要挂了结果4.8 啊还有助教平时分和大作业给分超好
72490,1887,肖少拥,2018-01-30 08:29:42,-3,0,3,老师人很好，但是真的不适合来上基础课啊……期末很认真复习了然后还是被拖了均绩......
73115,1887,肖少拥,2018-02-01 02:46:42,4,5,1,肖老师是个超级好的老师，善良和蔼，回答问题勤快，虽然我只有3。。但是我承认这是我没做思科作业，练习系统几乎也没碰过所饮下的苦果，希望能做前车之鉴吧。ps:千万不要因为觉得肖老师上课太无聊什么的不听课，干货真的很多。这也是我大一结束才领悟到的，千万不要瞧不起水课。。微积分线代4.5也拯救不了你。。
73262,1887,肖少拥,2018-02-01 08:55:51,0,1,1,老师讲课还好，几点还好，上四了
73350,1887,肖少拥,2018-02-01 12:02:16,3,4,1,我觉得肖老师的课很棒呀，其实大计基本来就是上课没啥用考前突击背的，和老师有什么关系（每个老师的课都会想睡吧）？肖老师上课会现场演示操作一些我们不太容易懂的术语，还有讲一些看起来好厉害的计算机操作。作业就是四个实验报告和一些单元测验，很多实验操作会在课上演示一遍，认真听一下回去写报告还是比较快的，单元测验都是可以交很多次的，只要认真平常分可以轻松拿高分，满分也不是问题。能感觉到老师在认真上课，但是下面确实没几个人在认真听，但老师也不太管。
74955,1887,肖少拥,2018-03-07 00:30:53,1,1,0,感谢老师不挂之恩
75045,1887,肖少拥,2018-03-07 06:32:36,0,0,0,老师授课非常认真，讲的也很多，给分也公平，看不出有什么好黑的
75099,1887,肖少拥,2018-03-07 10:38:04,0,0,0,贼困贼无聊
76274,1887,肖少拥,2018-04-01 10:54:30,3,4,1,上学期的课，现在忽然想回来给个好评。老师上课不是很好，但是教学方式真的很棒。听他讲课的时候甚至有些昏昏欲睡，也曾经抱怨作业多而难做，但是一学期下来写了很多实验报告之后收获很多的。而且老是有什么通知都会发在自己的个人主页上，要求什么的都特别清楚。让我不太爽的是计院给的大??作业题，不是肖老师的作业。计算机基础4.5，还算满意了。
77786,1887,肖少拥,2018-05-08 00:12:57,3,3,0,老师的小程很好，很细致。大程真的不怎么样，上课无重点，听不懂。
79296,1887,肖少拥,2018-05-30 07:25:36,0,1,1,老师是真的有水平，听不听是自己的事。认真学真的能收获很多！
80342,1887,肖少拥,2018-06-25 09:32:58,-1,4,5,大作业一定要用devc不给用vs也不给用其它图形库，一定要用他讲的winAPI，上课只知道吹他的linux交作业平台，垃圾，学生在这种老师手下怎么可能会有创新
81394,1887,肖少拥,2018-07-05 03:34:13,-1,1,2,还行吧
81817,1887,肖少拥,2018-07-06 08:50:24,2,2,0,。。。
82619,1887,肖少拥,2018-07-08 21:45:19,1,1,0,没有基础大程千万别选
84083,1887,肖少拥,2018-07-12 03:41:07,0,0,0,有基础的推荐选，没基础的别选
84091,1887,肖少拥,2018-07-12 03:55:17,0,0,0,老师还行吧。
84103,1887,肖少拥,2018-07-12 04:24:40,0,0,0,老师挺好的
84310,1887,肖少拥,2018-07-12 13:38:07,0,0,0,。。听不懂
84630,1887,肖少拥,2018-07-13 11:48:49,2,2,0,第一次上老师的课感觉老师太专业了，我什么也听不懂，后来认真听下去发现老师的课真的是干货满满，仔细听能学到很多的，从来不点名，课堂只有二十几个人到而且没什么人听也不生气，有问题都很耐心解决，不过C程想要学好还是得自己多预习和练习吧
84645,1887,肖少拥,2018-07-13 12:23:03,1,1,0,肖老师超级好的，补选进去的，少了前两节课，老师把前两节课的作业都给我补了，最后给分也超级好的，比我预想的好！！！！！上课也干货满满！很有意思。
84647,1887,肖少拥,2018-07-13 12:23:55,0,0,0,卡绩卡绩卡绩呜呜呜呜
84659,1887,肖少拥,2018-07-13 12:43:37,2,2,0,老师还是很萌的hhh
84662,1887,肖少拥,2018-07-13 12:52:05,0,0,0,老师课需要一定基础，不过给分蛮好…
84675,1887,肖少拥,2018-07-13 13:18:19,1,5,4,很好，一学期都在寝室，老师还是给了4.5
84676,1887,肖少拥,2018-07-13 13:19:24,7,7,0,这学期c小程是老师的，给分挺好的，如果你实验考满分了平时分都是会给满的。老师平时挺负责的，不管是上课还是作业方面，在98上的答疑也很及时。总之c程还是得看自己，考试前多刷刷往年试卷，c的套路和坑其实挺多的，理论考试想考高分挺难的，但是理论考要想及格也是很简单的事。还有实验考感觉比平时的作业简单，没有抽到函数题所以都是编程，只要平时作业好好完成基本都没问题，最后建议老师上课其实还是可以用手在黑板上写写东西的，毕竟用鼠标画画难免成为灵魂画手，考试内容简单还好，后面指针的时候看着老师画的灵魂图片脑子就很乱。
84881,1887,肖少拥,2018-12-03 03:25:54,-3,0,3,老师讲的虽然有些难，但对考试来说都很重要！
85434,1887,肖少拥,2018-07-18 00:36:29,2,2,0,慎选！慎选！肖老师人还不错，但是上课很少讲正经内容，非常高级。最大的问题是他的班大佬太多了！恶竞非常严重！即便期末占五十分平常大作业没搞好用处也不大！
85772,1887,肖少拥,2018-08-06 05:48:29,2,2,0,大计基3.0c程5.0(*´∀`)skr~
86794,1887,肖少拥,2018-09-19 00:46:01,4,4,0,肖老人家讲课和我们不在一个世界，感觉还是MOOC更适合我
87500,1887,肖少拥,2018-09-30 02:12:26,0,0,0,基础不好根本听不懂啊啊啊，上课全程懵逼。。
87791,1887,肖少拥,2018-10-13 12:43:33,9,11,2,为了听懂他的课 第一节课后我们后排的同学们不得不自发建了个qq群 叫 大计基求大佬 没了这个群我大概真的要凉 群里的小伙伴也很好学 上课真的有点听不懂 有些操作太复杂了....
87952,1887,肖少拥,2018-10-18 12:53:50,0,0,0,事太多
88824,1887,肖少拥,2018-11-09 03:08:44,1,1,0,没基础的同学的噩梦
90235,1887,肖少拥,2018-11-22 15:17:49,32,34,2,不看他的网页会错过一万个作业。。。
91073,1887,肖少拥,2018-11-29 13:26:06,3,5,2,坑爹……布置作业从不讲截止日期，刚上来就错过两三次
92049,1887,肖少拥,2018-12-25 15:40:15,2,2,0,大计基，感受就是事情比较多，（不知道其他老师是怎样没对比）。具体情况如下供参考：平时作业有：练习系统、思科、实验，而其中实验很花时间，曾有一个实验做了两个晚上还没做完，另外两个也需要时间不过是讲课内容。
92094,1887,肖少拥,2018-12-26 09:52:41,5,7,2,老师很认真很用心~我觉得c程靠自己看书就可以掌握很多，作业题中很难的即使老师讲得很细也还是需要自己花时间，所以上肖老师的课了解更多思路和与c程相关的东西很好玩~超级棒~
92183,1887,肖少拥,2018-12-27 03:12:43,0,2,2,老师是真的超级好
92282,1887,肖少拥,2018-12-27 11:47:53,0,1,1,听起来很牛逼的样子，嗯听起来
92341,1887,肖少拥,2018-12-28 02:17:38,2,2,0,聽不太懂
92506,1887,肖少拥,2019-01-01 06:43:40,1,3,2,没听过课，无法评价
92720,1887,肖少拥,2019-01-04 03:17:21,-3,6,9,听课体验极差，课听不懂，作业还贼多，能不能打零分？
93052,1887,肖少拥,2019-01-07 06:57:44,2,2,0,老师好~~
96093,1887,肖少拥,2019-01-20 12:44:41,1,1,0,讲真的，老师讲的很投入，但是我们有些专业术语确实听不大懂，感觉还可以吧
98189,1887,肖少拥,2019-01-23 07:13:36,7,8,1,上个大计把C程的资料都“偷”来了? 资料全都放在FTP上。最大的有点就是资料全！这点真的要为肖老师疯狂打call!上大计基经常扯开去，真的不知道他在讲什么。但是讲书本内容讲得还是清楚的。
99932,1887,肖少拥,2019-01-25 10:06:21,-12,1,13,期末pta上不给复习题害得我期末理论爆炸\n\n
101184,1887,肖少拥,2019-01-28 01:30:41,36,37,1,没有评论说得那么不好，肖老师人挺和蔼，而且上他的课明显能感受到他努力想让学生听懂
101185,1887,肖少拥,2019-01-28 01:32:10,5,8,3,老师给分还是不错的，只要你期末差不多满了平时分这种东西不存在的。上机课翘了好多，作业都印象流选选，最后99满绩了给老师10分
101187,1887,肖少拥,2019-06-11 11:15:38,35,41,6,我就想知道说老师不好的那些人，你们去哪里再找一个机房课即使腿脚不好也来给学生答疑的老师？课听不懂，是，我也听不懂，但那只能怪自己理解能力差，跟老师有关系吗？我真的觉得老师很负责了，还有说不给复习题的同学，你可能还活在高中吧
101188,1887,肖少拥,2019-01-28 01:42:52,6,6,0,谢老师不挂之恩啊啊啊啊啊啊
101424,1887,肖少拥,2019-01-28 07:42:55,12,18,6,大计基我不知道，只说C\n\n从不点名，上机课不考勤，平时作业不占分，而且对比张彤彧班明显作业少很多，期中考很简单，CC98答疑很及时，所有课件题目资料都开放，上课灵魂画手，还会讲讲很多课外的东西\n\n老师很和蔼，最后我C，96分，绩点5.0，我给个10分不过分吧\n\n那些自己不用功还来恶意刷低分的都司马
101437,1887,肖少拥,2019-01-28 07:59:16,3,4,1,虽然被卡绩了，我仍然要给老师一个10分
101573,1887,肖少拥,2019-01-28 13:06:16,1,3,2,从来不听课最后两天恶补看完整本书 给分还可以 作业有点多
101575,1887,肖少拥,2019-01-28 13:16:45,3,3,0,老师的资料非常好用的。人很好。上的大叽叽，课可以选。
101691,1887,肖少拥,2019-01-29 01:19:41,2,3,1,老师虽然上课有点无聊，但真的很热心，给分也好。能力强，平时作业不做，他会给高分；能力不强，但平时小实验还有作业都认认真真完成，他也会给高分。我期末考试一塌糊涂，以为要挂科了，最后竟然有3.9，大概是平时分给的高吧
101696,1887,肖少拥,2019-01-29 01:30:20,1,2,1,老师上课从来不点名，去不去都不要紧。但是老师上课其实有点东西，去了肯定能学到很多东西。
101759,1887,肖少拥,2019-01-29 04:10:34,1,2,1,大计基相关：肖老师上课非常认真，对PPT上的内容都讲解得比较细致。实验报告有点让人头疼，不过这应该是大计基的通病。听老师的课的确能收获到很多，但这是对有一定计算机基础的同学而言的。对于大多数想要学习基础的同学来讲，想要拿到好成绩不如先把课本认认真真地看几遍来的实际。
102232,1887,肖少拥,2019-01-31 13:59:29,3,3,0,老师讲得平平 但是给分很好啊！自己努力的话，是可以有好成绩的！
102550,1887,肖少拥,2019-02-07 07:38:56,4,4,0,真的是个好老师
102561,1887,肖少拥,2019-02-08 09:22:56,2,2,0,老师很厉害，上课听不太懂，第一节课下来大家纷纷说听不懂听不懂，老师会给很多的资料（ftp），四次实验，还有思科的很多内容，很好的老师，考试好好准备得分不会差。老师不点名，但要自觉的。
103160,1887,肖少拥,2019-02-26 09:01:01,-15,2,17,上课睡觉是听不进去的。但是作业好好做。自己好好看书理解。绩点还是不错的。4.5飘过
103477,1887,肖少拥,2019-03-21 12:48:34,1,1,0,全靠自学
104575,1887,肖少拥,2019-03-24 03:32:24,122,123,1,你 为什么 打字 带 空格
109207,1887,肖少拥,2019-06-12 02:35:06,6,6,0,老师很大佬，但是求求您把我们当成zz来教，听不懂啊
111166,1887,肖少拥,2019-06-30 07:37:00,1,3,2,上课不好好说人话，整天讲高端的听不懂的东西，期末考试难的真的出乎意料。说他负责的我赞同，解答同学的问题很热心，但是上课是真的差(不接受反驳)，真的别选(除非你够大佬)，大佬是少数的，大部分的编程小白怎么办？我就不赞同那些说好的。
111347,1887,肖少拥,2019-07-01 04:10:33,13,16,3,完全 听 不懂 上课 在 讲 什么 老师 在 群里 讲话 风格 也 很 奇怪 还 被 卡绩 了 很 难受
113460,1887,肖少拥,2019-07-06 17:35:05,1,2,1,肖老师真的海底两万里捞我，谢谢老师，非常感谢老师
113468,1887,肖少拥,2019-07-06 17:47:27,4,5,1,老师人巨好啊……印象中都是很认真地答疑 期末理论考炸了没到55分线 老师把我从海底捞了起来 总评还给了我3+ 浓浓师生情！！！
113486,1887,肖少拥,2019-07-06 18:21:59,-2,2,4,老师讲课很认真，课后也会在群里和98上及时回复同学们的问题，很负责，人超级nice，最后感谢老师理论考海底捞我
113643,1887,肖少拥,2019-07-07 01:50:25,-2,1,3,老师海底捞我\n\n虽然考的不尽人意但还是很感谢老师\n\n老师上课总能让我恍然大悟，自己纠结了很久的点能被他巧妙解答
116973,1887,肖少拥,2019-09-18 01:54:12,1,2,1,老师人非常热心，响应很快，感觉c程难度也刚好
117137,1887,肖少拥,2019-09-20 00:24:38,1,4,3,这样的工科男还是不要做老师。\n\n自己研究程序就好。整节课自说自话，完全不像是在讲课。他到底是怎么考上教师资格证的？有没有实践上过课哎，我对着书都能讲的比他好
117259,1887,肖少拥,2019-09-21 13:37:57,2,3,1,我觉得吧，小白听起来非常难，但是老师会很负责的在群里或者cc98上答疑，很负责而且很用心，确实要在讲课上做一些提升，但是老师的态度决对是很好的。（班级里总是会有大佬帮忙答疑，总体来说慢慢来吧）
117423,1887,肖少拥,2019-09-24 06:20:18,1,1,0,真的听不懂 醉了 每次都很绝望
117525,1887,肖少拥,2019-09-25 10:26:55,2,3,1,划水体验
119815,1887,肖少拥,2019-11-16 02:44:55,2,10,8,第一，当老师跟当码农是两个概念。也许是我太菜，但基本不知道你上课在讲什么，重点不突出，经常性自言自语\n\n第二，微信群里说话风格奇特，示范一下：呵呵，这我也 解决不了，你，带电脑来\n\n第三，助教是谁？具体的评分细则是什么？几乎一模一样的实验报告一个能满分一个分很低，你能公开化透明化吗？每次实验自己的分数自己都不知道，平时分我怎么知道你是怎么打的？\n\n第四，课讲的恶心，b事还多的很，彻底让我失去对计算机的兴趣\n\n最后，没选的千万别选，选了的趁早退
121091,1887,肖少拥,2020-01-19 14:18:28,-2,1,3,太lj了
121303,1887,肖少拥,2019-12-23 06:38:43,0,1,1,讲课一般 但用心负责
122052,1887,肖少拥,2020-02-07 15:18:39,2,3,1,很用心的一个老师，无论是上课还是课后答疑都带着一种认真的态度，考试周群里天天贴例题，还专门有为学生整理复习资料，就我上的大计基而言，认为是一个很棒的老师
122919,1887,肖少拥,2020-04-21 01:43:26,0,1,1,讲课感觉很随意，完全没重心
124068,1887,肖少拥,2020-06-23 07:28:22,2,4,2,老师水平很高同时也非常负责，重要的事情会多次强调，上课会直接给我们演示代码，下课会经常给我们答疑，也会经常发一些竞赛或者知识链接让我们拓展；但是，讲课缺乏重心（这应该也是许多同学说想睡觉的原因）同学跟不上他的思路的话很难听明白他在讲什么；总结一下，肖老师比较适合基础不错的同学（或者像我一样在网课时代可以看回放的同学），其他同学就真不推荐了
126133,1887,肖少拥,2020-09-18 03:32:15,0,2,2,不知所云
126189,1887,肖少拥,2020-09-18 17:08:54,2,3,1,祝你好梦
126270,1887,肖少拥,2020-09-21 13:02:50,-2,3,5,fw老师，啥也不讲
126541,1887,肖少拥,2020-09-30 03:15:47,0,0,0,谢谢老师捞我大程
127071,1887,肖少拥,2020-11-05 06:30:50,0,0,0,交作业有必要这么搞吗？
127749,1887,肖少拥,2020-11-26 10:16:41,2,2,0,老师真的很好，很用心，很有师德，可能听不太懂，但他确实是好老师
128723,1887,肖少拥,2021-02-01 08:52:34,0,0,0,能看得出老师很想让我们听懂，，奈何自己是真的蠢。。。。但是有问题这些的话，老师都会很耐心的解答
129256,1887,肖少拥,2021-01-02 13:43:38,2,2,0,睡神 不知所云 不见重心 空格很迷
129584,1887,肖少拥,2021-01-08 02:13:13,0,0,0,老师人很好，虽然讲的我有点听不懂
129878,1887,肖少拥,2021-01-13 06:45:23,7,7,0,老师 挺负责的，上机课 也考虑到 每个同学的安排 可以 不去，不 点名，事 也不多。
130522,1887,肖少拥,2021-01-23 10:54:01,0,0,0,老师在我快要挂科的时候把我捞了起来…………永远滴神！！！
130716,1887,肖少拥,2021-01-24 10:51:46,3,4,1,我觉得老师是真的很强，平时作业就两个实验报告，如果想拿满，就使劲卷页数。虽然老师上课真的可能听不懂，但是期末真的会给很多复习资料。而且你问他问题他回答的特别快。上课从不点名，开始觉得你不来上课，期末还考的高，这才是本事。我觉得老师很好啊😁
130801,1887,肖少拥,2021-01-24 15:38:37,1,1,0,未出分来评价，避免因为分数影响判断。可以说肖老师真的蛮好的，之前评论中所说的灵魂画手确实，上课经常打开画图就给我们演示。大计基这门课是一门课后花时间的课，然后肖老师的作业也比较奇特，但是平时任务相对较轻。上课努力在给我们拓展很多别样的东西，同时课后的答疑也十分及时，虽然说上课的语调一成不变以及有的时候答疑时奇怪的空格，但是好好听还是会有所收获的。
131143,1887,肖少拥,2021-01-26 07:12:35,5,6,1,你们不困吗
132355,1887,肖少拥,2021-02-01 04:58:24,14,18,4,周五早八 没怎么 去过 PTA两次作业都 没写 期末考 啥也不会 给分竟然 也有4.5 老师人 真好 不知道大家是不是都 满了 没关系 我已 知足
132460,1887,肖少拥,2021-02-01 16:58:23,-2,2,4,老师水平很高，很多操作直接从CMD或者linux bush里进行，奈何给社科生讲这些难免晕晕乎乎的233\n\n考试很水的，考前课件翻一遍，再做点模拟卷（老师提供）就能很高的分。\n\n我被卡绩了，差一分满绩，不过很满意了。\n\n老师事少，作业少，上不上课都行，只要你水平高或者考前突击，就能高分！
132601,1887,肖少拥,2021-02-02 14:48:18,3,3,0,虽然肖老师上课有点跳跃，容易犯困，一打开画图我就懵，但的确是我见过答疑最热情耐心的老师了！最后还捞了捞
133356,1887,肖少拥,2021-02-26 07:56:27,4,5,1,我觉得肖老师特别好，真的是个非常负责任的老师，在群里的答疑很及时，而且期末考试之前会自己安排答疑，同学可以去西教找他，而且他自己安排的答疑时间都是到晚上的八九点钟。其实说他上课听不懂的，是因为大家都是刚开始接触计算机语言，学到后面其实也是可以听懂的，给分也挺好！
133363,1887,肖少拥,2021-02-26 10:10:41,0,2,2,上的老师的大计基。肖老师上课确实催眠曲，确实听不懂。但是讲课很认真，答疑很认真很耐心。课下看书，看PPT，完成所有作业练习和实验题（不论自己做还是查资料还是和同学讨论）别抄就行。有两次实验报告，几乎每周都有练习系统里的题，还有思科和PTA里的Python编程。但是习惯了就好，总比高中作业量少。考前只要背好名词缩写，刷好往年卷，把不会的题全问懂就没太大问题。4.5
134152,1887,肖少拥,2021-03-17 06:50:21,0,0,0,老师人很好，能感觉到他也很想让大家听懂，但是是真的听不懂(ಥ_ಥ)答疑很负责的，给分还行
134502,1887,肖少拥,2021-03-30 07:58:25,8,10,2,老师人好负责，讲的也很细，为啥分这么低啊
135005,1887,肖少拥,2021-04-26 12:02:04,1,1,0,老师非常非常负责！解答问题很热情耐心
136847,1887,肖少拥,2021-06-25 16:12:51,4,5,1,老师不会说话，喜欢打空格，教学如开飞机\n\n总结:全靠自学。\n\n选这个老师的课，你不仅不能获得帮助，而且自学过程中会受到阻力\n\n最大收获：学会了抗压
138078,1887,肖少拥,2021-07-07 09:20:16,6,6,0,我对不起老师，当着他的面睡过去好多次qwq
138681,1887,肖少拥,2021-07-10 10:12:39,0,2,2,10分！！！老师好好呜呜呜! 海底捞！
138846,1887,肖少拥,2021-07-11 07:32:00,-7,4,11,老师给分超好，c小程和大程都是他的，一次5.0，一次4.8，大大拉高了均绩\n\n群里答疑也非常热心\n\n至于课堂吧...老师经常会不自觉讲一些超纲的内容和计算机思想，比如命令行，权限管理，用户管理这些的，看得出来老师是真心想提升我们的能力，但是这些内容有时甚至搞得课内内容都讲不完，很多时候靠自学才能跟上\n\n总之吧，如果你对电脑感兴趣或者比较善于自学，还是很推荐选肖老师的课的
139435,1887,肖少拥,2021-07-15 13:19:37,1,2,1,C大程课上的肖老师的课。总的来说，老师很负责，如果你真的认真做了给分也不错（满了）。但是我觉得老师总是上课时间规划方面做的一般。因为老师会给我们拓展一些别的内容，展示一些系统的使用方法，然后课上就没什么时间讲他要准备讲的东西了。其实很多东西还是自己去看。\n\n对于小白来讲，可能会对老师的讲课方法感到不适应。总的来说大一是从高中的被动被灌输知识的方式转换到大学主动学习知识的方式的一种过渡期。老师可能不会一步一步的去教你怎么做，但是实际上老师已经把怎么做的方法基本上都清清楚楚地写到他发的文件和课件里了。老师的服务器上有很多资源，大家要善于利用。不只是课上的ppt，其实还有很多（我第一次玩虚拟机就是用服务器里的软件）。\n\nC大程是一个学会把c的基础知识和应用以及团队合作融合的一个课程，认真看课件，不懂就问，你的成绩不会差。
139521,1887,肖少拥,2021-07-17 02:33:45,-4,1,5,快跑，C大程期中占30分还不调分
139750,1887,肖少拥,2021-07-23 06:05:24,-1,4,5,上课很认真\n\n老师很负责\n\n适合c程入门的同学选
140490,1887,肖少拥,2021-09-13 05:12:56,0,0,0,肖老师挺好的，虽然对没基础的同学可能有点困难，但是还是认真的
140877,1887,肖少拥,2021-09-17 06:14:38,4,4,0,虽然有点无聊\n\n但是很详细\n\n老师答疑很认真，教学态度严谨\n\n很能捞，捞王\n\n入门的同学可以且较推荐选
140917,1887,肖少拥,2021-09-18 00:34:56,2,2,0,听不懂
141631,1887,肖少拥,2021-10-18 09:47:22,2,2,0,上课，很努力想听了，但是真的听不懂，他演示，举例我也看不懂，就很困，就睡了……只好课后自己看PPT和书
141648,1887,肖少拥,2021-10-19 03:59:34,2,2,0,老师上课喜欢讲点别的
141873,1887,肖少拥,2021-10-29 01:02:49,24,25,1,不要问我 为什么 打字 要打空格。 听老肖的课 时间长了 就会这样， 哦对 老肖 一般用98 答疑 好像 周五 也有 答疑课。 但是 懒 我 没去过。
141924,1887,肖少拥,2021-11-01 03:43:55,3,3,0,上课节奏很奇怪，听不太进去
142096,1887,肖少拥,2021-11-05 14:31:39,-5,6,11,害，垃圾
144158,1887,肖少拥,2021-12-20 01:09:20,0,1,1,水平不够听不懂
144744,1887,肖少拥,2021-12-23 11:42:36,1,1,0,老师水平很高的，也很负责，就是上课有点无+无聊
145031,1887,肖少拥,2021-12-27 00:16:53,9,11,2,我觉得老师上课很认真，会拓展一些计算机相关的内容，这一点上极为推荐给有一点基础的同学；\n\n同时，老师答疑很认真，所以无基础的同学也非常推荐选肖老师。\n\n综上，我给10分。
146959,1887,肖少拥,2022-01-08 07:21:29,13,13,0,计科上课不点名\n\n比起别的班会有很多复习资料\n\n不会的问题随时问 私发和在群里问都可以\n\n答疑真的很认真
148437,1887,肖少拥,2022-01-12 12:49:04,1,1,0,讲课不知道讲写什么
148591,1887,肖少拥,2022-01-13 02:39:34,2,2,0,真的挺为学生着想的，很赞的老师了
149127,1887,肖少拥,2022-01-14 13:19:55,2,2,0,上的老师的c小程，凭心而论，只能说能感觉出老师水平真的很高，但像我这样零基础的上课完全听不懂。如果你本身基础好的话建议选，好好卷能拿高分，但没什么基础的想好好学知识的别选，因为基本等于自学。
149389,1887,肖少拥,2022-01-15 08:16:57,2,2,0,大计基B，真的听不懂，平时作业也很多。但老师还是挺认真负责的，课下交流超级耐心，最后给的复习资料也很足。但我真的实在是听不懂，可能老师输出的是计算机语言吧。
149409,1887,肖少拥,2022-01-15 08:55:53,-2,1,3,给分太吝啬了
149419,1887,肖少拥,2022-01-15 09:10:43,2,4,2,c小程：我认真的听了好几节课后发现无法从他的话中找到有用信息...给分真的...太吝啬了...一点都不带调的...成功拉低均绩...
149458,1887,肖少拥,2022-01-15 11:52:11,2,2,0,课前会讲有用的小知识点，平时分算法也很良心，基本可以拿满，还没有期中考和实验报告。可惜理论题考的不是很好，但是平时分的算法真的大赞！
149513,1887,肖少拥,2022-01-15 16:35:23,2,2,0,给分很求是，一分没调，理论都不太高的情况下一点不调不知是否合理，先给个9分
149605,1887,肖少拥,2022-01-16 07:38:55,0,0,0,上的是老师的计基B，老师上课比较喜欢举例子（但是又听不懂），实验报告一共是两份，相比于其他老师我觉得是挺少的，也没有期中考试。均绩低我觉得很大一部分原因是在于上课较难集中注意力，或者作业没有好好完成，平时认真完成作业+期末临时抱佛脚我觉得均绩不会低的~
149615,1887,肖少拥,2022-01-16 08:04:50,6,7,1,不错的老师，平时分都拉满了有些人也别奢望过分的调分了，我觉得比其他一些平时分都扣扣嗦嗦的老师强多了，也说了你水平不够可以不来，觉得老师讲的你听不懂你可以去旁听别的c程老师。水平很高，这点大家应该都承认，又有开放的教学观念，这样的老师我真的爱了
149621,1887,肖少拥,2022-01-16 08:24:29,2,3,1,大计基B，上课不点名，可能是自己水平太低，很难听懂，但老师答疑很认真很用心，人很好很负责，作业的话感觉较多，实验报告也需卷页数，但最后分给的还是不错。总的来说，事算多，但分还不错，只要作业报告这些做好就不会低。
149664,1887,肖少拥,2022-01-16 09:42:53,0,0,0,没听懂，靠自学，绩点杀，但是期末给的复习资料挺好的。
149785,1887,肖少拥,2022-01-17 03:14:41,2,3,1,肖少真的好温柔，平时上课虽然有点严肃，但是习惯了就会知道他更注重培养计算机思维。钉钉群里回答问题也很积极，只要习惯老师的说话方式就能学到很多，也会经常分享一些计算机的知识。平时也没有硬性要求去机房，我基本都是在寝室里用自己电脑做的作业，不过考试前会建议去机房适应环境。期末平时分给得很高，基本上只要理论考过关，分都不会太低，老师也会捞你的。
149799,1887,肖少拥,2022-01-17 03:52:34,1,2,1,老师是好老师，虽然上课可能听不懂但是资料什么都很全，大计基感觉也不是老师教就能会的，老师给分也很棒
150049,1887,肖少拥,2022-01-18 13:43:28,9,10,1,查老师的 第一条评分 给 xsy了 ， 本 以为 男神 不捞人，没 想到 捞我 了。
150085,1887,肖少拥,2022-01-19 02:23:11,0,2,2,作业量多，但确实可以学到东西\n\n以及今年好像开始捞人了…？
150106,1887,肖少拥,2022-01-19 05:19:47,-13,6,19,傻逼老师
150310,1887,肖少拥,2022-01-22 07:33:21,-4,2,6,计算机基础b 个人觉得给分还不错 平时有听没听的 最后几天刷刷题 估计考试考得不错最后 4.5 实验报告写的非常认真但是分数不高 总体满意 老师人也很好 但是上课的时候要听清楚老师的要求！！！
150949,1887,肖少拥,2022-02-21 10:21:24,14,16,2,说话。 面向， 过程  不面向  对象。
151040,1887,肖少拥,2022-02-22 06:47:00,12,13,1,老师很好，但是个人感觉上课内容和考试相差蛮大的，一个学期也不知道学到了什么，c小理论零基础没过斩杀线挂科了，建议小白别不要选，大神随意
151171,1887,肖少拥,2022-02-24 03:01:28,1,7,6,水平很高 很认真和蔼的老师啊 只不过讲课思维确实有些跳跃 自己做好预习 上课集中注意力就好
151373,1887,肖少拥,2022-06-21 14:15:35,11,22,11,讲课水平堪忧
151737,1887,肖少拥,2022-03-14 09:15:46,11,12,1,快逃！快逃！快逃！
151871,1887,肖少拥,2022-03-18 16:20:28,14,15,1,c零基础，上课基本听不懂，他的课完全不是给初学者上的
151874,1887,肖少拥,2022-03-18 19:53:36,0,5,5,线上上课的，觉得人挺好的，钉钉上一直耐心地回复我的疑问。上课讲的确实很无聊，有时讲的事儿技术性很强，但喜欢跟我们分享额外计算机知识。作业超多，给大家个建议：做好作业、复习老师的ppt、记作业题答案、考试一定会过的。最终4.5满意了哈哈。
151994,1887,肖少拥,2022-03-22 15:04:57,11,12,1,肖老师讲课时真的天马行空
152344,1887,肖少拥,2022-04-05 12:35:29,8,9,1,上课就像自言自语，作业少但时间设置不合理
152381,1887,肖少拥,2022-04-07 09:18:12,7,9,2,我真的听不懂啊
152678,1887,肖少拥,2022-04-18 07:28:07,2,8,6,讲课不知道在讲什么，非常混乱，每节课前讲10分钟不知所云的cc98答疑版 喜提3.3
153325,1887,肖少拥,2022-04-28 04:37:34,1,4,3,老师答疑很认真，会很耐心的去教你，计基期末会开放很多资料，平时作业要及时完成，两次实验重质不重量
154814,1887,肖少拥,2022-06-05 15:35:26,7,11,4,上课凌乱，讲话晦涩难懂，怀疑老师的语文水平
155000,1887,肖少拥,2022-06-07 09:42:34,3,9,6,老师教的是真的用心，过程管理也很细致。小测都会来机房监考，做事风格很务实。求是精神为何？我认为从一篇篇呱呱响的文章里是学不到的。我认为来浙大就是要跟这样的老师学的。\n\n分高不高最终主动权在自己，老师只是按照规矩，不放水罢了。\n\n有幸选到肖老师的课！
155167,1887,肖少拥,2022-06-09 03:53:05,-3,5,8,学c要预习，课上你会发现他会联系很多章节外的东西。不知道其他c程老师怎么样，我感觉xsy老师挺好的。
156623,1887,肖少拥,2022-06-20 12:09:49,3,4,1,讲课乱，下午最后一节课狂拖，又卡绩，老师还算负责人，但是还是无语了
156993,1887,肖少拥,2022-06-21 13:20:30,4,5,1,其实给分还行吧，没有很求是，但是老师讲课真的不太行
157514,1887,肖少拥,2022-06-23 13:49:17,5,7,2,老师会捞人，讲课有种沉浸在自己世界里的感觉，但是老师超级负责，不懂的问题一定要把你教懂，楼上同学说话请别太过分
158557,1887,肖少拥,2022-06-30 07:40:48,-13,3,16,大一预置的，讲的不好。我考前背了背， 我菜加上老师讲的无聊加上给分不好=1.8的绩点
158562,1887,肖少拥,2022-06-30 07:51:48,9,9,0,分数还没出，为了避免出分之后的主观情绪，先来把评价码了\n\n如果你有一定的c基础，或者是曾经学过，大致了解过一些编程，我觉得肖老师的课是相当好的。课上会有很多例题，会打开dev敲给你看，看dev的时间甚至可能比看ppt长，绝对不是那种只会念ppt的老师，不存在说上课只学语法导致最后实验考不会做题的情况。\n\n老师作业很少，和我室友的老师比起来可能只有十分之一的量，但是重点知识基本都覆盖了，应该是老师挑过的。\n\n但是如果没有基础，跟起来可能稍微有点困难，老师有些时候思维还是比较跳脱，偶尔发散讲一讲，但是最多一两句话，又会有意识地停下讲课。\n\n老师是真的好老师，只是可能不适合每一个人，我要献出我的十分，不是为了没出的分数，是为了我能感受到的真诚和热忱。
158644,1887,肖少拥,2022-07-01 03:03:48,2,3,1,给分好
159150,1887,肖少拥,2022-07-07 01:34:19,5,5,0,首先 好好听课好好刷题好好复习好好做实验报告 分数不会低 本人4.5\n\n别尬黑老师 老师的态度非常好 就是上课喜欢拓展吧 也可以不听 但是他会给你讲python 做python作业 对后期python的学习非常有帮助\n\n努力基本上还是正比的 当时实验写了好多但是分数不是很高伤心过 但是考试应该不错 努力会有收获
160453,1887,肖少拥,2022-09-23 01:56:18,6,7,1,一般的钉钉群是同学刷屏，老师见不到人，C程是肖老师刷屏，真的负责，能力很强，不过思维跳跃，建议有编程基础的人报，剩下的人...耗子惟知
162326,1887,肖少拥,2022-11-20 06:09:10,0,2,2,糟糕。
164616,1887,肖少拥,2022-12-22 08:36:14,4,4,0,肖老师的课水平很高，所以我昏昏欲睡。\n\n偶尔点名，最好不要。\n\n作业较多，写了50页Python和华为机器人实验报告真的会谢
164753,1887,肖少拥,2022-12-25 08:50:06,0,3,3,老师很厉害。所以建议和我一样的没有任何计算机基础的菜鸡不要选！不要选！不要选！是真的听不懂跟不上，哭哭。当时预置的大计B没敢退，现在要考试，看着sr老师的智云流下两行泪。以及作业是真的多。其他老师RPA交截图，肖老师是三个实验还有大报告。想想之前50页的python报告，真的会吐血。以及听说了老师极为求是的给分，哭了。奉劝以后跟我一样预置了肖老师的新生们：别怕退预置，跑吧，这里不是家！！！快跑！！！！！！！！！
164810,1887,肖少拥,2022-12-26 08:08:39,4,4,0,感觉C程没有那么夸张，个人感觉听不懂的可以看看课本?我基本上是靠着看课本自学过来的，然后老师人本身还是比较负责认真的，有不懂的也可以在98老师的答疑帖上提问
164987,1887,肖少拥,2022-12-28 08:02:01,4,4,0,c小：事情少，老师很认真负责。但确实不适合习惯依赖老师的零基础同学。老师在工作态度和答疑上很认真，讲课应该有提前规划，但讲到某些点会忍不住延申会影响听感，尤其对于前半学期零基础同学。总体看，如果你小白但愿意下来花功夫在新内容上或者你大佬，肖老师的c小是可以的。
165689,1887,肖少拥,2023-01-14 08:25:00,1,3,2,大计基B：8/10\n\n任务比较多，但这样得分也比较踏实有底。平时作业不要太水，关键还是最后阶段python的学习，弄懂算法，老师还是挺能捞的，最后可以上4.
165979,1887,肖少拥,2023-01-10 14:30:02,4,4,0,事少，老师认真负责。C小本身就需要自己好好学吧，纵使老师点拨的能力没那么好，但是自己努力一下还是能有结果的。起码，老师的诚意满满是每个选课的人都能感受到的，有哪位老师会经常在钉钉群里解答同学的问题并分享学习的细节和易错点呢。
166904,1887,肖少拥,2023-01-14 07:41:59,2,4,2,三天速成大计基B喜提4.2，期中考甚至没及格，估计是期末考还行，老师真的海底捞！我为老师正名！
166906,1887,肖少拥,2023-01-14 07:50:58,0,1,1,大计基血泪史，文科计算机基础不太好的同学不建议选
166909,1887,肖少拥,2023-01-14 07:56:46,2,3,1,老师蛮认真负责的。但课是真的听不懂，五十页笔记有点6，平时作业也蛮多。但作业多比较扎实吧，期末考有优势。最后上四了，给老师一个好评。
166910,1887,肖少拥,2023-01-14 07:57:42,5,6,1,老师水平比较高，零基础的人比较难适应，但是老师非常负责！答疑什么的会很认真！\n\n事略多，py和rpa都要实验报告，不过对于复习有帮助\n\n本人基础薄弱，考前复习做错题，最后喜提4.5非常满足
166945,1887,肖少拥,2023-01-14 10:18:11,2,2,0,老师水平很高。
166959,1887,肖少拥,2023-01-14 10:50:49,10,10,0,8/10，大计基B，给几点作为参考：\n\n1.老师上课有点迷（而且声音小小），一开始不太能跟上他的节奏……后面听着听着会适应哒\n\n2.老师说话有点像机器人，有时候听不懂……但是老师人很好，有问必答，钉钉回复也很及时\n\n3.老师作业有一点点多，要写50页python笔记和rpa实验报告，不过我觉得和大计基这门课也有关系\n\n4.助教老师很认真负责，有一次作业晚交了，我给他发邮件补交了，应该也有看到，虽然存在感有一点点低hhh\n\n5.我对这门课还是挺认真的，我觉得给分还好，甚至最后可能有捞一下。大计基能有4.5真的很满意啦。\n\n\n\n总的来说，这门课的话，如果你想划水，那大概拿不了高分，因为大计基本来就不水，而且老师也是很认真的。如果你上课听讲和课后作业有跟上的话，分数应该会令你满意的，而且学着学着你会发现老师有时候也挺萌的（？），希望肖老师在查老师的分数可以节节攀升:)
167441,1887,肖少拥,2023-01-16 09:37:54,4,4,0,老师水平很高，但是我太菜听不太懂
167821,1887,肖少拥,2023-01-19 08:58:24,0,1,1,上课听起来有点吃力，讲的和作业做的还有考试考的根本不是一回事，并且考前考试范围还给错了，老师上课明确说不考的东西惊现在试卷上
168023,1887,肖少拥,2023-01-23 02:52:37,1,1,0,还不错
168333,1887,肖少拥,2023-02-12 07:43:25,4,5,1,没有点基础的人真的会昏昏欲睡，建议自己提前准备一下，不然课上可能会跟不上。然后就是老师的给分，我这个学期基本上大计基是水了的，最后没有挂还是很感谢老师，文科生真的听不懂。老师很负责。
168418,1887,肖少拥,2023-02-15 15:46:52,3,3,0,老师挺可爱的
169616,1887,肖少拥,2023-02-27 06:49:12,8,9,1,好老师 抽象画水平极高
169705,1887,肖少拥,2023-02-27 12:53:27,3,8,5,xsy老师真的是海底捞~考试前看到有一次平时作业忘记写了，然后之前还有一次作业错太多没拿满分，期中也刚刚及格，本来以为要挂了，结果有3.9，给肖老师打个10分！
170396,1887,肖少拥,2023-03-14 12:39:07,7,7,0,少拥哥哥没挂我，嘴一个，虽然老师讲课确实高端平时作业也有点点小多（不过比室友wjj期末一起留好多了）不适合菜狗。苯学期助教哥哥大作业打分也很好，也嘴一个
171519,1887,肖少拥,2023-03-27 08:58:04,7,7,0,不上肖少的课的人生是不完整的！！可爱的小老头！！！谁不懂谁没品！！这么可爱说话还会发空格！！！！蹬个小自行车晃晃悠悠的呜呜呜真的特别可爱！！彻底疯狂！！彻底疯狂！
171742,1887,肖少拥,2023-04-04 00:35:49,-3,1,4,肖老师你真的好抽象啊啊啊啊啊啊
172009,1887,肖少拥,2023-04-17 09:08:03,28,30,2,跟不懂肖少的永别！！！特别可爱特别萌的小老头谁懂，骑个自行车晃晃悠悠，妈呀。。别太可爱了我说 回答 问题 也 超级耐心 空格 也 非常 可爱 \n\n不喜欢肖少拥？没关系，这是很正常的事情，毕竟大家都是在不停的相遇和分别的过程里找到真正志同道合的人，祝你未来一切都好。再见，没品味的东西
172010,1887,肖少拥,2023-04-17 09:10:43,3,3,0,肖少yyds！\n\n大计基无聊+微难是这门课本身的特性 但是在课程改革之下 肖少的课还是很棒的！！讲课耐心细致 课下也很乐意回答问题 为人也很有趣 是不可多得的好老师捏！！\n\n大计基更多还是靠自己啦 平时记好笔记最后背一背 重点学好python入门就好
173363,1887,肖少拥,2023-05-21 08:27:50,6,6,0,真的很爱小老头www
173921,1887,肖少拥,2023-06-04 14:32:38,8,8,0,舍不得小老头
174156,1887,肖少拥,2023-06-07 00:55:39,4,4,0,good
174772,1887,肖少拥,2023-06-17 11:34:28,-24,1,25,上课水平太差，给分也不好
175324,1887,肖少拥,2023-06-23 23:46:29,6,7,1,摆王吹爆，一行代码都没有的大作业老师都给50+
175448,1887,肖少拥,2023-06-25 03:16:40,8,8,0,爹！！！！
175813,1887,肖少拥,2023-06-26 23:38:41,9,9,0,感觉肖老师教学不太拘泥于框框条条的知识点，也希望教给学生一些思想和总体认识\n\n今年c大程期中考试改成了上机做一道大程，内容可能是有点多了，到最后拿40分就算满了，大程互评+老师评阅，没有申诉，遇到一些奇葩给你猛扣分是真的难顶
176148,1887,肖少拥,2023-06-28 03:09:22,17,17,0,爱死老师了，真的设身处地为学生着想
176149,1887,肖少拥,2023-06-28 03:09:21,14,14,0,爱死老师了，真的设身处地为学生着想
176173,1887,肖少拥,2023-06-28 03:46:26,13,13,0,捞，捞，捞，海底捞！！！老师把我捞飞了！！！
176174,1887,肖少拥,2023-06-28 03:47:15,17,17,0,肖老师真的是一位好老师，很用心地在教学，也在不断追求更科学的评价方式。在钉钉群里很认真地跟同学沟通交流。有一种工程师的风范。大赞！
176229,1887,肖少拥,2023-06-28 06:23:39,15,17,2,上过他的c大，其实这门课感觉主要还是自学的，老师上课讲的是有些抽象，但对同学的提问能够做出详细的解答。\n\nc大本身就是门很花时间的课，写大程过程中熬过不少夜，感谢xsy最后给了我98，也确实努力没有白费。10分拿走!!!
176885,1887,肖少拥,2023-06-30 14:14:54,4,4,0,老师，谢谢您把我捞起来呜呜呜
177000,1887,肖少拥,2023-07-01 04:19:05,13,13,0,几年前上课就觉得老师好了，看到评分上来了真的好欣慰
177326,1887,肖少拥,2023-07-03 02:27:15,21,21,0,过了一年再来看，肖少拥老师还是很有教育热情，解答问题也很耐心。就是感觉不太能传授出知识（神奇的机器人一般的说话风格），上课时而讲到一些过于高级的东西。给分很捞！
180823,1887,肖少拥,2023-09-27 02:32:40,2,2,0,绝对好老师
181048,1887,肖少拥,2023-10-07 02:26:01,1,1,0,睡死了
181083,1887,肖少拥,2023-10-07 13:43:43,1,1,0,，，，，，，，，。。。。。。。。，，，，，，，。。。。。。
181204,1887,肖少拥,2023-10-11 12:16:35,2,2,0,巨困无比
181332,1887,肖少拥,2023-10-15 02:46:19,0,1,1,给分很好，农学院学生上了C大最后能得4.5的绩点（虽然被卡绩了。。。
181758,1887,肖少拥,2023-10-31 04:40:49,1,1,0,有东西 但是很困
182044,1887,肖少拥,2023-11-09 02:48:23,1,2,1,困=_=
182552,1887,肖少拥,2023-11-17 11:20:24,1,1,0,老师很好，听不懂应该是我的问题(๑ó﹏ò๑)
184398,1887,肖少拥,2023-12-19 02:06:42,1,1,0,非常认真的开始 答疑回复很认真 C程作业也不多 但是平时过程测验可能会多一些 但是有助于我们提前适应期末实验考的环境 总体来讲还是很不错的 祝我期末C程拿一个不错的绩点！
184577,1887,肖少拥,2023-12-22 01:13:31,7,7,0,xsy老师人是很好的，线上答疑都是有问必答，而且前一天问他问题、他当时因为监考而没空，第二天晚上竟然回复了，真的有被感动到！\n\n平时作业量也还好，不多不少，过程测验较多，但难度不会太大，且较多的题目来源于教材原题及其改编，更多偏向于适应性考试。\n\n不过他的上课风格确实很有“特色”（说话风格也很独特），会更多地用例子来解释知识点、而非直接讲知识点，在教室里面听可能会比较催眠（？），个人感觉听他的课用智云课堂反而效率更高。此外，最好也认真看教材+高质量完成PTA上的题目，收获不会差的。
184899,1887,肖少拥,2023-12-24 08:10:54,0,0,0,好老师
184981,1887,肖少拥,2023-12-25 04:07:59,3,3,0,上肖老师的课，你需要钢铁的意志抵抗你的睡意，但讲的还行
185084,1887,肖少拥,2023-12-26 06:31:26,3,3,0,老师说话很有特色，容易犯困。\n\n不过大计基这课本来就没什么意思，作业记得好好做。
185397,1887,肖少拥,2023-12-29 01:10:43,6,6,0,老师人很好，认真负责；但是说话让人听起来有点混乱，而且困
185880,1887,肖少拥,2024-01-05 09:34:57,5,5,0,一开始听他讲课感觉很不舒服，但是没几节课之后，感觉确实讲的内容还是比较清晰能懂的，不要因为查老师上的分数先入为主了，好好跟着学没问题的
185997,1887,肖少拥,2024-01-07 09:09:37,5,5,0,老师很好的，很负责很有学识，值得10分。但大计基这课程体系不好评价。
186061,1887,肖少拥,2024-01-08 05:43:27,2,2,0,可以的
186501,1887,肖少拥,2024-01-11 11:09:59,4,4,0,上的老师的C语言程序与设计，很有趣的老师，问问题都会耐心解答，线上还会在钉钉和CC98上回答问题，助教也很nice，本来以为期末理论考要被斩杀了，很害怕去问老师，老师还很耐心地帮我查了成绩。这门课就是作业要自己写，写不出来可以求助一下别人，一定再自己完整的写一遍，理一遍思路，不能死看书，作业写到不会的一定要问清楚，理解原理，因为期末理论考考的很多都是原理题。总之就是理解原理，搞定期末考。自主完成作业，搞定实验考。感谢肖老师和助教的付出😊
187164,1887,肖少拥,2024-01-15 01:45:00,2,2,0,很认真的老师\n\n虽然我因为基础比较差，不太能听懂
187534,1887,肖少拥,2024-01-16 12:39:54,5,5,0,本人是河北人，大一第一次接触c，开始的很懵，不理解，听不懂，上课挺天书，只能下课b站上大学，但有一次我听的比老师讲的快，然后去听老师的课，哇塞，解决了我好多听的时候疑惑的点，老师是很有实力的，只是他把我们看的太高了，告诉了了我们很多进阶知识，但是我们还没基础，建议学了肖老师的uu不要怨天尤人，去做好预习，你会发现，能和这样一个有知识的小老头在一个课堂泰裤啦
187916,1887,肖少拥,2024-01-17 21:32:09,1,3,2,肖老师，人特别好，很可爱的一个小老头。平时作业少，基本上每周在实验课上就能完成大部分。并且第一节课去他就说会的可以申请不去听课（免听），每节实验课都要签到，但是实验考满分就当全勤，真的超级人性化，对于我这种以前学过竞赛的人来说绝对是一大福音。不用担心阶段考分数低，老师会赋分捞你。老师课后答疑随叫随到，经常在群里分享一些共性问题，还在阶段考完安慰我们不要灰心，他真的我哭死！讲课的话，确实可能因为老师的声音有点低，有种催眠的感觉，但是如果认真听得话还是干货满满的。今天刚出分，老师真的很捞，冲！冲！冲！最后还是谢谢肖老师送给我大学的第三门满绩^_^。
187986,1887,肖少拥,2024-01-18 02:50:38,4,4,0,C程序设计基础及实验 分正课与上机课\n\n平时作业适中，不是很多但能让你掌握知识点\n\n正课从来不点名 上机课需要签到 但是如果实验考满分则自动全勤\n\n小测难度适中 会赋分\n\n让我们好好准备实验考/期末考 不会散播焦虑\n\n上课内容个人认为讲的很好 不紧不慢 但是C这门课最需要的还是自学\n\n最后\n\n我靠今天一看发现给了100分这什么神仙给分啊啊啊啊啊啊啊啊啊我爱死老师了
188028,1887,肖少拥,2024-01-18 04:48:44,0,0,0,c尖，老师人挺好的，我有两次作业忘记做了，期末周考c程前钉钉问老师发到哪里补交，老师还让我先专心备考，作业的事考完再说。给分也很不错，感觉被老师捞了一把！
188114,1887,肖少拥,2024-01-18 08:32:36,2,2,0,认真负责，有问必答，海底捞！\n\n阶段测试考的差没有太大关系，期末会灵活调整！本人前两次小测做的奇烂，但最后直接被捞到满绩，真的难以置信，感谢XSY老师！！！\n\n我感觉C这门课其实本来就是自主学习成分偏多的，如果你是自学能力比较强的人，选他的课不会吃亏！不过，最好在上课前做好充分的预习工作，不然可能会跟不上（
188294,1887,肖少拥,2024-01-18 15:01:30,1,1,0,我爱他
188847,1887,肖少拥,2024-01-20 08:07:48,3,3,0,在今年大计基期末这么离谱的情况下，我简直无法想象老师是怎么把我捞到这个分的，太感谢了！
188852,1887,肖少拥,2024-01-20 09:18:06,0,0,0,大计基期末卷真的超级恶心，但是最后给分海底捞，赞了10分
188855,1887,肖少拥,2024-01-20 09:38:31,10,12,2,不知道为什么肖老师的评分相较于其他老师这么低\n\n如果说从水平来看xsy绝对是顶尖的\n\n可能正是因为太高级了所以导致有的时候听不懂\n\n而且从今年的大计基A来讲他讲的其实已经很不错了\n\n并且平时问问题他都能比较及时的回复的\n\n期末考卷我不加以评述，因为本质上我在考试的时候更多觉得像是现学现用，但确实也有不少分数是抽象的概念题\n\n但能捞是真的捞\n\n5.0爱死小老头子了\n\n给出10分
188859,1887,肖少拥,2024-01-20 09:58:17,5,5,0,爹！你是真的捞啊！
189016,1887,肖少拥,2024-01-21 08:57:34,8,8,0,肖老师真的很好，感觉很多都是为学生考虑，希望我们能学到东西。\n\n一、他很早就跟我们强调了调试的思想，让我们一定要学会，包括理论课和实验课都演示过。这样实验考的时候就会更稳一些。\n\n二、理论课讲的不快不慢，跟那个教学大纲差不多。如果没有学过c，最好课前要预习，尤其从指针那章开始。\n\n三、上理论课老师会经常给我们拓展，比如经常提及系统函数的应用，一些标准的写法\n\n四、平时小测比别的班应该是多一次，挺好的，也便于调分。期末考前给我们做了一份模拟卷，结果我做的很差，然后开始做肖老师给我们的几份以前的卷子，最后总评98是万万没想到的。所以c这门课是真的要动手去实践，动手去做才能学的好。
189127,1887,肖少拥,2024-01-22 05:18:28,9,9,0,23秋冬上的C程，好老师值得十分\n\n无论是上课内容、答疑热心程度、作业量、小测难度还是给分都是\n\n具体的前人之述备矣，不再赘述\n\n不用担心0基础，C程只要多动手，多思考，多交流（问老师（98有答疑版），问同学，问GPT[doge]）\n\n但是理论考的题确实很智障，建议多刷刷历年题（果然学习和考试是两回事[doge]）\n\n最后，祝每个uu在计算机通识课都取得自己心仪的成绩!
189969,1887,肖少拥,2024-02-04 09:06:12,13,16,3,大家不要被之前的评分误导了，肖老师真的是不可多得的好老师！！！！！！！\n\n首先从上课角度，肖老师的课第一次听肯定会有点难受，尤其是对于零基础的同学来说，因为老师上课会延伸拓展很多，所以在听老师上课之前一定一定要自己先预习。因为我零基础，只顾着自学了没听几节课，现在想起来挺遗憾的\n\n然后肖老师对于同学们上课没有要求，只要实验考（编程）满分，最后考勤全部给满，平时上课可以看智云，也可以自学不听，非常人性化！！！！\n\n再说打分，老师给分很慷慨，超级会捞，大家放心冲！\n\n而且，在今年理论考题型变化的情况下，老师在考前还给同学们发了五套题作为参考，并且最后一节课详细讲解了题型分布，非常顶！（其他大部分老师都没有）\n\n老师本人也是个幽默风趣的超级萌的小老头\n\n最后感谢肖老师，给了大一上第一个满绩
190066,1887,肖少拥,2024-02-18 12:58:55,2,3,1,实在无能听懂上课在讲什么，但小老头真的很耐心，钉钉上问什么都会及时解答。今年大计基a期末确实难，感谢海底捞。
191136,1887,肖少拥,2024-04-08 00:42:28,-36,2,38,lj老师
191621,1887,肖少拥,2024-04-26 03:22:39,1,1,0,谢老师不挂之恩
193066,1887,肖少拥,2024-06-03 08:03:09,0,0,0,好好好
193646,1887,肖少拥,2024-06-14 10:19:50,0,0,0,谢谢老师
196064,1887,肖少拥,2024-07-01 11:07:13,0,0,0,困真的、
196625,1887,肖少拥,2024-07-04 10:00:37,3,3,0,老师很捞！！！C小平时感觉学的一般，自以为最后3点几，没想到出分还蛮惊喜的。感谢肖老师和助教，平时都很负责的
196952,1887,肖少拥,2024-07-06 05:19:28,2,2,0,c小这门课上机挺重要的，老师要求大家上机这一点个人认为是最值得称道的，每周确保有2到3小时的专注学习，期末补一补，不会有太大问题。此外助教也很好，每节上机课都会在。给分的话，老师把我平时分捞满了（当然平时作业和小测都还可以），伟大无需多言。
197211,1887,肖少拥,2024-07-09 07:26:57,7,7,0,伟大无需多言，说捞你是真捞啊！
198047,1887,肖少拥,2024-08-26 14:29:00,4,4,0,伟大，无需多言！！！
198967,1887,肖少拥,2024-09-13 12:11:10,8,8,0,必给肖老师10分，我是c程小白，肖老师解惑真的很耐心，基本是秒回。（虽然不明白肖老师为什么回复会有空格，还有上课时坐后排基本听不到讲课，但肖老师人真的超好）
199023,1887,肖少拥,2024-09-14 06:26:03,4,4,0,非常耐心，延伸很多，答疑仔细迅速
199158,1887,肖少拥,2024-09-18 08:46:10,-4,2,6,老师人很好 但作业量真的很大。。
199370,1887,肖少拥,2024-09-22 10:09:59,23,23,0,肥肠耐心 肥肠 奇妙的 断句空格
201162,1887,肖少拥,2024-10-29 12:35:51,7,7,0,好老师，但上课是真困
203531,1887,肖少拥,2024-11-20 02:55:59,-43,1,44,天天捣鼓你那傻逼网站干嘛呢4m玩意
208397,1887,肖少拥,2024-12-27 10:46:10,1,1,0,水平很高，人很好，只不过听不懂，但是c程好像自学的更多
208399,1887,肖少拥,2024-12-27 10:47:16,3,3,0,古希腊掌管空格的神
208839,1887,肖少拥,2025-01-02 11:19:15,20,20,0,席助教人真的超好
209326,1887,肖少拥,2025-01-05 12:20:49,8,8,0,肖老师真的很负责！给分超好！小席助教真的超级温柔超级负责！！！
209630,1887,肖少拥,2025-01-08 10:26:23,-5,3,8,对不起，我不应该提前打分了，最后分数出来只能说非常非常离谱，算总分给我打到了4.8，xsy对不起，我太爱肖老师了
210018,1887,肖少拥,2025-01-08 02:19:47,13,13,0,肖老师真的捞啊，大谢！
210170,1887,肖少拥,2025-01-08 09:34:22,9,9,0,肖老师大捞🥹🥹大家都选他啊
210185,1887,肖少拥,2025-01-08 10:15:05,8,8,0,成绩出了火速来给小老头打10分！我的第一个满意，真的很感动了。肖老师真的是非常好的老师，坐在讲台上也萌萌的。平常点名不多的，而且他不要求你每次点名都到，只要到了一定次数就给你考勤算满。个人感觉期末总评绝对捞过了，助教gg人也非常好，选了绝对不亏，快冲！
210192,1887,肖少拥,2025-01-08 10:32:52,4,4,0,捞得高的离谱。。
210194,1887,肖少拥,2025-01-08 10:33:49,3,3,0,肖老师大好人，真的捞啊，给我非常满意的绩点，快冲
210195,1887,肖少拥,2025-01-08 10:39:09,2,2,0,真的很能捞(^～^)
210197,1887,肖少拥,2025-01-08 10:47:23,4,4,0,小老头我不允许任何人忤逆你，太捞了，都来选小老头(/^▽^)/ \n\n助教gg人也很温柔，很有耐心
210203,1887,肖少拥,2025-01-08 10:58:58,1,1,0,给分很好
210227,1887,肖少拥,2025-01-08 12:53:46,7,7,0,感谢肖老师，虽然有时还是不懂您的空格，但您真的是一位很好的老师！谢谢您！
210239,1887,肖少拥,2025-01-08 13:49:32,6,6,0,老师上课 非常好 很有耐心也很有 水平 助教也超好 伟大无需 多言 选就完了
210251,1887,肖少拥,2025-01-08 14:23:28,2,2,0,老师人很好，也很和蔼，老师水平很高，但是真的有看到他在努力想让学生听懂。肖老师人也很和蔼，在98上回答问题也特别热心，平时作业也不多。另外，我觉得肖老师打字带空格很有个人特点呐！！很可爱的一位老师，考c程期末考的时候他在我们考场，看见他就觉得很亲切。
210253,1887,肖少拥,2025-01-08 14:34:15,0,0,0,老师上课很难理解，自己顾自己在上课，中后排的同学真的一点都听不来\n\n最后的期末考考得好，他平时分给你拉满\n\n期末考考得不好，平时分不给你捞，感觉编程一般或者偏差的同学谨慎选他的课！
210255,1887,肖少拥,2025-01-08 14:35:32,1,1,0,好老师。\n\n教学水平高，能够讲透知识点的本质，而且还能课外拓展很多知识。\n\n老师人也好，也会及时地在浙大钉上回复问题。\n\n助教也很好，会在上机课或者浙大钉上给我们答疑。\n\n而且真的好捞啊！！神！！
210545,1887,肖少拥,2025-01-09 10:27:37,0,0,0,有基础的直接冲，上课不要听，出分美汁汁儿🤠
210643,1887,肖少拥,2025-01-09 14:17:46,0,2,2,感谢老师！捞了个满绩！上课可能会有点困，但是讲的内容都很好！会有很多扩展！建议听课前多看看书，多练练实验考的题目，很负责，很耐心答疑，很人性化的老师！超级好～
210871,1887,肖少拥,2025-01-10 05:47:20,1,1,0,讲课感觉有点难懂，可能本人无基础，但老师是真捞啊只要好好笑包能拿高分
210889,1887,肖少拥,2025-01-10 06:06:09,0,0,0,我爱你肖老师🌹
211601,1887,肖少拥,2025-01-12 03:52:41,3,3,0,期末考的一坨，但捞的离谱，伟大无须多言
212325,1887,肖少拥,2025-01-14 01:32:21,0,0,0,计基B，上课没听过，作业还忘做了两次。期末速通卷面分91都被老师捞到了4.8。人也很和蔼很耐心，满分！
212799,1887,肖少拥,2025-01-15 02:40:57,0,0,0,真的会捞！！！
214802,1887,肖少拥,2025-02-18 03:48:05,0,0,0,肖老师人很好，很认真负责，问问题会耐心解答，课程考核方式也会反复强调，信息也会通知到位。讲课也在很努力的让同学听懂，课件也都及时发布。计算机科学基础小白看完课件之后再听课就能听懂很多了。课程会有四次小测，每次分值不同。一学期上下来感觉零基础的话最开始会找不到方向，之后根据老师发的考核方案和课件慢慢学，上课也认真听，小测好好考，努力不会白费，期末也不会差。
217292,1887,肖少拥,2025-04-07 16:27:44,0,0,0,无敌好的老师
217480,1887,肖少拥,2025-04-11 03:50:21,0,0,0,其实讲的挺好的，给分也不错
219311,1887,肖少拥,2025-05-24 17:19:00,0,0,0,特别好👌
4511,1888,陆魁军,2015-06-24 04:57:08,-6,13,19,计院最差老师，没有之一
5307,1888,陆魁军,2015-07-06 12:20:49,3,17,14,太水了
6745,1888,陆魁军,2015-07-20 12:12:05,-5,9,14,太差了…妓院最差
7612,1888,陆魁军,2015-09-15 06:32:57,-5,5,10,水平比较低。。\n\n
10306,1888,陆魁军,2015-11-18 04:06:21,12,14,2,要求比较烦
19208,1888,陆魁军,2016-01-23 13:54:41,4,8,4,讲一个笑话
19559,1888,陆魁军,2016-01-24 16:40:54,21,28,7,计网功力很深
20758,1888,陆魁军,2016-01-31 05:41:17,4,11,7,典型的讲课差，课后麻烦，然后给分也低，选了他的课的能换尽量换…
23133,1888,陆魁军,2016-03-19 04:23:16,12,16,4,讲课很仔细， 不错\n\n
23362,1888,陆魁军,2016-03-27 08:16:34,7,10,3,讲得还好，作业最好少点
32110,1888,陆魁军,2016-07-05 15:51:36,7,10,3,公道话，上过他的接口和汇编，属于那种你有实力他就会给你高分的老师，而且感觉x86的汇编和芯片教的清楚的
35335,1888,陆魁军,2016-11-08 13:16:26,7,10,3,挺好的。
41642,1888,陆魁军,2017-01-12 09:36:23,7,26,19,我讲个笑话，今年考试首山雄上课实验都是86，考的是86的卷子，楼sir上课不讲啥实验做mips，考的是自己出的mips的卷子。陆魁军上课讲的是屎一样86，实验做的自己都不会的mips，考试用的是首山雄的86，平时问老师问题总是答非所问，而且超喜欢不停重复一个意思来刷存在感，评分标准一变再变，辛辛苦苦做的东西他改了要求就几乎没有任何意义了，真的，我在浙大妓院遇到过3个菜鸡老师，陈奇(上课哲学事儿还好)，杨莹春(上课我们给她答疑事儿还好)，陆魁军(不管哪方面看都是我在浙大遇到的最菜的老师没有之一，ps:只上过他的汇编与接口，计网不做评论，计组同为硬件课估计差不多)。\n\n第一次在查老师评价一个老师这么多，不喜欢的就踩咯，反正学长是字字肺腑，血的教训。
45012,1888,陆魁军,2017-01-18 23:36:00,-4,4,8,汇编与接口的实验到最后就变成为为其出实验指导书服务。自己说自己是搞计算机网络的。没那么多精力在汇编上。他讲的芯片估计他自己也不太懂。上课的水平实在不敢恭维。很多东西自己都讲不清楚，讲不明白。作业从来不讲评，问助教，助教说自己去看PPT。我要是看会了，还来问你助教。这么水的助教，这么多年在浙大我还是第一次碰到。实验要求比较多。一直不能确定一个实验评分标准。实验做的东西估计自己都不会。
49549,1888,陆魁军,2017-04-18 07:45:07,7,8,1,计网挺好的
52646,1888,陆魁军,2017-06-22 01:30:32,7,13,6,男神，长得帅讲课还好
56364,1888,陆魁军,2017-07-03 14:48:33,9,13,4,我觉得老师人挺好的，上课讲的也挺好，也很关心学生
56812,1888,陆魁军,2017-07-04 16:15:14,-5,3,8,补充一下。\n\n计组期中期末所有题都做出来了，实验也对的，最后给分迷之3.9。很坑。
56844,1888,陆魁军,2017-07-05 01:00:49,4,7,3,讲课不怎么的，但是人很好
56888,1888,陆魁军,2017-07-05 02:28:24,2,6,4,人很好 讲课…
57497,1888,陆魁军,2017-07-09 01:31:53,4,5,1,说实话没学到啥，这主要是个人的原因。老师虽然严格，人还是挺好的
57743,1888,陆魁军,2017-07-13 11:33:52,11,12,1,老师人很好。上他的计组，虽然讲课一般，但很关心学生，最后给分也算众多老师中很好的了。
57748,1888,陆魁军,2017-07-14 00:41:59,32,40,8,计组讲得还可以吧，喜欢用各种拟声词，发现这一点后每次上课我都忍不住笑。。\n\n“在你啪哒啪哒打键盘的时候”“他会啪啪啪地把数据送进去”“从内存吭哧吭哧地搬到cache”
58227,1888,陆魁军,2017-08-26 03:50:09,-1,9,10,怎么说呢，陆大爷牌复读机，有一次睡过头了，早上8点的机组，8点半才到，我还问同学前半个小时讲了什么，同学让我先听着，45分第一节下课同学告诉我他又把前30分钟讲过的东西又讲了一遍。上课水平有限，很喜欢复读，一个观点翻来覆去讲，问问题答非所问，全靠自学，实验施青松数逻班里出来的学生可能都比他了解开发板（怎么说了那么多都在喷）。然而给分巨高，期末稍微努力一下，实验全认真做给分高的一比。如果想认真学硬件去选施青松吧，计组陆魁军你要么自学要么划水……（还有，人脾气非常好）
68688,1888,陆魁军,2018-01-23 15:29:30,9,11,2,人很好，很负责任。
75722,1888,陆魁军,2018-03-15 12:08:13,-10,1,11,讲课跟背贯口似的 ....
78740,1888,陆魁军,2018-05-15 02:58:16,-9,2,11,（计组）可以感觉到陆大爷真的很菜，理论课讲得很浅 经常一个地方翻来覆去重复几次。实验课基本不讲什么东西（感觉他自己都不太）会 全靠看ppt自己研究
78797,1888,陆魁军,2018-05-15 07:30:16,-7,4,11,傻吊老师，请个假都不让
79438,1888,陆魁军,2018-06-05 04:06:28,-5,5,10,复读机，完全不会控制说话节奏，听他讲连ppt都看不进去，恨不得带个耳机或者去隔壁班听课
83648,1888,陆魁军,2018-07-15 01:00:53,2,11,9,上课水平不敢恭维。人很好，考试前一晚讲了下几个大题的题型。人过于'好'，考试两个小时嘴巴没停过，提醒这里提醒那里(虽然都是些很简单没什么用的地方)，严重影响答题节奏，你能忍受考试的时候旁边有个人一直bb没完吗，难受。\n\n实验课水得一批。\n\n想水自学可选，认真学请去sqc。\n\n最后考试建议带耳塞以防万一。
83683,1888,陆魁军,2018-07-11 03:52:23,-5,3,8,考试两个小时几乎全程复读 跟上课一个节奏 吵的根本做不了题 计网已退
84982,1888,陆魁军,2018-07-15 00:27:28,-5,1,6,最后时刻透露关键消息
85035,1888,陆魁军,2018-07-15 05:02:33,5,6,1,给分好，事情少。老师也很关心学生，虽然会一直叨叨，，，但是还行吧
85052,1888,陆魁军,2018-07-15 06:41:57,13,13,0,我觉得讲的很好呀，老师怕你听不懂会不停的问问题，然后讲解。回答问题还有加分。除了最后考试bb半天我觉得还是不错的。
87764,1888,陆魁军,2018-10-11 19:25:00,-1,5,6,瞎布置实验，不考虑学生进度
102273,1888,陆魁军,2019-01-31 15:53:14,2,3,1,还可以 给分完全超出我的预料（的高），建议学弟学妹前几节课认真听找机会回答问题。\n\n（以上评论专指计网）
104477,1888,陆魁军,2019-03-21 08:12:27,7,9,2,很认真负责任的老师~
104955,1888,陆魁军,2019-04-01 02:31:34,13,13,0,老师的课很好 讲的很清晰 也很关注学生 非常好的老师！
105150,1888,陆魁军,2019-04-04 14:54:20,6,9,3,仅评价计网，老师水平很高，对同学非常耐心，跟着就一定能学好。
108015,1888,陆魁军,2019-05-13 02:05:16,9,9,0,老师讲的很详细 很负责
109261,1888,陆魁军,2019-06-12 11:49:34,-3,3,6,讲课实在太差了，听和不同一个样，学弟学妹们千万别选
114441,1888,陆魁军,2019-07-10 03:06:26,6,7,1,老师人特别好，但是还是靠自己学吧
115142,1888,陆魁军,2019-07-16 05:12:39,9,10,1,我觉得挺好鸭
115279,1888,陆魁军,2019-07-17 12:42:09,9,10,1,讲的很仔细～超喜欢老师
118266,1888,陆魁军,2019-10-24 05:51:48,-2,4,6,sb呵呵
126244,1888,陆魁军,2020-09-20 22:36:33,-7,2,9,计组给分太香了
132974,1888,陆魁军,2021-02-05 16:20:52,-3,3,6,计网，实验六人水水，平时分数给满，考前精准押题，发卷前五分钟再讲解一道大题，考后舒适调分。
133002,1888,陆魁军,2021-02-06 05:48:56,-2,5,7,大家一定要选lkj班的计网，平时实验轻松压力小，给分好，考前会透二三十分的题目，我是别的班的，已经被傻逼老师给气死了\n\n计网我认为是全计院最烂的专业课，隔壁qjs平时实验任务量很大给分还很差，千万不要选！
133024,1888,陆魁军,2021-02-06 12:36:13,-5,0,5,计网强推，不点名，实验课全勤就有bonus，作业实验不用卷，交了没硬伤就是满分
136025,1888,陆魁军,2021-07-01 12:20:36,20,32,12,楼下的不要为了这货自杀，未来还有很多东西等着你，不要为了这啥B把自己的生命看的这么低贱
136256,1888,陆魁军,2021-06-14 05:20:34,13,27,14,傻逼傻逼傻逼傻逼傻逼傻逼傻逼傻逼傻逼傻逼傻逼傻逼傻逼傻逼傻逼傻逼傻逼傻逼傻逼傻逼傻逼傻逼傻逼傻逼傻逼傻逼傻逼傻逼傻逼傻逼傻逼傻逼傻逼傻逼傻逼傻逼傻逼傻逼傻逼傻逼傻逼傻逼傻逼傻逼傻逼傻逼傻逼傻逼傻逼傻逼傻逼傻逼傻逼傻逼傻逼傻逼傻逼傻逼傻逼傻逼傻逼傻逼傻逼傻逼傻逼傻逼傻逼傻逼傻逼傻逼傻逼傻逼傻逼傻逼傻逼傻逼傻逼傻逼傻逼傻逼傻逼傻逼傻逼傻逼傻逼傻逼傻逼傻逼傻逼傻逼傻逼傻逼傻逼傻逼傻逼傻逼傻逼傻逼傻逼傻逼傻逼傻逼傻逼傻逼傻逼傻逼傻逼傻逼傻逼傻逼傻逼傻逼傻逼傻逼傻逼傻逼傻逼傻逼傻逼傻逼傻逼傻逼傻逼傻逼傻逼傻逼傻逼傻逼傻逼傻逼傻逼傻逼傻逼傻逼傻逼傻逼傻逼傻逼傻逼傻逼傻逼傻逼傻逼傻逼傻逼傻逼傻逼傻逼傻逼傻逼傻逼傻逼傻逼傻逼傻逼傻逼傻逼傻逼傻逼傻逼傻逼傻逼傻逼傻逼傻逼傻逼傻逼傻逼傻逼傻逼傻逼傻逼傻逼傻逼傻逼傻逼傻逼傻逼傻逼傻逼傻逼傻逼傻逼傻逼傻逼傻逼傻逼傻逼傻逼傻逼傻逼傻逼傻逼傻逼傻逼傻逼傻逼傻逼傻逼傻逼傻逼傻逼傻逼傻逼傻逼傻逼傻逼傻逼傻逼傻逼傻逼傻逼傻逼傻逼
136265,1888,陆魁军,2021-06-17 16:28:58,14,24,10,本来想打个1分就走的，结果看到楼上笑晕了，期中考试拖到现在考，在大家写大作业的时候留一堆之前的作业，之前为什么不留的，在这冲KPI呢？
136291,1888,陆魁军,2021-06-15 15:33:02,-2,17,19,为什么还不死？为什么还不死？为什么还不死？为什么还不死？为什么还不死？为什么还不死？为什么还不死？为什么还不死？为什么还不死？为什么还不死？为什么还不死？为什么还不死？为什么还不死？为什么还不死？为什么还不死？为什么还不死？为什么还不死？为什么还不死？为什么还不死？为什么还不死？为什么还不死？为什么还不死？为什么还不死？为什么还不死？为什么还不死？为什么还不死？为什么还不死？为什么还不死？为什么还不死？为什么还不死？为什么还不死？为什么还不死？为什么还不死？为什么还不死？为什么还不死？为什么还不死？为什么还不死？为什么还不死？为什么还不死？为什么还不死？为什么还不死？为什么还不死？为什么还不死？为什么还不死？为什么还不死？为什么还不死？为什么还不死？为什么还不死？为什么还不死？为什么还不死？为什么还不死？为什么还不死？为什么还不死？为什么还不死？为什么还不死？为什么还不死？为什么还不死？为什么还不死？为什么还不死？为什么还不死？为什么还不死？为什么还不死？为什么还不死？为什么还不死？为什么还不死？为什么还不死？为什么还不死？为什么还不死？为什么还不死？为什么还不死？为什么还不死？为什么还不死？为什么还不死？为什么还不死？为什么还不死？为什么还不死？为什么还不死？为什么还不死？为什么还不死？为什么还不死？为什么还不死？为什么还不死？为什么还不死？为什么还不死？为什么还不死？为什么还不死？为什么还不死？为什么还不死？为什么还不死？为什么还不死？为什么还不死？为什么还不死？为什么还不死？为什么还不死？为什么还不死？为什么还不死？为什么还不死？为什么还不死？为什么还不死？为什么还不死？为什么还不死？为什么还不死？为什么还不死？为什么还不死？为什么还不死？为什么还不死？为什么还不死？为什么还不死？为什么还不死？为什么还不死？为什么还不死？为什么还不死？
136292,1888,陆魁军,2021-06-27 10:45:37,30,44,14,已经到期末了，不想再过多评价了，就讲一句话，这个老师从开学初的6.9分到现在的4.2分，我相信每个上了他计组课的人都知道是什么原因。
136304,1888,陆魁军,2021-06-16 04:17:25,8,21,13,恶心恶心恶心恶心恶心恶心恶心恶心恶心恶心恶心恶心恶心恶心恶心恶心恶心恶心恶心恶心恶心恶心恶心恶心恶心恶心恶心恶心恶心恶心恶心恶心恶心恶心恶心恶心恶心恶心恶心恶心恶心恶心恶心恶心恶心恶心恶心恶心恶心恶心恶心恶心恶心恶心恶心恶心恶心恶心恶心恶心恶心恶心恶心恶心恶心恶心恶心恶心恶心恶心恶心恶心恶心恶心恶心恶心恶心恶心恶心恶心恶心恶心恶心恶心恶心恶心恶心恶心恶心恶心恶心恶心恶心恶心恶心恶心恶心恶心恶心恶心恶心恶心恶心恶心恶心恶心恶心恶心恶心恶心恶心恶心恶心恶心恶心恶心恶心恶心恶心恶心恶心恶心恶心恶心恶心恶心恶心恶心恶心恶心恶心恶心恶心恶心恶心恶心恶心恶心恶心恶心恶心恶心恶心恶心恶心恶心恶心恶心恶心恶心恶心恶心恶心恶心恶心恶心恶心恶心恶心恶心恶心恶心恶心恶心恶心恶心恶心恶心恶心恶心恶心恶心恶心恶心恶心恶心恶心恶心恶心恶心恶心恶心恶心恶心恶心恶心恶心恶心恶心恶心恶心恶心恶心恶心恶心恶心恶心恶心恶心恶心恶心恶心恶心恶心恶心恶心恶心恶心恶心恶心恶心恶心恶心恶心恶心恶心恶心恶心恶心恶心恶心恶心恶心恶心恶心\n\n\n\n我只是在说《让子弹飞》的台词而已
136310,1888,陆魁军,2021-06-16 06:39:14,6,16,10,快跑啊，傻孩子们！
136312,1888,陆魁军,2021-06-16 07:33:24,9,19,10,预置lkj的计组建议直接退，可以说一学期下来没有任何收获，平时作业和小测一直拖，讲课水平差（怀疑他自己都不怎么会，让我去讲都比他强），你不会的不讲，无关紧要的扯一大堆，简单知识点复读，责任心也不怎么强，上课应付差事，实验自己不讲还破烂要求多，全靠看别的老师的PPT研究（感觉我们第一届RISC-V的实验设计本身就很差劲，拼凑痕迹明显，小问题很多，对进度没有把握，一看就是现做的，没有打磨过，实验PPT大量重复，没有一针见血，不能很好地帮助学生理解系统而是给学生增加负担）。总之只听了两节课，完全靠自学（好在课本身不算难），想听高手指点的同学和自学能力不强的同学千万不要选（唯一的好处是上课不点名）！！！
136323,1888,陆魁军,2021-06-16 08:07:55,7,18,11,快跑快跑快跑快跑快跑快跑快跑快跑快跑快跑快跑快跑快跑快跑快跑快跑快跑快跑快跑快跑快跑快跑快跑快跑快跑快跑快跑快跑快跑快跑快跑快跑快跑快跑快跑快跑快跑快跑快跑快跑快跑快跑快跑快跑快跑快跑快跑快跑快跑快跑快跑快跑快跑快跑快跑快跑快跑快跑快跑快跑快跑快跑快跑快跑快跑快跑快跑快跑快跑快跑快跑快跑快跑快跑快跑快跑快跑快跑快跑快跑快跑快跑快跑快跑快跑快跑快跑快跑快跑快跑快跑快跑快跑快跑快跑\n\n（这是计组的评价）\n\n\n\n没见过老师一个周末能在群里每隔十分钟说一句话的，什么“家里有人生病”等话也在群里说，你说我不反对，我也对你表示同情，但这都是借口而已。你的这些乱七八糟的理由可以解释你忙，但是解释不了你傻逼\n\n\n\n还有，此老师经常半夜一两点在群里发消息，发课件，合着老师您不睡觉的啊，您注意身体\n\n\n\n实验课两节课，每次都是花一节课开电脑......\n\n他的服务器永远都是有bug，不是精通计网吗，连个服务器天天出故障也弄不好？实验课没助教，自己也不会，期末冲业绩，很恶心哦\n\n\n\n还竟然有计院老师，连CSDN都不知道.........................
136392,1888,陆魁军,2021-06-17 10:19:49,2,11,9,世一大为什么有这种垃圾老师，骂他都浪费我时间
136393,1888,陆魁军,2021-06-17 10:19:30,1,10,9,世一大为什么有这种垃圾老师，骂他都浪费我时间
136416,1888,陆魁军,2021-06-17 16:35:19,-1,9,10,你是计院最差的老师！！！！你是计院最差的老师！！！！你是计院最差的老师！！！！你是计院最差的老师！！！！你是计院最差的老师！！！！你是计院最差的老师！！！！你是计院最差的老师！！！！你是计院最差的老师！！！！你是计院最差的老师！！！！你是计院最差的老师！！！！你是计院最差的老师！！！！你是计院最差的老师！！！！你是计院最差的老师！！！！你是计院最差的老师！！！！你是计院最差的老师！！！！你是计院最差的老师！！！！你是计院最差的老师！！！！你是计院最差的老师！！！！你是计院最差的老师！！！！你是计院最差的老师！！！！你是计院最差的老师！！！！你是计院最差的老师！！！！你是计院最差的老师！！！！
136417,1888,陆魁军,2021-06-17 16:33:06,1,11,10,rnm退钱
136485,1888,陆魁军,2021-06-18 14:49:52,1,11,10,退钱\n\n退钱退钱\n\n退钱退钱退钱\n\n退钱退钱退钱退钱\n\n退钱退钱退钱退钱退钱\n\n退钱退钱退钱退钱退钱退钱\n\n退钱退钱退钱退钱退钱退钱退钱\n\n退钱退钱退钱退钱退钱退钱退钱退钱\n\n退钱退钱退钱退钱退钱退钱退钱退钱退钱
136510,1888,陆魁军,2021-06-19 15:46:07,3,11,8,好的老师千篇一律，差的老师各有各的恶心之处。\n\n分数高的老师可能并不像分数这么好\n\n但是分数低的老师，绝对有垃圾的地方。\n\n\n\n我觉得群众的眼睛是雪亮的，大家都打那么低分，那么多差评，我只能说，别人的评价完全正确，毫无虚假，你若不信，可以试试，别说我们没提醒你
136522,1888,陆魁军,2021-06-20 04:41:27,-1,8,9,陆魁军，拉跨极了！\n\n\n\n今年评教不骂人，骂人就骂陆魁军！
136543,1888,陆魁军,2021-06-20 15:33:09,-4,6,10,垃圾老师像垃圾，老师垃圾好恶心
136560,1888,陆魁军,2021-06-21 04:49:32,-3,6,9,退钱\n\n退钱退钱\n\n退钱退钱退钱
136602,1888,陆魁军,2021-06-21 16:46:03,0,9,9,大二最遗憾的事情就是选上了陆魁军的计组了吧
136614,1888,陆魁军,2021-06-29 02:54:24,10,19,9,6.29号计组课打卡留念。楼下的兄弟已经说的很好我就不献丑了😅😅
136626,1888,陆魁军,2021-06-30 17:45:38,12,20,8,7/1 00：47布置作业，7/2 10：30考数据库，7/2 15：00作业ddl，合计合计我们只要搞你的计组就行了，其他的课都不是课是吧，平常你随便布置作业我们也没话说，考试周布置作业其他课不用念了是吧，不要跟我说他就布置了两题，考试前一天最忌讳读隔天不考试的科目，因为你必须让自己的精神完全集中在那些明天就要考的科目上（如果你是随便念都能上4或满绩的学霸那当我放屁）。提前布置很难吗？给个久一点ddl很难吗？没错对lkj你来说确实很难，因为你每天只想着会有教育局的人员来查你，然后用很多漂亮话来敷衍我们，而没有考虑过你的那些行动和决策会给我们带来什么样的影响，哪怕你6/30日布置这份作业我都不会这么生气，但我告诉你，教育局的人员过来找你麻烦未必只有教评这一种情况
136630,1888,陆魁军,2021-06-22 06:58:58,-1,9,10,恶心死了恶心死了恶心死了恶心死了恶心死了恶心死了恶心死了恶心死了恶心死了恶心死了恶心死了恶心死了恶心死了恶心死了恶心死了恶心死了恶心死了恶心死了恶心死了恶心死了恶心死了恶心死了恶心死了恶心死了恶心死了恶心死了恶心死了恶心死了恶心死了恶心死了恶心死了恶心死了恶心死了恶心死了恶心死了恶心死了恶心死了恶心死了恶心死了恶心死了恶心死了恶心死了恶心死了恶心死了恶心死了恶心死了恶心死了恶心死了恶心死了恶心死了恶心死了恶心死了恶心死了恶心死了恶心死了恶心死了恶心死了恶心死了恶心死了恶心死了恶心死了恶心死了恶心死了恶心死了恶心死了恶心死了恶心死了恶心死了恶心死了恶心死了恶心死了恶心死了恶心死了恶心死了恶心死了恶心死了恶心死了恶心死了恶心死了恶心死了恶心死了恶心死了恶心死了恶心死了恶心死了恶心死了恶心死了恶心死了恶心死了恶心死了恶心死了恶心死了恶心死了恶心死了恶心死了恶心死了恶心死了恶心死了恶心死了恶心死了恶心死了恶心死了恶心死了恶心死了恶心死了恶心死了恶心死了恶心死了恶心死了恶心死了恶心死了恶心死了
136640,1888,陆魁军,2021-06-22 12:39:17,0,9,9,我为你感到可悲，为计院有你这样的老师感到可悲
136648,1888,陆魁军,2021-06-22 11:35:08,-20,12,32,下面的一连排评论都是一个小组(或者说一个人？)刷的，所以语气都一样。我也是没想到浙大还有这样的喷子。建议那个小组的同学反思反思自己，至于戾气这么重吗？陆老师没有他们说的那么不堪，建议学弟学妹们找上过这个课的学长学姐了解一下。喷实验的，说真的，别的班都是一个人单干，一个人一份实验报告，就陆老师班四个人一起做，交一份报告，都水成这样了，有什么不满意的？楼下的同学天天躲在查老师骂，连着搞了这么多天，自己不累吗？\n\n而且你要是觉得陆老师教的不好，完全可以不听，反正他又不点名，你去别的班蹭课or智云课堂完全可以，而且陆老师的课给分好是有名的，不信学弟学妹可以跳过楼下的喷子，看看之前的人对陆老师给分的评价。建议后来者看查老师，不要只关注一个sb刷的一大批评论，多往后翻翻。
136748,1888,陆魁军,2021-06-24 03:00:31,1,8,7,今天咋没更新了，xdm都等着点赞呢😛
136778,1888,陆魁军,2021-06-24 10:06:48,0,8,8,朝令夕改，凌晨发要求，你当大家天天都在实验室吃喝拉撒了是吧？
136889,1888,陆魁军,2021-06-27 14:45:29,0,8,8,有的老师来教计组\n\n\n\n有的老师来学计组\n\n\n\n建议当老师之前先学学做人
136918,1888,陆魁军,2021-06-28 07:35:35,1,9,8,建议您先去别的老师班里面学学，计组是坨屎吧\n\n\n\n你是生怕学生学会计组吗？？？？？？？？？？？？
136938,1888,陆魁军,2021-06-28 11:07:32,0,8,8,不能说是愚蠢，简直就是愚蠢
136990,1888,陆魁军,2021-06-29 07:56:49,-1,9,10,6.29验收尼玛呢？啥都不会，也不让别人插手，一个小时一个组都验收不完，还说什么上面教育局的老师来验收检查bulabula\n\n\n\n你也太有自信了吧，教育局来会查你？你可是浙大最差的老师啊，不能有点自知之明？\n\n\n\n或许我们应该包容一下这个老师，可能今天是忘吃药了，建议晚上回去吃两顿屎补一补脑子\n\n\n\n无语至极，离天大谱\n\n\n\n一个庸医害一个人，一个庸师害一群人。\n\n\n\n您还是回去科研吧，科研出来什么狗屁东西都和我们没有关系，但是您搁着祸害学生，滚！
136991,1888,陆魁军,2021-06-29 08:00:32,-3,6,9,这种人应该多交300块医保
137016,1888,陆魁军,2021-06-29 12:39:00,-5,3,8,在选课之前看到查老师上评价：计院最差的老师！我最开始还挺担心的，不过上完计组下来我发现我的担心是多余的，因为他是浙大最差的老师啊！\n\n\n\n要是问上完计组学到了什么，不能说很多吧，只能说没有。自己把课上成这个烂摊子，也讲不清楚，实验也是各种无理取闹的要求，估计自已也不会。感谢智云保留刘海风回放救我狗命！
137081,1888,陆魁军,2021-07-29 05:37:17,18,18,0,注意身体
137087,1888,陆魁军,2021-06-30 17:18:38,4,12,8,牛蛙，考试前两天突然布置ddl仅剩一天的作业
137089,1888,陆魁军,2021-06-30 18:43:30,1,9,8,lkj老师在数据库考前一天布置计组作业，数据库考试当天作业ddl，截止的点还刚好卡在下午的马原考试上。您周二实验验收还很“贴心”地问我们计组是不是第一门考试，后面还有没有考试，我说前后都有考试，然后您说“考试要紧，别让实验影响复习，实验尽力就好”，当时还心里一暖，然后您就来这一出，真的是搞人心态。之前您说老母生病，没时间整理习题答案，我还是挺同情的（我觉得是个成年人都能理解，再说高校教师也都挺不容易的，很多都是非升即走），觉得实验准备不充分也情有可原，虽然讲课水平有限，但是夜里一点钟发改好的PPT还是体现出您的敬业。但是，您考试周前的一些行为真的让人很不是滋味：拖到考试周前做期中考试、反复修改实验要求、找学生当“助教”设计实验检查方案、考试前一天验收实验……您的实验相比于别的班确实比较“水”，但考试周前大家都忙的时候改实验要求，在学生最忙不开的时候增加工作量，这谁吃得消啊！请问您真得替学生着想过吗？了解学生的利害所在吗？每次都是表面上是在关心学生，实际上连学生们的一点小建议都听不进去，我实在是不理解。如果您真的关心学生，就应该让他们学到更广博和深入的知识，跳出制度的禁锢，见识到更广阔的世界，而不是把他们的时间和精力浪费在这些无意义的活动上、鼓励恶竞。2021.07.01 1:58，抄着数据库一张纸，看到您在钉钉群发的那些文字难以入眠，写下这些评价，希望学弟学妹们慎选！
137111,1888,陆魁军,2021-07-01 08:43:25,-1,8,9,自己想出来的各种阴间的策略和任务，自以为掩盖了自己的无知，美其名曰规章制度，公平合理，究竟是多么的拙劣和可笑，简直不堪一击！
137117,1888,陆魁军,2021-07-01 09:29:29,-15,2,17,进入浙大以来第一次，我想自杀了
137308,1888,陆魁军,2021-07-03 04:43:22,4,13,9,好老师！
137416,1888,陆魁军,2021-07-04 05:00:37,0,9,9,考试的时候，你BB你妈呢
137420,1888,陆魁军,2021-07-04 05:17:43,23,29,6,怎么说呢，虽然考试的时候是很啰嗦，但他本意还是为了我们得高点分的，尽管方式可能不太好，不过还是说了点有用的话。考前在群里的答疑也够意思了，陪我们到凌晨，早上起来也给答疑。他之前的安排是很窒息，但没必要把以前实验安排的情绪也放到考试的事情上来。反倒是考试的时候有些同学利用老师的善心，不断的问这问那，其实很多东西题目描述的没有问题，而你去问的话老师会给你把这题讲一遍，然后又给大家再讲一遍。zero寄存器老师看起来确实是不知道这是x0的convention name。但你不认识zero的时候，应该是先反思是不是自己的问题，而不是去问老师zero是什么。遇到不会的题就问老师算什么本事？考试环境如此嘈杂，我想不光是老师的问题。
137478,1888,陆魁军,2021-07-04 11:19:17,2,2,0,我大无语
137682,1888,陆魁军,2021-07-05 14:56:59,5,7,2,这个计组实验啊，最后lab2，lab5因为自己没时间验收了，就都不给大家打高分，合着我选这个老师就理论上比别的老师要低是吧，这还搞个屁啊艹
137736,1888,陆魁军,2021-07-06 02:36:48,4,5,1,事情真尼玛多，到处乱布置
138969,1888,陆魁军,2021-07-12 04:33:59,6,7,1,虽然平时是真的麻烦又啰嗦，但是给分出来后emmm，勉勉强强可以给个4-5分吧，希望他能洗心革面，不要再用对待我们的方式对待学弟妹了
138980,1888,陆魁军,2021-07-12 05:29:56,8,10,2,事情贼jb多，出分发现真香。今天我就是陆大爷舔狗
139075,1888,陆魁军,2021-07-12 12:46:26,8,9,1,这是要风评逆转了？？？？
146398,1888,陆魁军,2022-01-06 13:01:17,7,7,0,荷兰人集合
146535,1888,陆魁军,2022-01-07 01:35:20,22,28,6,必须是10分，少一分我都不同意，lkjyyds，以前我不懂事，现在我只想每门课都是陆老师
146550,1888,陆魁军,2022-01-07 02:03:39,8,12,4,计网考完叫声爹不过分吧
146553,1888,陆魁军,2022-01-07 02:15:19,16,18,2,计院最大的遗憾就是陆老师教的课太少了
146555,1888,陆魁军,2022-01-07 02:25:26,11,11,0,陆老师的4分有12分是计网的，计组倒扣了8分
146557,1888,陆魁军,2022-01-14 12:17:52,9,14,5,计网平时分在搞笑吧
146558,1888,陆魁军,2022-01-07 02:29:08,16,16,0,荷兰人荷兰人 Lkj yyds
146566,1888,陆魁军,2022-01-07 02:49:29,-23,1,24,计网透题不透完整，就只有一部分
148149,1888,陆魁军,2022-01-11 15:45:01,15,22,7,实验给分是傻逼吧，不知道TA脑子坏了还是老师有问题
148983,1888,陆魁军,2022-01-14 05:46:27,37,42,5,yysy陆老师在上好计算机网络这门课上的努力还是比较多的，虽然课堂讲的内容不那么明确有趣，但课下积极解答学生提出的问题，实验尽心尽力地讲解，确实尽到了自己能尽到的责任。说两个这学期比较感动的事情：1.做计网lab4还是5的时候，老师上课一如既往在卖力地讲课，但是没有什么同学认真听，老师就问大家是不是并不需要他讲，自己也可以做。没人回应就让有需要讲解的同学举手，看见没人举手需要讲解，就不再讲课了，把时间留给大家。感觉老师内心有一点点心酸......一把年纪了确实很难把知识生动有趣地传授给大家，但能感受到他的努力。2.考试结束后公布作业与试验情况的分给的不好，于是我就去找老师询问，老师特意回电话给我询问我相关情况，承诺调整分数然后还问了问大家平时的学习情况，预期分数等等，聊了十几分钟。感觉蛮不容易！考试的题目内容也算对大家仁至义尽了，希望大家至少再计网这门课上少一点恶评，多一点理性！
149909,1888,陆魁军,2022-01-17 17:01:06,9,11,2,老师水平真的不错的，实验一直找不出问题，老师一下就看出来了
150142,1888,陆魁军,2022-01-19 09:56:41,5,6,1,就冲老师的耐心解答和考前复习，打10分！
154159,1888,陆魁军,2022-05-25 02:04:14,4,5,1,讲的好的老师本来就不多。老师人已经很好了，人品也很好，打10分
155543,1888,陆魁军,2022-06-14 07:39:47,6,12,6,计组。除了讲课水平不太能博得大多数同学的注意，陆老师这学期认真负责，完全没有往届评论所说的恶行。第一节课就提前讲清整个学期的课程及实验进度，实验课件按时布置，了解到单周期CPU有同学没来得及验收还主动延长ddl，有时上课会提问课本重难点，答对问题还能加平时分（并不难），硬件课程遇到难理解的部分总是反复讲解和鼓励同学不要畏难（甚至讲的有点啰嗦了），课后同学找他提问有问必答，平时习题量不多但都挺有针对性（甚至还有一两题是往届期末题），考前一天晚上钉钉群答疑，反复强调重点还甚至提供例题说明，期末考试过程也没有一直讲题，同学问他只是小声回答，只有共性问题才会对考场所有同学说明。计组这种硬件课程是需要自己的努力的，陆老师基本上把他能做的都做到了，我相信老师的评分会越来越高的。
155630,1888,陆魁军,2022-06-15 01:09:41,6,9,3,说实话， 老师除了上课真的不咋地以外其他还是不错的\n\n特意在出分之前评价也是因为不想被绩点影响对他的评价\n\n这学期也没有像上学期一样考前布置作业， 当然同样的也没有透题(\n\n事情不多， 作业不多， 老师也挺负责的\n\n至于讲课不行这件事， 也没法求全责备， 计院挺多老师都这样， 可以去听海风姐姐的课
155648,1888,陆魁军,2022-06-15 03:45:42,1,4,3,陆大爷人真的挺好的
156547,1888,陆魁军,2022-06-20 08:30:07,4,6,2,快出分吧
157661,1888,陆魁军,2022-06-24 09:08:22,1,4,3,感觉给分挺好的
159445,1888,陆魁军,2022-07-20 09:16:34,3,6,3,坐标计组\n\n一学期下来觉得lkj老师人还是不错的\n\n讲课的时候容易一个知识点重复讲很多遍，感觉思路不是很清晰，但老师有很努力在讲了，也会在上课征询大家听课感受，还是很用心的\n\n今年没有出现乱布置作业情况。作业和实验会征求大家关于ddl的意见。\n\n实验可以2人组队，相比其他班级任务量会轻很多。\n\n个人感觉期末考试时候有点吵了，提醒的内容对我个人而言有些没必要，因人而异吧。
161331,1888,陆魁军,2022-11-04 07:19:12,0,5,5,实验过于垃圾，上lkj的计网就相当于上楼sir的计组
162691,1888,陆魁军,2022-12-04 15:09:35,1,3,2,？？？
164696,1888,陆魁军,2022-12-23 12:30:46,1,5,4,努力型老师，教课非常认真
167383,1888,陆魁军,2023-01-16 01:42:14,8,10,2,出分好慢！
167451,1888,陆魁军,2023-01-18 16:29:15,1,10,9,谁再敢黑陆老师我跟谁急
167719,1888,陆魁军,2023-01-18 14:44:53,4,12,8,你是我的，神！
167722,1888,陆魁军,2023-01-18 15:21:45,5,12,7,【计网】先开始爆吹环节：请说出最好的计网老师，并说明为什么是lkj\n\n他真的我哭死，出分慢只是为了捞我们让我们过个好年呜呜呜\n\n客观评价：陆大爷上课确实非常认真，好几次九点十五结束的课给上到十点左右（线上），但由于确实有点口音，两周之后我就很少听课了，实际上据说还是讲的比较生动的，实验方面没有改革，还是那一套祖传实验，就是说做的很无聊很崩溃，不过给分真的很ok，感觉上应该是平时分拉满了，计网全给我冲陆大爷！
167723,1888,陆魁军,2023-01-18 15:55:52,3,9,6,陆圣！计网真神，至少捞了十几分
167733,1888,陆魁军,2023-01-18 16:12:48,2,4,2,讲课非常催眠，给分神了，给陆大爷8分。\n\n针对这门课，不止是陆大爷，lab 和课程进度安排不一致实在是太蛋疼了，另外 lab 质量也算不上高。\n\n计网里面细节太多，上课也不好听，建议看自顶向下方法，可以完整详细地学习到发展过程以及思想。如果应付考试，王道足矣。
167742,1888,陆魁军,2023-01-18 23:11:37,1,4,3,计网我的神！
167939,1888,陆魁军,2023-01-20 14:32:31,-1,6,7,计网不选lkj 选谁
168709,1888,陆魁军,2023-02-21 09:22:41,4,6,2,。。。。
170087,1888,陆魁军,2023-03-01 10:31:07,-2,4,6,lkj yyds\n\n计网不选他选谁
174489,1888,陆魁军,2023-06-13 04:23:11,9,12,3,给陆大爷写了两次邮件已读不回，谢谢你
177250,1888,陆魁军,2023-07-08 08:34:10,-6,3,9,计组吹爆
183165,1888,陆魁军,2023-11-22 13:03:33,14,15,1,目前冬学期第二周\n\n我发现他是个老馋\n\n每次实验课把大家6：50叫来，至少7：30才开始讲课，今天更是拖到8：50才开始。期间不断拉扯，纯纯唐氏一个。\n\n目前在还没出分的情况下客观评价一下真实水平就是1分\n\n而且为了大家听他的课还上课提问加分、做实验提bonus，实验课点名种种作妖。\n\n而且老忘记ddl，什么事情感觉都是张口就来没经过三思，网传的考试喋喋不休我更是在上个学期体验过了，体验很差。\n\n天下苦lkj久矣，老师真的需要改变一下了
183739,1888,陆魁军,2023-11-29 11:46:49,14,15,1,体验真的不好，整很多花活，事情很多，实验课理论课次次点名，上课几乎必须要去，回答问题加分，但是听他讲课简直折磨。各种奇奇怪怪的事情很多，沟通也困难。做了bonus的还得经过很无聊的拷问，加分什么的让人不管躺平还是去卷都难受。
183744,1888,陆魁军,2023-11-29 13:41:51,9,10,1,我是真的无语，简直了。我给你1分都嫌多。实验课整天就知道浪费学生的生命，理论课真实不知所云。你是有几个码支持你这么抽象啊。
183745,1888,陆魁军,2023-11-29 13:42:02,9,10,1,我需要一个比一分更低的档位来评价lkj
184039,1888,陆魁军,2023-12-07 04:05:55,8,8,0,不讲课了能不能放人吃饭去啊**
185807,1888,陆魁军,2024-01-04 13:29:55,5,6,1,记录一下，\n\n1.10上午考计网\n\n1.4晚上，还有一次作业+一次100题没放出来
189265,1888,陆魁军,2024-01-23 11:10:50,8,9,1,哈哈，给分奇烂无比，陪你一学期玩过家家就这？\n\n\n\n补充一下，为什么说上🦌✌的课是浪费生命，上个实验课，一看就是根本没准备过要讲啥，还把大家都叫过来浪费生命。
189266,1888,陆魁军,2024-01-22 16:27:38,9,10,1,23年真的烂中烂 事情多 平时分还先-5
189267,1888,陆魁军,2024-01-22 16:31:04,7,8,1,平时上课作妖，节节点名，最后平时分还要压分比别的班低，勾史依托，1分不谢
189268,1888,陆魁军,2024-01-22 16:36:56,5,5,0,陆✌可真牛啊，屁事最多，给分最差。给你1分都嫌多。
189305,1888,陆魁军,2024-01-23 03:41:54,5,6,1,烂中烂，每个环节都令人糟心。。。
189308,1888,陆魁军,2024-01-23 04:19:41,6,7,1,计算机网络：\n\n1. 给分真的差，平时分低，有的作业上来就先扣五分压分。再加上这课的考试是全客观题，总评分数给的确实低。\n\n2. 平时作业实验ddl不明确，提交通道迟迟不开，管理十分混乱。作业反馈不及时，所有作业实验都是在最后批改，实验中同样的错误就会反复扣分。\n\n3. 上课经常点名，而且经常玩“狼来了”，说着点名把大家叫过来然后忘记点名了。点名通常是二维码点名，只有半分钟，点不上需持有效证件手动点名。\n\n4. 讲课讲的比较细，但同样的内容往往会重复讲解，感觉逻辑不太清晰。最后一节课还在上讲网络安全的新课，讲一些同学们之前课程学过的安全知识，没有复习。
189435,1888,陆魁军,2024-01-24 06:36:13,6,6,0,我只想问一句，辛苦两天写好的bonus加到哪里去了，又是谁询问bonus平时分的消息出分前的下午还未读，出分后就已读不回了！
189454,1888,陆魁军,2024-01-24 10:37:24,10,11,1,细数四宗罪：\n\np事最多：每次晚上有事都恶意用点名绑架同学陪他\n\n爱找存在感：特别希望整些骚操作给大家增加工作量来证明自己存在的价值，比如上课发言加分、分享实验经验（主要平时分最高只有95，你若想要好的成绩必须为虎作伥）。很难想象生活是有多么的不如意，建议老师的儿女能给老人多点陪伴。\n\n给分差：授意助教作业最高分95，并且报告批改很严格，还特别喜欢光速点名，还觉得自己特别威严。\n\n讲课差：来回讲同个内容多次，导致没有时间讲一些重点，叫大家自己看。而且讲课没有逻辑，导致前后根本串联不在一起\n\n\n\n那个副教授lkj早就已经死在千禧年的钟声里了，所有的成就都停留在2000年前，上课还反复提及自己19XX年的光辉岁月，交作业还用ftp导致ddl不清晰。现在的lkj无论之后给分是否好，都已经是一具干尸了，不建议大家选。
189533,1888,陆魁军,2024-01-25 08:43:50,12,13,1,依托答辩，为什么这种出生还能呆在浙江大学，还是快点退休回家养老吧\n\n上课烂，口齿不清唾沫飞溅，永远不知道在讲什么，还喜欢心安理得地拖课\n\n给分烂，压平时分，即使作业全对你也最高只能有95分\n\nB事多，特别需要存在感，他会让同学上课回答问题给加分(到底加没加还未知）。实验课说自己要《讲实验》必须到要签到，6: 50的实验课自己7:30才到，然后坐在电脑前和si了一样一句话不吭，到8:30开始说话，9:00点名，这么玩是吧。陆某这些行为也确实说明了我国养老制度还是不够完善，老爷子孤家寡人的，需要我们这些学生陪着他浪费时间，给他温暖呢。\n\n总的来说煞笔一个 快逃\n\n彩蛋:这家伙办公室在曹东五楼，大家猜猜曹东五楼都有哪些《神仙》老师
197022,1888,陆魁军,2024-07-06 17:31:02,4,4,0,计组，没什么好说的，第一次上课体验这么差。\n\n1. 前15周总共布置1次平时作业，第16周布置3次作业，期末周计组考试前两天布置平时测试（实际是当期中考）。赶KPI的水平节奏必学生还离谱。\n\n2. 班级内总共15人，最终期末考到考场9人，平时作业完成8人左右，实验完成验收4人。\n\n3. 不知道和学在浙大有什么仇，非要用ftp交作业。DDL是截止前两天才能讲明白的，最后DDL提交甚至服务器是会崩的。\n\n4. 平常群里私聊问问题永远装死，可能运气好三四天会进行一个回复。\n\n5. 课是讲的，效果是和看PPT一样的。个人认为直接看PPT/笔记效率和效果会更好。\n\n6. 签到是喜欢签的，可能看到教室里每节课三四个人比较寂寞吧。\n\n7. 给分非常非常非常一般，个人觉得没捞。作为到场期末考试9/15，平时作业完成的8/15，完成实验验收的4/15，完成实验bonus的3/15，不知道平时分到底是谁在拿。\n\n8. 助教人不错，可惜。\n\n9. 为什么最低分是1分。\n\n10. 以上内容为个人视角，或许不够求是，如果有兴趣的话可以尝试一下。\n\n个人认为作为一个老师，做不到成为学生发展的动力，那至少别学生给学生添阻。您老如果真的很忙，可以不用百忙之中抽空开一门课恶心人的。\n\n真是一次酣畅淋漓的赤石啊。
198233,1888,陆魁军,2024-09-05 12:12:40,10,10,0,石马东西，推免TM四你手里
214082,1888,陆魁军,2025-01-23 13:24:28,5,6,1,纯纯的畜牲，没妈的东西，上课是屁也不讲的，实验是瞎几把留的，期末考试是一分也不捞的，这种东西怎么也配在zju当老师？计院是真没人了吧
214431,1888,陆魁军,2025-02-03 04:14:47,0,1,1,计算机网络。讲课极啰嗦，最重量级的是问老师的时候，老师宣称考试范围跟课件范围不一致，那我还听你干啥呢。点名的时候会数班级里的人头数，所以不得不到课。今年开了两个班，周二班实验课点名过，但是周四班没有过，实际上可以在理论课上跟他商量实验课要不要去，老师听起来也嫌上实验课麻烦。其实人不坏，会为学生考虑，但他有自己一套想法，不能真正听取和理解大家的需求，加上讲课也不行，实验不把需求说透要求还高，给分也差（今年临时招的助教应该是尽力捞了但是在老师压力下收效甚微），那被同学们责骂也是应该的。听说老师就要退休了，祝他安享晚年吧。
1354,1902,陈建海,2015-03-22 00:45:27,32,39,7,感受幽默中的c程知识
1425,1902,陈建海,2015-03-22 02:44:44,87,101,14,幽默风趣，讲的蛮好的！
1845,1902,陈建海,2015-03-26 01:48:25,6,10,4,幽默
2652,1902,陈建海,2015-05-05 03:14:16,4,6,2,人挺好玩的。技术党。讲的内容很实在可以学到东西。回答问题也很清楚。不过我不觉得上课风格幽默。
3905,1902,陈建海,2015-06-17 07:58:27,6,9,3,很棒的老师，上课很有趣
4062,1902,陈建海,2015-06-17 15:43:15,11,14,3,老师棒棒哒！很有个性的老师，也很理解学生！
4526,1902,陈建海,2015-06-24 07:08:12,3,5,2,很风趣很人性化，上课也很好
4717,1902,陈建海,2015-06-26 12:11:05,83,100,17,人超级好，平易近人。上课幽默风趣完全没有老师的架子，就像一个和我们差不多大的学生。10.71.45.100网站就是他编写维护的，实力很强，大赞
4722,1902,陈建海,2015-06-26 12:19:33,7,10,3,很好的老师~上课很有趣，人也很好，跟他交流都挺开心的。
4770,1902,陈建海,2015-06-28 08:20:37,16,23,7,好老师
5996,1902,陈建海,2018-06-13 06:25:39,63,83,20,上课很好，就是平时的练习题太多而且难。
6236,1902,陈建海,2015-07-12 08:32:08,3,5,2,老师很好
6238,1902,陈建海,2015-07-16 07:25:27,4,6,2,T_T_TT_TT_T
6245,1902,陈建海,2015-07-12 09:55:33,-2,2,4,萌萌哒
6277,1902,陈建海,2015-07-12 14:38:35,19,26,7,海哥上课讲的蛮清晰的，很多学习资料都能在98版上找到，在98上积极互动还有加分。没有满绩真是对不起！
6366,1902,陈建海,2015-07-13 08:39:04,35,44,9,人帅，幽默，给分高。这些还不够吗？美中不足就是我没去cc98混一点绩点回来
6394,1902,陈建海,2015-07-13 13:39:54,-3,8,11,挂了……
6664,1902,陈建海,2015-07-17 14:14:00,9,13,4,老师讲的很清楚呀…而且经常在cc98答疑，给分也很厚道，赞赞赞！
7490,1902,陈建海,2015-09-14 23:38:57,0,2,2,哈哈哈哈
7704,1902,陈建海,2015-09-15 10:16:19,0,2,2,太有意思了
7900,1902,陈建海,2015-09-16 04:42:40,3,5,2,好有趣好有意思，反正不想睡！
8483,1902,陈建海,2015-09-22 00:10:37,0,2,2,好好好
8501,1902,陈建海,2015-09-22 02:08:58,1,3,2,有趣   上课幽默
8784,1902,陈建海,2015-09-27 09:01:37,0,2,2,网站老大就是厉害
8840,1902,陈建海,2015-10-14 09:41:27,43,65,22,作业多而且太难，自己做时简直就是弄坏自己的电脑
9096,1902,陈建海,2015-10-13 03:11:34,-1,3,4,挺有意思的
9404,1902,陈建海,2015-10-26 07:21:37,2,3,1,海哥666666
9612,1902,陈建海,2015-11-03 01:59:11,0,2,2,上课不错，就是平时事太多，自己爱做系统不过稳定性太差……
9613,1902,陈建海,2015-11-03 01:59:22,76,109,33,作业多死了！！！！死了！！！！
12373,1902,陈建海,2015-12-23 06:45:31,2,3,1,很不错哦\n\n
12602,1902,陈建海,2015-12-23 14:53:10,11,13,2,作业很多并且难，但老师真心不错
13063,1902,陈建海,2015-12-24 16:34:23,2,3,1,超可爱的老师！只上过他的大计基的大二狗决定良心回来推荐一波
13069,1902,陈建海,2015-12-24 17:04:07,0,1,1,好老师！
14175,1902,陈建海,2016-01-05 06:55:50,0,1,1,超级棒！
14256,1902,陈建海,2016-01-06 01:36:03,2,4,2,老师人超好 作业稍微有点奇怪 但稍微认真做就可以的\n\n
14355,1902,陈建海,2016-01-06 12:49:58,0,1,1,认真听有收获，但是也可以水
17295,1902,陈建海,2017-12-19 08:01:56,188,302,114,陈老师的人格魅力到了什么程度呢？每次上机课都能看到他布置了一堆shit一样的难题给你，但你却能心悦诚服地吃下去。男神不解释
18733,1902,陈建海,2016-01-22 12:19:15,0,1,1,我的男神
19390,1902,陈建海,2016-01-28 07:49:01,8,10,2,老师超级棒，上课很幽默，给分也很好。就是作业有点多，不过还是很值得的。
19890,1902,陈建海,2016-01-25 14:10:37,-1,1,2,老师超级好～人很棒～给分好～很负责人的老师呐～
19992,1902,陈建海,2016-01-26 00:44:41,0,1,1,绩点还不错(^_^)
20492,1902,陈建海,2016-01-28 01:13:08,0,1,1,超喜欢老师讲课！！
20539,1902,陈建海,2016-01-28 08:36:49,0,2,2,陈老师超棒，强推！如果私下发短信问问题也会很快解答的。给分超好，给分超好，给分超好！
20540,1902,陈建海,2016-01-28 08:43:17,-1,0,1,几乎无可挑剔，除了撇的闲天稍微有点多。给分也特别好
20544,1902,陈建海,2016-01-28 09:24:47,-2,0,2,老师給分不错，把作业抗下来，成绩有期待
20674,1902,陈建海,2016-01-29 14:54:52,-1,1,2,良心好老师，我是专门来点赞的！
20693,1902,陈建海,2016-01-30 02:06:31,-1,2,3,老师很棒，知识丰富，给分超鸡好！
20697,1902,陈建海,2016-01-30 02:46:38,-1,1,2,给分好，一学期没怎么听课最后考试还行就给分很棒，作业略多，也可水
20725,1902,陈建海,2016-01-30 10:03:43,-1,1,2,幽默风趣
21124,1902,陈建海,2016-02-19 03:01:15,-1,1,2,答疑既快又准确很棒的老师
21195,1902,陈建海,2016-02-26 05:06:57,-1,1,2,幽默风趣，非常好的一位老师，可惜我C程没选上他的课QAQ
21247,1902,陈建海,2016-02-27 12:12:00,-1,1,2,男神老师
21359,1902,陈建海,2016-02-28 08:14:14,0,2,2,幽默风趣
21394,1902,陈建海,2016-02-28 13:05:33,1,3,2,我好喜欢这个老师！帅就一个字！水平很高，给分很棒，虽然平时实验作业比较多，但真的有很大的收获～
21725,1902,陈建海,2016-03-01 01:59:03,0,2,2,幽默！
21819,1902,陈建海,2016-03-01 07:22:02,-1,5,6,作业太多太难…给分一般
22639,1902,陈建海,2016-03-09 04:04:04,0,2,2,良心老师啊
22928,1902,陈建海,2016-03-15 02:37:04,0,2,2,实在太棒了
23957,1902,陈建海,2016-04-22 09:18:10,1,3,2,任性的我！就只说！很喜欢这种厉害的老师！敬佩！虽然大计基差一点满…还是要多在98上问问题呀
23976,1902,陈建海,2016-04-23 10:09:35,0,1,1,作业多
24648,1902,陈建海,2016-05-03 01:27:36,0,2,2,上课很风趣，会给我们分享他弄自己电脑的艰难历程，讲教他儿子写程序的事，男神。作业虽然多但是交不上也没太大影响，放心选吧
26939,1902,陈建海,2016-06-21 23:11:11,-1,0,1,老师很棒我太渣
28097,1902,陈建海,2016-06-28 08:06:21,-1,2,3,好好好
29066,1902,陈建海,2016-06-29 08:04:48,3,5,2,只要你能正面刚平常的作业考试一定没问题的
29859,1902,陈建海,2016-06-30 12:08:37,1,3,2,上课不听 貌似挺幽默的 老师人也好 给分好
31741,1902,陈建海,2016-07-04 16:13:31,0,2,2,海哥！成绩还没出，但先打个满分
31906,1902,陈建海,2016-07-05 06:37:03,0,2,2,老师真好呀，老师的人格魅力让我喜欢上这门课~
31927,1902,陈建海,2016-07-05 07:28:25,0,2,2,老师很棒
32201,1902,陈建海,2016-07-06 02:56:55,0,2,2,好兮好
32842,1902,陈建海,2016-07-18 03:16:11,0,2,2,老师超好，答疑很有耐心，作业多但是有助于提高水平
34344,1902,陈建海,2017-01-20 10:22:54,6,9,3,老师真男神，成绩还没出，可我给了十分！作业多，但人好。我的大作业格式错了打不开，还特意打电话让我重发一次，安利一波！
34525,1902,陈建海,2016-10-13 00:01:08,1,3,2,老师人很和善，讲得很有意思！
34771,1902,陈建海,2016-10-21 03:40:45,0,2,2,很不错
34985,1902,陈建海,2017-01-23 03:47:05,8,11,3,太感人了 成绩一直没出我还以为我已经挂科了 抽到的试卷完全不会 绩点还是上4啦 爱我们海哥！！
35005,1902,陈建海,2016-10-29 02:50:38,0,2,2,男神陈建海，所有能选他的都选了，水平高，给分好，除了特别爱TC.
35923,1902,陈建海,2016-11-10 08:53:53,0,2,2,幽默风趣，对同学很耐心
37201,1902,陈建海,2016-11-18 01:52:20,4,6,2,老师，就不能再多给一分嘛。。
38223,1902,陈建海,2016-12-30 15:44:07,5,7,2,不喜欢交作业的网站，每次急着交作业就进不去。。。。
38272,1902,陈建海,2017-01-21 02:01:04,0,7,7,这么认真才均绩呵呵呵。友尽了
38926,1902,陈建海,2016-12-20 01:59:54,0,3,3,很不错，虽然因为都会没怎么听过
40196,1902,陈建海,2016-12-30 02:04:49,1,3,2,老师上课讲得很有趣，作业又多又难但是真的能学到东西。还有上课前不预习听课时有很大概率一脸懵逼。
40425,1902,陈建海,2017-01-03 08:37:16,1,2,1,爽 好老师 助教也很好
40502,1902,陈建海,2017-01-04 02:03:12,1,2,1,男神老师，最后一节课好舍不得他。
40561,1902,陈建海,2017-01-04 05:34:39,1,2,1,听海哥讲课，跟听讲故事一样。比喻很有趣。回答问题很耐心，问什么问题都行--超级白吃的他也会很认真回答。???超级棒！
41384,1902,陈建海,2017-01-11 07:49:42,0,1,1,很好，强力推荐
44261,1902,陈建海,2017-01-17 13:23:33,1,2,1,太好了！！！！！人过于好了、男神
46063,1902,陈建海,2017-01-20 14:08:49,1,3,2,老师讲课挺有趣的，讲的很好，老师人很好，考前还发短信提醒我们考试要带身份证和学生证，给分也不错，赞
46082,1902,陈建海,2017-01-20 14:48:32,1,4,3,感觉期末要挂，结果给分出乎意料，真的感谢陈老师，可能会比较看重平时分，一定要好好做平时作业，虽然略多
46264,1902,陈建海,2017-01-22 10:17:11,-1,1,2,超级棒啊！收获了本学期最高分！
46781,1902,陈建海,2017-01-22 10:03:13,0,2,2,给分好！
46783,1902,陈建海,2017-01-22 10:04:14,-3,1,4,给分好，上课挺风趣的
46784,1902,陈建海,2017-01-22 10:04:32,0,3,3,真的满绩了...
46785,1902,陈建海,2017-01-22 10:09:59,0,1,1,海哥，给分真的好，讲课也很好，10分，不解释。
46797,1902,陈建海,2017-01-22 10:38:36,15,17,2,陈男神我爱你！！！当然啦助教哥哥也很帅很负责。
46817,1902,陈建海,2017-01-22 11:20:20,0,1,1,超棒的，很喜歡
46901,1902,陈建海,2017-01-23 00:09:59,0,1,1,男神啊
46904,1902,陈建海,2017-01-23 01:00:18,14,15,1,为什么老师不点名，因为陈老师的课每次都座无缺席。
46974,1902,陈建海,2017-01-23 06:44:35,16,19,3,陈老师人真的超级好，大多数人对计算机都是不太了解的，但听老师讲课就觉得很形象。老师人很幽默风趣，虽然有时候作业会有点多，但都能照着书完成，而且陈老师布置的作业不用去机房，超方便哒。最后一节课的时候给我们讲了一些哲理话语，感觉很舍不得呢。海哥，我也会一直记得你的，爱你。\n\n（给分也自然没得说，超好的）
47511,1902,陈建海,2017-01-28 23:37:18,3,4,1,陈老师优默风趣，上课非常有激情，好老师，强烈推荐……
47924,1902,陈建海,2017-02-27 10:17:22,0,1,1,没有选到老师的c程真是太可惜了(；´Д`
48177,1902,陈建海,2017-03-01 05:56:53,6,7,1,就说考试之前发短信通知我们，感动到爆
48217,1902,陈建海,2017-03-01 09:16:40,0,3,3,给分巨好 轻松满绩
48893,1902,陈建海,2017-03-16 01:26:26,0,1,1,虽然平时作业很多，但是给分真的很好！
51430,1902,陈建海,2017-06-05 11:33:52,-1,0,1,老师讲的真的好，上机没有硬性要求我们去，甚至会开放IP，虽然开放时间都挺短(其实量也有一点多)，不过他一直认为多刷刷题比较好
52220,1902,陈建海,2017-06-29 10:39:42,0,3,3,大程对非计算机学院的人 有点吃力
52629,1902,陈建海,2017-06-21 16:04:43,-1,0,1,很棒的
53889,1902,陈建海,2017-06-28 03:12:31,-6,4,10,说妓院学生恶竞的那位，自己太菜还怪别人强？你辣鸡还有理了？
54495,1902,陈建海,2017-06-29 11:56:15,1,3,2,非常喜欢陈建海老师！很有人格魅力，讲课风趣，会给同学们举很多生动的例子，让人可以很透彻的理解一些原理吧，也让我对编程也很感兴趣，想去了解更多。成绩还没出来，但不过结果怎样，过程真的学到了很多，平时作业量不算少，但也都很有收获。课后也非常热心的帮同学们解答问题。男神！希望以后还有机会去上他的其他课。
55600,1902,陈建海,2017-07-02 04:26:54,2,4,2,老师好帅(⊙v⊙)看上去就很像工科生！老师儿子很萌:-D
56508,1902,陈建海,2017-07-04 02:10:51,5,7,2,大计基和C都是海哥。1人好，幽默，耐心2讲得清楚形象，很认真解答你的问题3就像好朋友一样，期末还做ppt鼓励我们好好考，劳逸结合。\n\n总结一句话，男神级
57450,1902,陈建海,2017-07-08 04:31:49,0,2,2,10分，打死不出分
57490,1902,陈建海,2017-07-09 00:42:03,0,2,2,很逗的老师
57602,1902,陈建海,2017-07-10 11:43:32,0,2,2,给分超级好！\n\n帅！
57605,1902,陈建海,2017-07-10 12:34:03,0,3,3,满?率24.3%呦 你值得拥有
57611,1902,陈建海,2017-07-10 15:08:32,-1,1,2,老师讲的很细致！只要用心学，结果一定很好！\n\n
57613,1902,陈建海,2017-07-10 15:26:48,-1,1,2,真的，老师懂很多，知道什么是重点，水染有些时候讲课快，平时练习是比较适当的，所以我们班期末考试稳稳的。
57614,1902,陈建海,2017-07-10 16:00:18,0,2,2,陈老师又幽默又耐心，真的有些后悔有几节课没有认真听讲。给分超级超级好，理论小测65分实验小测只对了一题，最后上机实验也只对了一题，还拿了3.9，班里一半人以上都上4了，很感动。
57615,1902,陈建海,2017-07-10 16:00:44,0,2,2,讲课风趣生动
57617,1902,陈建海,2017-07-10 16:42:52,0,2,2,在浙大遇到最好的老师，给分也好，真的表白！
57681,1902,陈建海,2017-07-12 10:08:38,-2,1,3,
57808,1902,陈建海,2017-07-16 03:07:50,-4,1,5,两个学期都是陈老师的课，老师超级好，C程满了
59165,1902,陈建海,2017-09-20 04:28:58,0,3,3,我就呵呵了。。有些人不好好学习还敢吐槽作业难，你以为课程是你看一眼就会的唉，脑袋有包！老师人超好，幽默和蔼，总之，只要努力学习，老师会对你很好的，如果你吊儿郎当，我想，别过来拉低老师的评价。
60064,1902,陈建海,2017-10-09 07:15:05,0,1,1,男神真男神
60265,1902,陈建海,2017-10-16 07:26:43,1,5,4,好老师不解释，为了不把我们正态去教务处吵了一架，虽然没用但是很欣赏。作业虽然多，但是都会做的话，不想满都难啊！
60845,1902,陈建海,2017-10-31 07:35:13,0,1,1,好好好
61607,1902,陈建海,2017-11-19 06:24:42,0,5,5,有趣但作业多且ddl时间短
61769,1902,陈建海,2017-11-21 00:33:33,-2,1,3,没选上
63483,1902,陈建海,2017-12-07 06:07:55,-2,10,12,垃圾垃圾垃圾老师，千万别选这个老师，要不然会后悔死的！！！
63620,1902,陈建海,2018-01-06 09:23:28,9,9,0,回复一下前面那个说老师一看就很像工科生的童鞋，其实老师是学数学的
63861,1902,陈建海,2017-12-18 03:15:20,20,22,2,作业巨多 怎么说呢 就是我的作业是我舍友的总和
64059,1902,陈建海,2017-12-20 23:45:59,2,3,1,男神男神男神！！！！
64589,1902,陈建海,2017-12-25 11:22:30,4,4,0,幽默负责\n\n但是作业真的多\n\n室友基本只有题库要做\n\n我每回肝实验报告肝得吐血\n\n
64682,1902,陈建海,2017-12-26 08:43:26,24,25,1,给我们在课上放圣诞节贺卡时，笑得像个孩子一样。
65177,1902,陈建海,2017-12-30 04:40:36,-1,4,5,谁选谁后悔
65332,1902,陈建海,2018-01-03 05:39:00,1,4,3,"很赞同上面那位同学的话""陈老师的人格魅力到了什么程度呢？每次上机课都能看到他布置了一堆shit一样的难题给你，但你却能心悦诚服地吃下去。男神不解释""。强推!"
65571,1902,陈建海,2018-01-06 11:40:28,0,6,6,为什么这个老师会有这么高的分啊！！！花在大计基上的时间比专业课还多，但是感觉什么都没学到。因为老师是搞区块链的我们所有的论文都要和区块链有关，可是这个根本没学过的东西可以写出什么来哦！！！除非对计算机爱得深沉，不然还是别选了吧！！！
65587,1902,陈建海,2018-01-06 15:51:42,17,21,4,大计基不要选他，不然你会在期末别人复习线代微积分的时候，一边痛哭流涕一边写他的论文
65593,1902,陈建海,2018-01-07 00:53:29,1,1,0,还不错
65594,1902,陈建海,2018-01-07 01:40:32,-20,2,22,就冲你程设考试让我等了两个小时，我给你1分
65751,1902,陈建海,2018-01-09 03:47:52,6,7,1,今生有幸，得以识君！
66530,1902,陈建海,2018-01-17 07:31:33,0,0,0,超好的老师，强推
68524,1902,陈建海,2018-01-23 10:05:23,1,1,0,我男神
69312,1902,陈建海,2018-01-24 12:34:20,9,10,1,成绩还没出来，但是老师真的是个好老师。喜欢
72714,1902,陈建海,2018-01-31 02:58:44,4,4,0,人是真的帅，作业是真的多！整天赶的大计基可能是超难忘的经历了哈哈哈~老师很希望我们学习新知识，所以让我们去写区块链的论文，虽然过程有点艰难但是收获颇丰。实验操作计科思科也都要做的，做久了确实浮躁。但老师实力巨强，人幽默风趣，而且非常负责，在群里认真解答学生疑问，连夜处理学生成绩，很值得敬佩！在这里感谢老师对一个渣的磨砺(给分还行呢~)，祝老师新年快乐！
72978,1902,陈建海,2018-01-31 13:19:09,1,1,0,老师讲的好但是作业真的好多呜呜呜
73421,1902,陈建海,2018-02-01 14:19:00,1,1,0,尽最大最大努力调分\n\n真的很废时间那种\n\n还会考虑到卡档问题\n\n真的很好！
73433,1902,陈建海,2018-02-01 14:36:11,0,0,0,老师的作业是真的多，给分也是真的好哈哈
73437,1902,陈建海,2018-02-01 14:39:08,0,0,0,好好好
73438,1902,陈建海,2018-02-01 14:39:17,0,0,0,真的是男生老师！！！！会教很多东西，人很好，给分很高！！！很体谅学生！爱您！！！
73442,1902,陈建海,2018-02-01 14:39:44,1,1,0,老师真的很棒，认真上课，作业虽多，但也是有意义的。他一直在跟我们说，就是要以学东西为最终目的。真的很棒，学到很多
73443,1902,陈建海,2018-02-01 14:39:59,0,2,2,满分有悬念？
73444,1902,陈建海,2018-02-01 14:40:32,5,5,0,调分不卡档往正态顶上打的老师是很少见的。作业没有说的那么多，还好吧。。。
73446,1902,陈建海,2018-02-01 14:41:35,30,32,2,我上的是老师的大计基课。平时布置实验操作比较多，但是挺有用的毕竟，老师上课很风趣，没有点名没有小测，最后有论文及其PPT介绍。期末考前，老师在CC98上有答疑，现在还有一些题积累在上面。平时的计科系统什么的老师会一次次因为同学没有做完而重新开放，非常非常认真可爱的老师 很负责！老师给分普遍较高，一个班好多九十多。而且最后录入会帮你尽可能上一个档次，不让你卡绩点！这是个会批正态烂的老师。老师就像他的名字缩写cjh一样，超级好！超级超级好！超级超级超级好！
73448,1902,陈建海,2018-02-01 14:41:53,1,1,0,除了作业多了点 啥都好！
73453,1902,陈建海,2018-02-01 14:47:15,1,1,0,老师人真的超级超级好！
73457,1902,陈建海,2018-02-01 14:58:01,1,2,1,超好的老师，我不配这么高的分数。
73459,1902,陈建海,2018-02-01 15:00:53,1,1,0,老师人还是很好的，讲的也不错，但是作业是真的多，而且有些巨难，但是给分还可以，作业都做了考试也过了的话绩点不会低
73461,1902,陈建海,2018-02-01 15:03:14,1,1,0,谢谢您老师，真的好老师
73462,1902,陈建海,2018-02-01 15:03:31,0,0,0,听他的课真是一种享受，坐第一排是我每次的心愿。虽然作业量稍微有一点多，但绝对你是心悦诚服地吞下然后开始完成。实在不行的可以和老师说明原因，真的很开明的老师呢。过圣诞还会自己做小动画给同学当礼物！真的是一个好老师！能选上他的大计基感觉自己欧气十足了！虽然最后理论没弄好，老师还是发了封邮件说明原因呢！反正选择陈老师绝对不会有错！你能学到很多，并且是快乐的学习！
73473,1902,陈建海,2018-02-01 15:23:51,5,5,0,老师超赞，人帅还幽默。虽然作业稍微多了一些，但是分给的特别好。第一学期还是有足够的时间完成的。期末绩点好看，出了大计基之后绩点成功上四了，谢谢老师。
73476,1902,陈建海,2018-02-01 15:35:39,1,1,0,虽然自己很垃圾，上课没怎么听懂。但老师专业水平确实很高，人很随和，而且很为学生着想。给分超级棒！
73480,1902,陈建海,2018-02-01 15:48:15,0,0,0,老师人真的超棒，真的是最大化的让同学有好的分数，而且课上也能学到很多，老师人也非常贴心，如果不是自己不选c程，我肯定退课也要换陈老师！
73481,1902,陈建海,2018-02-01 15:52:47,5,5,0,上面的评论已经把我想说的说完了，男神本神了
73482,1902,陈建海,2018-02-01 15:53:16,0,0,0,陈老师上课风趣，下课的时候很亲切，欢迎你上去向他请教问题，作业虽然多，但是挺有用的，还可以迟交不扣你分，期末不卡绩点，这一点真的感动cry！
73484,1902,陈建海,2018-02-01 15:57:38,0,0,0,老师人很好，就是作业有点多，但能学到东西呀……即使是我这样的计算机小白也能从中get到一些知识。而且老师最后还给调分了，让所有同学都拿到尽可能高的分数，满满的师生情啊！太感谢老师了！
73517,1902,陈建海,2018-02-02 01:05:12,1,1,0,我爱陈老师o(^o^)o
73533,1902,陈建海,2018-02-02 02:06:37,0,0,0,作业有点多，其他都很棒。
73535,1902,陈建海,2018-02-02 02:14:56,0,0,0,无敌好老师！
73542,1902,陈建海,2018-02-02 02:34:42,0,0,0,很棒很好嘞
73570,1902,陈建海,2018-02-02 04:01:40,1,4,3,平时作业有点多，但是给分真心好，我平时作业认真做，上课没怎么听，考前也没怎么复习居然有4.8。本来预公布是91的，可能老师不忍心看我们卡绩点，就给了我92，感动到爆！
73603,1902,陈建海,2018-02-02 05:32:09,0,1,1,老师人真的超好，很用心的一位老师，绩点还给得特高
73711,1902,陈建海,2018-02-03 00:18:25,1,3,2,有诚心，很认真很负责地在教我们。讲课很形象。给分超级好，会尽量绩点最大化，能上一档就会帮你上一档。实在感动。
73812,1902,陈建海,2018-02-03 06:47:12,-1,1,2,大计基 \n\n老师讲课讲的很好\n\n给分…自己期末机考考太烂 但老师还是给提分了 感激不尽\n\n大计基的机考真tm是玄学
73823,1902,陈建海,2018-02-03 07:31:04,1,2,1,老师真的超级超级棒！给分超级好！
74250,1902,陈建海,2018-02-08 03:30:08,4,4,0,陈老师果断是人帅讲课又好听啊\n\n虽然平时作业多了点是吧但是他打分高呀\n\n真的是做了多少给多少分\n\n该给的一定给，不该给的也可能给hhhhhh疯狂打call
75162,1902,陈建海,2018-03-07 15:58:38,-4,5,9,C程作业太多了，而且一小部分作业做完了没有收获，老师应该减少作业量，给同学们自主学习的空间。
75957,1902,陈建海,2018-03-23 01:14:10,2,3,1,给分超级好
76074,1902,陈建海,2018-03-29 13:25:15,8,9,1,老师人非常好，补选进的，最初上机还没位置，老师还找那里的人理论，讲课也很清晰，对待学生非常温柔。\n\n以上。
76213,1902,陈建海,2018-03-29 05:50:02,3,5,2,陈老师上课非常风趣，即使大计基塞在整天满课的下午是一种煎熬，讲课节奏略快，但是课后或者考前自己对照ppt基本都能理解。作业虽然多，但是按照实验手册的做了之后还是觉得收获满满。最后老师真的是很负责任了，期末分数都尽量达到最正态的部分，会给大家调分，公示让大家反复确认成绩组成来保证公平。好老师！点赞！
77456,1902,陈建海,2018-05-05 16:19:30,6,6,0,C大程预置了陈老师的课，总的来说是很nice的老师吧，上课气氛也很好。就是讲的要是能更深入一些就好了，这样做大作业的时候坑也会少一些٩꒰๑• ̫•๑꒱۶
80027,1902,陈建海,2018-06-19 05:16:53,4,4,0,很好很好
80540,1902,陈建海,2018-06-27 15:04:15,6,6,0,水平很高哦
80852,1902,陈建海,2018-07-02 04:55:46,4,4,0,大程相较于别的老师已经好的不能太多了。
84122,1902,陈建海,2018-07-13 15:15:19,4,6,2,老师人很好
84471,1902,陈建海,2018-07-13 02:44:59,3,4,1,好老师不解释，给分超好。
84491,1902,陈建海,2018-07-13 03:46:39,-13,2,15,讲的东西不够深入，作业布置的太简单，不过讲课态度很好
84599,1902,陈建海,2018-07-13 09:25:10,5,5,0,感谢老师不卡我绩点！\n\n棒棒哒
84702,1902,陈建海,2018-07-13 14:52:28,5,5,0,为什么没有11分！
84704,1902,陈建海,2018-07-13 14:54:09,5,5,0,在这里，我不想谈太多绩点，反正我是满意了。陈老师让我爱上了写程序这件事情，每次写代码遇到困难，想想陈老师阳光般的笑容，又有信心写下去了。真心感谢！
84705,1902,陈建海,2018-07-13 14:56:09,5,5,0,本来以为要凉的也没凉?除了作业稍微多一点，好多重复的题，其他方面都很好
84706,1902,陈建海,2018-07-13 14:56:38,12,12,0,超强的宏观调控…绩点给的很高
84708,1902,陈建海,2018-07-13 14:58:00,11,12,1,超级好的老师，卡绩了还会给上调一分进上一档！！上课讲的很清楚，而且完全没有老师的架子，混在学生里绝对分不出来，年轻有活力的老师！老师自己水平也超高！最后PTA上的题确实多，但是水平不就是这样练出来的嘛～大赞！
84712,1902,陈建海,2018-07-13 15:15:27,8,8,0,本来编程第三道选的比较难没做完，理论还有一部分欠缺，但是陈老师一个绝对令我满意的分数，陈老师的讲解让我对编程有了更大的乐趣，陈老师最棒，绝对男神！！
84716,1902,陈建海,2018-07-13 15:21:17,8,8,0,老师真的太好了！！！！！！！别问为什么 好好珍惜就对了
84719,1902,陈建海,2018-07-13 15:25:57,16,18,2,太感人了 调分不让你卡绩\n\n真的太感人了\n\n不管你学的怎么样 拿到的分绝对比你预估高一截
84720,1902,陈建海,2018-07-13 15:26:46,8,8,0,老师万岁万岁万万岁，我爱陈老师，是老师救我于水火之中
84727,1902,陈建海,2018-07-13 15:49:53,5,5,0,老师超级棒啊啊啊\n\n上课很有意思\n\n虽然作业有点难\n\n但是平时好好听课写作业\n\n期末肯定没啥问题了\n\n而且给分超级好(✪▽✪)\n\n男神无疑了
84729,1902,陈建海,2018-07-13 15:56:53,4,4,0,很好玩，老师很优秀。
84741,1902,陈建海,2018-07-13 16:46:03,6,6,0,陈老师真的超有魅力，讲课水平很高，作业有点多但是认真做完会很熟练，助教小姐姐也超负责，另外给分真的特别特别好！！我爱陈老师！
84750,1902,陈建海,2018-07-13 20:04:28,1,1,0,超级好！！！
84768,1902,陈建海,2018-11-27 07:57:30,6,6,0,人好不解释。
84769,1902,陈建海,2018-07-13 23:45:44,22,28,6,这是我在浙大遇到最好的老师，也是我第一次满绩。c程周二上午十一点半下课，而我们几个人总是围绕着老师一直问各种奇怪的问题直到12点多，可以感觉到老师是和我们一起学习的，他也和我们一样具有对知识的热爱和探索的兴趣，这点很难。有时去问别的老师问题，总是会得到敷衍的答案，而陈老师总是在编程环境里面给我们演示，就像他自己也是学生一样。你可以看出他的热情，他对学生的关爱。希望这样的老师越多越好，也祝愿陈老师在自己的领域做出更好的成就，一起加油！
84770,1902,陈建海,2018-07-13 23:47:44,11,11,0,是有多幸运才能成为老师的学生!希望之后选到陈老师的同学们好好听课，不要抱怨作业多，不辜负这么棒的老师! 我作为一个电脑渣，在老师超有水平的教学下，对编程慢慢有了兴趣。老师不仅上课幽默风趣，浅显易懂，给分也超级高!
84790,1902,陈建海,2018-07-14 01:30:47,2,2,0,很好哦
84798,1902,陈建海,2018-07-14 01:51:29,8,8,0,虽然一直认为他说的[c程很容易拿满绩]是骗人的，但是在海哥的带领之下还是实现了哈哈哈 顶海哥不多说
84801,1902,陈建海,2018-07-14 02:00:49,16,25,9,老师真的太好了！！\n\n一直说让我们以满绩为目标\n\n结果我真的满绩了！！！\n\n从以为自己要挂科到99\n\n谢谢陈老师！！
84853,1902,陈建海,2018-07-14 05:25:35,3,3,0,老师超级棒虽然作业有点多但是能力就是这样练出来的呀，而且期末给分超级棒，卡绩还会给你调分!男神!
84860,1902,陈建海,2018-07-14 05:58:19,1,1,0,作业真的多但是上的也是真的很好啦
84897,1902,陈建海,2018-07-14 09:07:57,6,7,1,这是我第一个查老师评价的老师，10分不解释，真男神，有魅力，我一个电脑小白都对编程有兴趣了！！跟着老师上，满绩不是问题！
84958,1902,陈建海,2018-07-14 14:39:02,0,0,0,满分老师！
85222,1902,陈建海,2018-07-16 07:37:48,4,4,0,连上cjh爸爸的小程和大程表示赚翻了。怎么说呢，cjh给分好到你在这秀满绩也不会被喷，因为给分实在是太好了。
85711,1902,陈建海,2018-07-27 06:32:15,1,1,0,好老师，男神，每节课我都第一排！讲的也好，人也棒，平易近人十分幽默！\n\n美中不足的就是作业很多，是其他班的两倍左右，因为有自己出的实验报告。\n\n不过也是对我们负责的表现，实验报告附的题对理论考很有帮助。
85720,1902,陈建海,2018-10-03 16:56:23,-17,4,21,上课挺好的，只是有些好奇，说好不卡绩然后被卡绩的我，算是什么呢？
108874,1902,陈建海,2019-06-03 11:59:39,6,7,1,就算我c程挂科，cjh老师也一定是十分。\n\n另外新的爆款通识课已经诞生了，大家快点选啊！
109248,1902,陈建海,2019-06-12 09:09:21,5,6,1,希望上老师的微信小程序可以收获诸多干货
109557,1902,陈建海,2019-06-17 03:30:27,0,2,2,超级超级喜欢陈男神！幽默风趣长得帅，每节课都有几句心灵鸡汤但是又不腻，生活化的语言但又觉得是很有智慧的工科男！就是喜欢
111372,1902,陈建海,2019-07-01 05:21:41,1,1,0,陈老师太赞了， 太有魅力了，一流老师，超有耐心
111616,1902,陈建海,2019-07-02 07:46:47,4,5,1,老师有一句口头禅:如果这都不知道就没有满绩了。\n\n——然后那些都知道之后真的满了！
112217,1902,陈建海,2019-07-03 23:22:18,0,0,0,好，老师很牛逼，我很菜，给分满意
112237,1902,陈建海,2019-07-03 23:54:15,1,1,0,上课挺有趣的，给分超棒
113240,1902,陈建海,2019-07-06 02:28:57,10,12,2,有幸这个学期能遇到两位超赞的cjh老师，一位在隔壁教微积分，一位在这教c程
113276,1902,陈建海,2019-07-06 03:33:30,5,7,2,老师有多厉害呢，去年2.7重修，这次5.0，吹爆陈老师
113292,1902,陈建海,2019-07-06 04:06:30,4,5,1,老师是好老师，但是班级挂科率10%了解一下，小程还是主要靠自学
113372,1902,陈建海,2019-07-06 11:08:28,1,1,0,真的太开心了，给分真的好。老师对我们的期望很高，虽然我时常因为达不到老师的要求而自卑，但是真的开了眼界，班上同学也很优秀。大作业我没什么参与感，而且做的跟其他神仙比起来也差了点，但是平时分还是给满了！老师人真的好
113780,1902,陈建海,2019-07-07 12:11:01,3,3,0,性格从容不迫 讲课风趣横生 给分特别好 超赞的老师
114017,1902,陈建海,2019-07-08 09:28:48,6,6,0,94，但是平时分真的给满了，考试分动不了，能看出来老师尽力了
114023,1902,陈建海,2019-07-08 10:23:54,1,1,0,非常好的老师，本来以为自己要挂了，居然被捞起来，还上70了!好人一生平安!
114213,1902,陈建海,2019-07-09 04:44:35,1,1,0,大爱您
114405,1902,陈建海,2019-07-10 01:07:32,3,3,0,“这个都不知道你们怎么满绩？”—cjh\n\n虽然最后也没有满绩，但分数自己还是满意的
114462,1902,陈建海,2019-07-10 04:18:26,2,2,0,陈老师真的人又好又幽默，人格魅力非常足。上课思路非常清晰，会用好多有意思又极为恰当的比喻解释比较复杂难以想明白的问题，重难点非常分明，只要上课能稍稍注意听一点（其实上课进度很适中，就算中途走神啊什么的还是有余裕的问题不大），c程都是能学懂的。而且陈老师真的很善于激励我们，鼓励我们以满绩为目标去学习c程，虽然最后离满绩还差了一点儿，但已经非常满足了。真的是不可多得的好老师。
114720,1902,陈建海,2019-07-11 06:14:49,2,2,0,老师回邮件很及时，? ?
115096,1902,陈建海,2019-07-15 12:08:18,1,2,1,给分超级棒，绝对好老师
115335,1902,陈建海,2019-07-19 00:24:16,1,2,1,上课知识点讲解的清晰详尽
116789,1902,陈建海,2019-09-16 01:58:48,2,2,0,给分真滴好
116848,1902,陈建海,2019-09-16 14:25:37,2,4,2,叫cjh的老师选就完事了
116968,1902,陈建海,2019-09-18 01:15:47,0,0,0,考试之前老师会过紫金港来答疑到很晚！平时会愿意帮你debug！很幽默！上课很享受！
116981,1902,陈建海,2019-09-18 03:09:25,2,2,0,好好好
117462,1902,陈建海,2019-09-24 23:07:13,9,10,1,你这糟老头，真是帅死我了
117905,1902,陈建海,2019-10-09 01:37:32,5,6,1,很催眠
117945,1902,陈建海,2019-10-16 12:07:22,-1,2,3,老师讲课超级幽默。
118956,1902,陈建海,2019-11-10 05:24:56,0,1,1,---
119424,1902,陈建海,2019-11-13 00:09:12,0,24,24,体验极差，不知道为什么会被刷分刷到9.99。上课自以为幽默，实际语气让人极度难受。声音催眠，讲课枯燥。作业布置极多，接二连三布置实验作业，吃了屎一样。
119541,1902,陈建海,2019-11-13 11:13:37,3,6,3,好，没那么好
120329,1902,陈建海,2019-11-28 14:42:51,4,5,1,讲课真的慢(´;︵;`)
120646,1902,陈建海,2020-01-14 14:25:29,2,2,0,跟着老师走，认真完成作业，用他的话来说就是“c语言还是很容易满绩的哦”。
121183,1902,陈建海,2020-01-20 02:58:43,4,5,1,给分真的好，我们班一群人都满绩
121219,1902,陈建海,2019-12-27 07:19:17,0,2,2,微信小程序\n\n当俺们没期末考试吗
121318,1902,陈建海,2019-12-20 07:18:21,0,0,0,快乐哦
121623,1902,陈建海,2019-12-12 05:46:53,4,4,0,C小程作业真的挺多的\n\n陈老师很敬业 带病上课依旧精神满满\n\n另外塑料口语莫名戳中笑点hhhhh
121970,1902,陈建海,2020-01-27 04:30:59,-65,9,74,平时作业又繁琐又多，但我每个作业都按时认真做完了。期末考试考前也认真复习了。然后呢？一堆满绩，4.8…不知道为什么我只有这个成绩。
123032,1902,陈建海,2020-05-03 17:01:23,7,7,0,有一次我发烧了早八大计基还下雨我就请假了，然后联系了一下陈老师，他居然同意给我打QQ电话让我在宿舍也能听课！最后给分是满分，陈老师真的特别特别好！10
123478,1902,陈建海,2020-06-09 05:42:27,0,3,3,我来评分！陈建海，cjh，超级好！C大程大作业队友退学，还会安慰我，“不要哭”，哈哈。老师超级和善，网课时代还课间放眼保健操，十分有耐心地授课。传道授业解惑也，概如此矣!
123806,1902,陈建海,2020-06-14 10:56:51,-21,6,27,作业很多，特别占用时间，上课教的东西根本没什么用，讨厌这个老师。
124666,1902,陈建海,2020-07-05 10:25:26,4,9,5,考试的时候身份证学生证正好全丢了，带着两张证明结果监考老师说丢一张可以用证明代替两张不行，虽然我带了校园卡然而不顶用，真的快急哭了，最后找陈老师终于让我参加考试
126599,1902,陈建海,2020-10-06 07:59:15,8,9,1,作业比线代多
126613,1902,陈建海,2020-10-08 12:58:25,11,12,1,作业太多（预置没办法，带伙做好心理准备吧）
126614,1902,陈建海,2020-10-08 13:02:33,11,13,2,作业又多又难…
129110,1902,陈建海,2020-12-30 07:29:12,2,4,2,虽然成绩还没出，但还是安利一波陈老师，上课感觉很好玩，虽然我也没听什么（一直在补作业）下课我去厕所回来晚了还帮我开门，一次作业交迟了也还可以补交，就是超级好！爱了爱了(⑉°з°)-♡
129464,1902,陈建海,2021-01-06 02:40:20,16,20,4,老师人好但是作业也太多了吧\n\n临近考试还要做各种实验，作业比微积分还多\n\n7个实验、文献调研、大作业、计科、PTA、思科\n\n我是小佬，现在只想静静
129544,1902,陈建海,2021-01-07 04:05:44,12,14,2,微信小程序纯自学 不建议选 没必要在期末压力这么大的时候还多个大作业给自己添堵
129693,1902,陈建海,2021-01-11 03:14:49,21,22,1,作业多的想吐
129843,1902,陈建海,2021-01-13 03:04:09,-2,7,9,体验极差
130263,1902,陈建海,2021-01-20 10:14:52,0,2,2,好棒好棒
132069,1902,陈建海,2021-01-30 05:46:54,1,1,0,老师风趣幽默，讲得很生动，C小程的陷阱讲得很到位。
132596,1902,陈建海,2021-02-02 14:01:28,1,1,0,老师超级可爱，男神不解释，期末还会调整分数防止卡绩，真的超级有趣又善良！！！
133095,1902,陈建海,2021-02-08 04:47:29,1,2,1,微信小程序综合实践：\n\n很有意思、很有挑战性、很有收获
133137,1902,陈建海,2021-02-10 04:24:15,3,4,1,作业非常非常多，但是给分好
133251,1902,陈建海,2021-02-21 02:01:40,-46,8,54,从未见过比他更恶心的老师
134366,1902,陈建海,2021-03-25 01:54:10,0,0,0,老师非常好
134621,1902,陈建海,2021-04-06 05:53:19,1,1,0,这老师真的太棒了！真的！
135029,1902,陈建海,2021-04-27 10:21:28,33,37,4,平时的作业量会让你有种想拔刀的冲动\n\n期末的绩点会让你自己把这把刀吞下去并说一句海哥yyds\n\n他就是这样一个平时让你恨透他期末让你爱惨他的人
137083,1902,陈建海,2021-06-30 15:04:51,1,7,6,事多分少，事情多到会让你崩溃，而且有很多事情还没有意义，见到快逃。真的很不喜欢上课
137209,1902,陈建海,2021-07-02 09:29:59,5,7,2,的确，C小程是要靠日常大量的作业训练出来的......说海哥作业多的可能到期末就能感受到了......
139006,1902,陈建海,2021-07-12 07:14:41,6,8,2,cjh，超级好！男神级人物。别看出分慢，其实是老师在进行复杂的计算，为的就是我们不被卡绩点。再说一遍，cjh，超级好超级好。永远爱你！
139174,1902,陈建海,2021-07-13 06:35:41,3,3,0,我愿称之为捞神
139256,1902,陈建海,2021-07-14 01:06:59,11,15,4,或许之前很好，这一次C大程老师期末出成绩前临时改成绩占比，很烦。
139291,1902,陈建海,2021-07-14 05:21:07,0,1,1,老师很帅很社会，可惜没能继续跟着他玩超算
139301,1902,陈建海,2021-07-15 11:34:23,0,8,8,老师很好，选了绝对不亏\n\n------------------------\n\nupd: 捞神，可惜下学期没选上老师的课乌乌
139312,1902,陈建海,2021-07-15 04:29:36,2,3,1,老师很负责
139350,1902,陈建海,2021-07-14 14:45:56,9,14,5,怎么说吧 也不是不能理解老师要正态分布，如果开学第一堂课就讲清楚30 40 30占比，也就不会有这种事情了。但这次确实挺...
139711,1902,陈建海,2021-07-20 23:38:57,6,13,7,至少让我明白了几个道理\n\n一个不负责任的助教可以有效破坏上课的体验\n\n查老师上分高的老师并不都是好老师
139875,1902,陈建海,2021-08-06 07:20:45,4,9,5,5分 给超算\n\n对小白属实不太友好\n\n如果不是对超算很感兴趣最好别报超算的小学期\n\n很痛苦
139903,1902,陈建海,2021-08-15 15:47:31,-8,10,18,超算，不仅占用了一个暑假的时间，而且可能有挂科的风险，与其他小学期课相比，从绩点的角度看，投入高产出低\n\n课上几乎不讲东西，既然完全靠自学，如果不是为了进超算队，不如别抱。反正都是自学，选了这门课还会拉低均绩
140752,1902,陈建海,2021-09-17 17:42:07,3,4,1,超算集训自己就来了一节课 全交给学长了😅
140797,1902,陈建海,2021-09-16 07:03:17,8,10,2,看到有课友喷超算感觉心里不服气。\n\n超算难真的是难，我是纯小白开始上的，linux操作本来只会cd ls，一开始上第一个lab就真的头都要炸掉了，一度很崩溃，每天从早做到晚做不出来。这课就会倒逼你学会怎么去查资料去实践；到后来越做越顺，lab5做出东西来应该都会很有成就感吧？\n\n\n\nTA都尽力捞了，可能课上的确实不太听得明白，但是cs不是本来就重自学吗\n\n\n\n对我来说可能真的是改变了我对于cs这个学科本身理解的一门课，甚至可以说影响了我的学习方向和生涯规划的一门课。
140859,1902,陈建海,2021-09-17 02:25:35,2,3,1,cjh，超级好！
143970,1902,陈建海,2021-12-14 16:08:38,4,4,0,一个实验报告写了十个小时
145346,1902,陈建海,2021-12-29 06:46:01,0,1,1,c小程给分很好但是事情蛮多的
149542,1902,陈建海,2022-01-16 02:16:16,4,6,2,微信小程序综合实践\n\n纯自学，老师没来上过几次课\n\n全靠助教写好的实验报告一步步跟着做\n\n选这门课算是倒逼自己掌握web入门吧\n\n上课体验不算好，收获是来自于助教和组员
149848,1902,陈建海,2022-01-17 09:00:50,2,2,0,给分很好，上课很幽默
150750,1902,陈建海,2022-02-17 04:53:14,10,11,1,c小程感觉就是自学....感觉也没有传说中的捞，隔壁张彤彧老师讲的很清楚
150895,1902,陈建海,2022-02-21 01:40:12,1,1,0,老师人很好！就是用了一寒假调分是不是有点摸鱼了呢？ovo
151363,1902,陈建海,2022-03-01 11:31:10,0,0,0,哈哈哈哈
152508,1902,陈建海,2022-04-13 15:57:34,1,1,0,很好，受教了
152821,1902,陈建海,2022-04-20 06:46:01,16,18,2,感觉査老师上评分有点高了，我感觉c小程讲课不怎么清晰，有点全靠自学的意思。
154107,1902,陈建海,2022-05-23 08:48:04,4,5,1,短学期前再写一下关于超算的评价\n\n前面有个5分给超算的评价也是我写的\n\n过了一年回头来看这门课其实也是有意义的，意义在于通过lab倒逼极高强度的自学\n\n想通过上课学到什么可能性不大\n\n更多有意义的是与TA和队友的高强度交流\n\n那两周几乎每天就是从早到晚都在查资料，配环境，写代码\n\n但是不得不说那两周是我大一一年里学习效率最高的两周\n\n零基础入门了深度学习，相对熟练地操作linux\n\n最后魔改的vgg-19在lab5上表现很不错，最后做出来的时候特别有成就感\n\n给分其实也还可以，最后因为lab1比较摆，总评扣了6分和满绩失之交臂\n\n对小白而言，选这门课之前建议做好两周从早学到晚的准备\n\n努力学的话，这门课可以逼着自己学会很多东西
154215,1902,陈建海,2022-05-26 05:38:05,0,1,1,很可爱的老师
154300,1902,陈建海,2022-05-29 13:11:34,42,45,3,看到评论区有点点两极，作为去年HPC101的助教想来简单说两句：\n\n1. 本身超算比赛相比其他学科竞赛对于技能的要求就比较广，下到最底层的CPU构造、网络通信，上至不同领域应用的算法策略，以及每年不断涌现的新硬件架构、新应用……超强的自学能力是入队选拔里必不可少的一环\n\n2.  对于课程，我们并没有讲述过多的实操细节，因为具体的微操随着技术的更迭随时都可能变化，而且每个人对于实操的掌握速度也不一样，在课堂上花费时间讲解过分具体的操作细节没有任何意义；但这并不意味着课堂上学不到任何东西，相反，我们希望在课堂上尽可能讲解操作底层的逻辑，注意我们的专业是计算机*科学*与技术，掌握科学的思维逻辑远比学习具体的操作方法重要，不然跟转码速成班有什么区别；相信认真听课理解了逻辑的同学对于完成微操没有任何压力，从每次实验的反馈来看也确实如此\n\n3. 确实课程本身是有难度的，但是相信完整跟完的同学一定有很大的收获，而且这些内容在你今后的cs专业课、乃至cs科研中都会非常受用，相信你到大三再回来看的时候一定会认同这句话的\n\n4.  去年捞人是真的尽力了，大家可以问问去年选课的同学，除非是摆烂完全不交作业的，最后能捞的都捞了，绝大多数同学都非常满意——大家辛辛苦苦忙了一暑假，给大家一个好的结果是我们应尽的职责，对于给分大家放心就好！\n\n最后，对于正在看这条评论的大一同学，期待今年能在小学期见到你~
154977,1902,陈建海,2022-06-07 07:37:43,1,2,1,人好，大程本身课烂，被迫选C大程的强推陈老师
158300,1902,陈建海,2022-06-28 07:17:38,4,4,0,C大怎么还没出分，催催
158420,1902,陈建海,2022-06-29 06:15:48,2,3,1,作业非常多，而且会增加课时，在答辩之前任意修改作业要求
158829,1902,陈建海,2022-07-02 13:11:01,2,5,3,珍爱生命，远离他的c大程，除了卷啥也得不到
158886,1902,陈建海,2022-07-03 04:22:54,4,4,0,cjhyyds
158943,1902,陈建海,2022-07-03 15:45:18,0,0,0,选！期末答疑很棒！
159068,1902,陈建海,2022-07-05 12:08:18,1,2,1,哈哈哈哈，老师巨好！给分更不用说！选！
160070,1902,陈建海,2022-09-13 02:35:40,0,0,0,好好好
160382,1902,陈建海,2022-09-22 03:18:59,0,0,0,怎么说呢，这门课其实就是想让你开开眼，把看待计算机的眼光往高处抬一抬，老师们似乎不是特别在意你微操的水准。对大一的学生来说，学这门课可以让你接触一些目前比较常用却又在大学鲜有人知的东西
160564,1902,陈建海,2022-09-27 03:35:13,0,0,0,c小，我的神
160713,1902,陈建海,2022-10-04 10:06:50,1,1,0,真·神中神
162445,1902,陈建海,2022-12-27 11:30:08,-3,8,11,作业非常多，对计算机不感兴趣的同学千万别选
162475,1902,陈建海,2022-11-23 03:38:00,4,4,0,作业多。。
162522,1902,陈建海,2022-11-24 08:07:08,0,0,0,满分不解释
163368,1902,陈建海,2022-12-14 02:23:00,-3,0,3,给分好，真的是太棒了
163736,1902,陈建海,2022-12-16 04:32:33,8,8,0,微信小程序这门课很硬核，很硬核，大一最好别选（别问我怎么知道的），而且作业很多很难，不过老师很好，很幽默，助教也很好，非常有耐心，不会的问题都会解决，现在疫情，大作业留到下学期交，希望绩点高一点吧
164105,1902,陈建海,2022-12-18 05:38:30,7,7,0,就冲我助教大哥给个10分
164241,1902,陈建海,2022-12-19 16:33:29,9,14,5,不明白为什么他评分这么高\n\n\n\n2学分的大计基的课程，在他这里内容当量不亚于5学分的专业课\n\n每次写实验报告都让我气血上涌，一次至少8个小时，而这样的实验报告，有九个\n\nPTA的内容更是完全不比实验报告简单省事\n\n这门课要求我花费的时间，甚至远高于微积分和线代\n\n\n\n此外，小测三次，题又多又难还不监察作弊行为，导致每次小测都是网络搜题速度大比拼……\n\n这对认真复习，专心答题的同学非常非常不公平\n\n\n\n上次上华为的RPA，整堂课2/3的时间浪费在教我们如何下载Weautomate，另外1/3？那当然是浪费在如何激活上了\n\n所以他到底有没有备课呢？我想大概率是没有的\n\n所有和知识点相关的内容全都被要求自学，\n\n最后甚至宁放弃讲课，也不愿意放弃他那自己也知道毫无意义的小测\n\n小测题还都是题库里原封不动扒出来的……\n\n\n\n我不管他给分好或不好，\n\n就凭他这份完全不为学生整体课业思考的理念，和那极不负责任的课堂教学态度\n\n这个1分我打定了
164505,1902,陈建海,2022-12-21 10:24:00,9,9,0,微信小程序综合实践，课确实很硬核，前面的还算简单，后面好难哦，不知如何下手。不过助教非常好非常好非常好，去问弱智的问题都会解答，因为我太菜了还让我把程序发给他改，改了好几版呢，真的感动。虽然很难，但是确实学到了很多很多东西。如果对这方面有兴趣的值得一学！：）
164683,1902,陈建海,2022-12-23 09:37:59,4,4,0,【大计基A】作业太多，花费的时间太多，远超过主课硬课，当然不能全怪老师，因为这门课本身就是依托答辩
165550,1902,陈建海,2023-01-08 09:00:21,5,5,0,我上的大计基。老师人不错。但是事情特别多。RAP不是所有老师都布置，他布置了；华为人工智能搜索也不是所有老师都布置，他又布置了。尤其是华为人工智能搜索，很花时间且败心情，最后除了往电脑塞了一堆乱七八糟的东西什么也没学到（就TM几个文件我又能学会什么，整个流程就在按步骤做）（我对计算机技术又没兴趣，考试好像又没考，你说学这个干嘛）现在没出分，不知道给分怎么样，但是如果不想因为一堆事情浪费时间，不推荐选他的大计基。
166767,1902,陈建海,2023-01-13 13:31:23,2,2,0,大计基报道，水了一学期的课，最直观的感受是老师上课很幽默，他的语调会有很丰富的变化，感觉很享受给我们上课的过程，他的笑容非常有感染力。从上课内容来说，其实我觉得老师讲的不能说是非常好的那种，但是听懂肯定是没问题，主要是上课会被老师的笑容以及语调带动起来，就不会感到枯燥什么的，我觉得这点非常好。然后就是作业留的真的是很多很多（哭哭）但是你要是只想水的话有很多方法都能毫不费时的完成作业，作业除了pta上的测试以外都是交了就会给满分的。现在还没出成绩，但是老师的课是上过一次还想继续上的，墙裂推荐。
166775,1902,陈建海,2023-01-14 17:07:11,2,2,0,c小，其实没怎么听课，所以估计要寄，但是老师给人的感觉真的如沐春风，所以该打10分还是10分
167144,1902,陈建海,2023-01-15 04:17:48,1,4,3,老师真的在用心捞人，一开始我被打了91以为又是卡绩点了，后来钉钉私戳了老师，我心服口服了，老手平时作业确实多，但是期末你会大喊一声，海哥我的神，海哥我爱你，海哥yyds，预置上海哥的，都给我偷着乐，要是海哥的C语言没学好，那都是你们的问题，海哥，不多说，yyds
167459,1902,陈建海,2023-01-16 11:50:05,3,3,0,cjh老师真是我男神，给分好，上课幽默，选就完事了
167548,1902,陈建海,2023-01-17 08:26:53,4,4,0,老师平时作业很多，但给分真的好
167752,1902,陈建海,2023-01-19 01:53:55,1,1,0,陈老师好帅！我上的大计上课可以摸鱼但是也会拓展一些知识，助教和老师都会很耐心的解答\n\n而且最重要的是期末被捞啦！\n\n唔唔唔我哭死！
167869,1902,陈建海,2023-01-19 15:26:58,3,3,0,选了他的课，只要正常学学，绩点都会很高。在打分上基本上找不出比这更好的老师了。话不多说，快冲！
167969,1902,陈建海,2023-01-21 01:50:50,1,1,0,虽然作业很多，但老师给分真的无敌好
168070,1902,陈建海,2023-01-25 13:29:32,6,6,0,大计基A，作业特别多，但这是课题组的锅，与陈老师无关，甚至陈老师还将原本教学计划上的一些内容给省掉了。上课很有意思，讲的也很清楚。哎，大计基课的一些不好的安排设定请骂整个课题组，陈老师已经做得很好了。最后给分会仔仔细细把卡绩的同学全都扶一把（+1分，绩点+0.3），人真的超级好。
169481,1902,陈建海,2023-02-26 11:23:39,2,2,0,助教无敌好，老师不爱上课but给分无敌好
172333,1902,陈建海,2023-04-25 06:21:52,2,2,0,上的好
173409,1902,陈建海,2023-05-23 12:56:09,0,0,0,作业跟s一样，容易把自己逼疯，但是绩点给的可以
173652,1902,陈建海,2023-05-31 06:42:02,1,1,0,Z助教巨好，老师感觉正常，没什么特别的。
174835,1902,陈建海,2023-06-18 20:35:31,3,3,0,最后一批C大，考试周来评价\n\n讲课，个人觉得一般，语言表达有瑕疵（不是抬杠，只是客观陈述。没有达到雯雯姐姐那种顶尖吐字）\n\n待人很好，讲课穿插小故事，答疑讲题很耐心（虽然我只问过一次）\n\n不搞恶竞！助教zjhgg明确提出反对恶竞，大作业互评限制恶意给分，比起有的班会好很多\n\n难度大，好像四五次PTA，3个Project，不过时间其实是给够了的，不要像我一样总是拖到最后一天
174920,1902,陈建海,2023-06-20 01:21:11,0,0,0,苯人是他的C大程\n\n讲课很好，给分很好，必须打十分\n\n但是作业确实对编程基础稍差的同学来说难度不小
176394,1902,陈建海,2023-06-28 16:28:07,1,1,0,海哥是真的好老师，可以学到很多东西，顶！不解释！！！太赞啦！！
177477,1902,陈建海,2023-07-03 11:10:14,1,1,0,作业很多 但是学到了很多
177789,1902,陈建海,2023-07-05 01:26:50,6,7,1,器材老师一堆横向，还最爱带创赛，课可以选，但是一定要远离这个没什么科研能力的商人。
177927,1902,陈建海,2023-07-05 13:48:28,0,0,0,绩点太好了，cjhyyds
177929,1902,陈建海,2023-07-05 13:49:53,2,2,0,助教zjh，绝对的反恶竞（互评打分不能低于80所以不会出现一些恶心人的同学）。给分太好了，cjh你是我爹
177975,1902,陈建海,2023-07-06 02:21:47,2,2,0,老师讲的挺好 下次别讲了 完全听不懂 作业太tm多 太tm难了 但是老师和助教都很会捞 好好写大作业 不会辜负你 点赞赞
178002,1902,陈建海,2023-07-06 06:07:30,8,9,1,c大 作业很难很多 但出分的时候我把所有答辩都吃了下去 大声叫了一声cjh是我爹
178059,1902,陈建海,2023-07-06 13:08:44,3,4,1,程序设计专题。作业很难，上课讲的和作业完全不是同一个难度，就像依托答辩。但是助教zjhgg很好很耐心，验收的时候陪我从四点熬到六点半，助教哥哥也强烈抵制鹅颈。虽然cjh的作业像答辩，但出分的时候我会把所有答辩都咽下去，给分真的很好。
178067,1902,陈建海,2023-07-06 14:11:45,3,3,0,区块链\n\n做做平时的lab就行，上课也不用听，知识都是通过lab获取到的\n\n最后的大作业最好还是要有一些web开发经验会更好做一些（否则会被卷到\n\n本非计院人士觉得给分还算kok
178507,1902,陈建海,2023-07-13 05:01:44,7,8,1,可以看出来陈老师不是那种醉心科研的人，更多的是那种接项目，带学生打创赛的那种老师。最后一批C大，只能说将来的C程如果你选上了这个老师，你就偷着乐吧
179305,1902,陈建海,2023-09-08 14:43:30,9,9,0,创赛大师
180441,1902,陈建海,2023-09-21 15:35:25,3,4,1,114514（╯▂╰）
182440,1902,陈建海,2023-11-16 04:31:50,7,8,1,陈建海老师人很幽默风趣，但废话有点多，每次都抓不到重点，而且作业超级超级多，期中考试周布置一堆作业，视频都长达一个小时，还要写巨多实验报告，时间远不止他口中的一个小时，我感觉得花四个小时还差不多！
184225,1902,陈建海,2023-12-13 11:21:11,19,21,2,微信小程序过来的。\n\n不知道他上专业课是什么样的，反正2023年秋冬学期的小程序课他就没几次准点到的，老师频繁迟到你敢信？有时甚至干脆就不来上课了，让你们自己学。虽说是个水课，但也不能这样吧。上课就是念PPT，实操的时候经常就出错了，在课上摆弄好半天，基本没学到什么，要做作业基本得自学或者问助教。说是个水课吧，作业又不简单，本人选课时大二，学过C小C大，仍感到有些吃力。真不知道为什么这老师评分这么高。\n\n另：陈老师上课时说微信小程序这门课以后不会再开了，之前开是因为有个什么小程序全国大赛，但是疫情之后就不再举办了，本来这学期也不想开课了，但是老师自己忘记在平台上取消了，反应过来的时候已经报完了，只能再上一学期。但这不应该是老师懈怠的理由吧。
187964,1902,陈建海,2024-01-18 02:04:34,0,2,2,C，刚出分，必须10分。\n\n觉得海哥讲的不好的这其实不是他的问题，是课程本身的问题。一个学期想学完一个编程语言的语法、逻辑，还要会自己写程序，这本身对大多数人就是很难的。我作为选了技术的浙江考生，学三年python也不见得学的多明白，想要一个学期学好C，没有基础的话基本不可能。\n\n你可能觉得海哥作业多，上课也讲的云里雾里，当你看到期末分数时候会把所有的抱怨都咽回去。海哥是真的能捞！！！不会卡你绩点！！！
188035,1902,陈建海,2024-01-18 05:05:14,1,2,1,神，课程对于初学者不简单，但老师 超级认真细致，给分也巨好，只要认真学一定有收获的
188360,1902,陈建海,2024-01-18 18:07:40,1,2,1,最后一届大计基，我觉得要拿高分确实不容易，我是浙江技术选考生，但是期末还是有一些题不确定，总评还是有91，相信海哥已经给我捞到顶了！！老师平时从来不会给学生压力，很幽默开朗！！好老师！！
190093,1902,陈建海,2024-02-21 02:32:53,2,4,2,微信小程序综合实践，平时作业很多，需要好好做，最后期末展示做了个功能完备个人感觉还不错的小程序，收了满绩。
196444,1902,陈建海,2024-07-03 12:39:46,-1,1,2,必须满分！
198084,1902,陈建海,2024-08-29 14:36:46,5,10,5,24超算短学期：糟糕的课程质量，混乱的课程安排。。。唯一的价值是提供了计算资源吧。7.1-7.12的课超算队成员在上面自己讲自己的，\n\n可以说是完全没有授课能力。一个实验拖到8.25才发布，然后告知因为教学科要求，8.31要截止。不像是一门开了好几年的课
198085,1902,陈建海,2024-08-29 14:52:35,2,5,3,接上一条评论，实验文档都是拍拍脑袋写出来的，从来不测试。。到最后这个跑不起来，那个跑不起来，很多问题都拖到八月二十几号才解决
198447,1902,陈建海,2024-09-09 03:55:20,-2,1,3,怎么可能不测试 你发布自己的程序难道不会运行吗？\n\n\n\n集群上不同人的环境配置不一样 这不是很正常吗\n\n\n\n你提出了问题 不是还是有人回答你的嘛
198686,1902,陈建海,2024-09-11 00:57:58,3,5,2,区块链技术应用实践 4.8\n\n给分还可以，作业是真多啊qwq还有大作业
198898,1902,陈建海,2024-09-12 15:11:15,-12,0,12,个人体验总结给后来修读短学期综合实践的同学：这门课程是一门硬课 面对lab 需要你有一定的自学能力，但是相对的，在这里你能收获的不只是技能知识的飞跃 还有思维能力，人脉的拓展
204784,1902,陈建海,2024-11-28 01:47:35,-16,0,16,老师很好，布置的作业不算很多，觉得多的人反思一下是不是自己能力太弱了
207582,1902,陈建海,2024-12-23 07:32:32,7,8,1,坐标人工智能基础A，陈老师讲课真的讲的一言难尽，一个学期下来什么也没学会，他讲课是讲了，但是你听了之后会发现如讲，选这门课的同学建议换个老师
208239,1902,陈建海,2024-12-26 10:02:19,-4,1,5,很有意思的老师，每次课上都能学到很多东西。
209604,1902,陈建海,2025-01-11 05:22:21,3,3,0,坐标C程序设计基础及实验，不点名，可以不去听课但要注意学在浙大的随堂小测（界面内会提前推送提醒），平时上机课也不强制要求去，助教很捞很捞。
209609,1902,陈建海,2025-01-06 10:53:56,0,1,1,C实验，刚出分就来打分了，总的来说本人C学得不怎么样，毕竟既没有基础学习节奏又快，但是老师和ygy助教人都很好，问问题必定会解决的，而且总的来讲给分挺好的挺能捞的，就算本人在实验考和小测都几乎依托的情况下也4.2飘过，不过平时题尤其是编程是真的难，做得想似
209673,1902,陈建海,2025-01-06 12:57:38,1,2,1,从来不点名，作为c程课就很好了
209705,1902,陈建海,2025-01-06 17:16:11,0,1,1,捞神！不会卡绩\n\ngygg：“经过努力调整”
209713,1902,陈建海,2025-01-07 00:13:23,-1,0,1,挺好的，讲课很有激情，虽然不强制同学听课但是还是希望能有人听讲（hh）给分也很不错
210968,1902,陈建海,2025-01-10 08:53:33,0,1,1,快选吧，平时课和习题课都不点名，最后会调分让大家不会出现卡绩的情况，助教gg人真的很好啊啊啊啊
210969,1902,陈建海,2025-01-10 08:53:28,0,1,1,快选吧，平时课和习题课都不点名，最后会调分让大家不会出现卡绩的情况，助教gg人真的很好啊啊啊啊
211482,1902,陈建海,2025-01-11 15:06:37,0,1,1,不点名 很捞 不卡绩 助教很耐心很好😭😭10分送上
213775,1902,陈建海,2025-01-19 17:38:51,6,7,1,人工智能基础A 五次课堂最后点名 给分神中神（属于是期末上90分占比超30%）
216698,1902,陈建海,2025-03-21 07:17:46,2,2,0,人工智能基础感觉实在是奇怪啊，课和作业不匹配。
216995,1902,陈建海,2025-03-31 06:18:11,0,1,1,陈老师人很有耐心，也很和善，我python作业忘记时间了，老师不嫌麻烦又开放了一次，大赞陈老师
217242,1902,陈建海,2025-04-06 07:50:29,7,7,0,人看着很nice，不过学术实在不敢恭维，自己都没搞清楚的就开始各种吹，号称带领超算队伍，可是自己完全不懂，拿着别人的成绩给自己贴金，各种活都让助教干。想学真本领的同学远离这样的老师，当然，想混混的可以。
218949,1902,陈建海,2025-06-16 05:40:00,4,5,1,人工智能A上的一言难尽，也不知道老师自己懂不懂，ppt朗读
219515,1902,陈建海,2025-05-29 05:52:13,2,2,0,微信小程序综合实践，作业屎，给分神，看到最后绩点的一刻，一切诋毁都变成了由衷的歌颂
220119,1902,陈建海,2025-06-15 06:38:22,1,1,0,陈老师人很好，但是人工智能基础A简直就是依托
221733,1902,陈建海,2025-06-25 15:19:34,1,1,0,电脑配置小霸王，狗路过都要跟它比一下（
3412,1921,钱云涛,2015-06-11 02:26:24,22,28,6,离散老师就是不一样，念单词都是离散着念的。。。
4597,1921,钱云涛,2015-06-25 01:13:50,7,9,2,很多东东讲不清楚。。老是讲话讲半句。。
6226,1921,钱云涛,2015-07-12 06:37:10,9,14,5,绩杀
6380,1921,钱云涛,2015-07-13 11:10:20,8,12,4,新一代绩杀
6783,1921,钱云涛,2015-07-23 02:16:16,0,5,5,老师讲的离散还算比较有趣的
16968,1921,钱云涛,2016-01-19 10:19:22,0,2,2,不太好。。靠自己刷提
18835,1921,钱云涛,2018-01-05 03:29:03,3,5,2,离散其实讲的还不错，可惜TA看起来不太靠谱
40822,1921,钱云涛,2017-01-06 00:15:20,0,1,1,还好吧
47874,1921,钱云涛,2017-02-27 01:20:55,0,3,3,英语太差了
47879,1921,钱云涛,2017-02-27 01:44:51,1,2,1,讲的还是不错的，视野很宽，知道得很多
49109,1921,钱云涛,2017-07-15 14:38:50,3,8,5,上课说话不好好说话，嗯嗯**？脑袋让门夹了？有种上去掐死他的冲动
56340,1921,钱云涛,2017-07-03 14:09:34,0,3,3,?杀\n\n
85064,1921,钱云涛,2018-07-15 08:16:44,0,1,1,英语瞩目
103182,1921,钱云涛,2019-02-26 11:58:59,0,2,2,不能因为绩点给得不好老师分就往低打啊，老师讲课强得一批啊。科研就更...！
107741,1921,钱云涛,2019-05-09 00:30:17,1,2,1,上课糟糕，简单的东西不讲，难的东西让我们自己在课上看书，自己有时候还解释错了。讲话么，嗯哼嗯哼的。是个让人窒息的老师
109087,1921,钱云涛,2019-06-08 01:26:05,1,2,1,讲课水平太差，全靠自学，唯一的优点是不点名。
114422,1921,钱云涛,2019-07-10 01:46:40,-1,0,1,老师人还是挺好的，尽管有的时候讲课可能不是很清楚，不过去问问题去讨论一定很认真地帮你解答。
115161,1921,钱云涛,2019-07-16 12:27:28,1,2,1,不点名 1/3到课也不点\n\n全靠自学\n\n给分靠自己 毕竟都是看考试成绩说话的\n\n考试考得高自然能满
134256,1921,钱云涛,2021-03-21 14:50:28,0,1,1,作业太多了吧。。。。
136262,1921,钱云涛,2021-06-14 12:54:09,0,1,1,离散数学平均每周布置30道题目，你们看着选
136837,1921,钱云涛,2021-06-25 11:51:35,0,0,0,烤柿粥前一周还能布置近20道作业题\n\n上课去了和没去一样，照着PPT讲，还不如自己把书看懂（个人体会\n\n冲作业量超大这一条就已经不推荐了
138105,1921,钱云涛,2021-07-07 10:46:52,1,1,0,认真学，没问题的，离散统一批改，不同老师之间差别不大
138198,1921,钱云涛,2021-07-08 01:33:41,3,3,0,个人感觉上课讲得还可以啊，至少比自己单纯地直接看书要好很多，最好的学习方式还是先听讲，然后自己下来再把中文书看一遍，每一章后面都是有专有名词对应的，那个也需要看。离散就是自己学了多少就得多少分，找自己要分吧，捞是情分，不捞是本分。
3971,1922,彭韧,2015-06-17 11:26:59,3,9,6,水的不行 并不知道他长什么样子
7890,1922,彭韧,2015-09-16 03:30:03,47,54,7,每天都要讲他和他的女儿
11061,1922,彭韧,2017-04-10 00:39:15,29,32,3,他和他女儿
19635,1922,彭韧,2016-01-25 03:42:23,2,6,4,这人简直工设一生黑，不过给分还不错。
23118,1922,彭韧,2016-03-18 03:35:29,3,9,6,水平不行，黑工设，黑技术。名声很臭
24817,1922,彭韧,2016-05-04 01:59:55,3,8,5,没水平，对学生也不上心，不知怎么当上副主任的。
26907,1922,彭韧,2016-06-21 14:40:03,10,12,2,怎么没有0分这个选项
30962,1922,彭韧,2016-07-03 04:34:53,-6,9,15,老师很可爱呀
34554,1922,彭韧,2016-10-13 10:31:51,29,31,2,日常晒女儿，日常黑工设，日常讲他在江南大学的时候
37211,1922,彭韧,2017-06-07 09:09:31,19,25,6,傻逼。
37333,1922,彭韧,2016-11-18 10:37:27,9,14,5,垃圾老师，完全不懂审美，还爱装逼。0分！
37552,1922,彭韧,2016-11-19 10:59:58,-5,8,13,老师很好！
38691,1922,彭韧,2016-12-15 01:23:16,24,25,1,这张画是我啥啥啥时候画的，“如果你不喜欢绘画，树莓不适合你，乘早转了吧。。”
50786,1922,彭韧,2017-05-05 10:34:41,-8,7,15,觉得老师上课挺负责的，讲得也可以而且很耐心的啊。给分的话……觉得每次都得了应有的分（自己在水的时候：会点名，但做到按时到课，按时完成作业，不管怎么惨，还是能接受的了的那种分数）
58192,1922,彭韧,2017-08-19 08:17:08,14,15,1,每个学期怎么都**有你
60260,1922,彭韧,2018-06-12 11:01:48,35,38,3,傻逼。
64051,1922,彭韧,2017-12-20 16:28:07,13,14,1,要求小白第一天就临摹自己的作品 exo me？
64157,1922,彭韧,2017-12-21 06:19:52,3,4,1,自以为是，专制。画画这东西光靠这样讲真的学不到什么东西。
71845,1922,彭韧,2018-01-29 04:27:11,8,9,1,垃圾。
71864,1922,彭韧,2018-01-29 04:50:01,7,7,0,奇葩（\n\n
72707,1922,彭韧,2018-01-31 03:24:26,8,8,0,设计绘画课 人不太讨喜 给分还行 基本靠b站自学
73213,1922,彭韧,2018-02-01 07:27:38,4,4,0,5分真的不能再多了\n\n不知道为什么就是打不出高分
73241,1922,彭韧,2018-02-01 08:29:59,4,11,7,不知道为什么评分这么低，感觉不止吧\n\n画画本身就是要靠自己多练习的，老师一笔一笔帮你画自己并不能得到进步   老师有疑问都会解答也鼓励我们问问题，而且拿自己的画去点评也会慢慢帮你分析给你指出来，等着老师来找你那肯定学得少了。
74674,1922,彭韧,2018-03-06 00:22:51,-9,7,16,老师很可爱啊，也没有日常扯女儿黑工设什么的，有可能是看到了查老师评论了吧…上课还是挺用心的，只是授课方式还是有问题，学起来靠悟性
82886,1922,彭韧,2018-07-09 09:09:11,2,4,2,人是很认真但是给分真的太低
83037,1922,彭韧,2018-07-09 14:02:32,3,3,0,蛮负责任这点无话可说，水平和人品你们自己体会hhh
83704,1922,彭韧,2018-07-11 04:49:01,2,3,1,巨水无比全靠自学作业巨多给分不是很好
84362,1922,彭韧,2018-07-12 15:48:53,1,2,1,人品真的无话可说
85756,1922,彭韧,2018-08-02 19:09:04,0,0,0,emmmm
86993,1922,彭韧,2018-09-29 03:14:57,13,14,1,我可以叫他岳父吗？
87424,1922,彭韧,2018-09-29 00:54:58,4,4,0,废话也太多了
87917,1922,彭韧,2018-10-17 15:54:28,4,4,0,真的**
89930,1922,彭韧,2018-11-21 10:07:44,7,13,6,怎么这么多黑彭韧老师的？？？虽然我们总是吐槽他叨逼叨，但是平心而论，他真的还是很不错的老师。给分低？我也是几乎不画画高中三年埋在数理化的，也没有低分啊？？？
91584,1922,彭韧,2018-12-14 07:35:28,14,14,0,“我的老师徐坚。”
92681,1922,彭韧,2019-01-03 14:46:21,-4,3,7,老师很可爱的
93632,1922,彭韧,2019-01-11 04:02:34,17,18,1,是一种吃屎的体验 我非常无语 直接一次否认一个人 绝了  还有点名是拍照 拍照你对的上吗你？ \n\n既然你当众diss人 那我也好当众diss你了?
98667,1922,彭韧,2019-01-23 17:27:06,6,7,1,傻逼，只会吃老本卖资历的废物。
100159,1922,彭韧,2019-01-25 16:16:13,2,2,0,不知道为啥是这个分数，可能自己真的画的一般吧，但是觉得自己很用心在学了，而且比起第一次画进步也很大了，不懂，到最后比其他班水一水过去的人分还低，呵呵了。不知道为什么，反正差评，被预置的趁早退了吧。
100182,1922,彭韧,2019-01-25 18:02:30,4,4,0,我不知道分是怎么给的如果能放图片我真想挂一下给大家看看，绩点低的人画的比绩点好的人还要好得多也不知道是pr的问题还是zxs的问题。zxs，pr班的均绩不知道要比zlf的低多少，留给学弟学妹们一句，你选到zlf你就赢了。不过话说回来，pr教水彩还是很用心的，人都在，也会分析点评。我不知道为啥同学都不想听他评画，虽然我画的不好但我觉得评画还是能帮助我们修正错误的。
100309,1922,彭韧,2019-01-26 02:44:36,3,3,0,补充一点：作业非常多。要画24张水彩。隔壁zlf老师班级是水粉而且少很多（可能10张左右？）
102608,1922,彭韧,2019-02-12 16:19:21,4,5,1,没赶上1.26那一波，教得挺用心。\n\n日!但是给分瞎给，高分的画得一般般，画得好的却很低，画都在群相册里，大家有目共睹。慎重。
102857,1922,彭韧,2019-02-24 10:26:58,-5,2,7,至少上课很负责，有问题都会帮你认真解答。
103972,1922,彭韧,2019-03-08 06:10:07,4,4,0,"""达芬奇是数媒人"""
104126,1922,彭韧,2019-03-12 12:50:34,1,1,0,呵呵呵。呸。
108976,1922,彭韧,2019-06-05 02:48:07,17,17,0,就劝劝学弟学妹们，别当他的研究生，会自闭的
116634,1922,彭韧,2019-09-12 06:06:54,1,1,0,树莓折磨王
120084,1922,彭韧,2019-11-17 10:58:49,2,2,0,吹逼 几学期的课百分制分数没变过 \n\n可能是看姓名打分法\n\n跟他审美不一样的就没了
123060,1922,彭韧,2020-05-14 02:08:59,15,16,1,真受不了 当我真正开始点评这个人渣点时候才发现自己描述这种傻逼的词汇竟是如此匮乏 总而言之就是太他妈把自己当回事 本来上他课就是玩玩 他还真他妈搞起来同学不提醒下课就不可能下课的 管你下节课他妈还有没有课 自己选择吧 喜欢和傻逼待在一起永远不分开的尽管选
123185,1922,彭韧,2020-05-17 18:05:31,16,17,1,钉钉时代写一发。设计基础课是在受不了了，本应该用来自己制作作品的时间（6节课）被他拿来讲课+个人分享（还说没展示的扣平时分），那我tm不是还要自己抽出时间来制作？？？听他上课也受不了，各种吹b，内容也毫无意义
123277,1922,彭韧,2020-05-28 03:55:08,10,11,1,不行了我实在受不了，这么喜欢上课，就连一点给我们做作业的时间都没有了？？？上课就算了，还tm不知道在讲什么，口口声声说就讲一节，到时候六节课都没有了。
134094,1922,彭韧,2021-03-15 16:00:24,17,18,1,彭老师工作非常认真，只要未来就会耐心地帮你扣分，作业要求天马行空，我等凡人实在看不懂。他博闻强识，上课热情洋溢，可以从世界杯讲到提起十遍的光辉往事，完全不讲干货。有这么一个好老师是浙大工设的幸事，世博会没有请他去展览真是一大损失。
135704,1922,彭韧,2021-05-20 00:52:38,5,5,0,折磨王
136103,1922,彭韧,2021-06-11 03:03:18,13,15,2,泻药，人在专教，本在埋头苦干，实在耐不住该老师三百六十度无死角转教室的巴拉巴拉粑粑啦，特来此评论一条（ 给2分以表达对其专业水平的肯定 ）
141249,1922,彭韧,2021-09-27 08:51:34,23,24,1,每次上完他的课严重怀疑人生，抑郁好几天，想想自己过去的努力就是为了进入大学上这种老师的课程，真的很绝望，花费大量的时间做毫无意义的事，既无关绘画，也无关设计，比较大条的理科生碰到他真是倒了八辈子大霉，简单的ps操作非要让你拿手画出来，声称讲究什么精细度，殊不知他的课有多么过时、与现实脱钩。有时候画累了吧，打开朋友圈，看到过去成绩远不如你的同学cs学得风生水起，你说你焦不焦虑、绝不绝望。造型基础一门课作业花费时间可能将近100小时，这100小时学习什么不好？对了，这学期第一节课就让花60块钱买他的书，然而这只是一本纸质版ppt，wcnm :)
142085,1922,彭韧,2021-11-05 11:10:16,3,3,0,我不理解
151913,1922,彭韧,2022-03-20 13:25:35,3,3,0,十年前呢
151915,1922,彭韧,2022-03-20 14:14:29,2,2,0,辣鸡！
151920,1922,彭韧,2022-03-20 16:48:44,1,1,0,已经落后于时代了
153375,1922,彭韧,2022-04-28 18:04:02,11,12,1,pr懂个p的动漫绘画
155477,1922,彭韧,2022-06-13 10:59:34,8,8,0,打了五分给老师的专业水平，零分给讲课水平。\n\n课件里放的都是少说十年前的旧图，讲动漫举例是指环王，pr你懂什么动漫绘画！\n\n不过y1s1，管理还是很灵活的，而且也给了自由发挥的空间。给我的感觉是这位老师上课态度和专业讲评都很认真，只是他本人的认知水平落后于时代，这个是客观条件。只能告诫一下此后的同学：课还是可以选的，但也要做到学不到东西的准备。\n\n最后补充一句，听他讲动漫绘画不如多问问班里的大佬，，，，，有很多外专业的画画大牛会选这门课的，真的受益很多！
156130,1922,彭韧,2022-06-17 17:50:35,1,1,0,ljlj
156149,1922,彭韧,2022-06-18 03:06:59,7,7,0,呵呵何
156161,1922,彭韧,2022-06-18 03:44:53,13,13,0,师德败坏，压榨学生，浙大之耻
156181,1922,彭韧,2022-06-18 05:23:55,14,14,0,指路98\n\n6月18日十大第一
156193,1922,彭韧,2022-06-18 06:24:07,4,4,0,98观光
156194,1922,彭韧,2022-06-18 06:33:15,7,7,0,看看CC98吧，辣鸡老师纯纯脑瘫一个，伞兵
156205,1922,彭韧,2022-06-19 05:37:14,8,9,1,你是永无止境你是没钱买药你是头脑有病你是眼里有泡你是嘴里流能你是你是殃及无辜你是祸害众生你是无可救药你是人模狗样
156206,1922,彭韧,2022-06-18 08:03:53,1,1,0,为什么没有0分呢
156224,1922,彭韧,2022-06-18 09:22:08,6,6,0,彭韧一日敛财，浙大一日有灾\n\n小吴，懂了吗？
159238,1922,彭韧,2022-07-09 03:22:56,2,2,0,www.cc98.org/topic/5370486/1#1
159240,1922,彭韧,2022-07-09 04:04:57,0,0,0,杀人嗜血
159241,1922,彭韧,2022-07-09 04:04:57,0,0,0,杀人嗜血
159242,1922,彭韧,2022-07-09 04:30:11,1,1,0,你的学生都跳河了，你tm还能心安理得的说出这种泯灭人性的话？
159243,1922,彭韧,2022-07-09 05:38:57,0,0,0,cc98慕名而来\n\n作为导师太哈人了
159246,1922,彭韧,2022-07-09 05:45:28,0,0,0,滚丨gun
159247,1922,彭韧,2022-07-09 05:48:44,0,0,0,。。。。。
159251,1922,彭韧,2022-07-09 15:49:34,0,0,0,你mlgb的什么时候死？
159252,1922,彭韧,2022-07-09 09:45:41,1,1,0,把学生逼到跳河，傻逼玩意，愧为人师
159260,1922,彭韧,2022-07-09 17:30:30,0,0,0,比较好奇怎么会有人给pr洗地呢？可能是收到了pr的欣赏吧，那确实你也就到这了（呕
159263,1922,彭韧,2022-07-09 19:36:48,0,0,0,傻逼一个
159268,1922,彭韧,2022-07-10 03:11:33,5,5,0,家人们去98看看他做的事吧，关键词搜索“同门跳河”“对线经历”，这种人怎么还能有分？
159282,1922,彭韧,2022-07-10 15:11:33,0,0,0,啊啊啊啊
159410,1922,彭韧,2022-07-17 17:00:37,1,1,0,抗议压榨！斗争必胜！
159552,1922,彭韧,2022-08-09 01:43:49,5,7,2,人渣一枚！道貌岸然的畜生！逼着自己的学生去跳河的败类！
160568,1922,彭韧,2022-09-27 06:17:22,7,8,1,《可能是选错专业了》
162140,1922,彭韧,2022-11-17 04:35:06,2,6,4,有一说一，老师还是很厉害的
176869,1922,彭韧,2023-06-30 13:11:59,2,5,3,老师知道很多工业设计系历史知识👍🏻
180367,1922,彭韧,2023-09-21 08:45:19,0,2,2,转专业来工设，就碰到李勇初号机+屁话超多的sb老师
183776,1922,彭韧,2023-11-30 06:12:48,2,2,0,感觉课上得还是不错的
203239,1922,彭韧,2024-11-18 10:00:51,1,2,1,纯傻逼
203868,1922,彭韧,2024-12-02 03:38:38,3,4,1,老而不死是为贼\n\n有看到这条评论的，它死的那一天，你打我电话19012770986，我请你吃饭（如果不方便我可以V你50）\n\n你分怎么能比李勇高？
208674,1922,彭韧,2024-12-30 16:09:50,4,4,0,其实是很好的老师，说话温柔，热爱设计，有老一辈知识分子的风范。设计基础课会经常把同学们的作品放一起点评，大家一起讨论挺有氛围感的，很温馨很美好。zn老师在设计史上也谈及他以前的构成课也是如此，亦如百年前的包豪斯设计学院。今天结课了，早上陈实老师也来了，大家一起在411整理教室整理作品，很美好的一门课，很好的一位老师，很好的一个专业。虽然因为点名，或是一些别的发言惹我们不悦，但我们不应抓着这些问题不放。老师人很好，看到有同学上课睡觉，老师把她叫起来，我以为她要被diss了，没想到老师也只是关心她身体。而且pr老师每次口口声声要点名，其实也就验收作业的时候会点，如果人没来还会再三叫同学去催，很难真的缺课。下学期有一门pr老师的动漫绘画，因为跟服创时间冲突了，很少人选，老师小心翼翼地问我们是不是选课结束了，挺落寞的。害不知不觉说了这么多，只能说查老师上很多评分看看就好，也仅供参考了，不要被查老师上的第一印象限制了，一位老师不应被评分量化。
214535,1922,彭韧,2025-02-11 13:45:05,0,0,0,就上课来讲，没有那么烂，指导作业很认真，鼓励式教育
11396,1929,张旭生,2015-11-30 03:45:52,4,5,1,如果他不三天两头出差开会不来上课，我是想给他满分的，教的东西挺好，眼睛长得特别漂亮。
11399,1929,张旭生,2015-11-30 06:05:15,0,0,0,好人啊
19358,1929,张旭生,2016-01-24 02:52:27,1,1,0,上课太水
63993,1929,张旭生,2017-12-20 13:09:32,3,3,0,老师很有风格，是个工设的好老师，而且对科创专业需求很了解～～
64016,1929,张旭生,2017-12-20 13:50:29,9,11,2,画画课一般都整个白天的，老师多数时候上午都在（出差就没办法了），问问题会很耐心的进行个人辅导，给出有启发性的建议。很强调对结构的理解，对设计思维和社会前沿技术都有见解。作业比较多23333大一上有次4周就要画60张产品手绘（当然ddl推迟了和后面的一起交）总之是个挺可爱的老师?
67632,1929,张旭生,2018-01-22 02:55:01,0,1,1,可爱老师
67875,1929,张旭生,2018-01-22 08:35:12,-19,7,26,水了一个学期，总共只去上过4次课，感谢老师最后给的4.5，虽然比预想低了一些，但还是得说老师很可爱，炒鸡可爱的老师啊。
67893,1929,张旭生,2018-01-22 09:06:43,0,1,1,老师超可爱的
67894,1929,张旭生,2018-01-22 09:08:40,3,3,0,“大学里的老师就像钟，要去敲才会响” 很可爱也很有思想的老师 ，适合科创的同学去学，如果来教室的话会很认真地教你，经常一对一，有收获。
68646,1929,张旭生,2018-01-23 14:12:06,-1,2,3,觉得老师人很好，给分也不错。ヾﾉ≧∀≦)o
71067,1929,张旭生,2018-01-28 02:20:35,3,3,0,老师人真的太好啦 冬学期开始四周的产品手绘有点多 但是期末才交也没有强制都要齐 数量差不多就可以 三天两头出差没错哈哈哈 有时候会迟一点到 所以到后期很多同学都没来教室自己在寝室画了w 没什么基础的同学也不用太担心 老师说看的是进步的过程所以不会有太大劣势的
73270,1929,张旭生,2018-02-01 09:02:36,0,1,1,上课水
78112,1929,张旭生,2018-05-09 10:49:42,0,1,1,很好的
79078,1929,张旭生,2018-05-22 07:52:16,4,4,0,老师人超好！！
91928,1929,张旭生,2018-12-25 03:47:39,2,2,0,水，老师上课基本不出现，素描自己摸索吧
98666,1929,张旭生,2019-01-23 17:25:48,0,2,2,给分给错了不给改，杂种。
98867,1929,张旭生,2019-01-24 04:22:18,0,1,1,老师都不怎么来\n\n但是一来就很好\n\n
100184,1929,张旭生,2019-01-25 16:54:07,0,1,1,我不知道分是怎么给的如果能放图片我真想挂一下给大家看看，绩点低的人画的比绩点好的人还要好得多也不知道是pr的问题还是zxs的问题。半学期就没教什么，素描全靠美图秀秀，pr别的不说至少还在教，你人都看不到什么意思？pr和zxs的合班的均绩不知道要比zlf的低多少，留给学弟学妹们一句，你选到zlf你就赢了。
100821,1929,张旭生,2019-01-27 01:21:27,0,1,1,东西教啊不教 分给的贼低 我画的真的不菜 但是却和...一个分
133815,1929,张旭生,2021-03-06 10:59:46,1,1,0,老师最好看了！鼻子眼睛都好看！
6281,1940,林兰芬,2015-07-12 15:09:48,1,2,1,英语不是很好。教的蛮认真的
14869,1940,林兰芬,2016-01-10 11:53:51,11,20,9,课堂会有几次quiz，给分不是很好\n\n教得比较认真经常拖堂。\n\n但是感觉老师能力比较差而且口音实在难以忍受
16670,1940,林兰芬,2016-01-18 16:49:37,10,13,3,老师人很不错的
22595,1940,林兰芬,2016-03-08 09:51:09,0,0,0,奇怪评分为什么0.0啊
22768,1940,林兰芬,2016-03-11 02:16:59,5,8,3,确实是个英语口语及普通话很差的主。“未知逻辑”（谓词逻辑），每次听到都要愣两秒才听懂。
25504,1940,林兰芬,2016-05-24 00:21:23,3,4,1,听她上课太吃力了。算了，她读英文读得开心就好
30606,1940,林兰芬,2016-07-02 04:50:15,3,4,1,很认真
34434,1940,林兰芬,2017-03-21 04:39:42,1,3,2,虽然口音可能有点让人不适应，但是老师非常认真。给分超好
48267,1940,林兰芬,2017-03-02 00:13:24,3,4,1,这老师的英语读的声嘶力竭
48268,1940,林兰芬,2017-03-02 00:15:15,-2,0,2,听她的英文发音就已经疯了
49504,1940,林兰芬,2017-04-17 07:00:29,1,3,2,口音太差，自己讲给自己听，很无聊的一个老师
52603,1940,林兰芬,2017-06-21 10:51:05,1,2,1,客观的评价一下\n\n老师的英文不是很好，上过课的determine的读音都应该记忆很深。\n\n但是老师对各种各样的离散问题都很耐心，你有问题问她她也很耐心，离散这个课本来就看考试。说给分不好的还是自己好好学吧。\n\n（老师已经把report弄成那么水了）
56519,1940,林兰芬,2017-07-04 02:40:16,3,4,1,老师教得挺一般，不论中文还是英文都发音很差，不过老师人很好，解答问题也很有耐心。
56521,1940,林兰芬,2017-07-04 02:40:56,7,13,6,给分算不上好 但绝对说不上绩杀 主要还是看考试和quiz吧 但是quiz还是挺难的 上课方面 感觉老师真的很想很想把课上好 备课也充分备过 但就是感觉教学水平一般 不知道为啥……
56532,1940,林兰芬,2017-07-04 03:18:05,10,10,0,给分跪
58025,1940,林兰芬,2017-07-24 04:04:56,1,2,1,讲课我挺喜欢的，很认真，问问题老师也会仔细解答，我英文也很差没啥可喷的，quiz挺好也学到了不少，report自己做也确实学到东西了，但是，认真学了一个学期，给分真的跪了（哭泣）
58843,1940,林兰芬,2017-09-18 05:28:31,2,4,2,老师很想努力讲好
64096,1940,林兰芬,2017-12-21 03:24:16,0,0,0,。。。
65531,1940,林兰芬,2018-01-05 08:20:56,3,3,0,人很好，也在认真地讲课，口音有点奇怪。给分不算绩杀也不算水
65744,1940,林兰芬,2018-01-09 00:55:00,1,1,0,...
75491,1940,林兰芬,2018-03-12 11:14:22,2,2,0,老师态度很和蔼
77596,1940,林兰芬,2018-05-07 01:32:40,4,4,0,为什么我觉得这个老师有点像 fps选手小绝???
78505,1940,林兰芬,2018-05-12 11:49:41,3,3,0,老师态度挺好，不过quiz比较难
84452,1940,林兰芬,2018-07-13 01:42:25,15,15,0,给分是看老师平时挺好的 ，绩杀不解释
84469,1940,林兰芬,2018-07-13 02:42:33,0,5,5,我想说的是，林老师真的很好，很棒。不要为自己的成绩找借口，quiz和期末前复习特别重要!特别重要!特别重要!题难度不高，只是知识点多而已。老师真的很好的!认真看老师放在ftp上的PPT，刷几套往年期末题，比什么都有用。(也要注重小测，占了27呢)
84488,1940,林兰芬,2018-07-13 03:22:21,4,4,0,道理我都懂。。
84542,1940,林兰芬,2018-07-13 06:26:17,3,4,1,呵呵，无法预料的低?
84593,1940,林兰芬,2018-07-13 09:07:31,2,3,1,老师人很好讲的也还行…就是给分……期末这么简单，平时分感觉也还行！。就是不知道扣在哪里
84717,1940,林兰芬,2018-07-13 15:23:01,-31,3,34,离散数学，让我重新燃起了对数学的希望。不怕大家笑话，我高考数学才130分，但是离散数学4.2，这门学科真神了。
84748,1940,林兰芬,2018-07-13 17:35:19,7,7,0,给分真的是
85464,1940,林兰芬,2018-07-18 06:34:26,17,25,8,全班均绩1.5是有点佛的。。。\n\n应该是完全没有调分，虽然无可厚非，但这成绩也太辣眼睛了吧
85742,1940,林兰芬,2018-08-01 07:57:07,4,4,0,老师人不错，就是给分不好
85820,1940,林兰芬,2018-08-19 04:10:24,2,3,1,现在学习帝全班均绩更正过来了，倒也没有1.5，老师是硬核给分，学弟学妹们要好好学离散，用心完成布置的东西www
92148,1940,林兰芬,2018-12-26 16:14:53,0,7,7,离散数学，让我重新燃起了对数学的希望。不怕大家笑话，我高考数学才130分，但是离散数学4.2，这门学科真神了。
104006,1940,林兰芬,2019-03-09 06:41:13,-1,5,6,离散数学，让我重新燃起了对数学的希望。不怕大家笑话，我高考数学才130分，但是离散数学4.2，这门学科真神了。
104560,1940,林兰芬,2019-03-23 16:16:15,0,5,5,离散数学，让我重新燃起了对数学的希望。不怕大家笑话，我高考数学才130分，但是离散数学4.2，这门学科真神了。
105517,1940,林兰芬,2019-04-16 02:42:55,0,0,0,虽然老师讲英语不太标准，但这不影响讲课质量，老师讲课其实很有趣呢。
108253,1940,林兰芬,2019-05-17 14:57:52,0,0,0,老师很严格也很可爱，自身水平也很强，就是英语口音太迷了
109833,1940,林兰芬,2019-06-19 14:07:07,0,0,0,老师讲课很仔细～解答也很细心
113776,1940,林兰芬,2019-07-07 12:05:11,1,2,1,特别关心学生 好赞
114059,1940,林兰芬,2019-07-08 14:38:26,-84,3,87,对于我这种均绩只有4.5x的差生，一个3.3的离散数学实在让我雪上加霜，我哭了，你们呢？
114607,1940,林兰芬,2019-07-11 00:25:29,1,2,1,老师人实在太好了，平时两次quiz和期中考得很差，以为自己要挂了，没想到老师直接用期末考作为总评，捞了我一把
114785,1940,林兰芬,2019-07-11 17:21:11,1,1,0,老师偶尔点名，因为早课的话很多人都翘了教室很空。。。老师人还是挺好的，问问题会很用心去回答，群里直接问或者私戳都可，给分的话我不清楚期末考了多少，可能分数也比预想的要高点。但是老师的英语确实有点不标准哈（习惯就好）。老师是最看重图论部分的，这是与其他老师最大的区别！真的很有用！小测和期中记得认真复习，分数不会差的！
114859,1940,林兰芬,2019-07-12 04:53:04,-59,2,61,没听过一节课，4.8，小测很烦。
114900,1940,林兰芬,2019-07-12 15:43:24,-46,2,48,我不明白老师期末盖平时的操作。如果因为期末考试成绩比含平时分按公式计算出来的成绩高就用期末考试成绩盖，那还不如以后大家quiz半期考都随便搞，就期末考一考定乾坤。平时成绩对于学习过程的评估作用完全失去了意义。对，你可以理解成“如果期末考试炸了，或许还有平时分给你涨分”以及“如果平时炸了期末考好了还有期末可以盖”作为双重给分保障。但是我作为一个期末考的不够理想的同学，用严格计算的分数作为总评带来的分数提升真的比得上期末盖平时同学得到的分数多吗？（以上发言都可以说我是斤斤计较。但确实是事实。）希望老师能一套标准贯彻执行，让学生真正在平时过程中落实好离散这门课的学习，这不是更重要吗？
116108,1940,林兰芬,2019-09-03 23:48:57,7,7,0,人好耐心，但教的差，给分差，建议换老师
122861,1940,林兰芬,2020-04-16 02:52:58,1,1,0,还可以
125518,1940,林兰芬,2020-09-11 02:35:36,9,9,0,真的完全不调分。。。平时成绩和期末成绩基本上是一个水平。。。
148165,1940,林兰芬,2022-01-11 17:12:22,-1,0,1,水平不行
152088,1940,林兰芬,2022-03-25 08:10:30,0,1,1,标准伦敦口音我真的受不了
152194,1940,林兰芬,2022-03-30 02:32:56,5,8,3,我均绩4.6.这个课得分3.6。你自己品吧。\n\n“补去年评论”
157859,1940,林兰芬,2022-06-25 07:09:16,0,3,3,老师的上课水平确实没有达到最好，但是每节课都认真听完全够用了。给分的话确实是完全不调，不过离散考试难度也不是很大，认真学的话不会差的
157947,1940,林兰芬,2022-06-25 17:22:06,0,4,4,那倒也不是，离散花了超级多的时间和精力，书后题写了将近一半，一直坚持用英语教材。最后喜提2.4
157970,1940,林兰芬,2022-06-26 01:50:28,2,3,1,老师本人性格什么的都很好，个人也感觉不出上课水平有什么问题（可能是没有和其他老师比较过X）ppt不知道所有老师是不是一样的，但很详细，复习的时候不看书看ppt完全够用了ww\n\n上面写了一半课后题喜提2.4的，建议你多反省一下学习方法的问题，毕竟计院er脑子都不差xx我平时作业都是糊弄一下，小测随便炸，期末考之前一边看ppt一边把老师布置过的少量作业题刷了一遍（甚至很多只想了一个思路），考试的时候还有一整道大题没做出来（硬磕了半个小时，真的完全没思路的那种），最后也喜提3.9了。\n\n总之，我觉得老师不差的，虽然听说不调分（？）但这不应该成为评价老师的最高标准，学弟学妹还是放心冲ww\n\n———————随便分割一下\n\n嗷嗷嗷楼下2.4应该不是我们这届的，这届雀实卷子难度有降低，总体情况应该都不错的orz
157971,1940,林兰芬,2022-06-26 01:23:16,0,2,2,上课一般，人很好，给分很求是（但整个课程组都很求是）\n\n不过好好学也是可以满的
157972,1940,林兰芬,2022-06-26 01:28:56,4,5,1,老师讲课认真的，不过跟其他老师比讲的可能不算好。离散这门课难在知识点广，而且要看英文教材ppt。知识点不算太深入，概念很多，建议多自学。另外老师有一个期末分高于平时分就直接用期末当总评的机制，这种机制对绩点应该是只增不减，算是好事，能满也是托这个机制的福。如果你对自己的自学有一定自信，林兰芬老师很合适。如果以前没怎么接触过相关知识，建议考虑一下，但不必太过纠结，离散这门课谁来教都挺吃课后梳理的。
157976,1940,林兰芬,2022-06-26 01:41:29,0,0,0,老师很认真，口音可以接受，还觉得有点可爱
157998,1940,林兰芬,2022-06-26 05:09:22,2,4,2,老师教这门课很久了，教学很认真，这学期生病了也在尽力为我们上课。当然我认为的确也存在一些小问题：\n\n1.老师口音可能不太好，但由于基本是中文教学，完全不影响理解，这个放心\n\n2.离散分数过于求是，这个其实是普遍的现象，并不只是林老师，而且期末考试考的好貌似能覆盖成绩？这一届的期末卷比较简单，所以大家的绩点可能普遍会好一点\n\n3.老师上课速度过于“匀速”，匀速的意思是有时候遇到简单的问题能讲很久，有时候遇到难的点却一下子带过了。离散知识点很多，建议上课思路跟上，把不懂的问题记录下来，下课好好搞懂，对着ppt自己梳理一下\n\n最终满绩了，很感谢老师一学期的教学！
158642,1940,林兰芬,2022-07-01 02:46:18,-21,9,30,之前看评论还以为这门课有多难呢。。。
173844,1940,林兰芬,2023-06-03 13:34:34,1,1,0,666
175154,1940,林兰芬,2023-06-22 03:08:34,2,2,0,就上课体验而言一般，自己学为主。讲点功利的，这课期末成绩取决于期末考题和你的掌握题型匹配程度，因为知识点很离散，除非是你整本书都刷过，不然分数不会很好看的。我觉得课程组保护试卷保护得这么好，也是上面所说的因素导致。但是也没啥更好的考法，多刷题，当成高考数学就行。
176364,1940,林兰芬,2023-06-28 14:28:59,-5,2,7,快出分来评论一下：\n\n我觉得这个老师很好，非常亲切，发消息都会回复，课后也会给同学互动问答；\n\n略有不足的是老师上课有些地方不太清楚，以及英语口语有点不行\n\n10分，可冲
176690,1940,林兰芬,2023-06-29 17:13:48,3,3,0,老师人比较和善，问问题会认真点回答你，英语口音比较怪但是大部分时间用中文上课。但是给分真的一塌糊涂。期末意想不到的低。她还在群里说大家都不错，或许是我太菜了，但是根本不知道扣哪里，唉。
178518,1940,林兰芬,2023-07-13 06:09:37,0,1,1,老师讲课确实有点不清晰，但是人还是很好的，可冲
179081,1940,林兰芬,2023-08-27 12:49:30,3,4,1,老师上课还是挺认真的，脾气很好，就是有点口音\n\nppt复习也够用了，离散这门课的难度有很多是因为知识点太多太杂，重在整理，理解和记忆\n\n22-23春夏，一到小测的时候人就比平时多特别多，有一次点名老师还在黑板上写了错误的签到码误导看智云的同学们[ac01]
193349,1940,林兰芬,2024-06-07 00:21:00,25,25,0,老师人是很好的，很和善，但是上课口音有点重。对待小测和期末考没什么区别，要求很严格，偷看课本或者手机会被做标记。重点是两节课都是早八但是会有毫无征兆的点名，并且8:10到的同学和9:30到的同学都是记迟到就有点无法理解
193350,1940,林兰芬,2024-06-07 00:24:02,25,26,1,默默在大雨天的某个早八用签到杀死每一个还在睡梦中的大学生
193815,1940,林兰芬,2024-06-19 12:27:06,2,6,4,老师超级好超级和善，讲课仔细认真，推荐大家上
196222,1940,林兰芬,2024-07-02 09:47:25,14,15,1,不捞，喜提最低绩点
196549,1940,林兰芬,2024-07-04 04:41:46,6,10,4,老师可能上课态度还算认真，人也还行，但是给分真不行。这课90%的成绩取决于考试发挥，而且无论是小测（两次各10%)，期中(20%)，期末（50%）难度都不算小，尤其是期末考，难度真的很大，而老师无论是小测还是期中期末又是原分计入，完全不调分。这就导致了成绩几乎完全取决于你的数学底子，跟你付出的努力关系不大。本人真的非常认真在学，但是小测和期末考发挥一般，喜提74（平时分50分扣了约10分），大学最低绩点。
197164,1940,林兰芬,2024-07-08 10:01:03,6,9,3,我军鸡4.8但是喜提最低绩3.6（\n\n\n\n确实不得不承认这学期有点飘很摆，但是还是正儿八经学了和小测均分也有65/80\n\n\n\n这课可以期末覆盖，得分差只能怪我考得差\n\n\n\n但是确实一点不捞\n\n\n\n求是林我哭😭
205830,1940,林兰芬,2024-12-12 06:57:19,2,3,1,讲的不错，全程认真听下来最后获得了4.5的绩点。不过啊，不过我必须提醒之后上她课的同学，她会在某些时候突然早八搞签到来偷袭，而且甚至是拿着花名册把教室里的同学记下来的，所以线上点名不可行，早八最好要来，尤其是早八的教室里人越来越少的时候更要来！
208374,1940,林兰芬,2024-12-27 07:46:39,1,1,0,大学最低绩点
218247,1940,林兰芬,2025-04-22 08:14:26,-5,2,7,快跑\n\n上课水平难评\n\n几乎每周点名\n\n作业多得要命\n\n至少我这种菜狗受不了了
218855,1940,林兰芬,2025-05-09 00:56:59,2,2,0,今天纸质签到了，不过老师似乎比之前评论所说的好，8：45让我们晚到的都补签上了，大家还是不要翘课啊
219731,1940,林兰芬,2025-06-05 02:38:10,2,3,1,老师人很不错
221595,1940,林兰芬,2025-06-25 01:50:17,4,4,0,老师会在后半个学期的早八突然来几次纸质签到，所以大家不要翘课。平时的小测难度没有非常大，主要考察的是基础的概念和定义。至于给分我也不清楚，虽说llf老师都有“求是林”的别称，但个人取得的成绩还是比较满意的。除了会有突击点名外，整体上课体感还是不错的，老师人也很好，PPT整理得很详细（好像wyl老师的ppt就是根据她的优化的）。
221648,1940,林兰芬,2025-06-25 05:50:11,2,2,0,llf老师感觉整体听下来还是很不错的，注意只要是交上去的作业或者小测验等都要认真写，而且会以是否来拿作业来看有没有到，所以建议不要翘课。跟着她上课走一遍基本问题不大，看ppt就够了，个人的得分感觉在期末考试这么难的情况下还是和努力成正比的
221844,1940,林兰芬,2025-06-27 00:08:52,3,3,0,虽然说老师确实不捞人，但小测比起其他老师难度极其简单，因此平时分会很高，即使期末考不捞给分也算是所有老师里几乎最好的。老师上课尽管没有讲的非常出彩，但态度很认真。听说会有突击点名（难怪我觉得分数不对www），所以还是别翘课了
971,1981,钱抱清,2015-03-19 17:07:30,17,34,17,个人不太能听懂他的方言。。不过给分很好的。
1868,1981,钱抱清,2016-12-19 14:28:49,2,8,6,昏昏欲睡
2555,1981,钱抱清,2015-05-04 13:57:40,-5,1,6,困啊困=.=\n\n大计基简直不要太瞎
4305,1981,钱抱清,2015-06-19 00:11:20,3,10,7,口音太tm重了。。。完全不知道他在弄啥呢。。。
4775,1981,钱抱清,2015-06-28 12:57:09,-1,5,6,听进去的人每节课超认真，像我这种没听进去的……第一节课以后就没去的必要了…错过了一次测验，不知道错没错过期中考试，马上期末了，考完告诉大家打分情况
4986,1981,钱抱清,2015-07-02 02:14:26,-5,1,6,简直不要太快
6262,1981,钱抱清,2015-07-12 12:34:44,8,12,4,啊啊啊啊啊c程怎么这么低怎么回事
7257,1981,钱抱清,2017-08-29 05:03:30,0,4,4,老师人挺不错的，给分也很正常
8842,1981,钱抱清,2015-10-13 00:30:57,-2,1,3,好坑啊
8849,1981,钱抱清,2015-09-29 02:37:45,-2,3,5,完全听不懂，口音太重，只希望给分能好一点。
9517,1981,钱抱清,2015-11-04 06:51:49,0,5,5,老师人很好，给分好
12025,1981,钱抱清,2015-12-21 14:07:56,63,74,11,睡吧孩子，不怪你
12185,1981,钱抱清,2015-12-22 08:13:07,0,4,4,口音重 但是好人
13439,1981,钱抱清,2015-12-28 03:58:45,10,14,4,会时不时来一次随堂考
14136,1981,钱抱清,2016-01-05 01:08:47,-1,2,3,我以为只有我听不懂他说的啥 比英语听力还难懂
14184,1981,钱抱清,2016-01-05 07:56:27,-2,2,4,无聊，说好的答疑课也不来
17898,1981,钱抱清,2016-01-21 03:33:15,2,6,4,这老师好像。。。挺水的
18149,1981,钱抱清,2016-01-21 08:23:55,-4,4,8,垃圾老师
19118,1981,钱抱清,2016-01-23 09:45:24,6,12,6,除了口音有点重没别的缺点了……
19119,1981,钱抱清,2016-01-23 09:47:56,-5,3,8,给分高，讲课水
19344,1981,钱抱清,2016-12-21 06:02:30,-31,10,41,请直接退课，不要犹豫。口音重，给分低，垃圾中的垃圾王
19780,1981,钱抱清,2016-01-25 09:08:58,7,12,5,口音比较重不过给分棒棒哒，自己一节课也没听过不过最后分数还蛮好，平时任务也没有那么多，测试作业也不用去机房~
20240,1981,钱抱清,2016-01-26 15:53:30,17,24,7,会突然来一个测验，做不来不要紧，只是当点名使的(≧∇≦)\n\n老师口音重的话其实是可以克服的，并没有想象中夸张。不过自己没有自带催眠免疫(-_-) \n\n好人一枚。
20922,1981,钱抱清,2016-02-04 05:30:00,3,7,4,莫名其妙给分2.4  难道是期末考试我忘了保存？
22466,1981,钱抱清,2016-03-06 12:51:29,-5,2,7,一点都不靠谱！给我们的邮箱他自己根本就不看，形同虚设！讲课也是一般般！
22605,1981,钱抱清,2016-03-08 13:38:41,118,149,31,学两门语言，c和杭州话
22839,1981,钱抱清,2016-03-13 10:38:40,3,6,3,好喜欢他。。给分不错 浙普听的亲切 测试作业不锁ip
22925,1981,钱抱清,2016-03-15 02:32:40,-1,2,3,讲的挺好挺认真的，稍有口音，能够接受
23287,1981,钱抱清,2016-03-23 14:15:34,-2,0,2,呵呵哒
23288,1981,钱抱清,2016-03-23 14:17:07,-2,2,4,呵呵哒
23310,1981,钱抱清,2016-03-24 04:29:32,6,7,1,老师人很好，就是讲的让人迷之困倦。给分不错！
25541,1981,钱抱清,2016-05-25 02:30:40,3,4,1,老师还是不错的啦，老好人了
25764,1981,钱抱清,2016-06-07 08:51:49,0,1,1,好好好
26689,1981,钱抱清,2016-06-21 02:17:12,-2,1,3,大鸡鸡2.7 我忘记保存了？
27136,1981,钱抱清,2016-06-23 06:51:35,0,1,1,挺不错的
28285,1981,钱抱清,2016-06-28 08:26:28,-1,0,1,讲课还好，讲题说话有点方言，还语速超快，一个题过去我连选什么都没听见
29176,1981,钱抱清,2016-06-29 10:30:17,10,12,2,两个优点1不点名（除了有一次课堂小测）2上机不限制IP，就是能在寝室上机练习。缺点，讲的不细致清楚。我就听了一半的课，一半自学吧。技能类的课是应该尝试自学，通过互联网查一些问题，自己解决摸索，看看网课，因为是几十年前的知识，很快就会了。要想学好，多练习是真，老师仅仅是引导。
31895,1981,钱抱清,2016-07-05 06:01:07,0,1,1,好老师！
31996,1981,钱抱清,2016-07-05 10:39:53,3,6,3,上课认真听还是很有收获的，给分不好。
32846,1981,钱抱清,2016-07-18 09:28:25,10,10,0,给分还可以，上课讲得中规中矩。
34672,1981,钱抱清,2016-12-29 14:56:15,-1,4,5,自己在课上自嗨 根本不知道在干什么....计算机实验上都不上就让我们去做报告 我也是醉了
35303,1981,钱抱清,2016-11-08 03:58:33,-1,1,2,想睡，感觉知识点完全听不懂，有完全做不来的测试
37489,1981,钱抱清,2016-11-19 05:26:04,-1,0,1,为什么要上机才能写测试啊，好麻烦
38634,1981,钱抱清,2017-01-20 05:56:23,3,3,0,老师挺厉害的，阅历比较丰富
39295,1981,钱抱清,2016-12-22 03:40:37,-1,1,2,讲话实在听不太懂，上课还蛮无聊的，作业虽然比较少而且交的时间都很晚，但是很难，基本靠自学吧
39896,1981,钱抱清,2017-02-26 23:55:33,2,5,3,给分好，作业随意做下都没关系，刚开始不太喜欢这老师，可能是评分低的原因，到后来觉得这老师确实超好，特别是看到别的班大计基低分的人之后。
40656,1981,钱抱清,2017-01-20 09:15:38,30,65,35,我是浙江人，听起来感觉口音很正常，但是上课真的有一点点无聊，虽然感觉老师在很认真地传递东西……大计基事情很少。最后拿到大学第一个满绩，谢谢老师。
40981,1981,钱抱清,2017-01-07 07:32:37,2,4,2,口音不会那么可怕，还是不错的老师
41165,1981,钱抱清,2017-01-14 10:52:13,5,9,4,其实老师人很好的，只是囿于大计基这门课了
41398,1981,钱抱清,2017-01-11 09:06:32,3,4,1,很好的老师 作为从小说普通话的人 认真听还是能听懂的
44794,1981,钱抱清,2017-01-18 09:05:52,5,6,1,其实，口音不是问题啊，真的不妨碍听课的。就是，老师的课，很少有同学会认真听而已。老师人很好的，不过，大计基本身就挺无聊的。
45890,1981,钱抱清,2017-01-20 08:33:41,2,3,1,老师很帅很帅
45922,1981,钱抱清,2017-01-20 09:09:26,-17,0,17,说能听懂的 我只能说你别瞎扯淡了，我说了18年普通话，他的课绝对听不懂，我全都是自学最后给分还很低，不过平时确实可以划水给个中评吧
45948,1981,钱抱清,2017-01-20 09:40:11,3,4,1,很喜欢钱抱清老师。
45962,1981,钱抱清,2017-01-20 09:58:06,5,6,1,翘了不知道几堂课，老师作业比其他班会多点，适合真的想学东西的人，别人大jj期末死命复习，我作业做过就只要随便看看啦
46365,1981,钱抱清,2017-01-21 10:56:30,5,5,0,人超好，给分超棒！认真复习不会有问题的。
47592,1981,钱抱清,2017-02-05 08:09:53,3,4,1,就老师个人来说不错，尤其最后一堂课，听得怪感动。不过课真心无聊，还是自己看书来的有用。平时的测验不多，一两次吧，完全不会做好像也没什么事。我以为大计基最后得分会很糟，结果也没想象的那么差！
47693,1981,钱抱清,2017-02-18 11:50:26,4,5,1,上课略无聊，课间安静得可怕。口音问题嘛...目睹一个留学生努力听了一节课最后无奈睡去。不过这些问题并不妨碍他的人品，对学生非常宽容，作业的DDL不知宽限了多少次，期末怎样要看自己，真的不要怪老师。
48144,1981,钱抱清,2017-03-01 01:43:54,-1,0,1,有口音，上课有点无聊，偶尔有随堂小测，可能是我水课吧，绩点有点低
48145,1981,钱抱清,2017-03-01 01:46:05,6,7,1,C程教得很好，很认真严谨，是个好老师
48855,1981,钱抱清,2017-03-15 02:52:48,14,18,4,我前前后后上过五个计算机（类）老师的课，钱老师不一定是讲得最好的，但是绝对是最有激情的最敬业的。（考前还会专门用一个晚上答疑）这学期另外一门上机课机房遇到钱老师耐心地指导学生，突然想起去年。可能老师是有一点口音，但绝对是值得尊敬的好老师。
48970,1981,钱抱清,2017-03-20 01:13:53,-1,1,2,说口音的...你们可能还没见识过更厉害的杭普吧...
49020,1981,钱抱清,2017-03-22 00:08:48,9,15,6,老师非常棒，一楼说的方言完全是扯淡，对听课完全没影响。老师也非常有耐心，讲的也很棒\n\n\n\n
51909,1981,钱抱清,2017-06-23 03:39:50,25,34,9,老师人超好，，c程题都可以在自己电脑上做，，，最后一节课还跟我们讲了点真情动心的话，很有用，很舍不得结束这门课，，，
52519,1981,钱抱清,2017-06-21 00:25:43,2,2,0,好老师\n\n没毛病
52929,1981,钱抱清,2017-06-23 14:39:54,4,4,0,老师人很好的，C程讲课很详细，口音也没那么严重，广东人表示听懂无压力，平时作业压力也不大
53913,1981,钱抱清,2017-06-28 04:22:34,-1,0,1,老师很儒雅讲课很有耐心
55631,1981,钱抱清,2017-07-02 05:22:55,0,2,2,老师99年开始自己创业，到现在已经有一个不错的it公司，平时上课也很好
55904,1981,钱抱清,2017-07-02 15:22:57,-1,1,2,口音真的没有传说的那么重，听得挺清楚的。最后一堂课还特地给我们一些人生的经验。测试题还全部可以自己在寝室做，没有限制IP，真的是个好老师。
56338,1981,钱抱清,2017-07-03 14:00:41,1,1,0,说不清
57240,1981,钱抱清,2017-07-06 05:48:50,8,8,0,只想说说老师的给分。上机考试编程血崩，只做出了一道，最后老师还是给了88。一开始确实有被老师3.18的均绩吓到，但其实老师的平时分给的还是很厚道的。
57246,1981,钱抱清,2017-07-06 06:23:02,0,5,5,一看到自己的74完全懵了 学的还算是很好的 但是居然这么低 跟老师询问后是助教统计错误了 卷面92 总评94 掉了0.4的学期绩点又回到了我的身边，老师上课朴实认真是一个非常非常好的老师！希望之后的学弟学妹好好珍惜！加油！
57445,1981,钱抱清,2017-07-08 00:25:09,1,2,1,为我打开计算机大门的钱老师。非常感谢钱老师( ´▽` )
58060,1981,钱抱清,2017-07-28 02:20:52,4,4,0,“大学生不要老想着创业，浪费自己的青春和家里的钱，我给你们的建议是先毕业工作几年再创业。”
63158,1981,钱抱清,2017-11-29 00:20:53,3,4,1,大计基讲的不明白，没有意义的作业特别多
64045,1981,钱抱清,2017-12-20 16:15:00,9,10,1,老师讲的很认真，语调很优美，只要顺着他的节奏走，就能睡一个安稳觉
64744,1981,钱抱清,2017-12-27 04:38:23,-1,0,1,钱老师讲c语言超细致又有条理，难的地方还会反复讲好几遍，真的是很好的老师哦
65120,1981,钱抱清,2017-12-29 03:28:26,-1,2,3,不怎么负责人 什么都问不到
65612,1981,钱抱清,2018-01-07 08:11:31,3,5,2,作业是真的多，太多了，熬夜做
65656,1981,钱抱清,2018-01-08 04:52:17,-1,1,2,老师的话感觉口音也没那么重，我一个北方人都听得懂，关键是老师脾气超好，c程题都可以在自己电脑上做，而且最后一节课说了点很感动的话，超级舍不得。。。
66350,1981,钱抱清,2018-09-17 07:36:06,0,2,2,老师人很好。上的他的计科，作业真的多，超级费精力，课上讲的很认真
67335,1981,钱抱清,2018-01-21 00:53:04,0,2,2,我觉得他真的是个很好的老师，上课有很认真地传递东西。而且作业的设置也很为我们着想。口音也不重啊，可能是因为我是浙江人吧。。。。
68871,1981,钱抱清,2018-01-24 04:16:51,-1,1,2,平时作业有几次忘了交，好像并没有太大影响。4.2也还可以吧，期末好好复习考好一点。\n\n老师很萌啊。还是认认真真地听了几节课的，口音什么的也没那么重。
72577,1981,钱抱清,2018-01-30 12:34:04,-1,1,2,在成绩没出来之前，先给老师一个大大的赞，老师人真的太好啦，很体贴，讲的很细致，一节课都没翘过，听他讲他被误认为卡被盗刷其实是去各地旅游哈哈哈哈，可能他口音确实重，但我当时的高中的老师也都来自各地，可能能更好地适应，只要老师是优秀的就行，对吧~
72846,1981,钱抱清,2018-01-31 07:46:31,-1,2,3,由于是浙江人，听老师上课感觉是外公在讲话哈哈哈格外亲切，对于外省同学可能真的有点重吧。但老师自己也承认了自己普通话不好，要同学们包涵。老师非常痴迷IT，感觉他真心陶醉在新技术中，也用心地讲课。但是老师作业要求有的时候不是特别清楚，发邮件基本没有回复。但老师给分挺宽松的，能给满的基本不扣。分低的人基本都是期末考自己考砸了吧…大计基考得好不好其实很大程度上在于自己看书刷题认真不认真。
72848,1981,钱抱清,2018-01-31 07:52:23,-2,3,5,事情少，给分高\n\n
72861,1981,钱抱清,2018-01-31 08:11:54,-3,2,5,老师的平时分给的很厚道，是个很细致很负责的老师～
73021,1981,钱抱清,2018-01-31 15:28:47,3,8,5,坑，卡我绩点，作业还贼多
73060,1981,钱抱清,2018-01-31 23:57:37,-1,0,1,其实老师的口音并不严重啊，感觉在老师里面已经算不错的了，而且老师很体谅，作业比很多老师少，事情不多人超好，绩点给的也很好
73066,1981,钱抱清,2018-02-01 00:39:27,-2,4,6,老师很好 绩点低是自己活该
73129,1981,钱抱清,2018-02-01 03:26:11,3,4,1,绩点确实是靠自己 但也不是活该吧下面那位兄dei 我每一次作业都按时交 也会好好听课 可是老师的通知非常不明确 到期末了突然说要做思科 关于上机 一开始说练练手 成绩出了才知道上机测试是要占分的 所以期末考试做完了一整本习题册 上机考的时候题目基本全做出来了也只有70分 如果真的想选钱老师 记得一定要好好听通知 什么要做 什么可以不做 弄清楚了才不会像我一样事倍功半 另外老师其实人挺好 但是还是。。不建议选吧
73239,1981,钱抱清,2018-02-01 08:28:00,-1,1,2,老师很好。
73261,1981,钱抱清,2018-02-01 08:51:02,-13,3,16,本来以为期末机考血崩，结果拿到了这个学期的第二个满绩，谢谢老师！我上的是大计基，钱老师上课内容很充实速度也蛮快的。作业相对其它通识课算多。可能对于文科生有些东西比较难以理解，但是好好看书就能懂。作业要认真做搞懂课本，不然到期末就很麻烦了。
73922,1981,钱抱清,2018-02-03 14:37:16,13,22,9,口音方面倒不是很严重，平时不点名，上课也可以做其他的内容，不过个人认为课讲的一般，而且作业很多，感觉也不是很有意义，最重要的一点！感觉老师出尔反尔太严重了，一开始说不用做思科，结果后来又要求做了，开始说测验作业不占成绩，最后竟然又说占了233，真心有点不爽……
75855,1981,钱抱清,2018-03-20 03:25:28,3,4,1,失望透顶
76629,1981,钱抱清,2018-04-16 15:20:57,-1,2,3,好好好
76670,1981,钱抱清,2018-04-18 02:54:54,-1,1,2,真的不想说了...\n\nc真的需要一个好老师入门\n\n真的打瞌睡啊...\n\n上课没有任何想听的欲望...\n\n不用强制上机好评\n\n其他的..\n\n自己看着办吧
80004,1981,钱抱清,2018-06-19 03:23:53,4,4,0,老师讲习题的时候可以把答案公布一下嘛？_(:з」∠)_
80104,1981,钱抱清,2018-06-20 03:36:23,1,2,1,讲的好快
80534,1981,钱抱清,2018-06-27 13:22:22,4,4,0,我觉得c程完全ok，上课也还挺好，预置的课运气可以的
82418,1981,钱抱清,2018-07-08 06:47:44,-2,1,3,最坑的就是说有小测，害得我次次都来上课。这学期的教室空调坏了，了解一下hhh。其他海星。
84528,1981,钱抱清,2018-07-13 05:30:26,3,3,0,出分好慢啊啊啊
84783,1981,钱抱清,2018-07-14 01:09:14,4,5,1,考完试整个人不太好，以为自己要挂科了，结果没有挂科，老师太仁慈了，呜呜。
84786,1981,钱抱清,2018-07-14 01:23:26,-1,2,3,感谢老师不挂之恩
84791,1981,钱抱清,2018-07-14 01:38:46,6,7,1,没有小测 而且老师期末很好会给复习资料 然后就是C程本来就是靠自己的嘛 老师人棒棒哦
84794,1981,钱抱清,2018-07-14 01:45:27,8,9,1,不点名，老师上课节奏有一点快，但是负责的，给分不错。(回楼上：老师本来就说可能会有小测，又没有说一定会小测)
84827,1981,钱抱清,2018-07-14 02:59:01,4,4,0,节奏有点快，但老师给分好好，比自己算的分调高了一档，平时布置的作业一定要好好完成，拼命完成。
84868,1981,钱抱清,2018-07-14 06:33:39,-1,0,1,敬业爱岗好老师，
84896,1981,钱抱清,2018-07-14 09:01:34,6,8,2,说好实验没过就挂科的，竟然还有没挂的
85075,1981,钱抱清,2018-07-15 08:38:05,-1,0,1,老师很好，很严肃但是讲的很不错
85086,1981,钱抱清,2018-07-15 09:25:57,-19,3,22,老师吐字不清，上课基本听不着啥\n\n主要是看PPT和课后练习\n\n课后练习很多，很有用\n\n满绩的我飘过
85124,1981,钱抱清,2018-07-15 14:11:28,-1,2,3,c程自学就好了，老师讲课水平一般，给分真的好，比自己预估高了真不少。
85685,1981,钱抱清,2018-07-25 14:52:38,3,3,0,给分真的好，比自己预估的高了一个档，好老师不解释。
85748,1981,钱抱清,2018-08-02 01:21:33,3,3,0,给分太好了，我哭了?，感恩老师
93284,1981,钱抱清,2019-01-08 23:20:30,-2,0,2,老师超好，c程作业多，但是对期末帮助巨大
93898,1981,钱抱清,2019-01-14 07:47:29,9,11,2,虽然老师比较直男 讲课不太好懂 但真的会为学生考虑 很有耐心 最后一堂课给我们说了三个忠告 受益匪浅
94254,1981,钱抱清,2019-01-27 16:36:58,8,10,2,上了他的大计。他讲硬件和操作系统部分很细致。上课很认真，早课会提前到。相比某些布置期末论文的老师而言他的作业真心不多，也没有点名。最后一节课的三个忠告也很暖心。事少人帅。
94413,1981,钱抱清,2019-01-16 10:53:20,4,5,1,很帅！！！
101582,1981,钱抱清,2019-01-28 13:39:28,0,1,1,感谢老师不挂之恩
101586,1981,钱抱清,2019-01-28 13:48:55,-1,0,1,事少人帅我太菜
101587,1981,钱抱清,2019-01-28 13:55:41,4,4,0,感谢老师，c程没挂，前来还愿
101589,1981,钱抱清,2019-01-28 14:07:12,-1,1,2,成绩刚出我就过来了，钱老师大爱啊！从来没想过给分能比我自己预估的高出一档，祝老师新年快乐
101592,1981,钱抱清,2019-01-28 14:11:06,0,1,1,不点名！可以很水 给分好 老师超温柔der
101598,1981,钱抱清,2019-01-28 14:39:36,8,8,0,我本来就是不及格的硬是把我托上及格了，大恩大德铭记于心\n\n
101604,1981,钱抱清,2019-01-28 14:49:12,-2,2,4,老师是真的认真在上课。“听懂没”“没”“那我再讲一遍”\n\n最后一节课还给我们讲建议。\n\n但大计基嘛，总是想睡的。这个也没办法。\n\n给分挺好，以为要挂了，4.5。
101608,1981,钱抱清,2019-01-28 14:56:36,0,1,1,老师给分很棒了！日常小作业比较多，但认真完成绩点不会差，一学期的课没睡过觉也算对得起分数，感谢老师！
101615,1981,钱抱清,2019-01-28 15:25:52,0,1,1,我只能说给分超级好，别看评分低
101639,1981,钱抱清,2019-01-28 16:03:19,3,3,0,最后考试崩了，眼看要不及格的时候钱老师捞一把真是感动。嗯，已经决定要好好学编程了，希望大家加油鸭！
102158,1981,钱抱清,2019-01-31 00:38:53,0,1,1,老师给分超级好
102313,1981,钱抱清,2019-02-01 01:33:32,-1,1,2,钱老师的大计基真的。。强推? ！\n\n和我舍友的大计基老师一对比，钱老师简直是神仙啊！作业少，实验少，不会莫名其妙突然改计科练习的DDL甚至还会往后拖！而且上课非常有条理，拓展的也很多。\n\n最后期末机考是我菜鸡啦? 但是3.9也很满意了呢?
102338,1981,钱抱清,2019-02-01 04:03:37,-1,0,1,感觉给分挺好的    而且作业要求也不严
102577,1981,钱抱清,2019-02-10 02:00:03,4,5,1,我自己选了老师的c程基础，上完感觉老师只有7.9实在有丶冤枉。\n\n    首先是口音问题，很明显老师有意识在改，不小心说了半句方言之后会用普通话(略标准一些)重新讲一遍。作为浙江人听起来基本没问题，唯一需要注意的是“Dits”=“地址”。对于北方同学来说可能需要克服如上例的平仄不分重音不当等问题。加油(ง •̀_•́)ง\n\n    特别强调：\n\n    老师人很好！！！超过时限没写完作业的话跟他讲他会再给你开放的！！！ \n\n    没有小测没有期中考！！！\n\n    习题课不点到，不去上也行！！！\n\n    \n\n    给分真的不错，我理论84/100实验24/30总评有90*罒▽罒*(按理说应当是理论50％实验25％平时25％我只有87左右)
102870,1981,钱抱清,2019-02-24 13:17:05,1,4,3,老师杭州话简直了\n\n口音简直无敌\n\n当时选课时想着口音不是什么大问题\n\n。。。。。。。。呵呵呵\n\n天天上课就全自学老师成了干扰源
102900,1981,钱抱清,2019-02-25 01:53:57,-1,0,1,期末考试成绩出来我感感动的热泪盈眶
104242,1981,钱抱清,2019-07-13 02:12:05,7,11,4,我觉得老师很好。作业量相比其他c程老师不知道轻了多少，不考的编程题一概不留，而且即使没做完也会一次一次给你开放。指针因为是重难点，甚至讲了三次课让同学们理解。而且上课也并不是很枯燥（但可能需要你对编程有点兴趣吧）。总之我觉得钱老师的c程确实挺好。（虽然我卡绩没满。。（7.13更新 下学期学数据结构基础的同学 记得假期自学一下递归和链表 尤其是链表一定要熟练会用
105057,1981,钱抱清,2019-04-03 03:18:17,-4,2,6,全程念ppt 速度还贼快 普通话真的不标准  还不如自学
105212,1981,钱抱清,2019-04-07 12:06:15,-28,1,29,我是ikun，考前刷蔡徐坤nmsl，看蔡徐坤打篮球，结果我满了
108943,1981,钱抱清,2019-06-04 13:35:55,3,3,0,比较宽松，作业都可以延期，重视动手编程，虽然上课比较无聊，但是老师真的很好！
109755,1981,钱抱清,2019-06-19 04:25:16,-6,0,6,回问题不及时 讲课就是念Ppt上书里的例题
110032,1981,钱抱清,2019-06-21 13:01:43,-1,0,1,666
110352,1981,钱抱清,2019-06-26 02:23:58,20,27,7,好老师，期末理论考34分(满分100)本来以为挂了，结果老师救我了我一把
110570,1981,钱抱清,2019-06-27 13:27:06,-3,1,4,不想上课
111192,1981,钱抱清,2019-07-06 18:46:37,1,4,3,我吹爆 C程这门课理论考堪称玄学 虽然复习了蛮久的但最后还是考的极差 钱老师简直是 大海捞针 我吹爆 给学弟学妹一个例子（似乎C程考试难度有浮动）我 48/100 14/30 最后3.0 吹爆钱老师 我爱他！
112096,1981,钱抱清,2019-07-03 13:36:27,1,4,3,诸暨话是真听不懂，上课只念ppt的题真是枯燥不过人是真的一般
112104,1981,钱抱清,2019-07-03 14:36:47,4,5,1,钱老师很注重学生课程的理解和知识的运用。我不懂请教他，他很有耐心的。人很朴实，是个真正做学问的老师。至于口音问题，我觉得还可以啊。
112390,1981,钱抱清,2019-07-06 22:33:51,0,2,2,谢谢老师海底捞我！
112751,1981,钱抱清,2019-07-05 02:07:18,0,2,2,谢谢老师捞我一把！！！
112845,1981,钱抱清,2019-07-05 05:44:00,1,3,2,好老师，比预估高了两档
113188,1981,钱抱清,2019-07-06 01:19:57,1,2,1,感谢老师海底捞我
113414,1981,钱抱清,2019-07-06 17:11:05,3,3,0,感谢老师大海捞针不挂之恩，来自学渣最真诚的感恩
113572,1981,钱抱清,2019-07-07 00:14:24,1,4,3,桃花潭水深千尺 不及恩师捞我情
113575,1981,钱抱清,2019-07-07 00:22:40,-1,1,2,谢谢老师海底捞
113597,1981,钱抱清,2019-07-07 01:10:16,1,3,2,浓浓师生情要叫人落泪了
113645,1981,钱抱清,2019-07-07 01:54:56,-1,2,3,谢谢老师！平时事不多，浓浓师生情！
113664,1981,钱抱清,2019-07-07 02:33:54,1,1,0,这学期我们班那场难到上天，理论没过线，我抱着必挂的心开始过暑假，结果出分后竟然让我过了，海底捞真的超感动，钱老师真的是好人！
114011,1981,钱抱清,2019-07-08 08:15:42,2,4,2,想水水过的选他，想学好编程的别选。
114599,1981,钱抱清,2019-07-10 23:46:32,-1,1,2,海底捞，老师是真的好
116463,1981,钱抱清,2019-09-11 00:43:11,6,6,0,明白了自学是什么意思
117388,1981,钱抱清,2019-09-24 00:17:15,4,5,1,我浙江人，老师确实有点口音，可是没有到听不懂的程度啊，不是很懂为什么那么多吐槽口音的
117646,1981,钱抱清,2019-09-27 12:40:23,2,3,1,上课超级水，作业超级多
117647,1981,钱抱清,2019-09-27 12:41:23,3,4,1,水中贵族
118612,1981,钱抱清,2019-10-29 11:25:07,3,3,0,我觉得还可，可能因为我是杭州人的缘故，没什么语言障碍，但感觉老师说的杭州话和我知道的不是一种
120907,1981,钱抱清,2020-01-18 14:57:09,0,2,2,老师人很好且事少！
122637,1981,钱抱清,2020-03-10 07:55:36,2,2,0,上网课网卡掉了，我们和他说了他仍不为所动自顾自讲，开学两周了钉钉群里就没说过几句话
123226,1981,钱抱清,2020-05-21 12:29:46,3,4,1,看底下评论说会海底捞，这的确是打高分的一种理由。但这学期的网课真的很不负责任。讲得不清楚，课后解答也很敷衍、非常非常不及时。
123578,1981,钱抱清,2020-06-10 08:13:11,3,3,0,老师人很好，也比较负责，不过少有口音，而且上课总感觉抓不住重点，程序设计专题上下来一头雾水，可能大多还是要靠自己。（ddl很好说话）
124534,1981,钱抱清,2020-07-02 11:51:27,5,6,1,这门课真的建议自学。上课睡觉老师也不管你（没有基础的慎重）。作业有点多，但考试、作业这些如果靠实力好好完成，成绩不会差。
126000,1981,钱抱清,2020-09-16 11:15:31,2,4,2,老师是会看查老师的评论的，我是19年春夏的课，老师在上课之初就告诉我们:“我普通话可能确实讲的不太好，但是我会尽力讲的让大家能听懂，要是实在是听不懂我的口音，可以退课换一个老师。”，后续上课其实我也没感觉口音有多重，起码我这个北方人是能听懂的，老师人是蛮不错的。
126183,1981,钱抱清,2020-09-18 12:54:36,3,4,1,别的老师班里比我理论低的人，都没有挂，我可太难了
126220,1981,钱抱清,2020-09-20 04:12:20,4,4,0,c大程，可能课程设计就是自己学，老师也确实没讲明白什么。给分不知道。同一场考试期末理论57的3.9，73的4.8。我68的3.6。我好难
126243,1981,钱抱清,2020-09-20 15:57:39,1,2,1,老师讲得不错 考试会根据难度调分 不用太担心
129478,1981,钱抱清,2021-01-06 04:29:14,0,1,1,钱老师讲的挺好的 很仔细
130252,1981,钱抱清,2021-01-20 07:43:36,-1,0,1,希望老师捞我ballball了
131449,1981,钱抱清,2021-01-27 14:06:20,4,5,1,老师普通话明明可以的嘛！！何必说自己普通话不好嘛（老师从来不点名，还是个刀子嘴豆腐心，作业会帮还没有完成的同学延期～人真的很好了，学在浙大上给的ppt又完整详尽又可以下载，期末复习太好不过啦）最后求一个大计基高分～～
132298,1981,钱抱清,2021-01-31 15:13:42,1,2,1,感谢老师捞捞\n\n虽然不知道老师长的什么样子\n\n但感谢QwQ
132500,1981,钱抱清,2021-02-02 03:52:55,4,4,0,老师讲的还不错，重难点的地方会多次重复一下，为了让我们理解的更透彻，经常问同学们这个程序用不用调试一下。\n\n老师不点名，上机课可以不去，而且没有小测，不过pta一定要好好做。\n\n最后，多谢多谢老师捞我
132626,1981,钱抱清,2021-02-03 02:55:05,0,3,3,给分不错，没卡我绩，虽然课从来没听过
134598,1981,钱抱清,2021-04-04 06:13:07,-1,3,4,老师作业好多呜呜呜呜
138571,1981,钱抱清,2021-07-14 02:37:57,5,8,3,安利下老师的C大程，比其他班开始得早，结束得也早，时间很充足，也不用期末肝大程。而且可能开始得早还有同学们都很好，感觉和别的班比，大作业不是很卷，本菜鸡也拿了互评高分。最后给分很好！开始是五级制给分，但同学们反应后马上改了
138684,1981,钱抱清,2021-07-10 10:39:57,6,8,2,老师真的好好啊！理论考没过斩杀线硬是给我捞到70，真的是个好老师，上课也很负责认真。
138685,1981,钱抱清,2021-07-10 10:49:49,6,8,2,钱老师宛如再生父母，没过斩杀线还能直接被捞到上三，钱老师yyds！
138686,1981,钱抱清,2021-07-10 10:50:57,8,9,1,吹爆钱老师，从前还以为这样的老师只能存在于想象之中，直到遇到了钱老师，才知道原来世界上真的有天使一样的老师！！10分！！必须的！
138687,1981,钱抱清,2021-07-10 10:54:40,4,5,1,爱死你了老师！！！
138688,1981,钱抱清,2021-07-10 11:05:10,9,11,2,老师上机课，理论课都不点名！期末超级能捞！直接起飞！谁上谁知道。大爱抱清老师。而且之前有些评论说的口音问题完全没有！老师讲课也很负责，很容易听懂。平时作业也不多，比起我朋友上的那个班作业真的少很多了！超级超级棒，强推！
138689,1981,钱抱清,2021-07-10 11:07:41,4,5,1,钱老师也太好了吧！课讲的很清晰给分也超级超级超级好！
138694,1981,钱抱清,2021-07-10 11:16:11,5,6,1,qbq老师yyds，最后的成绩真的让我感觉我不配这个分数，真的很好很捞人的老师，平时理论课和上机课也都不点名，但是教的也很好，会耐心的讲解很多习题，真的让人能够既收获知识又收获绩点
138695,1981,钱抱清,2021-07-10 11:22:20,4,5,1,老师我真的有这么高的分数嘛😂\n\n这也太会捞人了吧😘
138696,1981,钱抱清,2021-07-10 11:26:19,4,5,1,qbq yyds 我爱老师，期末捞了一把，理论59分，直接3.9，呜呜呜老师太好了。上课讲得也很用心，都有PPT，课下可以自己看，虽然看上去有点严肃，但是真的很不错。助教哥哥也很nice，每节上机课都在，不懂的上课问，也可以钉钉上问。
138697,1981,钱抱清,2021-07-10 11:39:31,5,5,0,上课不点名，PTA开放时间至少有两个礼拜，完全来得及做。讲课很认真，助教老师人也非常好。期末给分也很好。
138698,1981,钱抱清,2021-07-10 11:49:20,2,3,1,不点名，理论课上机课都没去过几次。\n\n最后捞人捞了好多！钱老师yyds
138699,1981,钱抱清,2021-07-10 11:52:33,1,2,1,超温柔超级捞
138719,1981,钱抱清,2021-07-10 13:14:56,2,3,1,理论64，总评89，qbq，我的超人
138730,1981,钱抱清,2021-07-10 14:50:17,2,3,1,超级捞啊，捞海底的神仙，永远记得老师的大恩大德😊 😊 😊
138777,1981,钱抱清,2021-07-10 23:32:51,-1,1,2,不给十分天理难容
138786,1981,钱抱清,2021-07-11 00:35:07,4,4,0,给分巨好！！！！
138802,1981,钱抱清,2021-07-11 02:32:57,-16,4,20,理论79结果直接满绩，我愿称之为c小程的神!平时事情少，没期中考，只需要做pta上的题
138822,1981,钱抱清,2021-07-11 04:55:06,6,7,1,海底捞黑海会员
139611,1981,钱抱清,2021-07-18 10:38:19,-1,1,2,还不错吧
140497,1981,钱抱清,2021-09-13 05:29:28,3,4,1,给分好，破事少
140788,1981,钱抱清,2021-09-16 05:18:17,-1,1,2,好啊，好
141048,1981,钱抱清,2021-09-22 07:06:06,8,8,0,给老师先打个满分，求求下次走到投影前面的时候，把麦拿上吧。。。。口音不是问题，问题是别抑扬顿挫，别忘带麦。。。
142286,1981,钱抱清,2021-11-10 01:04:41,6,6,0,我是21届的，期中之前点了三次名…为什么所有人都说不点名？
142287,1981,钱抱清,2021-11-10 01:10:08,6,7,1,点名给我点麻了
142935,1981,钱抱清,2021-11-17 13:43:44,9,9,0,c程上了半个学期 先占个坑 现在会点名了
142940,1981,钱抱清,2021-11-17 14:54:18,8,8,0,为啥突然开始点名了，开学的时候评分标准也没说有点名
146825,1981,钱抱清,2022-01-07 14:00:08,-1,1,2,方言没有，作业不算多。上课（有点）无聊。
147048,1981,钱抱清,2022-01-08 13:58:03,4,4,0,不建议没有C或C++语言基础的选他的课
147631,1981,钱抱清,2022-01-10 10:37:19,0,3,3,哈哈，查
147760,1981,钱抱清,2022-01-10 17:31:38,1,1,0,上课等于催眠曲
148798,1981,钱抱清,2022-01-14 15:02:24,18,25,7,c小程出分了，绩点2.7（73），比我想象的低好多，客观地说，钱老师一点也没捞，算起来我平时分还扣了5分，但是作业基本都交了啊，emo......现在c小程是我绩点最低的一门课了，吐血......吃一堑，长一智，在此立flag：本菜鸡要绝地反击，证明看！
149152,1981,钱抱清,2022-01-15 08:05:54,28,38,10,怎么感觉给分没有评论说的这么好，期末理论78，实验满分，只有3.9，平时分还被扣了4分，均绩直接下降0.07，吐血。
149167,1981,钱抱清,2022-01-14 15:15:42,16,18,2,如果给分好也就算了 但偏偏给分也差 凭什么扣我四五分的平时分啊？我什么没做到位？
149177,1981,钱抱清,2022-01-14 16:25:10,15,17,2,平心而论，老师上课知识点讲的很详细，平时作业也很多（相比其他老师），认真学确实能学到一些东西。但是说一件事吧，就是老师操作错误，同时布置了重复的几个题目集。有人在钉钉群里问老师要不要做重复布置的作业（问了好几次），老师没有回复。结果他在题目集截止后说重复的题目也要算到平时分里。找老师问分数成绩之类的，老师都是已读不回。而且最后老师也不怎么捞的，平时分扣了挺多的（我每节课都到，作业除了那个重复的，其他也都做了，而且得分也挺高的，有一次小测我还是全班前几名，但最后平时分还是扣了挺多的）。如果想学知识的同学可以选，但是想拿高分相比其他老师会难一些。意见仅供参考，可能会与真实情况有一些出入。再补充一句，这个学期的助教lyz gg很好，问他问题几乎都能很快给出解答，而且很有耐心，教到你会为止。
149180,1981,钱抱清,2022-01-15 07:34:03,-4,15,19,期末理论81编程满分总评81绩点3.6，qbq，这个给分是不是离大谱了已经？
149188,1981,钱抱清,2022-01-14 16:23:47,11,13,2,老师还行，就是平时分好像要注意，作业可能要看重分数，因为平时分不会拉满。
149205,1981,钱抱清,2022-01-16 13:16:22,33,38,5,给分是真的差，吐血\n\n感觉这老师和之前评论里说的就不是同一个人
149265,1981,钱抱清,2022-01-15 02:07:13,14,19,5,89+100总评87。\n\n我不理解。
149267,1981,钱抱清,2022-01-15 02:48:05,12,14,2,c小程讲课按部就班，基本能讲清楚，但建议有c语言基础的选择qbq老师。期中后老师学会了点名和课堂小测，需要引起注意。给分方面:平时分不会放水，作业分数也很重要;开学时会问有竞赛基础的是否免听，建议想要冲满分的不要免听，否则期末考试理论成绩占比会上升10%以上。\n\n课后问问题基本不及时回答，钉钉邮件线上不要想能及时找到他。评分标准模糊，变化了多次，给完分了也不知道咋给的。\n\n(注:最后总评成绩比例：理论50%，实验25%，平时25%，其中平时包含PTA作业，课堂，期中，等等，\n\n 平时成绩25：PTA上机84%+测试10%+点名6%)
149273,1981,钱抱清,2022-01-15 03:01:10,14,14,0,不说清楚细则，朝令夕改，建议大家认真对待各种平时任务，老师说不用也尽量做，尽量别申请免听，血的教训
149310,1981,钱抱清,2022-01-15 04:51:42,29,31,2,各位注意，这位老师开始点名且不捞人了，还有个别同学很冲动，来日方长啊
149401,1981,钱抱清,2022-01-15 08:42:37,10,11,1,按照之前一个老哥发的评分标准 我平时分被扣了6分 理论67 实验满分 最后总评82 绩点3.6（被卡了难受）\n\n确实理论没考好，也确实配不上高绩点了  但看了之前评论有理论60多被捞到4.5的 最后出分难免有落差\n\n总而言之，今年捞的幅度小了很多，之后选的人平时作业认真做，考试也好好准备下吧
151110,1981,钱抱清,2022-02-23 06:03:44,0,0,0,说的是普通话，但我就想睡觉
151242,1981,钱抱清,2022-02-25 07:38:08,1,1,0,可能讲话稍稍有点口音，确实催眠。\n\n但是老师还是很和蔼的，给分好像确实没有传说中那么好了。
151763,1981,钱抱清,2022-03-15 03:21:30,4,4,0,他的讲话方式，气声好重，听课太累了，听不懂在讲什么
154936,1981,钱抱清,2022-06-07 03:31:44,6,6,0,给分巨差，无语子
157065,1981,钱抱清,2022-06-21 22:45:21,3,3,0,讲课有些沉闷枯燥，不过上课思路还是比较清晰的。发信息日常已读不回，最后老师不会捞人，一点点都不会，慎选
157448,1981,钱抱清,2022-06-24 09:39:46,4,4,0,日常羡慕选上白洪欢的室友
158641,1981,钱抱清,2022-07-01 14:29:05,4,4,0,c小 点过两次名，小测题难度很大（不知道题目是否每个班统一），作业量大。\n\n这个学期老师还是没捞，跟前几年的评论里说的不一样
158663,1981,钱抱清,2022-07-01 06:10:48,1,1,0,课上的不错\n\n小测很难\n\n给分真的差
160145,1981,钱抱清,2022-09-14 01:35:45,4,4,0,不知道说的什么鸟语，听的想睡觉。。。。。。。。。
162166,1981,钱抱清,2022-11-17 08:08:11,9,9,0,对于小白超级不友好，寄中寄，挂了吧
164258,1981,钱抱清,2022-12-20 04:45:26,10,11,1,小测题目量不是给人做的 而且一学期下来加上期中得五次了 线上测试时间还那么阴间 问有课冲突了能不能换回复是看回放 离谱到家了属于是
166113,1981,钱抱清,2023-01-11 07:01:10,7,8,1,很一般，讲课有口音，基本上是自顾自的讲，不过上课认真听，作业认真做还是能学到些东西的。
166149,1981,钱抱清,2023-01-13 10:01:49,14,15,1,讲课中规中矩，口音有（本人基本没受影响），但考试是真阴间，期末也不告诉一下考试范围，改评分标准甚至是考试后才公布的，而且期末上机考要求变高了导致挂科的人好像变多了（当然这可能是因为在家线上的原因），但老师确实缺少了事先的提醒，而且绩杀毫不犹豫，怕是一点没捞  ˃ ˄ ˂̥̥
166150,1981,钱抱清,2023-01-11 07:43:45,14,15,1,一点不捞 牢底坐穿
166154,1981,钱抱清,2023-01-11 08:04:37,13,14,1,老师的口音还能接受，但是上课感觉好沉闷，一点气氛都没有。中间几次小测题量巨大，感觉对没啥基础的同学来说难度太大了。最后，他是一点不捞人啊，给分稀烂，建议跑路。
166163,1981,钱抱清,2023-01-11 08:37:55,11,12,1,完全不捞，给分稀碎，评分标准考后再发，平时事还多
166206,1981,钱抱清,2023-01-11 12:00:07,7,8,1,平时作业贼多，讲课有口音根本听不懂。考试不捞，评分标准考完期末才发。对小白极其不友好
166207,1981,钱抱清,2023-01-11 12:01:24,7,8,1,给分稀烂，作业贼多，小测真难
166212,1981,钱抱清,2023-01-11 12:21:59,9,10,1,老师讲课很认真但是很枯燥，口音重但是能听懂；\n\n上课会点名，进度很均匀；\n\n小测题量大；\n\n我们这次的期末考了很多结构后面的内容，导致我理论稀烂；\n\n看来没有调分。\n\n毕竟c程，还是自学为主吧！\n\n\n\n对钱老师印象最深的还是早八上课之前，坐在讲台后面高高的椅子上时的两个姿势：1、双手扶额，手指夹着眼镜；2、把穿着皮鞋的脚搭在另一个凳子上刷短视频。不过上课的时候还是走来走去，沉浸地比划着ppt，在黑板上写写画画...
166225,1981,钱抱清,2023-01-11 12:57:16,9,10,1,c小根本不会捞人，只有卡绩的痛苦。虽然没有期中考但有四次小测有时甚至放到九点半开始吐了
166317,1981,钱抱清,2023-01-12 02:27:13,8,10,2,真的就是快退休了就开始摆烂，而且真的绩杀，行政班上3.3以上都找不到，还是所有老师里面小测最多的
168759,1981,钱抱清,2023-02-22 00:13:22,7,7,0,击杀悲
169575,1981,钱抱清,2023-02-27 03:50:41,-11,1,12,好捞好捞
169577,1981,钱抱清,2023-02-27 03:56:25,6,7,1,sb老师，全班没几个3.6以上的
170044,1981,钱抱清,2023-03-01 06:10:11,5,6,1,快跑！！！！
170067,1981,钱抱清,2023-03-01 08:01:25,7,8,1,1分好评
170130,1981,钱抱清,2023-03-01 12:44:08,6,7,1,sb老师
171288,1981,钱抱清,2023-03-21 02:22:51,4,6,2,傻呗一个
171294,1981,钱抱清,2023-03-21 04:02:33,-5,3,8,！(讲课生动活泼，给分巨好无比）
172955,1981,钱抱清,2023-05-10 10:50:02,1,2,1,快跑！！！！！！！！！！！！！！！！！！！！！！
172956,1981,钱抱清,2023-05-10 10:50:11,1,2,1,千万别选
173204,1981,钱抱清,2023-06-26 08:31:19,5,5,0,小测全班60多个人13人及格，66666
173237,1981,钱抱清,2023-05-16 11:35:29,3,3,0,第一次在学期开始的时候我给了6分，第二次在期中的时候我给了四分，现在我给他一分并不是因为他值得一分，而是因为最低只有一分
173388,1981,钱抱清,2023-05-22 16:21:57,0,2,2,绩点1.5!好捞好捞！
173861,1981,钱抱清,2023-06-04 00:31:30,2,3,1,这老师给分稀烂，和之前说的完全不一样。可能是性格变了，速润。
177213,1981,钱抱清,2023-07-02 08:30:39,1,1,0,老师已经退休了，什么恶心的小测也没必要再说了，感谢老师没有让我挂科😭😭😭
177355,1981,钱抱清,2023-07-03 04:01:49,1,1,0,老师再见！
177896,1981,钱抱清,2023-07-05 09:35:40,1,1,0,有缘再见
178016,1981,钱抱清,2023-07-06 07:55:21,3,3,0,老师退休快乐！\n\n平时小测较难：第一次小测较为简单；有一次小测实验30分只拿8分，理论100分只能拿60出头；\n\n一开始作业量较大，后面感觉还好；\n\n好在自己努力，期末实验30，理论93，给老师捞到满！\n\n我想平时的难也是一种督促？C主要还是靠自己用心去学！\n\n再次祝老师退休快乐！
181096,1981,钱抱清,2023-10-08 09:53:31,0,1,1,宝藏老师
186217,1981,钱抱清,2024-01-09 13:29:43,0,0,0,老师人很好，有幸成为钱老师最后一届学生。六七十人的班级每次课基本只来十几个同学但老师仍然没点过几次名，实验课不签到。平时小测可能稍微难了一些，主要是题目有些坑第一次遇到感觉必跳，然后作业有些地方上课都没讲到过，没啥基础做起来有些费劲。但老师人真的很好，最后应该还是捞了吧，我卡上了一档。祝老师退休快乐！！！
52256,1989,蔡铭,2017-06-16 12:31:15,-13,1,14,事不少
52257,1989,蔡铭,2017-06-16 12:32:34,-8,2,10,也就那样吧
60082,1989,蔡铭,2017-10-10 02:19:31,4,8,4,教室很小，没有空调，好想睡觉
65623,1989,蔡铭,2018-01-07 13:57:42,20,26,6,蔡老师人非常nice。qq上答疑回复超级认真。实验要求也很正常，几个助教也不错。带研究生课程的老师就是不一样～ 唯一一个有待改进的就是课堂节奏太快了没预习可能跟不上。（数逻）
69891,1989,蔡铭,2018-01-25 15:27:54,1,1,0,好老师~
69906,1989,蔡铭,2018-01-25 15:46:03,6,9,3,我就是要吹爆蔡铭老师！！\n\n虽然不知道为啥评分总是0，我手动10分！
69916,1989,蔡铭,2018-01-25 16:03:12,3,4,1,老师人很好很负责，有quiz，但是给分超好啊！
70559,1989,蔡铭,2018-01-27 08:11:09,4,4,0,老师很负责任，上课不错
70873,1989,蔡铭,2018-01-27 16:05:39,3,3,0,老师认真负责，给分很友善
79747,1989,蔡铭,2018-06-13 08:17:53,-1,1,2,不同意补选
80344,1989,蔡铭,2018-06-25 10:45:44,4,5,1,当时数字逻辑设计教室里面没有空调，冬天贼冷夏天贼热，但是蔡爸爸就一直很好地给我们讲课。讲得不能再清楚！真的，超级好的老师。本来很担心学不好，结果上课都听得懂。而且作业小测安排都很棒，不会说特别难什么的。定期的小测帮期末减了好多负担！
85958,1989,蔡铭,2018-08-26 04:23:33,9,10,1,严谨认真，超赞！
86664,1989,蔡铭,2018-09-18 01:54:42,2,2,0,很好的老师
96554,1989,蔡铭,2019-01-21 06:22:06,0,0,0,讲的很详细，给分也很好，答疑很好，老师学识很渊博，很爱这个老师。
96560,1989,蔡铭,2019-01-21 06:30:52,3,5,2,cm和ta怎么可以这么棒！！！\n\n根本想不到只是将大作业勉强完成的我可以满\n\n跟助教提了提只有我们和sqs班的大程是单人做的之后助教答应给我们的大程提分\n\n哇哇哇\n\n太感谢cm和ta了，吹爆
96581,1989,蔡铭,2019-01-21 06:53:52,4,4,0,人美心善，讲课清楚，我真是不明白为啥不上9??\n\n给分巨好
96601,1989,蔡铭,2019-01-21 07:28:14,13,14,1,出乎意料的高分，本来还在后悔小测没有认真对待怕是要扣不少分，结果发现影响不大。小测怎么说呢，主要还是用来监督自己不要把复习全部堆到期末吧，平时作业也要抽空完成，不然期末都是要还的。实验课是助教上的，但是老师几乎每节课都会去。助教真的人超级好，做实验碰到问题都能耐心解答。
96614,1989,蔡铭,2019-01-21 07:50:52,0,1,1,超级喜欢的老师哈哈哈
96624,1989,蔡铭,2019-01-21 08:08:20,1,1,0,数逻老师里决对是良心老师了~讲课略微有点快但是你可以下课问问题呀~实验课助教也很好~会重新修改统一的PPT让你更好懂一些反正选起来没错的！
97470,1989,蔡铭,2019-01-22 09:12:58,1,3,2,非常好的老师 qq上答疑非常详细 第一门满绩的专业课 感动
102520,1989,蔡铭,2019-02-04 07:21:09,0,0,0,cool
103131,1989,蔡铭,2019-02-26 06:10:31,0,0,0,爆！炸！好！\n\n书也教的好，给分也好
103321,1989,蔡铭,2019-02-27 09:53:58,2,2,0,听他的课是一种享受，一种平易近人的享受
104816,1989,蔡铭,2019-03-28 08:48:31,1,1,0,真的很好
109522,1989,蔡铭,2019-06-16 09:49:06,4,4,0,天下无双
116213,1989,蔡铭,2019-09-06 09:16:35,1,1,0,会讲很多前沿的知识，不仅仅局限于课本，很好
117416,1989,蔡铭,2019-09-24 05:03:25,0,0,0,老师超级认真负责 讲课贼清楚
120884,1989,蔡铭,2020-01-18 07:31:03,1,1,0,老师超级棒 非常负责 各种问题都会回答整理 小测也会提前通知 助教也非常热心 给分巨好
121116,1989,蔡铭,2020-01-19 16:05:00,7,7,0,超级负责认真! 所有的课程资料 作业解析都超专心准备 校对过 还会科普课外知识 甚至给学生准备专业英文单词的翻译 给分无敌好 不用交作业不用交作业不用交作业 课后可以闲聊 得老师如此 无憾咯
122034,1989,蔡铭,2020-02-02 11:41:56,3,3,0,干 这老师真的很好，但是我竟然没有苟到均绩，惭愧无比
127917,1989,蔡铭,2020-11-30 08:01:59,7,7,0,两个助教太帅了吧555555
130528,1989,蔡铭,2021-01-23 12:29:30,9,9,0,上的是蔡老师在20-21秋冬开设的《汇编与接口》课程。老师讲的真的很清晰很透彻很仔细，课程内容比较枯燥难懂但是听蔡老师的课却很舒服。课堂上与课后（线上、线下）都可以随时提出问题，老师的解答也都非常的耐心清楚，甚至能不厌其烦重新给你讲一遍（我太菜了）。最后答疑课看到老师的备课文件夹，非常震惊，各种书籍、资料、笔记……蔡老师是我到现在（大三上）遇到的讲课最好的老师了，应该也会是整个本科阶段讲课最好的了，所以如果大家有机会一定要听一听蔡老师讲课。出分很快，一两天（可能因为只有三十多个人修这门课，只有一个教学班）；给分特别好，真的是绝世神仙老师啊。
131030,1989,蔡铭,2021-01-25 15:29:37,5,5,0,蔡老师是俺的神！呜呜，拜谢蔡老师！平时上课和答疑都很负责认真，强烈推荐大家选他的数逻！
131040,1989,蔡铭,2021-01-25 16:04:36,4,4,0,蔡老师在群里答疑超级认真，还会准备各种资料，最后给分也非常非常良心！！
131436,1989,蔡铭,2021-01-27 13:24:08,5,5,0,男神，不解释
132428,1989,蔡铭,2021-02-01 13:17:59,3,3,0,小测都会提前通知
133368,1989,蔡铭,2021-02-26 11:07:15,5,5,0,超爱小蔡老师！啊啊啊每周快乐源泉
147534,1989,蔡铭,2022-01-10 07:28:33,-16,2,18,讲课挺好，给分貌似不行
148998,1989,蔡铭,2022-01-14 06:17:01,17,17,0,蔡老师讲课清晰，实验课专门找了三个助教帮我们，我听说好多老师都是没有助教的，而且最后给分也很好，别看你平时实验分没有很高，结果肯定不会差的，无论是学知识还是想要高绩点的都强烈推荐
149000,1989,蔡铭,2022-01-14 06:17:45,9,9,0,蔡老师真的非常负责，可以感觉到他对待每一个同学都是在用心付出，为人谦和，平易近人；同时，他是本科生院所有老师中，少数可以把一门比较难的课程教的清晰并且仔细的一位老师，是少有的你仅通过听课和做作业就能学懂本门课程的老师之一！所以学弟学妹请拼尽全力去选这位老师吧！
149005,1989,蔡铭,2022-01-14 06:24:35,2,2,0,讲课很仔细认真，真的能学到很多东西，必须10分。
149020,1989,蔡铭,2022-01-14 07:07:29,2,2,0,必须十分！蔡老师yyds
149047,1989,蔡铭,2022-01-14 08:08:41,4,4,0,蔡铭老师讲课非常认真\n\n\n\n平时温文尔雅很有气度，看起来很年轻\n\n\n\n实验课带着三个助教来答疑验收，有问题无论的私戳还是在群里问都很详细的解答\n\n\n\n小测不难会提前通知\n\n\n\n数逻大程单人做\n\n\n\n给分好，我平时小测都是及格线水平最后也拿到了4.8
149062,1989,蔡铭,2022-01-14 09:25:28,3,3,0,成绩公布了来给老师打十分，老师真的太好了，认真负责和蔼可亲，不仅会帮助你学习到很多知识，给分也真的超级好。能遇到蔡老师真的是一种幸运！
149139,1989,蔡铭,2022-01-14 13:51:35,2,2,0,认真负责，非常敬业的老师，为人谦和，上过蔡老师的数逻和汇编与接口，讲得都很清晰，给分也好。\n\n5学分的汇编与接口可以作为嵌入式入门课程，课程设计上会给大家补充一些实用的现代汇编技术，比如使用intrinsic优化代码性能，编译器自动向量化知识，以及一些跨学科内容，比如步进电机驱动，来拓宽视野，平时分只有两个探索实验，无作业、无小测、不点名，考试虽然占70%但都很基础且时间充裕，很容易拿高分（平时摆烂期末复习两小时拿了4.5），学弟学妹们放心选。不过选的人还是很少，可能是很多同学对硬件不太感兴趣的原因。
163558,1989,蔡铭,2022-12-15 06:28:53,5,5,0,疫情导致大程没了\n\n课后作业不需要提交，不占分，自己对答案\n\n老师人一看就很有气度，同时还找了三个助教协助平时的实验\n\n没发现什么可以挑剔的点
166885,1989,蔡铭,2023-01-14 06:14:37,5,5,0,老师好温柔😭
166922,1989,蔡铭,2023-01-14 08:39:06,1,1,0,被老师捞上3了呜呜呜，谢谢老师！
167178,1989,蔡铭,2023-01-15 04:52:23,4,4,0,分高事少老师好，有不懂的问题老师会认真解答，很会照顾学生的感受，目前见过的最好的老师之一，10分
167691,1989,蔡铭,2023-01-18 10:22:39,3,4,1,四次小测一定要去。\n\n讲得深入而细致，太巨了！
168545,1989,蔡铭,2023-02-19 09:25:51,4,4,0,男神！
169143,1989,蔡铭,2023-02-24 12:19:45,3,3,0,很好的老师\n\n讲课清晰 认真负责 实验验收很照顾大家 基本都给满了\n\n快冲！
170498,1989,蔡铭,2023-03-06 03:05:34,1,3,2,上的汇编与接口\n\n老师人很好，讲课很仔细且课后答疑也不错，对于我这个汇编小白来说收获很大。\n\n\n\n不过这门课本身的内容很难，平时分两次实验为了有区分度，对探究主题深度有要求，没有卷过其他人可能拿不到90%；期末今年开卷考但PPT有上千页，自己和熟人最后感觉考试几乎都翻到了实际却意外失分很多，可能和军理一样有翻多处的设问。不过往年闭卷似乎没这么难\n\n\n\n总结：课程对于本科阶段想涉猎汇编的同学还是很不错的，最后分数和自己的水平比肯定高，但如果想保近满的绩点，又没有一定基础（计概、小白的汇编）还是慎重。
171446,1989,蔡铭,2023-03-24 11:53:33,3,4,1,请无脑选蔡老师，这样讲课又好，超级负责，给分也好，对学生也超好的老师在哪里还能找到
184670,1989,蔡铭,2023-12-22 06:26:19,1,2,1,蔡爹yyds，温文尔雅而条理清晰，无疑是硬件三连最佳引路人！\n\n选到蔡爹就是赚到!
187814,1989,蔡铭,2024-01-17 13:52:06,0,1,1,蔡爹你是我的神！\n\n刚刚出分 来评价一下\n\n老师的教学水平真的很高 数逻上课认真听就能基本掌握\n\n接下来就是靠自己课后好好做题做实验了\n\n最后 老师的给分真的非常非常的好 非常推荐大家选！
187920,1989,蔡铭,2024-01-17 22:20:54,1,1,0,讲课好，给分好，助教好
188139,1989,蔡铭,2024-01-18 09:16:55,1,2,1,蔡爹，无需解释，yyds
188563,1989,蔡铭,2024-01-19 09:24:31,0,0,0,叫他蔡爹不是没有原因的
188580,1989,蔡铭,2024-01-19 09:57:33,1,1,0,最帅最好最认真的老师，人美心善智商高，教学水平堪称顶流，最重要的是给分巨好无比
188701,1989,蔡铭,2024-01-19 15:20:10,3,3,0,小测今年调分力度很小，其实给分还是蛮求是的，发言夸老师的基本都是平时分数就很高的同学，选他注意准备好小测
189256,1989,蔡铭,2024-01-22 15:40:45,0,1,1,汇编与接口\n\n给分不错，平时实验要好好做，尽量拿满。期末如果蔡爹还给选择机会的话一定要选开卷，今年闭卷考而且考的比较难，好像挺多人最后成绩都不太理想。复习的话主要针对给的重点吧，接口部分弄懂即可，几乎不需要背什么，今年卷子上该给的全给了，好多东西感觉都白背了。反而是汇编部分，有的考的确实比较细，老师说是上课认真听的应该都知道，个人认为确实听过会有点印象，因此这门课平时听课还是很重要的。
189581,1989,蔡铭,2024-01-25 12:53:36,6,6,0,老师讲课很好 人更好。我承认学的有问题 但是为什么最后接口的填空全是选地址啊……人傻了 一个小知识点没有注意就直接期末二十分没了 只能说这一科目出分后学期均绩掉0.6…… 记得选开卷
192745,1989,蔡铭,2024-05-30 03:59:18,0,0,0,很不错
192874,1989,蔡铭,2024-05-31 07:18:30,0,0,0,老师真好
193853,1989,蔡铭,2024-06-20 08:31:08,0,0,0,救我命了
194908,1989,蔡铭,2024-06-26 02:01:11,3,3,0,学的数逻\n\n非常好的老师\n\n考前的那晚9点还在给学生线上答疑的老师恐怕并不多见\n\n考前还给我们整复习资料（最后一次复习课一定要去，你懂的）\n\n\n\n平时的小测很简单（当然后果就是平时复习没那么认真，期末补天 笑哭.jpg）\n\n\n\n蔡老师讲课水平很好，PPT也是在不断修改\n\n感觉数逻学的不好只会怪自己不努力，绝不可能怪蔡老师\n\n\n\n还没出分，不过听说给分很不错
195840,1989,蔡铭,2024-06-30 08:27:57,2,2,0,数逻不能失去蔡爹，就像西方不能失去耶路撒冷。\n\n讲得清楚，给分超好，期末海底捞！\n\n呜呜呜蔡老师我好爱你呜呜呜
196290,1989,蔡铭,2024-07-03 00:06:55,0,0,0,我菜，老师好
205513,1989,蔡铭,2024-12-08 11:14:05,0,0,0,cm老师真的超级好，讲课清楚，我同学yyc老师班的超级羡慕\n\n期末考前的复习课一定要去，老师会讲重点！！\n\n给分也真的捞，一个数逻实验磕磕碰碰的菜鸟，最后也被捞了
213992,1989,蔡铭,2025-01-22 14:05:23,0,0,0,汇编与接口讲得很仔细，非常清楚，老师本人很和蔼，愿意和学生仔细讨论问题。
216905,1989,蔡铭,2025-03-28 15:48:45,-1,0,1,！!!
217802,1989,蔡铭,2025-04-16 14:51:39,1,1,0,老师答疑特别仔细，小测有意外情况的也可以通融让你补上，一点也不死板。助教们也贼好！！（就是麻瓜学数逻真的有点艰难，软件和电路都不知道在干啥🤨）男神！！
221474,1989,蔡铭,2025-06-24 03:41:16,2,2,0,老师上课认真，非常关心学生
221485,1989,蔡铭,2025-06-24 04:33:38,2,2,0,师强我弱\n\n今年分数普遍比往年稍低一些，不知道是不是因为期末卷比较难
221666,1989,蔡铭,2025-06-25 07:09:21,-1,0,1,神中神
15917,1992,汤永川,2016-01-16 15:14:45,1,3,2,很认真，可是老师比较偏执，可以多多讲一些应用方面的事
40290,1992,汤永川,2017-01-01 10:32:44,-4,2,6,垃圾老师垃圾助教\n\n
91078,1992,汤永川,2018-11-29 15:23:03,6,7,1,老师是好老师，就是商业数据分析这门课难度比较高，对数学和编程能力有要求
102635,1992,汤永川,2019-02-15 16:10:41,1,2,1,挺难的
107595,1992,汤永川,2019-05-07 10:04:10,0,0,0,老师人很聪明，就是讲课技巧有点欠缺，而且真的不通融。。
108070,1992,汤永川,2019-05-14 03:29:51,0,0,0,呵呵呵呵
152507,1992,汤永川,2022-04-13 14:28:53,0,1,1,讲课内容确实比较艰深（能看出老师的研究水准和学术热情），对缺少基础的人不太友好。但想学可以学，想水甚至可以水，老师还是很包容的。是开放的、有在与学生真诚交流的老师。思维方式也很值得学习。是好老师
162075,1992,汤永川,2022-11-16 12:45:43,-1,1,2,很有条理的老师，开学就把所有作业和参考资料放在学在浙大上。每节课开头一定会向同学问上节课的知识（问得比较基础），每节课一定会点名，作业迟交了基本就没分了。这门课理解难度是比较大的，但是作业没那么难，每节课后一个小作业加最后大作业，直接参考老师给的代码就行，作业都交了就能得高分。
202543,1992,汤永川,2024-11-13 04:52:46,0,0,0,老师很好，感觉很有学问。就是商业大数据分析这门课讲得有点云里雾里的，用的数据集也大多跟商业数据搭不上边，总体来说就是介绍了几个机器学习的模型，建议老师以后可以多讲一些应用层面的技能。
116,2014,陈越,2015-03-14 15:58:34,-14,8,22,陈越姥姥
126,2014,陈越,2015-03-14 16:02:33,-2,27,29,讲课很清晰，个人功力很强
227,2014,陈越,2015-03-14 17:12:04,1,82,81,姥姥讲课就是好！超级清晰，能一直跟着思路思考下去，课堂的时间都过得超快～英文也是全计算机学院最好的！
1392,2014,陈越,2015-03-22 01:32:13,7,17,10,要求严格
2128,2014,陈越,2015-04-02 08:15:03,1,7,6,不点名口阿
7570,2014,陈越,2015-09-15 04:38:42,-47,17,64,还没上过陈姥姥的课，先给她评10分！
15890,2014,陈越,2016-01-16 13:59:53,-39,6,45,超级赞，不解释
18350,2014,陈越,2016-01-21 13:10:48,-27,6,33,和蔼的好老师，讲课清晰，即便用英语上课，我们也能听得懂
20437,2014,陈越,2016-01-27 14:27:22,-11,4,15,教学非常认真
20926,2014,陈越,2016-02-04 08:13:19,-30,7,37,姥姥的ds上得很愉快，互评和小测都很良心，虽然机考出了意外但给分依旧很高
27277,2014,陈越,2016-06-24 10:56:37,-33,7,40,姥姥最好！
27360,2014,陈越,2016-06-25 07:14:14,-18,9,27,又严厉又很慈祥的老师。虽然最后分数不高。但只能怪自己没有努力学习。姥姥很棒！但可能不适合我TT
32103,2014,陈越,2016-07-05 15:33:24,-1,8,9,姥姥英文很好，备课很认真，虽然沟通技巧这门课真是....
32185,2014,陈越,2016-07-06 01:51:02,-10,6,16,总体来说TC还是很因却斯汀的，不过第一次开课，也会有各种bug，相信姥姥会逐步修复的
32768,2014,陈越,2016-07-12 13:23:23,5,13,8,其他课都是满分，远离沟通技巧。
38823,2014,陈越,2016-12-19 09:03:41,30,38,8,不知道为什么大家都说好。老师很严格按照规定做事，但是规定的内容却不具体。出了问题去找她，她说上课说过了，可是没有同学听到...建议尽量不选她的课。
40432,2014,陈越,2017-01-06 10:04:00,345,386,41,极其反感分组互评之类的评价方式
40790,2014,陈越,2017-01-05 13:37:05,5,15,10,pta对细节要求这么高是否真的有必要？重点是不知道测试点的具体要求也不知道哪里出了问题.
41156,2014,陈越,2017-06-05 12:34:17,175,214,39,查重感人
41862,2014,陈越,2017-01-13 09:49:31,0,7,7,其实老师人是很好的，讲的也很不错啊
41959,2014,陈越,2018-12-24 15:41:40,82,125,43,不懂ds这种简单的基础课为什么要搞得这么复杂。pta做得是挺好的，但是project各种繁文缛节。最后查重。呵呵。莫名其妙就被判作弊。真的作弊承认不就好了，用得着考试周花这么多时间精力来各种申诉？老师助教学生之间就不能多点信任吗？还有些作业给了别人自己也0分了，如果最开始强调这个的话谁还会给别人？开始没强调，关系好的朋友来找你要，你能怎么做？
42037,2014,陈越,2017-02-28 14:25:37,44,60,16,很严格的人，按照 requirements 说什么就是什么，不会丝毫留情。一定要读清楚各种要求。
42048,2014,陈越,2017-01-13 13:05:01,8,28,20,我还是赞成查重的 其实只是差相似度 我想说如果你是自己写的 不借鉴别人代码 不可能被查出来的  如果不是一两题被查出来 你真的保证没有问题吗 扣点分也应该吧 姥姥的课讲得很详细 但希望选她的课 你英文听力要好 认真学收获很大的 拥有学识和责任感的一个老师 建议就是这样 垃圾互评迟早药丸 这一点 黑到底
42049,2014,陈越,2017-01-13 13:05:20,38,46,8,查重太坑\n\nproj太坑\n\nquiz太坑
42124,2014,陈越,2017-05-15 15:27:24,122,142,20,一门沟通技巧，让我对她的称呼从姥姥变成陈越。
43167,2014,陈越,2017-01-16 02:09:13,-5,10,15,姥姥人还不错，讲课思路也很清晰\n\n但是给分好是个谣言，最后一分也没调。\n\n另外互评这东西真是没话说，至于查重，个人感觉没什么黑点。
43541,2014,陈越,2017-01-16 13:40:24,-16,4,20,难受，讲课是好，但给分挺低的
44299,2014,陈越,2017-01-17 14:35:54,6,16,10,姥姥上课水平确实不错，英文授课听着很舒服。但给分相比其他老师是真坑，平时要求比其他班高，事比其他班多，查重什么的格外严格，最后平时分还比其他班低好多。平时花费了那么多精力，结果到头来得分还不如那些最水的班，心好痛…
47405,2014,陈越,2017-01-26 05:06:30,231,262,31,搞不懂互评是为了什么，如果只是省时间不想改作业的话，人家微积分史纲大课都能做到认真批改每个学生的作业，你为啥做不到。如果为了学生之间的参考学习，那请你调查下，有多少人是把别人代码下载下来认认真真一行行审查的。如果互评真的公正合理的话，为什么还有那么多互评超限要去额外处理然后惩罚扣分。互评下来除了耽误时间影响成绩破坏人与人之间的信任关系之外，还有什么收获。简单点儿说，互评就是通过设计各种扣分陷阱，让懵懂无知的新人认栽的钓鱼扣分制度。
47680,2014,陈越,2017-02-16 14:18:49,-43,10,53,浙大里面最喜欢的老师，最公平最好的老师，对每个学生都认真负责的好老师
48095,2014,陈越,2017-02-28 12:16:06,66,100,34,呵呵。这学期选了别的老师的ads。听说是cy极力要求在pta上做一个诚信守则的测试（highlight:请注意所有老师的班级都要做）。不到满分不给期末考试资格。\n\n强调诚信是应该的。\n\n但用如此极端的方式不知道老师有没有过过脑子。谁给的你剥夺学生期末考试的权利？抱歉差评。
48132,2014,陈越,2017-02-28 16:11:53,50,66,16,我不管讲课好不好，诚信测试什么的我就是不认同
48729,2014,陈越,2017-06-30 02:47:41,89,100,11,学啥沟通技巧啊！
48820,2014,陈越,2017-03-14 02:28:49,62,69,7,恶竞之源
48821,2014,陈越,2017-03-14 02:31:12,88,101,13,互评 诚信测试 绝对差评\n\n计院恶竞多严重可能别的学院不知道
48853,2014,陈越,2017-03-15 01:56:57,43,49,6,辣鸡搞笑的诚信测试
49002,2014,陈越,2017-03-21 07:16:50,-19,6,25,我觉得互评一方面是给学生来自同学的意见，更重要的是让人学习看（评价）别人的代码，个人觉得没什么问题。至于所谓恶竞，按标准评分应该不会超限。
49095,2014,陈越,2017-03-25 05:45:28,11,14,3,感觉非常糟糕
49404,2014,陈越,2017-04-10 11:23:20,12,16,4,很难受。
49722,2014,陈越,2017-04-25 00:10:55,19,25,6,怎么没有0分
49730,2014,陈越,2017-04-25 02:47:26,14,17,3,0分？？？
49966,2014,陈越,2017-04-28 01:04:36,9,14,5,呵呵呵
50062,2014,陈越,2017-04-29 04:56:25,11,14,3,你懂的\n\n
50231,2014,陈越,2017-05-01 17:50:15,8,14,6,诚信测试？？？
50450,2014,陈越,2017-05-03 02:57:24,171,192,21,矫枉过正 毁人一生
51058,2014,陈越,2017-05-15 14:06:28,46,57,11,上了三周沟通技巧，前来打分，不是说姥姥讲的不好，只是因为她引进了这门烦人的课，1分不能再多了
51059,2014,陈越,2017-05-15 14:26:27,3,5,2,我醉了
51060,2014,陈越,2017-05-15 14:26:45,14,18,4,无法理解的诚信测试
51066,2014,陈越,2017-05-16 02:02:06,22,25,3,沟通技巧这课比通核和J类加起来还要烦好几倍
51067,2014,陈越,2017-05-16 02:13:32,52,62,10,一门二学分的课，每周的作业量相当于一门通识一学期的作业量，而且还放在大二下这么敏感的学期，说她没病那都是看得起她。
51131,2014,陈越,2017-05-18 06:33:10,4,18,14,姥姥自己是北大数学系高材生 ，普林斯顿数学博士，所以上课要求确实很高(对比起来计院其他老师是真水)\n\n姥姥的教学本意非常好，理念也新。但考虑到大部分学生的水平，以及学生习惯了上课的水，上姥姥的课真心觉得麻烦，特别是沟通技巧。。。。也不好说到底是老师的错还是学生的错，反正就这样吧
51155,2014,陈越,2017-06-29 08:15:44,51,56,5,互评是真特么垃圾
51157,2014,陈越,2017-05-20 06:25:46,28,37,9,查重搞到自己从9分降到5分（可能继续降），何必呢！
51179,2014,陈越,2017-05-23 03:16:41,11,18,7,???
51193,2014,陈越,2017-05-28 14:48:02,20,23,3,辣鸡系统，时间都不是标准时间，还我分QAQ
51195,2014,陈越,2017-07-02 05:12:04,71,108,37,其实大家也就是黑互评吧，话说虽然ADS考试爆炸，但不得不说这年头能认真出考卷的老师真的是好老师啊，学术水平上姥姥还是依然高标准！
51212,2014,陈越,2019-03-23 07:06:31,114,127,13,写完2000多字的综献，30分拿了19分，惩罚扣分23分。我实在不知道也是很懵逼了，是不是还不如不写算了。呵呵
51213,2014,陈越,2017-06-09 05:58:16,46,51,5,客观地讲，课还是值得一听的。但是互评多大仇
51219,2014,陈越,2017-06-06 08:35:38,12,17,5,趕羚羊
51220,2014,陈越,2017-08-20 11:13:53,30,33,3,查重＋互评，每周project，一门沟通技巧等于n门通识，十人一组又能怎样？
51233,2014,陈越,2017-05-25 01:44:24,23,29,6,滚XX的诚信守则
51234,2014,陈越,2017-05-25 01:45:43,20,23,3,学啥沟通技巧呀，浪费生命
51325,2014,陈越,2017-05-31 10:18:52,7,10,3,贡献0分
51340,2014,陈越,2017-06-01 04:29:53,20,29,9,赶紧来人把她娶了吧
51341,2014,陈越,2017-06-01 04:33:58,-15,13,28,我认真听课，我课后思考。\n\n我作业不作弊，按照要求来完成pj。\n\n期末要求不高，考个八十几分就能得到很好的成绩。\n\n各位可千万别被那几个骂查重和互评的给忽悠了，他们是利益相关者。
51342,2014,陈越,2017-06-01 04:39:06,2,4,2,怎么没有0分
51344,2014,陈越,2017-07-05 14:12:30,3,11,8,bonus是给自己做的 不是为老师做的 斤斤计较那么点破分怕是智障吧
51350,2014,陈越,2017-06-29 08:26:14,42,48,6,我不觉得水军有这么大本事。像某些同学说的，作弊的也就几个。他刷差评能刷到哪里。况且学习帝今年无法不登录微信评价。也许老师很好很好。但是我不能接受就不能接受。看不惯他的教学方式，所以我打了差评。我觉得大家也都只是这么想的而已呀。有啥水军呢。
51355,2014,陈越,2017-06-08 07:47:53,9,10,1,非常糟糕
51358,2014,陈越,2019-03-05 09:08:44,96,108,12,学习如何隐藏个人信息\n\n从9+得分到现在的分数请老师也思考一下为什么
51379,2014,陈越,2018-04-03 10:15:38,153,171,18,该老师引入的互评制度比\n\n原校长引入的正态制度更加令人发指\n\n互评制度十分善于煽动同学之间的矛盾\n\n打压不善于投机取巧同学的学习积极性\n\n打压同学们互相帮助共同进步的积极性\n\n费尽心机去找个人信息扣分，还不如多做两道题目\n\n看到好的程序不敢给高分怕自己给分超限\n\n看到差的程序不敢给低分怕自己给分超限\n\n战战兢兢的防同学防老师防助教。\n\n辛辛苦苦写出来的东西和糊弄写出来的东西都只能拿到一半左右的分数\n\n这是您的愿望吗？\n\n该名老师，您是不是该自我反省一下呢？
51482,2014,陈越,2017-07-08 12:44:06,27,30,3,那个课应该改名为面向信息技术的互评技巧。
51622,2014,陈越,2017-06-07 15:09:45,12,16,4,ADS的报告都要present的，隐去组员信息有用吗?
51641,2014,陈越,2017-06-08 00:47:38,13,14,1,垃圾沟通技巧，浪费生命，毫无作用
51655,2014,陈越,2017-06-08 04:36:36,16,18,2,mmp的沟通技巧，凭什么我的分数全是要别人来打，老师是干啥吃的。万恶的互评制度，同意需要互评，但全看互评真的是nmb
51664,2014,陈越,2017-06-08 06:09:29,8,9,1,互评系统非常差。各种陷阱扣分，各种毫无根据被扣分，甚至要承担他人错误评价的过失。很差。
51666,2014,陈越,2017-06-08 06:21:51,4,5,1,不是很懂奇葩的互评制度
51669,2014,陈越,2017-06-08 06:42:59,1,2,1,辣鸡互评
51670,2014,陈越,2017-06-08 06:44:06,4,4,0,哎，沟通技巧
51671,2014,陈越,2017-06-08 06:44:22,1,3,2,虽说政策有些争议 但是讲课好非常耐心
51674,2014,陈越,2017-06-08 06:56:19,3,6,3,沟通技巧蛋疼\n\n互评制度蛋疼\n\n其他还好
51676,2014,陈越,2017-06-08 07:13:25,1,6,5,我觉得姥姥表演差老师讲课都比有些老师好到不知道哪里去了
51677,2014,陈越,2017-06-08 07:16:47,-4,2,6,蛮好的
51679,2014,陈越,2017-06-08 07:48:57,-1,1,2,interesting
51680,2014,陈越,2017-06-14 03:07:31,-1,2,3,233
51684,2014,陈越,2017-06-28 06:25:15,2,3,1,呵呵了
51695,2014,陈越,2017-06-08 10:51:17,0,1,1,不评价
51696,2014,陈越,2017-06-08 10:55:00,2,3,1,体验很糟糕
51711,2014,陈越,2017-06-08 12:32:41,15,17,2,我们要团结起来，对于一切互评都评70分，这样我们才不会因为互评制度而扣分。
51741,2014,陈越,2017-06-09 02:52:51,1,2,1,我很感动，呵呵
51757,2014,陈越,2017-06-09 06:05:36,2,4,2,互评 呵呵
51808,2014,陈越,2017-06-11 07:56:15,1,5,4,互评无论报告写得是好是坏，只能一律评70分。
51815,2014,陈越,2017-06-11 11:28:51,12,15,3,简直是狗，辣鸡互评，毁我青春
51996,2014,陈越,2017-06-14 05:13:12,-14,3,17,非常棒！
51997,2014,陈越,2017-06-14 05:14:00,1,4,3,为虾米没有0分
52135,2014,陈越,2017-06-15 04:58:40,-23,7,30,打1分的同学们醒醒吧，就算能打负分，难道这些课就从此消失了？还是乖乖上课好好提升自己专业水平吧。
52341,2014,陈越,2017-07-02 06:45:10,-34,11,45,一开始夸老师，攒了20个负评\n\n我喷一下老师卷子难，又多了2个负评…
52427,2014,陈越,2017-06-20 03:26:21,13,14,1,互评真的没有意义，无论做得好不好，都只能给安全分。
52429,2014,陈越,2017-06-20 03:33:57,8,13,5,打一分多是报复型或者是不满型的评分吧，其实这个老师专业水平不低，待学生也不是很差，就说互评和沟通技巧（和查重？）确实挺招人反感
52791,2014,陈越,2017-06-28 06:24:49,3,9,6,她是我唯一一个没上过她的课就只能给她评一分的老师。
52844,2014,陈越,2017-06-23 07:16:54,17,19,2,可怜的中加同学
52893,2014,陈越,2017-06-30 07:55:04,-1,3,4,还可以吧
53105,2014,陈越,2017-06-29 04:59:50,1,2,1,还可以啊
53140,2014,陈越,2017-06-26 04:26:05,9,10,1,特意赶来喷沟通技巧（这课就不应该存在），还有互评，发现我来迟了。
53162,2014,陈越,2017-06-26 05:57:08,1,2,1,都懂的
53163,2014,陈越,2017-06-26 05:50:24,1,3,2,我还能说什么呢
53165,2014,陈越,2017-06-26 05:55:15,75,90,15,宁可延毕，别碰此人。晚上出门的，肯定是tm想偷东西，一律打断腿。你们写的代码，著作权都是我的，我禁止你发布。否则，我可以让你挂科，哪怕已经修完了，我可以取消你出国资格，我可以搞各种事恶心你。让你在浙混不下去的手段，我可有的是。
53348,2014,陈越,2017-06-26 12:15:41,6,10,4,互评就是比谁更喜欢挖别人有没有暴露个人信息，一直挖到文档属性里面，那还不是美滋滋
53468,2014,陈越,2017-06-26 16:29:07,0,2,2,感觉挺好
53499,2014,陈越,2017-06-27 01:00:33,-2,1,3,不敢听，不敢听.jpg
53627,2014,陈越,2017-06-27 07:53:09,-1,2,3,呵呵呵
53665,2014,陈越,2017-06-27 09:23:42,-3,8,11,你们都喷她 但我觉得她挺好的呀
53855,2014,陈越,2017-06-28 01:57:05,2,3,1,互评呵呵
53861,2014,陈越,2017-06-28 02:20:14,-2,10,12,这刷低分也太恶意了吧 查重自己作弊被查到还有理由了？被误伤去申诉不行？喷也喷对点谢谢
53865,2014,陈越,2017-06-28 02:25:42,5,8,3,见识了一下什么叫“一桃杀三士”。
53866,2014,陈越,2017-06-28 02:25:45,4,18,14,姥姥水平高，要求高，人品好。\n\n特立独行，有些做法有争议我也不赞同。但是部分同学怼么又不敢正面怼，怼又怼不过姥姥，跑到学习帝来打低分，发表阴阳怪气的言论，真是窝囊。
53867,2014,陈越,2017-07-03 12:04:35,-10,19,29,你们的良心都被狗吃了，互评再怎么恶心，陈越也不可能只是一个2分的老师，恶意低分的怕不是有毛病
53868,2014,陈越,2017-06-28 02:30:10,-3,3,6,挺好啊
53885,2014,陈越,2017-06-28 02:58:01,5,12,7,诚信守则是严格了点，可是执行过程里没一个人是被冤枉的。沟通技巧也许是个黑点。互评倒扣也许是个黑点。但远远没两分那么低。\n\n那些各种骂的人，你们大概只是抄袭被查出来，被挂科然后恼羞成怒了吧？
53910,2014,陈越,2017-07-01 08:26:03,0,3,3,。。。
53927,2014,陈越,2017-06-28 04:39:08,3,4,1,特立独行的老师啊
53935,2014,陈越,2017-06-28 05:26:15,37,51,14,挺有趣的一点是，6月28日之前，刷低分的有，但是鲜有怼那些刷低分的人。然后6月28日突然出来一堆人开始三观超正开始正义感爆棚。同时，6月28日是沟通技巧出分的日子。所以个中原因，自己想吧
53947,2014,陈越,2017-06-28 06:03:08,6,17,11,这是第一次在学习帝上去评价一个老师。从授课来说，姥姥是所有计算机双语课里面，上课听起来最舒服的，而且回邮件很耐心，基本都是及时回复。给分来看，姥姥的确不比其他老师要好，ads里面bonus给分也比较严格，做一次pro还不比上课发一次言的那种，沟通是我唯一一门没上4的通识，希望老师的给分制度可以改一改吧。互评我相信老师的出发点是好的，主要还是希望我们能够从别人的报告代码中学习，也能提高自己的水准。看到很多人喷这个制度。我倒是觉得并没有像大家说的这么夸张，相信会被之后的学弟学妹慢慢接受的。至于查重，我也没什么太大意见，毕竟别人问你要代码的时候，总有理由拒绝了不是吗。总而言之，就是上课好，要求高，给分差，不管怎样，还是很敬爱陈姥姥的。
53965,2014,陈越,2017-06-28 06:28:23,5,11,6,老师水平很高，要求很严，除了互评没有别的黑点。嫌作业多，给分差的先问问自己，别逼逼了。
53970,2014,陈越,2017-06-29 10:50:17,-2,11,13,想了想还是把1分修改为9分了。之前打一分因为痛恨互评，但是这与老师又有什么关系呢
53999,2014,陈越,2017-06-28 07:34:03,1,2,1,沟通技巧一出，立马来评分
54000,2014,陈越,2017-07-02 08:20:07,-2,5,7,挺负责的老师
54064,2014,陈越,2017-06-28 10:57:09,1,3,2,互评呵呵呵
54131,2014,陈越,2017-06-28 13:48:54,2,5,3,很棒的老师
54173,2014,陈越,2017-06-28 15:05:06,1,6,5,想挑战绩杀的排好队，一个一个来。
54174,2014,陈越,2017-06-28 15:06:53,0,5,5,沟通3.9，谢天谢地。我一度以为自己上不了80。\n\n所以我给了5分。
54348,2014,陈越,2017-06-29 06:42:02,10,11,1,查重互评有点。。。矫枉过正吧
54360,2014,陈越,2017-06-29 07:35:55,9,10,1,互拼是恶竞之源
54385,2014,陈越,2017-06-29 08:36:43,3,4,1,反感互评
54600,2014,陈越,2017-06-30 00:35:42,-1,4,5,人很nice很有想法的老师\n\n
54617,2014,陈越,2017-06-30 02:35:12,3,4,1,互评………呵呵呵呵
55370,2014,陈越,2017-07-01 11:37:36,-1,1,2,666
55621,2014,陈越,2017-07-02 05:09:57,4,4,0,哎 一言难尽
55752,2014,陈越,2017-07-02 10:29:02,0,2,2,不能删评价？
55909,2014,陈越,2017-07-03 12:04:42,1,11,10,查重这种事，顶姥姥\n\n不畏各种舆论，做自己觉得正确的事情(事实上也是正确的)，姥姥其实很可爱的～
55970,2014,陈越,2017-07-03 12:03:00,6,9,3,互评真恶心
56416,2014,陈越,2017-07-03 16:39:36,6,18,12,全英授课英语水平不输外院老师。\n\n无论如何都要十分挺姥姥一波。就算上了姥姥的各门课程并没有拿到太好的分数，但是一直get不到喷子们黑姥姥的重点(?)。查重到最后并没有误杀谁，毕竟我也是第一学期被查过的。就不知道面对一个授课水平很高评价机制完善的老师，一直希望为自己不讲诚信找空子是一种什么样的心态。\n\nby妓院15某人，单纯是看不过眼才来评价的
56523,2014,陈越,2017-07-04 02:42:32,1,9,8,陈越姥姥是一个很负责任的老师，虽然给我的分数不怎么样，但是总体来说讲的内容是很好的
56626,2014,陈越,2017-07-04 06:09:06,5,18,13,看不下去了。姥姥是个好老师，不应该收到这样的对待。
56768,2014,陈越,2017-07-04 14:42:32,0,1,1,。。。
56977,2014,陈越,2017-07-05 05:29:26,-58,14,72,ads第一节课说bonus直接加总分，最后又不承认。做了几乎全部的bonus，平时分超了6，7分，结果期末最多算60分。最后总评94.4不给进个95？讲课好，但给分是真的很差。
57230,2014,陈越,2017-07-06 05:28:19,1,2,1,一言难尽
57660,2014,陈越,2017-07-11 16:28:26,-6,1,7,沟通技巧给分还行，互评一次忘评还给了不错的分数
57675,2014,陈越,2017-07-12 06:14:40,1,2,1,呵呵哒
57684,2014,陈越,2017-07-12 12:17:26,-3,5,8,黑查重的请自重
57879,2014,陈越,2017-07-16 14:19:46,-1,3,4,查重辣鸡
57884,2014,陈越,2017-07-29 11:01:41,-55,10,65,你们这届大一真是惯出毛病了？请自觉退学
57909,2014,陈越,2017-07-17 10:03:02,0,2,2,特别好
58090,2014,陈越,2017-07-29 11:01:16,17,26,9,哦，上面请大一退学的脑子没毛病？cy的DS，ADS，沟通技巧至少也是大二的课吧，这里吐槽的主要是哪个年级的自己用脑子想想，你是有意挑拨的吧？mdzz
58228,2014,陈越,2017-08-26 07:12:32,0,2,2,哈哈哈
58581,2014,陈越,2017-09-05 17:12:58,-3,3,6,good
58815,2014,陈越,2017-09-18 03:09:45,17,19,2,中國式互評
59093,2014,陈越,2017-09-19 11:54:02,2,5,3,有毒吧
59460,2014,陈越,2017-09-21 13:27:45,7,8,1,诚信测试感人。\n\n连坐制度未免太过不去了，组员抄袭也管不住啊。\n\n还有互评最后变成挖空心思找个人信息也是醉了
59689,2014,陈越,2017-09-26 02:47:29,-2,1,3,啦啦啦
60066,2014,陈越,2017-10-09 08:24:05,0,0,0,写三个字
60124,2014,陈越,2017-10-11 05:28:59,14,16,2,老师是好老师，但是对不起我只能打一分
60125,2014,陈越,2017-10-11 05:34:11,21,22,1,60%挂了哦\n\n66666666666666
60126,2014,陈越,2017-11-18 17:45:53,-22,9,31,老师真的很好，辣鸡喷子们！良心何在！！
60139,2014,陈越,2017-10-11 07:53:14,2,2,0,不好听
60142,2014,陈越,2017-10-11 09:05:57,7,8,1,很严格
60164,2014,陈越,2017-10-12 03:20:36,37,43,6,阿越真的很严格
60187,2014,陈越,2017-10-13 08:46:13,14,16,2,什么都没学到 倒是体会了中国的螂性 \n\n互评更是让同学间互相猜忌 \n\n
60214,2014,陈越,2017-10-13 09:09:36,7,7,0,查重感人
60223,2014,陈越,2017-10-14 04:07:18,5,6,1,无语了
60250,2014,陈越,2017-10-15 17:33:37,18,21,3,挂人很高兴 心态有问题
60288,2014,陈越,2017-10-16 15:18:31,3,3,0,，，，，
60289,2014,陈越,2017-10-16 15:21:01,30,33,3,自己不讲清楚pta的操作机制然后拿学生的前途在玩吗？建议所有被挂科的同学团结起来。把这个事情曝光给媒体。
60303,2014,陈越,2017-10-17 03:48:43,-4,3,7,很好！
60392,2014,陈越,2017-10-19 03:07:05,19,20,1,我不是她班的，但是受她影响每次老师布置任务都要提心吊胆地担心被误杀……特地过来给个差评
60399,2014,陈越,2017-10-19 05:50:52,47,52,5,身边好几个同学都被pta查重误杀了，真的是很好的同学，大学就这么毁了。矫枉过正，毁人一生啊
60428,2014,陈越,2017-10-19 14:19:04,3,5,2,为什么没有0分？？？？
60459,2014,陈越,2017-10-21 05:41:49,7,7,0,有怪病
60477,2014,陈越,2017-12-25 13:47:32,84,121,37,"被查重挂科的经历:第一次编程作业在自己的电脑上运行无误，但过不了PTA，于是乎抱着怀疑PTA的态度我提交了一次网上代码(在向他人求助无果的情况下)，后来在截止时间内我发现了自己代码的错误，又提交了自己的代码(我想当然的以为能够覆盖)。然后就挂科了。这样的行为被""诚信守则""定义为作弊！作！弊！我真的不能接受这样被定义为作弊，仅仅是怀着置疑的态度，最后导致了被评为作弊？难道连置疑都不允许了吗？"
60636,2014,陈越,2017-10-26 01:14:41,8,11,3,也是不懂一堆人洗地为了什么
60675,2014,陈越,2017-10-26 10:17:15,2,5,3,不能给负分吗
60716,2014,陈越,2017-10-27 12:44:12,1,3,2,辣鸡互评
60797,2014,陈越,2017-10-30 09:18:01,15,19,4,请知乎搜索 如何评价浙江大学数据结构课程某老师对题目「反转链表」进行查重，期末挂掉61%的人？\n\n真是给学校招黑
61299,2014,陈越,2017-11-14 02:22:15,10,16,6,之前的互评事件我还不知道是学生老师哪边的问题，突然看到知乎上反转链表查重，emmmm，特来差评，这种老师开的课越少越好，如果以后不得不选她的课我不如退学。
61361,2014,陈越,2017-11-15 08:13:40,11,11,0,为什么没有零分？
61524,2014,陈越,2017-11-18 08:49:30,8,8,0,………
61695,2014,陈越,2017-11-20 07:05:43,18,20,2,陈越老师课讲的确还是挺用心的，但是比她讲的好的，爱惜学生的也大有人在，不是很喜欢她这样跋扈极端的性格。毕竟有时候仅仅一门课的杀伤力就可以改变一个人生轨迹了。
63048,2014,陈越,2017-11-28 04:22:09,-2,5,7,相信姥姥
64108,2014,陈越,2017-12-21 03:53:57,-5,5,10,挺好的真的别黑了
64132,2014,陈越,2017-12-21 04:53:10,3,3,0,可怕\n\n
64243,2014,陈越,2017-12-22 01:55:56,1,3,2,反转链表
64468,2014,陈越,2017-12-24 09:33:36,6,8,2,勇士，但并不一定合理
64727,2014,陈越,2017-12-27 03:26:53,-4,1,5,老师的课上的很好啊
65194,2014,陈越,2019-07-28 03:44:11,-117,68,185,你吗死了，我是你爹
67647,2014,陈越,2018-01-22 03:54:45,1,2,1,快捷键
70565,2014,陈越,2018-01-27 08:21:36,4,6,2,讲课很好，互评制度未免矫枉过正。
71400,2014,陈越,2018-01-28 11:41:41,-1,2,3,emmmm风生水起
71938,2014,陈越,2018-01-29 06:20:35,24,30,6,水平很高，意识一流，操作智障
73657,2014,陈越,2018-02-02 09:37:09,27,30,3,DS是门神课，让你知道浙大有个人叫陈越，让你知道什么叫做浙大所谓的“诚信”。你搞出那么多制度之前能不能想想有什么意义？该抄的还是会抄，又有多少人互评是真正认真评的？还是说模仿别人的，浙大就变成世一大了？
73761,2014,陈越,2018-02-03 05:12:31,-7,8,15,说反感互评和查重的，你们根本不明白陈越的目的是什么。一个学院总得需要一个唱黑脸的人
75576,2014,陈越,2018-03-13 12:30:15,6,10,4,project互评是真的垃圾。
75721,2014,陈越,2018-03-15 11:50:49,4,6,2,上课确实很好，互评查重是有争议，但是对个人来说遵守了规则就没有问题
76466,2014,陈越,2018-04-10 07:50:55,23,27,4,跟互评跟制度都没关系，打1分是希望陈老师学会如何尊重学生，如何平等看待学生，如何知道做一个好老师，好老师不是只会上课就可以的。希望您知道这件事情。\n\n以后不会再选您的课了。
76677,2014,陈越,2018-12-27 05:09:36,-2,11,13,辣鸡老师毁人一生
76945,2014,陈越,2018-04-26 08:43:30,0,8,8,烂老师烂老师不要选超烂
77934,2014,陈越,2018-05-08 15:48:55,0,2,2,不错啊
79282,2014,陈越,2018-05-30 03:26:14,3,3,0,我们不生产代码，我们只做代码的搬运工～
79356,2014,陈越,2018-05-31 16:25:44,4,11,7,姥姥真的是个好老师，单站在那里就让人尊敬；互评是真的坑，冤枉太多人。还是希望来打分的同学对事不对人吧，有的话真的太难听了些。姥姥为了让计院、计院学生有更好的发展付出的心力，不是那些只上过她几门课的人有立场大肆批判的。
79872,2014,陈越,2018-06-14 14:46:07,1,3,2,沟通技巧是门垃圾课
80695,2014,陈越,2018-06-29 10:15:24,1,4,3,姥姥真的是个好老师 令人敬畏…但是沟通技巧这门课是真的…BALL BALL姥姥换个时间来上吧QAQ  大二下真的要人命啊
81700,2014,陈越,2018-07-06 02:33:16,8,8,0,在沟通技巧面前，毛概都自愧不如。
81784,2014,陈越,2018-07-06 07:28:03,4,6,2,沟通技巧感觉姥姥讲的还可以 给分其实是通识课水平 只是这课居然是专业课就很伤 任务非常多 又是拍视频又是看文献又是给意见表演啥的 总的来说就是硬是在专业课列表里塞了一节通识课 \n\n最后的最后亮一下观点 互评本意可能是好的 但现阶段的每次互评和被互评都感觉和吃了屎一样难受
83075,2014,陈越,2018-07-09 15:19:09,2,3,1,这ads给分还不好？ 知足吧
84623,2014,陈越,2018-07-13 10:51:32,-5,4,9,姥姥威武
86877,2014,陈越,2018-09-19 06:51:05,5,6,1,底下的臭弟弟嘴这么臭，有丶我孙哥的遗风
87013,2014,陈越,2018-09-20 02:52:24,1,4,3,想知道这个ds均绩是否是真的
87537,2014,陈越,2018-10-03 11:07:24,33,35,2,查重矫枉过正。学生写代码的时候想的都是如何避免被判抄袭，而不是如何提升程序效率和可读性。\n\n小组互评完全没有必要。如果是出于相互学习的角度，GitHub上大量优质源码可以阅读；如果是出于合作的想法，很抱歉，我不知道ds这门课需要合作什么？\n\n不要偏离了课程开设的初衷，而去搞什么花架子。我们学的是数据结构，不是反查重以及写文档技术。\n\n理想的解决办法是增大课程通过难度，淘汰掉平时抄袭的人，让学生把重心放到学习过程中，而不是想尽办法在花哨的评价体系中得到一个好的分数。
87604,2014,陈越,2018-10-08 06:04:33,18,19,1,emmmm由于发现自己写的代码和网上一个博客一样而瑟瑟发抖中
87673,2014,陈越,2018-10-10 02:23:35,9,11,2,peerreview是真的垃圾。\n\n事先没有提醒个人信息要怎样隐去，没有要求大家按projectrule给分。写得好的同学很多人欣赏不了，别人的代码也看不懂，最后就只看看排版了。\n\n学数据结构，刷上一百道题永远是最好的方法。搞这么多幺蛾子，为了给自己评几个教学成果奖，呵呵，是真的垃圾。
87715,2014,陈越,2018-10-10 23:19:56,5,7,2,人生最大的不幸莫过于预置了她的课但选不上其他老师的课
87794,2014,陈越,2018-10-13 14:57:21,15,16,1,我真的不认为部分peer有资格去review别人的代码
87849,2014,陈越,2018-10-15 23:27:43,10,12,2,该师引入的互评制度，将学生重点偏移，各种繁文缛节占用学生大量宝贵时间，互评不但不能起到互助提升的作用，反而成为计院学生的恶竞之源\n\n让学生感觉 努力有时不如划水\n\n好好思考代码分析 不如看看是否被查重，格式对不对。\n\n希望该老师取消互评制度，查重可以有。\n\n或者以上机考试和笔试成绩占大比例（60％+）\n\n又没有正态的课，何必打压大家\n\n既然怕平时分存在作弊\n\n那你办考试呀，pta上机考啊\n\n和c小程一样啊\n\n这有助于增加成绩的公平性\n\n互评模式偶然性很大
87850,2014,陈越,2018-10-16 01:14:31,7,7,0,project部分设置的很多规则不但繁琐而且很死板，就最大子矩阵这样一个简单的问题，花费在各种形式化的工作上的时间甚至几倍于写代码本身，完全超过一个2.5学分的课应该有的负担。最后还是因为一些奇奇怪怪的问题有扣分。实在不能理解为什么要在对学生实际能力提高没有帮助的方面如此刁难学生。
87851,2014,陈越,2018-10-16 01:59:23,5,5,0,极为反感
87918,2014,陈越,2018-10-17 16:32:52,6,6,0,万恶之源
87919,2014,陈越,2018-10-17 16:32:57,3,5,2,fds每天提心吊胆怕误杀，矫枉过正
88124,2014,陈越,2018-10-22 15:57:48,7,7,0,矫枉过正\n\n
88513,2014,陈越,2018-10-31 14:15:11,10,11,1,只能说是很讲规则的老师吧，虽然规则都是老师定的，解释权也在老师那里。而且有种不管什么情况都能给出自己的合理的解释。能用给零分解决的事情绝不会提供其他补救的方法。这当然符合一开始定的规则，也无可厚非。但是私以为还是有其他更好的途径来解决问题。
88519,2014,陈越,2018-10-31 15:58:16,8,11,3,对于查重，我无条件赞成，这毕竟是学术诚信的问题，而且现在姥姥查到的基本都是直接复制粘贴网上代码或者抄袭同学代码的人，只要是自己写的，不必担心被查。\n\n但是，对于互评，我难以接受，尤其是文档属性的问题，其中出现作者名字之类的，据我所知，别的老师班并不会直接归零，还有文章中出现组号、组员名，在姥姥的班都会零分处理，我觉得这首先对于不同班的学生就太不公平了，其次归零并不是警醒学生最佳的办法，我觉得还有其他更优的途径，规则严苛，缺乏人性处理。而且没有对提升能力有任何帮助。\n\n此外，我上的这个教学班，群内也是各种勾心斗角，巴不得把别人多扣一点，零分最好，让我提前知道了社会险恶。\n\n奉劝各位，\n\nfds别选cy\n\nfds别选cy\n\nfds别选cy\n\n如果不幸没选到其他老师，你会获得长达两个学期的烦恼源泉，一个课的压力顶四到五门课。
88541,2014,陈越,2018-11-01 04:15:14,7,7,0,认认真真评分你就输了，毕竟光脚不怕穿鞋的
88625,2014,陈越,2018-11-04 12:05:39,9,10,1,互评制度真的害死人。
88875,2014,陈越,2018-11-11 09:49:18,22,24,2,【强烈要求取消互评制度！！！】公正性极低，部分同学有意拉低别人分数，更多同学因为水平有限并不清楚何为好何为坏，评分标准极度混乱，评分和被评分的人心理压力都很大。搞互评的本意是相互学习，但几十行的小程序翻来覆去就那么几种写法，区分度拉不开多大，在多数同学水平差不多的情况下真没啥可相互学习的啊。最后实际操作就变成了在各种琐碎细节上搞噱头，最典型的就是无意义地堆注释（明明变量和函数名就可以起到自说明的作用），更让我无语的是还真有人靠统计注释字数来打分，不觉得这教条得很过分吗？制度本身极其不合理，再加上对期末成绩影响大（project总共25，互评成绩占一半，折算一下绩点跨度可是1.2了），评论区戾气重也就在所难免了（当然人身攻击是不对滴）。总结一下就是：陈越老师的课能让你确实学到不少东西，但运气不好的话陈越老师的课后作业能毁掉你一整个学期的好心情。
90950,2014,陈越,2018-11-28 03:21:39,7,9,2,反正我很享受姥姥的英语和教学风格
92211,2014,陈越,2018-12-27 05:05:08,9,12,3,一句话：peer review就是个垃圾
93124,2014,陈越,2019-01-07 12:11:29,5,6,1,老师讲课讲的很好！听老师的课是一种享受！
96175,2014,陈越,2019-01-20 13:59:16,13,17,4,卧槽这个给分，我要开始洗地了
96192,2014,陈越,2019-01-20 14:11:56,8,17,9,18年秋冬上的陈越姥姥的课，感觉给很好的老师啊。上课讲的很有用，平时查重也是应该的啊，并不是所谓的盲目查重，是人性化的。期末考试炸了，但还是给了我挺好的分。真学到了很多。谢谢陈越姥姥。
96193,2014,陈越,2019-01-20 14:12:16,3,12,9,姥姥给分厚道，比心！
96603,2014,陈越,2019-01-21 07:29:07,0,2,2,。。。
100191,2014,陈越,2019-01-25 17:53:49,21,27,6,懂计算机，懂计算机教育，但不懂中国，不懂浙大
101532,2014,陈越,2019-01-28 11:05:35,-2,7,9,姥姥真的很好啊，给分很厚道，平时上课讲得很清楚，英语也很纯正，除了互评制度我觉得还有缺陷以外，其他的方面都可以说是一名既有师生情，还很认真负责的老师呀
101548,2014,陈越,2019-01-28 11:48:39,3,17,14,讲课挺好，但总觉得人品不好。群里问个问题总是反问反问反问，直接给个答案能死啊。效率极低，能直接解决的问题非得延长。总有一股谜一样的骄傲，好像总是看不起学生。自私，不像是真心想教学生的。
103279,2014,陈越,2019-02-27 06:25:29,7,12,5,上了ads十分想念姥姥的全英文教学了，重要的是全英文还能讲的很清楚有条理
104240,2014,陈越,2019-03-14 11:15:40,44,48,4,2019.03.14 ads课学生\n\n我对于姥姥的上课 大程 互评之类的没有任何意见\n\n但是昨天是pta昨天刚刚改成了pteam(联想一下steam)，pteam教育超市功能上线，期末试卷价格是五折后四元或十元，试卷由题库随机组成，做完一次可以重新买，换句话说，你想做往年的试卷还得反复氪金，期待抽出一个ssr，大学必修课从学生身上想方设法捞钱，挣钱挣出这种花样也是叹为观止\n\n我只是想留个言看看三年以后 五年以后 姥姥的声誉会变成什么一个样子(现在3.7分)，之前的行为还可以算是尽职尽责的好老师，结果现在这样算是晚节不保吗？
105204,2014,陈越,2019-04-07 11:55:24,-30,6,36,我是ikun，考前刷蔡徐坤nmsl看蔡徐坤打篮球，结果 我满了
106489,2014,陈越,2019-04-28 01:08:51,4,6,2,pta氪金系统
106764,2014,陈越,2019-04-29 10:50:56,-1,5,6,姥姥的沟通技巧绝对有用，而且比隔壁班好多了，助教也很nice，罚分最后也能补回来。小朋友们自己写得不好就不好，不看ppt不听课有什么办法，别怪姥姥啊。\n\n姥姥的ads虽然英文授课，但是讲得很清楚，受益良多，虽然最后绩点不咋滴，但是我是有自知之明知道没有做几个pro的。
108221,2014,陈越,2019-05-16 23:27:57,16,18,2,如果没有长期对诚信近乎苛刻的要求，也无法在此刻实验课之事上如此有底气地据理力争。
109427,2014,陈越,2019-06-14 10:24:36,6,15,9,ADS\n\n1.讲课没得挑。内容脉络清晰，语音标准。\n\n2.关于组队与互评。\n\nds和ads都有互评吧，但是ads的互评氛围感觉和谐很多。这学期ADS普遍17(17/20分以上，想起上学期ds居然有个组给我们评价是(the program is not easy to understand -20(100分制，超过30%的注释率，眼睛不需要可以捐献。窃以为，互评氛围变好是因为少了外院学生(没有歧视意味，一方面是同一学院抬头不见低头见的，另一方面是少了些恶意评低分现象(恶意评分真的是恶性循环\n\n3.关于姥姥。我觉得姥姥人很好，不会嫌弃你的问题很垃圾，邮件也回复的很快。就是原则性太强，做事太规矩，但这也不是缺点，一方面在专业课那里抱怨老师原则性太强，扣分不留余地，另一方面又在思政课那里吐槽老师太过偏好于班长组长什么的，只有利己的才是好的吧？\n\n4.关于PTA教育超市\n\n还有两周考试，我买了往年的题，17年9块16年4块，以前的没去翻。我觉得还行，毕竟你在蓝田文印店买15年之前的所有试卷也要10元，还没有那么新。另外，想想一张试卷10块钱是不是就会更认真的做完。。。\n\n5.姥姥对上机课的态度真是硬气！比起各种用加平时分等等让学生去上机，强出一截
109711,2014,陈越,2019-06-18 15:55:30,1,4,3,老师nb，制度。。。
110265,2014,陈越,2019-06-25 08:15:27,11,13,2,沟通技巧：花最多的时间，拿最低的绩点
110290,2014,陈越,2019-06-25 10:50:02,2,5,3,沟通技巧，垃圾课程，学不到什么东西。
110384,2014,陈越,2019-06-26 08:20:45,-6,3,9,姥姥对学生和教学的态度至少值得尊重吧，虽然沟通技巧确实鸡肋
111654,2014,陈越,2019-07-02 11:22:41,6,8,2,沟通技巧绩杀不用怀疑
112005,2014,陈越,2019-07-03 07:01:13,1,4,3,。。。
113322,2014,陈越,2019-07-06 06:04:03,0,4,4,。。。
114252,2014,陈越,2019-07-09 10:30:02,-21,6,27,沟通技巧给分超级好，不知道翁凯怎么样，姥姥给分真的好！！！！
115486,2014,陈越,2019-07-28 03:22:44,3,7,4,姥姥的ds慕课还是挺好的
115629,2014,陈越,2019-08-12 05:56:40,-1,2,3,属实难顶
115864,2014,陈越,2019-08-22 06:23:35,3,3,0,废话太多，不严谨
116714,2014,陈越,2019-09-14 02:27:00,-26,7,33,姥姥值得10分，后悔之前没有选姥姥的课了。
116748,2014,陈越,2019-09-15 02:25:27,35,38,3,打了2分，其中1分是因为没有0分，保底必须要打，另外1分是给她的讲课水平。\n\n总结一下吧\n\n1.诚信守则测试\n\n2.查重\n\n3.互评\n\n4.PTA圈钱\n\n5.沟通技巧\n\n不知道为什么有些人还在洗地。我觉得这五条已经足以扼杀她所有的教学能力和学术能力。老师从小告诉我们说“先学会做人，再学会做题”。那为什么到老师这里就可以因为她学术水平高而忽略她这些行为呢？\n\n退一万步讲，1235这四条你可以强行说毕竟她初衷是好的，只是观念和方法有点问题。但是4这一条，你们打算怎么洗？作为一个老师，这个过分了吧？师德何在？
117296,2014,陈越,2019-09-22 14:36:05,8,8,0,其他老师班的前来补上一分
117448,2014,陈越,2019-09-24 12:07:28,18,19,1,老师讲课水平挺好的。但是我极其反感一些同学通过文件属性查个人信息泄露并且在群里提问，这种做法真的恶心的不行。互评前明明有同学在群里问了好几次，那时候怎么就没见有出来解释了？为了鹅颈真是挖空心思。即便互评制度是好的，在这种素质堪忧的人手里也成了下九流的玩意。
117460,2014,陈越,2019-09-24 17:01:31,12,34,22,建议别选，真的别选，一个双休日其他什么事也没干，然后一直在写代码，但是总是有BUG过不去。就去找了一个网上的代码看看对不对。本来想着如果对了看看我的代码和它的差别在哪，可以自己修改。结果一提交就被判定为作弊，直接挂了。我是真的不懂了，PTA上面的其他函数内容都被省略掉了，无法复制一份在本地运行进行测试。那我为了发现错误只能去找对的代码比较，这个能叫作弊？
117493,2014,陈越,2019-09-25 05:15:24,11,15,4,楼下那位同学是提交了百度来的代码被查重抓住了，xswl
117509,2014,陈越,2019-09-25 08:01:43,13,15,2,楼下那个兄弟直接挂科也太惨了。。。老师有点太严厉了吧
117641,2014,陈越,2019-09-27 06:59:58,7,8,1,nmd这是什么神经peer review 这是peer killing time
118693,2014,陈越,2019-10-30 17:26:53,4,6,2,查重呵呵
121387,2014,陈越,2019-12-16 12:22:53,3,4,1,呵呵。
121501,2014,陈越,2019-12-14 12:12:33,5,6,1,为下学期ADS和沟通技巧都是cyll的同学上香。。。包括我
122595,2014,陈越,2020-03-06 03:26:42,4,4,0,诚信守则真是
122994,2014,陈越,2020-04-28 03:46:29,-17,11,28,课真的上的很好\n\n互评制度也成熟了 虽然还是可能会有傻逼 但是申诉基本都能搞定\n\n其实作弊误判也会在后来撤回\n\n大二ads第一次上到姥姥的课 体验与查老师上普遍的差评相去甚远\n\n期中考试后来打个10分√
124354,2014,陈越,2020-06-29 14:30:03,1,6,5,ADS建议多做bonus吧，这学期在家没法鹅颈发言，bonus project做的很少。水了一学期苟了个4.2。学弟学妹想拿高分还是不要寄希望于期末考，平时分刷满/换老师。
124948,2014,陈越,2020-09-30 12:49:37,19,23,4,人品差 ，坑学生钱，还助长鹅颈，喊她陈越就算很给她面子了
125836,2014,陈越,2020-09-14 15:36:47,7,12,5,建议这个老师换个工作，积点阴德。
126111,2014,陈越,2020-09-17 15:40:08,10,10,0,很反感
126490,2014,陈越,2020-09-28 08:11:13,-28,1,29,姥姥～
126928,2014,陈越,2020-10-28 11:06:06,137,140,3,互评？？我们来评论区搓麻将吧！\n\n\n\n🀙🀚🀛🀜🀝🀞🀟🀠🀡🀢🀣\n\n🀥 🀗🀐🀏🀎🀍🀌🀋🀊🀉 🀥\n\n🀖 🀗                    🀙 🀥\n\n🀘 🀗                    🀙 🀔\n\n🀕 🀡                    🀁 🀁\n\n🀖 🀗                    🀁 🀁\n\n🀘 🀎🀍🀌🀋🀊🀉🀇🀉🀇 🀁\n\n🀐🀏🀎🀍🀌🀋🀊🀉🀇🀆🀅🀁
128236,2014,陈越,2020-12-14 14:36:24,12,12,0,垃圾，布置作业又多又累还不说清楚要求，快到交作业了又在群里这不行那不行，谁选谁后悔
128271,2014,陈越,2020-12-16 01:47:42,8,10,2,写**文献综述 啥比
128275,2014,陈越,2020-12-16 04:16:48,22,24,2,沟通技巧，现在就一沙比课，本来很有意义的一门课，让沉重的课程负担搞得毫无上课体验\n\n写个*的文献综述，一个星期我能写出个寂寞来，我的ds大物概统都不用学了？
128359,2014,陈越,2020-12-21 08:20:18,9,10,1,学啥沟通技巧
128619,2014,陈越,2020-12-24 18:17:30,19,20,1,我想知道为什么有几个逼的修改建议和标准答案完美吻合？
128646,2014,陈越,2020-12-25 02:24:27,15,18,3,沟通技巧感受到了互评的👎，第一次互评有同学给高分被仲裁扣分了，第二次大家都不敢给高分，一个个都把分压到24、25左右，反正按他的评分标准要压一下分简直不要太容易。另外，有的同学为了不被互评扣分，直接按着去年的评分标准写，总共3部部分，每部分6点，真就有人刚好全写中点？这就是互评的目的？
129012,2014,陈越,2020-12-28 11:28:56,-5,2,7,老师可爱:D且说英语好听(虽然我听不懂x
129136,2014,陈越,2020-12-30 10:15:45,1,3,2,原来沟通技巧不是只有她开，在另一个长学期翁恺还会开沟通技巧，而且就那点内容，差一个学期学也影响不大
129895,2014,陈越,2021-01-13 09:37:04,7,8,1,沟通技巧课让大家学会的不是沟通技巧，是怎么翻出来别人文件里的个人信息，这好吗？这不好。
130475,2014,陈越,2021-01-22 16:56:08,-4,3,7,那啥…学弟学妹们要记得沟通技巧的几篇文章的评判标准没变过哦…所以怎么做应该明白了吧
132515,2014,陈越,2021-02-02 05:26:06,4,4,0,姥姥讲课真不错，只是有时候会非常严格没有讲情理的空间
133366,2014,陈越,2021-02-26 10:59:49,3,4,1,能躲就躲吧
133394,2014,陈越,2021-02-27 01:12:05,9,10,1,姥姥讲课没的说，用英语讲课非常清晰。但是姥姥的honest test及带来的种种约束着实让在她的课上如履薄冰。
134540,2014,陈越,2021-04-01 03:08:21,11,15,4,ADS教学改革，上课不讲内容，要自己课前搞懂。真的是，那我要你何用？对那些基础好的（比如高中打过竞赛）的同学可能大杀四方，但是对我这种普通学生真的是太折磨了
134590,2014,陈越,2021-04-03 10:33:54,12,14,2,拿竞赛来说事情就过头了，ADS学的东西已经超出竞赛内容很多了。搞不懂的东西多提问可能能有一点帮助吧，但是本质上还是很大程度上要自学ORZ
136032,2014,陈越,2021-06-10 01:06:25,5,8,3,辣鸡辣鸡
136516,2014,陈越,2021-06-20 03:14:00,6,6,0,辣鸡互评
136844,2014,陈越,2021-06-25 14:18:21,3,5,2,垃圾互评
139573,2014,陈越,2021-07-17 12:22:03,1,2,1,。。。
139796,2014,陈越,2021-07-27 12:39:21,-15,1,16,给姥姥刷一刷分
139837,2014,陈越,2021-07-31 01:37:44,5,7,2,老师负责，但矫枉过正
140240,2014,陈越,2021-09-06 13:34:07,-13,1,14,姥姥很可爱呀
140992,2014,陈越,2021-12-21 17:20:42,-27,14,41,感觉很多评论有点过激，不至于因为老师是陈越所以她呼吸都是错的，一点小事就过来骂街，是浙大学生应有的素质吗
141303,2014,陈越,2021-09-30 14:47:26,1,3,2,给姥姥刷一分
141359,2014,陈越,2021-09-30 14:49:22,3,3,0,互评真的恶心人，无语。
141371,2014,陈越,2021-10-05 00:48:03,6,8,2,繁文缛节一大堆，垃圾互评
141373,2014,陈越,2021-10-03 07:43:29,3,4,1,听君一席话，跟没听一样
141382,2014,陈越,2021-10-04 15:07:45,3,4,1,垃圾互评
141390,2014,陈越,2021-10-05 10:15:26,19,20,1,老师人不错，就是不知道为什么会整互评这个勾八玩意，一方面搞人心态（各种细则太多了，而且为啥做完了才发扣分标准？）另一方面真的非常磨时间，整个国庆假期基本就是在整这个大作业，麻了都
141411,2014,陈越,2021-10-07 11:41:48,10,10,0,始作俑者，其无后乎？
141439,2014,陈越,2021-11-27 07:38:22,4,9,5,姥姥上课是真的挺好的，回答问题也挺热情，但是确实有些地方不能触碰底线😰
141455,2014,陈越,2021-10-09 13:08:32,1,2,1,从没见过这么傻逼的政策：互评、诚信测试、查重
141594,2014,陈越,2022-01-06 13:31:55,41,49,8,“一个好的程序员应该......”\n\n爷学计算机不是为了去当程序员的\n\n爬\n\n体验真的很差\n\n建议上其他老师班然后自己听网课
141848,2014,陈越,2021-10-27 19:48:51,0,2,2,深夜写ds的project写得有点emo
141853,2014,陈越,2021-10-28 01:45:13,1,4,3,搞什么互评，这里的学生什么✓⑧水平，什么素质你不清楚吗
141901,2014,陈越,2021-10-31 02:27:40,3,3,0,？？？什么勾把互评机制？大家都卡在25分里乱评分，一正太就试图把别人压低，自己就高了。这种机制是人能想出来的？
142575,2014,陈越,2021-11-13 13:51:28,0,0,0,。。。
142816,2014,陈越,2021-11-16 11:41:42,4,6,2,还好21级的学弟学妹不用上沟通技巧这门课了（20级还是必修）
143239,2014,陈越,2021-12-22 16:01:19,12,14,2,查老师的目的是要给同学们选课提供参考的 \n\n那我评一分吧\n\n对老师本人给予肯定\n\n对老师的课程给予否认
143247,2014,陈越,2021-11-22 09:14:47,7,7,0,一个好的程序员应该。。。。
143278,2014,陈越,2021-11-23 00:15:54,13,13,0,北大数院出来就这？\n\n教学生怎么给别人打工？\n\npiss off
143313,2014,陈越,2021-11-23 08:22:36,16,17,1,垃圾互评，tmd当信安上呢?你怎么不说只要能爬出作者就算作弊呢
143718,2014,陈越,2021-12-02 10:18:31,5,7,2,课讲的不错，互评我狠狠无语住了
143797,2014,陈越,2021-12-06 15:07:56,5,7,2,讲课还行，但学习感受极其糟糕，建议换老师吧
143952,2014,陈越,2021-12-21 10:24:14,13,18,5,kidding\n\nkidding尼玛呢\n\n伞兵
144905,2014,陈越,2021-12-26 01:37:45,-8,4,12,互评确实有问题，但不是可以申请仲裁吗？教学方面很优秀没的说，平时project只要认真做给分也很好呀，就是期中、期末很恶心。。。
145144,2014,陈越,2021-12-27 16:50:00,4,6,2,。。。
145475,2014,陈越,2021-12-30 02:24:37,32,36,4,PTA上真题卖这么贵还不给答案？让家庭条件不好的同学怎么办？您这么会营销怎么不去腾讯呢？
145633,2014,陈越,2021-12-31 01:07:12,10,13,3,双标狗
145718,2014,陈越,2021-12-31 16:16:39,10,11,1,过分！！！！！！！！！！
145758,2014,陈越,2022-01-01 12:56:06,13,15,2,你那么喜欢打工那你就去打工啊我焯\n\n别教唆别人去打工\n\n屁屁踢里的插图，上课的话术就可以看出是资本家的走狗
145963,2014,陈越,2022-01-04 17:02:46,22,24,2,“姥姥我啊，最讨厌那些不能赚钱的东西了”
146103,2014,陈越,2022-01-05 13:02:37,6,8,2,互评。。。。呵呵
146407,2014,陈越,2022-01-06 13:37:15,8,12,4,远离这个纯纯大傻逼
146412,2014,陈越,2022-01-06 13:52:31,33,39,6,选课的时候给教学科老师发火，说为什么是混合的选上了她的课，计院的没选上，还想把选上她的混合的踢掉。合着混合CS就不是CS了呗，选课没预置就算了，补选的时候还因为是混合所以优先级就比计院低，补选也很难补选上，还遇上这种排斥混合CS的老师？混合亲儿子，见谁都叫爹是吧。
146413,2014,陈越,2022-01-06 13:54:44,9,10,1,呵呵一笑
146484,2014,陈越,2022-01-06 16:15:51,-31,11,42,说句公道话：老师讲课很好的，互评虽然过程会有同学恶意打分，比较讨人厌但最后助教仲裁都会给捞上去的，最后的project大家都得到了应有的分数。\n\n关于pta卖题，老师本人并没有提倡我们去买题。再退一步讲，pta不买你们不还是得去文印店买吗？去文印店买的往年卷可以在pta上做两套了，你还可以用oj。\n\n最后，问各位一句：pta的运行维护不需要开销吗？这又不是学校给的钱，凭什么要求老师做慈善？平时让同学们免费用，期末你们自愿买了题然后回来喷老师？\n\n请各位求是一点，不要肆意发泄自己的情绪。老师的行为有不对的地方都可以理性提出，但人身攻击是真的屑。
146506,2014,陈越,2022-01-06 17:56:18,14,15,1,大傻逼
146513,2014,陈越,2022-01-06 23:09:18,-38,4,42,老师上课就不用说了，查重对于比较自闭独立的人来说其实也算个优势，大作业的互评至少fds班我觉得风气还行，有一次被人开盒，申诉写得好助教也给回满了。至于你满没满，反正👴满了。
146551,2014,陈越,2022-01-07 02:03:41,16,16,0,这个人就是脑子里有根筋转不过来\n\n极度自恋\n\n伞兵
146639,2014,陈越,2022-01-07 06:33:39,-7,3,10,我觉得 怎么说呢
146838,2014,陈越,2022-01-07 14:45:15,14,16,2,😅😅😅\n\n🖕🖕🖕
146977,2014,陈越,2022-01-08 09:05:39,1,6,5,讲课给分都没问题，其他的该说的其他同学也都说清楚了...
147006,2014,陈越,2022-01-08 11:37:25,6,6,0,真滴八行啊
147171,2014,陈越,2022-01-09 03:15:46,8,12,4,💩💩
147178,2014,陈越,2022-01-09 03:54:38,11,12,1,大烂人
147336,2014,陈越,2022-01-09 15:09:31,18,19,1,先说下没上过课，不清楚老师上课水平如何。但fds互评制度太恶心了，第一次project我傻傻写完就交上去了，虽然确实有些潦草，但有些扣分原因我不能接受，整个学期都在填那次的窟窿。提醒学弟学妹们，写fds报告前先去搜下互评细则，网上能找到的，对着那个写。还有pta试卷好贵，一份七块，都能吃顿饭了。至于在校内被狂吹的fdsmooc，说实话也就那样，ds有很多优质的网课和公开课资源，pta也不能算优秀的配套练习平台
147601,2014,陈越,2022-01-10 09:28:42,15,24,9,就DS授课来说是非常好的老师 入校以来听着最舒服的英文+尽力保证无人恶意评分的互评。\n\n\n\n为人还行，一些人说的歧视部分学生和不当发言至少这学期没有过。\n\n\n\n但是作为PTA高层、互评的始作俑者还有些黑料的老师来说，这个分数也是合情合理，学弟学妹们不知情可以多问问或者多逛逛某乎。\n\n\n\n建议选课放心选，毕竟选谁都逃不过互评。
147722,2014,陈越,2022-01-10 14:17:22,19,21,2,做的代码，就是过不去，本题第一句就是本题很简单
147814,2014,陈越,2022-01-11 02:23:49,-32,13,45,陈越讲课没得说，应该算是讲的做好的。\n\n查重确实很严，反正这学期不少就是因为抄袭挂科了，作业别抖机灵。\n\n互评的话，按我的3次pr基本没有恶意评分，就算有都会进入仲裁。\n\n最后ds能拿多少分还是要靠自己，老师讲的再好，你不学没用。
147857,2014,陈越,2022-01-11 04:20:46,9,11,2,互评。。。
147873,2014,陈越,2022-01-11 04:49:24,25,28,3,得了吧🙄\n\n自己当程序员去\n\n别他妈来教书了\n\n伞兵\n\n😅\n\n🖕
149668,2014,陈越,2022-01-16 09:45:55,10,10,0,就这😅
151170,2014,陈越,2022-02-24 02:56:38,11,12,1,傻逼\n\n真的脑残
151210,2014,陈越,2022-06-16 11:25:51,40,42,2,积点阴德吧您\n\n你是什么勾八人啊
151388,2014,陈越,2022-03-02 03:29:26,15,16,1,ads翻转课堂的话\n\n那要您有何用？\n\n这门课本身难度很大了，这样做会让很多人学的很痛苦\n\n1分不能再多了
151491,2014,陈越,2022-03-04 18:01:49,7,8,1,寄汤来咯
151573,2014,陈越,2022-03-08 06:36:50,7,7,0,每日一刷
151580,2014,陈越,2022-03-08 08:36:48,30,32,2,没上过她的课，对课程内容不评价\n\n单纯评价一下pat，如果有兴趣可以翻一下知乎微博，她对自己pat的评价，然后对别的计算机大赛的贬低，还有骂别人没有脑子的难听话。如果你想捞金，大家睁一只眼闭一只眼就不说了，还非得满大街宣传自己公司的考试有多厉害，非pat不可。吃相难看。
151671,2014,陈越,2022-03-17 03:56:59,49,52,3,密麻麻石蜡，陈睿叔叔是不是你本家？一家子都是这么掉进钱眼里的东西 \n\n——紫金港上单
151681,2014,陈越,2022-03-11 13:35:25,5,6,1,傻逼
152446,2014,陈越,2022-04-11 14:10:49,7,9,2,傻逼玩意 自己出个题能不能把题目要求讲清楚 真就把学生当狗刷呗
153504,2014,陈越,2022-05-02 13:50:25,-23,1,24,讲课讲的是真心不错的，学有余力的同学可选
154337,2014,陈越,2022-05-30 11:41:23,78,79,1,不会教书可以不教，互评促进学习？建议把查老师当作互评成绩，低于6分直接开除
154338,2014,陈越,2022-05-30 11:42:52,8,8,0,互评是个什么玩意儿？
154339,2014,陈越,2022-05-30 11:43:51,5,5,0,大傻逼
154759,2014,陈越,2022-06-04 15:21:04,6,7,1,如果不是冲突 谁会来...
155024,2014,陈越,2022-06-07 14:18:00,-7,2,9,干得漂亮
156323,2014,陈越,2022-06-19 05:18:13,17,21,4,cy，柠檬什么时候酸啊？
156324,2014,陈越,2022-06-19 05:18:59,8,8,0,人品和态度不行
159084,2014,陈越,2022-07-06 03:02:28,37,41,4,先来瞻仰一下大作：https://www.proquest.com/docview/304303006/abstract\n\n数学系PhD写这种玩意儿混毕业丢不丢人啊？怎么不拿出来互评一下？
159794,2014,陈越,2022-08-31 10:25:02,0,1,1,咕咚了
160062,2014,陈越,2022-09-12 14:25:08,1,1,0,傻逼东西搞你妈的互评
160137,2014,陈越,2022-09-13 17:43:23,4,6,2,自以为是，说自己和善却闭目塞听，谁要你那廉价的和善，笑里藏刀的和善？
160251,2014,陈越,2022-09-16 01:26:36,-25,2,27,不懂就问，评论都说pta圈钱，这是什么情况？期末考试真题要花钱买不是很正常嘛？是她卖的特别贵嘛？（顺便一问，这个卖法是她提出的方案嘛？）其实我一直在想，我们在各种网站上写题都是免费的，那谁替我们买网站运营和更新的单呢？
160254,2014,陈越,2022-09-16 02:01:18,3,3,0,沟通不了
160467,2014,陈越,2022-09-23 07:18:26,3,3,0,互评系统极其不合理，影响课程正常进行，加强同学之间的仇恨值，乐色
160468,2014,陈越,2022-09-23 07:20:37,0,1,1,垃圾互评系统。纯垃圾。不合理的东西没有经过实践的检验就拿出祸害学生。
160478,2014,陈越,2022-09-23 12:19:09,4,4,0,煞笔老师，不会说话可以不说，硬要当谜语人是吧
160547,2014,陈越,2022-09-26 15:06:21,2,2,0,陈越纯纯傻逼
160549,2014,陈越,2022-09-26 16:10:18,19,20,1,你妈的反转链表挂你🐎的人你户口本是不是只有一页
160555,2014,陈越,2022-09-27 01:15:46,7,7,0,恶心的互评制度，恶心的人，恶心的人用恶心的网站捞恶心的钱\n\n人品不太好，很自以为是
160563,2014,陈越,2022-09-27 03:28:18,2,2,0,矫枉过正 毁人一生
160587,2014,陈越,2022-09-27 12:33:13,1,1,0,nt互评
160604,2014,陈越,2022-09-28 01:42:16,3,3,0,什么nc互评
160605,2014,陈越,2022-09-28 01:46:12,3,4,1,互评的制度过于抽象，平添不少负担、猜疑和顾虑，建议取消。
160632,2014,陈越,2022-09-29 01:42:50,0,1,1,烂烂烂
160640,2014,陈越,2022-09-29 03:28:25,5,6,1,互评这玩意一旦破坏了同学氛围，人与人的默契就很难找补回来了，为什么不比谁家程序花活多啊，这么喜欢在满足程序要求上内卷吗
160653,2014,陈越,2022-09-29 10:28:45,2,2,0,太离谱了
160665,2014,陈越,2022-09-30 00:10:59,1,3,2,讲课就这样，听了和没听一个b样，作业还是不会做😅
160720,2014,陈越,2022-11-04 02:10:48,3,5,2,。。。大烂人
160753,2014,陈越,2022-10-09 13:33:34,1,3,2,不推荐，fds预置到她赶紧跑
160776,2014,陈越,2022-10-11 03:50:48,3,3,0,这么多最新评论怎么没有呀：）
160820,2014,陈越,2022-10-14 11:46:25,4,4,0,越想越气 1分奉上
161375,2014,陈越,2022-11-05 09:11:06,3,3,0,快跑！！！
161549,2014,陈越,2022-11-08 15:38:09,11,14,3,sb互评，sb pta，您那题目能不能描述的清楚一点，还有那函数题，本来题目描述就一坨shit，还要人在那东西上面写函数，自己连下标都不统一，又不说。\n\n建议预置的快润，不值得浪费你的一个学期的好心情在这sb身上。
162441,2014,陈越,2022-11-22 12:55:49,-24,3,27,对互评的制度不做评价，因为我也要在互评上跟助教扯皮再自己花时间反复检查错误，但是对打代码能力提升也不能说完全没有\n\n退一万步讲，cy老师水平人品还是合格的，至少比ljj这种人间之屑好了114514倍
162566,2014,陈越,2022-11-25 13:08:58,-53,7,60,唉，希望大家在看cy的评价的时候多一点理性。平心而论，cy讲课水平是好的，虽然有时候为了赶进度会加速然后说同学们下课自己看，如果你去问问题都会得到很好的回答。互评虽然有点严格，但是为了公平这也不无道理，知乎可查工高集体作弊，学院肯定得有人出来唱黑脸的。至于查重没过被挂的，你们哪里来的脸来喷cy，作业是不是抄的csdn自己心里没点B+树吗，一个程序题不写空着，最后影响最多是零点几分。根据诚信守则如果你只是问别人算法和思路也不算违规，只要自己写都不会被判的（并查集作业方法单一，交了之后一看网上有个很类似的代码，最后没判违规），老师和助教会再人工审一遍的，也会发在群里给你翻案的机会，这有啥可说的，诚信不是最基本的吗？
162649,2014,陈越,2022-12-02 02:11:38,5,5,0,别来这课
163169,2014,陈越,2022-12-08 19:54:02,6,7,1,客客气气给老师发邮件问问题从来不回
163178,2014,陈越,2022-12-09 03:22:51,8,9,1,又要发国难财了啊
163245,2014,陈越,2022-12-11 01:52:46,3,4,1,思想古板
163279,2014,陈越,2023-02-20 15:09:36,16,19,3,傻逼 就想恰烂钱是吧
163553,2014,陈越,2022-12-15 06:17:01,9,10,1,查重还算合理。互评实属恶心人，是不是都去买PAT给她送钱她才能饶了学生啊
164440,2014,陈越,2022-12-21 03:58:35,5,6,1,遇到过最恶心的，没有之一
165036,2014,陈越,2022-12-28 14:08:38,39,43,4,插句题外话，非人身攻击，此人面相就是那种阴险狡诈重利益且恨心重的典型，上课时候都不敢和她有眼神交流，仿佛要存心害你一样的眼神。而且她的脸越来越歪斜了，似乎是中风面瘫的前兆，坏人总会得到报应的。
165305,2014,陈越,2022-12-31 09:12:52,11,16,5,优秀的资本家\n\n合格的企业家\n\n差劲的老师\n\n不及格的“人”
165402,2014,陈越,2023-01-04 10:58:25,3,7,4,a very good teacher. Love from China~~
165653,2014,陈越,2023-01-09 06:29:39,6,7,1,坐标fds，虽然姥姥雷点很多（），但是要是不踩雷，必须承认姥姥讲的很不错，英语很标准，学到很多东西。给分也很不错，感谢姥姥。
165667,2014,陈越,2023-01-18 10:01:26,26,27,1,课讲的很好，单单看讲课绝对值十分。\n\n但是坑爹互评坑爹查重和坑爹oms只能让我打出1分。😥
165913,2014,陈越,2023-01-10 10:46:48,11,16,5,给分正常的\n\n我期中考94，期末考94，做的normal和两个bonus，总评98
167739,2014,陈越,2023-01-18 17:04:25,0,6,6,fds，感觉没有之前的评价里说得那么吓人。讲课可以打九分，英文很流利听起来很舒服；查重感觉只要不是完全对着网上的抄就不会被查杀，注意一下就好；互评确实恶心但是别的老师也都有；给分算偏好的那一档。总之，她的低分主要是在她的做人方面（pta恰烂钱，引入互评制度），如果只看授课学习这方面，cyll的课还是挺推荐的。
168211,2014,陈越,2023-02-03 05:19:04,7,10,3,听说下学期ads又要有大招了
171801,2014,陈越,2023-04-06 03:40:43,-7,3,10,非常好
172315,2014,陈越,2023-04-25 03:19:19,38,38,0,妈的30%注释呢，怎么填空题里一行都没有啊
173195,2014,陈越,2023-05-15 14:21:53,6,8,2,sb，弄个sb编程题 查验身份证 没脑子，rnmmp。
173373,2014,陈越,2023-05-22 03:40:41,-9,2,11,MOOC讲的也一般（特指ADS），后面算法分析学习路径真的有点陡峭，前面红黑树操作纯纯念PPT，P/NP一共差不多一个小时能讲懂啥，好多都是额外找了很多材料才看懂的qwq，不过单论翻转课堂来说上课非常有意义，cy非常好启发式问题，爱恨交加来自碧峰。另：cy平时加分多，给分好，小测和期中简单，还是比较推荐的，虽然别的班的难题很多也是cy出的，但是cy自己期中没用上。。。
175602,2014,陈越,2023-06-25 19:18:21,9,11,2,软工这b课是不是也是你搞出来的？
177037,2014,陈越,2023-07-01 08:33:44,6,9,3,2023春夏ads：翻转课堂的形式：第一节课不用来，学mooc的课，剩下两节讲课+讨论。课前测验基本都是mooc上做过的原题。一共8个project（做其中2个，2人一组）但是难度相差很大，很多人选了前面难的project费时费力成绩也不好，难的要做莎士比亚全集的倒排索引，简单点的在toplevel里面就能找到，最短的一个只需要50行代码。project整体难度是难——易——中。个人感觉互评的影响没那么大，完成了的平均都在17分以上（满分20）。上课回答问题作为bonus，期中考试难度一般（可覆盖）。给分还是不错的，平时分有1/3的同学都能拿满60，最低的也不会低于45。
180631,2014,陈越,2023-09-23 23:13:55,6,10,4,fds差一名被筛了，先给你打个1分
180740,2014,陈越,2023-09-25 14:13:56,7,7,0,诚信考试能不能死一死啊
181130,2014,陈越,2023-10-09 13:46:47,13,16,3,sb cnm 狗东西
181132,2014,陈越,2023-10-09 14:23:10,22,24,2,两句话的程序非要写一长串introduction，fds搞这么多稀奇古怪的东西，是不是水论文水的啊😓。选fds是来学习算法知识的，不是来浪费时间的。
181178,2014,陈越,2023-10-11 02:47:17,40,42,2,根据互评规则，chenyue在PDF文件中泄露了作者信息，故评为0分
181589,2014,陈越,2023-10-24 00:34:33,25,30,5,纯纯的砸种，早八小测我测你妈，提前一天22:46通知不知道这个点很多人都不看你吗的恼檀微信群吗？
181849,2014,陈越,2023-11-02 07:27:30,70,72,2,我个人认为，一个老师，如果做不到对学生最起码的尊重，而是挖空心思百般刁难学生，那它也很难得到学生的尊重。\n\n就比如说，如果一个老师想要给学生打低分，但不想直接承担骂名，那就可以在作业里面加上互评环节，鼓励学生互相扣分，然后将自己做的恶转嫁成学生内部的矛盾。如果学生抱成团互相打高分，还可以加一道高分仲裁。虽然这对于提升学术水平和专业技能毫无用处，只能浪费大量的人力物力，折磨学生，折磨助教，但它变态的施虐心理得到了满足，所以迟迟不改。\n\n说实话，如果把期末占比调高到百分之百，学生也许会骂，但至少不会有一种被侮辱的感觉，被堂堂正正地击败，和被心理阴暗的毒蛇暗搓搓咬一口的感觉截然不同。如果学生是因为专业知识的不完备而得到了一个较低的绩点，那学生自己还是有责任的；但如果学生是因为报告没有封面、作业没有readme文件、作业泄露了姓名、作业字数太少、作业注视行数不够百分之五十而被扣了分，我觉得，这就是形式主义，服从教育，不把学生当人看，一种对学生人格的侮辱，对学生时间和精力的浪费。\n\n从某种角度上说，这种老师也格外让人印象深刻。若干年后，也许会有今天计算机学院的学生，来到这种老师的墓前，拿笔写下：\n\n“墓志铭注释行数不足百分之五十”。\n\n没关系的。\n\n我会帮老师把笔迹擦去。\n\n因为这种工程不需要维护。\n\n这种代码也不需要可读性。
181861,2014,陈越,2023-11-02 13:43:14,38,40,2,很理解楼下的感受，但个人有不同理解。\n\n我也觉得作业查重理论上是好的，因为既然有了规则就要遵守，要有契约精神。我也觉得不记名互评理论上是好的，毕竟如果连作业匿名互评都接受不了，那走向社会又怎么能接受匿名投票呢？\n\n为什么骂她查重？因为有的老师不查不公平，她应该向其他老师开炮，直到统一查重，再去随便挂掉一个人。\n\n为什么骂她互评？因为中国社会的内卷程度太高，恶意很多，她应该去改变社会分配而不是在PTA上赚钱。\n\n她错在自己本身就是懦夫，却去要求孩子正义。
182052,2014,陈越,2023-11-09 06:15:31,32,34,2,年纪大了没有考核压力加科研能力不足导致她闲着没事干，让她把精力都放在天天琢磨怎么管学生上面，可惜管理能力也不足，强行要求大家遵循她心中的“公正”，把fds的课程设计弄得一塌糊涂。大言不惭地说着互评能让大家互相学习，实际上互相学习最好的方式恰恰是她最反对的开源。总得来说就是更年期+偏执症，如果你选她的课最好能保证你的行为完全符合她偏执的想法，不然当心被她的铁拳锤
182662,2014,陈越,2023-11-19 06:04:24,65,67,2,sb思吗东西，且不说这个互评机制是否合理，互评分数差距过大仲裁就算了，tmd95分以上还要仲裁？？你这么不相信学生的打分你搞你吗互评。自己还要求注释量到30%，自己PTA出的那题结构体定义都不明不白，也不按照书上的写，喜欢搞你那个沟⑧ppt，不知道你后面来个注释是能让你吗死灰复燃？查重查重，你咋不查查你血统里有多少和猴子重复的基因，还tm爱洋文，其实用洋文倒还好，你能不能那个变量定义洋文写明白一点，简写的歧义简直了，6奥。感觉是不是有点虐待症，看到同学们不爽自己就爽了。课程组的cx老师，zjk老师哪个不比牠好。家人们真别想不开。
183018,2014,陈越,2023-11-21 13:32:35,37,38,1,pta上买了两套卷子\n\n1、做完没有答案，只有对错\n\n2、要再做一遍还得再买一套，而且题目大差不差\n\n3、请问你是对标马化腾的吗
184419,2014,陈越,2023-12-19 08:42:50,1,4,3,姥/😀
184452,2014,陈越,2023-12-20 02:43:13,22,23,1,看了看cy当年的博士论文，和现在宁可错杀不可漏杀的诚信政策，只能说严于律人，宽以待己……有一说一讲课还是不错的，一直在bilibili和智云旁听cy的课，对我理解ds有很大帮助
184453,2014,陈越,2023-12-20 03:45:51,4,4,0,笑死我了
184462,2014,陈越,2023-12-20 06:15:09,10,10,0,没上过老师的课，听过她的大名，纯好奇，为什么感觉老师的嘴是歪的
184468,2014,陈越,2023-12-20 08:22:33,4,5,1,又上分了☺
185570,2014,陈越,2024-01-02 08:42:48,29,31,2,听cy的课是好的，选cy的课是坏的
186039,2014,陈越,2024-01-09 08:27:33,6,9,3,你这个老妖婆 什么时候退休啊
187207,2014,陈越,2024-01-15 04:51:46,7,8,1,傻逼。
187768,2014,陈越,2024-01-17 10:46:19,7,8,1,快跑，快跑，快跑
188275,2014,陈越,2024-01-18 14:20:00,0,1,1,所以cy班的FDS选了Hard的真的只能加到平时分里吗
188389,2014,陈越,2024-01-19 01:42:18,4,5,1,所以她的博士论文怎么了
190420,2014,陈越,2024-03-02 09:32:10,5,5,0,久仰大名，前来参观。
190716,2014,陈越,2024-03-15 13:08:33,49,51,2,强烈建议学习数据结构基础这门课！在这门课上，你能学到的是：\n\n1.翻译软件用法\n\n2.文档编辑技术\n\n3.废话堆砌技巧\n\n4.坑害他人阴招\n\n5.攫取利益途径\n\n6.七五稳赚不赔\n\n概括说来，无非就是：\n\n一筹莫展：二话不说，扣分三十有余，顿觉四面楚歌，令人五体投地，惊得六神无主，心中七上八下，十分甚至九分悲哀，百感交集，千辛万苦，怎敌他，零和博弈！
190994,2014,陈越,2024-03-27 15:55:02,23,29,6,彼阳若至，初升东曦。\n\n\n\n绯雾飒蔽，似幕绡绸。\n\n\n\n彼阳篝碧，雾霂涧滁。\n\n\n\n赤石冬溪，似玛瑙潭。\n\n\n\n彼阳晚意，暖梦似乐。\n\n\n\n寐游浮沐，若雉飞舞。\n\n你设计的fds真是一坨，上课几乎啥也不讲，下课出内个题？真把所有人当OI药娘了？每当做bydProject和作业，为了一堆grd没有任何意义的英文和充满傲慢的龟腚熬夜时，我都会怀念牛棚。你欠牛棚了。
191030,2014,陈越,2024-03-29 02:41:13,5,6,1,fds进度拉得最快，大程一周出奇迹，quiz想让你背誦代码，
192484,2014,陈越,2024-05-21 17:05:06,2,3,1,老谭。
193085,2014,陈越,2024-06-03 10:22:04,-41,5,46,那个说oi药娘的 我只能评价 菜就多练
194141,2014,陈越,2024-06-25 09:05:30,8,9,1,这软工做的啥玩意儿啊 计院怎么还不课改啊这都什么玩意啊
198124,2014,陈越,2024-09-01 08:26:39,5,5,0,久闻公之大名
199379,2014,陈越,2024-09-22 12:50:24,92,96,4,陈越小时候参加考试，发现想要参加考试就要先通过诚信测试，而诚信测试的答案必须上网查答案才能获取；通过诚信考试之后打算开考，结果发现试卷需要付费才能阅览；付了钱之后发现整张试卷全是空白，因为测试点是看不见的；蒙完了整张试卷，出了成绩一看是零分，原来试卷是同学互评的；向老师求情请老师来批改，发现自己的作文还是零分，原来是引用了名人名言被判了抄袭；不得不魔改全部名人名言，发现还是零分，原来是作文的注释不足百分之三十。
199435,2014,陈越,2024-09-23 13:00:14,5,7,2,pta团队天梯赛出的就是一坨，自己也表述不清楚，浪费我好久，纯纯沙币
201231,2014,陈越,2024-10-30 13:24:31,4,10,6,至少ADS的陈越老师值得8分\n\n编程作业就算全不写，也能靠bonus加回来。。。\n\n老师答疑也很积极，不知道为啥这么低分
203874,2014,陈越,2024-11-21 15:36:16,18,26,8,你就是个鸡巴\n\n\n\n有看到这条评论的，它死的那一天，你打我电话19012770986，我请你吃饭（如果不方便我可以V你50）
205095,2014,陈越,2024-12-01 10:47:26,4,5,1,pta上的题就他出的最恶心
206087,2014,陈越,2024-12-13 05:11:11,16,23,7,这几年cy的fds课改变还是挺大的.首先老师使用中文而非英文讲课.其次如果你课下去找她问问题，她会很耐心地给你解答.至于互评，现在基本都是由助教仲裁，基本不存在互评恶心人的情况.此外关于查重我想说上了大学要是连自己给出的不抄袭承诺都不能做到，就是人品和原则性的问题了，与老师无关.最后关于给分:实际上fds可捞的范围很小，而且cy的小测都是作业题，认真完成作业小测不会扣分，这一点算好的了.另外即使project做的是normal而不是hard，把两个bonus做了平时分基本能满.期末考试是拉开差距的重点，平均分可能只有70分左右.好好准备期末即可
206716,2014,陈越,2024-12-17 08:10:49,3,7,4,领先版本，虽然没什么用，mit的人接触的是yzh不是cyll，但还是给五分平衡一下
207611,2014,陈越,2024-12-23 08:46:14,13,13,0,陈越一定tm是个基督徒，因为它要求把ppt里的每句话当《圣经》（哪怕是错的）
208978,2014,陈越,2025-01-04 04:17:32,11,12,1,（引用98）助教A有一道题目出错了，在考试中途未进行订正。课程组成员B在考试结束后擅自修改了错题的题面，并且未通知先前考试的考生。A和B都应被判违纪
211078,2014,陈越,2025-01-10 14:04:06,13,13,0,有一个人只要在查老师上暴露姓名分就会被大伙根据诚信守则扣光，你猜猜是谁
213768,2014,陈越,2025-01-19 14:55:17,7,8,1,煞笔cy
214876,2014,陈越,2025-02-18 15:00:12,6,7,1,刚写完诚信手册，神人
214971,2014,陈越,2025-02-19 14:53:47,9,10,1,能做出诚信手册和互评这种抽象东西的也是神入了
215123,2014,陈越,2025-02-22 05:46:20,4,4,0,123
215231,2014,陈越,2025-02-25 00:04:47,0,2,2,666
215283,2014,陈越,2025-02-25 03:41:09,0,1,1,被查重了
215310,2014,陈越,2025-02-25 05:43:22,9,10,1,博弈论基础I【有预修要求：程序设计基础】
215373,2014,陈越,2025-02-25 12:23:07,3,4,1,有点恶心，先打个1分，学期末出成绩再说
215595,2014,陈越,2025-03-02 09:44:49,1,2,1,你无敌了
215659,2014,陈越,2025-03-03 14:30:50,1,3,2,好好好
215701,2014,陈越,2025-03-04 09:43:08,12,14,2,互评，而且不先发出来评分细则，不强调可能失分的地方，令人作呕。你是来教我的，还是来杀我的？助教的回复也含混不清，不回答问题只是叫你去看发的文件，有没有可能其实根本没写呢？
215731,2014,陈越,2025-03-05 02:17:47,6,9,3,辣鸡你
215853,2014,陈越,2025-03-06 03:46:40,13,16,3,傻逼东西 互评为了卷绩点盐都不盐了 直接给我评75 你看懂我代码了吗就在那指指点点 瞎几把说密码呢 还有这个互评制度 只有高度傻逼和固执的人才会想出它
215910,2014,陈越,2025-03-07 03:11:47,3,4,1,垃圾老师
215920,2014,陈越,2025-03-07 10:08:55,8,9,1,只能说，fds快逃。已经不是严不严格的问题了，而是莫名其妙的规定和一些只能让人顿觉心累的没有必要的东西。至于课程本身授课内容，不如自己看PPT和书去学。最后一句，老师，你真无敌了
215922,2014,陈越,2025-03-15 03:15:18,13,14,1,助力2.50，作为陈越的注释
215953,2014,陈越,2025-03-08 04:39:10,5,5,0,互评制度暴露出了非常多的人性丑恶
215960,2014,陈越,2025-03-08 07:26:09,15,15,0,Do you have anything to tell me?
216041,2014,陈越,2025-03-10 01:44:42,11,11,0,社交的手腕，识人术，暗黑心理学，人性的秘密
216123,2014,陈越,2025-03-11 00:41:24,3,6,3,高完整度的对一个工科学生的培养
216124,2014,陈越,2025-03-11 00:52:00,6,6,0,nt，小测不仅不提前说，甚至连形式也不告诉，十分钟谁能想到要写代码，快跑，不管因为什么课都快跑，很窒息很窒息
216185,2014,陈越,2025-03-12 02:14:51,0,2,2,煞笔。。。
216304,2014,陈越,2025-03-13 04:05:51,11,16,5,但是想补一句，互评制搞得很多人有点扭曲了，一个同学疑似因为自己互评被打低了最后仲裁终评拿了98然后在群里阴阳怪气，“我的分数可能污染了某些同学的眼睛”，真没必要吧，每个人标准不一样没必要觉得就是别人故意恶心你🤢🤢🤢
216373,2014,陈越,2025-03-14 15:11:57,-48,4,52,评论区黑cy老师的，你们水平有cy高吗？你们一群学生凭什么喷老师？就问你们cy师德有问题吗？cy查重问题很严重吗？cy有把学生随便挂科毁别人人生的行为吗？有高高在上审判学生的态度吗？有过吗？他又有违反校规随意制定挂科标准吗？有干天老大它老二的事情吗？没有吧。仔细想想自己说cy师德不好是不是血口喷人，人家作为一个老师还是遵纪守法的吧？如果cy真的因为一些小事做了能对你们人生产生严重不良影响的行为，那你们怎么做都不为过。但是因为听说cy人品不好就来骂人未免有些不合适了吧
216381,2014,陈越,2025-03-15 03:33:43,8,8,0,助力2.50\n\npr是蒸鹅心啊
216401,2014,陈越,2025-03-15 14:27:46,3,3,0,sb制度
216402,2014,陈越,2025-03-15 14:28:20,2,3,1,真是rz
216466,2014,陈越,2025-03-17 03:17:03,21,22,1,说我们是学生没资格评论老师的，这是什么平台？你tm给我翻译翻译，什么叫做tm的chalaoshi？\n\n你是cy本人吗？？？？？？\n\ncy搞的制度，我不管她初心是什么，这么多年所有人被恶竞、低效自学（因为github都是违规平台）困扰，而一直不改变，谁负主要责任？
216505,2014,陈越,2025-03-17 13:29:38,1,2,1,屎。。。
216670,2014,陈越,2025-03-20 13:20:32,9,9,0,做project2，先打个1分表示对互评的鄙视
216694,2014,陈越,2025-03-21 05:20:04,0,0,0,不嘻嘻
216719,2014,陈越,2025-03-22 11:39:17,4,4,0,始作俑者，其无后焉
216748,2014,陈越,2025-03-24 04:13:53,2,3,1,同做P2先打个1分泄愤
217085,2014,陈越,2025-04-01 12:56:50,8,8,0,互评好坏o(TヘTo)
217112,2014,陈越,2025-04-02 04:40:47,2,4,2,听课很享受
217198,2014,陈越,2025-04-03 19:40:59,1,3,2,只能说有点魔怔了
217542,2014,陈越,2025-04-12 19:01:19,1,2,1,纯\n\nnt
217617,2014,陈越,2025-04-14 07:08:11,2,3,1,依托史
218239,2014,陈越,2025-04-22 07:11:38,3,4,1,平衡一下，没必要扣\n\n没有想象的那么夸张，按要求来应该也不会有什么事\n\n期末出分再看看情况
218481,2014,陈越,2025-04-24 03:23:09,8,11,3,我真的服了，互评发现学生之间打的分高还要把分罚下来，请问您把学生当人看了吗
218677,2014,陈越,2025-04-28 15:23:37,0,1,1,不推荐
218738,2014,陈越,2025-04-30 04:43:56,0,1,1,早八上课前十分钟通知小测
219020,2014,陈越,2025-05-19 05:38:05,3,3,0,"3. 右手系、左手系是相对概念. 题目要求""不能建立左手系""是不合理的， 因为这相当于要求只有出题人认为的建系方向合理的\n\nλ(R^3)中的基底1， e1， e2， e3， e2e3， e3e1， e1e2， e1e2e3分别对应真标量， 真矢量， 赝矢量和赝标量\n\n可能e1^2 = e2^2 = e3^2 = 1 (G(3，0)， 此时(ab+ba)/2为真矢量a，b的内积) 或e1^2 = e2^2 = e3^2 = -1 (G(0，3))， 但(e2e3)^2 = (e3e1)^2 = (e1e2)^2 = -1\n\nG(3，0)与biquaternion代数同构"
219200,2014,陈越,2025-05-23 03:16:56,2,4,2,fds\n\n选姥姥的课其实没问题。要逃课的话，上课那天看看PTA上有没有小测（因为PTA的小测是前一天晚上十点多放出来的，不要错过了）\n\n然后查重其实你选姥姥也查重，选别的班也查重，总得是不敢抄的。互评也不光光是姥姥一个班有\n\n姥姥分低主要是因为查重和互评，并且查重和互评确实是傻逼没得洗。用不着焦虑退课。
219214,2014,陈越,2025-05-23 04:28:05,2,2,0,ads\n\n个人角度看，如果预置了没必要逃，cy老师的设计是每节课开头quiz，比较简单，大部分时间是讨论，然后提前一节下课。\n\n实际上这样理解会比单纯听课更深，不过缺点是看网课占用课余时间/你得听懂网课。\n\n同时ads的互评没有fds那么恶心，至少个人体验一学期没有被打过低分。
219250,2014,陈越,2025-05-23 10:55:53,0,2,2,推荐
219492,2014,陈越,2025-05-28 14:26:37,5,5,0,有没有人能教教我这个怎么听啊，我对这个非常感兴趣\n\nhttps://english.spbu.ru/news-events/news/professor-st-petersburg-university-radioactive-isotopes-platinum-jewellery
219583,2014,陈越,2025-05-30 07:11:44,2,2,0,姥姥人很好，课后都是亲自回答问题的，上课也很上心。
219943,2014,陈越,2025-06-11 20:09:30,5,5,0,可选规则：类似于桥牌，可以增加局况（vulnerability）的设定。首局游戏双方均为无局（non-vulnerable），后续游戏中的每局随机决定双方是有局（vulnerable）还是无局，可以有双方无局、南北有局、东西有局、双方有局（简称双无、南北、东西、双有，符号写作NO、NS、EW、BO）四种局况。在无局时，所有的赢分（完成墩数所得墩分和叫0成功的奖分）为上述介绍的得分×2，所有的输分（未完成墩数所扣墩分和叫0未成功的罚分，不包含超墩惩罚的扣分）也为上述介绍的得分×2；在有局时，所有的赢分为上述介绍的得分×3，所有的输分为上述介绍的得分×4。例如，南北作为无局方叫5墩，若完成则获得10分，若未完成则扣10分；作为有局方叫5墩，若完成则获得15分，若未完成则扣20分。超墩惩罚的扣分固定为−20分，不受局况影响。超墩数量的记录也与局况无关。若增加局况的设定，则需在计分表中记录每局的局况。（尚不确定增加这一规则的合理性，这里并不存在桥牌中的牺牲叫。）
220166,2014,陈越,2025-06-16 02:55:57,-6,1,7,仅讨论fds。客观来说，cyll给分还是挺不错的，没有做hard平时分也拿满了。所以放心选就好了。
220403,2014,陈越,2025-06-17 18:09:55,2,3,1,垃圾人渣
220407,2014,陈越,2025-06-17 19:59:37,0,0,0,r/m = 100 表示“使用 SIB”，r12 无法直接编码进 ModR/M 的 r/m 字段
221593,2014,陈越,2025-06-24 17:15:58,1,1,0,fds的话没传说当中那么可怕；感觉还可以 讲课蛮好的 就突然的小测总是个惊喜（bushi\n\n感谢姥姥捞了我呜呜呜
221736,2014,陈越,2025-06-25 16:50:12,-1,0,1,屎作俑者
22338,2052,鲁东明,2016-03-04 00:50:11,0,1,1,讲的很乱，根本没有在用心讲
23246,2052,鲁东明,2016-03-23 02:28:22,0,1,1,瞎讲，口音很重而且根本没有准备。\n\n上完之后还是得自己看书
25114,2052,鲁东明,2016-05-05 13:12:59,0,1,1,因为个人事情找别的老师代了好几次课，考前狂赶进度，真的差劲
85425,2052,鲁东明,2018-07-17 17:00:32,0,0,0,至少要写三个字哦
136217,2052,鲁东明,2021-06-13 02:39:36,2,2,0,这是唯一一位逼着我看完英文原著教材的老师
138365,2052,鲁东明,2021-07-12 16:05:09,7,9,2,助教给分真糟心
192204,2052,鲁东明,2024-05-11 14:08:39,0,1,1,Dynamic Programming 在课上的翻译是动态编程 [ac01]\n\n课上很多内容老师自己也是半懂不懂的， 怎么可能能教会学生.\n\n选了这个老师， 那就做好自力更生的准备吧.
196557,2052,鲁东明,2024-07-04 05:25:31,0,0,0,给分一般
196746,2052,鲁东明,2024-07-05 03:05:36,0,0,0,给分差强人意
196827,2052,鲁东明,2024-07-05 10:54:35,0,0,0,不知道平时分给的怎么样
197749,2052,鲁东明,2024-08-08 05:12:02,0,0,0,讲课也就那样，建议自学
217627,2052,鲁东明,2025-04-14 08:34:01,0,0,0,期中考最早，考得最多，要完蛋了
217629,2052,鲁东明,2025-04-14 08:37:22,-1,0,1,畜生里的出生。
221013,2052,鲁东明,2025-06-26 06:10:12,1,1,0,老师讲课确实不行，完全听不懂，跟同时段隔壁教室的lzx简直云泥之别。\n\n但对学生还是比较好的，好说话，stt助教姐姐也是人美心善，感觉要是不爱听讲选手还是可以选的\n\n建议平时下课之后或者期末周通听一遍lzx智云，牢鲁的课没必要听\n\n给分一般，感觉还是有点小伤心
48786,2114,王强,2017-03-13 03:44:58,7,7,0,老师敢不敢讲的再差点，爱你很难说出口?
85366,2114,王强,2018-07-17 09:07:39,2,2,0,上课差，给分也差
92566,2114,王强,2019-01-03 03:19:16,1,1,0,补空白
103819,2114,王强,2019-03-06 04:47:12,1,2,1,可以看出老师尽力了，很认真，只是教授方式不太能调动积极性
108174,2114,王强,2019-05-16 04:04:45,2,2,0,就是折磨\n\n
115434,2114,王强,2019-07-23 13:56:58,1,1,0,老师特别好，很认真负责！
124934,2114,王强,2020-07-21 15:39:01,1,1,0,编译原理讲的实在是一般\n\n
137193,2114,王强,2021-07-02 07:01:17,1,1,0,真的折磨
138993,2114,王强,2021-07-12 06:24:40,0,1,1,折磨，听不进去。给分好差！！！
152697,2114,王强,2022-04-18 11:57:47,0,1,1,老师的水平就那样吧，不过人还是不错的，给个6分吧。
158683,2114,王强,2022-07-01 09:13:44,3,4,1,平时分给的要不要再低点。
177356,2114,王强,2023-07-03 04:02:12,-3,1,4,给分还可以
177362,2114,王强,2023-07-03 04:27:55,0,1,1,讲课听不太懂，最后给分感觉也一般
177390,2114,王强,2023-07-03 06:13:25,3,3,0,第一节课还是第二节课点过一次名字，后面就没有了\n\n上课就只有念PPT，建议啃虎书中文书自学，很多知识只能说理解它很困难但是题目套路非常固定\n\n书上的作业有答案的，前七章可以直接查到，后面几章节是一个国外的网站上有答案\n\n大作业能早点开始就早点开始，省的后面极度痛苦（抱大腿另说），大作业验收不是很难（指王强班，如果是ly老师据说比较严格），主要是看你实现的效果以及问几个很基本的问题和分工情况。大程先验收后展示，验收在机房，展示是最后一节课拉到一个tx会议展示（看不懂的操作）\n\nquiz有两次，不算很难，可以用网页查，但不一定查得到，gpt亲测好几题都会写错，建议是能尽量自学跟上就尽量自学，不然就复制关键词到PPT看看符不符合原文\n\n今年考试题量非常大，但基础题的占比很高，想低于40分的斩杀线有些困难。其中大题主要集中在平时作业题，作业题即使是抄的考前也要好好看看。\n\n考试可以带三张A4纸，王强老师期中考是前七章，所以期末考准备剩下几个章节的A4就行，亲测正常写字也用不到三张。A4可以复印的，如果借的到大佬的A4打印出来也不失为一件美事。但手抄A4的时候也相当于复习了。
177432,2114,王强,2023-07-03 08:59:56,0,1,1,我以为我考得还可以，但是我的分数不高哇，跟其他班狂捞的比起来真的心有不甘。当然应该也有今年试卷课改，题量激增的问题
177444,2114,王强,2023-07-03 09:22:53,0,1,1,给分不好，小测和期中都比别的班难导致平时分低
177686,2114,王强,2023-07-04 08:38:20,0,0,0,讲课照念ppt 问题目一个不会 平时分大残 期末狂学也被绩杀
178377,2114,王强,2023-07-11 06:05:08,0,0,0,平时分确实低，别的班小测都是往年题，我室友全满分，我们班上90都不错了。
193555,2114,王强,2024-06-13 03:49:18,0,0,0,不会做人就不要做
196558,2114,王强,2024-07-04 05:26:06,0,0,0,给分属于一般水平吧
196748,2114,王强,2024-07-05 03:05:53,0,0,0,讲课讲的不是很能让人懂
196826,2114,王强,2024-07-05 10:53:31,0,0,0,给分也就那样
8822,2162,王总辉,2015-09-28 09:28:43,-1,3,4,讲课详细，但也有啰嗦之嫌\n\n
9627,2162,王总辉,2015-11-03 09:38:30,15,19,4,为人不错，讲课嘛。。。。他总是觉得你总会然后一带而过
11452,2162,王总辉,2016-09-19 04:36:10,6,7,1,呵呵。
13152,2162,王总辉,2015-12-25 03:30:57,-1,1,2,挺亲切的，实验课内容充实
14989,2162,王总辉,2016-01-11 12:23:50,-2,1,3,讲的很不错
21155,2162,王总辉,2016-02-23 09:23:48,-4,1,5,人真的挺好的，讲课还算靠谱，只少不会坑。
21169,2162,王总辉,2016-02-25 02:33:40,-1,2,3,挺萌的一个老师
35041,2162,王总辉,2016-10-31 07:02:32,-2,0,2,讲课不清不楚，经常花很多时间去逐个分析相似的实现，但课件什么的确实花了时间，实验课很有耐心
35242,2162,王总辉,2016-11-07 06:40:53,9,11,2,这个老师给人的感觉就是从来不备课。上课抓不到重点，没什么用的东西反复讲，重要的东西往往一带而过。而且真的挺啰嗦的。考虑到实验课时帮助同学还是很有耐心的，只能说是一个人不错，但是讲课不行的老师。
41235,2162,王总辉,2017-01-10 07:09:32,7,7,0,感觉全靠自学
42543,2162,王总辉,2017-01-14 12:00:33,7,8,1,全靠自学，他说我们都会的东西我真的一点也不会。。。
46997,2162,王总辉,2017-01-23 08:57:30,-5,2,7,讲的有点不清楚但是给分好到不行啊
47000,2162,王总辉,2017-01-23 09:00:58,-1,5,6,平时上课有点水，但是给分真心好
47002,2162,王总辉,2017-01-23 09:04:42,-17,3,20,你要问我给分有多好?划水一学期，绩点5.0，所以还犹豫什么，赶紧选王总辉啊
47029,2162,王总辉,2017-01-23 09:56:05,-20,3,23,随随便便5.0，硬件课就应该这么水，滋词一蛤
47034,2162,王总辉,2017-01-23 10:09:05,-1,2,3,给分好
47039,2162,王总辉,2017-01-23 10:27:14,-15,3,18,Quiz炸了，讲道理7分没了。最好4.8。给分真心好(￣∇￣)
49638,2162,王总辉,2017-04-21 01:41:19,8,8,0,讲课很恶心
94199,2162,王总辉,2019-01-15 14:33:53,3,3,0,是个人讲的都比他好
98318,2162,王总辉,2019-01-23 10:10:24,-3,1,4,很可爱的老师! 讲课也很不错，对于这门课相当认真!\n\n
98572,2162,王总辉,2019-01-23 15:04:17,-1,1,2,老师超可爱哈哈哈，“注：全是我改的”上课讲不太清楚，但答疑超耐心。
99822,2162,王总辉,2019-01-25 08:03:21,4,4,0,慎选。不会讲课，验收大程还爱挑学生的错打击人。说好讲小测题也没讲。不是很负责
132399,2162,王总辉,2021-02-01 09:46:41,5,5,0,讲课讲得很差，真的很差\n\n而且现在给分也不好了，其他班大部分上4，他给的平时分扣得很狠
132510,2162,王总辉,2021-02-02 05:23:10,4,4,0,千万别选，给分拉跨，讲课也不行，东西全靠自学，这种水平怎么敢来浙大的啊
132777,2162,王总辉,2021-02-03 14:31:43,4,4,0,讲课讲的奇烂不说\n\n给分为什么还能这么烂？\n\n真的无语了，服了，各位小心踩雷
138753,2162,王总辉,2021-07-10 16:25:58,2,3,1,老师的嵌入式系统虽然上课讲的没有很清晰但是人挺好的，顺便表白助教小姐姐🌹
141954,2162,王总辉,2021-11-02 02:25:38,3,4,1,连续两周考小测的骚操作大概也只有他做的出来了，他就不是一个正常人
148702,2162,王总辉,2022-01-13 09:03:20,1,1,0,老师是不是忘记要出分了？？？
150054,2162,王总辉,2022-01-18 14:51:28,2,2,0,讲课不清楚，会突击小测，最后给分也很拉胯
150061,2162,王总辉,2022-01-18 15:28:59,2,2,0,讲课虽然很认真但是讲不清楚\n\n给分很差\n\n问问题不喜欢回复
163165,2162,王总辉,2022-12-08 12:57:00,3,3,0,可能这个老师最大的优势是不点名吧。\n\n我向来是对老师上课水平和给分好坏不作太大计较的，但是作为一个老师你应该学会布置作业吧？三个chapter一起布置你想闹哪样？理论课说了要做实验，实验课ppt和guideline都不发你又是闹哪样？\n\n钉钉向来是已读不回，课后ppt也不上传，只能说和隔壁教学班差距不小。
165112,2162,王总辉,2022-12-29 07:27:09,6,6,0,一坨答辩
168046,2162,王总辉,2023-01-24 09:17:42,6,6,0,dinner
170400,2162,王总辉,2023-03-03 16:02:38,0,0,0,讲课一般般
171223,2162,王总辉,2023-03-19 11:13:15,-2,1,3,给分也没那么差
171663,2162,王总辉,2023-03-31 09:35:48,3,3,0,woc，从来没做过这么恶心的作业，嵌入式lab1逐行注释上千行的代码，我去，真不知道这作业是咋想出来的，太恶心了
175331,2162,王总辉,2023-06-24 02:40:45,2,2,0,嵌入式，快逃，三年以来上过最恶心的课，比软工还折磨
178186,2162,王总辉,2023-07-07 17:13:27,1,1,0,纯纯的建种
185912,2162,王总辉,2024-01-06 02:16:09,0,0,0,计逻，回回课前点名扣一分，突击发布作业扣一分，讲得不如隔壁好扣一分，实验课来搞人心态扣一分
189570,2162,王总辉,2024-01-25 12:08:38,-1,0,1,讲课确实一般，如果选上就自己学吧，实验认真做，大作业看看学长的，给分不会刻意为难
199824,2162,王总辉,2024-09-30 12:42:56,11,11,0,这短学期给分怎么依托答辩\n\n大家都是抄现成的代码，比啥？比谁报告写得好？我感觉我报告写得也挺好的，大作业得分也很高的，咋就这么几分
199836,2162,王总辉,2024-10-02 02:13:18,5,5,0,乱给分
199893,2162,王总辉,2024-10-07 11:54:46,3,3,0,想不清短学期为什么扣了这么多分
200048,2162,王总辉,2024-10-12 01:54:56,-1,0,1,sb一个
204637,2162,王总辉,2024-11-27 07:09:35,1,1,0,pop quiz  讲课还烂
204638,2162,王总辉,2024-11-27 07:10:17,0,0,0,人不错
205714,2162,王总辉,2024-12-11 11:52:57,0,1,1,老师人不错
205724,2162,王总辉,2024-12-11 12:28:33,0,1,1,人挺好的
207979,2162,王总辉,2024-12-25 06:20:06,-1,0,1,人挺好
207980,2162,王总辉,2024-12-25 06:20:37,-1,0,1,老师人还是挺好的
212121,2162,王总辉,2025-01-13 08:23:36,0,0,0,老师人还是挺好的，就是感觉上课内容和其他老师脱节了(实验的PPT是很旧的，理论部分也会有些内容没涉及)，给分也比较抽象。
212645,2162,王总辉,2025-01-14 10:31:02,0,0,0,上过的课：计算机体系结构\n\n点名情况：从来不点名，二十来个人的班每次只有七八个人去\n\n教学水平：感觉大家都不听课，我也是偶尔听了一下，没有前面的同学说的那么差，还是讲的挺清楚的。上课不论有没有眼神对视都会提问同学（只会问在场的同学，不会拿名单点），不影响成绩，有引导（他只是希望你学会）\n\n但是体系结构这个课考试范围是所有老师教的内容的并集，wzh老师有一章（DLP）没有讲所以我问的别的班要了ppt。\n\n实验验收会问的比较细（包括仿真和上板），尽早去验收的话验收分会高。\n\n作业不是很多，小测不会提前通知。我们这学期就做了两次作业，小测第8周测了1-3章，大概就是期末考卷难度（我没复习所以当时没做出来呜呜呜）\n\n给分的话我不是很清楚。我是88分4.2，供大家参考
215122,2162,王总辉,2025-02-21 15:44:17,8,8,0,短学期课程综合实践I（深度学习基础——理论与实践），补一下暑假忘发的评价：\n\n优点是理论和实验课都完全不点名，想去就去不想就旷（）；实验部分要自己写的部分很少，PPT上基本都给了；大作业想水过的话也可以参考已有的代码或AI跑生成的代码改一改，不像ds之类的课要查重（）；并且实验报告和大作业的提交期限很宽松，大作业的代码有问题、或不能很好地完成预期任务的话，助教会提醒你修改后重新上传（虽然定了ddl，但实验报告最后开了补交通道，大作业也是课程结束大概一周了，助教来提醒我修改重交hhh）。\n\n缺点的话有，用Python语言但对此没有任何教学，并且实验代码较长，没有接触过Python的同学可能会在实验上有困难（比如我）；实验报告和大作业情况不公开，评判标准不明（不直接公示给我们，但其实我也没去找老师问过）；想要高分的话也许需要卷一卷实验报告（做没有实际意义的事情）；出分拖了很久，助教好像是课程结束好几天之后才开始看大作业（）。\n\n就我个人的体验来说，感觉两周上得有点莫名其妙（？）可以说学到了一些关于深度学习、人工智能等的皮毛，但不太多，也有我太摆了的缘故吧，有时候起不来就干脆不去上课，就算去了也听课比较少，在下面干自己的事情（老师对不起）。实验也做得晕晕乎乎的，不过绝大部分的代码都是给好的，要自行完成的部分也就是填几个空，就算自己弄不懂，也可以厚脸皮去问问同学助教（）然后全丢给AI让解释一下代码含义，就能大概搞明白。实验报告方面我花的功夫确实不少，有去详细解释每一段代码在干什么（虽然大多文字来自AI），并结合原理等尽量写得详实一些，虽然肯定比不过大佬们，但也尽力了（）大作业的话就是东拼西凑水过去了，还因为准确度太低被助教打回来了一次修改重交（）最后有4.8，一同选课的其他两个朋友也获得了挺好的分数，不过身边统计学仅供大家参考，毕竟之前的评价里也看到了不幸被绩杀的同学们T_T
8969,2186,金波,2015-10-07 08:16:22,-6,6,12,讲的好啊\n\n\n\n
18092,2186,金波,2016-01-21 07:38:28,4,5,1,实在是……
18185,2186,金波,2016-01-21 08:53:56,-5,3,8,简直完美
19449,2186,金波,2016-01-24 08:58:00,-6,3,9,谁黑金老师我跟谁急(╯‵□′)╯︵┻━┻
30271,2186,金波,2016-07-01 07:15:51,-6,2,8,完美  完美
54230,2186,金波,2017-06-28 23:50:41,-5,1,6,很棒 给分很好
56886,2186,金波,2017-07-05 02:20:14,3,5,2,作业远超出承受范围，看每年的选课人数就知道了
73699,2186,金波,2018-02-02 17:01:09,-1,0,1,还不出分？\n\n
74013,2186,金波,2018-02-04 05:54:17,0,1,1,快出分吧orz
76938,2186,金波,2018-04-26 06:44:54,2,3,1,作业毫无意义
78524,2186,金波,2018-05-12 14:17:33,-5,2,7,我感觉金老师讲的还是挺好的，给分也很高，4.8/93，棒棒哒
80541,2186,金波,2018-06-27 15:10:54,0,1,1,不怎么样
85368,2186,金波,2018-07-17 09:18:14,-2,2,4,软件工程实践 给分很好 希望学弟学妹也要继续在互评时放下恶竞，互相体谅
86855,2186,金波,2018-09-19 05:50:05,16,19,3,"""现在经济下行，程序员大批大批的事业，严重到什么程度呢，我听说有的it公司呀，都直接倒闭了，代码员直接解雇了""""以后ai起来了，要你人来写代码吗"" 第一节课开始不到45分钟，金句频出。大家品一品?"
87699,2186,金波,2018-10-10 08:01:52,10,11,1,"""我一行代码都没写过，但我依旧是软件界的大佬。"""
91508,2186,金波,2018-12-12 05:23:35,2,3,1,上课回答不出来问题倒扣分
91518,2186,金波,2018-12-12 09:07:16,0,2,2,之前期待老师提问\n\n现在希望老师再也不提问
91534,2186,金波,2019-02-04 07:31:52,2,3,1,并没有觉得给分很好 可能满的都是组长吧 给分是相当随意 一个莫名其妙的问题给总评五分 一上课就点名 没来扣十分 作业的内容也给的十分莫名其妙 下午宣布课程结束晚上又来了作业 成熟度模型什么的感觉一学期上下来没人知道是啥 这课开的是相当匪夷所思
92913,2186,金波,2019-01-05 14:36:39,3,4,1,随缘点名 缺一次课扣10分总分
93678,2186,金波,2019-01-11 12:48:00,6,9,3,他和邢卫是我经历过所有老师里中最恶心、最傻逼的东西
100614,2186,金波,2019-01-26 12:01:37,9,9,0,给10分。为什么？和董玮比起来，这老师至少给分厚道，知道自己没教什么，觉得给大家应该分好一点，董玮呢？辣鸡董玮，比lowsir还low
108480,2186,金波,2019-05-26 13:41:43,0,1,1,????????????????
112748,2186,金波,2019-07-05 02:03:00,1,1,0,“绝对不止996或者997”
121959,2186,金波,2020-01-26 02:22:09,1,1,0,讲课真催眠，我一个学期就第一节课抬头看过一眼，不过给分很好。
124424,2186,金波,2020-07-01 03:03:43,4,4,0,15天布置这么多任务，我杀你🐎
132467,2186,金波,2021-02-01 17:20:47,7,7,0,软件工程管理课程本身挺水的，就是和软件需求工程联动的文档挺麻烦。给分特别好，比起隔壁煞笔邢卫好了几百倍
132469,2186,金波,2021-02-01 17:39:09,2,2,0,我给老师打10分 这不比隔壁傻逼xw给分好多了
873,2187,陆汉权,2015-03-18 07:16:06,11,49,38,男神！！！上课很虐但是给分很好！！大学以来最难忘的老师！！上课绝对不水绝对有用！！一年了无比怀念！！真爱！！
908,2187,陆汉权,2015-03-18 15:48:40,2,10,8,好老师，没说的\n\n
1447,2187,陆汉权,2015-03-22 04:27:08,-12,6,18,上课太水了，全靠自学。逻辑均绩4.1吓哭了。
1740,2187,陆汉权,2015-03-24 02:28:02,0,7,7,棒棒棒~有人说他是绩杀完全不是好吗(>﹏<)，作业略多，不水，上课有趣，棒棒哒~
1844,2187,陆汉权,2015-03-26 01:48:17,1,6,5,权爷
2153,2187,陆汉权,2015-09-13 11:31:42,0,4,4,好
2257,2187,陆汉权,2015-08-11 02:17:10,22,34,12,权爷给人的体会真的经历过了才知道！
2467,2187,陆汉权,2015-05-04 07:02:04,0,6,6,霸道总裁s我TAT
2905,2187,陆汉权,2015-05-10 23:30:23,21,28,7,告诉你什么是大学课堂，什么是大学。
3064,2187,陆汉权,2015-05-13 10:47:44,3,9,6,讲得不错～下午9、10节的课喜欢说晚上好……
3567,2187,陆汉权,2015-06-17 01:35:37,2,7,5,权爷有种悠然心境
3773,2187,陆汉权,2015-06-18 02:33:05,11,25,14,其实可以算不点名啦 给分好\n\n真的很霸气 特别有大神的感觉  前面听课没认真 有点惭愧 有次作业忘做去找他说 竟然特别慈祥地和我聊家里的事
3879,2187,陆汉权,2015-06-17 07:17:38,2,9,7,莫名其妙来个课堂测验……我不太喜欢。
4156,2187,陆汉权,2015-06-18 02:32:30,9,16,7,总喜欢说“我不懂英语” 然而。。。被虐
4863,2187,陆汉权,2015-06-30 02:13:31,4,15,11,计基和java都是权爷的，大学能有一个陪着你两个长学期的老师多不容易啊～他能很好的引导学生自己去学～点赞点赞～
5179,2187,陆汉权,2015-07-05 14:37:06,0,6,6,儒雅！可爱！有点儿腹黑
5216,2187,陆汉权,2015-07-06 01:36:03,-4,1,5,权爷很风雅，喜欢跟学生交流，教的也很好～
5872,2187,陆汉权,2015-07-09 16:33:35,0,3,3,能陪伴一整个学年的老师真的很难得，何况权爷又是个超赞的老师！太幸糊！就是期末三百分的试卷太虐人╮(╯▽╰)╭
6606,2187,陆汉权,2015-07-16 08:33:17,-4,3,7,很喜欢开玩笑但是人超级好
6610,2187,陆汉权,2015-07-16 09:47:25,1,4,3,好老师没说的，教的好，给分高！我大计基和Java都是陆爷爷带的。
6637,2187,陆汉权,2015-07-16 16:59:40,-4,2,6,很不错的
7227,2187,陆汉权,2015-09-11 13:18:05,0,4,4,好老师，大学第一位改变我的老师。讲课很好，好好学给分不错。
7432,2187,陆汉权,2015-09-14 11:00:03,-4,2,6,赞\n\n
8323,2187,陆汉权,2015-09-18 10:08:27,0,5,5,虽然我成绩不好但是他太帅了太帅了太帅了
10456,2187,陆汉权,2015-11-19 02:37:44,0,4,4,第一堂课还打了领带  男神  第一次坐一个学期第一排的课
12334,2187,陆汉权,2015-12-23 08:27:23,3,11,8,有意思的小老头 （他的口头禅就是“有点意思”）老师挺负责的 平时作业还好  会有两次课堂quiz 期末的时候会让大家把题目再从头到尾做一遍\n\n
12412,2187,陆汉权,2015-12-23 08:15:19,3,8,5,哈哈哈，可惜以后没有计算机方面的课了，权爷真是好样的，儒雅、腹黑毫无违和感，让你知道什么是大学，虽然总喜欢拿我名字举例子嘿嘿
13788,2187,陆汉权,2015-12-31 03:46:07,-2,5,7,最喜欢的老师，喜欢他的性格。对学生特别好。态度认真就可以得高分。如果抱着消极的态度就要小心了，权爷是会记住每个人的。
15892,2187,陆汉权,2016-01-16 14:03:07,-4,2,6,上课有趣，从来不觉得累；老师人超好
18843,2187,陆汉权,2016-01-22 15:32:17,9,10,1,真是老古董…
19951,2187,陆汉权,2016-01-25 15:46:32,-2,4,6,老师很棒，基本会记得班里的每一个人，作业会比较多但能学到东西，给分一级棒，拯救了我可怜的均绩，谢谢老师～～～
21715,2187,陆汉权,2016-03-01 01:20:48,-7,1,8,虽然给分一般 但是是非常好的老师
21921,2187,陆汉权,2016-03-01 16:41:47,-4,2,6,真的能学到很多东西，虽然作业挺多的，给分也很好
25073,2187,陆汉权,2016-05-05 07:16:41,1,3,2,=_=
26935,2187,陆汉权,2016-06-21 17:06:07,-1,1,2,我总是心太软~
28480,2187,陆汉权,2016-06-28 09:17:48,3,6,3,给分超级良心，对于考试只有一句话，他说好好看样卷，是真的……
30045,2187,陆汉权,2016-07-01 00:55:40,-4,2,6,上了一年权爷的课。虽然作为纯文科生本人计算机很差但是还是莫名喜欢权爷的课堂。
31267,2187,陆汉权,2016-07-03 13:38:20,-4,1,5,讲课清楚 思想丰富 作业适中 给分不错
31280,2187,陆汉权,2016-07-03 14:03:06,-4,2,6,两门计算机课讲得轻松有趣，又能收获很多东西，平时事情多但给分相当好
31381,2187,陆汉权,2016-07-03 23:44:43,-1,2,3,虽然学得很烂但是是很耐心的老师，给分好得不要不要的
41117,2187,陆汉权,2017-01-09 08:41:56,-4,2,6,老师衣服穿的见过的老师中最时尚。很帅。老师很好
47259,2187,陆汉权,2017-01-25 02:41:39,-5,2,7,给分超好 每次都穿衬衫打领带来上课特别有仪式感 上课有点奇妙但是作业完全不含糊
47352,2187,陆汉权,2017-01-25 10:58:11,-4,1,5,大计基上课略水，作业略多，应该课程问题吧，都这样。。。给分好，人也很好。
48527,2187,陆汉权,2017-03-06 14:38:28,-7,1,8,好萌啊。
57376,2187,陆汉权,2017-07-07 04:56:29,-12,3,15,权爷太可爱了哦ouo
60291,2187,陆汉权,2017-10-16 17:53:09,7,10,3,为什么查作业的时候那么凶
64283,2187,陆汉权,2017-12-22 08:11:37,18,20,2,完全不知道重点是什么
64286,2187,陆汉权,2017-12-22 08:23:07,41,51,10,刚过期中，谈谈感想\n\n首先说优点，上课的节奏很慢，有一些小幽默。据说资历十分老，故水平肯定是高的。\n\n然后是我认为的缺点：开始几星期的课，讲的云里雾里，声音也是梦幻到不行，无处不跑题，又轻轻松松地说，“啊，回到正题”。反正本人极易被催眠。\n\n可能是反映过的原因，后来课堂稍微好点，没那么多水了 。但每节课必拖堂，至少拖10分钟，拖完道歉，下节课继续拖……\n\n现在还没到给分环节，但是就我本人而言，这位老师引发不了我一丝一毫的上课激情和好奇心，所有的知识点，只是知识点而已，也毫无结构统筹可言。\n\n另外，喜欢在课上点同学的名字回答问题。经常同一人叫到10 几次……\n\n
65891,2187,陆汉权,2018-01-10 03:05:48,-13,2,15,特别好的老师，人也很好！
74048,2187,陆汉权,2018-02-04 13:36:37,-19,1,20,基本没怎么听过课 老师上课水水的 期末开卷考也很水 第一个满?谢谢老师anyway
74406,2187,陆汉权,2018-02-20 01:17:06,-13,1,14,上课主要是启迪思维。平时作业认真做，然后考前把课本看扎实了，自己都弄懂了，给分就很好！
76559,2187,陆汉权,2018-04-14 16:28:56,81,87,6,你永远不要期望作业上的内容有他讲过的东西\n\n更不要期望他能系统的给你讲清楚计算机\n\n
77393,2187,陆汉权,2018-05-05 09:26:14,-14,2,16,上学期大计基绩点出来意外的好？？？\n\n这学期java课对权爷彻底改观。可能是大计基本来就水的原因？有种“物是人非”的惊奇体验。\n\n从这学期JAVA课来说，很明显的每节课输出的实战知识增加了很多，上课还是喜欢叫人回答问题，也算一种点名吧。然后居然居然居然不拖课反而提前下课了（中途无休息）！！！\n\n上课过程中老师玄学的几率也大大降低，怀疑和上学期不是一个人……而且开始散发个人魅力了，有一种调皮又儒雅的可怕感觉……\n\n平时有上机作业，事不算多。PPT喜欢用英文，会有系统的结构整理。喜欢每节课埋下小问题，之后想的起来就提问，答不出来就威胁考试，被萌晕……\n\n反正，很神奇地黑转粉了。
78866,2187,陆汉权,2018-05-16 02:50:33,10,12,2,上课有逻辑么…英语是自己编的吧…我听懂了么…
80267,2187,陆汉权,2018-06-23 15:56:07,-15,1,16,好太棒了
80268,2187,陆汉权,2018-06-23 15:58:54,-14,0,14,特别好的一个老师
80547,2187,陆汉权,2018-07-10 11:01:26,-14,0,14,超级棒！！！！！！
82430,2187,陆汉权,2018-07-08 07:25:28,-14,0,14,喜欢引导你自学，人很有趣。
93165,2187,陆汉权,2019-01-08 02:12:27,-12,0,12,喜欢哦
96089,2187,陆汉权,2019-01-20 12:41:20,24,24,0,我只是来吐槽大计基的书的，，真的感觉没什么逻辑性\n\n?
103372,2187,陆汉权,2019-02-27 14:57:47,-2,1,3,平时虐，但给分不错
104112,2187,陆汉权,2019-03-12 08:15:11,30,31,1,说实话，大计基什么都没有讲，美其名曰“真正的老师就是让学生自学”。感觉大计基上课完全在浪费时间，还经常跑题。目前JAVA稍有改观，但依旧讲的很散，提问的问题也都很迷，比如“JAVA程序是什么”这种东西。建议大家还是自学吧。
105516,2187,陆汉权,2019-04-16 02:37:10,20,21,1,上课不讲课，满嘴跑火车，什么都得自己学，还要随机点名不能翘课？？？小测时长都不说明，说收就收，您难道不能提前说一句时间给人做题的安排吗？？？
106824,2187,陆汉权,2019-06-21 03:22:03,3,7,4,只会让我们自学 xjb小测每次小测都不通知 可以看笔记但不能看电脑 我tm笔记在电脑上啊?
110212,2187,陆汉权,2019-06-24 14:01:31,0,3,3,蛮推这个老师的，但是有时英文讲得不怎么好，谢谢老师不挂之恩！
110213,2187,陆汉权,2019-06-24 14:08:42,-2,2,4,喜欢在课上说英文，但是说的并不怎么样，英文有时候也会spelling错误，但是看他一把年纪了就不纠正他了。 上课有时候会说有点意思的额外知识。总体来说感觉是不错的，谢谢老师不挂之恩。
114784,2187,陆汉权,2019-07-11 17:14:45,-1,2,3,陆老师和助教都超好！非常乐意回答问题！并且感谢助教在结课后还一直教我解决难题，真的太太太感人了！！
117433,2187,陆汉权,2019-09-24 08:37:19,2,6,4,当初选课的时候也没有要求，上到第三周突然说大陆学生选这个课得不到分数，也不给通融，都大四了这三分再不拿就要延毕了，我恨ZJU
119980,2187,陆汉权,2019-11-17 02:57:09,13,15,2,老师水平应该是很高的 但是大计基这这种基础性课程的上课风格我个人受不了。讲得比较散，经常扯到别的问题上。上课完全不把握节奏，重点有时候下课拖堂的十五分钟草草收场，留给你自己探究。 总之如果你计算机水平和我一样菜，希望能有一个老师更踏踏实实地讲一点基础带着你学的话不推荐陆老师
120593,2187,陆汉权,2020-01-13 13:45:07,11,14,3,趁还没出分评一波。但凡他讲课的时候有一点是按照课本或者ppt讲的我都不会这么后悔上了这门课。复习课真的很好，讲的都是要考的。可是我上这门课不是为了考试啊。讲一点实际的知识点有那么难吗？上权爷的课就自学吧。
121297,2187,陆汉权,2019-12-23 11:02:39,41,41,0,好吧，I'm sorry，又浪费了大家的时间。
121652,2187,陆汉权,2019-12-10 11:13:40,9,11,2,倒也真不是我有什么偏见，大学不是高中，拖堂会打乱学生整个的学习以及上课的节奏，从一开始让我以为是忘了看表没听见铃声到后来直接说你们也知道我拖堂然后开始拖堂quiz，越来越失望，下学期还要上他的Python，希望有干货吧
122153,2187,陆汉权,2020-02-17 11:15:49,63,70,7,我非常不理解为什么给竺院人文社科班的学生配这样的老师，也许老师带专业学院的学生更好一些吧。但最竺院人社的课真的不上心，完全没有上课的样子。东拉西扯，不知所云，故意刁难。课堂上收益甚微，如果全靠自学，那我何苦要考浙江大学呢？所谓自学，应该是老师指引，学生自己修行。如果连指引都做不到，那你的课堂未免失败之至。
128243,2187,陆汉权,2020-12-15 03:44:44,3,5,2,上课拖课乃是必备，2节可上成3节课，作业内容不教，念书可还行
128617,2187,陆汉权,2020-12-24 16:12:01,2,5,3,晕头转向~
128625,2187,陆汉权,2020-12-25 00:52:29,-4,1,5,emmm上权爷的课一定要认真积极，自己预习复习，权爷上课讲的实质性东西没那么多，更多地是一种指点性的，然后需要自己课下努力去学，但是权爷人真的很好  而且给分也不错~有些大project还会让助教哥哥姐姐去给我们答疑(实质上就是帮我们做出来)
132341,2187,陆汉权,2021-02-01 02:01:29,5,6,1,大计基上课真的水，作业超多且超难，平时分还可以的我被期末全英文试卷拉惨了…～呜呜
133301,2187,陆汉权,2021-02-24 05:00:22,-12,2,14,其实老师人挺求是的，只要努力就能有收获的课。老师上课是不怎么讲知识，但是大计基的东西自学完全能学下来吧，对英语的考察也没有那么难啊（你要是这些都看不懂四级怎么考的）。所以总的来说，老师是希望我们自己学的，只要自己好好学就一定能被他看到眼里，有好成绩。
134476,2187,陆汉权,2021-03-29 15:26:24,-4,5,9,陆老师绝对是真男神！为人亲和没有架子，学术水平很高，选他你绝对不会后悔！！！
134477,2187,陆汉权,2021-03-29 21:41:08,-18,2,20,浙大最优秀的老师之一。
142446,2187,陆汉权,2021-11-11 12:44:50,15,16,1,上他的课我感觉自己是个小丑
145801,2187,陆汉权,2022-01-02 12:12:49,-15,2,17,课程计算机科学基础，从上课时的不经意流露，可以感受陆汉权老师学术方面高深造诣，老师为人亲切，课堂幽默风趣。\n\n计算机科学基础应算是一门通识课，学一些知识挺好的，认真付出，就会有收获。学弟学妹加油呀！\n\n（如果坚持每节课坐第一排且认真与老师交互，会触发隐藏剧情o
146192,2187,陆汉权,2022-01-05 18:53:25,-15,3,18,有趣的老师
148173,2187,陆汉权,2022-01-11 17:40:22,-21,0,21,感谢老师！
158200,2187,陆汉权,2022-07-13 06:56:20,-33,6,39,是所有竺院人社同学在整个大学阶段当中最喜爱的计院老师，没有之一。权爷的大计基和py，每一个人社人的不二之选🙂🙂🙂
159315,2187,陆汉权,2022-07-14 02:55:41,-8,1,9,男神！！！
160257,2187,陆汉权,2022-09-16 02:30:08,7,7,0,讲课好迷，没有框架逻辑，歧视非人社的学生，第一节课就说这些学生上课评分会低，说虽然你认为按能力成绩给分合理，但你（学生）的认为是没有用的，书还尚可，稍微有点逻辑，课程吗，呵呵
160305,2187,陆汉权,2022-09-18 11:40:49,3,4,1,说好的小测三次机会为什么后面几次都是前一次减0.1啊
160446,2187,陆汉权,2022-09-23 00:20:50,16,17,1,竺院人社理科生表示甚至不如高中信息课或者知乎讲得好 除了学了些自制英语
160722,2187,陆汉权,2022-10-07 05:11:11,4,8,4,汉权老师的课是不错的，作业是牛马的，没基础慎选
160742,2187,陆汉权,2022-10-08 14:58:35,12,15,3,smjb\n\nChinglish题目还拼写错误？！\n\n你给我出英文题我也不用这么费劲啊\n\n还有带小数点的二进制数
160812,2187,陆汉权,2022-10-13 10:45:07,6,7,1,作业太多
160852,2187,陆汉权,2022-11-06 14:47:46,5,6,1,事是真的多，说的也不清楚，作业考试和课堂基本没关系
161124,2187,陆汉权,2022-10-27 16:18:48,5,6,1,讲得太混乱，作业很杂
161125,2187,陆汉权,2022-10-27 16:28:56,3,4,1,事情好多
161414,2187,陆汉权,2022-11-06 17:10:55,11,12,1,不想说什么了，作业巨多，基本上每周专业课都没时间学就用来应付他了。上课从PPT到作业全是英文的，您到底是英语老师还是计算机老师啊？怎么不在大英课堂上看到您？本来那些专业名词就不理解，还要先过了翻译这关。给您分期付款十分好评好吧？
162214,2187,陆汉权,2022-11-22 12:57:11,4,5,1,好的，知道浙大数据库建设花了很多钱了\n\n个人觉得不如自学，至少书比课堂有逻辑
162754,2187,陆汉权,2022-12-05 15:12:38,3,4,1,上课的内容和作业考试没有任何关系
164049,2187,陆汉权,2022-12-17 12:20:27,6,7,1,规定很多，但是别无选择，有选择的赶紧润
164657,2187,陆汉权,2022-12-22 15:07:13,9,13,4,各位同学:\n\n\n\nProject展示安排已经在钉钉群里通知了。这里说一下展示注意事项， 时间控制在5分钟之内就行 (1)不用PPT，先简单介绍你改进(创新)点，打开project报告文档就行了。(2) 运行你的程序，解释数据分析结果。\n\n\n\nTA学长和我都会认真阅读你们的报告，运行你们的代码，其后有问题会邮件或钉钉中联系的。\n\n\n\n有幸和你们一起学习计算机，我也有成就感。你们都是非常优秀的学子，未来的Leaders。祝同学们学业进步!\n\n\n\n陆汉权
165461,2187,陆汉权,2023-01-06 11:38:43,6,6,0,快跑！！！！
168133,2187,陆汉权,2023-01-30 01:08:25,-1,3,4,给分好
168138,2187,陆汉权,2023-01-30 03:42:16,-6,2,8,老师很耐心负责，有问题给老师发邮件都会耐心答疑解惑，不得不说老师知识确实渊博，只不过我理解能力确实挺一般🤣再说同学们最关心的给分问题吧，好多绩点4.5的，给分超好，放心选😘
168148,2187,陆汉权,2023-01-30 07:07:50,-2,2,4,虽然上课听不懂，课后题目做得很痛苦，但老师很和蔼，期末考不算难而且给分真真好
169299,2187,陆汉权,2023-02-25 09:31:37,6,6,0,上课不知所云，平时学习全靠自己看书，考试全英文，英语单词、语法错误一堆，很多时候看不懂他想表达的意思...作业还多
170034,2187,陆汉权,2023-03-01 05:33:13,13,13,0,给分很不错，但是上课基本上没有用，很催眠，作业又多又臭，还是全英文的（关键是这老师英文水平一塌糊涂）
170898,2187,陆汉权,2023-03-11 13:21:14,-9,2,11,超级好的老师。有东西，很敬业。也是个大好人。我第一学期差一点儿就退学警告了多亏跟老师求了求情没挂科
172076,2187,陆汉权,2023-04-26 06:21:15,13,16,3,不会英语可以不用，别出来恶心人。中文不好就滚出拆那，别说句话人工智能都看不懂。不会出题就别出，别扣了分还不改。不会开玩笑就不开，别拿着别人的尊严开恶臭玩笑。逼老头，不会教可以混职校，别祸害浙大人。
172976,2187,陆汉权,2023-05-10 15:08:39,3,3,0,弃了弃了，run！，速速！
173426,2187,陆汉权,2023-05-24 05:39:53,2,2,0,不想说什么了
174565,2187,陆汉权,2023-06-14 06:39:35,6,6,0,怎么说呢，如果不上他的课，我自学Python的效率是90%的话，上了他的课，我的效率就变成了60%，他会给你加上debuff的(つಥ㉨ಥ)
176681,2187,陆汉权,2023-06-29 16:42:27,3,6,3,很nt，真的很nt，都给我去选他的课，真的是大nt，这么好的老师不冲？学py的同时还能学英语还能释放情绪，老师真的很好，非常的cs，是我见过最cs的老师了，以后还要选他
177022,2187,陆汉权,2023-07-01 15:07:33,-3,2,5,一般，还行
178180,2187,陆汉权,2023-07-07 15:56:48,3,5,2,讲课毫无章法，喜欢阴阳怪气，要不是竺院人社只能选他的课，我早就逃了
180948,2187,陆汉权,2023-09-28 17:18:26,10,10,0,好爱这个老师啊，很会英语哦 PPT上的英语80%的语法错误 可以拿来当英语改错写
180987,2187,陆汉权,2023-09-30 15:29:07,17,17,0,太抽象了，有同学问他作业怎么通过纯手写控制页面边距为标准word格式，然后不知所云，最后说“不妨搜索一下这不是难的问题”这种问题要是搜的到谁会问啊靠！！！！
181333,2187,陆汉权,2023-10-15 03:10:54,5,5,0,上课可听可不听，莫名其妙，作业跟课堂毫无关系
181527,2187,陆汉权,2023-10-21 06:15:57,8,9,1,他嘴巴里输出的语言全是狗屁不通的，俄罗斯老师教出来的毫无章法和布满语法错误、讲出来让启真湖下面沉着的东西都觉得恶臭的英语；通过这种狗屁不通的，俄罗斯老师教出来的毫无章法和布满语法错误、讲出来让启真湖下面沉着的东西都觉得恶臭的英语输出的知识和布置的作业毫无关联；上课对着一个不知道哪儿来的视频讲一节课，根本不知道到底讲了个啥，发个笔记本下来让我们课堂记笔记，这不搞笑吗？要不是预制的这个课就逃吧！！！！
182006,2187,陆汉权,2023-11-08 02:07:57,5,5,0,垃圾呵呵
183049,2187,陆汉权,2023-11-22 01:16:47,5,5,0,有病 布置作业多 上课讲的和作业毫无关系
183540,2187,陆汉权,2023-11-27 07:59:33,7,7,0,这位老师个人的学术和编程水平极差，为人怪诞，逆天发言多，作业无用冗杂，专门恶心人
184122,2187,陆汉权,2023-12-10 06:12:11,3,4,1,不会英语可以不拽，不会计算机可以不教
185270,2187,陆汉权,2023-12-27 12:32:33,-2,4,6,大计基H\n\n我还挺喜欢lhq的，虽然是全英文，虽然是看视频讲解，但是作业不多，都在学在浙大上面，\n\n文科生，课内课外作业编程主要靠自学，在自己努力上b站看论文最后终于用raptor解决该死的n皇后的时候很有成就感\n\n助教基本解决不了你的编程问题，但会给你他的思路\n\n在有些时候会觉得他是个可爱的老头\n\n在不小心电脑息屏导致测试中断并被告知不能补交的时候，会很难过
185414,2187,陆汉权,2023-12-29 03:22:41,3,3,0,ppt是一个东西，讲课是另外的，小测又是另一个，书也是另一个东西，下课不休息还拖堂，作业截止时间很迷
189869,2187,陆汉权,2024-01-31 17:01:31,7,12,5,大计基H在今年相比大计基甲真的是一股清流，开卷！总体事情有点多，但给分好！平时作业的分占比比较低，主要还是几个大作业以及期末考试。而且还能通过笔记加分，可以考前补下笔记。大作业的话其实都可以搜到，是深圳大学计算机基础的作业题，估计老师直接就抄过来了。总之不用和平时作业和课堂小测精神内耗，像我这种平时基本不听课的也能拿4.8
190574,2187,陆汉权,2024-03-09 13:20:45,2,4,2,建议这种傻逼老师赶紧去死
190820,2187,陆汉权,2024-03-20 06:00:30,0,2,2,cnmb的傻逼玩意，去si吧你
190931,2187,陆汉权,2024-03-24 18:57:48,2,3,1,有些老师的计算机水平真的还不如大四学生\n\n慎选，nt老师
190968,2187,陆汉权,2024-03-26 07:37:42,0,1,1,傻逼傻逼傻逼傻逼
191000,2187,陆汉权,2024-03-28 00:54:22,2,2,0,烂！！！！！
191160,2187,陆汉权,2024-04-10 03:57:19,1,2,1,死！！！！
192711,2187,陆汉权,2024-05-29 06:14:31,1,1,0,难绷绷
192943,2187,陆汉权,2024-06-01 04:26:10,2,2,0,抽象大作业，题都讲不清楚，怎么做
193010,2187,陆汉权,2024-06-02 11:58:56,-1,2,3,给分是真的好
193331,2187,陆汉权,2024-06-06 12:07:15,5,7,2,大傻逼
193429,2187,陆汉权,2024-06-10 14:37:18,3,3,0,说他史都觉得是在硬夸
193791,2187,陆汉权,2024-06-18 07:46:43,8,8,0,从授课内容来看，概念与理论强，但是实际用处并没有。讲课云里雾里，作业要求高，难度大，基本需要全部自学。
195264,2187,陆汉权,2024-06-27 13:47:24,3,5,2,考完python，终于基本和计算机课永别了\n\n很抱歉我从来没听过一节课——但是在考试前把所有PPT都抄了一遍之后，发现那该死的全英课件竟然也别有风味\n\nreview，preview，thinking question\n\n好像是老师的精神带着我把没上的课又给补了一遍——讲起来充满感动色彩，但是你每一页都要开着百度翻译英转中，再英汉互文抄到纸上的时候真的很逊\n\n关于十二小时速通python（H）这回事（我连蒙特卡罗别名都抄下来了hhh.）\n\n不过最get到陆汉权的时候居然是今天在考场，他检查到场学生，给没来的同学打电话的时候\n\n他真的，我哭死\n\n早知道不把一年的游泳课都排在他的课前面了\n\n尽管不能下次一定了
196352,2187,陆汉权,2024-07-03 04:51:29,3,3,0,出个分跟便秘一样
197156,2187,陆汉权,2024-07-08 08:30:08,3,4,1,讲课抽象，但是给分极好
197330,2187,陆汉权,2024-07-11 03:20:13,2,2,0,讲课抽象
197810,2187,陆汉权,2024-08-14 09:26:27,7,9,2,虽然都在骂，但是权爷真的很有人格魅力
198269,2187,陆汉权,2024-09-06 03:48:11,-3,2,5,陆老师人挺好的，也挺随和。讲课会比较抽象且让人不太想听，但给分挺好的，最后还特地抽一节课给我们划重点。总体还是认真负责的
198952,2187,陆汉权,2024-09-13 10:37:22,4,5,1,sb别选
198956,2187,陆汉权,2024-09-13 10:56:50,0,1,1,如果一间房间里有希特勒，墨索里尼，和lhq，一把枪两颗子弹，我会选择杀lhq两次
199759,2187,陆汉权,2024-09-29 05:49:57,13,13,0,我想了一晚上为什么他能站在那里讲课，不是我想明白了，而是天亮了。
200175,2187,陆汉权,2024-10-14 12:51:42,3,3,0,呃 难评。。。
200732,2187,陆汉权,2024-10-21 14:23:14,2,3,1,能不能别布置那么多的作业？我不是畜生\n\n答案给不全就别布置作业，什么意思？
201328,2187,陆汉权,2024-11-01 00:06:40,9,9,0,台风天卡点签到太6了
203893,2187,陆汉权,2024-11-22 00:34:51,0,1,1,计算机基础的老师有一颗教你计算机领域中所有知识的心，呵呵
205972,2187,陆汉权,2024-12-13 02:28:39,3,3,0,如果你已经会Python了，可以来选Python（H）刷刷分（毕竟又主修又H），老头给分还是很好的，如果不会的话，恐怕都得自己学，挺费劲的，还是别选了吧（）
207053,2187,陆汉权,2024-12-21 10:17:40,3,5,2,说真的 很有思想很有情怀的一个老师\n\n我要是什么都会 然后听着玩 肯定很有意思
208321,2187,陆汉权,2024-12-27 01:24:44,1,5,4,别的不说，就冲权爷说cc98网站是他做的（cc98历史可以查到），就应该给10分
212563,2187,陆汉权,2025-01-14 07:56:49,1,1,0,不知所云
213397,2187,陆汉权,2025-01-17 07:51:51,2,3,1,虽然上课非常抽象，英文PPT也是奇葩，课上讲的、书上写的、作业留的和考试考的可以说没啥关系（不过考试和作业关系还算大点），但是如果你笔记记得好的话就能得不错的分。所以好好记笔记吧，省得期末检查时痛补好几天。给分是不错的，所以打9分。
213421,2187,陆汉权,2025-01-17 09:11:23,2,3,1,老师其实讲课喜欢扯东扯西，但是给分很好还会给你很多加分的机会。教评系统没给老师打好分有点愧疚来查老师弥补一下🤧🤧🤧
213972,2187,陆汉权,2025-01-22 08:29:01,1,3,2,陆老师是非常体贴学生的老师，会在台风天开定位的点名，会让学生写计算机的手写作业，会留没讲过的作业，会用上交笔记加十分来告诉你不交是要扣十分的。本来还对于老师给分存在一丝的幻想，但是现在这个幻想也没有了。所以我来报答老师的恩情了。
214942,2187,陆汉权,2025-02-19 08:03:38,1,2,1,虽然上课不怎么能听懂，但是权爷真的超级亲切，超级有趣，给分超级超级好！
215555,2187,陆汉权,2025-02-28 06:49:25,-2,1,3,老师很有魅力。虽然英语有点差，上课胡言乱语，作业也有点抽象，但还是把我诱骗去接着上一个学期他的课，不知道这是种什么魔力。\n\n不给差评，学非工科自然科学的要理解看似不太教得懂人的教学方式。
215733,2187,陆汉权,2025-03-05 02:38:12,0,1,1,几乎每节课都要签到点名。每次上课坐最后两排都是要被说的。\n\n学在浙大上quiz是不会发的，还会说你不会用学在浙大。quiz的截止也是无前摇的，测个两三分钟突然截止不让你提交。\n\n上课是学不到什么东西的，天天讲什么美国川普，什么国际大事，别人不知道的还以为他是政治家呢\n\nquiz是全文科的，能把一个理科的Python课上得这么文科也是一种实力。作业还有写文科小作文哈哈哈哈。\n\n 就一逆天老头，什么样的人都可以在浙大教书了
216174,2187,陆汉权,2025-03-11 12:36:38,0,1,1,永远不要期待他给你讲会什么东西
221582,2187,陆汉权,2025-06-24 15:43:44,0,0,0,平时上课依托，全靠自学，但是给分强无敌。\n\n系统依托，做小测的时候卡出去真崩溃吧，但是给分强无敌。\n\n作业依托，全是bonus根本做不过来，但是给分强无敌。
26438,2220,王巍贺,2016-06-18 12:52:39,3,4,1,酷爱萝卜车【黑脸】
93815,2220,王巍贺,2019-01-14 02:04:13,7,7,0,非常可爱
125767,2220,王巍贺,2020-09-14 06:33:22,4,4,0,挺不错的
127025,2220,王巍贺,2020-11-03 04:38:18,0,2,2,非常好的老师！
130780,2220,王巍贺,2021-01-24 14:19:11,3,4,1,可爱的老师
187437,2220,王巍贺,2024-01-16 06:52:25,-1,0,1,点名少，事情少，给分好！敲可爱滴！
190584,2220,王巍贺,2024-03-10 12:42:25,-4,1,5,byd，就你会拖堂
194129,2220,王巍贺,2024-06-22 06:11:08,0,0,0,形策给分挺好的，背了一天4.8
194619,2220,王巍贺,2024-06-24 15:33:58,2,2,0,可以的
198667,2220,王巍贺,2024-09-29 02:25:45,1,3,2,老师真的很好，甚至会提前下课
211364,2220,王巍贺,2025-01-11 08:49:28,0,0,0,老师太好了！
211369,2220,王巍贺,2025-01-11 08:56:56,0,0,0,爱你老师
211626,2220,王巍贺,2025-01-12 05:03:18,0,0,0,老师真的很可爱，并且给人一种很儒雅的感觉。德法给分真的好，感谢老师！
212503,2220,王巍贺,2025-01-14 05:57:37,-2,0,2,给满了，平时不用听，签到要签，期末写得越多越好
212888,2220,王巍贺,2025-01-15 07:20:32,0,0,0,不错的老师
220063,2220,王巍贺,2025-06-14 11:19:51,0,0,0,形策翘课被阴两次 背了一天好多没背到4.8
27289,2251,寿黎但,2016-06-24 13:00:59,-5,2,7,平心而论寿老师的OS讲的还是挺好的，算是全英授课的里面质量较高的吧
33973,2251,寿黎但,2016-09-24 03:24:22,-4,0,4,翩翩君子～讲的很细致，听他的英语是种享受～
42944,2251,寿黎但,2017-01-15 13:02:11,-4,1,5,老师讲的很好啊，只是应试的帮助不多
54379,2251,寿黎但,2017-06-29 08:25:06,2,2,0,2222
59737,2251,寿黎但,2017-09-26 10:15:06,-3,0,3,不错哦
60220,2251,寿黎但,2017-10-14 03:54:04,-6,0,6,英语一级棒
60823,2251,寿黎但,2017-10-31 01:46:15,3,7,4,听课半学期，先来评价一波。老师笑容很亲和，为人很礼貌，有涵养。大爱他的英语口语，听了满满的英伦风啊！可惜我对os不太感兴趣，学的不好。。。
69757,2251,寿黎但,2018-01-25 10:27:03,5,8,3,老师超棒！对课程内容超懂，讲得超好超具体！英语也特别棒
71859,2251,寿黎但,2018-08-27 02:58:47,12,19,7,英语好个屁啊...根本管不管你听没听懂，反正瞎往下讲。平时分给的很低，期末绩点很低
82384,2251,寿黎但,2018-07-08 04:51:57,1,1,0,就是期末跟平时上课？？
98509,2251,寿黎但,2019-01-23 14:00:55,8,9,1,平时分给的有点狠了…上课重点不突出，平平淡淡。老师气质不错，人也挺好的，不过os还是jjm稳吧……
98538,2251,寿黎但,2019-01-23 14:36:15,2,2,0,感觉给分有点低了。。。老师人还是不错的\n\n
98549,2251,寿黎但,2019-01-23 14:43:59,4,4,0,很糟糕的体验 。给分不好
98551,2251,寿黎但,2019-01-23 14:48:01,4,4,0,想刷绩点的话慎选。记得去听xyj的复习课。
98627,2251,寿黎但,2019-01-23 16:16:10,3,3,0,给分不好，平时分太低了。问了助教结果不回复。老师人还不错。
98830,2251,寿黎但,2019-01-24 03:47:51,6,6,0,考试内容必须自学，听课体验还可以，平时还要做一个论文展示，事情比jjm老师班多，但是平时分给的超低。实验报告可能需要写得一级棒才行!重视实验报告
130929,2251,寿黎但,2021-01-25 09:08:27,3,4,1,平时分给的太低了吧，好狠呀
131440,2251,寿黎但,2021-01-27 13:39:36,3,6,3,慎选！！平时分给的真的很低很低
131474,2251,寿黎但,2021-01-27 15:45:40,0,0,0,【就我一个想知道大家咋知道平时分的吗\n\n如果是平时作业的给分，感觉确实不高，但也不知道最后是咋算进去的2333
131831,2251,寿黎但,2021-01-29 04:27:31,1,1,0,老师人很好，讲课很清楚。但是平时作业要求比起其他非教改班要硬核一些，而且平时分比较务实。考试的话也不会给画重点啥的。总的来讲就是如果想学点东西可以选，但是为了水个好分数事情少一些的话还是慎选。最后给分其实还挺好的，主要看考试成绩吧。
166340,2251,寿黎但,2023-01-12 04:04:15,0,4,4,OS出分看老师两年没有评价了来给老师评价一波。老师人非常好，平时很儒雅，在实验出了非常离谱的bug时愿意提供帮助，而且可以看出对于操作系统的理解是非常深的（虽然平时没怎么听吧），就是上课的语调略催眠，有点难以让人集中注意力。而且助教也非常非常好，可能都被我折磨疯了还在帮我找bug（当然那个实验框架本身就挺离谱就是了）。\n\n至于之前说给分差的，我考完时以为要挂了，而且lab6还没做，结果被捞到了一个非常离谱的分数（怕被喷就不说了）……总之体验还是比较好的，个人比较推荐
166669,2251,寿黎但,2023-01-13 08:15:19,1,1,0,老师很好，会耐心解答我愚蠢的问题(线上线下都是)，而且可以看出老师水平很高。有3次突发小测，平时作业很少。做了lab6(bonus)但是还是没有满，可能期末没考好？总之老师挺好的，我认真学下来把bonus做了拿了4.8，付出和收获是成正比的，推荐寿老师。
167542,2251,寿黎但,2023-01-17 07:16:34,1,1,0,好老师，课讲的不错，小测会在课前半个小时通知，除了小测以外不点名。实验要求比较高，助教验收会问的很细，但是给分还是很不错的
169931,2251,寿黎但,2023-02-28 13:31:02,2,2,0,我觉得老师人很好，其实讲课水平也很不错，可能听起来有点平淡，但是仔细听感觉老师其实对知识点的理解很深入，今年平时分感觉给的还挺不错的，小测也会提前通知。
187424,2251,寿黎但,2024-01-16 05:20:54,3,4,1,出分了，来给老师评价一下。\n\n寿老师讲课风格很儒雅，看出来水平很高，对学生也非常有耐心，印象里没点名，小测就是正常的安排，会提前通知。\n\n最后成绩出来，看得出来是捞了的，分数比预期的好，感激老师！\n\n学弟学妹们可放心冲
187565,2251,寿黎但,2024-01-16 14:56:29,3,3,0,寿老师讲课不算是特别有趣味的那种，可能听起来会略无聊，但条理很清晰，理解起来没有难度，老师也很乐于和大家讨论答疑\n\n实验只要自己认真做了，验收的时候肯定能讲出来+满分通过的，小测也会通知，平时分非常友好，大家不用担心页面显示的均绩，可以放心冲
212766,2251,寿黎但,2025-01-15 01:10:54,1,2,1,温文尔雅，讲课很清晰，人也很好，助教更是人非常好，也狠狠捞，给分非常好，大家放心冲！
212938,2251,寿黎但,2025-01-15 10:00:44,0,0,0,狠狠捞，感恩助教和老师
214149,2251,寿黎但,2025-01-25 15:51:05,1,1,0,大三四门专业课，should老师是讲课最好的一个，老师人也很儒雅，对系统理解很深。给分比较捞，助教实验验收也很负责地给大家解决问题。推荐选！
8773,2278,何晓飞,2015-09-26 05:31:35,3,3,0,来上过一次课应该
61629,2278,何晓飞,2017-11-19 11:15:41,4,5,1,看来没人知道这个老师，网易年度ai风云人物35位候选人之一，12月初揭晓最终名单。绝对大佬。
86429,2278,何晓飞,2018-09-16 02:46:10,0,1,1,很好！！！
10645,2299,张克俊,2015-11-21 10:43:20,-40,8,48,比较负责，但是没有什么新东西
10714,2299,张克俊,2015-11-23 02:59:25,24,36,12,男神，讲课幽默风趣，受益良多！
10728,2299,张克俊,2015-11-23 03:36:48,20,26,6,男神老师，上课很有趣，而且干货多多！
11128,2299,张克俊,2015-11-24 11:27:54,22,25,3,男神，特别负责任。但是曾经漏了一节课没去，课后看ppt什么都看不懂。作业有点多的。
11599,2299,张克俊,2015-12-07 08:54:18,17,21,4,超有意思的
34519,2299,张克俊,2016-10-12 12:02:39,25,29,4,俊哥2333333来自萧宾的问候～
105304,2299,张克俊,2019-07-28 18:19:14,-19,17,36,sb.
105461,2299,张克俊,2019-04-14 13:11:12,10,15,5,太好了
105827,2299,张克俊,2019-04-21 12:32:33,-15,10,25,设计思维这课其实挺无聊的\n\n不知道老师的迷之自信怎么来的
108870,2299,张克俊,2019-06-03 11:48:02,-10,12,22,设计思维与创新设计不建议选。\n\n作业挺多的，然后每次布置的和交收的要求都不一样。小组作业突然变个人作业了。mooc也一开始说参与一下，最后发现全部要参加还算分。\n\n课程内容和大作业对外专业比较不友好。
109171,2299,张克俊,2019-06-11 05:37:55,12,19,7,正能量的老师啊，很有想法也很会鼓励人，上课可以上的很开心！
110515,2299,张克俊,2019-07-28 18:19:21,-16,14,30,经常点名，作业巨多，要求从不说清楚，朝令夕改，通核体验感巨差，傻逼老师
110656,2299,张克俊,2019-07-07 05:00:49,0,9,9,给分差
111091,2299,张克俊,2019-08-03 06:30:20,4,15,11,全程高能，上课体验很不错，课程很不水！！！
111128,2299,张克俊,2019-06-30 03:46:18,16,22,6,考试出分前来评价下今年设计思维通核课。上课非常开心，一个半小时一气呵成，邀请的老师水平也都很高，涉猎各方面知识。正能量多多！今年貌似是老师第一次开通核，和学生们交流也很多，作业会根据大家情况灵活调整和减少，但是还是很想说作业量挺大！想水过的学弟学妹慎选！最后想说，老师上课真的是很不错，很有风格和魅力。
113408,2299,张克俊,2019-07-06 17:07:41,-4,6,10,给分差
113418,2299,张克俊,2019-07-06 17:12:15,-4,6,10,给分差
113437,2299,张克俊,2019-07-06 17:20:07,-12,8,20,给分烂，事情多，上课无聊，通核大坑，排雷
113536,2299,张克俊,2019-07-06 23:18:17,-3,12,15,通核给分太恶心了！\n\n脸上笑嘻嘻，心里mmp
113604,2299,张克俊,2019-07-07 01:05:58,-9,11,20,好吧，虽然绩点不好，我还是尽力客观评价一下：1. 上课总体体验不错，老师比较能讲，张老师邀请的其他老师和苹果工程师的课程也很有意思 2. 讨论课基本是展示作业 作业多，基本每周写1000字，讨论比较无聊，加上慕课，好好做的话事情很多，想要分就多发言 3. 绝大多数teamwork 4. 期末考试整倪马呢？？？开卷考照搬慕课上的题，比谁能猜着你心思就给他加分？？？新出一份卷对课程负责不好吗？这种题配用来当作期末考试？？我不想辱骂老师但这种做法着实恶心
113639,2299,张克俊,2019-07-07 01:41:21,21,29,8,虽然绩点一般，我也来客观评价一下。1）课程教学水平和体验很不错，看得出很用心，上课不困，学到 很多；2）作业有点多，上半学期好几次团队作业要写1000字论文，下半学期会轻松些；3）讨论课参与需积极，得像专业课那样付出，很不水！！！4）MOOC尽管只有10分，需谨慎deadline；5）期末考试开卷比较简单，属于复习型考试，给分也给力。\n\n\n\n希望学弟学妹们做好思想准备，能学到东西，付出也得多。
113734,2299,张克俊,2019-07-07 06:37:21,9,14,5,超级棒！
113738,2299,张克俊,2019-07-07 07:04:21,9,15,6,男神！\n\n上课认真负责，虽然作业量大，但是好好做下来的话的确会学到很多！
113741,2299,张克俊,2019-07-07 07:06:17,8,15,7,张老师上课很有趣，课程内容涉及范围广，我通过他的课堂学到了很多知识，棒棒哒！
113930,2299,张克俊,2019-07-08 01:15:42,-16,9,25,给分差，事情超级超级多，课讲的一般
114594,2299,张克俊,2019-07-10 23:40:04,3,14,11,老师挺不错的，但是我上这门通识核心课的感觉是这门课本身并不是以人为本的
115391,2299,张克俊,2019-07-21 00:53:34,12,16,4,设计思维通核体验很不错，老师们教学水平没得说，收获很大！我的绩点似乎被正态了：（（（啊啊啊！
119083,2299,张克俊,2019-11-10 07:02:01,18,21,3,上课内容很棒，任何专业都适合听的。大作业是设计一个App，如果下次能够有一个选题的方向或者迭代过程的跟进就更好了！助教小姐姐们非常美丽负责，大赞！考试比较水，认真学mooc都能拿高分！
136643,2299,张克俊,2021-06-22 10:57:59,12,13,1,张老师的课干货满满，很有趣，上课也比较轻松，作业量不多。
141839,2299,张克俊,2021-10-27 12:04:42,11,11,0,老师很棒，干货多，很负责、很谦虚，会和我们分享他自己的成长。正能量老师，给分也很给力哈哈
141846,2299,张克俊,2021-10-27 15:57:51,12,12,0,启发性强，Workshop很有趣，作业量适中，现在是和MOOC结合上，内容很丰富，需要投入较多时间，收获很大！老师很为学生着想。
142089,2299,张克俊,2021-11-05 12:12:10,19,20,1,非常开心的一次通核体验，老师上课好像还拿奖了。考试基本不用怎么准备。
153727,2299,张克俊,2022-05-09 11:55:57,-10,5,15,事情真的好多，新技术激扬传统文化这选题也太限制了
156964,2299,张克俊,2022-06-21 12:39:25,13,13,0,很负责 很人性的老师！！
156994,2299,张克俊,2022-06-21 13:20:59,19,20,1,从一些细节处可以看出来，老师的教学和他所讲的设计思维一样，是以人为本的。作为通核，老师这门课的定位很清晰，事不多，只是为了开阔学生的思维和眼见。而从结果来看，这个课的目的达到了。自己也了解和学习了很多有关创新创业的知识。 难点在于想法的构思，也就是去自己个性化的构思一个东西。而当这个想法想清楚之后，这门课可以说就结束了。 没有莫名奇妙的论文，有几次小组展示，也很锻炼人。 作为通识课而言，它的性价比很高。感谢张sir.
156997,2299,张克俊,2022-06-21 13:30:01,15,15,0,呜呜呜谢谢老师！老师人很好很可爱！虽然事情有点多但是也是为了我们最终成果能够更好！学到了很多东西！
157544,2299,张克俊,2022-06-23 16:27:52,17,17,0,非常开心的通核！张sir教学水平没得说，点名是为了记住每个学生的名字，助教也很赞！
158778,2299,张克俊,2022-07-02 04:19:08,7,7,0,课程流畅，体验杠杠的。没有小作业但有进展和中期检查汇报，会资助大家买资料学习。老师们很用心，很以生为本。考试开卷，有五个开放式问题，认真听课的话，回答起来问题不大，不过很锻炼写作，好久没写这么多字了嘿嘿！
159093,2299,张克俊,2022-07-06 05:12:46,7,7,0,学到了很多！最愉快的通核！
159254,2299,张克俊,2022-07-09 11:12:02,10,10,0,课堂很棒，时间过得很快，MOOC简单，考试虽然开卷但不容易。助教也是很用心。
159306,2299,张克俊,2022-07-11 23:44:18,0,2,2,给分挺好的，事不少
163660,2299,张克俊,2022-12-16 02:14:46,11,11,0,老师人超好 讲课也有趣 课程比较硬不水 三人组大作业，我们组几乎一半的学期都在不断修改选题，老师很看重你去做一些真正有意义的项目。喜欢设计、喜欢思考的人不容错过！真的能够学到很多 还接触了UI设计哈哈哈 不过缺点可能是会有高年级大佬碾压（我是大一上的，4.2也还行）但是真的能收获很多
169215,2299,张克俊,2023-02-24 16:26:55,4,4,0,清晰流畅~~~
170448,2299,张克俊,2023-03-05 05:00:17,6,6,0,听了两节课，通识课体验开心。
170449,2299,张克俊,2023-03-05 05:08:39,4,4,0,重点突出，吸引人。会劝退想来水水的。作业量看样子不大，有点期待
173890,2299,张克俊,2023-06-04 06:48:44,12,12,0,图灵班的《信息与交互设计》，全心全意为学生成长考虑，非常赞的老师！
174611,2299,张克俊,2023-06-14 13:20:17,1,4,3,男神，一定可以学到很多东西，上课也很有趣，队友还很大佬..嘿嘿
174620,2299,张克俊,2023-06-14 14:59:09,5,5,0,《设计思维与创新设计》通核课是个宝藏！我本来想水过，但是欲罢不能！非常负责，干货满满的正能量老师！课程精彩！分数还没出，但已收获满满！
175157,2299,张克俊,2023-06-22 03:40:31,7,9,2,设计思维拿到考卷的那一刻，是懵逼的，主观题量吓人啊。做着做着，整个学期迷惑的地方似乎慢慢被解开。两个小时的开卷考试，没有太多填鸭式的知识默写，更多的是4个多月学习的全面思考。虽然写的手疼，但是每个字似乎都是有温度的。感谢课程，干货满满，感谢我的同伴大佬们，感谢老师！
175821,2299,张克俊,2023-06-27 00:45:34,1,1,0,除了给分，其他还行
175887,2299,张克俊,2023-06-27 05:17:48,0,1,1,只能说，如果摊上rz队友，那你这门通核的体验...一言难尽，会比你专业课还烦还爆炸...真羡慕队友大佬的人呀，我队友真的物种多样性...
176409,2299,张克俊,2023-06-28 18:09:12,7,8,1,设计思维，课程前期能学到挺多东西，同学讨论热情度也高一些，到下半学期确定大作业主题后课堂就稍微有点水了。\n\n如课程名称，这门课看中的是你的设计思维、创新能力，再加上我们这学期大一学生比较多，老师很体贴的减少了实操的部分，如果你想的话整门课都可以与代码不沾边。\n\n作为一门3学分的通识课只能说作业不少，会有2-3次ppt展示，2-3次课上临时准备的展示，但压力都不大；慕课作业很多，但可以水。\n\n整门课给分还是比较有依据，开课前会讲清楚，但可能根据同学意见进行调整（会跟同学协商）。\n\n本人作为一个理科生，不水不卷的完成了每次作业、展示，再加上提出了一个相对较好的大作业idea，最后也是得到了挺好的成绩。
176612,2299,张克俊,2023-06-29 12:33:57,1,1,0,通核：设计思维与创新设计\n\n个人体验：1.这门课事情比较多，想水通核的同学要谨慎。2. 三人组做一个设计大作业，MOOC（平时测验，简答题，期末考试），期末考试。\n\n3. 这门课队友很重要，或许会遇到摆子，或许会遇上大佬，或许... 4. 谈一下大作业，老师反复强调选题的重要性，选题选好了，就成功一半。很多组的选题一直在修改，甚至在最后一个月，还在推翻重新来做。大作业要展示3次左右，不断的修改，不断的完善。5. MOOC比较水，一般分都9点几 6. 最后期末考试，量比较大，大约5个论述题，还有15个选择题。
176803,2299,张克俊,2023-06-30 08:19:42,-2,0,2,事情不算多，期末题目主观性很强，比较看最后的大作业吧，所以遇到拉胯摆烂的队友会很想死（）给分中规中矩，群里一个谢谢老师都没有hhhh可想而知
177944,2299,张克俊,2023-07-05 16:26:30,4,5,1,课程：设计思维与创新设计\n\n老师人还不错，课也比较硬，在交流过程中常常能给一些新的思路和想法。我相信如果能认真学下来完成大作业还是会有些收获。课程前期能学到一些东西，后期基本就是完成大作业，老师会比较看重大作业的选题和内容，会关注你做了什么，解决了什么，有没有什么创新的idea。\n\n本人的悲惨体验（负能预警）：这门课的体验很大程度上依赖于你的两个队友（无论是能力还是积极性），以个人为单位的mooc，期末考据说大家差不多分，而其他的发言加分，小组讨论，大作业分数全都是三个人一起的。因为队友是随机抽的，能不能遇到好的队友全看运气（或者你可以拉两个靠谱的队友一起选课组队），这门课没有啥组内贡献系数，导致组员即使摆烂也可以享受相同的分数，最终变成摆烂的队友可以无底线的摆烂，本人很不幸遇到了两个摆烂的队友，刚开始还能勉强讨论几句有点积极性，课程还没到一半就基本开摆，讨论课坐着刷手机电脑死气沉沉，作为组长多次调动并没啥软用，提出啥新想法就是直接全票通过，问他们有啥想法直接反问我？？？，最后还得在跟老师助教交流才发现不足并且修改选题。最后好不容易调动队友去做点ui，结果就扔过来一个乱七八糟的残次品。还得我花大量时间进行修改优化。总之，本人作为冤种组长基本完成了从选题的产生，到选题的优化，到最后选题的实现。最后这门课也只是拿到一个一般的分数，并不是觉得分数差或是什么，主要是感觉努力配不上分数，毕竟一个人勉强补上了本来三个人要做的工作。\n\n总之，最后跟学弟学妹说一句：假如你不幸遇到了摆烂的队友，一定一定要多把你的选题或是想法跟助教老师多多沟通，助教和老师都还是很和善的，能给出很多想法，帮助和实现方法。同时，因为这门课刚开始的想法产生是无法强求的，但实现过程还是能尽量调用一下你的摆烂队友，给他们安排些任务。最后希望大家都能遇到大佬队友
178512,2299,张克俊,2023-07-13 05:20:39,1,4,3,点名方式是花名册，所以不要想逃掉~\n\n设计思维与创新设计，借用朵友的一句话，除了前面idea的构建之外，满足你对水课的一切幻想。\n\n但是需要注意的是，这门课非常吃队友，也非常吃创造力。比如我们这一届的大作业主题就是”为亚运做点事“。我们的idea推倒重来了三次，从一开始的ProduceHUB，改成了亚运版求是潮，最后是电视、杭州：变球......期间经历了很多充满愤怒与焦虑的夜晚，想着为什么队友就不上点心，为什么自己的想法队友不能认可。\n\n但是，我们也经历了开怀一笑的时光。比如实验张sir组里的仿ChatGPT，问曰：如何让亚运会与残障人士结合起来？答曰：让残疾人参加极限运动，如蹦床等。为什么产品取名叫”电视“？电意为”赛博“，视意为”视觉盛宴。\n\n这门通核课还是非常值得推荐的。而且经过给张Sir的建议，他也同意在下学期开一门博雅（还是美育）课了。我甚至建议他开一门小语种，因为大家都不懂机器语言，大家也都没有受过比如日语、俄语这样的义务教育，所以汇编也可以算作F的语言课，可惜他听不懂，最终没能让汇编成为一门语言课。
178764,2299,张克俊,2023-07-22 03:26:09,2,3,1,学了几门张sir课，教学内容啊、方法啊没得说，很干货、很生动！感受到张sir对于讲台的热爱，通核课比较硬，要高分不容易。
193600,2299,张克俊,2024-06-13 11:54:18,0,3,3,（创新思维）通核，根本不关心产品是什么啦，，说得虚头八脑一点、高大上一点比较好。。比较卷。课程后期没什么意思。张sir人格魅力撑着了。
200504,2299,张克俊,2024-10-18 02:07:08,3,4,1,毕业了来写两句。设计思维课，比较考验想象力，能学到很多东西。课内课外，老师都给力，体验超级好。美中不足是给分中规中矩，我的有点低了。
208969,2299,张克俊,2025-01-03 19:01:08,3,3,0,人工智能情感艺术与设计课，爽！实践体验很开心！视野打开了“.
210343,2299,张克俊,2025-01-09 03:12:08,1,1,0,《人工智能情感艺术与设计》遇到了很好的组员开拓见识受益良多，课也很有趣，会请很多厉害的人。不敢在课上发言自认为在小组贡献也挺低的但是最后给分也不错。好想和组员还有老师再一次相遇TT
214182,2299,张克俊,2025-01-27 03:58:01,1,1,0,课程内容精彩，信息量简直大。十多次课程，每次都有收获和期待。有介绍一些ai视觉、听觉的典型国内外应用，特别是张sir实验室自己的科研实践，作业是用AI进行音乐、字体设计的创新实践，学得很开心，助教和邀请专家很棒。但要拿高分不容易（我周围没有满绩）。
219751,2299,张克俊,2025-06-05 06:21:32,0,0,0,开心的！
221962,2299,张克俊,2025-06-28 02:45:35,0,0,0,设计思维与创新设计，这门课信息量非常大，我收获很多，从一个维度上说，这堂课打开了工业设计整堂课的思考流程，给我们提供了一个方法论，受益匪浅。\n\n但是话又说回来了，给分真的很一般，真的）如果小组的最终成果没有太过出彩的话，即使你个人慕课、考试等都拉满，看样子也只能拿到四以下的绩点...
221971,2299,张克俊,2025-06-28 06:47:42,0,0,0,不是很能理解这个通核的分数是怎么打的，我们组每次大班展示都有，然后视频自认为做的也不错，最后全组没一个上90的，真的很不理解，感觉这分数对不起我们的付出
221986,2299,张克俊,2025-06-28 08:36:23,0,0,0,通核课没的说，视野、方法论都有，含金量高高的通识课。说点关键的分数部分吧，慕课比较轻松、期末考试题目很灵活，拿高分不容易。大作业是小组式作业，需要持续、高度努力了，我们小组大作业前面拉胯了点，一度紧张慌张，还好没放弃，最后的大作业汇报带飞了，成绩满意。
51156,2307,郑文庭,2017-07-06 08:06:03,2,4,2,谢老师不挂之恩
52325,2307,郑文庭,2017-06-18 11:28:06,0,1,1,考试之前评价一波 老师保佑
57074,2307,郑文庭,2017-07-05 12:09:08,0,2,2,提前给老师评一个低分 \n\n希望离散不会炸
57193,2307,郑文庭,2017-07-06 03:50:17,0,3,3,不知所云 人不错 喜欢笑 给分让我笑不出来…
64420,2307,郑文庭,2017-12-23 12:19:43,-1,2,3,。。。。。。
64449,2307,郑文庭,2017-12-24 03:42:35,1,2,1,111
65285,2307,郑文庭,2018-01-02 10:06:32,1,3,2,为什么是0.00先提交个9分看看能不能拉上去不会真的是0分吧
65287,2307,郑文庭,2018-01-02 10:59:06,-2,1,3,不会真是o分吧
65312,2307,郑文庭,2018-01-03 02:38:04,0,1,1,！！！
65387,2307,郑文庭,2018-01-03 13:42:54,1,3,2,不错的
65707,2307,郑文庭,2018-01-08 10:49:39,4,6,2,老师讲的不错的>
65814,2307,郑文庭,2018-01-09 09:33:50,0,3,3,一般般
72328,2307,郑文庭,2018-01-30 02:07:14,4,5,1,挺不错的~
74970,2307,郑文庭,2018-03-23 04:01:19,7,8,1,希望给分好~
75304,2307,郑文庭,2018-03-09 00:55:19,-1,2,3,不知所云
76405,2307,郑文庭,2018-04-08 01:12:18,-4,3,7,离散数学讲得是真烂......他让我意识到有些老师就是讲课的业务能力差，也许他自己能理解自己要讲的东西吧，然而就是怎么也讲不清......
79318,2307,郑文庭,2018-05-31 02:52:44,4,5,1,谁来告诉我这均绩是不是真的？
79359,2307,郑文庭,2018-06-01 01:43:53,1,1,0,不听会后悔系列
79360,2307,郑文庭,2018-06-01 01:50:55,1,1,0,助教批作业超认真
80097,2307,郑文庭,2018-06-20 03:12:54,1,1,0,希望给分好
83777,2307,郑文庭,2018-07-11 08:14:01,-6,1,7,给分好…别想了 给个3.3不能再多了
84658,2307,郑文庭,2018-07-13 12:43:01,6,6,0,给分棒！！\n\n不过学还是主要靠自学
84670,2307,郑文庭,2018-07-13 13:02:33,16,18,2,问了一下平时分，给的算是不错的，（毕竟小测比别的班简单一些，也不知道有没有调过分）不能算是绩杀。平时讲课念PPT，有点无聊，不过其实离散都是挺无聊的。助教批作业很认真。\n\n总而言之是个不错的老师吧，爱笑。
84677,2307,郑文庭,2018-07-13 13:24:58,8,8,0,讲课一般，喜欢笑。
84709,2307,郑文庭,2018-07-13 14:59:13,9,10,1,和蔼的老师，，，可以选的吧，，，给分不算差，，，小测考作业内容
84735,2307,郑文庭,2018-07-13 16:20:34,10,10,0,老师对学生真的很好，在考场上有学生问他不会的英文单词老师也很耐心的回答了。真心觉得老师很好，也不为难学生，均绩低只是因为课程很难罢了\n\n
84823,2307,郑文庭,2018-07-14 02:49:22,7,7,0,挺不错的，课还是要认真听的，老师人真的很好，助教小姐姐也很棒，给分也还不错，值得一选！
84828,2307,郑文庭,2018-07-14 03:05:56,6,6,0,讲的一般吧，但人还是很好的
84833,2307,郑文庭,2018-07-14 03:40:19,3,3,0,老师人很好很耐心，对于学生的要求也尽量满足。
85951,2307,郑文庭,2018-08-26 00:32:49,16,16,0,随机电人回答问题，发现不在，笑呵呵的：不在吗，换一个。发现又不在，还是笑呵呵的，连续三个之后，笑呵呵的说：其实概率还是挺低的
104087,2307,郑文庭,2019-03-12 01:04:22,6,6,0,苏格拉底：我是伟大的哲学家，不是凡人。
104409,2307,郑文庭,2019-03-20 02:20:31,3,3,0,老师教课一般，人很好。\n\n助教这学期不知道和之前那些评价是不是一个，虽然是逐题批改了，但很死板，方法和答案不一样竟然就算是错的（已经求证过是对的了）。\n\n也希望助教能打完叉后写个原因吧，微积分助教批快两百人都写原因的，这个八十人只判对错过分了。
105546,2307,郑文庭,2019-04-16 12:11:51,2,2,0,人有死。苏是人。苏有死。\n\n苏格拉底那段可以用这个，简洁很多。
107568,2307,郑文庭,2019-05-07 01:18:32,5,5,0,老师真的很可爱哈哈哈哈哈哈哈哈哈哈哈哈哈，学生闹起来也不生气，可以说是见过脾气最好的老师了
110161,2307,郑文庭,2019-07-11 05:40:54,0,0,0,过了，就给高分
111907,2307,郑文庭,2019-07-03 02:28:03,2,2,0,10分求过
113969,2307,郑文庭,2019-07-09 10:56:24,13,13,0,郑老师，带帅锅
114244,2307,郑文庭,2019-07-09 09:21:30,2,2,0,人真的很好
114251,2307,郑文庭,2019-07-09 10:26:34,2,2,0,老师很好，是我太菜了，一面离散拉了0.15均绩，我想哭
114261,2307,郑文庭,2019-07-09 12:16:20,4,4,0,郑老师，带帅锅。
114266,2307,郑文庭,2019-07-09 13:43:25,6,6,0,老师给我的分数敢接感觉我自己被拉了一把，可私戳问分也真的很友善。问了分数之后我感谢老师捞我，老师回我：没有捞你，是你自己努力的结果。\n\n妈呀这是什么神仙老师！！！
114501,2307,郑文庭,2019-07-10 08:25:02,2,2,0,谢谢捞我过线
114616,2307,郑文庭,2019-07-11 01:01:31,0,0,0,好！！！
116565,2307,郑文庭,2019-09-11 17:11:13,1,1,0,学弟学妹们quiz考前记得在群里匿名复读：郑老师，带帅锅，求小测翁肉点。会有奇效哦～（不得不讲郑老师的脾气是真滴好）
117177,2307,郑文庭,2019-09-20 04:04:28,3,3,0,男人都是凡人，苏格拉底是男人，所以苏格拉底是凡人。（黑人问号）
125450,2307,郑文庭,2020-09-09 09:05:20,0,0,0,这学期都是网课，郑老师上课很认真，谢谢老师，还没出分，求不挂
125596,2307,郑文庭,2020-09-12 06:58:48,1,1,0,也就一般吧
125597,2307,郑文庭,2020-09-12 07:26:19,-1,0,1,老师超级可爱！！！！
125969,2307,郑文庭,2020-09-16 05:46:01,2,2,0,给分差
138941,2307,郑文庭,2021-07-12 02:02:36,0,0,0,10分求过
139674,2307,郑文庭,2021-07-19 17:24:34,0,2,2,辣鸡。
176734,2307,郑文庭,2023-06-30 02:34:50,4,4,0,受不了了，讲的和考的完全是两码事，期末考试题目又多又难
176774,2307,郑文庭,2023-06-30 05:19:52,3,3,0,唉。。我不知道该喷你还是喷课。。
177219,2307,郑文庭,2023-07-02 09:44:34,17,17,0,离散数学理论基础。讲课一般，上课基本就是念 ppt，但比隔壁 lm 好一点，因为他起码知道自己在念什么，可以智云两倍速用来过知识点。喜欢抽同学回答问题，但考勤不占分，不来也没关系。但是小测和考试有的题是真的出的太难了，有点为难学生。怀疑他估计不来题目难度，期末考试巡场发现大家根本做不来，给大家延时了五分钟...\n\nupdate:助教锐评：这期末卷子我自己也不一定能及格
178533,2307,郑文庭,2023-07-13 17:10:13,0,0,0,睡不着了
178535,2307,郑文庭,2023-07-14 02:11:55,6,7,1,你感慨这么多，这么感觉抱歉，当初期末卷子怎么不下手轻一点呢？《比平时小测简单》🤡甚至都没给助教gg做一下估计难度。唉唉
178536,2307,郑文庭,2023-07-14 02:20:21,0,1,1,23年参考7.2那条就好了，教考分离，均绩3.0左右吧，挺拉分的，不过也没什么可说的，也没选择，感觉也不全是老师的问题，但看我的分，得给文庭磕一个，再给llgg磕三个
178537,2307,郑文庭,2023-07-14 02:18:03,3,3,0,这很难评。。。离散数学理论基础\n\n考前：“这次期末考试很简单，预计平均绩点会高很多”\n\n然后平均绩点3.0\n\n讲课讲不明白，101个人，创造过到课16人的历史\n\n最后被狠狠绩杀了，因为一门课均绩掉了0.1
184916,2307,郑文庭,2023-12-24 09:59:28,3,3,0,教考分离，题出太难了，教学水平只能说念ppt挺认真的
197324,2307,郑文庭,2024-07-11 02:21:06,2,2,0,今年的离散期末感觉还好……？绩点在意料之中吧（虽然也不高）老师是个好人
197362,2307,郑文庭,2024-07-11 12:38:21,1,1,0,不点名，可结合ppt和教材（中文版+英文版）自学。考试较难，给分尚可。
219505,2307,郑文庭,2025-05-29 03:07:05,1,1,0,如果平时分不错老师会捞的
221855,2307,郑文庭,2025-06-27 02:37:01,-1,1,2,zwt 是我爹！这学期相较于往年，给分真的超级超级不错！私下问过助教，期末考证明题改的相对比较宽松，能给分就尽量给了。总评已经相当满意，10 分献上！
221904,2307,郑文庭,2025-06-27 10:00:35,1,1,0,睡不着了
221913,2307,郑文庭,2025-06-27 11:35:56,1,1,0,老师值得一个10.\n\n讲课虽然没多好，但至少是平均水平。很爱笑，而且有时候会扯一些人生的长远的事情，就在写评论的时候还在钉钉群里祝福同学们。\n\n我给老师10主要是人真的很好，有问题会积极解决，有一次小测和我的事情冲突了联系老师老师竟然能直接改小测时间。还有点点滴滴的小事，无论如何为人真的没的说。\n\n都说离散成绩很难看，反正在我这里没反映出来，我对我的成绩比较满意，甚至如果期末前再仔细复习一下成绩还能更好。可能老师本学期也在努力捞人\n\n另外本学期李明来带过一次课，我觉得他就讲课而言也算平均水平吧？不会评分那么低的。
26528,2350,孙守迁,2016-06-20 01:57:38,36,50,14,浙大怎么会有这么能装逼的老师，这课一学期基本上什么都学不到，唯一一节听着觉得还不错的课还是这老师出差的时候别的老师来代课的一节，孙老师在外面呼风唤雨日理万机，但希望能给我们本科生传授一点真才实学，而不是每节课来夸耀自己做了哪些了不起的大事。
27185,2350,孙守迁,2016-06-23 12:41:49,14,15,1,两个字：呵呵
27186,2350,孙守迁,2016-06-23 12:41:49,11,12,1,听不懂在说啥
27197,2350,孙守迁,2017-04-26 00:57:13,-2,7,9,老师本身是很厉害的，科研工业行政方面都很棒。但是本科讲课一般般，打分不知道怎么样，得了分再来说。 
27201,2350,孙守迁,2016-06-23 13:19:59,44,48,4,路甬祥院士，潘云鹤院士，我跟他们谈笑风生
27324,2350,孙守迁,2016-06-25 02:18:21,11,14,3,全程装逼。暂且不说老师本身水平怎样，可我作为学生一点都不想听你所谓风光无限的经历。作业布置得，有点抽象。反正选这个课的同学祝你好运。。
27407,2350,孙守迁,2016-06-26 01:25:32,9,19,10,如果你觉得自己挺有挑战精神的 不妨选一下试试看 只能说我不喜欢这种吹bi的老师 或许还真的是有科研实力的 有实力能不能赏脸展现一下… 来来来 把前几天这个照片给他们看一下 这个是路甬祥院士 这个是我…
28400,2350,孙守迁,2016-06-28 08:50:11,-10,7,17,老师确实喜欢说一些自己的经历，嗯，有点过火……不过据说新生研讨课都是这样子。对大一学生的期望还是有一点高了，作业不太好做，做下来是有收获的。几位助教教的干货还是有的。致要选课的同学：这门课真的不是关于UI设计的，讲的东西比较开眼界，但是真是有点太高端了……
30313,2350,孙守迁,2016-07-01 08:37:13,9,11,2,给分有毒
30366,2350,孙守迁,2016-07-01 12:00:46,14,16,2,什么意思？天天上课就在装逼，说自己多厉害全国到处跑，然后大作业什么都没讲清楚就让我们做出来，完全没有教任何东西，我们是本科生好么！给分这是什么意思？平时时不时拖个堂，最后还有展示，就这点分？？？简直了
30412,2350,孙守迁,2016-07-01 13:42:11,7,8,1,丝毫不明白上课在说些什么
30491,2350,孙守迁,2016-07-01 16:59:44,9,11,2,上课只会瞎逼逼，谁想听你讲你做了什么！呵呵
56477,2350,孙守迁,2017-07-04 01:22:03,2,5,3,绩杀慎选
56651,2350,孙守迁,2017-07-04 07:09:18,2,4,2,也不能算绩杀，给分全看个人付出，作业布置再详细点就好了，搞到最后一头雾水。
60690,2350,孙守迁,2017-10-26 15:49:26,5,5,0,不关心学生
74588,2350,孙守迁,2018-03-04 07:52:28,3,3,0,为什么最低分是1，好想打0分啊
77018,2350,孙守迁,2018-04-28 13:17:04,5,5,0,没选过他的课，但我还要给他一分，新生研讨课开在玉泉是几个意思，不想开课直说好不好？！
118130,2350,孙守迁,2019-10-21 08:51:57,3,3,0,好好分享insight是不可能的，课题太宏大飘渺对于实际做设计毫无益处。
119523,2350,孙守迁,2019-11-13 08:52:28,6,8,2,你觉得呢？\n\n小伙子，你觉得呢？\n\n十分记仇的一位老师，同班同学跟他据理力争，他讲了一圈又回过头来点名怼这位同学。不等别人话说完就插话，觉得自己的观点最牛逼，别人的观点都是渣渣
142075,2350,孙守迁,2021-11-05 06:26:10,0,1,1,总之就是他也不来上课，呵呵😄
142078,2350,孙守迁,2021-11-05 07:03:23,0,1,1,就不要在这老师的课上浪费生命了
159435,2350,孙守迁,2022-07-19 09:17:55,1,1,0,啥也不是 天天大数据5G 其实啥也不会
41823,2469,鲍虎军,2017-01-18 08:41:09,1,1,0,project给学生很大的自由度，人也很和善，给分也超棒！
73875,2469,鲍虎军,2018-02-03 09:37:36,2,3,1,课讲得很好，特别清晰
128070,2469,鲍虎军,2020-12-06 07:20:08,1,2,1,讲课很清晰，作业要求不是很清晰
148598,2469,鲍虎军,2022-01-13 02:58:28,0,1,1,应该是我在浙大见过最和蔼的老师了，课讲得也很清晰，给分也很好
212863,2469,鲍虎军,2025-01-15 05:48:28,0,1,1,期末作业要求不清晰，给分也不好，选课最好慎重
6062,2471,杨莹春,2015-07-10 14:14:43,71,84,13,老师自己都不会……
18854,2471,杨莹春,2016-01-22 15:43:21,15,21,6,这都能开计算理论真是个joke…
20432,2471,杨莹春,2016-01-27 14:23:22,27,33,6,老师自己也是一脸懵逼，怎么教啊
35030,2471,杨莹春,2016-10-31 02:04:38,14,19,5,老师语文没学好，话都不会说\n\n
36779,2471,杨莹春,2017-01-24 04:20:06,33,45,12,自己不会，读ppt都卡，喜拖堂，一拖一节课，假装调课，实际给自己加课(因为自己没学会需要更多的时间在课堂上自学)，建议杨老师不要再教这门课了，自己给自己留点脸面，给浙大留点脸面。
41632,2471,杨莹春,2017-01-12 09:25:22,83,88,5,几乎所有课都是答疑课——我们给她答疑
45547,2471,杨莹春,2017-01-26 10:25:07,51,61,10,听了她的课，也听了jxg的，最后考了万年不变的背诵默写考试题，立志以后回浙大重新开这门很有思想的课，一个半懂不懂，一个完全没入门
47114,2471,杨莹春,2017-01-24 01:56:39,19,24,5,给她一分算高看了。自己都不会还教别人？
47121,2471,杨莹春,2017-01-24 02:52:54,1,7,6,计算理论哈哈哈哈
47512,2471,杨莹春,2017-01-29 00:44:54,19,28,9,老师讲的一塌糊涂\n\n但我更想问：上面那个说jxg半懂不懂的考了多少
47516,2471,杨莹春,2017-01-29 01:18:28,9,15,6,拖堂，自己也不会。
47524,2471,杨莹春,2017-01-29 09:00:20,7,14,7,这老师讲课一点不会。明显不备课。所以讲课一直很慢，无语，浙大遇到最差劲的老师。千万别选她的计算理论
58049,2471,杨莹春,2017-07-27 01:25:36,3,10,7,有毒，浙大最差\n\n
58607,2471,杨莹春,2017-09-08 11:59:09,5,8,3,字数字数字数
59576,2471,杨莹春,2017-09-23 10:58:27,2,7,5,实验课说要来，结果大家都来了就她不来，一群人干坐着没事干
59577,2471,杨莹春,2017-09-23 11:57:14,4,12,8,她上数字视音频实验课就像是一个人的表演，完全不顾学生能不能听清听懂，盯着电脑就开念。
59867,2471,杨莹春,2017-09-28 01:43:38,5,8,3,课，自己都不懂。每节课磨磨唧唧没内容。成绩出的很晚，最后成绩还很低，f verb
59945,2471,杨莹春,2017-09-29 00:17:49,10,16,6,额  上了三次课了 两次迟到 另外拖堂 感觉没有基本的职业操守 迟到了说什么小孩发烧 exm？这样就可以浪费学生的时间 简直无语  （趁着上课时间还没来   到了再开电脑一大堆事 真的呵呵了
67812,2471,杨莹春,2018-01-22 07:44:12,87,99,12,强烈建议yyc和学生一起参加计算理论考试，由别的老师命题，yyc能有一半学生分高我直播吃翔
70470,2471,杨莹春,2018-01-26 16:15:22,9,18,9,退课是不可能的，这辈子都不可能退课的。感觉考试又简单，老师又负责，我超喜欢待在里面的。
74077,2471,杨莹春,2018-02-05 02:01:37,2,4,2,真的不怎么负责
74166,2471,杨莹春,2018-02-06 03:03:55,5,7,2,不知所云 还爱拖堂
74292,2471,杨莹春,2018-02-09 16:45:30,6,12,6,上课自顾自bb个没完 完全不管学生听没听懂 群里不回答同学问题 pre前也不回答 上课迟到 考前重点划了和没划没区别 专业课最差老师没有之一
74293,2471,杨莹春,2018-02-09 19:44:07,3,5,2,听不懂
74300,2471,杨莹春,2018-02-10 04:17:19,6,7,1,音视频，上课无聊，ppt是论文截图，然后上课照着念，明显不备课，因为念都念不明白，不明白就直接跳过，也不管底下懂没懂，第一次评论，真的是被老师恶心到了，赶紧退吧
74366,2471,杨莹春,2018-02-15 07:05:22,20,26,6,不仅什么都不会，上课经常把英语书原文在黑板上原封不动抄满，还憋到最后除夕出分，服了。祝老师新年快乐
74367,2471,杨莹春,2019-07-12 05:10:10,26,33,7,厉害了 除夕出分
74508,2471,杨莹春,2018-03-02 09:33:34,4,8,4,0分必须
76055,2471,杨莹春,2018-03-26 05:17:53,-30,6,36,计算理论是比较难，基本靠自学，所以和老师没有太大关系，另外杨莹春其实给分还行
85830,2471,杨莹春,2018-08-19 16:57:50,0,5,5,贼差啊
87368,2471,杨莹春,2018-09-27 13:09:48,6,12,6,恕我直言，这傻逼就是个混子。
87502,2471,杨莹春,2018-09-30 02:41:53,13,18,5,只要学会复读“我们讲”“就是说”“实际上”这几个词\n\n你也可以教计算理论
87771,2471,杨莹春,2018-10-12 03:02:21,5,9,4,果然名不虚传
91106,2471,杨莹春,2018-11-30 03:43:26,15,19,4,"沙雕老师，上课自己讲着能卡住，卡住之后说什么哲理。嫌学生签到投机主义，然而自己搞签到的时候原话""今天人少我们就来签到""，然后原话""签到不来不会扣分的，只会给来签到的加分""\n\n看到的可信可不信，你们自己评判吧"
91368,2471,杨莹春,2018-12-07 02:22:24,7,10,3,上课上得自己卡住的老师也是在浙大见过的第一个了
91371,2471,杨莹春,2018-12-07 03:25:30,13,18,5,就是说，就是，这个，一个，这样一个，内个，所以说，嗷，额。这几个词占了一半
91375,2471,杨莹春,2018-12-07 03:53:40,5,9,4,诶拖堂拖的真难受\n\n
91810,2471,杨莹春,2018-12-21 03:16:08,5,9,4,希望你多听听自己的现场
92340,2471,杨莹春,2018-12-28 02:02:40,4,9,5,真的弱子老师
92508,2471,杨莹春,2019-01-01 09:54:57,12,17,5,太傻逼了这个，不光讲课不好，人品更差
92729,2471,杨莹春,2019-01-04 04:15:06,8,11,3,自己上课都要迟到半个小时...
92733,2471,杨莹春,2019-01-04 04:53:01,36,47,11,今天是2019年1月4日，时间是中午12点27分，距离下课还有-60分钟，请各位同学继续认真听讲，不要在评论里攻击老师，谢谢!
93686,2471,杨莹春,2019-01-11 15:02:11,7,11,4,上午3，4节的课拖堂拖到一点多，十二点半还点个名……是个狼灭
95861,2471,杨莹春,2019-01-20 06:45:05,6,10,4,太傻逼了，人品差
100686,2471,杨莹春,2019-01-26 14:33:45,5,7,2,有点崩溃
102153,2471,杨莹春,2019-01-30 23:39:45,7,10,3,这人脑残
102470,2471,杨莹春,2019-02-03 05:43:25,8,10,2,这老师太差了
102477,2471,杨莹春,2019-02-03 07:07:53,6,9,3,我觉得老师有病 给分贼差
102478,2471,杨莹春,2019-02-03 07:17:13,2,6,4,给分也太差了吧...
103818,2471,杨莹春,2019-03-06 04:40:28,1,4,3,真心无语
107643,2471,杨莹春,2019-05-08 02:40:31,2,4,2,无语啊
109999,2471,杨莹春,2019-06-21 04:03:37,3,5,2,自己上课只会读课件，拖堂10分钟到40分钟不等，完全没时间观念。浪费时间，浪费生命
116984,2471,杨莹春,2019-09-18 03:46:23,7,8,1,严重怀疑老师没备课\n\n严重怀疑老师的ppt不是自己做的\n\n严重怀疑老师自己都不会
117161,2471,杨莹春,2019-09-20 02:57:44,4,5,1,一个小时过去了 感觉没真正的东西啊 讲不清楚的感觉
117162,2471,杨莹春,2019-09-20 02:58:57,4,4,0,名不虚传+1
117164,2471,杨莹春,2019-09-20 03:01:02,2,5,3,上完第一节课就觉得这老师上课应该没了，课也不讲，上课先吹一节课图灵，再发一节课鸡汤，第一节课毛都没上，鬼知道要干嘛
117684,2471,杨莹春,2019-09-29 02:07:49,6,6,0,ppt是隔壁xiaogang jin的，就是说我们讲
132535,2471,杨莹春,2021-02-02 06:55:27,7,8,1,这老师的评分怎么还能有1.4？
136967,2471,杨莹春,2021-06-29 03:34:17,4,6,2,快跑！
140673,2471,杨莹春,2021-09-15 04:25:56,3,4,1,人傻了，讲的啥啊
141090,2471,杨莹春,2021-09-23 06:53:57,3,5,2,就是说 这个 那个 一个 就是 呃 就是说\n\n话都不会讲的老师
141296,2471,杨莹春,2021-09-29 02:21:32,4,7,3,最无语的一个老师，下个学期要学这门课的同学建议假期先自学好，老师啥都不会，作业还难得一批，实验器材大半是有问题的，叫老师来排除问题也没用。真就是大不自多了
141313,2471,杨莹春,2021-09-29 08:41:25,1,5,4,学在浙大上好奇听了课，闭包（closure）竟然能讲成包含关系？！！
141460,2471,杨莹春,2021-10-10 06:05:54,5,7,2,rnm，退我学分钱
141722,2471,杨莹春,2021-10-22 06:08:34,3,5,2,感觉老师啥也不会，讲课一句话一半是额、这个、那个、哦对、就是这样。。。。。。。反正还是自学吧
141869,2471,杨莹春,2021-10-28 10:45:51,3,5,2,只要你会说这个 那个你也能开这么课程。\n\n要不是因为选不上其他老师的课程，谁会选她的课....
141870,2471,杨莹春,2021-11-03 01:50:22,4,9,5,啥都不懂，话也说不清，考核还严\n\nzhentamashiyitiaochougou
143846,2471,杨莹春,2021-12-08 11:14:05,-8,6,14,10分
144696,2471,杨莹春,2021-12-30 08:02:03,10,12,2,连着三周说下周小测，连着当天取消了两次，最后一次拿着公布的往年卷当小测题😅\n\n阿西吧 连着复习了三周计算理论 现在已经在破防边缘了
144914,2471,杨莹春,2021-12-26 02:09:09,5,6,1,球球了数逻不要挂科
149363,2471,杨莹春,2022-01-16 08:42:07,12,21,9,艹，给分有点好
149687,2471,杨莹春,2022-01-16 11:10:20,7,9,2,给分还行，但课堂几乎学不到什么，全凭自学。
150001,2471,杨莹春,2022-01-18 09:10:09,3,7,4,咱就来这等等yyc打算什么时候计算理论出分，不会真到除夕夜吧😅
152222,2471,杨莹春,2022-03-30 17:09:12,-20,19,39,感觉老师也蛮不容易的吧，大学老师本来就不是给本科生讲课的，每个老师都有自己的科研任务，就完成科研任务也挺不容易的。讲课的话确确实实不太行，但也能感受到老师在努力，今年计组的话实验课能看到老师来马德的实验课旁听，多多鼓励一下吧！
153071,2471,杨莹春,2022-04-25 01:41:58,2,5,3,讲不清楚课，PPT 拿国外的直接讲。
155017,2471,杨莹春,2022-06-07 13:13:42,0,4,4,讲的差
155211,2471,杨莹春,2022-06-09 10:23:38,8,15,7,我在马德老师的课上看到杨老师了，杨老师可能讲课水平是没有很好，可是我是看到老师的努力了，而且计算机本来就是自学很重要的，还是希望同学们能多多包涵一下吧。
156812,2471,杨莹春,2022-06-21 04:07:15,9,13,4,虽然讲课一般 但是建议对硬件无感的同学们选yyc的计组 验收要求少 很容易就能过 期末甚至还会放宽要求 把必做的改成bonus 实验报告给分也挺好的 听课的话可以去智云听马德老师的回放 总的来说老师虽然讲课水平确实不高 但人确实是挺好的
157904,2471,杨莹春,2022-06-25 11:48:25,9,14,5,这给分无敌了\n\n本来上三就心满意足的我看着4.2的绩点甚至有一些惭愧
158078,2471,杨莹春,2022-06-27 00:34:40,5,11,6,杨老师给分好，感人了，最后的总评比我自己预期的要高。计组这门课实验比较难，但老师，助教都非常有耐心
160271,2471,杨莹春,2022-09-16 05:01:21,9,11,2,计算理论每节课都小测，绷不住了，让他自己来做都及不了格
160429,2471,杨莹春,2022-09-22 05:40:04,-3,2,5,😒😒😒
160522,2471,杨莹春,2022-09-26 00:41:18,15,19,4,讲这里面就是说没有一个什么，我们讲就是我们讲的没有一个是我们讲对应的什么，就对应的这个a就是自然的集合，对应这个什么，这个是这个整数的，这个它的这个基数，我们讲这个阿里克林，阿里克林这里面和这个什么，就是我们讲对应的这个阿里克林就实际上就是什么，我们讲一个自然数这个基数那什么就说它。
160734,2471,杨莹春,2022-10-08 06:59:24,4,7,3,😄就是说💧
160941,2471,杨莹春,2022-10-20 12:32:52,0,3,3,讲课水平不高，既不熟悉课程内容表达能力也比较弱
169976,2471,杨莹春,2023-03-01 00:37:34,10,13,3,计算理论讲得差，给分差，千万别选她的计算理论
170005,2471,杨莹春,2023-03-01 03:24:53,3,5,2,"讲课真不行。。。各种""就是说""""实际上""\n\n给分。。感觉这次是不是没怎么捞"
170161,2471,杨莹春,2023-03-01 16:13:47,4,6,2,上过yyc的很多课（\n\n特点鲜明，必须纯自学，事情基本都比较少\n\n给分其实挺不错，不过别指望她捞人，平时分基本给满了，大部分课期末考卷是流水改卷操作空间不大，因此对比起来yyc的课拿高分比较容易\n\nyyc的上课水平就只值现在这个评分\n\n但是从功利的获得绩点角度而言评分可以高一些
174951,2471,杨莹春,2023-06-20 11:09:15,1,3,2,期末临时改要求，自己做的作业突然全都上交还喜提缓存实验\n\n真就绩点消消乐呗
178096,2471,杨莹春,2023-07-07 01:19:13,-6,5,11,老师挺好的
178136,2471,杨莹春,2023-07-07 05:48:56,14,17,3,客观上来说，老师可能讲课水平不高但是还算是比较努力（但有时候因为讲不明白就要各种加课的行为确实令人反感），老师的课件实验等都和md班相同。在人少的时候会点名，但是点名可能并没有太大的作用（老师可能只是希望大家来上课），所以你不来其实也没什么关系。值得吐槽的一点就是这个学期经常说要小测但是最后只有一次期中考（其实课程要求就只有一次期中考）。在听课方面，md的智云课堂是不错的选择。\n\n  实验课实验bonus还是比较多（虽然lab6的cache拉扯了一番），但其实最终必做实验是所有计组班相对较少的（比lkj班少多了）。另外吹爆本学期助教邱老师，他真的我哭死。\n\n  一句话总结：老师的讲课水平还有待提升，可以智云，但事少，老师人也挺好的，从给分角度来看评分确实可以高点
187252,2471,杨莹春,2024-01-15 10:14:01,5,7,2,老师挺好的，就是课讲的一般而且拖堂、纸质签到。但是是真的捞，计算理论没怎么学，感觉挂了，结果硬给捞上来了
192845,2471,杨莹春,2024-05-31 03:33:32,12,14,2,yyc老师的课，听她讲课效果不如自己阅读教材。突出一个自学能力，指望她教会你基本是不现实的，学了一个学期感觉云里雾里
194176,2471,杨莹春,2024-06-22 10:30:45,8,9,1,究极无敌差的听课体验，听了一个学期啥也没学会，上课就是依托构思，教给我的东西远少于期末补天时看的瓜豪的复习资料，实验是乱讲的，作业小测是自己对答案的，小测更是直接从书上抄原题，也不管对错，两次小测题量又多，题干描述不清每次都要更正，摆明了就是不想让你写完呗。关于实验，要不是神仙助教qrhgg几次救我于水火，不然实验根本完不成，看那狗屎ppt做实验仿佛用原木造汽车一样荒谬。总结就是，能自学成才的大佬当我没说，想跟着老师学些知识千万别选，我后悔到肠子发青。
195564,2471,杨莹春,2024-06-28 20:40:29,2,3,1,啥也不会
196116,2471,杨莹春,2024-07-01 17:07:17,3,5,2,老师人还是很好的，助教哥哥真的超级棒（但是好像保研了）好可惜。给分真的很无敌，还是比较推荐的，但是大家要做好自学的准备
196145,2471,杨莹春,2024-07-02 00:41:52,7,9,2,一直想给0分，但是期末考出分以后嘛，看在杨老师的给分不错上，给您刷十分！
196146,2471,杨莹春,2024-07-02 00:50:37,2,5,3,数逻推荐喜欢自学的同学选。\n\n事情少，验收相对水（可能跟助教也有关系，这学期的助教qrh超级好！）\n\n期末给分真的神了，我期末两道大题做错，前面小题也有错，本以为下4，结果91。\n\n小测比较水，都是作业题，期末发还给我们自己订正批改好上交（）\n\n总结来说，老师上课水平是真的不太行，但是人是挺好的，给分无敌
196496,2471,杨莹春,2024-07-03 23:10:03,0,9,9,十分客观的评价（我不是托）\n\nyyc老师的业务能力确实有待提高，上课念ppt，实验课程也是用的md老师班级的材料；\n\n但是今年的考试，相信大家都知道是什么情况，我感觉考的简直就是依托答辩，作业也是后来补交的，作为一名大四的学生，本来以为是稳挂，还得岩壁，最后没想到出分是63分\n\n我真的不知道说什么了\n\n固然，杨老师在专业水平上有待提高，但是，老师真的是没话说，切实的从同学的角度出发，不能说给分有多好吧，只能说老师真的是尽力在捞了，给老师一点时间吧，相信未来的她会进步也会改变的\n\n（以下纯纯的主观观念）\n\n我真的吹爆杨老师好吧\n\n一如杨门深似海；\n\n再回首已是百年身。\n\n相信我同学们，不能说给分巨好，但是真的是事少（一次或者两次纸质签到，两次开卷小测，一次开卷期中）她的开卷是真的开卷，也真的会捞！！！
196552,2471,杨莹春,2024-07-04 04:57:30,10,15,5,课程：计算机组成\n\n讲课：1分，只会念ppt，并且热衷于念ppt\n\n认真程度：9分，老师虽然业务能力不行，但好歹ppt也是参考了两三位其他的老师做出来的，虽然逻辑性很差  \n\n小测难度：1分，全开卷，2次，且全是课本题（可能业务能力相关），善于搜寻资料的学子懂的都懂\n\n实验：10分，其中9分给助教，实验比别的班多，bonus比别的班少很多，但是助教gg本身就是个bonus（逃）\n\n给分：10分，有助教gg的功劳，这两年yyc老师的助教gg都很不错，给分超好，助教gg请尽快打捞我wwwww\n\n糊涂程度：10分，貌似期末给所有人都算漏了分\n\n点名：有三次不通知的纸质签到，不知道算多少总评\n\n\n\n本人这个期末所有课都炸裂了，害，无法过多评价，但是单从给分和捞这两件事上看，她不至于只有1点几的査老师评分，虽说计院三幻神，但是我觉得除了讲课差和人有点糊涂以外她貌似没有特别多特别坏的特质，ljj和楼sir才是真的（请学弟学妹自行填空）
196591,2471,杨莹春,2024-07-04 06:55:47,9,10,1,我跟老师原则上不能在不通知大家的情况下更改评分标准，老师亲口说，她的原则是同学们的平时分都偏高，她觉得这样不行
197053,2471,杨莹春,2024-07-07 02:56:58,6,9,3,数逻\n\n教学能力太差了，刷新了我对浙大老师的能力下限的认知，老师的ppt做得云里雾里，上课还不如自己翻课本看，实验方面也全是自学，我都是靠隔壁班的实验文档磕磕碰碰做完实验的，整个学习过程极其痛苦。看到有人说给分好，但我被卡绩了，不敢苟同，个人建议大家还是选别的老师
197071,2471,杨莹春,2024-07-07 06:44:05,9,11,2,没有上过yyc的课，但是有幸srtp答辩的评委有yyc\n\n之前听闻yyc在诸如计算理论、计算机组成等课程中似乎会的还没有学生多，我半信半疑\n\n但是现在我确信了\n\n抛开人品不论，浙大有这种老师，该如何提升教学科研质量呢？
198301,2471,杨莹春,2024-09-06 09:22:56,18,18,0,老师在未通知的情况下自己修改评分规则，最后在同学的反映下做出改变，决定改分。改分的结果是大多数人分数保持不变，你们有这样的巧合吗，真是巧巧又合合呀。\n\n说人话就是：答应实验给分变高，但是压低平时分维持总分不变，以达到总分不变，不提交改分申请的目的。\n\n再说人话就是：傻逼才选它，我是傻逼
199244,2471,杨莹春,2024-09-20 00:53:07,11,12,1,楼下说的对，外加我和老师argue了两个多月的计组成绩，对方总能找出一种很新的评分方式不肯给我平时分，当我按照她给的标准重新算了一遍的时候，刚答应能够给我改，又出尔反尔换了种计算方式。人品也不行其实，她就是想糊弄过去，对什么事情都是。
199289,2471,杨莹春,2024-09-20 12:19:43,29,30,1,老师今天忘记来上课了
211922,2471,杨莹春,2025-01-13 01:54:54,-7,4,11,给分炒鸡好的老师！虽然自己不会教学，但给分相当相当好啊啊啊！完全可以上其他老师的智云课堂，混yyc的高绩点！！！
214386,2471,杨莹春,2025-02-02 15:00:45,-4,0,4,5559018338
214492,2471,杨莹春,2025-02-08 15:17:28,-7,2,9,老师挺可爱的
217642,2471,杨莹春,2025-04-14 12:14:12,7,7,0,一分的老师，十分的助教。这学期这个数字逻辑助教真的超级好啊
218172,2471,杨莹春,2025-04-22 01:38:31,8,8,0,研究生课程机器学习\n\n课讲的混乱至极，板书纯纯想到啥写啥，写完了面向黑板讲，学生根本看不到她指的什么内容\n\n一句话反复说好几次，吐字还不清晰，越说声音越小，讲着讲着就开始吃字\n\n不要指望在这门课上学到什么知识，考核内容比别的课多，慎选！！！！！！！！！！！\n\n\n\n讲话：就是、这个、对吧、他这个、嗯
219469,2471,杨莹春,2025-06-27 05:43:01,3,3,0,满分的助教，jhgg太棒了
219488,2471,杨莹春,2025-05-28 12:25:45,1,1,0,自己记错课程安排他妈的让我们期末周补课，讲课讲的巨烂，自己都学不明白还来教学生。但助教是神中神的，爱你助教
219621,2471,杨莹春,2025-06-01 14:41:34,3,3,0,您可怜的数逻课就非补不可吗
219691,2471,杨莹春,2025-06-04 08:07:51,1,1,0,计组有三次纸质点名。上课依托，建议听别的老师的智云。实验课也不知道讲啥直接问助教吧。但是老师人倒是不坏，虽然啥也不会但是也还挺有耐心。。给分也还行吧。没得选了也可以选她，但是千万别听老师讲课，浪费时间
220666,2471,杨莹春,2025-06-19 06:26:14,2,2,0,助教jhgg太好了！
221679,2471,杨莹春,2025-06-25 08:09:03,0,0,0,别选，要不是我选不上稍微正常点的老师谁会选她
221961,2471,杨莹春,2025-06-28 02:24:46,2,2,0,老师虽然上课不行，但是给分还是可以的
222084,2471,杨莹春,2025-06-29 12:44:07,0,0,0,老师确实不会 这我完全发现了\n\n助教昊神神中神！（听说明年还来哟
6955,2484,宋明黎,2015-08-23 08:01:40,33,35,2,宋老师人超级好
20573,2484,宋明黎,2016-01-28 13:41:39,17,21,4,Brook宋简直棒呆～我见过最萌的老师～
20589,2484,宋明黎,2016-01-28 16:21:16,11,11,0,人很好，常常和同学们交流，还卖萌
20912,2484,宋明黎,2018-06-29 10:33:27,-50,10,60,内容简单明确，每次作业一小时之内就能搞定（除了第一次），期末背背复习资料轻松满绩。
47735,2484,宋明黎,2017-02-22 12:05:53,6,6,0,好！好！
54264,2484,宋明黎,2017-06-29 02:14:24,3,4,1,老师超可爱，期末考题超友好，课上涉及的东西多点，不细讲就不细讲吧
56624,2484,宋明黎,2017-07-04 06:04:16,2,4,2,大牛教授
58544,2484,宋明黎,2017-09-01 05:59:38,1,3,2,老师超棒！上课讲的很清楚易懂，答疑也很耐心，考试也会给范围。
70815,2484,宋明黎,2018-01-27 14:26:13,7,9,2,不点名，事少，但是背的内容比较多，就是文科课程，记忆力好的同学们就直接冲吧，像我这样记忆力一般般的拿个3.9，有点小后悔。。
71346,2484,宋明黎,2018-01-28 10:28:41,10,12,2,宋老师是个实干派 讲课有点干，初听可能有些无聊，但只要认真听，绝对是收获满满。视觉的作业不算难，但要花点时间；最后期末复习，宋老师绝对是最赞的，回答问题没有一点架子
82520,2484,宋明黎,2018-07-11 07:49:52,2,4,2,好像不修分
83691,2484,宋明黎,2018-07-11 04:06:37,3,4,1,课程内容充实，难度适宜，老师认真负责，态度超好，可下也经常水群和大家互动，作业比较简单，但是挺有趣，考试好好复习稳过，给分好
84500,2484,宋明黎,2018-12-07 11:42:20,17,26,9,老师是真的好老师，这学期的助教是真的垃圾助教。平时分疯狂扣，有毒。这学期均绩能比往年能低0.6不止吧。
86478,2484,宋明黎,2018-09-17 00:35:33,16,17,1,被慕分而来的学生们操得想退自己的专业课
102488,2484,宋明黎,2019-02-03 10:52:21,-7,5,12,上课很好，给分有些一般
102489,2484,宋明黎,2019-02-03 11:03:11,3,3,0,有水平而亲切，不可多得的好老师，给满分。作业不复杂且是为了更好掌握知识点。
102494,2484,宋明黎,2019-02-03 13:18:47,0,0,0,人超级好，实验内容也很有趣，至少终于知道ps里面的一些算法是怎么来的了。六个实验一定要自己好好做，否则你会错过一门满绩
102500,2484,宋明黎,2019-02-03 14:47:43,3,4,1,一小时写完作业的那个笑了，平时分满分的我表示文档写起来都不止一小时（笑\n\n还是要认真对待呀，cv课能学到干货的
102540,2484,宋明黎,2019-02-06 03:13:22,6,6,0,宋男神对学生非常好，最后的大作业延期了好久，期末考试就是背背背，没满可能是平时报告写的太简略了...
117291,2484,宋明黎,2019-09-22 11:51:28,24,28,4,黎叔真是苦口婆心、想方设法地劝我们退课。。
121622,2484,宋明黎,2019-12-12 05:48:23,0,1,1,好好好
122030,2484,宋明黎,2020-02-02 11:23:01,-10,3,13,这个老师很好玩，完全没有长辈的那种严肃感，很逗，不过上课确实有点无聊，翘了几次，去上课的话基本不听，但是平时作业做了，期末好好看ppt的话分数绝对不低。我期末没有复习完，结果考到几题没复习到的，胡扯一通心想必完，但是成绩意外还蛮好看的，感觉有被捞过嘿嘿
122405,2484,宋明黎,2020-02-26 08:54:50,-4,8,12,上过宋老师的图像信息处理和计算机视觉，水平一流，人非常和蔼可亲，作业量不大难度合理～反对说课无聊～毕竟是工科课程无法和别的课相比～说无聊的人恐怕没有上过计院的某些必修课
136058,2484,宋明黎,2021-06-10 13:49:00,22,23,1,“您客气了”
143312,2484,宋明黎,2021-11-23 08:02:41,5,5,0,宋老师真是我见过最可爱的老师，2021秋冬学期喜欢喝元气森林了是吧hhhhh。钉钉群里面说话也超好玩，就像有趣的同龄人一样！
143818,2484,宋明黎,2021-12-07 12:39:03,11,12,1,看起来是个资深火影爱好者，连学在浙大上的头像都是火影23333
144191,2484,宋明黎,2021-12-20 07:57:03,1,1,0,老师人超级好！！
150232,2484,宋明黎,2022-01-20 17:48:09,6,6,0,老师是真的有大师风范，即有超强的实力，又幽默风趣，并且年轻时的黎叔还是个花美男（当你学期末登教务网写评价的时候就能看到靓照了）
150249,2484,宋明黎,2022-01-21 02:28:56,4,4,0,特别特别好的老师
150250,2484,宋明黎,2022-01-21 02:51:17,3,3,0,很好的老师
167471,2484,宋明黎,2023-01-16 14:01:13,4,4,0,讲课还行，不过有时候瞎扯的东西比较多，以及最后考试都是纯纯背诵课
167922,2484,宋明黎,2023-01-20 09:29:30,2,2,0,老师讲课还好，重点是人真的很赞，对待学生很有耐心
167993,2484,宋明黎,2023-01-21 14:33:11,15,18,3,老师人很好，但是讲课觉得很一般。\n\n出分更是离谱，大年三十出分，平时实验做了也不告诉你多少分，考试纯纯背诵。\n\n最后感觉给分也一般？
167995,2484,宋明黎,2023-01-21 15:22:33,5,6,1,给分一般
168009,2484,宋明黎,2023-01-22 06:43:08,-30,1,31,老师人很好，很有意思，上课完全不点名，讲的东西比较简单。\n\n第一次作业一定要好好做，接口做的好一点后面的就很容易。\n\n期末要记忆的东西很多，给分一般吧，4.5
168012,2484,宋明黎,2023-01-22 07:33:20,10,11,1,除夕晚出的分，群里突然开始刷谢谢老师。看得出来大家都比较爱戴黎叔。就教学来说，整体知识不是很难，但是内容还是比较多的，从基础的图像格式和编码等，到比较前沿的图像识别、卷积神经网络等，能很好的引导小白了解图像领域。老师平常讲课语气比较平淡，有时候会显得比较冷幽默，但是知识点是重点的时候会强调一下。老师很负责也很为学生着想，期中考试周较忙的时段，推迟了作业的ddl，让我们不要担心。最后一周是划期末考试重点的课，嘱咐我们好几遍一定要参加。今年线上的期末考试前，组织了两次模拟测试，第二次他应该是一个一个查看学生的设备情况的，在群里也一直和学生讨论线上考试的一些问题，考虑得很周全。最后我个人的给分来说，没有我想象中的好，但和付出也差不多成正比吧，只是原本听说给分还不错所以期待值比较高。
168013,2484,宋明黎,2023-01-22 09:45:25,8,8,0,给分确实一般
168377,2484,宋明黎,2023-02-15 05:46:13,12,12,0,视觉给分有点差，一方面由于线上考试原因，感觉出了很多不是背了就行的题，需要一些计算，比往年卷难度大了一些；另外一方面平时实验分不透明，完全不知道给了多少分。总之这课老师讲的迷迷糊糊，作业做的迷迷糊糊，考试也迷迷糊糊。
174955,2484,宋明黎,2023-06-20 11:44:15,-1,0,1,老师人很好，会反复组织线上测试保证不出问题，是我太蔡了然后考的东西全都没记住，在卷子上胡扯一通喜提最低绩点\n\n考前最好早点记背起来，我这种记了就忘的实在是折磨得要死
181465,2484,宋明黎,2023-10-18 07:54:40,-2,0,2,难得的好老师~
189342,2484,宋明黎,2024-01-23 09:38:52,-1,0,1,黎叔出分真的有点慢呜呜呜呜呜
189549,2484,宋明黎,2024-01-25 10:44:33,10,12,2,别信那些给分好的鬼话
189555,2484,宋明黎,2024-01-25 11:04:07,12,15,3,不在意给分的可以选，被狠狠创到了，想学东西看一遍ppt把他ppt里的assignment都做一遍就好了，但是他给分不是求是，应该可以算作绩杀了）））\n\n我知道的情况是：两个上4的，一坨1点几2点几3点几，整门课程的所有人的总体均绩感觉3.0差不多了。\n\n课是很水，但是出分能要你命。\n\n有一说一，黎叔是很和蔼，assignment也很有趣，但是这给分...我这辈子都不敢选他的课了
189562,2484,宋明黎,2024-01-25 11:21:08,7,8,1,给分极差，讲课特别催眠，慎选
189563,2484,宋明黎,2024-01-25 11:32:46,-29,4,33,说实话给分不好是助教的问题，不告诉你实验报告的分数，也不告诉成绩，不知道用意是什么。老师人很好，考前会告诉你要背那些东西，我觉得理解+背诵就可以，作业很多参考，最后我考前从头到尾背了 2 遍，考试除了图像金字塔其他都背到了，最后 97。大家考不好应该是没有他们没有调分的缘故。
189565,2484,宋明黎,2024-01-25 11:33:54,3,3,0,DIP，我的天哪
189566,2484,宋明黎,2024-01-25 11:45:39,7,7,0,图像信息处理\n\n\n\n讲课一般，考核方式不太行。建议直接要PPT自学，不建议选课
189574,2484,宋明黎,2024-01-25 13:00:37,13,13,0,这给分？建议都去找老师反馈，老师好像啥都不知道
189576,2484,宋明黎,2024-01-25 12:33:33,-41,2,43,DIP\n\n挺好的课，作为这个方向的入门感觉很不戳，期末有点太文科了。最后给了个94，难受啊jrm
189580,2484,宋明黎,2024-01-25 12:42:53,-15,4,19,挺好的课，就是期末需要好好背诵和看历年卷，最后有两道大题不是很会，感谢老师捞到了93。看到不少人说绩杀的可能是期末没有背好。答案都是课件里定死的，和老师没啥关系吧，但是你不会写的话肯定蒙不出来qwqqq。
189593,2484,宋明黎,2024-01-25 13:13:07,2,2,0,老师人很好，给分感觉应该算求是吧。\n\n平时六次作业占比40%，期末60%\n\n说实话六次作业基本只有一个功能实现，没有非常详细的要求，感觉摸着石头过河，凭感觉写报告。\n\n助教为什么不把平时作业分数公布一下。
189594,2484,宋明黎,2024-01-25 13:40:55,9,9,0,2023~2024年秋冬学期的图像信息处理。\n\n从课程教授内容上讲，主要讲述的内容包括实操内容（例如图像二值化、直方图均衡化、各种滤波操作等）和理论内容（比较复杂难以实操，例如卷积神经网络、SIFT操作、SURF操作等），实操内容个人认为相当有用，在普通物理学实验等课程中可以使用到，也是计算机图形学和计算机视觉基础中的基础，这两个方向都是浙江大学计算机学院的强项。\n\n本课程平时lab（本学期是6个）占比40%，期末考试占比60%。前面的lab基本上两周一个，不算太紧张，给分大概38/40（根据个人掌握的信息），给分的重点是期末考试，基本不会调分，而且大多数题目需要背诵，不背的话很难有话可说，所以部分同学可能对于编程掌握比较好但是最后的分数比较低。\n\n重点就是期末考试之前的背诵，针对PPT、学长的总结以及历年卷。如果时间比较紧张的话可以先看历年卷，从后往前，大概当你不看PPT就能答出80~90%的题目的时候，应该不会得到特别低的分数了，对于较复杂的操作，基本就是强行背诵，没有技术含量，考察也只能考察背诵。\n\n今年可以看出老师还是放了一点水的，首先是最后一个论述未来发展的题目5分意图很明显就是送分。前面的题目分数分布也能看出来，一些比较难的题目，比如image blending和CNN都是7~8分，基本的直方图均衡化操作大题却有15分。\n\n我的6个lab全部在截止时间之前提交，然后在考试前一天进行了疯狂的背诵，不过在我认为是考察重点的SIFT、SURF上浪费了不少时间，忽视了直方图均衡化的细节，导致15分送分大题只做了半对，不过也有收获，就是image blending的大题直接原封不动背诵（甚至英语不会翻译就直接写的英语），卷积神经网络由于之前修读的人工智能引论已经背过写出了最难的一道题。最后综评89，个人比较满意。\n\n希望可以给学弟学妹带来参考，希望黎叔的图像信息处理明年还有人选。
189612,2484,宋明黎,2024-01-26 02:36:23,12,13,1,给分很一般！不建议选。期末要拿高分请参考楼下高分同学从头到尾把划的重点好好背！但期末周哪有这么多时间去背dip呢（）所以慎选
189674,2484,宋明黎,2024-01-26 14:26:20,2,3,1,图像信息处理，课挺好的干货很多，做assignment也能学到不少。不过期末考试基本是文科背诵，不把重点流利背一遍可能都拿不到80多分，想要90+就参考那些高分评论吧。
189750,2484,宋明黎,2024-01-28 09:25:09,-19,3,22,整体来说这门课还是很有用的，srds黎叔上课经常吹水。期末考试基本文科背诵，而且历年卷拟合效果极佳，对着黎叔最后一节课画的重点一个一个背过去就行，感觉考的挺简单的。给分还行，喜提93。
189770,2484,宋明黎,2024-01-28 13:52:52,21,24,3,不点名。助教给分不透明和期末背诵默写为主大概是给分差的主要原因。\n\n老师考前给的重点大约有三四十个，最后卷子大约涉及十个。评论区里用幸存者偏差装13的学沙滩们别tm演了。
189964,2484,宋明黎,2024-02-04 02:55:32,2,2,0,给分很差，但能学到知识，也不点名，作业比较有趣。
207405,2484,宋明黎,2024-12-21 09:39:24,-2,3,5,一个沙雕老师
213347,2484,宋明黎,2025-01-17 08:31:37,4,4,0,作为23秋冬缓考到24秋冬学期的考生，似乎两个学期对于sml老师的评价两极分化，23秋冬（24年1月考试）当时好多人都在哀嚎，说给分不好，这学期换了助教但是我沿用了上学期的平时分，说实话我感觉我去年实验做得不是特别好，但平时分（23秋冬）还是拿到了38/40，新助教给他们选课的人的平时分似乎也挺好的（我问了下学弟）。24秋冬考试整体来说做得还是比较顺利，考前花了一个中午的时间去看去年他们整理的复习笔记，把重点记住就可以做出来大部分的题，整体来说24秋冬的备考总共花了2小时左右，最后拿到很不错的成绩，也算是很好了！btw，23秋冬好像没点名，24秋冬选的人太少了点过名）
214438,2484,宋明黎,2025-02-03 10:29:23,0,0,0,不错的老师，但是课程设定比较恶心，需要自己花很多时间，记得多参考前辈的笔记
214914,2484,宋明黎,2025-02-19 05:34:25,1,1,0,老师人超级好，上课内容也简单，实验花的时间也很少，基本每个实验一个晚上就解决了，最后期末考试就是背多分，而且老师非常捞，总结下来是非常推荐选
8964,2551,陈华钧,2015-10-06 13:41:41,6,9,3,不错哦
76058,2551,陈华钧,2018-03-26 05:22:07,0,3,3,上课态度真心不行，上课迟到，然后再磨蹭半天，其他暂不评论
104057,2551,陈华钧,2019-03-11 06:37:55,-2,2,4,很懒。
108289,2551,陈华钧,2019-05-20 06:59:50,1,2,1,大数据存储技术像通识选修课，没机会真的见到用来存储的设备
113970,2551,陈华钧,2019-07-08 04:23:55,0,0,0,给分一般到群里都没人谢谢老师
113973,2551,陈华钧,2019-07-08 04:45:14,1,1,0,给分中规中矩吧，想满有点难，想很差也有点难
122082,2551,陈华钧,2020-02-11 15:37:54,9,9,0,老师很随和
134681,2551,陈华钧,2021-04-09 04:54:34,5,5,0,老师比较平易近人
145151,2551,陈华钧,2021-12-28 01:23:09,4,4,0,这老师每次邮件都是已读不回
158740,2551,陈华钧,2022-07-01 17:40:18,1,1,0,用钉钉定位点了几次名，上课比较水，课程最后就一个展示，给分还不错。
164242,2551,陈华钧,2022-12-19 16:41:26,0,0,0,偶尔几次点名，给分还是很好的，算是挺不错的通识课
176688,2551,陈华钧,2023-06-29 17:07:48,0,0,0,这学期完全没点名\n\n因为只有一次展示\n\n还很担心成绩\n\n今天出分了终于放心了\n\n谢谢老师
176691,2551,陈华钧,2023-06-29 17:15:32,0,0,0,给分有点迷
176834,2551,陈华钧,2023-06-30 10:13:56,0,0,0,作为通识课不错，最后就是展示，给分也还行
195554,2551,陈华钧,2024-06-28 17:38:47,3,3,0,给分很好，事情少，就一个报告和pre，钉钉群签到，很随和的老师！！！
195622,2551,陈华钧,2024-06-29 05:03:00,9,10,1,开门！社区送温暖 ！！\n\n●█〓█€█▄▄▄▄▄▄▄▄▄▄▄\n\n▄▅███████████▅▄▃▂\n\n█████████████████\n\n◥⊙▲⊙▲⊙▲⊙▲⊙▲⊙▲⊙▲⊙◤👎👎👎👎🖕🖕🖕
195634,2551,陈华钧,2024-06-29 06:11:57,0,2,2,大数据存储与计算技术 水分无敌课！签到是钉钉群签到，没作业没考试，最后展示给分无敌好，展示正常再提问个问题随便拿满绩，我看谁不冲？chj无敌
195638,2551,陈华钧,2024-06-29 06:19:12,2,2,0,CS专业课：举手的艺术，懂的都懂，10分送上
196410,2551,陈华钧,2024-07-03 08:48:22,0,0,0,大数据真乃神课
219836,2551,陈华钧,2025-06-08 11:58:50,2,2,0,未读（1人：chj）
221592,2551,陈华钧,2025-06-24 17:07:53,0,0,0,大数据不点名，没几个人来老师也不管\n\n老师感觉人挺好，但是就是不怎么读消息
221650,2551,陈华钧,2025-06-25 05:57:49,8,8,0,这学期不知道是不是老师忘了点名，最后给分也很随机，相比别的专业课可以说是比较差了
221655,2551,陈华钧,2025-06-25 06:39:44,4,5,1,今年给分是💩，但模块课不得不修
221659,2551,陈华钧,2025-06-25 06:47:23,6,6,0,给分很随机，今年提问环节也因为赶时间后面取消了，展示老师也很赶时间，几乎不怎么听，随手翻一下报告PPT，然后就给了一个最后的分数，给分随意性太大，我个人感觉今年给分不好，该展示的展示了，中规中矩，最后84，也当了组长，每个组的内容几乎都听了，感觉都差不多，我也不知道怎么给分的，如果想要确定的分数还是远离这种课，老师自己也蛮混的
221660,2551,陈华钧,2025-06-25 06:51:25,5,5,0,感觉今年给分一般
221661,2551,陈华钧,2025-06-25 06:51:50,7,7,0,事少分少，给分够随意的，这个分数下建议摸鱼
221668,2551,陈华钧,2025-06-25 07:14:48,5,5,0,什么垃圾给分\n\n上课水，考核也不放在心上，期末瞎jb给个分
221669,2551,陈华钧,2025-06-25 07:15:22,2,2,0,抱着水课心态来的，只有一次期末展示，小组其实有好好准备，出分4.2，结合课友评价应该是给分不如去年\n\n水学分可以，但是分数应该比较主观，卷绩点仔细考虑
221683,2551,陈华钧,2025-06-25 08:24:47,6,6,0,经过消融实验，当组长不加分，提问总评加2分。\n\n自己分还不错就不喷了。\n\n想要给的高：\n\n1、不要跟别人的内容高度雷同，老师的推荐选题都不推荐，疑似老师看太多同质化东西以后生气了最后量产85\n\n2、举手的艺术，占座的艺术，让老师看见的艺术，懂的都懂
221717,2551,陈华钧,2025-06-25 12:22:42,3,3,0,牢陈规则怪谈：\n\n1.牢陈在点名的时候会一远一近分区点，如果能让他在转椅子的时候第一眼看到你 那么被点到的概率激增\n\n2.永远不要选择他推荐的选题\n\n3.平时上课根本不会点名 也没有人听
221737,2551,陈华钧,2025-06-25 16:54:52,0,0,0,给分依托，谨慎选课
221800,2551,陈华钧,2025-06-26 09:48:15,3,3,0,事少分差
221827,2551,陈华钧,2025-06-26 14:22:46,3,3,0,今年给分实在一般
222060,2551,陈华钧,2025-06-29 09:58:42,1,1,0,春夏学期上了大数据存储与计算技术，平时上课没有点名，没有作业，只有一次小组作业展示来决定最后分数。个人感觉给分较为随机，可以选择一些特殊的主题来吸引老师注意力，水学分是一门好课，如果追求高绩点的话谨慎选择。平时钉钉上老师不太关心同学问题，最后线上展示有同学问时间，两三天后才确定时间。。。
1162,2617,蒋方炎,2015-03-21 16:22:23,5,6,1,人如其名…
163278,2635,张传华,2022-12-12 03:10:53,1,2,1,。。。。线上考个几把啊sb
184799,2635,张传华,2023-12-23 02:04:16,3,3,0,秉公办事，不为学生提供帮助，真好
186065,2635,张传华,2024-01-08 06:02:50,9,9,0,你算你吗几把老几啊，你跟李晓比就是个弟弟，李晓老师比你负责多少倍心里没点逼数吗
190232,2635,张传华,2024-02-26 06:25:26,1,1,0,恶心东西，真喜欢摆架子，一副不耐烦的样子。李晓老师虽然有时候也会不耐烦，但她的工作态度是你永远比不上的。
193036,2635,张传华,2024-06-03 02:03:57,1,1,0,你还真是个吊毛
219861,2635,张传华,2025-06-09 07:06:17,4,4,0,不是哥们，专业必修课加其余时间冲突你看也不看直接不让补选啊
219879,2635,张传华,2025-06-09 14:53:44,1,1,0,干啥啥不行，为难学生第一名
30872,2646,卜佳俊,2016-07-02 16:53:20,-2,0,2,啊，ADS上课没怎么听，差点挂了。感谢老师助教不杀之恩。
31621,2646,卜佳俊,2016-07-04 09:28:09,1,3,2,听他讲课感觉学不到多少东西，有的东西他也不是很懂的样子……
40787,2646,卜佳俊,2017-01-05 13:21:01,0,0,0,三个字
48619,2646,卜佳俊,2017-03-08 12:19:39,10,13,3,讲的还不错。。。就是因为老师出差了一次下一次四节课连上，从AVL树讲到了红黑树再到B+树，一脸懵逼
77917,2646,卜佳俊,2018-05-08 14:16:47,1,5,4,互评清一色的0分
84018,2646,卜佳俊,2018-07-11 23:40:29,4,4,0,助教宛如黑社会老大 真是为所欲为...
85204,2646,卜佳俊,2018-07-16 04:44:20,2,2,0,老师讲得很好，只是夏学期经常出差，叶德仕来代课...
113886,2646,卜佳俊,2019-07-07 23:25:01,1,1,0,有没有人能告诉我学习帝均绩3.96是真实的吗
114376,2646,卜佳俊,2019-07-10 00:16:21,1,2,1,学习帝均绩不用看了，它是这门课改革以前的成绩，现在改了之后均绩降了很多
122064,2646,卜佳俊,2020-02-10 21:25:48,0,1,1,老师讲得好，人品也好
122568,2646,卜佳俊,2020-03-04 06:43:32,0,0,0,老师人很好。
128179,2646,卜佳俊,2020-12-10 11:19:26,1,5,4,2020年度全国助残新闻人物\n\nhttps://mp.weixin.qq.com/s/rZ6Ggd8aidZ9QoCLvq6RRg
133086,2646,卜佳俊,2021-02-07 19:04:48,0,1,1,ads平时分给分很好 讲得也算比较清楚 老师人也特别好 要刷平时分建议多刷一下q&a 总之算是ads老师里面比较推荐的了
158974,2646,卜佳俊,2022-07-04 06:25:16,2,4,2,平时分真的很烂\n\n算下来平时分被扣了7.6分 离谱
158989,2646,卜佳俊,2022-07-04 08:39:39,0,0,0,老师人挺好的
158990,2646,卜佳俊,2022-07-04 08:39:39,0,0,0,老师人挺好的
171584,2646,卜佳俊,2023-03-29 11:47:29,0,0,0,。。。。
172037,2646,卜佳俊,2023-04-18 03:09:37,1,1,0,喜欢连坐
172375,2646,卜佳俊,2023-04-25 13:55:20,1,3,2,出生老师，讲课烂还恶心人\n\n别的老师都是尽量让同学平时分满的，pro多做一个都可以加平时分，加满60为止\n\n你倒好，说这样大家分数都太高了，只能加pro的30分\n\n选上的快逃，畜生老师真该414
174050,2646,卜佳俊,2023-06-06 02:52:57,-2,1,3,只会逼逼逼 自己讲课什么水平心里没点逼数
174970,2646,卜佳俊,2023-06-20 13:14:15,0,0,0,给个7分吧，老师基本的课程是能讲清楚的，只是有时候时间安排不好会临下课很赶，后面的内容比较马虎；有一组同学展示的时候少了一个人，在场的两个人说联系不上，老师就比较生气，最开始没准他们展示，说是他们组内沟通问题，后来又展示了，不知道展示分数怎么处理的
177554,2646,卜佳俊,2023-07-03 16:14:43,1,1,0,建议老师以后的bonus可以直接加到平时分里，以及QA真的很重要
178314,2646,卜佳俊,2023-07-10 03:31:18,2,2,0,老师对project的展示很严格，但其实人还是很好的。出分速度很快，ADS的分数很透明各个老师都差不多主要靠自己，所以如果不是很在乎讲课的话还是不错的
190581,2646,卜佳俊,2024-03-10 08:13:01,2,2,0,讲课十分一般
208983,2646,卜佳俊,2025-01-04 05:12:59,1,1,0,老师挺好的，但平时分给的不是很好，感觉要求有点多，听我室友说别的班平时分好像基本都是给满的。
219083,2646,卜佳俊,2025-05-21 08:32:04,0,0,0,老师人还是挺好的，虽然讲课一般，不过可以智云其他老师，得分的事情全权交给助教，至少上学期的助教哥哥人还是特别好的，bonus是每多做一个lab平时分+1，可以多做一次展示，好像是平时分+2，都可以以小组的名义做，整个组都有加分。
20739,2672,李际军,2016-01-30 12:52:56,-22,3,25,很好哦
28263,2672,李际军,2016-06-28 08:22:49,3,7,4,没记住长相。。。
58802,2672,李际军,2018-03-05 01:22:20,-90,13,103,选的他的C#小学期。讲课主要念ppt且本身C#水平一般，但是人很nice，综合给分不错且付出就会有回报。小学期会布置ddl为直到开学的大作业，会有恶竞。综合给9吧，毕竟满了
58857,2672,李际军,2017-09-18 05:57:05,-7,7,14,上了他的短学期，从来没听懂过。但似乎给分还不差。
59014,2672,李际军,2017-09-19 06:10:31,-8,8,16,短学期给分很好
60003,2672,李际军,2017-10-01 08:44:03,-13,4,17,很好的一个老师，讲的全面
75802,2672,李际军,2018-03-19 02:11:24,-6,22,28,老师OOP讲的很仔细很认真的说  而且态度也超棒
80283,2672,李际军,2018-06-24 08:14:11,25,28,3,大作业在最后三周布置 贼坑
80412,2672,李际军,2018-06-26 08:24:35,-13,4,17,老师人超好！！！
80631,2672,李际军,2018-06-28 13:47:51,36,38,2,上了他这学期的oop，期末的时候想捶他
82391,2672,李际军,2018-07-10 12:43:46,-11,4,15,嗯 期末作业多的我想打人 但是老师很不错 很负责 批评过我代码问题让我一点一点改...
83808,2672,李际军,2018-07-11 08:49:34,-9,7,16,老师很nice，认真教你写代码，格式什么的都会上机检查大家！给分不错啊，就是期末大作业能不能布置早一点？？？
83878,2672,李际军,2018-07-11 12:15:29,-16,2,18,给分nice
85005,2672,李际军,2018-07-15 10:18:57,-5,2,7,哇哇哇哇
85682,2672,李际军,2018-07-25 13:24:08,-55,7,62,大学三年第一个满绩，感天动地好老师
86644,2672,李际军,2018-09-17 23:40:19,-1,5,6,还没见到老师
87609,2672,李际军,2018-10-09 00:51:10,2,8,6,老师每次提前二十分钟上课，中途休息两分钟，可能还压堂，亲老师吖
88753,2672,李际军,2018-11-07 09:41:03,14,17,3,跟各位说一下，这老师小学期最高4.5，给分中值3.9，各位自己看着办吧
88763,2672,李际军,2019-08-20 12:45:14,248,264,16,老师讲课凑活 在临近考试周留100道题只给四天实在想锤爆他的脑袋
88764,2672,李际军,2018-11-07 12:11:22,96,107,11,任务布置不明确，作业经常很迷。上机课要求签到，考试周前心血来潮在pta上布置接近两百题且只给5天时间
88793,2672,李际军,2018-11-08 06:33:20,74,79,5,oop，一次上机60道编程题，另外还有近百道填空选择，看着办吧，呵呵，老师自己做做看，傻逼
88868,2672,李际军,2018-11-11 05:31:39,20,23,3,傻逼老师，考试周前布置tm100多道题！不让我们复习
88872,2672,李际军,2018-11-11 08:16:04,15,19,4,傻逼一个\n\n
88882,2672,李际军,2018-11-11 13:15:35,35,36,1,作业布置的多暂且不谈，麻烦布置的时候走点心好吗，一些毫无意义的题目真的太浪费时间了
88886,2672,李际军,2018-11-11 14:38:43,30,33,3,临期中考留了几百道题，ddl只有几天。
88888,2672,李际军,2019-03-29 00:06:22,1537,1610,73,生活本就很艰辛，半路杀出李际军。上课朗读屁屁踢，下课TM浪一批。期中考试百题斩，我想拿刀把他砍。劝君更尽一杯酒，这个老师绕着走。
88954,2672,李际军,2018-11-12 14:12:13,28,30,2,一副恶心的嘴脸说做题是为了你们学到东西。那你tm不要几十道pta就给半个星期的ddl啊。就跟那些拍脑袋的领导一样，不管别人死活。
89520,2672,李际军,2019-01-28 02:06:36,28,34,6,上课念ppt，作业多到炸，嘲讽学生，给分巨低。这样的老师怎么还不滚出浙大！！！
89524,2672,李际军,2018-11-19 11:33:36,15,15,0,傻逼老师
89526,2672,李际军,2018-11-19 11:36:02,6,8,2,这作业是什么鬼\n\n\n\n\n\n
89530,2672,李际军,2018-11-19 11:43:02,3,13,10,老师人还可以，问问题回答比较耐心。但是一次布置几十道编程题ddl一周是什么鬼啊，当我们没别的课要学了吗，一学期三十多学分的人，你再这么一搞，我真是要原地起飞了
90840,2672,李际军,2018-11-26 12:09:41,12,13,1,不知道学生平时事情也很多吗？
91427,2672,李际军,2018-12-10 01:26:06,22,23,1,这老师真的情商为-∞，还是别教书了，先好好学做人吧
91706,2672,李际军,2018-12-18 06:26:34,7,8,1,只求好好布置作业
91869,2672,李际军,2018-12-24 01:19:43,9,13,4,上课讲的都是什么？不想教就别在浙大祸害人了行吗
91914,2672,李际军,2018-12-25 01:32:39,16,17,1,前面慢悠悠地讲\n\n发现赶不上进度了\n\n就自己去看书？？？\n\n上课完全按书上讲\n\n除了读ppt没别的了
92269,2672,李际军,2018-12-27 10:46:51,4,5,1,不好的
92291,2672,李际军,2018-12-27 13:30:00,14,15,1,每次上机听老师回答同学的问题真的是一大欢乐源泉
92411,2672,李际军,2018-12-28 10:00:31,26,27,1,简直就是推脱，问什么题都会扯到别的地方，一整就说你自己去想，点点点再也不选了
92999,2672,李际军,2019-01-07 00:25:09,14,15,1,题目多且质量不高，很多题目和本周学习内容不符，极浪费时间
93009,2672,李际军,2019-01-07 01:49:23,73,76,3,"开学说好了不用做的pta题目最后要算入总分，去问他就一句""你可以不做啊""，呵呵，傻逼老师"
93121,2672,李际军,2019-01-07 11:40:23,-38,9,47,本人亲测c#小学期和这学期oop，个人感觉李老师人还是很好的。期中考试周前布置很多题大概是因为那周才开始pta，前几周都没有布置的作业一起布置了吧。后来的题量也没有特别大，函数编程题也就七八道，不会像ds那样一道写好久，不过有些题目确实有毛病让人很烦。关于问问题，你不要问一些挑战原则的问题，李老师都是很耐心微笑回答的。所有人都在抱怨，怎么没人感谢期末没有project呢，翁恺班胡兰青班的同学这次都有project，个人觉得这给期末复习赶别的ddl省了不少时间。本人小白，感觉学习李老师oop收获还是很大的。理性看待吧，嫌麻烦的同学或大佬就直接绕道吧！以上纯个人想法。
94011,2672,李际军,2019-01-15 01:17:24,11,14,3,期末PTA200+题是sd吗？？？
97206,2672,李际军,2019-01-22 00:19:15,42,45,3,上课和作业布置怎么样不谈，感觉人品不行，同学在群里问问题各种冷嘲热讽，从没见过正面回答的。要是懂还用问吗，老师就该有老师的样子。我们不懂至少部分反映出你的教学水平也不咋地。
97300,2672,李际军,2019-01-22 07:56:32,42,44,2,没有解答，问问题基本不回答，考前不知道考什么，在群里回答问题的时候总是会有各种其他的方面来替代而不是作答，基本靠自学，作业多，没有讲解，不管死活，大概这些，自己决定吧\n\n
97410,2672,李际军,2019-01-22 08:42:25,16,17,1,就是tm傻逼一个，说话跟tm食屎了一样
97414,2672,李际军,2019-01-22 08:44:11,24,27,3,别的么不谈了，连期末考试题型都能搞错也太真实了8
97483,2672,李际军,2019-01-22 09:18:29,23,25,2,佛了，佛了，以怼学生为乐?
97551,2672,李际军,2019-01-22 10:31:23,30,31,1,可以好好回答一次同学的问题么
97558,2672,李际军,2019-01-22 10:46:19,163,175,12,证明一下:千万别看这个老师评分高就选他的课，我开学初的时候就是8.4，那时候差评还没有这么多，结果学期末一看，差评多了好几倍，可是分数一点没变…… 这个老师作业多、给分差、作业内容直接拿的pta上其他学校(还不是好学校的)、作业布置时间超迷，你问他个问题他永远用讽刺的语调回答你，qq群里有个同学问了句考试有哪些题型，这个老师就回了句“你们两个是小班的还是中班的”，期中考试之前作业一口气布置几百道，pta上分成两份，同学问两个都要做吗，结果老师回了句“你可以不做试试看啊”，临期末考试，除了说是上机考以为什么都不说，结果我们那个班到最后全借的其他老师资料来复习。但是说实话，也不是没有好的地方啦，老师讲课其实还可以，而且这学期似乎被吐槽作业太多，结果最后没有布置大程，而且作业后来几次量也又明显下降，到期末考前也没大量布置作业了，所以学弟学妹看着选吧，就是风险太大……
97824,2672,李际军,2019-01-22 22:56:06,22,23,1,听课没啥体验，就是口音太重挺不习惯。倒是这人脾气很差，师德不高，同学问问题不是让人自己想，就是冷嘲热讽，没劲
98772,2672,李际军,2019-01-24 02:18:56,13,14,1,课件还行，上课朗读，作业rubbish，提前告知考试的形式是您的义务诶，解答疑惑也是义务诶，不说了狂躁症建议尽早就医
99198,2672,李际军,2019-01-24 11:38:15,-18,0,18,优秀。
99305,2672,李际军,2019-01-24 14:29:35,15,17,2,原评价:可以好好回答一次同学的问题么\n\n现在只想说:你tm是不是不会好好说话
99364,2672,李际军,2019-01-28 02:03:37,17,19,2,“讲的不好”——这是之前的\n\n傻逼一个和它讲人话根本没用
100406,2672,李际军,2019-01-26 05:34:31,8,10,2,那个写打油诗的同学你怎么这么有才
101204,2672,李际军,2019-02-01 02:53:40,133,144,11,更新一下吧，翁恺班oop出分了，同学期末比我高一分，总评能高我八分。
101205,2672,李际军,2019-01-28 02:09:25,18,23,5,“平时做的题目的分数占50%，那次测验的分数占50%；累计起来作为平时的分数，占总成绩的30%”这是考完了之后被同学问分数说的，而那次测验那天，他一直说的是，那个测验和一次平时作业一样比重，一样算分————就这样连评分标准都不说清，怎么学
101206,2672,李际军,2019-01-28 02:03:58,17,21,4,傻逼老师\n\n我总评比卷面低了6分
101212,2672,李际军,2019-01-28 02:09:54,16,18,2,别选这个 真的别选
101213,2672,李际军,2019-01-28 02:10:51,18,21,3,本来说好不算分的PTA题目期末又算分\n\n平时作业贼多每周都有作业\n\n期末给分迷得一匹\n\n总之谁选谁倒霉
101214,2672,李际军,2019-01-28 02:13:10,24,28,4,给分只比卷面低7分，莫慌
101217,2672,李际军,2019-01-28 02:16:52,11,17,6,讲真，凭良心老师的ppt真的不错，所以这些分我全给老师ppt了。警告各位想要选这个老师的人，如果你没有什么学术素养，只想要分的普通人，我劝你还是别选了。pta作业题难得飞天，编程题函数题很多，自己写每个一两天是写不完的，平时怎么计分也不说，跟你说pta可写可不写(他一开始跟我们说pta不计分写了就行，然后到学期末的时候突然说pta成绩也是算分的)，到了期末算分就是pta作业分占一半，平时分记得真的迷的不行。问问题被嘲讽，啥都不说，群里也没有助教(更别提某些阴阳怪气的大佬了)，我想学啊，但是我活该是个弟弟我不会我不配学习。
101219,2672,李际军,2019-01-30 01:34:23,108,119,11,下面4.8的那位，我不知道是什么给了你自己很厉害的错觉？敢问你在题目答案修正以后期末的分数多少？如果你配不上现在的成绩，作为“求是”的浙大学生，你是不是应该在开学以后去教务处自己把成绩改回来？还重新做人？同学们一开始是这么激动的吗？还不是因为在群里面反映问题，想要拿回本应该属于自己的分数，老师却一味地在那里打太极拳，毫无作为，还解散群聊，置同学们修改分数的请求于不顾。你站在既得利益者的角度当然是轻轻松松，但那些理应得到更好的成绩，却因为期末上下近10分的误判，不但丢了绩点，还要得罪老师，被群里拿着虚高的分数的人嘲讽着的同学们呢？你自己心里难道不清楚这件事到底孰是孰非吗？\n\n\n\n比你强的人在这里，他也觉得这个老师很差。
101220,2672,李际军,2019-01-28 02:18:49,15,18,3,明明做了很多，到最后总评比卷面分还低，而且死的不明不白，心好累啊
101221,2672,李际军,2019-02-05 03:38:47,96,114,18,翁恺班同学期末比我低了15分，总评高我1分 这种老师不喷留着干啥
101223,2672,李际军,2019-01-28 02:28:59,29,33,4,老师名言：分数不重要，学到知识最重要(=^.^=)所以不在乎你绩点爆炸就选吧，不过貌似上课内容也就是按照PPT读，好像也学不到太多呵呵呵\n\n
101224,2672,李际军,2019-01-28 02:21:49,79,84,5,我想来总结一下这老师，首先这人不是一个合格的老师。原因如下：1.平时作业多而且质量不过关，很明显可以看出是不经大脑直接就拿过来用的（比如有一次作业出现了两个挨在一起一模一样的题，这题还是上次的原题），但凡看过作业的老师绝对不会出现这种问题；另外期中考试百题斩的破事不想多说，其他人都提到了，明明知道我们考试周还布置这么多作业DDL还就几天是什么意思？美其名曰做题练习，那为什么DDL这么短？2.人品师德实在差劲，上机课同学们问问题就从来没有好好回答过，反之一昧冷嘲热讽，别问，问就是骂人自己看自己学。那请问您这老师存在的意义是什么？3.从不正面回答学生问题。在群里面提问的时候每次都是顾左右而言他，问的问题不回答只是敷衍，到最后也没有答复。4.对学生的考试丝毫不上心，在考oop之前，群里面很多人别说复习资料了，连考试题型都不知道，问也是不回复，让你自己学，你觉得呢？这种回答。弄到最后还得去问其他老师班的同学要资料和题型。5.最后针对说他上课和POT还行的人，这难道不是老师应该做的？为人师表该做的都只做到了一点点就可以受到夸赞了？就是因为不少人的要求就这么低，只要绩点给得好就是感天动地好老师了？难道不负责任的老师大行其道你们就毫无关系了？心情不好，言语过激之处实在抱歉，但希望以后的学弟学妹们甚选这个老师。
101226,2672,李际军,2019-01-28 02:23:18,15,21,6,服了，作业布置的超级多，曾经有50+编程题，而且题目也很垃圾，有的点全班没人过。课程要求不清不楚，上课也一般，疯狂强调考试是手段，可是很多细的知识点您也没讲啊。\n\n作业是还说可以选择性的做，最后期末直接按得分/总分折成平时分，最后解释道，你可以不做啊。平时分拉低卷面分也是醉了。
101240,2672,李际军,2019-01-28 02:37:08,16,19,3,有这种老师给浙大丢脸！！
101248,2672,李际军,2019-01-28 02:41:49,36,40,4,我无语了，第一次见到最后得分会比卷面分低还低到卡绩。平常作业多到爆炸，20道编程20道函数，要不是老师我还不知道PTA上可以有这么多题目呢！问问题从不正面回答，你看开学初还有人“老师怼人真好玩”，等你自己被怼了or自己也想问这个问题但看见别人问了被骂就不这么想了。
101251,2672,李际军,2019-01-28 09:35:46,30,33,3,QQ请你更新分数，装作没看见？\n\n开学教务处见吧
101257,2672,李际军,2019-01-28 03:08:23,49,52,3,一分都不想给。 问知识上的问题，他不耐烦。问成绩上的问题（例如考试题型、成绩构成），他讽刺你。聊那些没用的（闲聊，比如八九年这时候你在干啥），嬉皮笑脸，很愿意聊。评分标准极为模糊，前后不一致，美其名曰“学知识比分数重要”。期末不知道考啥题型，不知道知识范围，复习根本没有方向。给分还低，本人平时练习好好做了最后才给个及格分？听说平时练习成绩很好的同学30分平时分只得了8分，ljj还说平时分最低60（100分制）。本人总评比期末考试低了10分。期末考试答案明明有问题，就不给更正，说题目没有问题，也不给出理由。\n\n双语课程，讲课用汉语，PPT是汉语，平时作业练习都是汉语，从来不提考试。最后有同学问考试是英语还是汉语，他就讽刺到，英语和汉语有什么区别吗。之后有同学在群里问问题，同学说看不懂题目（说的是题目可能有问题，这是个知识性的问题），他以为同学说的是英文题目会看不懂，他就讽刺到“你的外语是俄语吗”，不回答同学的知识性问题，讽刺人倒是挺溜的。
101258,2672,李际军,2019-01-28 02:52:33,20,26,6,希望你下学期回幼儿园做个人
101261,2672,李际军,2019-01-28 02:55:48,11,18,7,给分极差，看系统做题分数给平时分。如果全对了还来上课做什么？百分制下居然平时分比考试分低不少？而且不是点名没来作业没做...
101263,2672,李际军,2019-01-28 02:59:09,56,64,8,我觉得李际军傻逼这个ID一点也不过分
101268,2672,李际军,2019-01-28 03:06:00,12,17,5,没话说\n\n分给ppt 老师太不耐心，就喜欢各种刻薄和毒舌。真心觉得ljj就是不愿意学生考好的样子
101289,2672,李际军,2019-01-28 03:26:37,31,33,2,我估分3.9+，出分1.8，问评分标准还根本就不理你，煞笔老师，千万别选
101300,2672,李际军,2019-01-28 03:49:19,-17,7,24,老师非常好
101315,2672,李际军,2019-01-28 04:00:28,16,18,2,会了的可以不做，不算分。\n\n平时成绩占百分之三十。\n\n你可以不做啊。\n\n\n\n平时成绩拉低卷面成绩。\n\n佛了。比预估降了两到三档。\n\n
101360,2672,李际军,2019-01-28 05:32:55,17,20,3,千万别看评分，能操作掉一定操作掉，只能帮你们到这里了
101368,2672,李际军,2019-01-28 05:56:19,9,14,5,令人作呕?
101373,2672,李际军,2019-01-30 03:19:59,19,23,4,平时分还扣了不止五分?真好，那我诅咒你春节出门直接暴毙
101375,2672,李际军,2019-01-28 06:07:13,5,8,3,上这位老师的课，就抱着自学的打算去吧，我们期末考的时候，课还没讲完
101381,2672,李际军,2019-01-28 06:12:23,61,63,2,麻烦期末出分的时候不要连这种老师都刷谢谢老师好吗？斯德哥尔摩了？？？
101387,2672,李际军,2019-01-28 06:24:22,8,12,4,卡绩3.3。点点点。\n\n我不说老师，我来骂一下zjuC程\n\n考你?的undefined behaviour呢\n\n我要是你上司你能写出这种代码直接滚出去好? \n\n草（中国语）\n\n一人血书8分钟写4题实验应该给予加分
101390,2672,李际军,2019-01-28 06:26:54,16,20,4,（oop）本来是一个令人作呕的老师，在各位同学的衬托下形象突然就光辉起来了呢，真是辛苦大家了
101391,2672,李际军,2019-01-28 06:29:57,52,57,5,答案错了还没改就出分的骚操作是真的牛逼。\n\n怎么艾特都不回，提到校长信箱了突然冒出来超级委屈了。\n\n只想对洗地狗说，实名举报是纳税人的基本权利，别人冒着得罪老师的风险给你争取来了改成绩的结果你却只会舔老师。要点脸吧。
101412,2672,李际军,2019-01-28 07:16:31,17,18,1,上课催眠大师，只会念PPT，底下人都睡着了。作业火葬场，天天熬夜做作业，作业题多而且很多重复。给分差，基本不会调分
101421,2672,李际军,2019-01-28 08:21:38,40,44,4,请问贵老师的评分是如何维持在8.4的
101427,2672,李际军,2019-01-28 07:50:27,10,11,1,太垃圾了 一学期全自学 给分还差
101463,2672,李际军,2019-01-28 10:51:11,-4,12,16,个人觉得对老师口无遮拦和随便问候同学母亲同样不可取，随意上升到“贵浙”开地图炮也只会让认同自己观点的人更少。
101521,2672,李际军,2019-06-20 14:19:59,-273,20,293,反正我认真学了一个学期最后4.8，自己菜还怨别人？真的是匿名就可以为所欲为了啊，没有一丝一毫的尊重吗？先学学怎么做人吧，不知道自己反省一下，第一反应是对老师大骂特骂，人身攻击，觉得这样很有本事吗？
101529,2672,李际军,2019-01-28 11:00:40,10,12,2,别再让我看到他，不然我要跟他拔刀相见
101633,2672,李际军,2019-01-28 15:44:35,6,10,4,不想说什么，没有基础的同学最好不要选他的课，因为上课基本学不到什么，全靠自己努力，期末勉勉强强过了就好了，也别纠结绩点啥的了，上了一次课就都懂了，反正期末上不完的课有三章，还都是考试要考的....
101641,2672,李际军,2019-01-28 16:15:14,-49,5,54,老师可能确实有的地方没和我们讲清楚、说清楚，但是因为匿名就可以对老师随便开展人身攻击甚至用上这么恶毒的诅咒吗？老师自己都在群里反省为什么没有教会大家编程，有些人真的不反省一下自己的言语有没有不当的地方吗？
101779,2672,李际军,2019-01-29 05:08:24,13,18,5,回复下楼下那只舔狗，你说这话的时候自己的良心不会痛吗?傻逼老师给分怎样你自己心里没点逼数是吗？同样的c程课其他老师平时分基本不扣不说，甚至还会调分，这个煞笔呢?呵呵
101882,2672,李际军,2019-01-29 11:55:52,9,10,1,一学期都靠自学，最后一点分不调，给分超差，作业多，还出的很多下学期的东西，慎选呵呵
102109,2672,李际军,2019-01-30 12:58:12,12,14,2,整个学期自学c呵呵呵了\n\n好像没有助教\n\n问他问题全程嘲讽，当着全班巨大声地对你喊:不要问我这么不专业的问题\n\n我操你妈呢 我就不说给分了 先好好说话成吗 做个人吧
102111,2672,李际军,2019-01-30 13:44:40,12,13,1,怎么还是8.4？？？
102423,2672,李际军,2019-02-01 16:07:17,20,20,0,看来不但是C，连oop他都随意给分，随随便便把人平时分扣掉，我建议下学期一起去教务处告他，mmp
102547,2672,李际军,2019-02-07 05:19:56,0,3,3,态度不好
102766,2672,李际军,2019-02-22 15:01:42,22,23,1,只能说，喜欢这个老师的，祝你以后碰到的全是这种老师
102841,2672,李际军,2019-02-24 03:55:57,-1,1,2,算了吧
102842,2672,李际军,2019-02-24 04:06:50,57,58,1,以下是就“期末考试答案修改后要求重新算分”得到的邮件回复：\n\n“我很想你们每个人都能拿到100分只要你们学会了编程!本来分数是按照平时30%!卷面70%计算的，现在还想较真的话，是否严格按照规则来?按照就高不就低的方式处理了，你们还要纠结这2-3分?既然这样的话，我就按照规则来，把你的分数重新计算，可以吗?别的班级只有90人，我好心签署了你们这么多人进来，现在居然还去投诉告我，有意思吗?我以后不敢再签字加人了，也严格按照规则来，不会心慈手软了，谢谢你们教会了我!”\n\n看看看，这说的是人话吗？nmsl！
102863,2672,李际军,2019-02-24 11:49:53,5,6,1,慎选，平时作业很多，最后平时分还给贼低TOT
102896,2672,李际军,2019-02-25 00:49:57,9,10,1,是个坏人
103043,2672,李际军,2019-02-25 15:14:19,10,11,1,在浙大遇到的最垃圾的老师，给分巨低
103095,2672,李际军,2019-04-08 02:59:27,5,7,2,无语凝噎
103193,2672,李际军,2019-02-26 14:38:57,5,7,2,辣鸡老师，上课就是念PPT，一直在扯一些没啥卵用的概念，那种东西不都是自己看一下不就好了吗？练习题都是不知道从哪儿找的辣鸡题目……不知道意义在哪儿
103213,2672,李际军,2019-02-27 01:35:36,10,13,3,计院的千万别选，c++课上的比大一新生c还低端，完全就是三流大学课程的档次\n\n
103505,2672,李际军,2019-02-28 16:24:05,1,5,4,差极了，千万不要选
103601,2672,李际军,2019-03-02 06:04:01,0,2,2,平时分巨低无比……
104009,2672,李际军,2019-03-12 05:08:26,18,19,1,历经千辛万苦成绩终于第二次改了，你猜怎么样，依然没改对！作废的题和有多种答案的题的分依然没加上。没办法，这种老师你说八百遍他也不会听的，他只觉得自己最可怜，最弱小，最无助，因为你们都是补选进来的，所以我给你们多低的分都是应该的！
104012,2672,李际军,2019-03-09 12:57:07,8,12,4,感谢开学后不断奔波，和各种老师沟通的同学hhhhhhhhh成绩终于改回来了，虽然手工的还是差了四分，但也满足了。我尽量避免用充满感情色彩的词讲讲我的想法吧，个人觉得上学期oop体验不好的点主要有:作业质量低且量大，老师交流意愿低，并且在平时分计算等一些细节方面没有提前告知，因为第一点，这门课质量注定不高，同时因为第二点，直接导致了老师和一定数量的同学(没错包括我)情绪的对立。李老师一些理念确实没错，但是对这门课花的精力，从我个人的标准，只能说是不够的，并且希望他能够意识到这些。
104013,2672,李际军,2019-03-09 13:55:00,6,7,1,终于等到了第二次修正分数，想说的楼上两位都说了，希望上学期为老师辩护的同学，如果分数变低了的话，不要生我们的气
104077,2672,李际军,2019-03-11 13:49:56,8,11,3,听说面对对象的成绩都改了，那c程序设计的呢?放着任由他给那么低?
104078,2672,李际军,2019-03-11 13:56:39,7,7,0,傻逼老师
104256,2672,李际军,2019-03-28 01:05:28,18,22,4,楼下的4.8了不起什么。c语言刷两道题就4.8了，每次题目都差不多，4.8还真的觉得自己多厉害了？
104530,2672,李际军,2019-03-22 16:16:36,14,15,1,垃圾老师…上课口齿模糊读ppt，下课不经挑选布置一大堆题目。pta上有很多时候布置了作业也不告诉学生，ddl也会突然出现变动。同学期末编程没编出来就直接在班级群里艾特出来质问，知不知道有个东西叫私聊？c程没考好是我自己的锅，我没有好好自学。也提醒大家理论知识平时就要积累不要在期末时为了准备一学期落下的理论知识而忘记编程练习。
104647,2672,李际军,2019-03-26 01:28:53,3,5,2,大快人心
104649,2672,李际军,2019-03-26 01:39:29,25,27,2,他的分不可以比我的绩点高
104653,2672,李际军,2019-04-01 10:40:11,2,5,3,差死了
104659,2672,李际军,2019-03-26 01:54:28,1,4,3,没上过他的课但是很想来给个0分
104662,2672,李际军,2019-03-26 02:01:49,3,5,2,。。。
104682,2672,李际军,2019-03-26 03:14:28,23,27,4,看到2.4特地来评价，完全配不上之前的8.4。小学期C#代码写了一万多行，实验报告写了五万多字，nmd说作业做得极其不认真，做**呢。秋冬学期不幸选上他的oop，念ppt，基本全靠自学，虽然分数现在改过来，但当时他处理的态度极其恶劣。面对恶劣的老师就应该投校长信箱\n\n，免得继续祸害学生。☹️☹️☹️☹️
104693,2672,李际军,2019-03-26 04:36:49,-14,5,19,目前来看觉得讲得挺好的……作业也还行………
104769,2672,李际军,2019-03-27 11:51:39,0,2,2,日常打卡
104770,2672,李际军,2019-03-27 11:53:04,1,5,4,祝你身体健康，万事如意。
104864,2672,李际军,2019-03-29 03:44:10,4,4,0,吃多了吧
104887,2672,李际军,2019-04-11 00:53:29,5,7,2,我受不了了
104951,2672,李际军,2019-04-01 01:02:44,6,7,1,真是什么人都可以当老师
105185,2672,李际军,2019-04-06 16:37:39,7,8,1,百题杀一人，千里不留行
105349,2672,李际军,2019-04-10 10:01:42,4,6,2,好嗨哟
105410,2672,李际军,2019-05-15 06:54:17,21,25,4,楼上的不用等期末绩杀了，这个傻逼期末一定会绩杀。。。
105637,2672,李际军,2019-04-17 16:05:42,4,7,3,无f***可说
105890,2672,李际军,2019-06-08 08:33:54,4,7,3,没意思
106292,2672,李际军,2019-04-26 07:23:39,5,6,1,大家别选了
106664,2672,李际军,2019-05-12 03:29:50,13,16,3,nmsl!拼题a上布置了作业也不会和学生说一下!\n\n期末绩杀我们就校长信箱见
107444,2672,李际军,2019-07-03 20:01:46,29,34,5,修改一下自己的评分把，，关于绩杀，，，我期末56差一分就凉了，最后还3.0，我心满意足了，，，关于老师的话，上课这方面的确就是读ppt，而且老师情商巨jb低，说点话阴阳怪气，，反正上课体验不好，不过大学大学，打不了自学，也就那样吧
107861,2672,李际军,2019-09-25 12:45:19,245,266,21,傻逼，你随机分你妈的组呢？我锻炼和你妈血b沟通的能力好不好？三个人的组一个人退课，一个大三重修的five让他回个消息比杀了他亲妈还难。留老子一个人写项目，甚至还要帮组员写项目感想，最后成绩强制五五开？你把你犬母拿出来五五开好不好啊？
107865,2672,李际军,2019-07-05 14:45:08,7,15,8,好的可以
108761,2672,李际军,2019-06-01 14:05:23,3,6,3,c程，一堂课没缺，pta上题全做了，最后一算成绩，发现平时分蒸发三分之一。
108939,2672,李际军,2019-06-04 12:09:13,26,27,1,没选他的课，听了他参加的毕业答辩。内容听不懂就怼格式，偶尔听得懂就开始显摆他那点学识，根本不管学生课题的实际应用场景是否合适使用他的意见。总结下来就是一个没啥科研能力，只看形式主义，还狂的不行，说话必须带着嘲弄语气显示自己高人一等的废物。我听了三场答辩，所有专家就他说话最为难听，还最没营养。对待科研尚且如此，上课态度自不必说，建议这等傻逼滚出浙大嗷~
108944,2672,李际军,2019-06-04 13:41:10,9,10,1,答辩的时候，啥都不懂乱怼
108951,2672,李际军,2019-06-04 15:48:01,2,2,0,呵呵呵
108954,2672,李际军,2019-06-04 16:16:30,8,13,5,4.8的，我大学才开始写代码最后5.0，你bb什么，你在说谁菜？
108970,2672,李际军,2019-06-05 02:14:21,62,66,4,恭喜垃圾老师喜提98热帖：\n\n某L姓老师，在答辩过程中疯狂的刷新我对于计算机专业教授的认识，有些言论+想法真的是让我不知道该哭还是该笑，我恳求央求跪下求计算机学院能不能让每组答辩的同学分到近似领域的老师来做答辩组长，太糟心了。 简单的说，他基本上没看懂绝大多数同学所做的工作，而且极其讨厌数学公式，数学公式放的多≈不是计算机的学生，在同学答辩的过程中基本上无法对项目提出有效的要求。第一组的小姐姐写的论文据我所知是导师鼓励她投期刊的，L老师在问问题过程中对其所有的理论只字不提，只简单的提出了一些格式问题，最后直接给了个不通过，被推到了二轮答辩。所有机器学习方向的同学，主要内容是对算法有所创新的论文全部被说“不是计算机专业的学生”，会问“你用什么语言写的？”，大家都可以理解他会问你用什么框架或者问一些实现细节，但是这种评价和奇怪的看法只能让我觉得他对于此方向不了解。有做知识图谱方向就被说成“打杂的”，可视化的方向没法提出有效问题和评价，还有一些同学没有被问到任何关于内容的问题，但是给了很低的分数。真的不明白为什么可以不看内容，评价也不写什么有效内容，这就是毕业答辩的真实吗？
109006,2672,李际军,2019-06-16 05:18:25,5,9,4,总地而言，水平真的不行，我被不少他班的学生问大程问到心累了。\n\n很多基本的知识竟然都不懂……
109008,2672,李际军,2019-06-05 10:08:48,2,3,1,垃圾垃圾
109023,2672,李际军,2019-06-06 01:19:41,3,3,0,呵呵呵
109059,2672,李际军,2019-06-06 11:06:06,9,9,0,感觉大家喷的都不狠
109118,2672,李际军,2019-06-09 03:53:39,4,4,0,垃圾的一批\n\n
109122,2672,李际军,2019-06-25 00:49:43,11,12,1,互评真是让我见识了什么叫恶竞，原以为自己给的会不会太少了，结果hhhhhhhh，恶竞就是这样吧
109262,2672,李际军,2019-06-12 11:49:02,11,11,0,大作业得分是同学互评的分数，我笑了
109485,2672,李际军,2019-06-15 16:13:39,1,2,1,呵呵呵
109488,2672,李际军,2019-07-04 02:16:54,22,27,5,大程出分了，特来改评论。期末考试的分没查到，但考下来觉得要挂，然后大作业做得也不太好。自己确实超菜，但没想到最后还能上3。老师真的有在改变吧，感觉人也挺和蔼的。但上课感觉真没听进去啥。。
109525,2672,李际军,2019-06-25 03:19:14,13,20,7,某些人自己水平不行，还给别人打低分
109537,2672,李际军,2019-06-16 16:26:15,3,5,2,大学里面遇到过的最垃圾的老师，没有之一
109538,2672,李际军,2019-06-16 16:28:12,3,4,1,相遇即是冤
109569,2672,李际军,2019-06-19 09:27:16,5,7,2,不说了
109634,2672,李际军,2019-06-18 05:35:48,4,5,1,不说了 再也不会选了
110027,2672,李际军,2019-06-21 12:29:18,0,2,2,运气不好
110242,2672,李际军,2019-07-02 08:52:22,6,12,6,李爷我不怼你了，你C++调分行不
110297,2672,李际军,2019-07-04 01:31:08,6,10,4,期末考试39，多谢老师捞我? ，没挂科，感觉老师其实已经在慢慢改变了，加油！
110338,2672,李际军,2019-06-25 17:35:47,14,17,3,老师人不坏，但是情商真的不高。 。具体有这么几点：1在群里和同学们交流的时候语气奇怪，让人听着不舒服 。2.大作业采用互评机制，并且经常强调让同学所谓实事求是，殊不知这种制度本身就容易促生恶竞，总有些人怀着的恶意去评判别人。3.在一些观点上莫名坚持，并且显得十分固执，例如互评制度，以及一些评分细节的问题。导致很多做法并不人性化。\n\n但是可以看出，老师有一些自己的想法，也绝对是看查老师的，之前说的作业布置的问题在今年的oop课上根本不存在，而且老师多次问了我们作业多不多之类的事情并调整了作业的安排。可以说是在想办法改变自己的风评，知错能改善莫大焉，老师加油吧。。
110354,2672,李际军,2019-06-30 05:29:19,9,15,6,有没有一起考试周结束后去校长信箱举报的！！！
110400,2672,李际军,2019-06-26 10:32:08,5,6,1,想死啊我
110403,2672,李际军,2019-06-26 10:42:19,-11,4,15,很好啊老师
110445,2672,李际军,2019-06-26 17:21:02,12,12,0,我对别人仁慈，别人对我下狠手....
110477,2672,李际军,2019-06-27 04:58:04,-1,3,4,只从我这学期的C大程说一说:上课讲内容还算凑合，但课下有问题能给到的帮助很少；大作业互评感觉占的比例太大了，我宁愿老师评分多点而不想要只看界面美观不看代码数据结构甚至带鹅颈的互评；很多人说的期末不上心的情况好了一些，至少给出了复习要点，提纲和到哪找相关资料。现在期末总评还没出，只看上课体验的话还不算那么不堪。
110669,2672,李际军,2019-07-08 00:43:47,24,25,1,第一次见到出分没人在群里刷谢谢老师，估计都在心里问候他全家
110724,2672,李际军,2019-06-28 05:41:46,9,11,2,课程群里跟他讨论简直是鸡同鸭讲。。
111143,2672,李际军,2019-06-30 05:29:52,11,13,2,窃以为是一位令人失望的老师，令人很难提起对这门课的热情。上课内容虽然详实但基本都是在读ppt，pta上作业量倒还好，最重要的是作业内容杂乱无章，感觉老师就是在敷衍的上课与留作业。大作业花费了很多时间完成了一个六千行代码的项目，最终却因为互评被恶意评违规，老师面对恶意互评的不作为更是令人难受，反倒是一直在说分数不重要，能力更重要。我做这样一个东西就是为了展示自己的能力，我需要的是得到肯定抑或是批评的建议也好，但这绝不应该成为付出努力后得不到回报的理由。犯错的人不是付出努力的人，最终却要付出努力的人来承担错误的责任。窃以为，犯错了就应该付出代价，倘若有人可以犯错而又不付出代价，那么还有谁会相信神的荣光呢？半年时间，近万行代码，最终我也只能总结以失望二字。
111144,2672,李际军,2019-06-30 05:35:19,7,9,2,说违规的也不要一棒子打死吧，我就打了违规，收到了两份一模一样的代码，我同学也遇见了直接抄袭的情况（抄袭数年以前发布的原帖）。 \n\n值得诟病的违规应该是关于信息隐匿方面的问题，没有统一标准，很多同学恶意打分。无论是哪种情况，希望互评能开放申诉吧
111152,2672,李际军,2019-06-30 05:52:08,4,6,2,课程体验极差，互评可以学一下cyll吗？不公正的体验真难受
111170,2672,李际军,2019-06-30 08:06:34,7,9,2,这种老师真的可以投诉了
111803,2672,李际军,2019-07-02 23:37:59,1,6,5,傻逼！告辞
112187,2672,李际军,2019-07-03 20:29:05,4,6,2,傻逼玩意，有啥可评价的
112317,2672,李际军,2019-07-11 07:58:24,14,14,0,如果均绩太高，不胜寒，考虑一下\n\n
112375,2672,李际军,2019-07-04 03:13:17,-2,4,6,感谢老师捞我
112392,2672,李际军,2019-07-04 03:51:25,-3,4,7,还挺好
112398,2672,李际军,2019-07-04 04:03:37,5,14,9,实话实说，没有感觉到前面的人说的那么多缺点，至于说老师说话阴阳怪气……是不是有些人一开始就带着查老师评分的滤镜在观察老师呢？\n\n同一件事情在课程群里说了五六遍了，还有人在不停地问，连消息记录都不愿意划两下，这样子依然要求老师耐心回答，我觉得太难为人。
112500,2672,李际军,2019-07-04 14:28:29,-4,6,10,给分变好了
112844,2672,李际军,2019-07-05 05:43:31,2,6,4,给分巨吭！
112953,2672,李际军,2019-07-05 15:26:55,-13,7,20,小学期怀着忐忑的心情来上课第一天课，其实没有像一些评论里面说的那么恐怖。老师人挺好的，我觉得还ok啦。
113837,2672,李际军,2019-07-07 17:29:01,8,11,3,面向对象谈谈感受吧!首先关于上课，老师ppt做的可以，清晰易懂，但上课确实感觉是在念ppt，也可以接受叭！然后作业很混乱，一周多一周少，题目质量参差不齐，缺乏筛选，作业不是按次计分而是按照每次的分数权重，友情提示一定要注意那些200多分400多分的题目集千万不要错过，否则平时分可能5分直接凉掉！大作业互评很混乱，缺少清晰的评价规则，对于违规大家的判定条件不一导致结果很窒息，希望对被判违规的同学老师那边有重新的判断（这学期怎么操作的目前不知道）！个人体验给分不好。
113854,2672,李际军,2019-07-07 19:05:17,6,9,3,别选就对了。。。快跑
113870,2672,李际军,2019-07-07 22:31:38,16,19,3,我艹出分均绩降了0.4\n\n这傻逼老师每天就表面友善，实则在屏幕后面讽刺挖苦，成绩给分不明确，最后期末不能合理给分，向下取整，努力一学期均绩被一门课拉下去…\n\n都不要选！！！
113874,2672,李际军,2019-07-07 22:40:50,7,12,5,楼上均? 掉0.04的加一
113922,2672,李际军,2019-07-08 00:47:50,13,14,1,wdnmd果然大学不碰见几个奇葩老师都不算完整的大学
113967,2672,李际军,2019-07-08 04:02:03,6,9,3,老师评分咋变高了
113982,2672,李际军,2019-07-08 05:53:07,12,18,6,大作业得分全是同学评分？？？老师不审核的？？？被评违规也不看看什么原因的？？？
114010,2672,李际军,2019-07-08 08:14:48,19,20,1,楼下那种问号三连的说话方式真的像老师本人
114226,2672,李际军,2019-07-09 06:44:29,10,10,0,为什么没有0分这个选项？
114721,2672,李际军,2019-07-11 06:20:13,15,16,1,上课就用一满是错别字加输入错误的PPT照着念，互评环节要是你得了得分准是你是咸鱼对方大佬，因此你只能认真思考为什么得低分却不能问为什么打低分。学了两天两手空空居然被要求重构什么大项目，话说我都学了些什么你心里没点数吗？你讲的东西真的和你的作业有关系吗？我真是脑子进水了进这个大坑！
114753,2672,李际军,2019-07-11 09:29:25,-11,2,13,ljj短学期无限大于lxq，可能你们觉得绩点不好，但一天真的只上3个小时，而且作业量不过，绩点也不lxq高，群里面之前说lxq好的那个学长lj我觉得就离谱
115943,2672,李际军,2019-08-26 13:44:47,5,5,0,我不要你觉得，我只要我觉得，感觉这句话挺适合这个老师
116396,2672,李际军,2019-09-10 01:33:45,-2,2,4,没那么恐怖 有些改观
117149,2672,李际军,2019-09-20 01:27:04,5,5,0,一个小学期的课，居然让我觉得不挂就谢天谢地了
117153,2672,李际军,2019-09-20 01:59:28,2,3,1,有一说一，给分还行\n\n但是 讲 课 太 一 般 基 本 靠 自 学\n\n什么意思呢？\n\n就是说如果你仅仅用从他课上听到的知识去做他布置的题……\n\nemmm……
117182,2672,李际军,2019-09-20 05:02:03,0,0,0,水平不够
117210,2672,李际军,2019-09-20 10:59:08,2,2,0,只上过小学期C#，上课确实在读ppt，而且态度也确实不太好，但好像真的没那么吓人（所以是有可能开始hhzr了吗）小学期的话暑假还可以靠自学，正式学期的话...反正我是苟不动的
117425,2672,李际军,2019-09-24 06:51:41,36,38,2,刚刚路过教室偶然看到李际军，马上回想起了一年前的惨痛经历，于是赶忙上查老师再给他个一分。
117527,2672,李际军,2019-09-25 10:49:58,8,8,0,傻逼一个
117759,2672,李际军,2019-09-30 10:01:28,0,4,4,19年春夏选的大程 完全不知道他讲的什么，和布置作业一点关系都没有。千万别选这个老师
117981,2672,李际军,2019-10-17 13:50:03,2,3,1,作业都是瞎布置的吧。。。
118039,2672,李际军,2019-10-19 06:29:39,0,2,2,听gay铜的时候回想起被他支配的恐惧
118182,2672,李际军,2019-10-22 07:26:27,3,4,1,我希望浙大可以处理一下这些评分低的老师，亲爱的学校难道不在乎自己的名誉吗
118822,2672,李际军,2019-11-06 14:50:24,7,11,4,挺好，今年期中考试前关心我们没有作业。
120497,2672,李际军,2019-12-09 09:08:33,1,3,2,留了莫名奇妙CAD大作业，不让自由选题
120639,2672,李际军,2020-01-14 06:30:01,-6,8,14,C程：老师很好啊，不像大家说的那么糟糕。这次期中也没有留题，期末也把事情都讲清了，也发了复习课件。作业的话但凡是想用心学好c程的根本不会在意这些东西的好吗？每周两节实验课给你做作业了，像我这样做题慢的都能做完大部分了，课外花点时间就ok了，难道一点课外的时间都不想花？老实说作业量确实可以接受，只是对没编程基础的可能不太友好，可能会被几个函数编程题困扰很久。不过大家高中应该或多或少接触过vb吧，即使没接触过也听说过程序员改bug的痛苦从而有点心理准备吧。老师能决定的平时分只占25%，这次是按作业总得分的排名给的，也设置了最低分，只要好好努力平时分不会低，即使水几次也不会差，因为有很多人更水......不过平时分跟签到情况完全无关，老师说是为了多给我们点分，可能也是考虑到签到有点难反映实际到课情况，毕竟总有像我这样常迟到的😂讲课的话，老师有时会讲些课外的东西，并且会讲明大纲不要求只是希望我们多学点东西，对想认真学好c程的同学来说比较不错，只想水的也可以不听。对比较难的结构和指针部分老师也尽可能讲得慢一点了。老师声音有特点😂习惯了也还好不会影响听课。群里提问的话，老师好像是不会直接回答你，只是针对你的bug讲一些程序员的素质什么的...实验课举手提问的话会认真帮你分析的。学弟学妹放心选。下学期选老师的程序设计专题，到时候再来评一次。
120810,2672,李际军,2020-01-17 10:58:19,-1,1,2,从善了
120927,2672,李际军,2020-01-18 23:37:14,-5,4,9,挺好的呀。讲真，直到出分前一天我还战战兢兢的，现在看虽然我的绩点不高但这是我目前为止最满意的一门了我这个辣鸡。
121224,2672,李际军,2019-12-27 02:11:21,1,4,3,被投诉了还是这个德行 根本没有从善 学弟学妹们留点心
121470,2672,李际军,2019-12-16 01:13:50,1,3,2,脑瘫 我怕了
121620,2672,李际军,2019-12-12 07:05:16,-1,1,2,ppt带师\n\n
121668,2672,李际军,2019-12-09 09:08:33,0,2,2,留了莫名奇妙CAD大作业，不让自由选题
122060,2672,李际军,2020-02-10 21:04:25,1,2,1,光念ppt，没点屁用
122782,2672,李际军,2020-04-05 06:25:23,2,3,1,学生问个问题yygq的 真想锤爆他的小脑袋呢
122797,2672,李际军,2020-04-07 16:37:22,0,3,3,学姐对学弟学妹最温柔的建议就是 别选ljj。（我当初上的是oop，看到评论不以为意，如今悔不当初。）
123305,2672,李际军,2020-06-01 10:41:17,-1,1,2,。。。。。
123658,2672,李际军,2020-06-11 07:36:19,9,13,4,军军对不起，以为你是最差的了，没想到还有比你更差的
123676,2672,李际军,2020-06-11 10:19:17,3,5,2,我星号他星号B的，我为什么要作死选这个老师
123702,2672,李际军,2020-06-12 02:33:38,3,6,3,ppt朗读大师\n\ncnm的ljj
123724,2672,李际军,2020-06-13 01:56:33,-2,2,4,试试看
123947,2672,李际军,2020-06-17 12:30:07,2,3,1,打个分求大家避雷
125589,2672,李际军,2020-09-12 02:53:16,2,4,2,，，，
126491,2672,李际军,2020-09-28 08:13:14,3,6,3,早点退休，造福浙大
126604,2672,李际军,2020-10-07 03:09:02,7,9,2,讲课什么的我都不说了，毕竟大不（了）自（己）多（学一点）\n\n但是，这个pta我是真的服了。\n\n自己布置的什么题自己都不知道，连续两道重复的题目，填空题的题目程序都是有错的，一周一百道题目，人都要傻掉了\n\n而且用的题目都非常的emmmm我都想不出词了\n\n反正，别上他的课就对了，来自oop已经上课写作业到气炸了的可怜孩子
127352,2672,李际军,2020-11-20 19:04:42,5,6,1,19年计院答辩不懂就瞎逼逼，上课朗读ppt，作业自己也不筛选有时同一份作业还出现相同的题目。这种老师学校不管管吗？1分送上，是因为最低评分1分。\n\n50多岁了 还只是个副教授，你自己没点逼数吗
127858,2672,李际军,2020-11-29 03:18:32,1,4,3,快点逃
128800,2672,李际军,2020-12-25 11:48:28,1,4,3,听了各位的评价我没敢选
128862,2672,李际军,2020-12-26 14:51:41,7,11,4,光电的给我冲！！！
129501,2672,李际军,2021-01-25 06:18:21,-7,10,17,oop满了来刷个好评，虽然大作业把所有人都拉到了80分以上感觉自己亏了
129574,2672,李际军,2021-01-07 14:40:11,14,14,0,垃圾老师你来写这些oop作业也写不完吧！\n\n脑瘫，以后别选这个老师的课，我一门oop花的时间相当于50倍数据结构花的时间。
130177,2672,李际军,2021-01-25 04:05:41,-33,8,41,作业是真的少，考试是真的简单，最后绩点是真的不错！！！！
130860,2672,李际军,2021-01-25 04:19:55,4,6,2,感觉给分好像还行，虽然作业量和大作业是真的淦
130870,2672,李际军,2021-01-25 05:06:42,4,6,2,不管怎样还是感谢老师没让我挂呜呜 感觉oop这学期除了平时作业是真的多其它还挺好的 大作业最终打分都是80分以上
132651,2672,李际军,2021-02-03 06:42:52,6,8,2,虽然老师是在“变好”，但这个“变好”在我看来大概率只是因为受了一学期折磨最后拿了个比意料之中高一点点的绩点。\n\n回到课程本身，讲课十分无聊，相当于把ppt上的语法念了一遍，也就是说，你跟着他的授课或看他的PPT只能学到c++最基本也极无聊的语法点，得不到太多的拓展（c++应该还是蛮重要蛮有趣一门语言吧）。平时作业巨多（可能是hlq班的二十倍不止），作业题全是一些野鸡大学老师出的题；期末solo大作业，题目较难（虽然最后给分还行）。各位自己看着办。总的来说不是万不可以别选，别学我头铁。
133808,2672,李际军,2021-03-06 05:35:57,-1,0,1,哟西。
134306,2672,李际军,2021-03-23 06:15:37,-7,3,10,还还行吧 仁慈很多了
134744,2672,李际军,2021-04-13 07:28:29,5,9,4,课好不好另说，作业真的多，真的多，真的多啊啊啊啊啊\n\n中文的，英文的，一连布置好几次，每次超过一百题\n\n后悔，真的后悔，真的真的很后悔
134824,2672,李际军,2021-04-17 01:31:23,19,20,1,因为组队大作业有人划水，增加其他人工作量，所以就干脆每个人自己完成大作业？真有你的啊ljj……
135094,2672,李际军,2021-04-30 06:48:35,10,16,6,人总是要为当时的冲动负责
135432,2672,李际军,2021-05-10 09:16:53,7,9,2,宁退勿选。
136221,2672,李际军,2021-06-13 03:43:08,6,6,0,大作业一个人做，快死了
136558,2672,李际军,2021-06-21 04:30:53,91,96,5,有人说他上课划水，下课瞎布置作业；\n\n有人说他期中百题斩，期末大作业人手一份。\n\n这都是诽谤！全是污蔑！\n\n你们就是嫉妒李老师一点都不清楚的普通话！\n\n他上课顾左右而言他，是为了培养我们的自学能力啊！\n\n他下课布置500道习题，是为了让我们扎扎实实的复习啊！\n\n我从来没有见过如此为学生考虑的老年副教授！\n\n课友们，让我们高举手中的1分，把这样的好老师推荐给更多的人。
136682,2672,李际军,2021-06-23 03:25:45,3,5,2,ljj，wdnmd
136797,2672,李际军,2021-06-25 00:29:32,6,6,0,傻逼一个，大作业是真烦。。千万别选，春夏本来就烦，还有minisql，ljj的课伤不起，傻逼一个
136836,2672,李际军,2021-06-25 10:51:55,0,1,1,一言难尽
136932,2672,李际军,2021-06-28 10:28:54,4,5,1,每天都来给差评
137223,2672,李际军,2021-07-02 11:12:00,4,4,0,快逃。
137703,2672,李际军,2021-07-05 16:29:50,3,6,3,不得不说老师的oop ppt很适合复习，也很适合听其他老师的课的笔记
137708,2672,李际军,2021-07-05 16:56:05,1,4,3,其他班的。yysy，李老师的oop课件做的还是很用心的，很适合oop复习看
137925,2672,李际军,2021-07-06 15:04:33,8,8,0,考完oop来客观评价一下\n\n上课很无聊，就是念PPT，上课认真听可以跟上进度，但很难认真下来，所以基本靠自学。oop其实主要还是学习一些C++的语法，有c语言基础的话自学难度并不大，但考试会把一些知识点考得很细。\n\n作业巨多，最好不要拖到最后。题目重复很多，质量也很低，最好平时拿碎片时间来做完。作业成绩是根据你的作业分和全班最高分的比值来赋的，所以好好做可以让你这个分子更接近分母（或者成为那个分母）\n\n大作业很离谱，感觉是老师不知道从哪儿看到一个东西就拿来让我们做了。互评占比100%，同学之间不太卷的话还是很留情面的。\n\n一个学期在最后点了一次名，记得到后面不要缺勤。\n\n老师没有古老评论里说的那么差劲，应该是有改变的，问问题都会回复只不过偶尔不太及时。总体来说ljj班对大佬来说比较好拿分，本垃圾也不难生存，但性价比比较低，选课需要慎重。\n\n最后，wknb
138181,2672,李际军,2021-07-07 21:30:50,9,10,1,老沙币一个，上课就只会吹比，啥也不讲，课程已结束就解散课程群，司马玩意
138594,2672,李际军,2021-07-10 02:46:16,13,15,2,你看看隔壁wjj？？？？？？？？？？？？？？？？？？？？？？？？？？？？？
138784,2672,李际军,2021-07-11 00:30:25,-22,5,27,平时分96，期末大作业98，总评92\n\n？？？！！！\n\n真的搞笑
138950,2672,李际军,2021-07-12 02:37:14,-3,8,11,Oop出分了来评价一下，老师给分还算是不错了，平常作业大作业认真做（大作业按时交上去了最后都给85及以上）平时分可以拿很高的，总评成绩想要高分主要还是看期末考。老师人其实也蛮好的，线下去问问题基本都会回答，讲课也凑活。但是！！平常pta作业是真的多！每次平均也得有个好几十道编程函数题+选择判断，是真的顶。而且老师似乎不清楚我们的水平？大作业扔了个CG的内容让我们自学，一个人完成真的要命。每次看着不到一半的到课率，老师心里估计也拔凉拔凉的吧……
139868,2672,李际军,2021-08-05 02:27:11,-6,6,12,给分蛮好，oop满了
139896,2672,李际军,2021-08-13 08:27:01,-5,4,9,老师很和蔼
139899,2672,李际军,2021-08-14 12:39:28,5,6,1,念ppt
140495,2672,李际军,2021-09-13 05:25:23,-6,5,11,很好的老师
141146,2672,李际军,2021-12-07 14:53:57,8,12,4,作业太难
141149,2672,李际军,2021-09-24 17:04:02,0,2,2,为什么没有0分
141160,2672,李际军,2021-09-25 07:18:14,-12,5,17,给分好
141161,2672,李际军,2021-09-25 07:18:42,-24,5,29,短学期给了一门满绩，主观意愿给个10分
143790,2672,李际军,2021-12-06 10:01:12,5,9,4,上课只读ppt，从不正面回答学生的问题，还以此嘲讽学生。
144104,2672,李际军,2021-12-17 15:04:19,7,9,2,。。。
145907,2672,李际军,2022-01-04 05:54:52,5,8,3,不推荐
147189,2672,李际军,2022-01-09 04:48:22,27,31,4,ljj真有你的，平时pta找些三本的漏洞百出的题，大作业丢个meshlab让我们建个差不多的，同学提问不直接回答，期末考试一句提醒都不说来全英文的，还不让用编译器做编程题。厉害厉害👍
147213,2672,李际军,2022-01-09 11:14:32,27,28,1,上完oop来评价一下，C++这门课最重要的是锻炼面向对象的编程思维，而他那个大作业直接让你阅读重构十万行代码的大程序根本没啥用。问他问题要么已读不回，要么冷嘲热讽。最重要的是，期末考试把程序填空题出成填空题....想想就多脑瘫。\n\n但是言归正传，老师比远古评论里面说的好多了。期中考试百题斩没了，上课稍微正常一点了，评分标准也说的很详细。我只能说，老师把作业这些他觉得能改的都改进了，但刻在骨子里的嘲讽学生、solo大作业的问题，估计要改还是不太可能。慎选吧。
147294,2672,李际军,2022-01-12 01:58:41,22,25,3,考试和平时作业完全是两条线，考试是纯英文，并且不提前通知，导致很多题目因为不知道英文做不了。而且试卷出的很烂，排版很差，质量很低，考的绝大多数都是非重点内容，比如异常考了很多。大作业跟C++关系不大，浪费时间。只能说老师不仅水平低，而且恶心学生非常有一手。平时上课中规中矩，但从不正面回复学生问题，原因懂得都懂，这种贵物能留在浙大，不就是靠着弄虚作假嘛？他只要不回答问题，我们就永远不能知道他有多垃圾了，真是非常聪明呢ljj。之所以还可以教书，大约是因为某些没有骨气的人，冲他给分相对不错，就感激涕零，殊不知自己已经被PUA了。
147314,2672,李际军,2022-01-09 13:47:47,15,17,2,唯一的优点：上课中规中矩，不朗读PPT可以自己讲；而且允许上课睡觉。\n\n\n\n然而……\n\n平时上课恶心人、作业多、大作业没用，这些都是可以通过日常挂机/不来、好好自学撑过去的。\n\n可是期末考在事先故意不说的情况下出出全英文，外加“下面哪个头文件体现了OOP”一类的荒谬选择、非跟标答一模一样不可的填空题以及不让开编译器还声称一旦编译错误就零分的30分大编程题着实令人绷不住，一出考场问认识的能读万行meshlab改写的佬，客观题70分只能40出头，填空题各种错完。本以为“期中考试百题斩”已经是下限，是我格局小了。\n\n\n\n就挺绝望的，忍了一学期，最后绩点还得裂开……\n\n\n\n总而言之：\n\n如果是正常学期，只建议有足够基础且能抵抗嘲讽的人万不得已选。\n\n如果是他单开课的学期，不管你有多强，宁退勿选。
147790,2672,李际军,2022-01-11 00:56:25,2,6,4,cjb
148238,2672,李际军,2022-01-12 02:42:58,12,13,1,相较课程投入和课程收获来讲，给分也不算好的。\n\n体验也会比较差，除非真的没选择了而且一定要上这课，不然极不推荐
148474,2672,李际军,2022-01-12 15:12:09,4,6,2,大人才
150189,2672,李际军,2022-01-26 00:35:05,7,9,2,学完oop评价一波（仅代表个人意见）\n\n优点：PPT做的很好，适合我这种C学的特别差的，上课从不点名，只要作业都按时交了，平时分会尽量拉满\n\n缺点：上课纯念PPT，平时作业虽然较去年少了很多，但依然很多且质量很差，大作业个人solo量还巨大，考试全英文倒也没啥毕竟一直都是全英文，但是出的题的质量属实不敢恭维
150816,2672,李际军,2022-03-09 01:31:10,20,24,4,又请学生来刷评分了哦，休息一下吧，你把这个教书育人的理念先搞懂，wjj教的蛮好的你跟他比什么，这下输xsy，输完xsy输wjj，接下去没人输了，哎哟哟谢天谢地
150937,2672,李际军,2022-02-21 07:17:32,5,9,4,咱就是说，有方言的老师见过，这个是最离谱的，完全不知道在说什么
151100,2672,李际军,2022-02-23 04:04:24,3,5,2,实在是令人无语
151289,2672,李际军,2022-05-06 07:45:37,14,17,3,很遗憾，这位老师不仅课讲的不行，人品也有很大的问题
151544,2672,李际军,2022-03-07 06:53:10,-31,6,37,老师很认真啊，很用心啊\n\n本来以为自己倒霉只能选这个老师\n\n没想到老师真的很用心\n\n大家不要被以前的评论蒙蔽双眼！！/
151546,2672,李际军,2022-03-07 07:24:51,-11,4,15,老师挺好的，PPT很用心（老师说都是自己做的），感觉真的想教会我们，srds我菜鸡只能听懂一半
151933,2672,李际军,2022-07-04 04:24:42,25,31,6,每当你觉得ljj没有评论中那么差的时候，他就会在作业上给你暴击。。\n\n\n\n期末update：除了作业阴间，以及有时候网上难以沟通，其实真的没有评论里那么差，个人建议作业理论题查答案做就行，主要认真看ppt认真复习
151934,2672,李际军,2022-03-21 06:12:51,4,4,0,自知命不久矣……
151950,2672,李际军,2022-03-21 12:24:03,13,13,0,这作业真的是罄竹难书了（意味深
152081,2672,李际军,2022-03-25 03:51:14,2,3,1,单选题80题，单选题150题，我累了，这只是一门课啊，一个学生一学期要修那么多课，学生有什么办法
152271,2672,李际军,2022-04-01 05:55:14,41,42,1,逃。\n\n最倒霉的不是选他的课的，是选他毕设的。我本科毕设选了他，选他的基本全员延毕，最少三个月，我直接结业第二年参加毕设基地才毕业。最可怕的是在毕设基地还看见了一个被他坑了一年没换导师，延毕两年才开窍的老哥。据毕设基地老师透露，ljj是计院本科延毕最多的导师。\n\n什么你问为啥毕不了业？不给你论文签字不让你答辩怎么毕业？\n\n我都怀疑他精神有问题，天知道怎么来浙当老师的。
152649,2672,李际军,2022-04-17 11:20:37,27,29,2,真无语透了\n\n全程靠自学\n\nPPT上的内容都基本掌握了\n\n也背了一遍\n\n大作业让自己重构meshlab\n\n？？？\n\n我怎么能看懂啊不是\n\n至少给个大纲吧\n\n期末考试全英文\n\n我连封装还有稀奇古怪的英文都分不清\n\n怎么考试啊\n\n期末大作业晚教了一分钟\n\n直接不要了 说你好好准备下一场的考试吧\n\n最后喜提大学以来的第一门挂科\n\n我之前修了数学学院四十多分专业课\n\n本专业也是很多硬核课\n\n加起来200分\n\n挂了这一门\n\n真无语！\n\n就是个想故意刁难人的坏老师
152747,2672,李际军,2022-04-19 07:19:56,13,16,3,准备做大作业，临写之前刷个1分不解释
153500,2672,李际军,2022-05-04 05:49:34,15,18,3,嗯，浙大总有那么一些老师，让你怀疑他为什么能在这里教书，为什么要在这里教书。\n\n很不幸，这就是其中一位。
154346,2672,李际军,2022-05-30 15:18:52,3,4,1,期中100道全英选择题\n\n大作业一个人写\n\n快跑
154415,2672,李际军,2022-06-01 05:58:09,6,7,1,c大程滚出🌍
154670,2672,李际军,2022-06-03 06:10:58,2,4,2,无语啊
154698,2672,李际军,2022-06-03 15:18:06,0,1,1,懂得都懂
155026,2672,李际军,2022-06-07 14:34:42,7,8,1,狗屎老师！！！
155033,2672,李际军,2022-06-07 15:42:28,5,6,1,纯纯的傻逼，线上沟通戾气大得要死😓
155130,2672,李际军,2022-06-08 14:57:41,3,5,2,lljlj
155295,2672,李际军,2022-06-10 09:14:19,-62,7,69,给分超好！！！ 吹爆！ 我不知道你们满没满，反正👴满了
155453,2672,李际军,2022-06-13 04:52:51,11,12,1,傻逼老师能不能别来迫害软工啊
155557,2672,李际军,2022-06-14 09:40:01,7,8,1,为什么没有0分？？？？？\n\nC大滚出中国
155809,2672,李际军,2022-06-16 05:32:14,-123,9,132,给分超好！！！ \n\n吹爆！ \n\n我不知道你们满没满，反正👴满了\n\n还有，自己菜还怨别人？真的是匿名就可以为所欲为了啊，没有一丝一毫的尊重吗？\n\n先学学怎么做人吧，不知道自己反省一下，第一反应是对老师大骂特骂，人身攻击，觉得这样很有本事吗？
156234,2672,李际军,2022-06-18 11:33:50,4,5,1,压榨学生，时间安排很不人道，周末没有，晚上没有。
157648,2672,李际军,2022-06-24 08:03:19,9,11,2,今年OOP李际军出的什么破题目......
158964,2672,李际军,2022-07-04 04:17:16,18,23,5,面向对象：会点三次名，基本在课程快要结束的时候点，点两次平时分就能满；\n\n平时会出很多道作业题（传说中的百题斩）不过给的时间很多，网上也都能搜到答案，但是一定要做，会算平时分；没有期中测试，期末考试之前作业题会大幅减少（不像之前同学说的期末百题斩），平时分给分也很好。\n\nppt非常非常非常详细，（听过翁恺老师的讲课，ppt非常简约，复习不太好用）基本上看一遍ljj的ppt就能对oop有一个大概的理解。\n\n2022大作业有两个选题，一个是复现一些图形学的工作（较难）；一个是做一个简易版的geogebra，没有很明确的评判标准，ljj说尽力而为即可。不过这两个作业ljj都明确要求使用OpenGL完成，如果没有图形学基础可能会比较难。\n\n最后，李先生至少在2022年的oop课上不至于得到2分的低分，上课体验还是不错的（尤其对喜欢自学的同学们）
158966,2672,李际军,2022-07-04 04:26:12,11,12,1,坦白说，22春夏的面向对象好像还不错？\n\n作业题都可以搜到答案，期末都是统一阅卷，唯一有难度的只有最后一个大程，总体而言事情不多，给分也主要看自己
158986,2672,李际军,2022-07-04 08:02:30,4,7,3,22春夏oop体验还行的
159019,2672,李际军,2022-07-04 13:02:45,8,11,3,老师比以前好了，PPT内容非常详细，适合同学课前课后自学，自学PPT能学会大部分的内容，缺点就是上课有点念PPT。另外大作业给分也还不错，pta的作业题量相比其他老师确实偏大了很多，但是最后作业的给分还是科学的，按时完成作业这一部分分数还是能拿到绝大部分。总评的给分也感觉老师比较善良了
159461,2672,李际军,2022-07-22 03:56:38,18,18,0,浙大的败类，祖国的耻辱。
159530,2672,李际军,2022-08-04 02:15:53,5,7,2,上完他的课一年了，来补个一分
159667,2672,李际军,2022-08-23 03:49:58,14,17,3,纯垃圾一个。长的和猴一样。野猿人。
160014,2672,李际军,2022-09-12 00:02:34,6,9,3,第一排那个傻逼怎么批话这么多
160033,2672,李际军,2022-09-12 05:04:46,2,4,2,呵呵呵 懂得都懂 只能说他很值得这个1.9分
160177,2672,李际军,2022-09-14 11:33:59,1,3,2,无话可说，心累，，
160206,2672,李际军,2022-09-15 03:51:23,10,10,0,打卡名人古迹
160736,2672,李际军,2022-10-08 07:52:25,16,16,0,半夜pta破防了，不来给个1分睡不着
160792,2672,李际军,2022-10-12 06:05:20,1,2,1,这作业太多辣
160838,2672,李际军,2022-10-16 14:57:19,2,2,0,杀了我吧ljj
161058,2672,李际军,2022-10-25 08:33:47,3,3,0,无话可说，一分为敬。
161138,2672,李际军,2022-10-28 13:48:23,17,18,1,二百道选择题，写到第一百道了。过来评个一分接着再回去写
161181,2672,李际军,2022-10-31 10:50:55,10,12,2,祝家人健在
161220,2672,李际军,2022-11-01 04:50:23,3,4,1,题目又多错也多，还很没质量
161972,2672,李际军,2022-11-15 13:29:29,1,2,1,。。。
162640,2672,李际军,2022-11-30 14:08:50,2,4,2,作业真给人整破防啊，是别的老师好几倍，先把难的放前面再给书上例题放后面，书上例题教的都插在前面的题里面了叫我再抄一遍浪费时间是吧。
163530,2672,李际军,2022-12-15 02:00:12,9,13,4,sb一个，问他问题，既避开重点不解答，又阴阳怪气，问我：“讲的很清楚了啊，你上课都没有来吗😅”\n\n你要是讲清楚了谁还问你啊，建议退课 千万别去问他问题😅
164107,2672,李际军,2022-12-18 06:07:46,6,7,1,不行。
164767,2672,李际军,2022-12-26 01:07:35,15,18,3,最后一节课你还来恶心人是吧\n\n大作业给别人分太高会给你自己总评扣分是吧\n\n顶级出生 你什么时候能414啊\n\n孤儿东西你也配当浙大老师
165589,2672,李际军,2023-01-08 14:04:38,0,3,3,百题斩
166031,2672,李际军,2023-01-11 01:33:56,4,4,0,给分不好
166038,2672,李际军,2023-01-11 02:13:56,4,4,0,给分是真的差，大家要选还是谨慎一点，不要像我一样是来重修的，学过，就以为能拿个稍微高一点的成绩（坐标C程）
166490,2672,李际军,2023-01-12 15:19:09,18,20,2,非常推荐下一届的学弟学妹们选ljj的C小程！\n\n上课无需听讲！锻炼自学基础！\n\n英文小测！扎实英文功底！\n\n两千题斩！只为我们的基础着想！\n\n选他，就不用再为刷题找不到题库操心！\n\n这么好的老师，有什么理由不选他呢！\n\n----------------分割线----------------\n\n下面认真回答一下。\n\nljj的C小程，上课的PPT内容比较详细，而且上课不点名，可以不去，这可能是唯二的优点了。上课只会朗读PPT，而且口音非常不清晰。\n\n课后的PTA作业除了课程组统一布置的题目外还有大约2500道英文题目，只有少部分是较早布置，大部分题目只在考试周前一个月布置。\n\n不过很多题目都是重复的，也都可以在某个国外网站上找到（就连顺序都一样），（国外网站可以在做第一个题目集时看到，被放在某个题目的题干里）。\n\n小测这个学期考了两次，上机课考，题目都是上面所说的英文题库里选的，（不过既然上机课可以不去的话，那其实……）。\n\n最后说一下给分，其实老师在上第一节课的时候有说，平时分会给作业最高的人打满分，其他人按照成绩比例打分。\n\n到了课程后期ljj布置了7个题目集（每个题目集有300-500道题目），虽然那些英文题老师是说给我们复习用的，但是ljj的所有题目都是算分的（包括那2500道英文题）。\n\n所以楼上那几位给分不好的大概率是这些题目没写导致的。\n\n课程快结束的时候实测了一下，在全部抄的情况下，一个约500题的题目集需要一个半小时。\n\n我C语言0基础的情况下每周都花5个多小时做ljj的题目……\n\n所以除了ljj之外选不上C小程的情况外，还是避雷吧。
166806,2672,李际军,2023-01-27 11:42:03,5,8,3,不正面回答学生问题 含糊其辞
167206,2672,李际军,2023-01-15 05:37:44,5,7,2,慎选oop \n\n大作业solo，且工作量较大，大作业成绩基本全靠互评\n\n平时作业题量很大，和国外某题库重合率很高，而且题目质量不佳，不建议花很大精力钻研\n\n总体而言 上课体验不佳，但给分不错，选不上其他老师的课的话为了绩点也可以学
167227,2672,李际军,2023-01-15 06:44:12,-1,3,4,oop\n\n对自学选手很友好，因为你一个学期都可以不去上课，也不用点名（听说本学期至少两次点名，从未点到过，事实证明点名没用），除了作业百题斩比较牛马（但题目基本都能查到）\n\n建议追求高绩点或课程繁重喜欢补天的同学选
167734,2672,李际军,2023-01-18 16:16:06,-15,5,20,oop无功无过 期末简单 互评友好。给分不错
168484,2672,李际军,2023-02-18 11:50:50,3,3,0,zzz
168485,2672,李际军,2023-02-18 11:51:09,0,0,0,啊啊啊
168541,2672,李际军,2023-02-19 09:15:22,8,9,1,上过很多低分老师的课，只有ljj我是真的认为是个纯SB
169328,2672,李际军,2023-02-25 12:24:40,9,11,2,作业全是英文题，不给答案，题量大，错题多。最后给分不好。慎选\n\n说实话，题量大一点就算了，全是英文题，又不给答案，有什么用？？？
169965,2672,李际军,2023-02-28 23:54:19,15,17,2,s b
170144,2672,李际军,2023-03-01 14:06:06,16,18,2,《课程组统一规定实验题必须完整实现至少一题方可及格》到手的及格直接飞了
170969,2672,李际军,2023-03-13 12:36:44,12,12,0,感谢李老师在完全没看懂我的论文情况下，对我论文的倾力指导。\n\n\n\n我会改论文的，但也只是希望再也别遇到你了。
171159,2672,李际军,2023-03-17 06:14:45,10,10,0,不必多说
171670,2672,李际军,2023-03-31 12:12:15,20,20,0,写他的PTA心态炸了，过来给个1分再接着写
171805,2672,李际军,2023-04-06 07:33:03,-39,21,60,听人都在骂，没上过他的课，过来给个1分
173312,2672,李际军,2023-05-18 09:55:45,0,1,1,。。。
173514,2672,李际军,2023-05-27 09:04:34,3,4,1,现在的分数说明打分的人里有过半没给他打一分，这显然不能反应最真实的情况。希望大家能尽快一起解决这个问题。
173744,2672,李际军,2023-06-02 06:16:34,3,5,2,cnm
173923,2672,李际军,2023-06-04 15:32:34,7,8,1,知道的说是找老师问问题，不知道的以为是在向神祈祷——一样得不到回应。\n\n发个消息等好久都不会，回了也不是正面回答，就回你一两句有的没的，披用没有，还阴阳怪气，真的无语。\n\n不过这些都还好，最关键的是大作业互评自己倒扣分，你是什么天才能想出来这种主意？这么伟大的制度，联合果知道吗？有没有申遗？
174037,2672,李际军,2023-06-06 00:50:05,11,14,3,首先评价之前需要搞清楚，这位生物在教学和科研上无一建树，感觉他在他们院的地位就像你们中学班上倒数第一的地位一样，纯纯的混子，靠着编制混饭，人品垃圾至极，义眼盯真，鉴定为纯纯的人渣
174971,2672,李际军,2023-06-20 13:23:44,4,6,2,pta上有广告，海盐饼干叔叔;大作业openGL依托答辩
175044,2672,李际军,2023-06-21 08:53:15,0,3,3,一个字：跑！
175681,2672,李际军,2023-06-26 07:36:47,-5,1,6,还可以吧
175719,2672,李际军,2023-06-26 10:01:28,6,6,0,学弟学妹们快跑，这种折磨不是你们这个年纪该承受的。
176632,2672,李际军,2023-06-29 13:12:56,-4,0,4,平时作业和大作业确实一坨答辩，但ppt还不错
176636,2672,李际军,2023-06-29 13:32:07,-4,1,5,虽然不是老师的课，但是感谢您的ppt！！
177278,2672,李际军,2023-07-02 14:11:18,-3,4,7,给分挺好的
177288,2672,李际军,2023-07-02 15:04:27,2,3,1,学不到东西
177699,2672,李际军,2023-07-04 10:31:44,-10,7,17,上了ljj老师的c大\n\n说实话上课前看到这些评论心里挺忐忑的，上过之后感觉老师人还挺好，讲课蛮认真，上机课也会一直在机房辅导。\n\n要说不好的地方PTA上的题确实有点恶心，好在c大PTA不多。大作业solo，都是如果你早些开始其实完全可以，给分基本上看大作业互评，会略高于此，重要的是没有期中考。所以如果你是大佬，还是非常建议上ljj老师的c大的。
178015,2672,李际军,2023-07-06 07:50:40,10,11,1,希望有同学能把老师的家庭住址发出来，方便大家去塞刀片。。。确实想刀他，课讲得精彩作业留得精彩分数也精彩（玩笑勿当真）
178382,2672,李际军,2023-07-11 08:20:42,1,1,0,和让人无语的老师，自以为是，亲身体会！
178476,2672,李际军,2023-07-12 06:41:27,1,5,4,OOP，期中期末纸质点名，作业量没有之前评论里那么夸张了（七次加起来大概500道？），但还是建议互帮互助。\n\n大作业纯看互评，不要太糊弄就有90左右（不用完全实现那个libigl，只要能做出个3D的东西再加点坐标变换就行），给分全看考试和大作业，如果你自学能力强还是可以选的（OOP这课面向考试学习就行），讲课不评价因为我一次课没去过，也不太建议去，直接翁恺智云就行。\n\n总结：选还是能选的，只要你自学能力强，且大作业不拖ddl
178499,2672,李际军,2023-07-12 15:17:27,1,1,0,第一次想说老师烂得一批，完全摆子混子孙子，自以为是喜欢恶心人，上课学术皆拉跨
180292,2672,李际军,2023-09-21 03:20:26,3,4,1,辣鸡，无需解释
180706,2672,李际军,2023-09-25 05:23:31,1,2,1,不好
180868,2672,李际军,2023-09-27 10:01:06,2,3,1,一句话：不要不相信前车之鉴
180880,2672,李际军,2023-09-27 14:12:54,3,5,2,15天的短学期压缩成5天，作业全靠自学，那我选这门课干嘛
181460,2672,李际军,2023-10-18 07:21:42,2,3,1,作业太多，难度不高但是费时费力，浪费人生
181646,2672,李际军,2023-10-25 06:46:50,8,9,1,pta写裂开了，来打个1分继续写
181655,2672,李际军,2023-10-25 09:53:42,4,5,1,纯傻逼真傻逼
181656,2672,李际军,2023-10-25 10:06:29,3,3,0,作业13天241道选择题，16道填空，9道编程你们自己看吧
181864,2672,李际军,2023-11-02 14:21:54,9,10,1,这b和别的老师比作业量巨大，写这个c程作业真的浪费生命，浪费人生。\n\n第一次作业48道编程，第二次18道，第三次35道，更别说每次几十道几十道的判断选择填空\n\n还有，这b出的小测题巨阴间，全英文的一百道选择题，其中还有一堆没讲过的东西，像指针，位运算这些……
181876,2672,李际军,2023-11-03 03:35:01,12,13,1,pta小测搞英文版，还全部超纲
181878,2672,李际军,2023-11-03 03:54:56,7,8,1,出的英文题考的是英语不是C程，折磨人的。程序题只给一半，输出怎么可能会有。百题大多数是读程题还一堆变形，就算不是英文题面，怎么可能90分钟做100题嘛，更何况是全英文的，真的无语。
181879,2672,李际军,2023-11-03 03:55:06,5,5,0,题目出的很好 下次别出了
181899,2672,李际军,2023-11-04 04:05:14,53,53,0,您这次作业仅仅选择题就布置了241道，但我很喜欢做题，所以给您打了241分。但上限只有10分，所以只好模除10给分了
181918,2672,李际军,2023-11-05 10:31:15,4,7,3,241道选择题写得蚌埠住了，过来骂两句。
182405,2672,李际军,2023-11-15 14:56:26,2,4,2,绷不住了，写哭了要
182482,2672,李际军,2023-11-16 12:16:44,17,19,2,真门课真的不错，特别是这个老师。他是智障学校毕业的吧，他上课的声音，比绵羊音还要糟糕；摸过的键盘，连阿米巴原虫都活不下去。他和猪最大的区别是，猪不能随便变成人，而他隔三岔五就变成猪。我猜他是用猪蹄敲的代码吧。建议他吃点痔疮药，治疗一下他的口蹄疫。
182631,2672,李际军,2023-11-18 14:41:02,-1,2,3,滚滚滚滚
183284,2672,李际军,2023-11-23 11:47:54,5,6,1,为啥我有336道！！！
183351,2672,李际军,2023-11-24 04:35:51,6,6,0,区区336道，老师布置的很合理，我给满分1分！
183840,2672,李际军,2023-12-01 03:41:48,14,16,2,啥逼小测，全你吗比超纲，全你吗比英文
183841,2672,李际军,2023-12-01 03:44:17,6,8,2,傻鸟老师，小测考time和rand，还都是英文，到现在为止还没有上机考过程序设计题，教考严重分离，快跑
183845,2672,李际军,2023-12-01 04:21:31,4,5,1,啥笔李老师，全你吗笔超纲，全你吗笔英文，啥笔小测，写不了一点，级罢
184165,2672,李际军,2023-12-11 14:56:39,13,14,1,"这是填空题模板。\n\nljjsb0|ljjsb1|ljjsb2\n\n。最多可设十个可选答案，用 ""|"" 隔开。\n\n\n\n每题可以有多个空。\n\nljjoopsb|ljjstillsb|ljjabsolutelysb\n\n。题目创建后不可修改填空数量。"
184318,2672,李际军,2023-12-20 06:25:41,8,9,1,首先，我打了一分，客观来说，这分有点低了，但为了泄愤，我给一分。评价一下，作为一名老师，他算的上教学水平最烂的那一档，其次，作业布置量相对大，小测题目奇怪。情商极低，不知道怎么做一个人。
184613,2672,李际军,2023-12-22 03:01:03,4,4,0,恶心死了
184784,2672,李际军,2023-12-22 16:24:07,12,14,2,oop就是一坨，两周来个百题斩，全都是拿外校的题，选择就全抄外国的题目。大作业一个月写一个图形建模，让我们实现一个库的三个功能。我请问我们课上有学过跟这个一毛钱关系的东西吗？\n\n相当于要我一个月学会mfc编程，再自学别人计算机图形学的内容，还要学会opengl怎么用，然后写程序实现别人写好的库。我请问这有可能吗？我感觉纯是拿自己其他课的作业来当大作业，我不说你这个老师教的怎么样，只会念ppt，课间不下课，你对待学生和对待你的工作的态度就不行。人也不行，人品也差，话说的多好听，真实想法就是自私，能退退吧。一个教室一百来人的容量只有20个不到的人，坐里面的估计也没几个自愿的。一把年纪，做人做老师做到这个地步了也挺悲哀的。
185036,2672,李际军,2023-12-26 03:45:58,9,10,1,看不下去了，我室友要被他大作业折磨疯了\n\n只能说谁选谁后悔
185047,2672,李际军,2023-12-26 04:19:33,0,2,2,千万别来
185062,2672,李际军,2023-12-26 05:07:55,1,2,1,我服了
185157,2672,李际军,2023-12-27 01:08:23,7,8,1,sbljj
185211,2672,李际军,2023-12-27 05:47:20,6,8,2,sbljj
185271,2672,李际军,2023-12-27 12:33:33,11,11,0,上他妈一学期课了忍不了了，他妈的OOP一周要不二十道编程函数要不200+选择填空，他在课上骂你，你他妈来一句“就是要锻炼你们”，你他妈讲个b课讲出优越感了是吧。\n\n傻逼大作业，你他妈要不要看看留的什么b东西啊，还他妈用VS，你要不要把你xie马拎出来配配环境啊。\n\n什么傻逼东西一天天的。
185327,2672,李际军,2023-12-28 02:27:49,5,5,0,sbljj\n\n希望后来者不要抱着“只是作业比较多罢了”这种侥幸心理，这个司马玩意的oop能让你一个长学期的节奏乱的一塌糊涂
185346,2672,李际军,2023-12-28 06:00:56,5,6,1,sbljj，pta会写裂开
185389,2672,李际军,2023-12-28 15:44:37,1,1,0,c程全英文小测——然而这不一定是坏事。我不会，您猜怎么着，大家都不会，都别卷了。课都不用学了，学了看着全英文也不会。\n\n最喜欢正态的一集，就算都不及格，总会有人拿高分的。
185393,2672,李际军,2023-12-28 18:18:55,6,7,1,ljj我真的服了，极品大作业+平时一堆作业+闭卷考试。平时丢几个PTA百题斩，期末丢个大作业。大作业啥也不讲，就让我们自己看个上古缝合ppt，里边的环境全是十几年前的，现在win10win11的库都不带的，还要自己去下载。
185465,2672,李际军,2023-12-29 19:40:32,2,4,2,sbljj
185490,2672,李际军,2023-12-30 15:20:04,7,7,0,别抱着只是作业多点选，这课程内容就一坨，1分没的说，大作业真破防了
185514,2672,李际军,2024-01-01 07:52:30,3,4,1,sbljj，快逃！
185621,2672,李际军,2024-01-03 03:34:03,3,4,1,sbljj
185823,2672,李际军,2024-01-04 15:34:42,4,7,3,室友这学期考oop，纯英文试卷，一道大编程还特么不能跑，只能在不知道能不能正常运行的情况下交答案，而且还把时间放在了1.9晚上，虽然不在ljj的班上，但我们一致认为:这绝对跟ljj这个裟俾脱不开关系！
185977,2672,李际军,2024-01-07 04:33:50,2,4,2,nt老师，规矩是死的人是活的，我看你就是shiti，大作业布置下来，看都不看全是互评分，shizhongshi
185987,2672,李际军,2024-01-07 06:29:10,6,6,0,纯狗屎
185991,2672,李际军,2024-01-07 07:50:02,5,5,0,sbljj，布置的什么sb大作业
186088,2672,李际军,2024-01-08 08:35:32,6,7,1,sbljj
186227,2672,李际军,2024-01-09 15:49:35,7,8,1,sbljj
186321,2672,李际军,2024-01-10 13:37:02,0,2,2,c程作业确实多 课讲的也不好 但是上课几乎不管 自学的可以放心
187178,2672,李际军,2024-01-15 03:34:41,3,3,0,nt老师，大作业仲裁了我12分。
187334,2672,李际军,2024-01-15 13:26:30,8,9,1,grumpy old man
187596,2672,李际军,2024-01-16 17:01:25,4,5,1,讲课口音跟嘴里含了史一样听不清，课程的其他部分体验更是史中史。\n\n只有ppt还算可以，上他的课建议对着自学，多听一秒都是浪费时间。
187905,2672,李际军,2024-01-17 17:42:14,3,3,0,去死吧我还是
187932,2672,李际军,2024-01-18 00:18:47,5,9,4,上的大C，没那么不堪，简单说下几点：\n\n1.老师不点名，上课不会管你在做什么。\n\n2.作业量确实大，期末前的作业认真做数组和指针就行，其他的随便做点就好了，直接CV式编程，作业给分根据最高得分者给，建议不会做就面向CSDN编程，选择填空面向另一个网站（99%原题，叫啥忘了，H开头的，搜多了就知道哪个又快又准）\n\n3.小测全英文，但是词汇量很浅的，你把VS或者别的编译器换成英文用一次作业就差不多会了，小测的题目和作业关系不大，都是基础知识和底层逻辑，对理论考试帮助大，得分情况大家都很低，好像第一次小测就三个及格。\n\n4.实验考试有斩杀线，考前多做做常见的编程题，比如按照绝对值排序，反转小数。\n\n5.给分似乎还好，比我预想高一点，不知道怎么给的，虽然老师总说谁要他捞就扣分，但是似乎还是捞了点？可能是规定的四次小测剩下两次没考就给满的这种捞吗，不太清楚。\n\n老师上课偶尔有讲错的地方，PPT做得可以，考前看看，虽然我只看了文件的部分，理论考前做几张卷子基本能90+，主要是实打实地去做，不会的就调试，一路看过去变量怎么变的，比如连续的逻辑判断里面x&&y||z怎样的情况会叫停，怎样的情况三元全部执行，推荐VS的编码环境，但是devc（也就是实验考试用的）的调试得熟悉下。
188201,2672,李际军,2024-01-18 11:35:30,8,9,1,C程从不点名，有英文小测，自学的同学可以大胆冲，考前有千题斩（选做），我们这届好像没太多人做，出分比像中的好，人还可以，就是有点倔，预置了他的课，硬着头皮可以上，但自己要多多努力。
189609,2672,李际军,2024-01-26 01:40:05,18,19,1,[C尖]：上课形式：上课念PPT，PPT会发在学在浙大，上机课写本周作业，老师自己都说可以不来。作业量巨多，编程题最多时能有四十多道，需要写整整一个周末，但偏基础，大部分都是教材习题，在网上也找得到答案，直接复制粘贴也没问题。\n\n评分：点名（就点过1次），平时作业，小测，实验考，期末。\n\n评分细则：平时作业每次作业总分加起来，按照总分排名给分（很不合理，逼所有人内卷，逐个的查答案争取全对），小测从题库中抽100道题，全英文，全选择，但是千万别信他说的考试范围，一定要往后自学，小测中有很多都是没学的（第一次小测说考到函数，结果都考到指针了；第二次说考到指针，结果考到文件操作和ctype库和time库），小测也是两次总分和按排名给，实验考和期末考是学校统一组织的，实验考两个大题共30分，斩杀线是8分，期末判断+选择+写程序结果+补全程序。\n\n对老师的评价：比较固执，坚持自己的一套思维模式，讲课真的不太行，只讲最基本的，用来编程够了，但是理论题不会做，而期末主要就考理论。有的时候感觉挺关心学生的（比如准时下课，课间问你学没学会，要是不会就再讲一遍；让觉得困的同学睡一会）有的时候又很刻薄（比如你问他考试范围和出分）。虽然老师嘴上说只把不及格的人捞上及格，应该最后还是捞了的（要是真按照他的评分方式应该不会考这么高）。\n\n如何卷绩点：别听课，可以看PPT，上别的老师的网课，作业保证全对（拿不准的上网搜），超前学习应对小测，实验考不用担心，只要平时作业中的编程大题都是自己写的，实验考接近满分很容易。期末很恶心，建议狂刷历年卷，以前的C大要更难一些，刷历年卷的理论题就可以了，然后一定要会写文件操作和链表！最后的补全程序就是考这个！\n\n我的评价为：这门课程可以优化掉老师。
190253,2672,李际军,2024-02-26 13:33:27,-49,9,58,不管你们怎么说，我还是要给李老师打十分，对我很负责，感谢他
190739,2672,李际军,2024-03-16 16:42:55,6,8,2,老师讲课实际上并不算差但讲课没什么逻辑，但是口音我不大能听懂，基本没听课，从上个学期来看老师还算和蔼\n\n小测全英文且超纲，作业量较大\n\n总而言之在这门课上花的时间不少但并没有学到很多，即便高中选考了技术也喜提低绩点\n\nljj教会了我作为菜鸟即便选不上课，也不要冒险选低分老师…
192734,2672,李际军,2024-05-29 16:38:27,-30,7,37,最好的老师之一
192865,2672,李际军,2024-05-31 05:50:32,15,17,2,我是德国人，给李老师1分的好评[赞][赞]
193830,2672,李际军,2024-06-20 03:28:28,3,5,2,sb。
195140,2672,李际军,2024-06-27 02:48:22,0,2,2,路过，踩一脚
196022,2672,李际军,2024-07-01 07:35:40,-3,0,3,查老师诚不欺我，快逃！！！
196086,2672,李际军,2024-07-02 11:57:50,3,3,0,快跑。
196845,2672,李际军,2024-07-05 13:00:25,0,1,1,12345
197087,2672,李际军,2024-07-07 12:13:57,6,8,2,每次作业PTA200道题，快逃...
197212,2672,李际军,2024-07-09 08:02:45,2,3,1,convert to 1
197417,2672,李际军,2024-07-14 01:55:14,-2,2,4,垃圾！
197584,2672,李际军,2024-07-20 08:09:12,6,6,0,ConvertTo1
198236,2672,李际军,2024-09-05 14:21:23,5,9,4,百题斩让人苦不堪言，大作业丝毫不考虑难度和量，上课念ppt，ppt也晦涩难懂
198292,2672,李际军,2024-09-06 07:07:28,28,31,3,我曾经也是一个懵懂少年，天真的以为自己好好学就能拿到高分。但是突然出现了一位老师，他让我知道了选择远比努力重要。
198626,2672,李际军,2024-09-11 11:21:41,12,14,2,预置ljj，直接退了
198654,2672,李际军,2024-09-10 11:46:45,2,4,2,真的是垃圾
198741,2672,李际军,2024-09-11 10:45:38,4,5,1,伟大无需多言。
198761,2672,李际军,2024-09-12 08:10:32,2,4,2,我走了！
198762,2672,李际军,2024-09-11 11:25:26,7,9,2,昨天ljj的课还是满的，容量为0。今天早上学校良心发现，加了三门课，bhh和zy的。晚上再看ljj的课已经退了四十多个人了，足见ljj含金量。
198810,2672,李际军,2024-09-12 01:41:31,-2,2,4,选ljj的这辈子有了
198861,2672,李际军,2024-09-12 08:01:59,1,3,2,还好在上课前一小时退了他的课
199003,2672,李际军,2024-09-14 02:09:00,-3,6,9,上的课程综合实践1（c#），刚出分满了。总的来说体验还不错的，每天上午纸质签到，下午也可以补签；pta题量有点大，不过ddl给的很慷慨；大作业都是互评，给分规则很清晰。这门课还是能学到东西的，dotnet做gui很方便，还能学到三层架构设计的思想和工程实践。就是底下的层包括数据库表设计对还没学数据库的大一学生可能会比较痛苦，不过主键约束级联删除那些也就提高内容，不做那些也能拿满大作业。
199024,2672,李际军,2024-09-14 06:36:38,4,6,2,C#短学期体验还行，缺点是基本自学、题量爆炸、互评看命，优点是给分还行，认真把大作业写完+PTA选择题搜答案分数基本就往90上去了。想拿高绩点的可以选。
199031,2672,李际军,2024-09-14 07:22:44,3,7,4,短学期课程（课程综合实践 I，C#）给分超级好，值得推荐！
199032,2672,李际军,2024-09-14 08:04:00,10,15,5,生活本就很艰辛，半路杀出李际军。上课朗读屁屁踢，下课TM浪一批。期中考试百题斩，我想拿刀把他砍。劝君更尽一杯酒，这个老师绕着走。
199062,2672,李际军,2024-09-14 14:40:36,1,4,3,短学期可冲
199249,2672,李际军,2024-09-20 01:54:07,2,6,4,傻逼东西，去你妈的老子草泥马
199286,2672,李际军,2024-09-20 11:22:09,2,3,1,直面天命
199355,2672,李际军,2024-09-21 14:29:13,1,4,3,不好。。。。
199633,2672,李际军,2024-09-26 12:11:40,5,6,1,作业量大已经体会到了。既然选了这个老师，就要花更多时间学了😢
199750,2672,李际军,2024-09-29 02:03:21,5,7,2,问你个问题你就会说个调试，我调试完了还不知道咋改，你来个自己看，那你教你马呢
199921,2672,李际军,2024-10-08 11:09:35,4,6,2,强烈建议别选
200010,2672,李际军,2024-10-11 01:23:59,5,8,3,1.5真高了，你就是石
200034,2672,李际军,2024-10-11 11:30:14,9,11,2,傻逼李际军，遇上你真是我上辈子福气，上课说话说不清，就读个ppt，考试也全英语，说什么逼着我们学，我真是...
200335,2672,李际军,2024-10-16 05:00:38,7,8,1,我是地质学家，这就是石
200427,2672,李际军,2024-10-17 02:50:10,9,12,3,我是美食家，这就是你在某些高档会员制餐厅会遇到的东西（非常的新鲜，非常的美味！）
200831,2672,李际军,2024-10-23 05:36:07,13,14,1,只能说是一个非常固执的老头，对于编程有这自己的坚持，就是不懂得变通。上课读ppt我觉得也不能算个缺点，毕竟我感觉大部分老师都有这个通病hhh，教学水平只能说不高，建议自学。作业和小测就和前辈说的一样题量大且阴间，甚至会有作业题重复，只能说是自己没做过了（题量这么大我tm也不想做，一次作业上百题）。但是我还是想说至少他做人是比较热心的，你去问问题（先忽略他解决问题的能力）他也会比较热心的回答。总结：tmd赶紧退休得了
201018,2672,李际军,2024-10-27 03:17:47,8,9,1,大一新生千万别选
201970,2672,李际军,2024-11-08 01:04:15,6,7,1,如果这就是计算机学院的水平……
202027,2672,李际军,2024-11-08 10:47:57,5,6,1,作业多的夸张，解决问题的能力相当于没有，同学全靠自学，考试全是超纲
203059,2672,李际军,2024-11-16 07:13:46,-106,4,110,反正我认真学了一个学期最后10.0，自己菜还怨别人？真的是匿名就可以为所欲为了啊，没有一丝一毫的尊重吗？先学学怎么做人吧，不知道自己反省一下，第一反应是对老师大骂特骂，人身攻击，觉得这样很有本事吗？
205111,2672,李际军,2024-12-01 17:05:10,2,3,1,作业多到爆，捞也不捞
205211,2672,李际军,2024-12-03 02:24:02,-9,0,9,所以ljj和cy哪个更逆天
205405,2672,李际军,2024-12-06 01:44:01,9,9,0,纯纯SB，什么调试，我全靠自学，他是一点不教，还有什么全英文题目，tmd跟他教的一点都不沾边，完全超过这门课程的要求，别教课恶心人了
205459,2672,李际军,2024-12-06 15:46:04,3,5,2,上课是水的，小测客观题是全英的，题库是随机抽的，题目是错的，分数是统一排名的。\n\n喜欢抽奖和铤而走险和抖m的建议选择
206107,2672,李际军,2024-12-13 05:30:59,2,3,1,没话说
206485,2672,李际军,2024-12-15 13:03:47,6,7,1,真抽象啊！这oop上课讲的奇差无比，作业题布置之前连看都不看吗？甚至把ads的题库直接给扔到了oop？
206498,2672,李际军,2024-12-15 14:34:35,6,6,0,交了大作业不给过，选他之前慎重考虑吧！能跑就跑
207968,2672,李际军,2025-01-10 05:11:32,19,22,3,sb一个，讲课PPT，问问题就是自己调试，woc我要是会调试要你有何用😤😤😤，绩点也一般
209266,2672,李际军,2025-01-05 09:14:15,57,58,1,某同学：李老师，听说卷子改完了是吗\n\n李际军：想挂吗
209269,2672,李际军,2025-01-05 09:29:18,14,14,0,想被打一分吗？
209338,2672,李际军,2025-01-05 12:42:17,2,2,0,“想挂吗？”
209355,2672,李际军,2025-01-05 14:07:26,1,2,1,想挂吗
209366,2672,李际军,2025-01-05 15:45:26,3,4,1,你确实是想挂了
209435,2672,李际军,2025-01-06 02:56:36,4,4,0,既然大家都在骂，那我也帮你骂一下，逼养的玩意
209489,2672,李际军,2025-01-06 05:27:57,5,6,1,“想挂吗”
209747,2672,李际军,2025-01-07 03:08:21,9,9,0,想挂吗？？？
210116,2672,李际军,2025-01-08 07:38:35,-19,2,21,虽然平时考试和作业是抽象了一点，但期末分数起码还是给得比较足的，我期末当时都怕挂了，最后还是有4.5。
210144,2672,李际军,2025-01-08 08:31:42,-10,0,10,老师人还算不错，就是作业巨多，讲课的话和书上基本一样，可以自学，最后绩点还行。
210148,2672,李际军,2025-01-08 08:50:07,2,3,1,比之前拟人多了，但还是不推荐选。\n\n\n\n\n\n还有，卡我绩😢
210174,2672,李际军,2025-01-08 09:44:33,2,4,2,卡绩+点名有次系统问题没点上 当场就找他他说他不会操作 没法加分 我寻思这学在浙大其他老师不都一样用 \n\n ？
210191,2672,李际军,2025-01-08 10:30:09,-9,3,12,本来看到评分就想寄了，但是没想到c尖绩点4.5，真是意料之外，我并没有求情什么的，只是完全自习，多看书罢了，老师其实很反感提成绩，但是有专业问题会热心解答，可见是一位希望让我们学到真知识的老师，说实话，教学对零基础学生很不友好，题目出奇的难，我也非常忐忑，但是你要踏实完成的话成绩还是可以的，不能因为老师问题消极你的对这门课的态度
210221,2672,李际军,2025-01-08 17:24:14,4,4,0,认真评价一下吧\n\n如果真的选上他了，直接听网课，他的课真听不了。作业非常非常超级多，是其他老师的好几倍。表面上态度很好但有时态度又是一坨。要想拿高绩点，每次作业要力求满分，最好自己做完再拿ai查一遍，作业一定要做。小测全英文并且严重超纲，只能尽量做，这里的超纲指的是完完全全考书本以外的知识。
210359,2672,李际军,2025-01-09 03:38:59,2,4,2,讲课没听过不好评价，两次数字签到一次钉钉群雷达签到，上机课可以不去倒是挺好的。\n\n小测全英是相当阴间😅，并且会考些不在课本范围的东西😅。\n\n作业量是真的多，无意义的百题斩，还好给的时间也长。\n\n总体来说我个人还能接受，毕竟最后绩点还行，但是真的不推荐选，能选上别的老师就别来这赤石了
210920,2672,李际军,2025-01-10 06:59:52,4,5,1,多打了1分不用谢
211038,2672,李际军,2025-01-10 11:34:23,-6,2,8,其实你要是说课还可以，首先所有作业都可以上网去查，他也不管，作业分基本稳拿；小测前几次就是pta限时，那些英文题网上都有原题，他也不用监考系统，拿分肯定比别的老师用监考系统简单，实在不行拿手机查也没人管你；平时签到就3次，但总课前说签到，课上不说签到，就课前注意一下就行；期末的评分标准都一样。而且老师上课不管，如果自学能力强或是有一定基础的，稍微动点脑筋，他的分也绝对不会低
211052,2672,李际军,2025-01-10 12:06:10,8,9,1,单选题241/241\n\n填空题8/8\n\n程序填空题9/9\n\n函数题9/9\n\n喜欢你就来，每次作业有惊喜
211074,2672,李际军,2025-01-10 13:37:41,4,4,0,大家小心 这个人是个变态
211136,2672,李际军,2025-01-11 01:27:14,5,6,1,傻逼傻逼傻逼
211702,2672,李际军,2025-01-12 08:22:47,4,5,1,真心不建议选，给分会比其他老师低很多，而且作业也多，能学到的东西也很有限。
214142,2672,李际军,2025-01-25 08:41:47,7,7,0,24-25秋冬oop，老师的百题斩确实不走寻常路。不过并非每次都是上百道选择，只有第一次作业的题量吓人且不合理，之后都勉强能接受。oop重要的可能是通过写代码来体会抽象、封装、继承、多态、重载等等，因此作业形式像其他老师那样，每次写一个较大的程序会更好吧。选择、填空、程序填空的题量明显过饱和了，不过对于应付期末考倒是挺有用处。\n\n对于老师本人，和他在线下和钉钉上都有过沟通。他的对话风格独树一帜，也不知如何形容比较好，但是用有意为难学生来形容大概是不合适的。\n\n大作业不好做，不过同学们互评时基本都很友好。说来惭愧，我当时交了一个没有编译成功，内容也极简陋的vs包上去，但大家还是从80开始往上打了，不知道是否和老师在临近截止时说“只要交了东西就不要打太低”有关。大作业会更新，但是98上的经验贴（tag:oop/ljj/大作业）还是很值得一看。如果像我一样对于用visual studio、设计gui、配置第三方库感到十分茫然无措，那么只追求完成度而不要管复杂度，让自己先完整搭出一个能跑的项目来然后再做修改，或许是较好的方式。结合98上的经验帖、ai、网络搜索，找到入门难度的用vs做类似项目的教程，然后每周跟着它做一些，别等到最后一周猛赶，大作业对我等小白来说或许也不再恐怖如斯了吧（笑哭）
218743,2672,李际军,2025-04-30 06:44:49,16,16,0,你们只是选了他的课还好，我选了他的毕设。毫不夸张的说，这个人生当进监狱，死当下地狱
219690,2672,李际军,2025-06-04 08:05:40,0,0,0,讲课依托，不知所云，而且作业巨多，都是无聊的选择题填空题。还不如像别的班那样每隔两周一个project，感觉啥也妹学到，大作业也是很恶心，能跑赶紧跑。
219712,2672,李际军,2025-06-04 13:05:06,0,0,0,想学东西的不建议选，好的地方是不点名，坏的是作业多，而且大作业莫名其妙的要用MFC，巨难上手，人也有点古板
219863,2672,李际军,2025-06-09 07:16:50,0,0,0,f-ck
4328,2702,罗仕鉴,2015-09-20 05:55:22,5,10,5,水。。。
50873,2702,罗仕鉴,2017-05-07 16:41:20,1,4,3,放心，老师上课是不会来的，老实说长学期的大作业我们是两天就做完了的(｡ì _ í｡)
74921,2702,罗仕鉴,2018-03-06 12:09:19,5,12,7,他上课的PPT准备的特别足，内容很多，视野开阔，还邀请了行业大拿来给大家讲课，很不错的老师，得过奖出过书，却特别平易近人，给分也很客气。
100059,2702,罗仕鉴,2019-01-25 13:30:00,0,2,2,还可以
102663,2702,罗仕鉴,2019-02-18 10:14:52,-9,1,10,没有点名的
102932,2702,罗仕鉴,2019-02-25 04:33:09,-3,1,4,超级棒
103356,2702,罗仕鉴,2019-02-27 12:36:00,0,1,1,很好的
183479,2702,罗仕鉴,2023-11-26 14:12:38,4,5,1,老师个人的专业能力挺厉害的，只是第一节课开始的行为让人觉得很没有树脂，而且作业布置得有点意味不明，没有给门路还要让人自己去和公司联系要数据（人家公司的数据凭什么给你，这要求真是莫名其妙）
213254,2702,罗仕鉴,2025-01-16 13:05:40,-2,0,2,“工业设计不需要本科生”。\n\n主打啥都不教，需要包括但不限于的技能：可视化制作、海报设计、UI设计、基于UI的视频制作…
10309,2720,李善平,2015-11-18 04:24:56,3,4,1,讲课可以  但求不要绩杀……
16015,2720,李善平,2016-01-17 04:13:38,17,32,15,浙大史诗级灵魂教授，没有之一
18110,2720,李善平,2016-01-21 07:49:37,2,3,1,上课讨论其实是强制的
18455,2720,李善平,2016-01-24 18:21:03,5,8,3,平时分怎叫一个惨字了得
19106,2720,李善平,2016-01-23 09:17:20,5,7,2,上课回答问题是强制的，一个问题不回答的话期末直接扣20分，不要问我是怎么知道的
19611,2720,李善平,2016-01-25 02:50:39,3,3,0,上课非常认真，课堂要求参与度高
40111,2720,李善平,2016-12-29 07:59:34,5,7,2,对linux的理解非常透彻权威，也乐于解答学生的问题，讲起专业知识杠杠的。但真的太迷了。。。研讨安排、实验要求都让人摸不着头脑，很难明白他的意图，整个课程学习很憋屈。。。总之，如果不是希望学到非常权威的操作系统知识，不建议选
40767,2720,李善平,2017-01-05 10:19:26,0,0,0,学生受教了
46482,2720,李善平,2017-01-22 00:47:23,6,8,2,个人觉得lsp老师讲课是真的不错，真正的大佬们尽管选，不会失望的，老师也是真的爱才……但是出了名的那啥也是真的，验收极其严格，大家只好团结在助教周围……\n\n但是今天期末给分真的好好啊！我都以为自己要跪了！！表白助教！感谢老师！
46608,2720,李善平,2017-01-22 03:49:03,3,3,0,老师要求很高，验收要求严格，课上也会要求互动，学到了很多，而且意外的是给分也挺好的
48011,2720,李善平,2017-02-28 04:36:23,1,1,0,李老师上课对参与度要求高，实验验收严格，没有专门的复习课，这次助教学长挺好的，认真学的话收获还是挺大的。
54471,2720,李善平,2017-06-29 10:57:32,1,2,1,讲课不错
68814,2720,李善平,2018-01-24 04:17:53,10,13,3,因为平时分要求发言次数过多，建议想拿高分的同学绕道。\n\n这老师和陈奇是一个系列的，这么说你懂否？
70761,2720,李善平,2018-01-27 13:26:00,-2,0,2,不做展示就是寻死哦
73590,2720,李善平,2018-02-02 04:31:25,6,7,1,平时分回答问题的占比确实偏高，比例略坑。而且只有讨论课和前几节课提问机会比较多。就上课而言，个人认为lsp是个好老师，干货很多，段子也有不少。至于实验课嘛，老师比较倔，会和学生争论（手动滑稽。不过验收只是验证一下是否由自己完成，要求并没有太严格。\n\n只要不是面向GPA选课，老师当然还是ok的（请务必尽早做展示，或者多回答问题
73845,2720,李善平,2018-02-03 08:48:20,5,5,0,李老师讲课不错，认真听会很有收获。展示分和回答问题分占比很高，需做好准备。实验除了实验一都不会很难验收。考试务必参考其他班的资料。
73890,2720,李善平,2018-02-03 10:54:55,6,7,1,没有复习课，没有考试范围。发言分+研讨分占12分，要拿满还是挺麻烦的。老师的水平确实高，也很愿意与同学交流。
96280,2720,李善平,2019-01-20 16:06:06,1,2,1,李善平挺萌的，大家别黑了
98217,2720,李善平,2019-01-23 08:03:52,2,3,1,遇过最有教学热忱的老师。平时要回答或是问问题，实验部分都给满分。
100955,2720,李善平,2019-01-27 07:55:34,6,7,1,大四外系? 给大家一个参考。0交流0展示，实验好好做，期末好好复习，最后86。
131441,2720,李善平,2021-01-27 13:42:40,1,3,2,老师真的很棒！每次我线上找老师问题，老师都马上回，不懂还会打电话给我讲清楚！人还可爱，爱了爱了，讲课也讲的很清楚，除了上课随机抽人回答问题让本社恐略微自闭
131472,2720,李善平,2021-01-27 15:41:09,3,4,1,老师上课很有激情，会举很多生活中/计算机发展历史上的例子，很喜欢和学生讨论，实事求是（虽然有时会花比较长的时间get同学的点[ac01]），课下在微信群答疑很快很认真，还会不时分享相关领域的推文给同学。平时多发言/展示的话平时分可以拿到比较高。爱了爱了！
150412,2720,李善平,2022-01-24 18:33:28,6,7,1,找李老师验收有较大风险
151260,2720,李善平,2022-02-26 13:30:33,-1,0,1,老师上课很有激情，是真心爱才的老师，大佬如果选了他的课应该会有很多体会；老师为人很和善，有问题都会认真回答（期末考的问题除外哈哈），挺较真挺可爱的；另外，我是没学过计组的软工er，0发言0老师验收，期末比较认真地准备了，最后4.2，供参考
155397,2720,李善平,2022-06-12 06:52:30,5,8,3,作为没有修过计组的软工学生，李老师的实验还是比较容易上手的，老师对操作系统的理解也是很深的，会乐于解答学生的问题。实验的话如果觉得掌握的不是很透彻就找助教验收就ok了，助教还是比较好的，基本能放过就放过哈哈哈。平时基本没有发言和复习过，实验也就是基本的水平，最终绩点4.8。os的实验基本可以看出是参照mit6S081（页表映射那个实验代码简直一模一样），但是相比mit的课程，浙大的理论课与实验的关联并不紧密，可以参考的资料感觉也不是很多（当时是看riscv手册硬啃的）。而且实验中涉及到大量的汇编代码，个人感觉不是那么有必要，可以考虑参照mit实验把汇编代码改成C语言。
163942,2720,李善平,2022-12-16 15:55:51,3,6,3,不知道老师为什么会有这么高的评分（相对别的os老师而言），上课喜欢点人回答问题，前两周的理论课几乎没有讲过课程内容，要么是花几十分钟的时间抽名单上的同学回答问题，要么是在讲他的实验word文档。bonus不给实验文档，美其名曰让同学们自己探索，实际上就是偷懒不写文档。。逆天
165437,2720,李善平,2023-01-05 08:25:11,2,6,4,平时分不好
105,2855,郑小林,2015-03-14 15:53:38,-2,3,5,还不错
4642,2855,郑小林,2015-06-25 10:52:28,7,10,3,讲与没讲差不多
16638,2855,郑小林,2016-01-18 14:53:27,8,15,7,太差哦
20913,2855,郑小林,2016-02-03 21:26:15,-2,2,4,工作量与得分正相关。
21031,2855,郑小林,2016-02-12 05:20:23,-10,7,17,太差啦
58323,2855,郑小林,2017-08-28 15:21:13,3,6,3,电商经验丰富！课程打分跟付出基本吻合！
70128,2855,郑小林,2018-01-26 06:56:20,2,7,5,上课认真给分良心
70327,2855,郑小林,2018-01-26 12:47:51,6,14,8,付出有回报，不像某隔壁图形学
76057,2855,郑小林,2018-03-26 05:19:35,-3,0,3,给分很好，但是确实学不到什么东西
87357,2855,郑小林,2018-09-27 11:01:49,18,28,10,刚去了上机课 助教小姐姐好好看呀 10分给小姐姐
108132,2855,郑小林,2019-05-15 13:22:26,-7,1,8,老师很好呀
109311,2855,郑小林,2019-06-13 04:58:46,-5,2,7,老师讲得很好，实验课助教也很好。可以接触到很多方面的知识，像UML图，推荐算法，都会有一个初步的认识，给分也很好
115635,2855,郑小林,2019-08-13 07:56:35,-6,2,8,很好呀
134052,2855,郑小林,2021-03-14 10:16:00,10,12,2,没上过他的课，但作为新生之友绝对不合格。
141341,2855,郑小林,2021-09-30 04:44:09,2,4,2,小学期课程设置比较不科学，但认真学也能学到很多。给分一般（比较像正太的课），主要看助教
149595,2855,郑小林,2022-01-16 06:51:05,5,6,1,寒假来补评一个暑期短学期的课：金融科技（套皮AI），老师人看起来不错，但是上课由他手下博士生一个一个讲，一天一个topic，讲的东西比较泛，和实验关系不是很大；实验难度感觉不太适合机器学习初学者，更适合有一点前置知识的人来做；最后做一个开放题的展示+大作业+报告，感觉就挺好高骛远的。给分在计院专业课里算一般。\n\n上完课之后感觉自己什么都学到了一点，但又什么都没学到。Anyway，这个课作为满足毕业要求的短学期感觉还是可以选的。
156354,2855,郑小林,2022-06-19 07:58:50,28,32,4,zxl还行，但遇到他的手下zmy你就惨了
168259,2855,郑小林,2023-02-07 07:54:39,-5,0,5,认真负责，好老师
178363,2855,郑小林,2023-07-11 05:21:59,23,23,0,郑老师手下的朱梦y就是纯纯大纱布，讲课一坨答辩，只会恶心学生
179303,2855,郑小林,2023-09-08 12:33:11,18,18,0,一分给到老师手下的zmy
185018,2855,郑小林,2023-12-25 19:52:50,20,20,0,zmy能不能去死
198297,2855,郑小林,2024-09-06 07:29:14,0,0,0,上了短学期金融科技导论，给分好，下午上机课可以翘，上课耗时也少，只点了一次名，大作业也比较简单，强推
212126,2855,郑小林,2025-01-13 08:29:20,0,1,1,短学期金融科技补一个评论，上午的理论课可能会签到，今年应该签了两次，下午上机课可以翘，内容对于没有接触过AI的同学来说是比较硬核的，但是能学到很多东西，最后给分也特别慷慨，总之非常非常推荐！！！
134148,2944,姚琤,2021-03-17 05:17:37,0,2,2,上课就给学生放放视频？
135856,2944,姚琤,2021-05-29 11:36:27,0,1,1,老师很准时，绝不耽误下班时间，下班的短信 第二天上班准时回。。。。。
201871,2944,姚琤,2024-11-07 05:23:17,1,1,0,天呐，绝世好导，他真的我哭死。
214461,2944,姚琤,2025-02-05 13:34:39,0,0,0,神仙导师！谁家导师在计算机领域、设计学领域、管理学领域都有建树啊！离了姚老师，还有谁把我们当小孩！
19207,2974,朱建科,2016-01-23 13:52:21,5,11,6,好老师！上课逻辑非常清晰，就是感觉英语讲的有点不标准
19265,2974,朱建科,2016-01-23 16:23:50,49,57,8,老师科研水平挺高，自己对于概念的理解也很好，不过讲课时英文水平有待提高
19636,2974,朱建科,2016-01-25 03:44:05,0,1,1,老师人很好，上课也挺幽默。
34624,2974,朱建科,2016-11-10 07:42:09,1,10,9,吐词不清，布置的作业多而且要求过高
41207,2974,朱建科,2017-01-11 09:42:18,0,2,2,人帅咋都好！
41306,2974,朱建科,2017-01-10 13:25:17,4,5,1,朱老师很帅，人也超好
41311,2974,朱建科,2017-01-10 13:35:18,-1,0,1,不错呀
41312,2974,朱建科,2017-01-10 13:39:15,-1,0,1,男神给分超好\n\n
41313,2974,朱建科,2017-01-10 13:41:36,2,4,2,必须10分啊，平时分这么厚道
41316,2974,朱建科,2017-01-10 13:48:48,-1,1,2,課講的很清楚\n\n給分也好
41326,2974,朱建科,2017-02-16 07:09:42,-2,5,7,给分巨好 平时分加了bonus基本都能满分 期末总评分基本是期末成绩+10分，我个弱鸡期末复习了一点也有94，不比大牛但也很开心
41328,2974,朱建科,2017-01-10 15:03:04,2,4,2,给分超好呀～DS学到很多
41804,2974,朱建科,2017-01-12 16:26:50,-2,0,2,给分好\n\n
42491,2974,朱建科,2017-01-14 09:30:44,3,5,2,每次上课近距离看男神感觉好棒棒哦w 特别喜欢他那件呢子大衣
42541,2974,朱建科,2017-01-14 11:56:39,0,3,3,给分高，口语烂，人帅，人好，教的一般
42859,2974,朱建科,2017-01-15 09:55:53,-11,0,11,给分好，考试什么都不会也能上4
42902,2974,朱建科,2017-01-15 11:37:52,15,21,6,不得不说，这老师给分真的没话说，而且不查重
43112,2974,朱建科,2017-01-15 17:14:44,11,13,2,真心好老师…ddl说延后就延后，说不查重就不查重，说给分就给分
43177,2974,朱建科,2017-01-16 02:46:08,0,2,2,给分厚道，讲课挺不错的
44439,2974,朱建科,2017-01-17 23:54:25,1,3,2,老师人还是很好的，助教也很细致，全怪自己编程能力太差。
44960,2974,朱建科,2017-01-18 15:52:37,-1,1,2,给分好是硬道理
46078,2974,朱建科,2017-01-20 14:44:06,3,3,0,只能说我太菜
46620,2974,朱建科,2017-01-22 04:15:34,7,9,2,帅到炸天( •̀∀•́ )别的老师都查重，世外高人就不查，平时分高高高，努力得到回报很开心
46872,2974,朱建科,2017-01-22 15:03:52,0,1,1,给分真的超级好，人也很nice~
51214,2974,朱建科,2017-05-24 08:40:58,-6,1,7,老师人真的很好！
51650,2974,朱建科,2017-06-08 03:08:54,0,1,1,给分好
60075,2974,朱建科,2017-10-12 14:06:25,0,1,1,.....
71941,2974,朱建科,2018-01-29 06:23:38,-1,3,4,墙边草
71985,2974,朱建科,2018-01-29 07:24:53,0,1,1,谢谢老师
72564,2974,朱建科,2018-01-30 11:30:43,-4,9,13,pta上bonus和project的测试别的班都有，老师说他太忙了没时间弄，助教也非常不负责，平时问问题基本不回答，课水且基本自学，最后期末还不能覆盖期中，给分严格，是多少就多少，呵呵
73973,2974,朱建科,2018-02-04 02:46:35,1,2,1,给分超棒，讲课超赞！
76554,2974,朱建科,2018-04-14 03:57:37,1,3,2,看来教务网确实有分数上限，还不是九十九
95324,2974,朱建科,2019-01-19 08:14:35,1,1,0,老师人很好，讲的很清楚，给分也很好……没考好都怨我自己
99240,2974,朱建科,2019-01-24 13:19:36,1,1,0,挺好的，是我太菜
99816,2974,朱建科,2019-01-25 07:58:55,5,6,1,老师人特别好 但是会有不提前预告的quiz 当然只要你每次课都去上就没问题了 3次quiz10分基本做了就全给你 期中考不跟别的老师一起上机考 还延后 project也是有两周的ddl 可以说非常良心了 给分也超好 助教也超负责任(心疼助教) bonus4分直接加 只要你期末别太差 分数会让你满意的！
116159,2974,朱建科,2019-09-05 02:49:42,5,6,1,人很nice，学术水平很高，不卡学生实习。未来走工业界学术界老师都会帮忙。
118228,2974,朱建科,2019-10-23 08:43:09,-28,4,32,英文一言难尽，几乎听不懂；课上亲口说去年因为查重退课了30多个人，所以不查重的时代已经过去了；project如果迟了可以交给助教，但是会失去互评的50%哦~\n\n综上所述，真的没有17年以前评价那么好了。大人，食大便了。
121093,2974,朱建科,2020-01-19 14:33:18,28,31,3,[数据结构基础] 讲课情况: 9/10；给分情况：10/10\n\n1. 讲课方面，老师在算法和数据结构方面的功底可以看出来是非常扎实的，由于朱老师是做ai， multimedia相关的大牛，平时上课的时候也会讲到数据结构在研究中的实际应用，对于基础数据结构的讲解也足够深入浅出。作为一个OIer，其实FDS的内容在初中就已经学过，但是认真听过一遍老师的课以后仍然有收获。\n\n2. 老师的英文口语不是特别标准，但是仔细听绝对是可以听懂的！学期开始的时候因为有基础，经常不怎么听课，后来上课经常坐第一排之后也逐渐发现了老师讲课的亮点。\n\n3. 老师是一个比较佛系的老师，不太纠结一些小细节。引用老师最后一节课的话你们感受一下：“你们何必非要点开PDF的属性呢？”。对于某些学生的行为，老师多半会采取宽容的态度，但是还是要说：不查重是情分，查重是本分，希望一些同学不要得寸进尺...\n\n4. 给分方面，非常厚道。期中考试是笔试，会调分。其他的平时分也会尽量给满，作业方面就是得分除以总分（再强调一下，宁可不做作业，也绝对不要抄袭，完全得不偿失），如果两个Bonus做了，基本上平时分还是容易满的。\n\n5. 期末考之前会公布平时分，会留出申诉的时间，比较透明。考完两三天就会出分，总体上还是比较快的。期末考试主要就是看氪金够不够多了。
122095,2974,朱建科,2020-02-12 14:30:07,0,1,1,老师人特别好，对于有时大作业忘了匿名之类的很可能会让人挂科的事很宽容，信任学生。不过有时候老师中英文切换，需要花一点时间才能够明白他讲的是什么。
123397,2974,朱建科,2020-06-08 05:58:31,-24,3,27,建议选周六班，他说过周六班是开给工高班的，实际体验互评的时候普遍会给高（第一次project大家不熟悉通常会比较低）。助教人好，非常耐心地解答我的问题。只不过我对当时没建群只能用邮箱这一不及时的工具联系稍稍有点不满。
128336,2974,朱建科,2020-12-19 10:24:54,-1,1,2,。。。
130042,2974,朱建科,2021-01-15 12:46:19,2,2,0,好！！！特别好！！！
133112,2974,朱建科,2021-02-08 16:12:28,4,4,0,我怎么感觉......老师总评是不是多给了5分...出分把我自己都吓一跳
136639,2974,朱建科,2021-06-22 09:56:54,6,7,1,朱老师我爱你！
146102,2974,朱建科,2022-01-05 13:01:38,-11,5,16,给分机制复杂。。。班里还卷的要死。。。。。。讲课也讲不清楚。。。。快跑！！！
146117,2974,朱建科,2022-01-05 13:45:55,10,12,2,楼下的别太过分，班上哪卷了，老师明明挺佛的，quiz随便乱写错了分也照样给了，bonus还能补平时分，还想怎样
147315,2974,朱建科,2022-01-09 13:37:06,3,3,0,秋冬学期的fds。老师水平很高，几乎不点名，上课适应了口音之后体验很好；平时的分数能给就给；整体分数很求是，不过登分的时候靠四舍五入小捞了一下，强推
147599,2974,朱建科,2022-01-10 09:27:49,3,3,0,老师真的算是给分超级好！真的爱了爱了！
147602,2974,朱建科,2022-01-10 09:29:40,0,1,1,给分很求是 是我太菜了
147629,2974,朱建科,2022-01-10 10:35:03,0,1,1,给分超好，上课佛系，quiz签到，讲得清楚，选他不亏
147744,2974,朱建科,2022-01-10 15:48:51,1,1,0,上课讲解很深入，给分特别特别好yyds
149948,2974,朱建科,2022-01-18 02:53:59,0,1,1,必须十分！上课还可以，不怎么查重，给分无敌好
150216,2974,朱建科,2022-01-20 11:26:03,3,3,0,老师的FDS，除了英语口音之外无可挑剔
150513,2974,朱建科,2022-01-28 06:12:24,-36,3,39,朱老师柠檬什么时候酸啊
152618,2974,朱建科,2022-04-16 04:24:34,2,3,1,口音不好，语速快，不喜欢\n\n还有就是给分很求是
157901,2974,朱建科,2022-06-25 11:43:22,1,1,0,老朱很温柔
165512,2974,朱建科,2023-01-07 14:33:58,0,0,0,不错的，很好说话的，给分好的，助教xjj温柔的
165915,2974,朱建科,2023-01-10 10:52:27,1,1,0,给老师磕俩响头
165947,2974,朱建科,2023-01-10 13:04:13,0,1,1,虽然听不太懂他说了什么，但是学到了很多
165983,2974,朱建科,2023-01-10 14:46:31,3,3,0,从老师的上课态度和专业水平来看，绝对是个好老师。听说三个project都不查重，平时作业也不查重。不过两个bonus都分别需要写一个简短的报告，而且bonus的分数只加到平时分，溢出的不计。期末会微微调分，一般都是帮你不卡绩。如果是想学些东西的话绝对值得选，不过如果是为了单纯好拿分的话，可能其他几位把bonus算到总评里的老师更好。
168160,2974,朱建科,2023-01-31 03:31:55,0,1,1,老师真的非常好！\n\n讲课节奏很好，思路清晰，虽然英文有点不标准但完全可以听懂，如果他看见你疑惑的眼神就会快速解释一下刚刚讲的东西\n\n给分也很好，我是外专业同学选了ds感觉收获满满，而且老师特别宽容善良
169907,2974,朱建科,2023-02-28 09:53:55,4,4,0,对于唯一一个我问问题我说谢谢他说不客气的老师没什么好说的，人好人帅给分好，除了英语口语之外老师真的很完美
181041,2974,朱建科,2023-10-06 10:43:40,11,11,0,这个老师是这样的，自从第一节课被他的“阿婆棒”打了个下马威之后，你就再也听不懂英语了（doge
183867,2974,朱建科,2023-12-01 14:56:00,27,29,2,翻译：\n\nQB Time = cubic time\n\n瑞克神 = recursion\n\n瑞克神力 = recursionly\n\n阿婆棒 = upper bound\n\nQ子 = quiz
188144,2974,朱建科,2024-01-18 09:22:53,1,1,0,口语多听听就懂了，其余都满分
188253,2974,朱建科,2024-01-18 13:32:05,9,9,0,就凭你fds的hard不屈服于cy淫威你值得10分
188856,2974,朱建科,2024-01-20 09:38:49,3,4,1,很好很耐心，期末的时候突然说对于hard mode，课程组决定不能超过平时分的，但是朱老师自己学期初的时候说可以超过平时分补在总评上，最后也是顶着课程组的压力兑现了承诺，10分
189163,2974,朱建科,2024-01-22 08:11:17,0,0,0,除了阿婆棒别无问题！
189590,2974,朱建科,2024-01-25 13:06:44,2,2,0,除了发音之外无论是水平还是人品都值得10分
190064,2974,朱建科,2024-02-18 09:06:52,9,10,1,朱老师严谨认真；上课内容丰富，逻辑清晰，旁征博引。但我冒昧地对老师个别英文单词之发音表示质疑，尽管这一般情况下并不妨碍对内容之理解。\n\n朱老师《FDS》课程知识量不算很大，如果认真学习、揣摩，还是比较能够掌握的；作业、Project与Bonus之布置因材施教，亦比较照顾同学的感受。老师上课时以quiz之形式点名，然次数并不很多。此课程Project之报告似乎应尽量用英文书写；且作答名义上要求以C或C++二种语言，尽管事实上Python完成之作业也在争辩后被接受了。\n\n感谢朱老师和诸位助教老师；您辛苦了。
190185,2974,朱建科,2024-02-24 16:42:48,3,4,1,很好的fds老师
190618,2974,朱建科,2024-03-12 02:15:46,0,1,1,讲课太跳跃了，我笨跟不上咧
194917,2974,朱建科,2024-06-26 02:32:09,1,1,0,朱老师你是我的神！
205831,2974,朱建科,2024-12-12 06:58:02,1,1,0,FDS绝对的好老师！
218376,2974,朱建科,2025-04-23 03:45:39,1,1,0,老师好，但随堂小测有点过于零帧起手了🤪
219164,2974,朱建科,2025-05-22 14:46:53,0,0,0,非常好的老师！！！！！
221865,2974,朱建科,2025-06-27 03:48:05,1,1,0,三次小测，只把小测当成点名，交了就有分（满分）。这学期好像没见查重过代码，不过感觉助教水平一般，问的题目有时候也不太会解答，而且比较慢。还有一点是3个project的申述会在学期末统一处理，大家不要因为申述了好几个月没动静而选择弃修。给分相当好
33110,3000,刘波,2016-09-13 03:20:35,1,1,0,困不知所云\n\n
33208,3000,刘波,2016-09-15 16:36:11,2,2,0,有点无聊
33209,3000,刘波,2016-09-15 16:36:40,1,2,1,来杯咖啡
35365,3000,刘波,2016-11-09 07:57:59,4,4,0,声音很moxing
35590,3000,刘波,2016-11-10 07:29:59,1,2,1,老师很可爱，很正能量\n\n
36061,3000,刘波,2016-11-10 11:09:31,3,3,0,可以水，老师人很好，善解人意，也是个大佬，还很正能量
47411,3000,刘波,2017-01-26 05:33:33,6,6,0,人好，善良。困。
53150,3000,刘波,2017-06-26 05:07:12,8,15,7,形策课不算无聊，反正也不听，期末思考题全背出了！每次都去上课，最后3.6呵呵班级平均分75
53152,3000,刘波,2017-06-26 05:11:43,7,8,1,不知道最后分数怎么算的呵呵\n\n每一项任务都给你认真完成了\n\n最后成绩和努力完全不成正比?
53178,3000,刘波,2017-06-26 06:37:01,4,5,1,老师上课很赞 给分很求是\n\n不过助教傻逼\n\n不过听说这个助教去人文了\n\n大家之后应该不会撞到了\n\n可以选选
53256,3000,刘波,2017-06-26 09:04:30,-1,4,5,其实老师还可以的，但是形策嘛这门课也要求不了太多，而且本身很多同学平时没在意，现在绩点低了又有什么好吐苦水的呢
53289,3000,刘波,2017-06-26 10:00:37,5,6,1,声音相当魔性 不过行测课嘛 认真听的人才奇怪 就写写作业 水水手机 考试是真的难啊 分低了其实也不能怪老师的 助教么我就呵呵 碧峰学长组也是他操作的 反正态度很差 估计是新上任的
54272,3000,刘波,2017-06-29 02:34:49,-1,2,3,其实还可以，班级总体给分也算在那么多行策班里算比较好的了 反正还有人能上4 唉
138020,3000,刘波,2021-07-07 05:36:03,1,1,0,绩杀不解释
138028,3000,刘波,2021-07-07 05:54:36,2,3,1,老师挺好哒，很温柔，来的人实在太少的时候会以课堂作业的形式点名。助教小姐姐也不错！
138833,3000,刘波,2021-07-11 06:35:21,0,1,1,形策😅
141755,3000,刘波,2021-10-24 13:02:51,1,1,0,鲁迅说“无端的空耗别人的时间，无异于谋财害命”，这样看来，形策无异于“刑铡”\n\n不过单论老师的话，其实刘老师挺真诚的
156528,3000,刘波,2022-06-20 07:44:38,1,1,0,虽然形策比较说教，不过老师其实是很真诚地希望同学们理解一些国家政策~
156531,3000,刘波,2022-06-20 07:47:39,1,1,0,行策课反正，懂得都懂
156541,3000,刘波,2022-06-20 08:13:17,0,2,2,怎么说呢 课上基本不听 文字作业稍微认真一点 期末裸考3.9 还算满意了
156545,3000,刘波,2022-06-20 08:27:33,1,1,0,还行，期末稍微复习下，不会失望的
176338,3000,刘波,2023-06-28 12:36:50,1,1,0,老师评分机制极其单调，建议不要让你们小组的人发言，全部自己来，分数原地升天
176339,3000,刘波,2023-06-28 12:39:36,0,0,0,形策给分还可以，相比其他班事算少了很多的，好老师bd
178562,3000,刘波,2023-07-14 14:06:52,0,0,0,平时事情很少，不太喜欢点名，我没记错的话2022-2023这一学年应该是只点过一次名，给分很好。对于一门水课，老师做的很不错了
9103,3042,刘海风,2015-10-13 04:35:33,16,19,3,quiz测完我就来打了10分
20164,3042,刘海风,2016-01-26 10:45:06,8,9,1,讲的还过得去，但没有给人惊艳的感觉，下课请教她问题，她讲解的挺耐心的
21592,3042,刘海风,2016-02-29 09:14:20,0,4,4,讲得确实一般般，但是最后一节复习课绝对是良心
39527,3042,刘海风,2017-09-18 08:57:56,6,6,0,老师挺呆萌的，人很和善
41061,3042,刘海风,2017-01-12 10:51:33,8,11,3,萌妹纸
41991,3042,刘海风,2017-01-13 11:20:13,1,1,0,好好好
45751,3042,刘海风,2017-01-20 04:25:29,4,4,0,给分很好！
45784,3042,刘海风,2017-01-20 05:37:10,1,1,0,很良心
45796,3042,刘海风,2017-01-20 06:06:35,4,5,1,老师有点呆萌，上课讲得一般般，不如自己看ppt.quiz有三四次，不是太难。平时作业不用交，快期末的时候要上交检查一下，建议还是做一下，不然quiz还是会有点蒙逼的。最后给分很棒，4学分的数逻一下子就拉上来了不少分，点赞！
63485,3042,刘海风,2017-12-05 03:05:33,1,1,0,女神啊。蠢萌蠢萌的
63706,3042,刘海风,2017-12-13 07:40:29,0,0,0,很不错的老师
64618,3042,刘海风,2017-12-25 14:23:03,1,1,0,很温柔也很耐心的老师，课程要求相对而言偏水，讲的不算特别好也不算特别差，总体还可以吧。
65697,3042,刘海风,2018-01-08 09:33:42,4,7,3,不知道数逻课讲了什么，今天数逻实验看到有说是lhf班的同学拿着个显示器接FPGA在捣鼓，数逻课的定位什么时候变得这么高了呀
65883,3042,刘海风,2018-01-10 02:04:06,0,0,0,温柔可爱
70546,3042,刘海风,2018-01-27 07:41:55,5,5,0,老师很负责很耐心，数逻当个性很赚
70648,3042,刘海风,2018-01-27 10:28:03,3,3,0,好老师，quiz会有34次。
70798,3042,刘海风,2018-01-27 14:07:37,3,4,1,软工学个选修这门课性价比还可以 事情算多但是也学到了一点东西 最后给分也很好 经常提前下课 小测也会提前说一声 老师讲的一般般但私以为在妓院里算是比较好的水平了 最后的大程序给的ddl很晚算是很贴心了
70827,3042,刘海风,2018-01-27 14:48:27,2,3,1,老师说要调分只能往低了调，我感觉我被调了ಥ_ಥ
70856,3042,刘海风,2018-01-27 15:49:03,0,0,0,老师很萌，而且绩点给的真的好，出乎意料地好。。。
71162,3042,刘海风,2018-01-28 05:18:47,0,0,0,老师她辣么萌
71234,3042,刘海风,2018-01-28 07:37:59,0,0,0,老师很负责，还很萌2333，最后给分也很好
74420,3042,刘海风,2018-02-21 00:07:30,0,0,0,老师超萌，给分又好，这不就足够了
74791,3042,刘海风,2018-03-06 01:59:10,0,0,0,老师特别可爱
75208,3042,刘海风,2018-03-08 03:59:10,0,0,0,很可爱的老师ớ ₃ờ\n\n
85620,3042,刘海风,2018-07-22 02:36:31,0,0,0,萌萌哒
86428,3042,刘海风,2018-09-16 02:30:41,2,2,0,计组给分一般般吧，课还行，有时候会抽人回答问题
88690,3042,刘海风,2018-11-06 01:47:51,1,2,1,给分太好
136320,3042,刘海风,2021-06-16 07:44:31,3,3,0,嘟嘟嘟
138666,3042,刘海风,2021-07-10 08:17:27,1,5,4,老师人很好，但给分感觉一般，别的班加分的实验都要必做。
139385,3042,刘海风,2021-07-15 03:36:55,13,14,1,老师很可爱，数逻和计组的给分都很好，稍微做点bonus平时分就能满。顺便夸夸hjh助教，真的好负责
144392,3042,刘海风,2021-12-21 10:24:40,1,1,0,人好声甜分高
151083,3042,刘海风,2022-02-23 01:58:36,5,7,2,对老师的评价：人美心善，人少的时候偶尔会点名，小测给分巨好，对于画图题，只要有画线，总能为你找到得分点。对于平时分比较少的同学，会给机会上台做题目来获得平时分。\n\n对数逻的评价（针对软件工程，毕竟计科是必修的）：事巨多，一学期要学一门硬件语言，每周都有实验要做。并且要用这门语言做个游戏，贪吃蛇是最低要求。期末考试也比较难，需要认真复习。总之非大佬最好别选。\n\n对助教的评价：hjh助教真是特别负责任，当然这也意味着实验课水不过去，对于后面几个比较难的实验，虽然可以请教别人，但是需要自己理解代码的全部逻辑才会被验收过。对于上实验课特别认真但是能力相对不足的同学，助教也会相对给多一点分。\n\n最后，刘海风老师yyds
154052,3042,刘海风,2022-05-21 06:46:25,-3,2,5,感觉讲的还是挺好的（可能是因为之前数逻碰上了神奇(niu ma)老师）
158280,3042,刘海风,2022-06-28 04:08:54,-1,1,2,希望老师下次上课的时候能唱首歌
158361,3042,刘海风,2022-06-28 17:11:16,18,19,1,均绩不会骗人
158362,3042,刘海风,2022-06-28 17:19:32,-28,4,32,趁着刚出分赶紧来打个10分。海风姐姐上课挺简单易懂的，比隔壁某位自己都不太会的老师要好太多了。助教gg很负责，但如果实验迟交可能会有一点点点凶（）给分中规中矩意料之中叭，有点后悔没做cache bonus，似乎能加不少(´･Д･)」
158368,3042,刘海风,2022-06-28 18:39:34,15,17,2,楼下那个差不多得了，少来这踩一捧一，海风姐姐上课不错，姜女士也没你说的那么差，计组和体系上的还是蛮清楚挺不错的，别把你计概的刻板印象带到这。知道你考得还行，但你能不能在群里面收敛一点啊，天天搁那装来装去烦不烦啊，一副小人得志的样子真的让人作呕。事多分低难道不是事实吗？去了解了解别的班的实验以及报告要求再在群里bb可以吗？
158472,3042,刘海风,2022-06-29 13:57:25,23,27,4,我评价的是2022《计算机组成与设计》，这门课有两个教学班，分别由lhf、jxh两位老师教授，主要面向图灵、混合同学\n\n老师讲课不错，条理清晰，回答问题及时；郝助教很负责任，实验有详细的指导；感觉学到很多东西；但这门花了我这学期接近一半的精力的课，绩点很低，不明不白；我完全不知道我哪里没做到位，会得到这样的分数\n\n\n\n助教负责任是很好，但是导致我们班比隔壁jxh老师班实验难度大很多，验收也完全不能水，实验报告要求也很高，完全是整个年级实验难度最大耗时做多的班级；实验室空闲时段，五一端午假期，各种周末时间，走进509，你总能发现我们班的同学在辛苦的调试；而隔壁jxh班的同学，甚至经常没几个人去上实验课，还能提早几周做完实验；实验硬核一点不是坏事，但是如果做的东西多，总评得分还很差呢？属于是事多分低了\n\n\n\n\n\n多说无益，只能希望同名课程的老师们能统一一下平时的要求、给分的标准吧\n\n我不会忘记我写的那些CPU的结构、流水线的知识，但“选择大于努力”还是2022年计组课上我学到的最有用的知识\n\n\n\n总结：求高绩点请往他处，划水摸鱼勿入斯门
158534,3042,刘海风,2022-06-30 05:29:13,4,8,4,老师人很好，很喜欢老师，好说话，会问我们实验要不要延期一些，以及为我们争取实验室在周末开门。不过这门课确实挺难的，助教我也不好说，不是很喜欢，毕竟人家是本科时期的学霸，可能就是不能接受给不完美的报告打高分吧。明年这位助教就不当助教了，还是可以选hfjj的。
158885,3042,刘海风,2022-07-03 04:25:36,-14,4,18,很多人吐槽实验比较严格，但实际上hjh助教并非空穴来风地刁难。一般来说是因为验收时间太晚了防止抄袭才会问的比较详细，我几个实验都做的比较快，助教问我的问题就比较简单。其实本质上还是只要真正掌握了知识、理解了自己写的内容就根本不必担心。而且最重要的是，在独立做完了几个实验之后你会发现期末考试就跟切菜一样简单。\n\n然后我得要反驳一下实验难度大的说法，我认为所有班级实验难度都是一致的，问了《计算机组成》班级的同学，知道他们也都是得实现RISCV的所有指令。唯一的区别应该只是在于TA Code水或不水上了。如果因为TA Code水而通过了验收，但CPU功能实际上是有问题的，那我觉得不是合理的现象。
167578,3042,刘海风,2023-01-17 12:12:05,3,3,0,数字逻辑设计满绩前来还愿，老师上课逻辑很清晰，比较喜欢点人上去回答问题，比如找人去黑板上画卡诺图什么的，但是画不出也没啥关系。小测的形式一般是每次两道题目，基本都是电路设计题，如果作业做了的话时间肯定来得及的
167583,3042,刘海风,2023-01-17 12:42:12,0,1,1,爱了爱了
167586,3042,刘海风,2023-01-17 12:54:58,9,9,0,老师讲的很好很有耐心~\n\n老师好助教更好(斯哈斯哈我的瓜瓜)
167590,3042,刘海风,2023-01-17 13:18:21,1,1,0,老师很好，数逻这个课事情是真的多
167670,3042,刘海风,2023-01-18 07:46:54,3,4,1,老师超好，助教也很棒
171380,3042,刘海风,2023-03-23 02:16:58,19,19,0,“哎我怎么晕了”
172879,3042,刘海风,2023-05-09 03:26:11,5,7,2,老师很好，但是计组的助教怎么要求这么多，五一在调板的大部分都是我们班的人。而且要求多就算了，指导几乎没有，全靠自己摸索，不知道助教咋想的
174545,3042,刘海风,2023-06-14 02:49:46,4,7,3,快逃，事多分少
175972,3042,刘海风,2023-06-27 09:53:17,24,25,1,老师上课讲的很对，但是助教瓜豪哥哥好帅🤤斯哈斯哈🤤想和瓜豪giegie贴贴🤤🤤🤤🤤🤤
178171,3042,刘海风,2023-07-07 12:02:13,-1,1,2,老师人美心善，助教gg也是超级棒！
178318,3042,刘海风,2023-07-10 04:02:31,6,8,2,老师人很好，但是平时分扣得是真的狠，我所有的bonus全做完了也补救不上来，给分虽然是黑箱，但平时分基本不会调的，虽然期末很简单，但平时得花费很多时间去卷报告，小测也一定要认真对待，因为小测时一般还不太会，但扣了就真的实打实扣，不会根据你期末考得好就调分，这真的是令我很难过的地方，我觉得完全可以和其他课程学学，平时分可以根据期末调调，而且这种实验我觉得还是把重心放在验收上吧，把重心放在卷报告上是真的令人很难受，那么多指令有好多重复性的验证，如果换成书面文字又冗长又没有必要，真的更重要的是实现并掌握基本原理
178319,3042,刘海风,2023-07-10 04:04:39,2,3,1,老师人很好，但是平时分扣得是真的狠，我所有的bonus全做完了也补救不上来，给分虽然是黑箱，但平时分基本不会调的，虽然期末很简单，但平时得花费很多时间去卷报告，小测也一定要认真对待，因为小测时一般还不太会，但扣了就真的实打实扣，不会根据你期末考得好就调分，这真的是令我很难过的地方，我觉得完全可以和其他课程学学，平时分可以根据期末调调，而且这种实验我觉得还是把重心放在验收上吧，把重心放在卷报告上是真的令人很难受，那么多指令有好多重复性的验证，如果换成书面文字又冗长又没有必要，真的更重要的是实现并掌握基本原理
187796,3042,刘海风,2024-01-17 13:02:26,6,7,1,海风老师+瓜豪，神中神
188147,3042,刘海风,2024-01-18 09:36:28,2,3,1,GOAT
190063,3042,刘海风,2024-02-18 08:39:50,10,10,0,刘老师学术水平很精湛；同时她认真严谨、和蔼可亲。期末考试前，半夜时分我援疑质理，老师仍然秒回；且考试开始前不久还认认真真地答疑而无丝毫敷衍之意。\n\n刘老师的《数位逻辑设计》课堂气氛活跃，她几乎不点名 (但实验课程需签到)，布置作业也很照顾同学的感受；期末考试之题目不偏无怪，若平时掌握知识而完成作业，则应答料非难事。此前付出相应之努力，最后给分也是非常理想的。\n\n感谢刘老师和此课程之助教郭老师；您辛苦了。
220534,3042,刘海风,2025-06-18 11:45:00,1,3,2,谁说我海风妈一句坏话我就冲冲冲（x\n\n海风属于妈妈型的，Sys1搭配瓜豪和Q助教简直是爽上。而且海风会提前通知什么时候“可能点名”，提前通知小测，小测调分，允许期末cheating sheet打印一部分（实则全部），小测还给各种信息\n\n别的不说，有一天周一早八下了一场巨大的雨，大到我骑车子骑不稳那种，淋着雨到教室，海风依旧没点名，就凭这天早上我就信任了海风\n\n如果海风还不能俘获你的芳心，那真的要考虑一下到底是海风的还是自己的问题了
222049,3042,刘海风,2025-06-29 07:29:27,0,0,0,（24-25春夏计算机系统1）\n\n很好的老师哇！特别体贴同学。从来不点名（有一次另一个老师来上，老师在群里提前通知“可能点名”）\n\n小测会尽可能给提示\n\n教学方面，大部分重要的东西讲的还算清楚，一小部分可能讲着讲着会把自己绕进去，需要课后自己回去理一下思路，毕竟也是老师第一次上系统课，计组和数逻两门压成一门来上确实不好把握重点\n\n这个课期末考察的还是比较浅的，平时实验相对比较重要
8921,3058,蔡登,2015-10-01 05:21:11,-9,3,12,听不懂
25574,3058,蔡登,2016-05-26 06:51:42,11,14,3,听的懂
32735,3058,蔡登,2016-07-12 07:22:44,-3,3,6,讲得还不错，干货很多，然而quiz很多，给分也不高
50275,3058,蔡登,2017-05-02 06:22:13,6,7,1,讲的很赞
51182,3058,蔡登,2017-05-23 06:11:29,34,49,15,很棒的老师。上课总是带三瓶农夫山泉，两大一小，校庆过后变成了三瓶格桑泉，hhh
58858,3058,蔡登,2017-09-18 05:57:32,4,4,0,我觉得ok
86022,3058,蔡登,2018-08-27 08:04:45,0,0,0,超级棒的老师
87086,3058,蔡登,2018-09-20 07:57:10,4,4,0,蔡登老师还是很牛的，膜拜。
93507,3058,蔡登,2019-01-10 06:25:04,8,13,5,进门我还以为是来干活的工人。。外形实在是太不拘小节了，课讲的很不错，人也是有刷子的，但是作业非常恐怖。旁听可以，选要慎重。我本人分很低，不过那是因为我太菜了
114228,3058,蔡登,2019-07-09 06:39:15,2,3,1,老师上课很好，条理很清晰，分数实打实按考试分来，所以想要特别高的绩点难度会比较大。正常水平在3.6到4.5之间
118718,3058,蔡登,2019-10-31 07:17:45,-9,4,13,课是好课，可惜讲课水平确实不怎么样
132928,3058,蔡登,2021-02-05 04:41:17,0,2,2,ML真的是好课 胡神yyds
1638,3084,潘纲,2015-03-23 03:32:12,5,9,4,说话有点像歪国人，很萌的老师。计算机视觉知识量很大，还是闭卷考试，不过能学到很多东西。
17706,3084,潘纲,2016-01-20 16:14:09,2,2,0,哈哈潘老师的外国调调
18836,3084,潘纲,2016-01-22 15:26:38,33,35,2,算是目前上过的最良心的CS课了，不管是作业设计还是考试安排
20895,3084,潘纲,2018-03-22 03:44:26,-41,6,47,他的课不是很好懂，唉，拖了我不少绩点啊，不喜欢这个老师，幸亏以后再也没这个老师的课了。
45530,3084,潘纲,2017-01-19 16:38:44,3,3,0,还没出分 超喜欢潘纲老师！
47720,3084,潘纲,2017-02-21 16:51:18,7,7,0,超级好！
66638,3084,潘纲,2018-01-18 02:01:30,2,2,0,讲的非常非常清晰！复习提纲非常好！
70953,3084,潘纲,2018-01-28 00:48:04,6,6,0,cv还没出分 但是真的真的很喜欢潘纲老师 大学遇到能排在前五的老师 上课认真讲课细致 虽然作业可能会稍稍复杂 但确实对理解cv里关键的内容很有帮助
75229,3084,潘纲,2018-03-08 06:02:15,2,2,0,不错不错
121925,3084,潘纲,2020-01-24 05:20:10,17,17,0,上课讲的内容很多很仔细，作业挺干的，复习提纲非常滴详细，感觉上得比较扎实。
149841,3084,潘纲,2022-01-17 08:38:54,9,9,0,潘老师作业的ddl比较紧，每一两个星期就要做个小实验这样子，没及时交的话那一项作业只能拿80%的分数，所以尽可能在ddl前提交0.0\n\n最后的期末考试基本都在老师给的提纲范围内，对着提纲好好复习肯定考的不会差√
170862,3084,潘纲,2023-03-10 15:28:18,12,13,1,饮水姬第一人
189958,3084,潘纲,2024-02-03 16:50:37,5,5,0,评价的是2023-2024冬学期的计算机视觉课程，该课任务量很多，今年作业较往年有不小变化，5次编程作业难度都极高，和隔壁sml老师班相比作业难度相差了不知多少个数量级。有期末考试，几乎是按照文科模式考的，最后给分一般，不好也不差，只能说这么大的任务量不应该是一门仅仅两学分的选修课该有的。老师还是有水平的，所以如果你真的对CV方向很感兴趣，或者很擅长的话可以选，但是如果仅仅是想拿选修学分的话，那还是挑一些别的课吧，懂的都懂(
189971,3084,潘纲,2024-02-04 11:40:39,2,2,0,cv，老师讲课不错，几次lab很扎实，能学到东西；期末考试直接面向理念卷复习即可
9388,3089,董亚波,2016-08-27 12:55:59,6,9,3,讲课很棒啊。赞赞赞
19795,3089,董亚波,2016-01-25 09:29:13,3,6,3,讲课很认真，也很生动。
22218,3089,董亚波,2016-03-03 03:25:34,8,10,2,人好课好。老师为什么不开计组(T＿T)
32603,3089,董亚波,2016-07-08 04:08:56,-2,2,4,一般般
33352,3089,董亚波,2016-09-18 15:45:04,-4,0,4,test
46675,3089,董亚波,2017-01-22 06:41:49,3,4,1,会卖萌！强力推荐！老师怎么不开计原阿！！！
47007,3089,董亚波,2017-01-23 09:13:28,0,1,1,老师好萌好可爱，讲得挺不错的
48607,3089,董亚波,2017-03-08 09:03:04,1,2,1,老师怎么不开计组～
49309,3089,董亚波,2017-04-05 01:39:46,0,0,0,人很nice，上课也棒。老师要是开计组就好了。
51560,3089,董亚波,2017-06-07 06:11:30,0,0,0,萌，水平高
60735,3089,董亚波,2017-10-29 03:50:47,26,32,6,实验课能不能讲清楚点，节奏放慢点？一上来大家都不知道原理，复制代码的时候不知道是什么意义，出现错误更是一脸懵逼，往往卡在很多低级错误上。如果事先花些时间把这些讲清楚了，实验课也不用那么折腾，大家可以做得更轻松老师也不用那么累，何乐而不为？
62804,3089,董亚波,2017-11-27 04:11:53,4,4,0,Verilog语言真心看不懂……
65625,3089,董亚波,2018-01-07 14:40:11,18,21,3,讲个笑话 大家百度搜一下 浙江大学董亚波 承诺   会发现奇妙的东西
66375,3089,董亚波,2018-01-15 12:54:40,2,2,0,快考试的时候才发现老师讲课条理如此清晰...老师太nice
67467,3089,董亚波,2018-02-01 01:08:55,2,2,0,真的好老师，能讲得很清楚，不过突如其来的占比很大的quiz还是有点惨
72883,3089,董亚波,2018-03-15 23:27:16,6,6,0,quiz多，给分一般
73972,3089,董亚波,2018-02-04 02:46:00,0,1,1,讲课思路清晰，实验课任务不多，且可以耐心解答同学的疑问，大赞！
75528,3089,董亚波,2018-03-13 03:05:48,2,2,0,理论课讲得非常好，如果认真听的话可以很好的理顺知识点。实验课有点诡异……\n\n对于不开计组还是有怨念的?
81497,3089,董亚波,2018-07-05 08:18:08,6,6,0,实验ppt上的东西不少是有错漏的……
91194,3089,董亚波,2018-12-03 06:22:56,2,3,1,肯定哪里错了，自己再去看看
91739,3089,董亚波,2018-12-19 04:23:06,3,3,0,实验讲的比大姑娘谈恋爱还含蓄，quiz占比重很大。
99064,3089,董亚波,2019-01-24 08:10:56,18,18,0,讲的好，给分不好
99082,3089,董亚波,2019-01-24 08:46:30,12,12,0,讲课很棒 人也很不错\n\n信息不对称，不回邮件，不公示平时分（没有渠道，老师不建立课程群）
99096,3089,董亚波,2019-01-24 08:56:47,11,11,0,给分不太好
117245,3089,董亚波,2019-09-21 06:31:26,4,5,1,理论可 实验个人感觉讲得一般 \n\n一个是每次任务都不是很清楚 然后原理与内容混在一起orz虽然也不是很重要 ppt错漏的就emmmmmmm
120400,3089,董亚波,2019-12-03 12:08:15,0,1,1,助教有毒
128093,3089,董亚波,2020-12-07 06:19:06,4,4,0,老师笑声太魔性了，鹅哈哈哈哈哈
132431,3089,董亚波,2021-02-01 13:25:46,0,0,0,数逻给分不香
132457,3089,董亚波,2021-02-01 16:26:04,1,1,0,别选 预置的也最好换掉吧...给分说实话真的不好，出分了只有十个人在群里谢谢老师，很多同学都说低得离谱
132576,3089,董亚波,2021-02-02 12:01:26,1,1,0,。。。给分真的太差了，和别的老师比起来差了好几个档，一门四分的课，不同老师直接给分差距这么大，是不是不太公平
132637,3089,董亚波,2021-02-03 04:20:15,1,1,0,讲得好，给分和其他老师差别有点大
133162,3089,董亚波,2021-02-12 05:27:04,-2,0,2,尽量别选就对了
142071,3089,董亚波,2021-11-05 05:22:43,0,0,0,偷袭式小测
149753,3089,董亚波,2022-01-16 17:28:40,5,5,0,老师真的好可爱！希望您能一直给同学们传递开心和知识！[比心]
149790,3089,董亚波,2022-01-17 03:24:33,9,9,0,老师的笑声堪称一绝，感觉很适合某些动漫里的反派配音（雾）
151296,3089,董亚波,2022-02-28 04:41:28,0,0,0,老师讲课很清晰，人也很好，期末考试难度正常，好好复习卷面分不会太差。一定要注意小测，占比很大而且搞偷袭，平时分容易被扣爆。。。
162511,3089,董亚波,2022-11-24 01:21:54,-9,1,10,计逻给分很好
164346,3089,董亚波,2022-12-20 10:59:35,1,2,1,突击quiz，平常作业不收，理论课讲的很好，实验就一言难尽了（
166924,3089,董亚波,2023-01-14 08:40:12,2,4,2,怎么还不改卷子？\n\n小测突击，给分烂就不说了，现在还不出成绩是没改卷子吗？\n\n唯一的优点是比隔壁班讲课稍微点，外加不收作业，仅此而已了，6分
166925,3089,董亚波,2023-01-14 08:40:57,0,0,0,波波你快出分啊啊啊！！考试结束过去11天了，你害在干啥呢！！！
167610,3089,董亚波,2023-01-17 15:33:12,12,13,1,给分真的烂啊兄弟们 董老师讲课没得说，课下问问题老师也很耐心。这个给分有点过于求是了。
168085,3089,董亚波,2023-01-26 07:48:01,7,7,0,正在播放《老师会捞我的》\n\n ━━━━━━●─────── 11:45:14 ⇆  \n\n     ㅤㅤㅤ◁     ㅤㅤ❚❚      ㅤㅤ▷      ↻
188895,3089,董亚波,2024-01-20 12:21:22,-2,0,2,好好好    [双手做鼓掌]
188930,3089,董亚波,2024-01-20 16:59:53,0,0,0,听理论是好的，别选他的课，期末捞平时十正常现象
189332,3089,董亚波,2024-01-23 09:07:29,0,0,0,计算机逻辑设计基础。讲课很好很清晰，但是有突击小测，这一块分数占比很高。而且老师很求是，不调平时分，给分这一块差了不少。
189751,3089,董亚波,2024-01-28 09:29:11,1,1,0,上课讲的挺好，但是给分真的求实，不捞小测平时分，和平行班比绩点基本要低一档
194036,3089,董亚波,2024-06-21 13:36:55,4,4,0,学的计逻，这学期感觉还行，9/10吧。\n\n\n\n老师讲课确实是很清晰的，如果跟着老师的思路走理论这一块基本是没什么问题。\n\n\n\n关于小测的话，留意一下老师什么时候在学在浙大上上传作业答案就行。虽然老师在最后一次课上小测，狠狠地偷袭了我们一把。\n\n\n\n实验这一块，刚开始的时候感觉确实很不好，实验室里三四十位同学老师和助教两个人也不可能全顾得过来，经常一个人对着错误的代码发呆。不过后面上手之后就没什么问题了。个人认为实验这一块老师确实没帮什么忙，基本都是自己+同学搞明白的。\n\n\n\n给分暂不论（），总体上课体验超越浙大老师平均水平，突击小测扣一分，实验指导少扣一分，老师魔性笑声加两分，总分9分。结论是：可以选，但不是非选不可。
196158,3089,董亚波,2024-07-02 02:06:14,4,6,2,首先就是计逻老师上课讲的非常好，但是实验确实比较痛苦面具，关于给分其实并不是击杀，主要是得花点精力，包括卷实验报告和考前突击，还是能满的。
196892,3089,董亚波,2024-07-05 19:20:18,14,14,0,计逻，来讲讲个人学习感受吧（23-24春夏），本人最终成绩92/4.8，希望能给大家提供有用的参考\n\n首先老师理论课讲课非常好，PPT也比较全面，一学期跟下来没问题的！\n\n作业布置但不收，个人建议还是都看一看做一做。\n\n实验占比30。每周的至暗时刻…共14个实验，除了前三个类似物理实验，后面的并不是给出步骤照着操作就行，越后期需要自主写代码完成的部分越多（PPT有时还有错漏），需要自学。老师和助教很耐心，但验收蛮严格的，尤其是仿真部分要求较高。总地来说建议早早学好Verilog（上课完全不讲好崩溃），每次一定要提前预习，可以在github上找找学长学姐提供的资料来参考，最后认真按时完成实验报告，得分不会低的（本人的报告不是很精美，也基本都有95+）！\n\nProject占比10。小组不超过3人，单刷无额外加分。建议早早开工，否则可能出现考试周还在实验室奋战Project的绝望场景。给分应该还好(?)\n\n小测占比20。不会提前通知，但还是很有规律的：每次小测时，老师至少在上节课就已经讲完了本章，并且提前在学在浙大上传了作业答案。除完成作业之外，建议可以在智云上看看往年的小测题（都是在屏幕上给出题目），考察的知识点及题型的重合度蛮高的。对我来说小测是挺有难度的，如果没有提前准备会很寄，但做历年题很有帮助，最终提到了接近满分。\n\n期末占比40，斩杀线45。把作业和小测搞定，期末的大部分大题和一些选填基本就没问题。但选填还会涉及很多较细节的知识点，因此考前一定要好好过一遍知识（本人就是这块没复习好导致期末好些题是纯蒙的），可以在98找找数逻历年卷。此外不要忽视Verilog，同时可以记记单词防止看不懂题目。\n\n总体来说老师和助教老师都很好！虽然查老师上都说不捞，但我自己出分时感觉成绩出乎意料地高了一些。不过硬课比起盼老师捞，还是得靠自身实力以及平时任务的认真完成。祝以后学习这门课的同学们顺利呀！
197323,3089,董亚波,2024-07-11 02:19:26,2,3,1,老师人很好 计逻理论课讲得很好（虽然事实上我没怎么听）实验课就emmm不知道为什么默认我们什么都会 最后总评和预估差不多（但卡绩了）总之老师是个好人 但这门课还是上得感觉很痛苦
197806,3089,董亚波,2024-08-14 07:07:47,4,5,1,利益相关，因为拿满了。\n\n首先老师讲的很好，这是公认的。其次老师的课程确实十分有挑战性。平时小测的内容上课都不会特别强调，但是都讲到了，不过上课容量很大估计不太容易记住，因此需要从历年题目中提取解题方法。实验尽量早做，因为上课绝对来不及。
208622,3089,董亚波,2024-12-30 07:01:16,8,8,0,上学期上完dyb老师的计逻，这学期计组赤了一学期的石，期末到了，不禁又回想起上计逻时的时光（泪）\n\n所以老师为什么不开计组（怨念）
222089,3089,董亚波,2025-06-29 14:06:25,0,0,0,今年数逻期末分都这么低，结果平时分还一点不捞是吧。别的班的老师都是平时分狠狠往上捞，然后自己一看数逻直接拉低均绩零点一几，直接成为学年最低绩点。
1263,3120,黄琦,2015-03-21 17:09:59,8,22,14,总是拿他公司的东西给我们当作业。没给1分是因为还有收获。
2667,3120,黄琦,2015-05-05 04:50:52,19,36,17,上学以来最不喜欢的老师
10655,3120,黄琦,2015-11-21 14:57:45,12,22,10,这老师真的…日了狗了
19504,3120,黄琦,2016-01-24 12:01:56,-13,8,21,看在助教帅比的面子上给了十分
24495,3120,黄琦,2017-07-17 10:35:11,5,16,11,没有多少钱装的像上亿身家一样，挺搞笑的一个老师
26456,3120,黄琦,2016-06-18 14:18:57,14,21,7,对学生态度极差，自以为了不起，我见过最差的老师，极品
38481,3120,黄琦,2016-12-06 23:50:02,6,13,7,挺自以为是的 不像老师
47905,3120,黄琦,2017-02-27 08:15:54,1,10,9,垃圾老师
48221,3120,黄琦,2017-03-01 09:33:47,3,10,7,不配当老师
48576,3120,黄琦,2017-03-07 14:50:21,8,16,8,根本不尊重学生，拿学生做他公司的活...
50870,3120,黄琦,2017-05-07 16:35:59,26,43,17,看到大家都喷的那么狠，还是有点心酸。大家冷静想想，黄老板的课反而是工设少有能学到东西的课，哎......为双方都叹个气......
51588,3120,黄琦,2017-06-07 10:34:46,6,11,5,事情居多，每星期都不得安宁，最后大作业的展示在考试周，一边复习考试一边还要做大作业
56335,3120,黄琦,2017-07-03 13:54:11,5,9,4,特别……特别……的辣鸡
63185,3120,黄琦,2017-11-29 03:41:50,1,4,3,日常拖课?
66996,3120,黄琦,2018-01-19 15:58:09,4,9,5,黄老师的课挺好的呀，黄老师人也不错
68777,3120,黄琦,2018-01-24 01:24:52,8,12,4,作业爆炸多，但是真的非常的干货，这门课好好学可以学到很多，助教和老师都是很有学识的人，但是态度不认真就会比较惨吧，感觉老师有时候还挺较真的。反正认真的话会得到匹配的分数，想水的话就别报这门课了，给分会不好。
68843,3120,黄琦,2018-01-24 03:26:51,-1,4,5,老师课很好，很有知识。就是那个姓徐的助教很差，让人不舒服
72882,3120,黄琦,2018-01-31 08:52:30,2,5,3,不该总把自己公司产品公司项目给同学们做
74999,3120,黄琦,2018-03-07 02:53:38,0,4,4,我觉得 可以学到很多
75779,3120,黄琦,2018-03-17 14:31:23,21,26,5,作业的确是挺多的，但是作为一堂专业课都想水过的话，不知道来大学是干什么的...老师是一个阅历很丰富的人，比起象牙塔中的学者，他更有一丝商人的感觉。但也正因为这样，他对市场的远见卓识，用户调研的方法论，很有学习价值。说拿公司项目给学生做，那还不是因为学生自己想不到好的课题...况且没有市场经验的学生，要想做一个公司的项目这么容易么...\n\n总之就是很有干货，助教虽然严格，但也很有耐心啊。还是那句话，付出多少就会得到相应的回报。
76007,3120,黄琦,2018-03-24 04:39:32,1,6,5,高高在上的优越感 怎么进浙大的?
84364,3120,黄琦,2018-07-12 15:53:03,6,8,2,上工业设计的课为数不多喜欢的老师
86064,3120,黄琦,2018-09-03 07:29:45,2,4,2,大学里学到最多的课，交流最多的老师
86413,3120,黄琦,2018-09-15 10:11:42,3,6,3,我们的服务设计课程不是黄老板来上，真是感到万分庆幸?
113357,3120,黄琦,2019-07-06 09:39:35,5,6,1,黄老师病好之后，绝对是工业设计数一数二的好老师。是真正关心学生而且有设计思维的老师。
121867,3120,黄琦,2020-01-23 02:25:43,5,5,0,说实话黄老板爱挑刺，但这不就是说明他严格吗，而且作业全是干货，几乎是我第一门学到了设计的一般流程的课，也是第一个全部小组合作作业的课，真的学到了很多。再说了讲道理被他怼的我可高兴感觉又学到了不少，那些说老师坏话的干嘛不当面说啊，交流也是学习的一部分啊…
123009,3120,黄琦,2020-04-30 02:10:26,3,4,1,唉，过于严格……日常就是劝你退课= =\n\n抗压能力不强的还是别选了……
148497,3120,黄琦,2022-01-12 16:41:39,0,2,2,非常傲慢。
151918,3120,黄琦,2022-03-20 16:51:54,1,5,4,非常负责的好老师，骂之前麻烦先想想这门课学到的东西是不是有价值的？都是成年人了不要不看利弊只看别人的态度。\n\n说拿公司项目给学生做的，设计专业不依靠实战怎么提高？更何况有多少项目是真正被公司拿去投产的？如果你真喜欢整天一团和气吹牛B的老师那我无话可说。\n\n最好笑的还有说他没多少钱的，我就这么说吧，他挣这点工资来给你上课算是做慈善。
165203,3120,黄琦,2022-12-30 04:43:03,5,6,1,作业可能会被全盘否定，你做的这个东西完全不行。这个与用心程度，花费时间无关，只要思路一错，就全白干，比如一个组因为用户选的不好，直接被评价“这个输入是没有意义的，接下来的PPT就五分钟过一下好了”😅。简单说，别的课，努力基本会有回报，这个课，完全看命吧。
178553,3120,黄琦,2023-07-14 10:12:31,5,6,1,黄老板实在是自我感觉实在太好了，教东西的时候当甩手掌柜，检查进度就是当皇帝，看不起学生做的东西，看不起学生的想法，完全随机的厚此薄彼。当他的学生体验极差。
178602,3120,黄琦,2023-07-16 12:29:59,0,0,0,😅😅😅😅😅😅😅😅😅😅😅😅😅😅😅😅😅😅😅😅😅😅😅😅😅😅😅
183780,3120,黄琦,2023-11-30 06:20:46,2,2,0,怎么说呢，对于工设学生来说，在大二上就选到这门课是我的不幸，忙，太忙了完全没有时间搞访谈，搞ppt，到处去采访不同的人，甚至有些数据是无效数据（比如不花钱的人），我只是一个工设学生啊，我还能怎么办呢？
183782,3120,黄琦,2023-11-30 06:21:06,1,1,0,设计心理学，作业占比百分百，但是非常麻烦，展示的时候也是各种批评
186550,3120,黄琦,2024-01-11 15:52:34,2,3,1,设计心理学组内互评拍屁股想出来的？小组每人基准分20分，调分必须为5的倍数，小组总分固定，禁止平均分全员20分，那么组内想有互评高分就必须有互评低分，这很正常对吧？但是组内互评必须所有人达成共同意见，全员同意才能提交！而且互评成绩直接影响作业成绩，作业成绩占总成绩比例100%！你让这分数怎么分？以后怎么面对组里的其他同学？这样评分有啥意义？被这课名字骗进来的同学快跑！
186586,3120,黄琦,2024-01-12 03:22:54,1,1,0,虽然自己早已不在意分数和天天会见到的同学的人际关系，可是还是事情真多啊
190656,3120,黄琦,2024-03-13 11:51:04,0,0,0,我觉得可以提前体会到当乙方的感觉？有些展示确实被批挺惨的，黄老板点评绝不留情面，做作业体验很丰富
205667,3120,黄琦,2024-12-11 03:56:55,1,1,0,设计心理学确实能学到东西，老师也很认真，但事情真的超级超级多，基本上能占用掉周末绝大部分的时间（其他设计课的作业根本没时间做了……），作业量能抵得上其他2-3门两分的课程相加。如果真的很空没什么课上的话可以来试试。
208676,3120,黄琦,2024-12-30 16:22:49,2,2,0,老师人很好，讲课风趣幽默。这里说一下设计心理学这门课，工作量大是事实，不建议要摆烂的同学来。每周基本上要花整整一天的时间（或者更多）做小组作业，但是如果你热爱设计的话就会很快乐，我们这学期有服务设计的项目，会经常出行，也可以认识到很多好朋友。每周答辩的时候遇到做得不好的小组，能看出来老师已经很尽力忍住自己不批评同学了，最严厉的无过于“我已经不是这个时代的人无法共情”云云。那些说老师经常否你们方案的不如多找找自己的原因，小组作业划水不喷你喷谁？
214648,3120,黄琦,2025-02-15 16:35:25,1,1,0,黄老师是非常幽默风趣的老师，课堂氛围也很轻松，老师脾气也很好（据说是近几年变好了 也可能一直都这么好），有些小组完全摆烂甚至他也不会骂人。就设计心理学这门课讲，很有意思，选题自由开放，超级推荐，比如可以开番茄慢闪店等等，可以体验从未做过的很多有趣尝试 事情比较多但是收获也多，与付出和精力总是对等的。如果你真的喜欢设计，愿意花时间，那是不容错过的宝藏课程哦！
217932,3120,黄琦,2025-04-18 06:40:26,1,1,0,非常傲慢
72356,3218,冯结青,2018-01-30 03:04:42,4,6,2,虽然只听了几节课不过感觉老师讲课有条不紊的，还会讲解公式的推导，感觉很细致hhh。
104318,3218,冯结青,2019-03-18 00:28:01,10,13,3,老师本人还算好，但是作业真的太太太太太太太多了！！一个星期一百多道题谁吃得消啊。而且会点名，每次都是拖堂点名，拖堂拖个十分钟非常正常（好像是因为老师从前不带本科生，所以把握不太好讲课的进度）。可能这样的老师能让你把课学好吧，但是这种硬性的时间投入实在是太多了...
104520,3218,冯结青,2019-03-22 09:39:10,5,7,2,分高事少，认真负责，上课生动有趣
105271,3218,冯结青,2019-04-09 02:20:03,12,15,3,认真负责，讲课也很好，人性格超级好问问题都回答的很仔细，就是作业多+会拖课点名
105494,3218,冯结青,2019-04-15 11:26:57,-6,2,8,作业超级多，选课要谨慎。
107675,3218,冯结青,2019-05-08 07:17:13,9,10,1,老师很认真负责，回答问题炒鸡仔细。助教姐姐也很好，每天在微信群回答问题。\n\n老师作业很多，但是认真写完会有收获(￣^￣゜)。\n\n老师以前不教本科生，习惯两堂课连上，偶尔压堂点名。
107677,3218,冯结青,2019-05-08 07:46:59,11,12,1,人很好，非常负责。作业偏多，但c的作业多一点也不算坏事（大概）
108127,3218,冯结青,2019-06-29 09:13:49,27,33,6,老师真真真特别好 给几乎全班同学调整考试时间 让大家能够好好休息 讲课也很好很细致很清楚 为人处事也是 爱了
109786,3218,冯结青,2019-06-19 07:51:43,5,6,1,老师性格超级好啊，男神！！！感觉得到他竭力让每个学生都学好c语言，爱上c语言！
112193,3218,冯结青,2019-07-10 11:30:45,7,9,2,给分真的挺好的，平时作业虽然多但是到考试的时候你就不会慌了。老师人也挺nice的，平时问他问题回答也很热心。作为第一年带本科生，我觉得老师已经很不错了。
113520,3218,冯结青,2019-07-06 22:40:00,4,7,3,老师这波捞的，我吹爆！！！
113574,3218,冯结青,2019-07-07 00:22:28,4,4,0,老师人挺好，解答问题也好，就是作业多到爆炸。可能因为之前没教过，不熟悉课本，但是专业能力还是很强的！讲得进度偏快，上机课必须去机房。开始有点拖堂，后面就不怎么拖堂了。
113584,3218,冯结青,2019-07-07 00:31:44,7,7,0,作业一开始布置的很多但是后来经我们的提议量就很正常了，老师真的超级超级认真负责而且捞人能力一流!
113593,3218,冯结青,2019-07-07 00:43:31,5,5,0,给分超好！！对学生要求挺高的，作业偏多，上机要去，但这些对考试都很有帮助！话不多说10分！
113852,3218,冯结青,2019-07-07 18:30:26,4,4,0,冯老师虽然是个新老师，但无疑是个好老师，对学生要求严格，上机课必须去机房，但是为人和蔼可亲，遇事会先跟我们商量，尊重我们的意见。作业是比较多，但是经过每周限时上机两小时至少八道题的洗礼，期末考试一小时三道题就轻松多了！
114029,3218,冯结青,2019-07-08 11:44:57,4,4,0,师生情浓浓，感动...期末理论没上线，但依然60分飘过~
114160,3218,冯结青,2019-07-09 02:01:22,5,6,1,这个老师真的超级好啊，第一次带c程，虽然时间把握的不是很好，但真的超级负责，老师经常会去询问其他教学的老师。其实作业还好，c程的作业都挺多的，老师布置的算适中吧 没有期中但是有点名，上机课一定要去的，助教和老师都会在这里，有什么问题都可以问的。只要上课听了作业做了，感觉不会容易挂，老师会说：c程功夫在平时呀。反正，十分不解释！！！
115358,3218,冯结青,2019-07-19 17:22:41,-12,3,15,啰哩啰嗦
116095,3218,冯结青,2019-09-03 13:42:18,1,2,1,老师人很nice，上课认真耐心！很负责！\n\n被预置的时候慌得一批因为老师好像是第一次给本科生上课查老师上没有评分！\n\n是大学的一个惊喜！
122935,3218,冯结青,2020-04-22 12:58:46,3,5,2,老师真真很细致很nice，助教汪蕾姐姐太太太认真耐心了！一个小小的上机问题给我发了好大一段话讲解，感动(ಥ_ಥ)～
123915,3218,冯结青,2020-06-16 07:45:01,2,3,1,助教小姐姐和老师都超级认真负责
126257,3218,冯结青,2020-09-21 04:20:54,-8,0,8,不点名，睡得挺香的
136263,3218,冯结青,2021-06-14 13:33:18,1,2,1,课上的好，人也好，男神！
137062,3218,冯结青,2021-06-30 07:56:06,5,6,1,作业很多（他还嫌少），但老师很耐心，讲课很细致，胡子超级帅
137217,3218,冯结青,2021-07-02 10:47:23,0,2,2,老师上课炒鸡生动，课后作业虽然多，但是写对一半平时分就满了，一学期就点名两次，没期中，上机课一定要去，助教和老师都在的，顺带答疑
139019,3218,冯结青,2021-07-12 08:05:20,-1,2,3,呜呜呜呜谢谢老师捞我
139084,3218,冯结青,2021-07-12 13:51:34,0,1,1,老师实力很强，助教xjj也很负责。平时现场答疑或者线上答疑老师都会很乐意回答的
139087,3218,冯结青,2021-07-12 14:53:11,0,1,1,太感谢老师海底捞了
151385,3218,冯结青,2022-03-02 02:42:43,2,3,1,老师挺不错的
151817,3218,冯结青,2022-03-16 13:29:39,-1,1,2,老师很可爱～问问题也会及时回复 很有耐心 爱了爱了
158805,3218,冯结青,2022-07-02 11:26:10,3,4,1,上课以做题形式点名（好像是学院要求）\n\n有个期中考试会专门安排到周五\n\n给分求是 或许像我这样摆烂的不太适合 但老师上课还不错？（没认真听）
158808,3218,冯结青,2022-07-03 03:29:42,7,7,0,极为求是
158810,3218,冯结青,2022-07-02 11:34:14,1,8,7,呵呵 再见
158815,3218,冯结青,2022-07-02 12:02:56,1,6,5,老师很温和儒雅，作业也没有前面几年的那么多了哈哈哈哈（老师自己也承认）\n\n\n\n上机课要求去机房（不过其实不去，自己在电脑上写也可以……一般有什么事情都会提前通知）\n\n\n\n给分确实很求是，不过很值得选
158841,3218,冯结青,2022-07-02 15:53:10,8,13,5,真的是一点都不调分啊，快逃！
158842,3218,冯结青,2022-07-02 15:50:54,15,19,4,给分：一点都不调\n\n点名：节节课点名（或者课堂线上小测，和点名一个性质，反正不准你不听他的课）\n\n讲课：还好，但是讲课速度极快，不细\n\n建议：虽然给分求是，也不会给你调低，但选个其他给分好的老师不香吗。\n\n           听课zty（张彤彧）老师yyds，讲的极为细致，属于将c程手把手教你的那种，比如c程fjq老师花一节课讲完了最难的指针，zty老师讲了足足三节！不要问fjq老师剩下的课干嘛去了，问就是讲了考试不要求的部分
158860,3218,冯结青,2022-07-03 00:03:20,2,3,1,感觉老师平时作业和小测应该是有调分的 期末成绩应该没动 老师平时作业布置的比较多 对期末复习的时候很有帮助
174098,3218,冯结青,2023-06-06 07:50:32,5,7,2,很古板，较为求是，小测难度高于其他班（导致经常心态有点差），频率好像也高一些，本人高中选考技术，学期初对C程充满热情（还没开始上课就自学了一些），但到后面变成草草完成作业，现在只想早点考完了
177672,3218,冯结青,2023-07-04 07:17:55,-5,6,11,冯结青老师讲课很细致很好哇，有一种沉稳的帅气。C程好好听好好写作业，虽然有几次小测考得很差，但是最后认真分析错题期末考得不错，总评也不低。所以要相信老师，跟着老师的步子一点点学习，不会差的～
196408,3218,冯结青,2024-07-05 00:28:28,0,2,2,出分了，认真学可以拿高分的。选他有利有弊吧，利在可以学的很好（因为作业比较多，且面向应试，这一点十分有利于复习，不像某两个老师一个学期作业只有一二十道理论题），弊在给分求是，小测编程随机分配，不同人难度不同，可能有些不公平，我算了一下最后应该没有调分。但个人感觉是利大于弊的，因为这门课主要是看硬实力吧，只要你学的好不管老师怎么样都能拿高分的。
196471,3218,冯结青,2024-07-03 15:35:59,2,3,1,666
199863,3218,冯结青,2024-10-05 08:18:02,-3,0,3,他教了那么多人，为什么没人评分？
201800,3218,冯结青,2024-11-08 03:38:52,1,2,1,教学质量真不如Kimi
204424,3218,冯结青,2024-11-26 00:10:23,2,3,1,呵呵🤭🤮
207387,3218,冯结青,2024-12-21 06:08:04,0,0,0,老师讲的很棒，逻辑清晰，下课问老师问题会很细致地解答。但是对于科研任务繁重的硕博研究生，慎选老师的应用几何造型基础和计算机图形学。本学期应用几何作业和图形学作业均需要阅读大量课外文献来完成课程大作业（cpp框架），以及分别需要完成一万五千字和一万字的综述性课程论文，相比一些较为轻松的研究生课（3-4k字总述或报告等）多了一个数量级。
208465,3218,冯结青,2024-12-28 06:26:55,0,0,0,常翘他的课🤫，因为本人学过C🌚（我还是听智云比较精神☺️）\n\n这不重要啊🌚，课讲的是可以的，感觉会比较快吧，还得靠课后自己琢磨（做题啊问AI啊之类的）。知识很饱满，认真学可以学好的。重点课后会有雪灾浙大的限时小测验（1-3道题），就算翘课也要智云哦！
210713,3218,冯结青,2025-01-10 01:07:03,2,2,0,是一位拥有求是精神的好老师。不仅想教给我们知识去应付考试，更想交给我们一门技术和很多做人的道理。而且冯老师人性格特别好～
211557,3218,冯结青,2025-01-12 02:12:11,0,0,0,还不错
211786,3218,冯结青,2025-01-12 12:17:40,0,0,0,很好的一个老师，收获的不仅仅是知识，还有做人做事的智慧
212470,3218,冯结青,2025-01-14 05:05:10,0,0,0,给分好，好几次作业忘记做最后仍有4.8
212743,3218,冯结青,2025-01-14 16:44:08,1,1,0,讲课还可以吧，但是课后不看书学一学课后题根本应付不了，总分没怎么调分，算是中规中矩吧。
214468,3218,冯结青,2025-02-06 08:10:35,-1,1,2,应试教育之王，作业很多，所以期末理论会考的很好
3629,3249,厉向东,2019-01-05 14:17:55,14,15,1,东哥说话好温油hhh
10733,3249,厉向东,2015-11-23 03:41:56,6,9,3,老师颜值超高，不过就是性格腼腆，上课不太有趣
17276,3249,厉向东,2016-01-20 03:24:36,7,13,6,计算机辅助工业设计全靠自学
22036,3249,厉向东,2016-03-02 06:37:09,4,6,2,老师挺严谨的
78506,3249,厉向东,2018-05-12 11:52:02,0,1,1,老师非常好?，要求严格但是口硬心软
126566,3249,厉向东,2020-10-01 14:48:37,0,3,3,很好的老师，就是有点不听学生的意见
160825,3249,厉向东,2022-10-15 02:59:08,-1,0,1,东东两拳~
174000,3249,厉向东,2023-06-05 13:36:51,2,2,0,设计管理，上课讲得一般，点名会提前提醒，甚至还有一次额外点名（不点不扣分，点了加分），在批阅作业的时候明显展现出他英语水平的一般以及不仔细不认真，但是这门课的作业好好修改几次，还是能拿高分的
179433,3249,厉向东,2023-09-15 09:07:22,1,2,1,老师人真的好好\n\n度过了开心的一段时光
183478,3249,厉向东,2023-11-26 14:08:50,4,4,0,感知通信课照着pdf读，作业要求又麻烦，这里要出一个方案那里要出一个方案的，搞都没搞明白还要求能做出来，各种点评，让人无语
196789,3249,厉向东,2024-07-05 07:17:24,0,1,1,大三老狗表示，想要高绩点直接无脑选东东的课，然后多和他交流就行了（
197385,3249,厉向东,2024-07-12 04:32:16,2,3,1,课程综合实践一\n\n课程要求不高，五次点名就有40分了，作业量很少，上课时间也不长，有几天不用去教室，后面还能去阿里云参观，两周下来体验非常好，大家快来
197955,3249,厉向东,2024-08-21 14:45:32,3,4,1,课程综合实践一\n\n平时分超级好拿，上课类似听讲座一样（你在座位上悄悄玩电脑也是可以的），最大的收获是对AI在文生图以及编码方面有了进一步的认识。\n\n但是相较于隔壁MATLAB，就会感觉这门课超级水（又臭又长是怎么回事？），14天学习到的东西也并没有想象当中那么多\n\n给分无敌，以至于本人甚至以为教务系统出问题了...\n\n适合在经历了一个学期的折磨后想在短学期摆烂的学弟学妹们
201992,3249,厉向东,2024-11-08 03:56:25,2,2,0,课程综合实践I，让你明白什么叫做水课的极致，用最水的课获得最高的绩点。虽然学不到什么东西但是给分超棒！必须狠狠地选。这不比那些累的要死还绩点不高的课强多了？
207715,3249,厉向东,2024-12-24 03:33:22,1,1,0,短学期人好给分好
215658,3249,厉向东,2025-03-03 13:21:30,0,0,0,作业布置条理清晰，任务不算重，给分还好
217616,3249,厉向东,2025-04-14 06:59:22,2,2,0,设计管理，上课纯水，还要求学生开火车发言尴尬时间。作业说是可以改三次，但是一直不批改，交了一周之后才批改已经没有几天改了，作业给意见模糊，个人感觉他评分标准随意，照着优秀案例做给分也一般般。一门八周的课签到就有八次，有几周一周签到两次，不知道这么多次签到是为了什么。
218508,3249,厉向东,2025-04-24 05:27:45,2,2,0,虽然签到麻烦了一点 但是抵不住最后给分真的超级好啊 我哭哭哭哭
85071,3253,张丰,2018-07-15 08:33:39,0,0,0,人很好
34156,3255,于金辉,2016-09-28 00:52:38,9,9,0,吹逼能力远大于讲课能力
34361,3255,于金辉,2016-11-22 08:16:39,14,18,4,没讲过这么烂的老师，他好意思领工资吗？\n\n
34753,3255,于金辉,2016-10-20 06:51:55,8,8,0,简直了\n\n
34871,3255,于金辉,2016-10-26 00:34:26,9,12,3,每次上课都要讲一节课人生哲学\n\n上课不能看电脑\n\n还喜欢评价老师打分机制不合理\n\n莫名“看不起”本科生
37655,3255,于金辉,2016-11-20 03:26:35,8,8,0,拿着微信鸡汤读的老师我是第一次碰到
39534,3255,于金辉,2016-12-23 15:20:00,-8,4,12,老师讲的很好…学习到了前沿的哲学…感受到了老教授长者的风采和出色的绘画水准
40488,3255,于金辉,2017-01-03 17:35:34,3,3,0,很差啊
41634,3255,于金辉,2017-01-12 09:27:04,4,4,0,"学习帝问我，""听老师上课是一种怎样的体验""，抱歉，我还真没听过他上过真正的课_(:з」∠)_"
46098,3255,于金辉,2017-01-20 15:12:42,3,3,0,莫名其妙的人生哲理 来自奇怪的地方的教授优越感
46340,3255,于金辉,2017-01-21 09:24:49,4,4,0,给分差，讲课也无聊，还整天灌毒鸡汤
46346,3255,于金辉,2017-01-21 09:39:45,3,3,0,上课读鸡汤，教同学查字典，迷之观念一大堆
50874,3255,于金辉,2017-05-07 16:44:39,3,4,1,烂的要命，请学院立即开除这种老师。
107637,3255,于金辉,2019-05-08 01:04:56,0,1,1,老师讲的计算美学感觉不错，哲学方面的讲解也打开了新世界的大门，佛系老师～感觉蛮有收获
9438,3285,魏宝刚,2015-10-27 07:06:53,6,6,0,上课无聊透顶，不如mooc自学
9552,3285,魏宝刚,2015-10-30 08:55:59,4,5,1,上课ppt念都念不清。上课纯属浪费时间
11435,3285,魏宝刚,2015-12-01 06:55:03,1,1,0,听不懂
19101,3285,魏宝刚,2016-01-23 09:07:18,0,0,0,
27118,3285,魏宝刚,2016-06-23 04:57:37,7,7,0,老师身体欠佳，上课可能有些没活力，但是人还是很好的，给个高分鼓励一下老师！
115577,3285,魏宝刚,2019-08-05 12:56:26,19,19,0,老师一路走好? ? ?
115579,3285,魏宝刚,2019-08-05 15:06:10,1,1,0,听说老师走了 叹叹  来打个10分??
39377,3349,孙丹岭,2016-12-22 09:21:38,0,0,0,不知道是怎么改实验报告的
34367,3362,伍赛,2016-10-08 02:15:42,2,5,3,讲的也TMD太快了吧，话讲的不是很清楚，没有觉得任何比其他老师强的地方，貌似给分也比较差
40091,3362,伍赛,2016-12-29 06:38:41,0,1,1,吓死我了这么低
46718,3362,伍赛,2017-01-22 08:17:09,-2,3,5,讲得还行，关键会讲习题。助教人都很好，给分良心啊！！！
51538,3362,伍赛,2017-09-18 09:00:56,1,2,1,泄题小天使。。。然而我翘课了
52940,3362,伍赛,2017-06-23 17:21:47,0,0,0,最后减分差评。\n\n颜值还可以。
54377,3362,伍赛,2017-06-29 08:24:43,0,0,0,1111
73880,3362,伍赛,2018-02-03 09:50:28,1,4,3,讲得快给分差，实验也很赶，慎选
74177,3362,伍赛,2018-02-06 04:39:36,0,1,1,美滋滋
91177,3362,伍赛,2018-12-02 15:54:55,7,12,5,除了长得还行 没有任何优点。实验要求奇葩 可以抄代码不让调库 活久见真是服气。讲课讲的云里雾里
98258,3362,伍赛,2019-01-23 08:47:30,5,7,2,讲的差，给分也差
98771,3362,伍赛,2019-01-29 09:04:30,-4,2,6,给分差，讲的差，对学生也不好。
105758,3362,伍赛,2019-04-20 05:10:08,1,2,1,讲课不像讲课，像在做talk(微笑
143672,3362,伍赛,2021-12-01 08:13:18,13,13,0,其实感觉讲得还行
148799,3362,伍赛,2022-01-13 14:37:13,13,14,1,伍老师不该这么低分，上课讲的其实很不错，至少是我这一学听下来讲得最舒服的老师了，讲的确实快，所以最后能留下很多时间复习和讲习题，分虽然还没出，但大头的40分实验都是助教给的，小测老师说了也只是点名，应该没什么给分好不好的，至少我按比例算下来50分裡只扣了不到1分，适合面向考试的人选，最后给的复习资料很足
149859,3362,伍赛,2022-01-17 10:10:12,7,7,0,其实感觉还行，讲的特别快，但是考试关键的内容也都讲到了。平时分看助教，这一届助教都挺好的
149872,3362,伍赛,2022-01-17 11:37:22,8,8,0,感觉老师上课挺温文尔雅的，助教人也都很好
150687,3362,伍赛,2022-02-12 16:35:37,3,3,0,讲的挺好的，而且老师讲完内容会带着复习。平时分看助教，期末靠自己。伍老师值得一个更高的分
166052,3362,伍赛,2023-01-11 03:12:23,0,1,1,基本可以认为不点名，用三次小测当点名，小测不计分，而且会提前通知。人帅，讲课还过得去，不过老师本人是做数据库和分布式系统的，有时候会掺杂一些私货，也还算有趣。这学期助教gg也很负责，只要实验都认真做完，\n\n期末刷一刷往年卷，分数也很不错。
166068,3362,伍赛,2023-01-11 04:28:47,3,3,0,老师人帅讲课好，很有条理也会带着复习。非常推荐
168063,3362,伍赛,2023-01-25 04:39:22,3,3,0,人帅讲课好，重要考点会讲的很详细（但上课节奏比较催眠），最后几次课会复习，实验跟别的班不一样但助教人特别特别好，给分不错，推荐。
168115,3362,伍赛,2023-01-28 15:14:06,0,0,0,111
184368,3362,伍赛,2023-12-18 09:02:13,5,5,0,OS\n\n今年三次小测当点名，没有提前通知。\n\n助教是sm和lky\n\n验收还行
188314,3362,伍赛,2024-01-18 15:22:19,2,2,0,ws讲课很清晰，可能有点偏快？但是助教真的很好，给分也很好！！！男神！！！
189015,3362,伍赛,2024-01-21 08:47:56,3,3,0,赛哥牛逼！！！\n\n助教牛逼！！！\n\nOS 满了，来磕一个！！！
189449,3362,伍赛,2024-01-24 09:26:31,7,8,1,1.给分很好，助教说只要肯做bonus就能够满平时分，但是bonus的截止日期在所有考试结束之后，因此不用担心没有时间。（但是如果不做bonus的话报告和作业事实上是会扣分的，所以别掉以轻心）。只要你肯努力，这50分你是可以拿到的\n\n2.期末考一定要做jjm班的作业和小测题，亲测有用。（至于王道，在我看来今年OS的考试并没有和王道深度绑定，如果不会大题的话可以看看真题）\n\n3.老师的讲课非常清晰，唯一缺点是有点快，今年提早4周就结束了所有的课程进入了复习阶段\n\n4.我们班是教改班，实验文档清晰，一步步教你慢慢实现操作系统，而且结合了软件和硬件，验收的时候也会问相关的问题，非常建议熟练掌握并且深刻理解，对学习非常有帮助（不止是这么课，会对riscv整个体系都有非常深的理解）。今年的助教们也非常认真负责，人也非常好。\n\n总而言之，选上的同学就偷着乐吧
210246,3362,伍赛,2025-01-08 14:12:03,2,2,0,平时分给的真的好，三次小测不提前通知（但是只要看到助教来就知道是小测了，可以消息互通）实验相较于别的班的版本低了很多，框架也清晰，但是会查重，两个助教人都很好，感觉懂的也很多，验收的时候会拷打细节（实验的框架就是他们自己改的所以他们自己清楚）但扣分不多，还会在实验报告的批改里指出你哪里实现的不足，bonus做了就能满，总体还是非常不错的，希望期末考试能有个好成绩吧！
210662,3362,伍赛,2025-01-09 14:59:32,0,0,0,出分前评一下，老师人很好，讲课能听进去，期末考试求捞求捞求捞求捞求捞求捞求捞求捞orz
211907,3362,伍赛,2025-01-13 01:36:39,3,3,0,给分的神！！
212117,3362,伍赛,2025-01-13 08:04:47,3,3,0,给分太好了，感动中国😭😭😭
212124,3362,伍赛,2025-01-13 08:26:56,2,2,0,掌管OS给分的神！！！出分后直接解散钉钉群，深藏功与名，神仙老师爱了爱了
212697,3362,伍赛,2025-01-14 13:33:53,0,0,0,老师给分不错，最后平时分掉了一分也满了\n\n\n\n但是老师不看钉钉，能不能读一下我的钉钉啊，都这么久了还未读啊（恼）
214425,3362,伍赛,2025-02-02 14:54:11,1,2,1,出分后补一下：\n\n关于点名：点名和小测事实上是一样的，小测交了就算，不用刻意追求分数，建议当成一个练习查漏补缺\n\n关于上课：是真的有点催眠。。有点语调平淡，慢条斯理？但是该讲的也会讲到，要是睡了也可以看王道视频，其实差不多我感觉\n\n关于实验：和其他班的大抵只有最后一个bonus不一样，会在学期末进行肉眼查重，就是记忆里看着特别像的会问你怎么回事。这边建议不要直接复制粘贴（至少改改变量名，删删注释吧。。）\n\n关于考试：考试特别基础，更多的是考你对概念的理解，祖传A4有用但不是万能的，和王道的拟合度一般般，大概会有那么10-20分是王道的考研历年真题。今年最后一个大题还考到了实验的东西，还是得认真做一下的\n\n\n\n可放心冲\n\n——zszm
4653,3368,首山雄,2015-06-25 15:43:24,0,0,0,外国友人令人感动
20915,3368,首山雄,2016-02-03 21:31:00,0,0,0,大法已经失效，慎选
22031,3368,首山雄,2016-03-02 06:21:22,5,5,0,大法依旧有效，选选选！
47063,3368,首山雄,2017-01-23 13:08:49,-1,0,1,没上过
47738,3368,首山雄,2017-02-22 21:25:27,1,2,1,感觉讲的不错。回答问题一定要记得站起来。。
73429,3368,首山雄,2018-02-01 14:26:17,1,1,0,谢谢爸爸
73431,3368,首山雄,2018-02-01 14:32:14,1,1,0,谢谢爸爸
73454,3368,首山雄,2018-02-01 14:49:17,-2,0,2,为什么总是被正态，难受。。。
73472,3368,首山雄,2018-02-01 15:19:00,0,0,0,老师的汇编平时还是比较水的，上课略无聊，期末要好好复习。
73874,3368,首山雄,2018-02-03 09:37:02,0,0,0,上课有点枯燥，但是最后给分意外地好
74617,3368,首山雄,2018-03-05 00:04:03,0,0,0,赞赞！
3663,3375,陈为,2015-06-17 02:07:45,3,40,37,老师上课从来只会讲好高骛远的东西，给人感觉就是上了八周概论、完全不切合实际、有大程然后半点不讲技术。最后大程验收一顿乱批。护短、实验室的学生就轻松满分……
8382,3375,陈为,2015-09-20 14:09:20,10,29,19,这个老师上课不认真好好讲课，对教学非常不认真，作业布置极度不合理，而且偏袒自己实验室的同学，fuck！
12928,3375,陈为,2015-12-24 10:46:26,8,19,11,上大学以来最讨厌的一个老师，选项目的同学想要多少分就多少分，其他同学，呵呵
14486,3375,陈为,2016-01-07 08:44:21,7,16,9,最后大程展示的时候，这老师一边玩手机一边挑刺，还经常打断问一些几秒前讲过的问题，而且估计他没看过大程，因为他连地图上标的数字都不知道什么意思。希望他快点狗带。
18596,3375,陈为,2016-01-22 06:00:45,-2,2,4,不乐观
18609,3375,陈为,2016-01-22 06:14:33,1,7,6,给分坑
18635,3375,陈为,2016-01-22 07:28:12,11,18,7,老师上课讲的都是很难很高端的可视化方案，大作业助教甩一个国际可视化竞赛的题目给刚学一个月的新手做，花了一大把时间，得了一个惨不忍睹的分数，感觉不要更酸爽。
18654,3375,陈为,2016-01-22 08:36:58,0,5,5,从头至尾，我都有一种感觉：你这只能60，不能再高了。
18662,3375,陈为,2016-11-14 14:32:32,-5,13,18,最喜欢这种给分不公平的老师了（笑
18691,3375,陈为,2016-01-22 10:30:20,13,20,7,很有特色的一门课，能学到很多最前沿的科研成果。但课上并不讲具体的实现，在做大程过程中自学了JavaScript，获益匪浅。
18737,3375,陈为,2016-01-22 12:25:33,1,5,4,讲的很美好。我自己想的也很美好。然而只是想想根本实现不了想要的效果。老师给了云没有给登云梯。大程太难对于完全没有基础的学生做不出想要的效果。给分更是呵呵哒
19096,3375,陈为,2016-01-23 08:55:25,2,5,3,老师上课只是讲一些案例跟作业大量的代码没有关系，他连大作业题目是什么都不知道大家展示的时候他也不认真听只是不停挑你的错误，对最后作业的要求特别高。总之就是别选
19500,3375,陈为,2016-01-24 11:48:42,35,44,9,老师很棒。给分视个人能力，但这不是喷点。没学过js和网页，临时自学，小作业和大程写的都很简单，但用心设计了。没加项目一样接近满绩。难道水水过给个高分才算好课？
19974,3375,陈为,2016-01-25 17:26:21,0,3,3,讲的和让我们做的完全不是一个东西。
20150,3375,陈为,2019-09-01 12:30:03,2,7,5,讲的特别好！学弟学妹想学新知识的快点来报名 受益匪浅
20999,3375,陈为,2016-02-09 07:04:41,2,8,6,其实分数一开始不是很满意，后来和猪脚聊了很久，后来分数还是可以的。老师讲的内容的确是框架性的，作业的话如果想拿分数好看一点是得花不少时间。
21005,3375,陈为,2016-02-09 12:55:22,-4,0,4,。。。
23925,3375,陈为,2016-04-21 08:33:33,1,3,2,最后分数还可以。。但是同组的同学分却很低 不知为何
45699,3375,陈为,2017-01-20 02:56:34,3,8,5,没选他的课，这种挑学生去实验室干活给满的，打心眼鄙视，我院怎么能出这样的老师
59273,3375,陈为,2017-09-20 12:05:55,1,2,1,厉害哦！
63449,3375,陈为,2017-12-12 09:21:43,8,20,12,呵呵，一个给本科生开的课自己的博士生坐满了第一排，上课时不时用极不流利的英语和自己的博士生对个话装个逼，顺便吹一下自己的博士生。自己的博士生都不知道几本出来的还好意思装逼。时不时问个问题，本科生答对了，就来一句哇你们浙大的学生什么时候这么厉害了。我真是想骂人。全身都是官僚气息，恶心得一匹。先退为敬。
63667,3375,陈为,2017-12-12 06:56:23,10,16,6,说博士生是几本的同学是清北特意跑过来听课的？毕竟浙三本渣出身没办法和您并列。为什么不先查一查别人的CV再喷呢
109723,3375,陈为,2019-06-19 01:25:49,-13,2,15,https://mp.weixin.qq.com/s/tg2x7s-c4uTWkAgtrp9lNw\n\n欢迎为陈为书记投票！
136698,3375,陈为,2021-06-23 06:49:51,1,4,3,老师人好。
180099,3375,陈为,2023-09-20 09:49:56,1,1,0,好好好
202370,3375,陈为,2024-11-12 06:39:09,4,5,1,上的是人工智能国画创新。\n\n干货满满，认真听可以学到很多东西（但我没怎么听，都在摸鱼，对不起😄）\n\n有一次展示，期末小组作业，基本上没有任何事，想科普人工智能知识的可以选，想摸鱼的也可以来选这门课。\n\n老师就用心做PPT，上课就认真念念，就这样
215170,3375,陈为,2025-02-23 12:34:50,0,1,1,上的人工智能国画传承与创新，干货满满（有国画知识科普+人工智能平台），有实践参观（去了博物馆），事极其少，无考试，给分好
215368,3375,陈为,2025-02-25 11:50:58,0,0,0,基于人工智能的国画传承与创新这门课，事少，给分好，而且是两学分的创新创业类课程，想水的放心去
6862,3414,陈天洲,2015-07-27 00:53:23,15,16,1,fat一路走好
6872,3414,陈天洲,2015-07-27 11:42:32,5,5,0,一路走好。
6876,3414,陈天洲,2015-07-28 02:59:43,3,5,2,一路走好
6938,3414,陈天洲,2015-08-21 16:57:16,3,3,0,一路走好！
23521,3414,陈天洲,2016-04-04 08:54:19,1,1,0,老师一路走好！
23524,3414,陈天洲,2016-04-04 11:50:48,1,1,0,一路走好！
32904,3414,陈天洲,2016-07-27 12:50:02,3,3,0,为人师表 忠于职守 我也要努力成为像老师这样的人！！！！ 一路走好！！！
122140,3414,陈天洲,2020-02-16 14:36:54,1,1,0,RIP
122701,3414,陈天洲,2020-03-21 08:26:33,1,1,0,RIP
136030,3414,陈天洲,2021-06-09 18:55:06,1,1,0,R.I.P.
180819,3414,陈天洲,2023-09-27 00:25:10,0,0,0,fat老师一路走好
198058,3414,陈天洲,2024-08-27 12:09:21,1,1,0,今天了解了老师的事迹，先生永垂不朽！
666,3415,金一庆,2015-03-15 11:17:25,-3,1,4,可以的哟
56085,3425,王东辉,2017-07-03 04:43:43,0,0,0,很稳 我喜欢
106368,3425,王东辉,2019-04-26 18:49:50,0,0,0,非常认真敬业的老师
106369,3425,王东辉,2019-04-26 18:54:32,0,0,0,亲如父子
117983,3425,王东辉,2019-10-17 15:37:33,1,3,2,一位实事求是，实话实说的老师。不搞虚的，不搞小心眼。良师益友，很照顾学生，相处起来亲如父子。
125645,3425,王东辉,2020-09-12 14:07:27,0,4,4,人工智能。课程本身就是念ppt，和老师没什么大关系。三个project认真做，争取把天梯榜打高一些。今年（2020）没考试，给分还可以。
139575,3425,王东辉,2021-07-17 13:25:12,3,4,1,[计算机学院 人工智能课程的 王东辉老师]\n\n上课水平：念ppt\n\n作业：AI每个班作业一样的，今年比去年多了一两个，但是都不难\n\n复习课：上课的时候还没出卷子，但是好歹划了范围\n\n\n\n平时分：有过一两次点到，应该是会看到场情况（脸熟情况）给一部分印象分
175740,3425,王东辉,2023-06-26 11:06:47,5,5,0,我愿称之为海底捞神师
221526,3425,王东辉,2025-06-24 08:20:32,0,0,0,平时分构成：6个lab，按分数前1/3，中1/3，后1/3给35，34，33分（满分35分），点名的五分应该白送，不过老师说来得多的可以加平时分（每节课都有签到）\n\n\n\n平时分应该给满了，基本上就看期末考，老师为人也是非常不错的
8691,3427,钱徽,2015-09-24 06:39:32,11,14,3,非常好
9749,3427,钱徽,2015-11-08 04:33:41,50,65,15,从来不管你来不来，听不听得懂，上课就跟他的汇编谈笑风生，我们呀，naive
10143,3427,钱徽,2015-11-17 00:26:49,2,10,8,听不懂
10259,3427,钱徽,2015-11-18 00:30:54,2,17,15,不如自学【再见
11200,3427,钱徽,2015-11-25 07:09:25,12,18,6,你们都不懂！上课很好玩！做什么都不阻拦你！自学又怎么样？说得好像有老师教楼上就个个能满绩一样。重点是做题！虽然绩点不好然而我还是给了高分。
11203,3427,钱徽,2015-11-25 07:12:52,6,6,0,人好，脾气好
11490,3427,钱徽,2015-12-02 14:35:30,6,6,0,不错，人很好
11922,3427,钱徽,2015-12-21 10:43:55,27,35,8,这个老师讲的通透，风趣人好，说他讲的不细的听不懂的预习工作没做好，他经常很精辟的几句话讲通一个知识点，作为码农给个赞
12001,3427,钱徽,2015-12-23 01:02:39,6,6,0,还可以
12161,3427,钱徽,2015-12-22 06:18:32,17,20,3,男神，比较逗比\n\n
12402,3427,钱徽,2015-12-23 07:53:38,3,3,0,内容较高级
12786,3427,钱徽,2015-12-24 04:35:49,6,8,2,上课不点名，但是无法理解他上课的节奏。
14384,3427,钱徽,2016-01-06 15:59:54,58,65,7,人很好，跟着他你可以学到好多考试不考的东西，但是你也学不到好多考试要考的东西
14494,3427,钱徽,2016-01-07 08:56:34,4,5,1,听不大懂但是老师人很好
18706,3427,钱徽,2016-01-22 11:21:31,6,6,0,潇洒。。。
20545,3427,钱徽,2018-07-08 09:08:59,15,23,8,期末出分死慢
21129,3427,钱徽,2016-02-20 09:51:44,22,22,0,每次上机课都能不去 比较爽
21131,3427,钱徽,2016-02-20 11:58:00,94,107,13,我是热评第一，钱老师现在感觉讲的好多了，不知道怎么撤评论…出分特别特别慢，但是给分特别特别好
21148,3427,钱徽,2016-02-22 07:08:04,8,9,1,上课事情少，给分超级好
21904,3427,钱徽,2016-03-01 13:43:03,12,14,2,给分好，事还少，作业直接开给你期末做完就行了，而且邮件也回的很及时
22070,3427,钱徽,2016-03-02 08:52:45,9,9,0,给分特别好，人帅
22140,3427,钱徽,2016-03-02 13:34:28,6,6,0,绝对男神好老师！
22141,3427,钱徽,2016-03-02 13:35:56,39,47,8,天呐上了许端清才知道钱徽大帝的课有多省事，事少给分好，良心老师，可惜这学期不是他的课，so sad。。。
22726,3427,钱徽,2016-03-10 07:18:53,6,6,0,给分超好，事情超少，人超帅
23467,3427,钱徽,2016-03-30 15:02:22,6,7,1,人简直太逗比了23333.只是上课节奏有些诡异。。
23599,3427,钱徽,2016-04-08 08:04:26,30,31,1,上过许端清老师和钱徽老师的课。感觉各有千秋吧。如果不打算学计算机的话，许老师的课是可以听得很懂的。而钱徽老师讲的东西才是真家伙。另，老师总喝可乐对身体不好。
23927,3427,钱徽,2016-04-21 09:36:15,8,8,0,嚼着口香糖上课哈哈哈哈哈，人很好给分好，超有码农的风格
26288,3427,钱徽,2016-06-16 14:59:25,20,22,2,事少，适合有基础的同学，讲一些很有用的东西，教你做一个优雅的码农，对学生很好，给分很好。有基础的话真的能收获很多，但是没基础的话就比较痛苦。
26525,3427,钱徽,2016-06-20 01:50:50,7,7,0,事少不点名有趣，听课很有收获，许端清儒雅，钱徽风趣实在，语速稍快不过很清楚，习惯性好评
26655,3427,钱徽,2016-06-20 15:43:41,3,3,0,好老师啊
27664,3427,钱徽,2016-07-04 00:50:40,3,8,5,c小程 c大程都满了 拯救了我的绩点 上课不点名 讲的也很靠谱 邮件也回的很及时 课下作业会给你超级充裕的时间来做 力推
28904,3427,钱徽,2016-06-29 03:07:02,5,5,0,绝对不是照PPT念，真的能学到编程
31422,3427,钱徽,2016-07-04 01:50:48,3,6,3,老师很风趣，优雅，帅。\n\n给分好哈哈哈\n\n说听不懂的都是自己的问题，钱老师讲课很好。
31446,3427,钱徽,2016-07-04 02:21:12,2,4,2,钱徽男神一生推！！！！！！！！啊啊啊啊啊啊啊！！！！！！
33496,3427,钱徽,2016-09-20 00:26:02,-3,3,6,3个字
35812,3427,钱徽,2016-11-10 08:16:23,9,9,0,特别好的老师。有水平，又不傲。分专业的时候就是为了他选了计科。
42250,3427,钱徽,2017-01-14 03:09:37,2,3,1,十分好\n\n
46988,3427,钱徽,2017-07-24 03:48:53,0,6,6,不说了，我爱他一辈子。
47135,3427,钱徽,2017-01-24 04:02:52,0,2,2,讲课幽默，有干货，给分好。
47142,3427,钱徽,2017-01-24 04:17:36,2,2,0,人很好 给分也好\n\n只是没基础不怎么听得懂
47476,3427,钱徽,2017-01-27 16:33:45,2,3,1,怎么说呢，确实学到了很多，大学的第一个编程老师，事真的很少。挺不错。
47928,3427,钱徽,2017-02-27 10:23:40,1,2,1,就是好！
49131,3427,钱徽,2017-03-27 09:10:59,0,1,1,很高端很逗很好
54458,3427,钱徽,2017-06-29 10:31:30,4,4,0,基础不好的同学真gg
55477,3427,钱徽,2017-07-01 14:52:06,5,5,0,上学期翁恺这学期钱徽，怎么说呢，借用一句话—“翁男神是会编程的老教授，钱老师是会讲课的程序员”两个老师在都讲十分的情况下，对于零基础的非计科专业学生跟翁老师能学八分，跟钱老师只能学三分。老师人超级nice洒脱，不过学期初那句“补课还不如睡觉”也是让我印象深刻。
55903,3427,钱徽,2017-07-02 15:15:19,1,2,1,老师的课…我永远听不懂，这个是因为我太菜了，但是…给分超级好，大帝啊！！
57502,3427,钱徽,2017-07-09 03:08:39,3,4,1,大帝啊，隔壁家重考的工图都出分啦，咱这..
57541,3427,钱徽,2017-07-09 12:16:28,2,3,1,给分好到哭。如果没有基础上课会比较难。但是给分真的感激涕零。
57553,3427,钱徽,2017-07-09 13:36:43,3,3,0,这里是C大程   两周一次课 上机课可以不去，事情极少，所有作业只需要在期末之前交就行了(但不要全堆期末  补天补不过来)  作业都好好做  期末刷刷往年题找感觉  能满 g。建议基础比较好的同学上   基础不好会很痛苦(上课时间本来就少  qh思维又比较跳跃)     基础差建议xdq
59619,3427,钱徽,2017-09-25 02:49:05,5,6,1,虽然听不懂，但老师好帅啊啊啊啊啊啊啊啊啊
66079,3427,钱徽,2018-01-11 11:33:35,3,3,0,好老师，渣学生
72093,3427,钱徽,2018-01-29 10:25:46,3,4,1,适合有基础的学生，拓展多，跑题远，思路跳跃，但是有基础的话会觉得开拓视野都是干货，我是没基础的，全程靠mooc，但是，绩点 太 特么感人了！！！
72096,3427,钱徽,2018-01-29 10:32:29,7,10,3,课真心听不懂。没有基础就别听了，自学吧。给分嘛，还可以吧，也没想象中那么好（卡在91分的我）
72132,3427,钱徽,2018-01-29 12:04:25,0,1,1,给分极棒
72219,3427,钱徽,2018-01-29 14:45:05,1,2,1,今天出分了给分真的真心感谢呀！虽然老师上课讲的似乎没有全弄懂，但是硬靠着钱男神的人格魅力啃下了这门课！！！一百昏一百昏！
72344,3427,钱徽,2018-01-30 02:35:09,1,3,2,老师上课不点名，事情很少，给分超级好
73599,3427,钱徽,2019-01-20 03:42:51,6,11,5,钱老师很强，拿了个满绩，谢谢钱老师
73819,3427,钱徽,2018-02-03 06:56:23,3,3,0,老师人很好啦，但是上课有点点没跟上……可能是我太菜了……
75299,3427,钱徽,2018-03-09 00:08:50,4,4,0,今年不会没关系，明年就会了
78666,3427,钱徽,2018-05-14 09:35:21,4,6,2,听完一头雾水啊，不明白在搞什么。作业还是毫无头绪。
95536,3427,钱徽,2019-01-19 14:38:27,0,1,1,巨巨巨喜欢！！天然萌！！虽然讲课不是很能让人理解吧但是自己认真就很可以～
97183,3427,钱徽,2019-01-21 23:54:16,8,10,2,每次听他“嘿嘿”都想笑，很幽默的老师
99125,3427,钱徽,2019-01-24 09:48:09,4,5,1,程设基础。上课幽默，有很多拓展，但重要的知识点如果第一次错过了可能会一直不太明白。没有大作业。
99288,3427,钱徽,2019-01-28 09:59:50,4,7,3,感觉钱老师其实很和蔼哪～考试的时候他老是来看我做题看得我特怂，老师就说了一句做得不错，没自信的孩子感觉被拯救了！老师回答我们的问题都很耐心，基本不会被怼，在群里还特别萌地使用各种捂脸和笑哭表情～就是上课没基础听不太懂，但是一学期下来不还是学会了很多嘛！ps，谢老师救我均绩；pps，楼下我真题刷了两遍，这门课均绩4啊，哪里能算绩杀
100340,3427,钱徽,2019-01-26 03:18:09,1,4,3,从不点名 超级萌的老师 哈哈哈哈 也是段子手 超爱！
101473,3427,钱徽,2019-01-28 09:11:30,2,4,2,零基础靠mooc.\n\n老师很好，但基础较差的话听的真的很痛苦。\n\n
101490,3427,钱徽,2019-01-28 09:52:46,-1,9,10,大绩杀，成功收获最大一上的最低绩点！！考前把前五年的卷子刷过一遍，考试感觉也发挥得还行。哭了。老师本来上课就很迷，给分还这样吗。千万别信给分好，那都是过去式了！！！
101498,3427,钱徽,2019-01-28 10:12:17,1,7,6,绩杀！真的大绩杀，学得很努力了，谁知道这样
101504,3427,钱徽,2019-01-28 10:17:37,19,19,0,上课听不懂，真的听不懂。
101511,3427,钱徽,2019-01-28 10:33:18,1,2,1,老师很好，是我太菜了
101514,3427,钱徽,2019-01-28 10:37:23,1,4,3,公正点说，男神上课很棒，程设没有大作业，看着室友肝别的老师的游戏制作不要太爽哦⊙∀⊙！这学期的期末呢是稍稍难了那么一点点，坑有点新有点偏，对于非计院专业的竺院同学呢可能是有点不大友好，但是有些基础题，以及第三第四大题纯粹考察逻辑的如果全对，分数不会低。至于上课听不懂这个问题，我想说老师只是带个路，coding很多时候要自己课外下功夫吧，包括但绝对不仅限于刷题和看翁老师的mooc，就算是专业的程序猿也不能指望自己在工作中一马平川不出bug，总会遇到很多问题需要自我学习解决
101533,3427,钱徽,2019-01-28 11:10:42,-32,1,33,才给我99分，差评
103670,3427,钱徽,2019-03-04 03:46:23,1,2,1,神仙老师！超级可爱很亲和，喜欢喝麦斯威的咖啡。讲东西很深入，力求将计算机内部真实的原理讲给我们听，而不是选择好理解但有所偏差的说法。虽然我是小白，刚开学时也很怕qh爸爸，但是他真的超棒！！！
103866,3427,钱徽,2019-03-06 13:20:56,2,3,1,钱徽大帝给分贼好，感觉上课对萌新不友好但是有点基础的话收获还是很大的，10分不解释。感觉好多老师都不是萌新向的，预习一下再去听课会有很大收获，比自学好
103989,3427,钱徽,2019-03-08 12:14:39,0,3,3,留作业用pta机批不好吗。。。非要提交程序然后主观评分
110325,3427,钱徽,2019-06-25 15:54:04,2,2,0,我没有资格骂老师
110365,3427,钱徽,2019-06-26 05:17:37,2,2,0,考前求大帝保佑? ? ?
110389,3427,钱徽,2019-06-26 09:00:57,3,4,1,钱徽男神，又萌又帅，谈笑风生，给分超好！！！
110813,3427,钱徽,2019-07-06 03:38:29,15,20,5,老师很好，助教哥哥也很好，但我只想说：为什么总有人要求延迟PTA？？？为什么永远无下限延迟PTA？？？那我们这些每次都按照ddl安排project时间，每次早早按时提交，如果来不及就放下其他事情或者刷夜的人算什么？？？为什么他们说延迟就延迟？？？别的课难道作业都是可以这样无底线延迟交的吗？？？延迟提交的人可不可以扣分？！请问这样对得起其他按时提交的人吗？！真的是我今天看到还有人要求延迟我就气不过，延迟一两天也是可以理解的，这都他妈猴年马月了考试周都结束了还延迟延迟，忘记提交了难道不是您自己的错么？？？考试忘记去考了难道也有补考的吗？？？那么PTA形同虚设的ddl到底有什么意义？？？如果老师总是这样无底线纵容，那学生也会变得没有底线！！！
113477,3427,钱徽,2019-07-07 17:11:15,-11,0,11,给分贼好。本学期作业靠室友大佬，一共就听过一节课，期末啥啥不会都75……
113839,3427,钱徽,2019-07-07 17:30:40,0,2,2,楼下smwy……怎么还有这样的奇葩
113881,3427,钱徽,2019-07-07 23:04:14,0,1,1,我真的觉得我期末考的很差，平时讨论课也只展示过一次没有恶竞。。。只能谢谢老师捞我！
114799,3427,钱徽,2019-07-11 22:39:03,2,3,1,上课可以用渐入佳境来形容，在不知不觉间使我一个编程渣爱上了代码。
115631,3427,钱徽,2019-08-12 12:53:00,1,1,0,很好！
116401,3427,钱徽,2019-09-10 01:47:24,-5,0,5,老师人很好，善于与同学交流。给老师10分！
117283,3427,钱徽,2019-09-22 07:55:41,3,3,0,怎么第一节课讲djj的内容，不会啊
118017,3427,钱徽,2019-10-19 00:59:19,1,2,1,讲c基础用linux给你演示。。我居然一年后才发现这个问题。。。
120598,3427,钱徽,2020-01-13 15:45:18,17,18,1,客观地来点评一下，钱老师的课对于小白来说是绝对不友好的。在一个领域了解越深的人，反而越不知道如何像初学者解释。就我身边的同学而言，大部分上钱老师课的都会对上课内容感到困惑，而想要把c小程和大程学明白，也必须在课下花出自己的努力。当然，老师人还是很棒的，捞人捞的很猛。
125286,3427,钱徽,2020-09-05 13:51:40,5,5,0,只有一句话：没基础慎选！！血的教训
126666,3427,钱徽,2020-10-12 12:04:23,17,17,0,不讲循环先讲指针的老师你爱了嘛
126902,3427,钱徽,2020-10-27 06:49:11,16,17,1,我其实很想问问那些口口声声说“只要预习就能学好”的人你们是只有这一门课吗？还是说你们一天有48个小时？老师上课不预习就听不懂难道和老师没有关系？而且讲的这么跳跃是不是要我一个周末自学成C语言大佬？？？？
128766,3427,钱徽,2020-12-25 08:06:31,4,5,1,真的对初学者太不友好了。零基础者慎选
128944,3427,钱徽,2020-12-27 10:11:03,4,6,2,他会毁了人初学者对编程的兴趣
128945,3427,钱徽,2020-12-27 10:08:32,4,4,0,初学者别选！
128947,3427,钱徽,2020-12-27 10:09:43,5,5,0,不明白为什么评分这么高，讲的课听不懂
130439,3427,钱徽,2021-01-22 10:59:58,4,4,0,老师上课真的可以将很深奥的问题说的通俗易懂。而且总有一种讲课收放自如的艺术感，赞赞赞
132570,3427,钱徽,2021-02-02 11:14:25,0,0,0,很好！
132976,3427,钱徽,2021-02-05 16:32:22,0,1,1,给分太好了吧！！！！
133642,3427,钱徽,2021-03-03 06:06:05,3,3,0,0基础初学者不要想听懂
137097,3427,钱徽,2021-07-01 05:03:07,7,7,0,但凡去了他这学期最后一节课的人都会给10分的！
137098,3427,钱徽,2021-07-01 05:03:29,0,0,0,yyds
137239,3427,钱徽,2021-07-02 13:18:38,3,3,0,永不点名怪
138853,3427,钱徽,2021-07-11 08:42:23,2,2,0,挺好的老师，不点名
138854,3427,钱徽,2021-07-11 08:56:55,1,1,0,针不戳！！钱老师我的超人！！
138855,3427,钱徽,2021-07-11 09:07:29,2,2,0,给分太多了 我觉得我不配\n\n钱徽大帝yyds
138956,3427,钱徽,2021-07-12 03:23:16,3,3,0,虽然很多听不懂，但是qh老师真的无敌幽默有趣+有水平+海底捞的老师！爱他！
143955,3427,钱徽,2021-12-14 07:30:26,5,7,2,讲课确实用心，但是毫无逻辑，讲课按照自己的理解讲，在生疏的概念一下子就过去了，让人感觉这个人莫名其妙，讲课还是很用心，但是真的讲得不好
144561,3427,钱徽,2021-12-22 09:44:13,0,0,0,个人觉得老师讲的特别好
146846,3427,钱徽,2022-01-07 15:17:27,1,1,0,钱徽老师真的是一名非常nice的老师，上课幽默风趣，课后积极答疑，讲得内容对于拓展思路也很有帮助，让你可以对计算机有一个整体的了解，知道自己为什么要学，如何去学。当然，老师给分超好也是不用多提的啦，绝对男神！
151543,3427,钱徽,2022-03-07 06:20:01,1,2,1,老师看上去竟然有点帅
158156,3427,钱徽,2022-06-27 08:22:03,3,3,0,选就完了，选钱哥不可能后悔
158213,3427,钱徽,2022-06-27 13:46:12,-51,2,53,老师很好，就是卷子太简单，一不小心就拿了100分
159025,3427,钱徽,2022-07-04 15:50:48,4,4,0,上的C程序设计专题。钱老师人超级好，能把我们不是计科的同学讲得想转码。不过感觉上课内容和平时作业难度差距有点大，作业好难呜呜呜。不过期末考试考得还是挺简单的，多刷几套历年卷，把上课的PPT看一遍就差不多了。
167800,3427,钱徽,2023-01-19 07:01:19,3,3,0,钱哥出个分吧，都进决赛圈了
169941,3427,钱徽,2023-02-28 14:20:32,4,4,0,qh！我的光！我的超人！
169951,3427,钱徽,2023-02-28 15:22:49,0,0,0,优化给分极好！也不会点名！
169952,3427,钱徽,2023-02-28 15:22:44,1,1,0,qh！我的光！我的超人！
170101,3427,钱徽,2023-03-01 11:09:02,5,5,0,神爱世人
170160,3427,钱徽,2023-03-01 16:13:11,1,2,1,钱门🙏🙏🙏
178327,3427,钱徽,2023-07-10 05:27:14,0,0,0,神 不解释 问就是无敌
181724,3427,钱徽,2023-10-30 02:11:56,1,1,0,老师很帅人很好，讲的也超级好。就是前几节课对于电脑上连个编译器都没安装的小白来说会懵逼。后面入了门就还好，目前老师作业也不多
189483,3427,钱徽,2024-01-24 23:19:52,1,1,0,首先他是真的不点名，甚至也会拿冬天上课人少来打趣hhh。现在已经是c尖的年代了（悲）然后是我个人觉得他讲课会有点快，浙江技术选考人也觉得容易跟不上（？）但是就是可以及时答疑，不懂的就去问老师或助教或ChatGPT及时跟进，同时平时作业及时答疑，那理论考那方面就没什么问题。然后是实验，如果你没有基础的话就死磕课本，我感觉难的就是在于格式化语法，就是输入输出那一块的，同时写代码要注意逻辑性，可以先在纸上用汉字写出你给代码分几块以及每一块的具体作用。然后是关于作业，不懂就问hhh，都来当c程助教了那心理素质一定很强大（给我们助教哥哥点赞www）考后会开放一个补平时分的环节，而且平常作业也不算多，老师自己评价也说自己作业应该算最少的hhh反正认真学，给分不会辜负你的努力的！
189485,3427,钱徽,2024-01-24 23:56:36,3,3,0,钱徽爷爷真是个守序善良之人，在青年最需要时拉了一把，帮了一把(๑＞ڡ＜)☆
189491,3427,钱徽,2024-01-25 03:21:12,0,0,0,真的不点名 \n\n作业也很少\n\n答疑很及时\n\n给分很不错！十分奉上
189616,3427,钱徽,2024-01-26 03:34:25,1,1,0,入门的时候比较炸裂，但是每一节课都是很认真给你讲解，答疑也很细致。\n\n人超级好！唠嗑很舒服的（bushi）是几门硬课里面最有趣的一位。\n\n给分反正不坏，绝对不亏的
194759,3427,钱徽,2024-06-25 09:25:23,0,0,0,这里是C尖。老师真的超级无敌好！作业算是老师里面最少的，上课很幽默风趣，不过对有基础的同学来说更好，没基础会有些吃力。总之钱徽大帝yyds！
200774,3427,钱徽,2024-10-22 07:11:02,2,2,0,老师讲的真的很有意思！\n\n编程这种东西感觉真的上手操作才真能学会，老师讲的更本质，而不是单纯的课本内容。\n\n真的能在学习写作业过程里体会到编程的乐趣！\n\n但有一说一，确实对刚入门来说起的略高，但还是强烈推荐选课😋
201736,3427,钱徽,2024-11-06 01:18:42,2,2,0,把期中推迟了一周，义父啊我靠！
202363,3427,钱徽,2024-11-12 05:27:47,0,0,0,钱神！无须多言
202366,3427,钱徽,2024-11-12 05:33:43,2,2,0,特别好，事少，考虑学生的感受
202367,3427,钱徽,2024-11-12 05:34:05,0,0,0,味大！无需多盐
203745,3427,钱徽,2024-11-21 02:16:04,4,4,0,课程、作业和期中考试都是可以水掉的；0基础同学是不用听课的（因为不可能听懂）；老师上课会一直用浑厚的嗓音喊“man”，很好听
213770,3427,钱徽,2025-01-19 15:25:50,1,1,0,钱徽老师捞人一绝
214166,3427,钱徽,2025-01-26 10:34:45,2,2,0,优化的神
13202,3435,干红华,2015-12-25 07:10:45,-2,12,14,还不错
13985,3435,干红华,2016-01-03 11:00:44,4,7,3,还可以
22082,3435,干红华,2016-03-02 09:44:57,3,5,2,。。。
22622,3435,干红华,2016-03-09 02:09:40,3,6,3,一般，比较无聊。
22838,3435,干红华,2016-03-13 10:21:21,3,6,3,听不懂
22913,3435,干红华,2016-03-14 15:02:20,3,8,5,对课后作业不太细心啊
23248,3435,干红华,2016-03-23 02:47:30,1,8,7,挺有趣啊，笑呵呵的
23690,3435,干红华,2016-04-12 23:51:57,11,28,17,。。。除了点到还会干什么
24835,3435,干红华,2016-05-04 02:57:22,23,93,70,讲得稀烂，感觉很不负责的样子\n\n
25442,3435,干红华,2016-05-19 08:05:08,4,7,3,别选，千万别选，否则听一次regret一次
26279,3435,干红华,2016-06-16 13:27:25,8,15,7,以为人挺好，讲的不错……结果期末就是发现该讲的啥也没讲
26586,3435,干红华,2016-06-20 08:01:48,4,12,8,真心没什么东西
26647,3435,干红华,2016-07-04 04:40:18,0,6,6,期末就编出一道，结果还上80了，感动哭了
26864,3435,干红华,2016-06-21 11:10:23,-1,5,6,我觉得还好，有点风趣
27155,3435,干红华,2016-06-23 08:26:53,3,3,0,太不负责了
28945,3435,干红华,2016-06-29 04:11:16,3,6,3,还可以\n\n
29083,3435,干红华,2016-06-29 08:22:44,9,17,8,所有ppt和书本基本一样 上课不讲原理 不操作 只读书本 每次点到 要想好好学最好还是换个.老师想活跃气氛，可惜讲的全书上，很枯燥.
29972,3435,干红华,2016-06-30 15:38:28,8,18,10,想学好还是换个老师吧：）
31427,3435,干红华,2016-07-04 01:57:10,-9,6,15,老师上课还是很容易听进去的 但是确实没有课后作业 仅靠上课是不够的 要自己课后多看书做习题 不会差的
31436,3435,干红华,2016-07-04 02:11:08,1,4,3,最重要的完全没讲，直接跳过了，上课无聊！
31453,3435,干红华,2016-07-04 02:30:50,0,7,7,还行O(∩_∩)O
31620,3435,干红华,2017-01-15 13:19:34,5,10,5,老师给分很好
33121,3435,干红华,2016-09-13 08:31:32,0,5,5,还好吧
33299,3435,干红华,2017-01-19 14:35:50,18,26,8,讲课比较沉闷，但认真学绩点还是很高的。
33819,3435,干红华,2016-09-22 02:33:41,49,64,15,老师想活跃气氛讲讲笑话，但同学实在不知道笑点在哪
34225,3435,干红华,2016-09-29 01:13:50,3,12,9,打一分是因为没有0分
34229,3435,干红华,2017-09-18 00:35:48,23,38,15,老师人挺好的，大计基自学也没问题的
34239,3435,干红华,2016-09-29 02:51:11,12,16,4,老师的笑点好奇特
34363,3435,干红华,2016-12-02 03:18:18,8,17,9,辣鸡老师，作业炒鸡多，而且上课什么都没学到。全都用来做作业了…
34453,3435,干红华,2016-10-11 02:29:33,2,6,4,为什么没有0分？？？诶给个1分吧
34526,3435,干红华,2016-10-13 00:06:57,14,36,22,这个老师一点都不好，他自己上网站的密码给我们说错了，同学们给他发邮件发信息他还很生气，在课上批评我们，说我们连网站都登不上去，不会自主学习。还说我们不知道在干什么。觉得我们问他问题烦，让我们自己解决问题。\n\n那你除了上课还会干什么？上课还上的不好，不如自己看课件。\n\n但是如果选上了也别慌，自己学也不差。
34535,3435,干红华,2017-01-19 16:17:02,4,5,1,大计机考试就是靠靠前看书背的，老师上课像是在自言自语，但你要是听的话也能学到东西，实验测试一定要做，很能拉分的，最后给分出了理论成绩就是靠这个，还有千万别翘课，想翘课也要找好人给你签到！还行啦，没那么差，多发发邮件，增进师生情！
34888,3435,干红华,2017-01-20 06:40:28,9,12,3,还好啦
34939,3435,干红华,2016-10-27 00:05:13,1,5,4,他自己懂不懂啊？讲的什么啊！可惜没有零分…………
35019,3435,干红华,2016-10-30 10:03:54,7,18,11,很水，作业超多超难，不幸预制上他课的我特别后悔没有退掉╰(‵□′)╯
35646,3435,干红华,2016-11-17 01:50:02,8,10,2,每节课点到，作业贼难，不坐第一排听不清他讲话
35770,3435,干红华,2016-11-10 08:05:42,-1,2,3,完全无语，点名倒是必点
35831,3435,干红华,2016-11-10 08:24:07,4,8,4,上课听不懂，课后作业巨多而且都不会，不能乱问最好自己解决。但是确实。。。根本不会啊，太多了而且。
36142,3435,干红华,2016-11-10 14:55:17,2,4,2,稀烂，实验作业很烦且发邮件问他他也不回，后悔没退掉他的课
36899,3435,干红华,2016-11-16 11:31:04,2,8,6,从来没听过课。因为听不懂。自学准备。上机作业难的我都不知道自己会不会用电脑了。为了做上机作业自己电脑上下了软件结果卡成96%内存被占用，之后病毒入侵电脑（我可是用了三个月的新电脑啊），花了我一百块修电脑。也许他在自己领域是专家但作为老师我认为他是不合格的。
36944,3435,干红华,2016-12-29 01:50:28,4,7,3,hhhhhhhhghh
36996,3435,干红华,2016-11-17 04:30:26,1,3,2,不想说话...一分送上
37070,3435,干红华,2016-11-17 08:33:56,1,3,2,不想听的
38021,3435,干红华,2016-11-23 07:42:07,2,3,1,??
38185,3435,干红华,2016-11-25 11:36:20,1,4,3,超级烂！作业多到爆炸?
38854,3435,干红华,2016-12-19 14:48:56,1,5,4,怎么给我预置你这傻逼的课？？？哭
38935,3435,干红华,2016-12-20 02:23:58,1,5,4,抱歉，我已经想听他的课想了一个学期了，一直没实现过
39883,3435,干红华,2016-12-28 06:02:36,8,8,0,没有词能够形容他的课水的程度
40057,3435,干红华,2017-03-01 05:59:33,9,9,0,真好，给分高\n\n
40507,3435,干红华,2017-01-04 02:14:52,-1,3,4,退了不亏
40681,3435,干红华,2017-01-05 03:25:52,9,12,3,真水，真好
42032,3435,干红华,2017-01-13 12:42:30,-11,5,16,c语言满绩路过
42631,3435,干红华,2017-01-14 15:42:34,10,13,3,认真的老师，人超级好，给分不能再棒了
42632,3435,干红华,2017-01-14 15:43:04,5,5,0,很为学生考虑，不过计院的课还得靠自学
42633,3435,干红华,2017-01-14 15:44:15,12,14,2,人很好的一个老师，虽然课程需要自学，但老师人确实很好
42637,3435,干红华,2017-01-14 15:53:00,7,10,3,非常好，选吧，不后悔
42638,3435,干红华,2017-01-14 15:53:58,9,11,2,老师人很好，助教哥哥人也很好。只不过很多需要自己看，给分也很好。
43173,3435,干红华,2017-01-16 02:27:43,3,3,0,好老师好助教
43628,3435,干红华,2017-01-16 15:55:45,4,4,0,老师人挺好的。
45460,3435,干红华,2017-01-19 14:50:09,1,1,0,讲啥不懂，作业巨多，我都完成了然后挂了，恩就这样再也不见
45465,3435,干红华,2017-01-19 14:53:15,5,5,0,培养自学能力
45490,3435,干红华,2017-01-19 15:26:53,0,3,3,老师上课水平一般，每次课必点名，秋学期作业明显多于冬学期.....秋学期的时候有种每次登陆计算机课程网站就多一个实验作业的感觉......平时上课也水水过（不知道为什么...挺难集中注意力......可能是我渣吧...），主要靠自学是真的，我没挂也没有很高分，就这样。
45510,3435,干红华,2017-01-19 15:58:16,-1,1,2,大计基真的好水好无聊，基本靠自学。上课上去电脑里签到，平常没有小测，不过实验作业是比较固定的。最后有安排答疑，老师还是挺用心的。努力还是可以拿个好绩点的。
45561,3435,干红华,2017-01-19 22:27:44,1,2,1,作业拖延忘做或者过了ddl传不上老师会通融让发他邮箱，每次只要交了哪怕你做得很水很烂平时分也会比较高，最后说一句，谢老师不挂之恩
46463,3435,干红华,2017-01-21 16:59:32,3,3,0,给分好
46970,3435,干红华,2017-01-23 06:07:48,2,2,0,很水……只要有人帮忙点到就行了。\n\n按时交作业，每次有点到，平时分基本全了，期末前背一下书，过还是挺容易的。\n\n但是真的……什么都学不到。\n\n如果选上了这门课……自学吧朋友。
47442,3435,干红华,2017-01-26 11:14:32,-1,1,2,我就笑笑不说话?
52938,3435,干红华,2017-06-23 16:36:16,5,7,2,大计基我不清楚，c程觉得自己自学能力不错的又想水的一定要选，作业巨少巨轻松，上课上机基本都可以不用去，爽的一匹
56859,3435,干红华,2017-07-05 01:28:01,4,4,0,老师人很好
56861,3435,干红华,2017-07-05 01:30:53,4,4,0,还不错，讲课给分都是。
56864,3435,干红华,2017-07-05 01:39:14,3,4,1,作业超少，事儿不多，助教哥哥很棒，给分挺好
56865,3435,干红华,2017-07-05 01:40:02,5,7,2,老师和助教真的很好呀！给分也很好。不知道大家在黑什么
56890,3435,干红华,2017-07-05 02:33:42,2,3,1,给分真的好\n\n上机重考了还有3.9
56936,3435,干红华,2017-07-05 04:02:47,2,4,2,助教和老师不是挺不错的吗，给的分数真的挺好的
58794,3435,干红华,2017-09-18 00:38:16,12,15,3,很难受 我的眼皮沾上了口香糖
60012,3435,干红华,2017-10-03 06:08:48,3,6,3,ds就冲这种ddl设在10.3的无敌行为 我给你一分
60230,3435,干红华,2017-10-14 13:19:00,11,13,2,老师都挺好的，就是ds课程的程序题作业做起来巨难，如果每天就只盯着一道编程题来研究，估计到ddl之前都不能研究个所以然来，而且还不能借鉴，全靠自己手撸，就比如让一个完全不会游泳的人直接把他扔到深水池里，要求一个小时学会游泳，这怎么可能啊？
60502,3435,干红华,2017-10-29 06:31:42,1,3,2,超级差，完全不知道在讲什么。讲的也不仔细，课后问题觉得问得简单就不耐烦，只让学生去看书，不耐心解答。还有莫名其妙的笑点，都不知道有什么好笑的。作业也布置得乱七八糟，完全不顾学生有没有听懂。
60563,3435,干红华,2017-10-24 06:36:29,1,3,2,辣鸡老师
63405,3435,干红华,2017-12-03 07:12:29,8,9,1,虽然老湿讲的差\n\n但是这个学期没有点名\n\n相对于其他班期中考也特别水\n\n就冲这一点给个好点的分数吧\n\n毕竟有些老师自己会但是讲不好\n\n其实自学上mooc挺好的\n\n姥姥和何老师讲的超清楚
63804,3435,干红华,2017-12-15 05:56:07,1,2,1,哇咔咔，想打，接着想吐，最后只能想逃
64019,3435,干红华,2017-12-20 14:09:18,1,1,0,真的，无语凝噎
64224,3435,干红华,2017-12-21 15:49:51,3,3,0,感觉他努力想让课堂生动起来，但是。。。。他真的做不到。。。我找不到笑点。。。最后还是睡觉加自学。。。
64367,3435,干红华,2017-12-23 03:36:24,2,2,0,吔屎啦
64733,3435,干红华,2017-12-27 04:02:43,10,14,4,超级棒的老师啊！讲课很仔细，每一个知识点都会好好说呢！和评论完全不一样啊！把我顶上去，让学弟学妹们看见！
66376,3435,干红华,2018-01-15 12:56:56,35,40,5,真的，老师除了讲课有点困以外其他真的很好了！特别是在DS课其他班人人自危的环境下干老师和雷助教真的跟天使一样了！！（小声说）查重只要不是100%就不给挂，互评不扣惩罚分，期中考送分，期末重开作业，真的很天使了！
69526,3435,干红华,2018-01-25 02:37:34,1,3,2,晕乎乎的，呛屎一样
69696,3435,干红华,2018-01-25 08:31:50,8,9,1,上课的人越来越少，其实大计基多半靠自己学，再刷刷题吧。其实看的还是自己，平时不会严格要求你做作业什么的，大作业也比其他老师简单，上课经常想讲冷笑话，但通常一个人笑起来
72375,3435,干红华,2018-01-30 03:58:44,9,10,1,上课可以用来自习 边自习边听课也是可以的 老师很无为 你也可以随意 只要你认真完成作业 考前多看书多刷题 成绩会很好的
72387,3435,干红华,2018-01-30 04:30:16,6,6,0,虽然旷课很多次，书没有看过，考试前突击了两天(其实大多数时间还是在追剧)，竟然没有挂，虽然绩点不高，但真心感觉老师和助教给分很好，这门课本来就是要自己背书，也不存在老师讲的好不好的问题
72389,3435,干红华,2018-01-30 04:43:53,2,2,0,考前突击\n\n原来大学考试是这样的……
72420,3435,干红华,2018-01-30 05:49:11,6,7,1,老师蛮可爱的，会在群里答疑，陪我们水群
72461,3435,干红华,2018-01-30 07:09:56,26,29,3,老师的课真的挺无聊的，考试的时候主要看书。但是在群里很亲切，会给同学答疑，有时候很可爱，发一些迷之表情包，平常作业只要认真完成，给分就很不错啊！
72472,3435,干红华,2018-01-30 07:38:15,1,1,0,大计基这门课跟老师实在是没有关系的… 全靠自己考前看书的… 但这个老师是真的好 平时分尽量都给满！！老师知道有很多人没来还是不点名！！！
72557,3435,干红华,2018-01-30 11:18:30,15,20,5,数据结构：虽然教得烂但是给分感天动地。
72561,3435,干红华,2018-01-30 11:26:18,19,24,5,我见过的给分最好的老师了…QAQ
72566,3435,干红华,2018-01-30 11:34:50,8,8,0,老师给分非常好
72585,3435,干红华,2018-01-30 12:44:29,8,9,1,大计基就是自学，老师上课不强制你听也不会点名。作业相对其他老师来说真的是又少又轻松，对时间也没有太多要求，认真完成就好。能感觉出来老师讲课时很努力很认真，虽然可能确实是听不不进。老师平时经常会在群里解答疑问，有什么事给老师发邮件老师回复也很快。最后考试我是只花了三个小时看了两套15年模拟题，也没挂。感觉如果能把书看一遍，模拟题做一遍，拿到高分还是轻轻松松的。说句实话比起其他科目的老师，干老师评分低可能是他讲课风格不合大家胃口，不过老师真的很棒，给分也很好。
72684,3435,干红华,2018-01-31 01:11:36,6,6,0,数据结构给分真的好！！助教也很nice！
72688,3435,干红华,2018-01-31 01:36:48,8,8,0,迷幻，给分贼好?
72720,3435,干红华,2018-01-31 03:20:38,8,8,0,给分贼好 ds这门课 老师虽然讲的真的不咋的 还是自己看书刷ppt比较靠谱 全程无点名无小测 助教project总评给分水 期中考试水 基本很完美了
74418,3435,干红华,2018-02-20 10:52:16,0,1,1,。。。。
74882,3435,干红华,2018-03-06 08:09:07,-4,2,6,很渣很不负责的老师
75252,3435,干红华,2018-03-08 07:20:28,1,3,2,这人不适合当老师
78586,3435,干红华,2018-05-13 13:06:45,-9,1,10,这狗人，呵呵，当初后悔没退了他的课
80915,3435,干红华,2018-07-02 16:05:38,-5,2,7,我能说什么，混子老师
81254,3435,干红华,2018-07-04 12:44:17,10,10,0,送给17级及以后计院学弟学妹的忠告：DS请首选GHH，跟分贼好，班级均绩大概能比隔壁zjk和cy等等班高0.5以上，期中考送分作业会重开等等一堆福利。所以讲得咋样请忽略吧(虽然ds本来就水水的 自己看PPT就行
84684,3435,干红华,2018-07-13 14:11:31,2,2,0,别的不管，老师和助教人很好
84765,3435,干红华,2018-07-13 23:29:35,6,6,0,老师给分真的超级好啊～老师和助教人也特别好，c程基本都是靠自学了，虽然老师上课就是按照书和ppt，但看得出来老师真的很努力的想活跃课堂的气氛。真的特别感谢老师～
85060,3435,干红华,2018-07-15 07:48:02,8,8,0,平心而论，阿干老师很不错(*๓´╰╯`๓)♡
86513,3435,干红华,2018-09-17 03:23:01,-3,1,4,我的天，他到底在讲什么，读课本不好吗，做什么PPT……笑点奇低，感觉崩溃，声音模糊不清
87549,3435,干红华,2018-10-04 08:58:59,-2,1,3,宝宝想哭
87815,3435,干红华,2018-10-15 02:43:39,-3,1,4,老师让我对大计基感到深深的绝望
88418,3435,干红华,2018-10-30 13:01:11,-4,0,4,上课太无趣了，PPT和书本内容基本一样，作业还贼多，老师也很不负责。呵呵哒。
88648,3435,干红华,2018-11-05 03:33:25,0,3,3,拖堂 我死了
88654,3435,干红华,2018-11-05 04:23:41,-7,1,8,巨无聊，把大计基当计算机的专业课上。自己讲得开心了，有考虑过大一新生的云里雾里感受吗？非常后悔没有换课
88901,3435,干红华,2018-11-12 03:20:38,-11,2,13,垃圾老师，不负责又没能力是怎么在浙大舔着脸混下去的？
90704,3435,干红华,2018-11-25 10:38:10,-2,1,3,我只想说助教极不负责任，平时在群里有人艾特他问问题从来就没出现过。就想问问这样的助教要他何用？
91506,3435,干红华,2018-12-12 04:37:09,92,101,9,干老师以前是软件学院副院长，2015年一次事件后便被免职，干老师其实是政治斗争的牺牲品，我挺他。
92176,3435,干红华,2018-12-27 02:40:06,19,20,1,上的大计基，平时上课基本miu听。但是事情和室友相比少很多呀！听说大计基不用上课，期末刷题就行啦。如果是想水一水的大家，选阿干完全没问题
92484,3435,干红华,2018-12-30 07:45:03,-10,2,12,稀烂稀烂
93797,3435,干红华,2019-01-14 00:11:43,4,4,0,数据结构基础。老师人真挺好的，除了上课讲的很无聊，但这种课不都是自己学吗？  期中考试对我们也特别好，点名还提前在群里说一下。
93819,3435,干红华,2019-01-14 02:18:45,7,7,0,老师挺好哒!事少平时分给的好，而且人也蛮好的，挺负责的，并且不点名...
95984,3435,干红华,2019-01-20 10:17:39,14,14,0,老师人真的挺好的，虽然我不怎么听，无法评价讲的怎么样，但是人很好，作业只要上交了没有太大的问题都会给满分，刚开学的时候有两个作业迟交了他也只是扣了五分，有同学思科考试做错了少了15分平时分他还给了机会补交，真的超级棒啊，处处都为了我们着想。看前面的评价说他讲的不好，但是大计基这种课考试基本靠背诵的，老师能做到这个地步已经不错了，给老师点个赞！
96054,3435,干红华,2019-01-20 12:05:25,6,6,0,老师人超好，很有耐心。
96290,3435,干红华,2019-01-20 16:32:28,19,23,4,老师真的很好很负责！在群里提的问题都会耐心解答，有同学忘交作业还会提醒，期末作业很多人错过时间还会想办法尽量让每个人平时分都拿满，真的超级棒了！虽然我上课不听...但是还是要给老师好评。出分前保佑一下吧！！！
98966,3435,干红华,2019-01-24 06:01:51,2,2,0,老师人挺好的，讲课虽然有点无聊，但是给分是真的好
98992,3435,干红华,2019-01-24 06:32:45,0,1,1,老师虽然讲的可能比较枯燥，但是给分和助教是真的很好！不过DS这类课基本也是自学。
99891,3435,干红华,2019-01-25 09:11:35,7,7,0,最后给分真的很宽容啊。
99917,3435,干红华,2019-01-25 09:43:41,5,5,0,平时分给得很好
100380,3435,干红华,2019-01-26 04:12:34,6,6,0,老师很可爱很可爱！一开始和我们说大计基交作业的我有话说是看不到的，然后我放飞自我写了一堆以后，在群里老师讲这个作业出现的问题，我就问老师我有没有问题，老师说“你不是都撒花了吗/可爱”啊原来能看到啊！给分真的好的不行，强推阿干的大计基！
100541,3435,干红华,2019-01-26 09:16:54,6,6,0,大计基不点名，作业比室友少很多，作业不难，按时交按要求做就能拿满分，有问题在微信里或是邮件里都会回答，尤其是考试周，感觉很负责任。会提醒没交作业的同学，给我们延长计科练习时间，给分浓浓师生情，给阿干疯狂打call！！！
100552,3435,干红华,2019-01-26 09:37:48,-11,4,15,老师人不错，最后给分只能说一般了。感觉群里经常舔的人分都很高呢: )
100558,3435,干红华,2019-01-26 09:48:30,9,9,0,老师真的很好，很可爱，平时作业只要做了都能拿满分，并且老师还会在群上提醒不交作业的同学。当同学错过思科考试后，老师还会给补救机会。这样负责的老师真的让人很感动，我也很庆幸当初没有因为查老师上的评分而退课，和老师说一声谢谢?
100559,3435,干红华,2019-01-26 09:48:37,9,9,0,其实老师是挺好的 怎么说呢 大计基大多靠自学 老师第一节课说不点名是因为查老师上有人骂他还觉得挺心酸的  老师人很好啊作业晚交会提醒 平时实验作业也不多  最后一节课还说此日一别不知何时才能想见之类很搞笑的话?
100569,3435,干红华,2019-01-26 10:20:05,4,4,0,挺好的，不解释，也绝对不夸张
100584,3435,干红华,2019-01-26 10:59:54,3,4,1,老师给分太好了 老师也很负责
100592,3435,干红华,2019-01-26 11:13:32,4,4,0,老师人蛮好的，会延长练习时间，平时分基本上都是满分，最后成绩也不错
100624,3435,干红华,2019-01-26 12:40:22,4,5,1,接上一条，但是我心里面有数，知道自己没有好好复习，可能也只是踩线。老师已经如此宽容了，还不从自己的身上找原因，反而diss我们在群里舔，老师教了我们一学期，感谢老师就叫舔，活该你分低。
100635,3435,干红华,2019-01-26 12:57:10,5,5,0,超感动了 老师认真的好给分也好 说大计基无聊的我不反对 但这种课真的是自学的
100675,3435,干红华,2019-01-26 14:26:38,3,4,1,老师太太太太太可爱了。
100770,3435,干红华,2019-01-26 23:22:54,5,5,0,老师很可爱，我遇到的和学生互动最多的老师之一，谢谢老师
100857,3435,干红华,2019-01-27 03:12:22,10,10,0,人挺好的叭，“我先买个菜，然后再检查一遍就去把成绩上传了”，有点可爱。然后，个人觉得，计基这门课本来就是要自学的吧
101556,3435,干红华,2019-01-28 12:17:34,7,7,0,老师人很好，会尽量帮我们把平时分点满，和蔼可亲? 上课真的无聊，只能自学了。我的绩点真的不咋地，不过本文科生心里有数自己什么水平，大计基这种能过我就谢天谢地了，要不是老师平时分点满我肯定更低。。。谢谢老师两个学期的上课了。
101685,3435,干红华,2019-01-29 01:05:59,23,28,5,干老师人超级超级好的，不知道评论里骂老师的脑瓜子是怎么长的，从不点名，作业少，事少，给分好，平时和同学们在群里互动解决问题，负责认真贴心，而且很幽默搞笑，老师真的好。还会买菜。\n\n
101834,3435,干红华,2019-01-29 08:39:31,5,5,0,除了教学以外，老师人真的非常非常非常好！给分最好的大计基老师没有之一！但是给分多好讲的就有多水……自行斟酌吧。爱恨交加的阿干呀
102700,3435,干红华,2019-02-21 08:52:25,96,109,13,干红华老师，微信昵称：阿干，对同学十分亲切，上课认真，总是为着学生着想。已ppt的形式教学，时常用时事举例，分享自身经验，说话有一点口音但无伤大雅。虽然有教学热情，但是授课的内容和节奏会让人很难专注于他的上课内容，索性同学上课就做各自的是，算微积分等等。不过这门课的考试只要好好读课本就可以的高分，建议喜欢自己读课本的同学可以选干红华老师的课。\n\n	再来说说干红华老师一个令我印象深刻的一点是，他非常希望同学都可以让他平时给满分，比如课堂唯一的一次点名，点名前的两个星期就再三强调，还可以时后补签。。。第二是作业的给分，作业的期限一般是两三个星期很长，时常提醒同学，只要有交，十分里用三四分的努力就有满分，迟交不管多久，只扣五分。有人会说他作业很多，但是其实不用花太多的心力就可以拿分。\n\n	最后是在期末考试前，他对于未交作业的同学们至少都提醒了五次，之后还一个一个的在微信群里点名询问，对于一些期限到了却还是没交作业的同学，他还在布置了其他的作业，就是希望同学们都有作业分，阿干老师大概是我见过最有耐心的老师了吧。\n\n       *******结论：适合上课爱作自己的事，可以自己读课本的同学。作业可能量比较大，但是凑合着写，不用认真，最后阿干老师都会给你好看的平时成绩。这门课拿高分的重点是最后的期末考试。\n\n*******喜欢就帮忙顶上去！！！\n\n
103427,3435,干红华,2019-02-28 05:19:46,10,11,1,平时懒得评论，但是干老师有个点十分感动我，所以想多说几句。\n\n大一修的时候是一个比干老师评分高的老师，但是我挂了；上学期上干老师课，绩点4.2。两种情况都是没怎么听课。。\n\n经过和大一的老师对比，干老师真的是作业少，简单，认真负责了。大一的老师真的是只管布置作业，而且只在课堂上布置，也不建群，很多同学经常错过作业，他也从来不会提醒。但是干老师一遍又一遍提醒。在群里通知了，还会通知到个人。真的觉得太宽容了，宽容到我都觉得是对学生的纵容。\n\n最后，个人觉得大计基绩点如何绝对不是有些同学说的舔不舔的，完全看你自己学的怎么样，作业有没有做。我期末复习，背了两遍课本，没看ppt，所以有的知识点漏掉了，期末考得一般，但是作业都及时交了，老师给分是公正的，请有些同学不要颠倒黑白！！！
105653,3435,干红华,2019-04-18 02:28:48,0,1,1,助教超级辣鸡，群里问问题从来不回答！
110266,3435,干红华,2019-06-25 08:17:53,0,3,3,老师讲课海星，但可能是因为是夏天的下午，当我期末面对满屏不会做的题，最后出来4.5时，我只能说，大家上课比我努力大概就能满了！老师很亲切，同学的问题也不会忽视。
111125,3435,干红华,2019-06-30 03:27:25,10,10,0,虽然评分不是很高，但没有想象中那么差。上课讲的内容不太注重编程的具体操作，更多的会讲一些原理的东西。个人觉得可以接受，毕竟都说c程是自学，所以也没指望能在课上学到很多编程经验方面的东西（当然有是最好的）。期末的时候会很耐心地在群里给大家答疑，总体感觉是个负责的老师，和室友交流以后，感觉和某些高分老师比起来也不差的。
111160,3435,干红华,2019-06-30 06:29:53,4,4,0,感觉还不错的
112415,3435,干红华,2019-07-05 17:19:06,10,10,0,本来以为要挂了，结果老师给了我3.6，给分真的超级好！！
112508,3435,干红华,2019-07-04 15:48:19,18,20,2,干老师真的是特别有亲和力的老师，给分超级好，期末海底捞，讲课水平可能确实不是那么的棒，每次去的时候，教室的人不到30，翘了一大半，挺同情老师的，但是即便是这样，老师上课也没有敷衍，感受得到老师一直在很努力想把课上好，平时作业没做完的，临近期末也会重新开放，平时分尽量给满，该给高分也从不含糊，希望大家不要因为查老师分数和上课水平随意的翘课吧，尊重老师的付出
112716,3435,干红华,2019-07-05 01:04:56,9,9,0,干老师讲课觉得挺好，课下问问题绝对耐心，对待学生态度谦和。平时在pta上布置的习题一定要做，一定要做，一定要做，重要的事情说三遍，否则期末编程就算运气好碰到很基础的题目也没辙。最后强调一点，老师给分好·真。
112977,3435,干红华,2019-07-05 17:12:04,9,9,0,给分巨好！我期末理论考54分结果给了我3.3！
112997,3435,干红华,2019-07-05 17:21:03,6,6,0,老师让我喜欢的不是讲课的水平，而是传授知识的态度
113066,3435,干红华,2019-07-05 22:20:28,6,6,0,给分超棒！在群里自称阿干
113072,3435,干红华,2019-07-05 22:34:05,14,16,2,这么说吧，期末上机理论考了31老师给了68，天，永远感激
113132,3435,干红华,2019-07-06 00:07:11,3,4,1,给分是真的好！永远爱干老师！
113145,3435,干红华,2019-07-06 00:19:52,7,7,0,自学给分好
113148,3435,干红华,2019-07-06 00:27:57,4,4,0,老师人很好，上课讲课比较轻松，课下作业很少，也没有小测，不点名，c程课的成绩主要是看自己练习，老师给分也很公平，很喜欢这个老师。
113176,3435,干红华,2019-07-06 01:08:31,4,4,0,虽然没怎么听过老师讲课但是他没给我挂真的是这个期末最开心的事情了！！！
113208,3435,干红华,2019-07-06 01:36:16,7,7,0,老师太可爱了吧！微信群里没认真看还以为是助教xgg！不明白为什么之前评分不高？不多说了，给10分！兄弟们，把我顶上去！
113269,3435,干红华,2019-07-06 03:28:36,4,4,0,浓浓师生情
113278,3435,干红华,2019-07-06 03:35:14,5,5,0,阿干，真棒，平时上课随和，作业pta，考试感觉挂了，结果拿了70多，激动的从床上跳起来了，感谢老师！！！！
113281,3435,干红华,2019-07-06 03:45:37,7,7,0,圣雄干帝！！！给分超好
113295,3435,干红华,2019-07-06 04:35:47,4,4,0,c程讲得很细致负责，也有逻辑性，但是可能稍显枯燥。老师人很好，会在群里解答同学们的问题，非常耐心，给分也很好。高赞的几个评论感觉都有点偏颇，也许是老师这两年变得更好了吧。不过还是要记住，想学好c程，自己还是要努力，哪个老师都不可能百分百保证把你教会。
116174,3435,干红华,2019-09-05 13:37:56,0,1,1,中规中矩，ds虽然教的不咋的但是pta牛逼啊，给分很好！老师人真的很好！ps：我不仅喜欢干?老师??‍?还喜欢干老师的猪脚?
116783,3435,干红华,2019-09-15 23:56:35,0,0,0,还可以
122057,3435,干红华,2020-02-08 12:20:58,3,3,0,讲课一般，事少不点名，给分却是极好，给10分。
124025,3435,干红华,2020-06-21 02:06:23,2,2,0,课真的超级水...但是给分真的超级超级好 谢谢老师惹
125740,3435,干红华,2020-09-14 01:10:48,2,2,0,今天刚上了一节课，加上看了学长学姐们的评论，感觉真不错
126255,3435,干红华,2020-09-21 03:30:37,2,2,0,压堂王
126379,3435,干红华,2020-09-24 11:12:45,0,0,0,讲课真的无聊，没有什么干货
131819,3435,干红华,2021-01-29 04:16:14,1,1,0,课很水，事情少，讲的一般般，但是给分特别特别好
132492,3435,干红华,2021-02-02 03:23:32,5,5,0,老师人挺和蔼的，不过上课内容，作业内容，考试内容这三者没有什么关系，我全靠期末三天补天，效果还可以，绩点4.5。
132812,3435,干红华,2021-02-03 23:37:35,1,1,0,讲课比较无聊，但是事情相对比较少，给分也不错的
133032,3435,干红华,2021-02-06 16:44:15,6,6,0,老师人挺和蔼的，是少有的作业和期末考试内容几乎没有关系的老师，不过确实能在平时作业中练习一些技能（word，ppt，Access），我全靠期末两天半补天，效果还可以，绩点4.5，不过被卡绩了。助教解释问题很负责！
137065,3435,干红华,2021-06-30 08:08:22,5,5,0,求捞，老师上课有点枯燥，但人超好
138381,3435,干红华,2021-07-08 23:38:05,0,1,1,后悔选了干老师的大计基。。。目前最低绩点。。虽然老师事少不点名但是真的没有什么干货啊都要靠自学
139311,3435,干红华,2021-07-14 08:32:17,5,5,0,干老师太会捞了！感动！！！老师人真的很好，平时上课从不点名，快到期末还可以让大家补交作业，上课可能确实有些无聊但知识点都会涉及的，是个负责任的好老师！给阿干十分！（PS：上的是Python课）
139313,3435,干红华,2021-07-14 08:43:48,4,4,0,干老师！！！我永远的神！python真的绝了啊！！！！很会捞太牛了！！！选他！！而且老师上课特别可爱，经常讲点儿特别冷的好玩的事！
139315,3435,干红华,2021-07-14 08:57:16,3,3,0,干红华牛逼，打在公屏上
139834,3435,干红华,2021-07-30 15:17:07,3,4,1,python海底捞！！！选他！上课不点名事也少，和蔼！太感谢了
145029,3435,干红华,2021-12-26 17:20:03,-1,0,1,真的很赞，浓浓师生情
147282,3435,干红华,2022-01-09 11:14:46,2,2,0,（选的数据结构基础）\n\n老师人很好很可爱！\n\n不点名；project开放时间长，补交机会多；只有一次期中，没有小测。\n\n讲课的话没有听过…但是考前看ppt+做历年卷，最后成绩还不错。\n\n总体感觉事少分高而且查重不严，冲冲冲！
147377,3435,干红华,2022-01-10 01:07:52,-6,1,7,ds不多说了\n\n助教很好\n\n老师很耐心\n\n满绩飘过
147553,3435,干红华,2022-01-10 08:14:49,1,1,0,数据结构基础，ghh老师和lzx助教给的ddl相比于其他班级非常友好，让我们有很多安排时间的自由。给分也很不错，project认真写，作业认真做，平时分都满了。上课不点名不小测，一点也不卷，很好，点赞！
147934,3435,干红华,2022-01-11 07:37:36,-4,0,4,绝对的良心老师！ddl给的很宽，还会看完成情况往后调。不小测不点名。讲课就是照着ppt讲，拓展的东西不多，但也讲清楚了，而且ds主要就是靠自己学和练习吧。必须满分！
148974,3435,干红华,2022-01-14 05:31:40,0,1,1,上课虽然听不懂，但是没关系!老师很会捞人!考前我还一直担心会挂，结果绩点上4了!超级好的老师!
149034,3435,干红华,2022-01-14 07:39:39,0,1,1,从不点名，但是被正太了有点难过
149431,3435,干红华,2022-01-15 10:03:24,-3,1,4,确实海底捞
150896,3435,干红华,2022-02-21 02:05:47,2,4,2,上课没重点，很困，但是事少不管你上课干嘛，会捞，会捞到上了朵朵十大
150932,3435,干红华,2022-02-21 06:51:13,0,1,1,感谢阿干饶我狗命qwq\n\n(差点被互评干碎
151133,3435,干红华,2022-02-23 09:46:42,8,8,0,Python，每周上机不用去，赞
154125,3435,干红华,2022-05-24 04:26:42,2,6,4,建议大家不要当面问他任何问题，包括学习上的问题和考试上遇到的各种登录问题。可能是老师性格原因，对话的时候语气很冲。但老师是好老师，诶嘿。
157538,3435,干红华,2022-06-23 16:06:38,-10,2,12,事少分高
158709,3435,干红华,2022-07-01 13:35:31,12,17,5,讲的又烂，给分还不好。期末理论90小测几乎满了最后总评84
158717,3435,干红华,2022-07-01 14:19:56,12,20,8,本学期大绩杀
158722,3435,干红华,2022-07-01 14:32:26,18,22,4,讲的差还绩杀无语了
158723,3435,干红华,2022-07-01 14:35:24,16,18,2,真的有捞吗。。。
158725,3435,干红华,2022-07-04 07:41:57,-13,5,18,1.讲课：两节课的话我跟得上一节，老师讲得没有很吸引人所以听了一会后我就做作业去了或者走神，但期末补天的时候发现还是上课听一下比较好。\n\n2.作业：其实作业量平行班应该是一致的，不过老师倾向于把所有的编程题摞到一起布置，会造成量很大的感觉。\n\n3.小测：老师的小测比较特别，两次纯理论两次纯编程。纯编程题是为了防止大家期末的时候一道编程题也做不出来被斩杀。\n\n4.给分：我属于懒得把平时作业细致改得全对的那种，但编程题会努力编出来，可能这一块没有什么优势；最后期末的测试理论部分提交后我看到的是90，但应该统一调分了，会有一些优惠，试验题我只做出了简单的那一道。这样下来最后给分上四。
158733,3435,干红华,2022-07-01 15:31:49,8,11,3,讲课含金量不高，考试也不捞，甚至平时分能拉低考试分的，我只能说快润
158735,3435,干红华,2022-07-01 15:51:48,4,4,0,太逊了
158756,3435,干红华,2022-07-02 01:52:51,16,19,3,不如自学
158770,3435,干红华,2022-07-02 03:05:30,6,10,4,总评比期末卷面低10分是什么鬼？
158780,3435,干红华,2022-07-02 05:41:06,6,8,2,怎么说呢 就挺无奈的 期末理论93 编程一道 平时小测大概也是中上水平，结果总评也就84 连个4都没有 被狠狠杀了 哎 无奈
158857,3435,干红华,2022-07-02 23:20:24,6,6,0,感觉老师给分挺迷惑的，而且没公布平时成绩
159010,3435,干红华,2022-07-04 12:46:50,0,4,4,全靠自学。按照所谓的评分准则来，分数一样低。真不知道怎么才能高。
159304,3435,干红华,2022-07-11 14:09:02,7,13,6,讲得差，事多，给分差。
160530,3435,干红华,2022-09-26 03:27:42,-3,1,4,干老师挺好的，上课挺自由的，就是容易困。\n\n作业也挺合理的，虽然我还没开始写😀😀
166279,3435,干红华,2023-01-11 16:20:33,-3,0,3,事情不多，平时分给分不错，就是课由于时间原因太容易犯困。
166309,3435,干红华,2023-01-12 01:58:39,-9,1,10,除了上课确实讲得一般，干老师真的好，没小测，事情少，而且最后还超级能捞。
166311,3435,干红华,2023-01-12 02:09:37,-5,1,6,老师给分相当好，bonus和提高组都有加分，期中期末砸了也能拿到比较可观的分数。
166564,3435,干红华,2023-01-13 00:26:38,-5,1,6,老师人真的很好很温和，fds给分也很不错
167605,3435,干红华,2023-01-17 15:11:37,5,5,0,。。。
167608,3435,干红华,2023-01-17 15:26:57,7,8,1,什么绩杀，见鬼。。。
167667,3435,干红华,2023-01-18 07:42:22,3,6,3,阿干真的是海底捞呜呜，干爹真的是我干爹。本来担心djj要挂科的，被捞上来辣。上课有点无聊，pta作业确实耗时间，小测有点多…但是老师真的人很好，很和蔼，可以的！
167686,3435,干红华,2023-01-18 09:52:56,-2,2,4,坐标ds。讲课一般；平时分给得挺好的，但不能溢出；助教带得班级互评风气很好。
169128,3435,干红华,2023-02-24 11:37:03,5,5,0,为什么不捞一捞呢
170092,3435,干红华,2023-03-01 10:38:47,4,6,2,大计基靠着自己的基础绩点上了4，还算满意\n\n大计基讲的真不太行，也有可能是本身课程改革带来的设计上的普遍问题，大家都觉得大计基教的不明所以，这估计也不完全是他教学的问题\n\n不过干老师似乎默认大家都有比较好的计算机基础，有时候回答同学问题会带着一种“这么简单都不知道啊”的态度，小测没考好的同学他会直接当堂把名字放出来，可能不是所有人都接受
172370,3435,干红华,2023-04-25 12:26:14,9,10,1,作业超级多，每次编程题都是二三十道题，甚至会冲掉一部分你学微积分的时间。期中考编程题难度很大，几乎一道都做不出来，中途直接弃修了，感觉他有点瞧不起文科生，还说什么学生的智力一届不如一届，阴阳怪气的无语了。
172373,3435,干红华,2023-04-25 13:24:03,9,9,0,这学期提前三天通知期中考，很多班都是五一放假回来考或者根本不考，还考根本没讲过的四道编程题，吐了，一生雷
173364,3435,干红华,2023-05-21 08:36:16,8,8,0,byd布置那么多作业
173407,3435,干红华,2023-05-23 11:35:13,7,7,0,课还没开始讲就布置一大堆作业，作业里的知识点有些课上也不讲，这Python上不了一点
173408,3435,干红华,2023-05-23 11:38:17,4,5,1,tmd什么垃圾
175355,3435,干红华,2023-06-24 07:05:39,2,5,3,给分一般，但是人挺好的
177366,3435,干红华,2023-07-03 04:50:33,13,14,1,python 事情属你最多 给分属你最差
177397,3435,干红华,2023-07-03 06:34:03,2,3,1,这学期上了干老师的Python，干老师人是挺好的，笑容很和蔼（憨厚）\n\n缺点是上课有点口齿不清，小测非常突然且难度较大\n\n不过我自认为学的很烂最后3.6，有点运气在吧\n\n大佬可放心选
177665,3435,干红华,2023-07-04 06:26:37,7,8,1,头回见，实验做对一道，理论过斩杀线甚至挺高，但是因为平时成绩太低，看在我毕业班的份上给我挂了，什么啥比？别的老师都是巴不得你过，他巴不得你挂，根本不调分，666
178145,3435,干红华,2023-07-07 07:12:19,7,7,0,python，上课听不了一点，作业两周一章，小测非常突然，几乎没有准备时间。给分相对客观所以大佬无所谓，但总体不推荐选
178576,3435,干红华,2023-07-15 06:51:50,-2,5,7,python，怎么说，其实干爹小测还是挺放水的，但大概总分是按比例的算不怎么调。平时小测+期末（磕头感谢题目不难）都还可以，虽然实验题只写出一道，最后得分也很不错（甚至比我苦逼专业课还高，，，）感恩的心。\n\n&讲课实在是难评，建议是自学比较好，PTA写写就懂了（）
181371,3435,干红华,2023-10-16 04:35:35,7,12,5,外交部每年就一次宣讲会，不允许录音录像，不允许缺勤；您的课可以回放，而且没有测验，完全不耽误；可您却认为外国语学院的学生请假参加外交部宣讲会是本末倒置，是在浪费时间？unbelievable。。大二就遴选了，到那时候再做准备，黄花菜都凉了吧！
181492,3435,干红华,2023-10-19 07:28:41,9,10,1,大计基和Python都是ggh，两门课都是事多课烂给分差，小测难作业多考试不调分，默认学生计算机基础都很好还会课上公布成绩公开处刑，非大佬别选。
181716,3435,干红华,2023-10-29 13:32:49,23,27,4,python来的。\n\n怎么说呢。。。感觉老师讲课也没有评论里说得那么不好，还是可以听下去的\n\n但是老师给分是真的不怎么样，平时分感觉给的非常低，反正我上机一道期末84最后3.3.。。别的班比我期末分数低十几分的总评比我高。就因为这门课我直接错失果酱，我不好说。。。
185151,3435,干红华,2023-12-27 00:16:49,2,3,1,快跑，，
187679,3435,干红华,2024-01-17 05:34:43,0,7,7,非常非常好的老师，很多评价都有失偏颇。fds虽然上课听课的人不多，但是老师很努力地讲好讲清楚每一个知识点。无论是作业还是project还是期中考试都绝对不会为难大家，非常考虑学生的想法，和他交流讨论问题的时候超级耐心和蔼。\n\n这学期上fds遇见干老师就是我的幸运！
187867,3435,干红华,2024-01-17 15:30:38,1,2,1,project做hard居然不能加在总分里 就他不行 上课一般般
187901,3435,干红华,2024-01-17 17:35:50,0,2,2,老师很好，但fds的project作业选hard模式的加分算在平时分里，平时分又不能溢出60分（本来大部分人就有接近60的），一学期拼死拼活写hard这5分到头来是一点用也没有。选了这个老师就轻轻松松写normal吧，省时省心，hard一点用也没有。早知道不加总评，加平时分里，才不去做hard呢！现在想想我为求导计算器熬的夜，就像一个笑话！
188207,3435,干红华,2024-01-18 11:45:11,2,3,1,快跑！！！出分前给老师打了一个10分，出分后才发现只有他project的加分不溢出到总评，而且开学第一节课的时候并不是这样说的，有点难过。
189198,3435,干红华,2024-01-22 10:08:03,4,4,0,不懂，总评比期末成绩低很多，还卡我绩点。当初选课就应该听前辈话，讲课还默认你有基础，整个课堂感觉没人听您讲课 真幽默。
189548,3435,干红华,2024-01-25 10:42:15,3,4,1,他的所有课程都不会调分哦，总评各项相加，多少就是多少
190039,3435,干红华,2024-02-13 05:48:18,3,4,1,老师人是好人，可以感觉到知识储备很丰富，但是讲得烂，给分也烂，踩雷了。
190995,3435,干红华,2024-03-27 15:54:14,-10,2,12,彼阳若至，初升东曦。\n\n\n\n绯雾飒蔽，似幕绡绸。\n\n\n\n彼阳篝碧，雾霂涧滁。\n\n\n\n赤石冬溪，似玛瑙潭。\n\n\n\n彼阳晚意，暖梦似乐。\n\n\n\n寐游浮沐，若雉飞舞。\n\n不调分的byd，fds真是一坨，上课几乎啥也不讲，下课出内个题？真把所有人当OI药娘了？每当做bydProject和作业，为了一堆grd没有任何意义的英文和充满傲慢的龟腚熬夜时，我都会怀念牛棚。你欠牛棚了。
193829,3435,干红华,2024-06-20 03:23:02,1,2,1,不调分，很求是，不捞人
194392,3435,干红华,2024-06-23 15:14:40,8,9,1,老师真的很好，数字点名写黑板伟大无需多言
195002,3435,干红华,2024-06-26 08:05:27,0,2,2,纯莎壁好吧，我认真学了期中和期末都在90分左右，期末总评88，你还卡我绩点？？隔壁班期中50期末70的绩点都给到4.5了。你给分不好就算了，为什么您讲课还是依托答辩呢？？？
195878,3435,干红华,2024-06-30 13:45:27,3,4,1,周一早八python\n\n其实老师人很好也很随和，点名会提前通知，小测不难都是pta原题很容易拿满分，所以平时分很容易拿很高的\n\n作业如果都是自己做的话实验考也没问题\n\n期末自己感觉写了一坨但是最后91/4.5 虽然卡绩但真的很满意了呜呜呜（大计基4.2）\n\n然后助教哥哥也很好！
195997,3435,干红华,2024-07-06 07:17:32,12,12,0,这学期选了干老师的FDS，说实话一开始看到查老师上的评价是有点忐忑的，但一学期上下来，发现老师其实很不错（至少我个人是这样认为的）。本人学FDS是属于平时摆期中期末突击的那种（对不起），来大致说说自己的感想吧。\n\n首先上课方面，老师的讲课水平确实不能说特别高，我复习的时候基本在看陈老师和何老师的MOOC，但遇到一些MOOC没有覆盖的知识点，再去看干老师的智云时，发现老师讲得也是清楚的，就是没有那么简洁，但听懂是没问题的。\n\n第二点是老师真的蛮体谅学生的，整个学期的点名是连着五周，老师提前一周就在群里说明了，并且全都是把数字写在黑板上的数字点名，我真的哭死；布置作业和project时也会考虑到同学们的情况，比如期中周时并没有和有些班同步布置project而是迟了一周，并且因为五一假期的原因把提交截止时间延后了一周让同学们能好好享受假期，每次有project时每周作业也会把截止时间延后一周；project的评分标准在开放题目集之前就全部发在了群里，并且还特意提醒同学们不要因为个人信息扣别人分，等等，因此我在做project的过程中虽然也觉得很烦，但并没有在论坛里刷到的那种“被故意恶心到”的感觉，如果被恶意打低分的话也是直接申诉就好，助教哥哥会打出公正的分数的；期中考试前在钉钉群仔细说明了范围，期末前也是在群里发了精确到每章出多少道什么类型的题，分别占多少分的出题范围（据我所知有的班是没有发的），从这方面来说老师真的很好🥺\n\n给分方面的话，本人是感觉自己的分有被上调一点点的，但周围也有人觉得实际出分比期望低一点，或者遇到了卡绩情况的，感觉总体来说给分是比较正常的。\n\n总结一下的话，干老师似乎比较适合我这种平时摆一摆，期中期末自学突击一下的学生，如果想要一个上课讲课很好的老师，干老师可能确实不是最好的选择。但干老师真的是蛮好的老师！这学期的FDS老师是干老师我是很高兴的！
196180,3435,干红华,2024-07-02 04:43:32,12,12,0,这学期学的干老师的fds感觉老师人真的很好，助教哥哥也很棒，projects互评仲裁时很公正并且给分特别好。其实我觉得类似于fds这样的课程大家都可以自己计算出得分，也没有什么给分求是之类的评价吧。最后再夸奖一波干老师和助教，真的很体谅我们，数字点名写在黑板上我真的哭死。（但是貌似老师好像要退休了）
199093,3435,干红华,2024-09-17 02:24:36,1,1,0,这学期的大鸡鸡主角好帅…解答也很有耐心（嘶哈嘶哈）
201044,3435,干红华,2024-10-28 01:59:04,5,5,0,还行吧虽然课上的不是很好但是好歹基本上不点名，偶尔点名也是数字点名。
201914,3435,干红华,2024-11-07 10:42:13,-2,0,2,Python讲课勉强还行，给分很差，本人小测每次基本只错一两道，作业全部按时完成，上机一道，期末90总评才86不知道怎么来的
203873,3435,干红华,2024-11-21 15:35:23,2,3,1,绿色的东西，看到僵尸会跳起来\n\n有看到这条评论的，它死的那一天，你打我电话19012770986，我请你吃饭（如果不方便我可以V你50）
205088,3435,干红华,2024-12-01 08:03:30,-9,2,11,干老师讲课非常细致，耐心回答同学问题，课程内容浅显易懂，给分高，爱了爱了
205944,3435,干红华,2024-12-13 01:47:47,3,6,3,讲课真的差啊，认真听的觉得什么都没学到，没听的也没损失什么。拖堂非常严重！！！！中间休息永远只有两三分钟，下课了多次拖堂十分钟及以上。。。。pta作业不放答案，问了也不给。。。回答问题不耐烦，态度很差。。。。。
209726,3435,干红华,2025-01-07 01:29:48,2,2,0,其实还行，全是数字点名，虽然讲课一般，但是大不了自己多学点
212525,3435,干红华,2025-01-14 06:41:25,3,3,0,感谢阿干！虽然上课让人昏昏欲睡，但是大学大学，本来就大不了自学。本人从来没有接触过python，纯纯文科生，纯靠听B站编程课程和看教科书，最后有被绩点惊喜到！老师给分好，可以冲！
216529,3435,干红华,2025-03-18 03:55:15,2,2,0,老师人超好，作业都允许补交，project也照顾我们推迟一星期
216873,3435,干红华,2025-03-27 20:45:26,3,3,0,这老师人挺好的，小测基本上全是原题，背一背都能作对(之前选的wk，全是创新题妈呀)，就是想拿高分的话可能得期中期末自己要考好，平时作业分都会给满的，期末作业也会给补交。就是会点名(连着五周那种，五次点名后就不会点了)
219941,3435,干红华,2025-06-11 15:10:00,1,1,0,坐标fds，老师还是很体谅学生的，平时分基本能拉满，作业和project也允许补交，互评也还行，同学间也没啥刻意压分。不过老师讲课风格挺像老一辈教师的，总是让我昏昏欲睡的。
221963,3435,干红华,2025-06-28 02:48:34,1,1,0,老师对学生的要求比较宽 从不会刻意为难学生 fds没有小测 Project互评体验良好 助教会逐一核实更正成绩 退休快乐干老师！
221964,3435,干红华,2025-06-28 03:59:42,1,1,0,上课让人昏昏欲睡，但是期中原题很多，对project也没有很严苛，助教也很负责。谢谢老师！
222062,3435,干红华,2025-06-29 10:04:15,1,1,0,老师人很好，点名是数字点名，四次小测，除了编程基本都是作业原题，python期末考试有些难度，需要人眼编译代码计算结果。
40948,3462,汤斯亮,2017-01-06 16:37:41,1,2,1,很爱笑嘛
58354,3462,汤斯亮,2017-08-29 09:23:43,2,2,0,小学期给分也太好了吧！
79000,3462,汤斯亮,2018-05-20 01:54:52,0,0,0,字数字数
83996,3462,汤斯亮,2018-07-11 16:26:21,1,1,0,te s t
109208,3462,汤斯亮,2019-06-12 02:39:32,1,1,0,挺好的老师，虽然还没上过他的课
113583,3462,汤斯亮,2019-07-07 00:29:38,1,1,0,老师的NLP好硬核
115483,3462,汤斯亮,2019-07-28 00:24:51,5,6,1,课很硬核 但老师的给分也太好了吧 大爱老师呜呜呜
115493,3462,汤斯亮,2019-07-28 16:32:17,7,8,1,wsl，这门课内容硬核，给分好，老师极好极爱笑极幽默，助教简直神仙好人。
115496,3462,汤斯亮,2019-07-29 01:49:16,4,4,0,不点名，课硬核，锻炼自学能力，给分好到不敢想
115500,3462,汤斯亮,2019-07-29 16:24:33,1,2,1,小学期是新开的一门introduction to AI，从零开始的人工智能深度学习课程。认真学还是能学到很多东西的…给分怎么感觉是小学期最好的？顺带一提做DRL的时候自备mac或linux
115510,3462,汤斯亮,2019-07-30 13:54:15,2,2,0,给分太好了 虽然深度学习学懵了 但老师人真的好 特体贴 给老师和助教疯狂打call
115512,3462,汤斯亮,2019-07-31 01:06:25,1,1,0,小学期的课。老师人超好！助教小哥哥也超好！虽然课很硬核，但是给分真的超乎想象的好！完美！
122091,3462,汤斯亮,2020-02-12 14:20:39,0,0,0,课太硬核了，但是也确实学了点东西。给分很好！上课风格我也很喜欢！
124785,3462,汤斯亮,2020-07-09 08:31:53,3,3,0,给分巨好，好到超乎我意料
133523,3462,汤斯亮,2021-03-01 15:34:21,0,2,2,老师讲课风格挺轻松的，小学期比较难，但老师会考虑我们的接受能力进行简化或重讲一遍难的地方，且给分好
134763,3462,汤斯亮,2021-04-14 05:25:34,1,3,2,很喜换汤老师的上课风格，真心不错
139441,3462,汤斯亮,2021-07-15 14:38:59,11,12,1,wsl 大作业做不出来 课很好老师很好助教也很好 但华为的平台一定是煞笔
139584,3462,汤斯亮,2021-07-17 15:01:38,4,7,3,从实践的角度上来讲，mindspore这个框架是照搬pytorch的实现逻辑的。底层的东西暂且不谈，主要问题则在于mindspore本身的文档和给的sample，试图模糊与pytorch的近亲关系，这就有点掩耳盗铃的意味，也导致了mindspore难以上手的问题。\n\n另外，老师谈到未来的课程可能都要国产化，对此不予评价。\n\n不过拿人家手短确实也应该出几分力(拿了快1k+的代金券），但华为在目前的情况下还有没有精力去维护一个基础的深度学习框架，mindspore的未来发展到底如何，仍然要打上一个大大的问号。
139624,3462,汤斯亮,2021-07-18 11:57:20,15,19,4,#自然语言处理 DL4NLP\n\n汤老师和助教人都很好，讲课的思维很清楚，听他的课很快乐！但老师似乎想要塞给我们的东西比较多，而我们比较菜，所以效果可能并没有那么好（这似乎不能怪这门课，得怪ZJU的一众垃圾本科AI类课程）。但认真听+课后看看实验还是有收获的，至少能对NLP的大领域有了解，且能对部分技术/话题能够有深入理解。\n\n\n\n这门课最让人最不满意的就是实验平台了。今年应该是第一次全程都强制要求使用华为的mindspore框架，从华为的这个框架到实验的云平台都极为极为极为难用。我不同意楼下的“拿人手短”的观点，华为要是每人发1k现金我当然手短；但给我们的是1k代金券，还只能用在modelart开发平台上，这不就是在喂我们巧克力味的屎么。我当然希望mindspore这款国产框架能够越来越好，但用它作为我们这些什么都不懂的本科生的教学工具属实是有点误人子弟。要想用mindspore来教学，等个三五年，待版本接口啥的稳定下来、社区资源充足了再说吧。\n\n\n\n然后是实验内容，平时有4个实验（词向量、TextCNN、GCN、seq2seq+transformer），基本没有什么要你自己写的代码，华为的实验手册都提供了源码，主要任务是跑一遍写个报告就好了。但是正因如此，大部分的时间都花在了读代码上，这很痛苦，相比自己写代码来说实在是一个糟糕的学习模式。\n\n\n\n自然语言处理这门课没有考试，有一个大作业。大作业的ddl原定考试周最后一门考试后的5天，最后延期了2天，总体时间很赶。虽然很早就布置了，但考试周前事情多，4个平时实验都才勉强做完，考试周就更不用说了。大作业要求做一个VQA模型，在一个较小的数据集上训练测试，同样必须要用mindspore框架（否则80分封顶，这不就是强制么hh）。\n\n\n\nP.S. 刚出分，感觉分数有点对不上我爆的肝。不过考虑到在这门课的收获不少，整体而言不算很亏:)
139626,3462,汤斯亮,2021-07-18 12:21:49,5,6,1,出分了\n\n虽然这门课真的很好 学到很多 最后大作业也确实是我做的菜\n\n但仍然觉得对不起自己的爆肝……\n\n华为傻逼华为傻逼华为傻逼
139627,3462,汤斯亮,2021-07-18 13:04:50,8,8,0,给分确实很好，老师和助教人也都很好\n\n但是华为的ModelArts平台和MindSpore框架做的是真的垃圾，体验极差，具体的可以看已有的评论我也不重复了\n\n考虑到这门课的作业和实验，我不是很推荐大家选
139685,3462,汤斯亮,2021-07-20 02:46:12,1,3,2,NLP满了，谢谢老师
152392,3462,汤斯亮,2022-04-07 14:17:59,11,12,1,华为这个平台比浙大领导还SB
158867,3462,汤斯亮,2022-07-03 01:59:18,1,3,2,汤斯亮yyds\n\n老师讲课知识含量很足，而且不强制听课。虽然我后面都不去现场了，但是依然会听老师的课堂回放，收获很大。\n\n最后的大作业考完连肝6天，但是结果不错。
177484,3462,汤斯亮,2023-07-03 11:40:39,1,3,2,人工智能专业的同学们，汤老师的nlp建议在大二下就修，能够对你之后的科研有很大的帮助，不管是做cv还是nlp，每一节课都让我有醍醐灌顶的感觉
177958,3462,汤斯亮,2023-07-05 23:32:35,-3,0,3,虽然大作业有点难，但给分巨好，助教和老师都特别好，老师非常幽默有趣。
178012,3462,汤斯亮,2023-07-06 07:34:47,-3,0,3,汤老师给分真的巨好！讲课也很风趣幽默（可惜我没怎么去过。实验的代码不需要自己写，只要跑一遍给的代码就好了，大程还是有点挑战性的。实验和大程认真做就能满！
178883,3462,汤斯亮,2023-07-28 02:09:31,4,6,2,汤老师从不点名，但是讲课真的很幽默有趣，建议大家都去听课，能够对深度学习有较深的理解，平时作业都是有代码和指导步骤的，很好去完成，我个人觉得mindspore框架和modelarts平台也没大家说的那么难用吧，个人基本也没遇到什么问题，毕竟给我们这么多学生提供了可以使用的设备算力（不仅仅可以使用ascend的芯片，还能够购买使用其它镜像和设备，用没钱了就找助教要代金券）\n\n大作业是给几个选题，组队完成，很硬核，但也会给一些指导文件，我们组选择的做ASR，网上有很多资料可以参考\n\n最后给分很好，认识的人基本都是满绩
193990,3462,汤斯亮,2024-06-21 08:10:45,0,1,1,课程本身没问题。\n\n但必须得狠狠骂一下构史华为云平台，不是人能设计出这种东西。\n\n还请华为扎实地学一下用户平台设计吧。
196705,3462,汤斯亮,2024-07-05 01:12:07,-2,0,2,华为云确实不太好用\n\n老师给分实在是太太太太太好了
196717,3462,汤斯亮,2024-07-05 01:55:31,-3,1,4,全勤，实验大程认真做，满了
208151,3462,汤斯亮,2024-12-26 03:14:43,-3,2,5,nlp导论，给分超人，上课内容也与时俱进加了些大模型的内容，上课节奏也很舒服，作为导论课但真能学到东西。\n\n去年没强制用mindspore，但老师吐槽往年上课人太少了偶尔点了几次名。
216705,3462,汤斯亮,2025-03-21 11:28:55,1,3,2,自恃甚高
217564,3462,汤斯亮,2025-04-13 09:46:47,6,6,0,mindspore 这种垃圾东西也好意思拿出来让人用？
218943,3462,汤斯亮,2025-05-14 05:47:10,10,10,0,nlp的实验烂的没边了，实验设计垃圾、文档垃圾、计算后端更是垃圾
219866,3462,汤斯亮,2025-06-09 08:10:58,8,8,0,上课吹水，坐一下午没听什么干货
219886,3462,汤斯亮,2025-06-10 03:22:29,13,13,0,如果想学到东西就不要上nlp…除了给分好（？）真的一无是处\n\n上课以吹水为主，能学到的实质性东西很少。大作业在期末考前两周才布置，要占用期末周的时间去做，一学期下来体验实在是不好。。
220051,3462,汤斯亮,2025-06-14 07:58:52,11,11,0,2024-2025春夏学期\n\n选课的时候看了之前的评论，对这门课抱了挺大期待的，但是实际体验很差，下一级的同学慎选！\n\n1. 楼下说的上课吹水，大作业布置时间不合理，非常中肯\n\n2. 助教隔很久才回或者直接不回消息。6月10号大家在群里说希望推迟大作业ddl，今天是6月14号，助教一点表示也没有，不知道是没读还是已读不回
220192,3462,汤斯亮,2025-06-16 07:06:03,16,16,0,感觉zju本科（非图灵）已经没有有价值的AI课了
222027,3462,汤斯亮,2025-06-29 03:33:17,1,3,2,我感觉还好，课件做的很认真很新，可能是计算机学院我上过最接近前沿的内容，不过讲的就不是那么深入，确实喜欢东拉西扯然后难点稍微讲讲得了。实验一坨，文档乱，任务没有渐进性，不能获得学习成长。\n\n     助教平时就一个，导致回消息很慢，也不是助教的问题，而是百人的课程应该多招一两个助教。\n\n     给分确实不错，点名全到，作业正常做，大作业一个人做，最后95，供后来人参考
77685,3467,夏莹杰,2018-05-07 09:07:52,1,2,1,随机组队……
88827,3467,夏莹杰,2018-11-09 07:05:00,0,2,2,事贼多，净整些没用的
93001,3467,夏莹杰,2019-01-15 13:02:35,2,6,4,老师太好了\n\n可以说是上大学以来遇到最萌的老师
94423,3467,夏莹杰,2019-01-16 11:48:31,-4,3,7,考前先来赞扬（舔一波）老师，绝对好老师！明天就看老师压得准不准了
108674,3467,夏莹杰,2019-05-31 01:36:14,9,11,2,靠点名才能留住学生的老师不是好老师
108747,3467,夏莹杰,2019-06-01 08:41:05,5,6,1,没什么干货
110000,3467,夏莹杰,2019-06-21 04:13:14,6,6,0,态度嚣张，没有干货，体验极差，选了绝对后悔。要不是为了学分，鬼都不选他
110267,3467,夏莹杰,2019-06-25 08:18:44,1,1,0,信安管点名 上课无聊 没有干货 随机组队 周一老师讲课 周五早课小组展示 每周有小组作业 早课偶尔会点名 均绩4.41不可信。总之我后悔选这门sb课
121958,3467,夏莹杰,2020-01-26 02:18:42,3,3,0,态度嚣张，讲课催眠
130235,3467,夏莹杰,2021-01-19 17:11:43,2,4,2,一个学期的OS下来，我觉得老师并没有评论当中所说的不堪。（也或许是今年老师换了种讲课风格）\n\n我觉得老师是很负责任的，上课内容也很充实，虽然课上当堂小测讲过的内容有点。。。
130245,3467,夏莹杰,2021-01-20 04:38:49,6,7,1,同楼上，我感觉老师人不错的，嚣张确实嚣张，感觉有时候有点流里流气的（？），但是讲课逻辑很清楚啊！小测问题也不大吧，小测搞懂感觉期末大题起码基本会做了。
130872,3467,夏莹杰,2021-01-25 05:11:41,-4,0,4,老师讲课蛮好的呀，也会很仔细的带大家复习，顶一个
131218,3467,夏莹杰,2021-01-26 14:53:03,2,2,0,老师人挺好的，给分也不错
133384,3467,夏莹杰,2021-02-26 11:35:11,0,1,1,上课讲得口齿清晰声音洪亮逻辑清楚，虽然有时态度看上去有点凶，但也可以算作是一个奇怪的萌点吧hhh（每次讲到一半突然停住就很好笑）\n\n复习课太棒啦！
136864,3467,夏莹杰,2021-06-26 14:08:45,-1,0,1,老师真的挺好滴，为啥评分这么低呢
137781,3467,夏莹杰,2021-07-06 06:16:58,-2,0,2,信安管，每周五周日早八，虽然累的要死但是从来不点名。报告有六个外加一个展示，但不得不说给分是真滴好，这就够了！
140456,3467,夏莹杰,2021-09-12 07:58:36,0,1,1,自以为是
143888,3467,夏莹杰,2022-01-12 16:29:25,0,2,2,上课讲话可以大声，提醒学生集中注意不是坏事。\n\n但是不要老是念PPT，况且咱的PPT还不是原创，还是人家的阉割版。\n\n----------------------------------------------------\n\n其他老师能把三节课的知识点浓缩到两节课，讲得还更细，剩下一节课将linux内核实现，还有会讲这次命中率（指知识点）十分高的考题，即使不是本人出题。\n\n时间都是从这里的停顿，不停的课堂练习中挤出的啊！\n\n----------------------------------------------------\n\n导致认真听你讲课的同学反而不会做你给出的课堂练习签到题。\n\n只要认真备课了，就算声音小，或者声音很大能震碎耳膜，同学们不需提醒也会挤破头去听的。\n\n\n\n----------------------------------------------------\n\n\n\nplus: 建议还是智云其他老师和B站王道听吧，我一开始头铁，不相信评论区的大哥，以为只要好好听学校老师讲课照样能掌握知识（不止这一门）。\n\n但是现在还是听老人的话，回头是岸吧。\n\n----------------------------------------------------\n\n不过这届的助教质量十分的高，跟他们交流过，他们中间不乏真正喜欢OS理论的人，回答问题也可以看出他们的水平。\n\n但Again，这跟老师的水平无关。
149352,3467,夏莹杰,2022-01-15 06:58:54,1,1,0,专业课还是得靠自己学的，不过PPT的内容据说是jjm的阉割版，配合王道考研很不错。最后的复习课很重要，老师看过卷子精确押题
149362,3467,夏莹杰,2022-01-15 07:19:18,5,5,0,讲课水平比较一般，实验和Linux内核的部分基本不会去讲，推荐看季江民的复习课，刷季江民的作业题和小测题。平时会有小测，基本上当作点名用的，都比较简单。最后一节复习课精准押题（透题）真确实节省了我们很多复习的时间。给分很好，老师第一节课就说平时分基本给满。总之，完全可以选，但是要自学。
149425,3467,夏莹杰,2022-01-16 15:42:34,3,3,0,[操作系统] 给分挺好的， 讲课也还行， 考前建议把jjm的小测作业刷一遍， 再好好过一下老师强调的重点就稳了， 推荐.
165820,3467,夏莹杰,2023-01-10 02:12:28,-1,2,3,讲课还行 小测点名\n\n给分好低呜呜呜 lab+bonus全做了
165826,3467,夏莹杰,2023-01-10 03:27:39,0,1,1,讲的挺好的，上课节奏不快，很适合我。会不定时进行小测，不算太难。作业也不多，而且最后一个实验改成了bonus，总体任务量适中，助教也很nice。\n\n实验可能布置的有点晚，有能力的可以找找往届或者别的班的做起来。\n\n成绩应该不会特意调分，我的分数跟估计的差不多
166059,3467,夏莹杰,2023-01-11 03:52:30,-2,2,4,总评给分好低。。。自我感觉期末不错，实验没做bonus，但评分比ws班的低了两档\n\n上课有可能会把作业/例题当作突击小测，点名性质\n\n讲课一般
166061,3467,夏莹杰,2023-01-11 04:01:46,0,2,2,给分比较求是，要点名，但是事很少，小测作业约等于无
167923,3467,夏莹杰,2023-01-20 09:38:26,1,2,1,老师讲课非常一般，选他等于自学，小测和作业应该是交了就有分，实验和其他班一样，lab6是bonus\n\n老师讲课特别慢，讲的速度没有我看王道速度快。。。仔细听其实讲得还行，就是太慢很难集中注意力\n\n总评完全黑箱，没有一项成绩公布，但是我感觉老师给分应该没楼下说得那么差？因为我没做bonus也满了，小测也写得不怎么样（感觉助教人不错，平时分应该尽量往高了给），期末应该是所有教学班混在一起改试卷吧，也没有调分的余地。。so，总评差的原因大概是期末在意想不到的地方出错了
170320,3467,夏莹杰,2023-03-03 00:45:38,0,1,1,绩杀。。。
173485,3467,夏莹杰,2023-05-26 03:18:38,-3,0,3,一言一行举手投足都透露着有大病……
176905,3467,夏莹杰,2023-06-30 15:45:27,1,1,0,信息安全管理，软件工程专业水课。上课内容很浅，用8周的时间让你明白一个道理：人是每个安全系统中最不确定的因素。\n\n考核方面每周一个1k字课后报告，然后分组进行展示。给分倒还不错。
187808,3467,夏莹杰,2024-01-17 13:47:30,1,1,0,还不出分啊哥
189053,3467,夏莹杰,2024-01-21 12:55:48,4,4,0,出分速度有点离谱，其他班最晚的都出完5天了还没出
189245,3467,夏莹杰,2024-01-22 14:51:01,4,4,0,最后一节课可以看到有情怀的\n\n个人体验感觉平时分给分不像前面说的那样\n\n好像是都给满了
189298,3467,夏莹杰,2024-01-23 03:18:02,3,4,1,操作系统：\n\n1. 上课也就那样，反正大家都是自学，平时经常有课堂练习，需要线下提交，当点名用了。不过可以提前看PPT里有没有课堂练习进行预判（\n\n2. 给分感觉还是很好的（虽然出分确实慢），平时分应该基本拉满了，还有一个实验作为bonus。\n\n3. 最后一次课是看完卷子后押题（划重点），大幅降低复习负担。\n\n4. 总体体验不错，的确能学到不少知识（自学）。
189441,3467,夏莹杰,2024-01-24 07:43:02,2,2,0,【操作系统】平时事情比较少，小测作业都很水，平时分给分也不错，但比较考验自学能力，总体来说还是很推荐的
32046,3515,尹建伟,2016-07-05 13:07:35,-16,7,23,真的看你考试成绩和大程做的怎么样给成绩的好老师
32389,3515,尹建伟,2016-07-06 11:43:48,1,6,5,资深点名爱好者，上课喜欢侃大山。
78883,3515,尹建伟,2018-05-16 06:40:40,0,0,0,紫薯紫薯紫薯
84316,3515,尹建伟,2018-07-12 13:56:39,1,2,1,? 杀无疑
84317,3515,尹建伟,2018-07-12 14:04:03,2,3,1,靠自己吧\n\n没有师生情的一门课，好好准备考试就是了
84348,3515,尹建伟,2018-07-12 15:24:25,0,4,4,?杀，喜欢点名
84350,3515,尹建伟,2018-07-12 15:26:11,1,3,2,吭哧吭哧地点了名
85371,3515,尹建伟,2018-07-17 09:23:32,3,7,4,会点名\n\n语速快声音小 普通话没有一百级听不懂的\n\n大家复习时多看看ppt里的图表，尤其是里面为数不多的计算
87937,3515,尹建伟,2018-10-18 04:23:58,12,15,3,柜为副院长，无论是本科生教育还是硕博的教育都偏差……感觉zju计算机系的都这个水平当上副院，难怪大家都想出国读
109749,3515,尹建伟,2019-06-23 16:05:05,13,16,3,sbyjw
110117,3515,尹建伟,2019-06-23 08:47:29,0,4,4,平时分给分苛刻，讨论题做了也会扣分。大作业要求和其他班不一样，整体工作量两倍不止。助教是好人，可惜老师太差劲。
134727,3515,尹建伟,2021-04-13 05:01:26,5,8,3,随机点人上台讲课？？？？？？
151510,3515,尹建伟,2022-03-06 08:47:41,12,13,1,1. 老师不上课，让大伙看录像。那老师存在的意义是什么？\n\n2. 课程录像和课件在捏嘛百度网盘上，下载速度死慢，百度网盘打钱了是吧？！传个浙大云盘不行？\n\n3. 让同学讲课，我的评价是：真行。
151552,3515,尹建伟,2022-03-07 09:36:17,9,10,1,不上课让同学上，课还放在百度网盘。拖大堂。\n\n很喜欢一句评论“sbyjw”
151902,3515,尹建伟,2022-03-20 05:06:25,22,24,2,你好，我讲课可以把工资打我卡上吗？
153119,3515,尹建伟,2022-04-25 17:22:07,17,19,2,让我感受到的人生经验：\n\n\n\n“任何人都不能评价你的能力，也不能规定你的未来。”\n\n\n\n软件工程形式繁琐，你当然会在这堂课上出错。但是这不代表你能力不够。\n\n\n\n这些繁文缛节，我个人臆想：“通过无意义的东西（因为只能拿出无意义的东西）消耗年轻人尝试其他东西的精力，以便于这些年轻人踏上跟老一辈人同样的道路。”\n\n\n\n工业界天天搞这种东西，耗费很多时间开会沟通，就算是上班族也会意识到自己没有成长。那么不被裁员谁被裁？\n\n\n\n四大天坑有很多能让你熬上一天的实验课，客观上阻止了同学们转换方向的尝试。\n\n\n\n所以我总结：“除了卷GPA，不要对这门课抱有能提高你能力的任何臆想。”
154447,3515,尹建伟,2022-06-01 13:36:15,14,15,1,从第一周恶心到最后一周\n\nyjw真有你的
156353,3515,尹建伟,2022-06-19 07:56:22,39,42,3,淫贱萎
156973,3515,尹建伟,2022-06-21 13:02:50,8,11,3,垃圾软工
157899,3515,尹建伟,2022-06-25 11:37:24,4,5,1,太阴间啦sb玩意
158048,3515,尹建伟,2022-06-26 12:22:34,11,12,1,SB滚出浙大
158069,3515,尹建伟,2022-06-26 15:40:45,10,11,1,给1分是因为没有更低分了/微笑\n\n断人前途，等着遗臭万年吧
163369,3515,尹建伟,2022-12-14 02:53:46,1,2,1,...
168176,3515,尹建伟,2023-01-31 13:20:32,2,3,1,sbyjw
169643,3515,尹建伟,2023-02-27 08:50:45,2,3,1,楼上说得对，2023年依然如此
169644,3515,尹建伟,2023-02-27 08:54:02,0,0,0,果然，我们是老师
169745,3515,尹建伟,2023-02-27 15:23:51,4,5,1,他意识不到自己这门课多烂，还觉得翻转课堂很牛逼
170529,3515,尹建伟,2023-03-06 06:58:04,2,2,0,翻转课堂快润
170976,3515,尹建伟,2023-03-13 14:55:44,3,5,2,每周先听一遍之前的网课，再上课抽同学讲，上课举手回答问题还要算分。我的评价：\n\n不想讲课可以不讲不想讲课可以不讲不想讲课可以不讲不想讲课可以不讲不想讲课可以不讲不想讲课可以不讲不想讲课可以不讲不想讲课可以不讲不想讲课可以不讲\n\n不想讲课可以不讲不想讲课可以不讲不想讲课可以不讲不想讲课可以不讲不想讲课可以不讲不想讲课可以不讲不想讲课可以不讲不想讲课可以不讲不想讲课可以不讲
171195,3515,尹建伟,2023-03-18 04:01:23,4,6,2,sb淫贱萎 我建议你赶紧滚出浙大 做不好就滚 别在这丢人现眼
171393,3515,尹建伟,2023-03-23 08:08:03,7,9,2,鉴定为出生
171730,3515,尹建伟,2023-04-03 12:06:26,4,6,2,真希望他出点事
173545,3515,尹建伟,2023-05-28 12:12:29,3,3,0,无语啊
176946,3515,尹建伟,2023-07-01 00:18:49,5,7,2,今年好了不少，平时分疯狂送，很容易拿满平时分，期末考试选择题的给分方式也更好拿分，可能比较诟病还是翻转课堂。\n\n助教姐姐真好看
186064,3515,尹建伟,2024-01-08 05:59:33,2,2,0,太差劲了
190611,3515,尹建伟,2024-03-11 14:27:12,7,8,1,这老师上课是真轻松，双周学生自己看录像，单周抽同学上台讲课。那还要您做什么呢，这样的课我都能开
194540,3515,尹建伟,2024-06-24 09:44:54,7,7,0,“想问一下这是哪位老师给我拨的穗，人挺好的，主动和我握手”
194751,3515,尹建伟,2024-06-25 08:51:27,6,6,0,下面那个3.11的评论也是我写的，更新一下\n\n一开始是双周看录像单周翻转课堂，后来更tm恶心，直接就每周都翻转课堂，我翻转nm呢，上不来课就别jb开，搁这恶心谁呢
194924,3515,尹建伟,2024-06-26 02:49:20,11,12,1,sm东西，天天就惦记你那bi翻转课堂，两周翻变成周周翻，翻你牢木，狗屎课屁用没有，再加上你的狗屎教学，给人恶心坏了
195050,3515,尹建伟,2024-06-26 13:47:45,2,2,0,。。。
195062,3515,尹建伟,2024-06-26 14:33:20,4,4,0,这就是史
215220,3515,尹建伟,2025-02-24 11:32:02,4,4,0,"有这样一个笑话：一个旅客走进硅谷的一家宠物店，浏览展示的宠物。这时，走进一个顾客，对店主说：""我要买一只C猴。""店主点了点头，走到商店一头的兽笼边，抓出一只猴，递给顾客说：""总共5000美元。""顾客付完款，然后带走了他的猴子。这位旅客非常惊讶，走到店主跟前说：""那只猴子也太贵了！""店主说：""那只猴子能用C编程，非常快，代码紧凑高效，所以值那么多钱。""这时，旅客看到了笼子中的另一只猴子，它标价10000美元。于是又问：""那只更贵了！它能做什么？""店主回答：""哦，那是一只C++猴；它会面向对象的编程，会用Visual C++，还懂得一点Java，是非常有用的。""旅客又逛了一会儿，发现了第三只猴子，它独占一个笼子，脖子上的标价是50000美元。旅客倒抽一口气，问道：""那只猴子比其他所有猴子加起来都贵！它究竟能做什么？""店主说：""我们也不知道它究竟能做什么，不过它是做项目顾问出身的。""虽然这只是个笑话，但是有一点是能够肯定的，项目管理是很重要的，而项目管理的人才又是极为缺乏的。"
215865,3515,尹建伟,2025-03-06 06:36:59,1,1,0,我扎nmlgb
217037,3515,尹建伟,2025-03-31 15:22:20,3,3,0,翻转课堂搞的很6，我之前在教四好几次路过yjw软件工程课的课堂，从前门往教室里看，发现每次都是学生在讲，老师不知在哪呢
169578,3558,林海,2023-02-27 03:56:52,-3,4,7,企业实习人均满绩
216783,3558,林海,2025-03-25 10:40:23,2,2,0,软工。。。快跑啊傻孩子们。。。。。。
217009,3558,林海,2025-03-31 08:48:08,0,1,1,快跑！傻卵林海 别开盲盒了
218126,3558,林海,2025-04-21 09:47:03,1,2,1,至少没有反转课堂，感觉老师人还行，对电梯情有独钟，不过讲课这个事情怎么说呢可能大家都讲不好软工这门课吧，讲的确实一般般
218878,3558,林海,2025-05-10 09:46:44,2,2,0,每节课随机抽人，按姓名首字母，哈基海
218892,3558,林海,2025-05-11 15:30:23,3,3,0,开始还装模作样上课点名，现在完全开摆只点到场的人，小测让大家拍个照就行，真是替我们着想
219392,3558,林海,2025-05-26 09:49:27,4,4,0,林海之于电梯\n\n就像那刻夏之于大地兽\n\n大象之于踩踩背\n\n曼波之于哈基米\n\n🐋之于杜兰特\n\n真实球迷汇基于C罗
220025,3558,林海,2025-06-13 15:06:08,3,3,0,海海酱！Hi~~ 你喜欢什么？\n\n比起小测， 我更喜欢电梯！\n\n海海酱！Hi~~ 你喜欢什么？\n\n比起点名， 我更喜欢电梯！\n\n海海酱！Hi~~ 你喜欢什么？\n\n比起复习， 我更喜欢电梯！
221014,3558,林海,2025-06-20 22:39:17,2,2,0,密码的软工能不能放过我这一次😭👊🏻\n\n下辈子我只想做不学软工的孩子🥺🥺\n\n没有闭卷没有背诵也没有期末考试🤗🤗\n\n画完电梯冲向快乐暑假的日子🥰✈️\n\n一勺料汁～🥄🥄
221589,3558,林海,2025-06-24 17:03:41,0,0,0,最开始点名后面摆烂，不拖堂，人不错
222015,3558,林海,2025-06-29 01:33:33,2,2,0,感觉还可以，大作业全班分成三个大组，每个大组下面若干5人小组，所以每个人workload不算大，就第一节课点了一次名，春学期基本都有随堂作业，老师自己说签到不重要，不知道怎么算分的，每节课会随机抽人问问题，应该是到了就可以，感觉给分还可以，算是软工老师里不错的选择
222063,3558,林海,2025-06-29 10:07:21,1,1,0,软件工程：老师喜欢课程前提问问题，说实话软工这门课就是一坨，谁讲都那样，考试也蛮恶心的。考之前可以多尝试看一些题库里的题，有大概的印象，画图题仔细学习，注意细节。
222066,3558,林海,2025-06-29 10:28:02,0,0,0,应该是软工里最好的选择了吧
22906,3593,邓水光,2016-03-14 12:40:30,2,3,1,老师年轻有活力，会与我们分享人生经验（据说在MIT和Stanford都干过）。但是计组毕竟是难课，老师有时缺一点经验，有的东西说不透。
57164,3593,邓水光,2017-07-06 00:39:25,1,3,2,听说给分很好，慕名而选。软工出分以后，工训既视感。总之，慎选！
104751,3593,邓水光,2019-03-27 04:43:48,3,3,0,上课很有激情
104811,3593,邓水光,2019-03-28 05:29:27,3,5,2,我觉得邓老师讲课还是很负责，软工讲的也比较生动，虽然上课提问会让人紧张。
135427,3593,邓水光,2021-05-10 08:00:41,1,3,2,这课 纯nt
135434,3593,邓水光,2021-05-10 09:44:38,4,6,2,建议不要选。老师自己基本不讲，全部是学生讲。课程安排一点都不说，到了要交/展示的时候突然说一句。助教也啥都不知道，期中刚结束觉得我们代码都写的差不多了，服了，阴间课程。
136920,3593,邓水光,2021-06-28 08:03:21,1,2,1,见过最不负责的助教
139236,3593,邓水光,2021-07-13 13:50:40,5,8,3,软件工程给分也太差了
139257,3593,邓水光,2021-07-14 01:09:33,5,5,0,超烂。给分烂助教烂老师不讲课。
139296,3593,邓水光,2021-07-14 05:49:05,3,3,0,给分很差
139345,3593,邓水光,2021-07-14 13:37:09,4,4,0,给分巨差，而且平时就是让学生讲课。这课开成这样真的十分失败，本科期间烂课能排前3。
155074,3593,邓水光,2022-06-22 09:12:51,0,0,0,中间件课程，会请一些毕业的学长们来分享（个人认为学长对于分布式的讲解比隔壁大规模清楚）；助教人很好，认真负责；老师人挺好的，看起来比较佛\n\n————————————\n\n给分不错（前提是认真做了最后的展示and报告），感谢助教和老师
155888,3593,邓水光,2022-06-16 12:46:58,0,0,0,老师比较佛，助教人挺好，一般提前20分钟下课好评。给分估计大差不差，在软工老师里面算还行
157215,3593,邓水光,2022-06-22 10:47:15,1,1,0,中间件，有时候老师在下课之前会让助教用纸记下来到了的同学的学号当点名。只要最后报告认真做给分就特别好，身边两个课友都满了（虽然我没满，可能是错过签到的原因）。
158519,3593,邓水光,2022-06-30 02:49:55,6,6,0,软工今年给分算很好了，但是这个和助教相关，不敢以后还保证。软工这门课太烂了，早点取消吧
158871,3593,邓水光,2022-07-03 02:37:49,1,1,0,老师人挺佛的，基本每节课都会提前20分钟下课，平常基本没有发言加分环节。给分全看助教，老师展示课不来
176265,3593,邓水光,2023-06-28 07:46:35,5,5,0,李助教今天第二年带\n\n贼好\n\n平时分期末分都好\n\n平时也很宽松\n\n只要还是这个助教绝对可以选
176784,3593,邓水光,2023-06-30 06:24:10,2,3,1,助教很好\n\n这个课纯看助教\n\n最好打听一下明年还是不是他
176858,3593,邓水光,2023-06-30 12:00:35,1,1,0,助教很好，推荐
176904,3593,邓水光,2023-06-30 15:42:48,0,0,0,中间件，软件工程专业水课，上课内容大概是学长或者老师进行分享，会有点名。考核就是中间件源码分析报告和展示，个人感觉给分很好。
176924,3593,邓水光,2023-06-30 16:59:10,0,0,0,选dsg真的纯靠助教\n\n展示课也不来的\n\n基本打分核算都看助教\n\n今年还是22年那个助教\n\n很不错\n\n明年不知道了
186063,3593,邓水光,2024-01-08 05:57:23,1,2,1,这个老师，每节课点名，给分巨差，平时分该扣的都扣完了
190622,3593,邓水光,2024-03-12 03:25:22,3,3,0,翻转课堂，先给个1分。
190653,3593,邓水光,2024-03-13 08:08:06,4,4,0,闹麻了，翻转课堂，留个贴
190963,3593,邓水光,2024-03-26 01:58:25,4,4,0,无敌了，等到不能退课的时候才说翻转课堂
191109,3593,邓水光,2024-04-03 13:21:37,4,4,0,闹麻了，翻转课堂
193106,3593,邓水光,2024-06-03 14:35:35,4,4,0,翻转课堂真是个天才般的想法（赞赏）
196256,3593,邓水光,2024-07-02 17:04:15,1,2,1,别选！
196276,3593,邓水光,2024-07-02 18:10:51,5,6,1,李助教是大好人，挺能捞的\n\n但是一整个学期的翻转课堂，而且翻转课堂dsg直接就给打分，算一项平时分，扣的挺狠的\n\n记得有一组，dsg点评，“挺好的”“我给85”\n\n总结下来就是，不要选，快逃，但是李助教真的是大好人，感觉李助教暗中帮dsg擦了很多屁股，无论是残破的平时分，还是混乱的给分制度
196313,3593,邓水光,2024-07-03 00:59:59,5,7,2,你给85分？我给你1分
221776,3593,邓水光,2025-06-26 07:34:53,0,0,0,还在翻转课堂
221828,3593,邓水光,2025-06-26 14:30:49,1,1,0,只能说这门课实在太烂了，很管理而非 cs，平时翻转课堂，考前准备啥也不会，而且是纯记忆，只能说好在试卷难度相对偏八股。\n\n\n\n项目 4~5 人一组，主题任选，但说实话，好像无论是做的好还是做的烂，项目给分基本都差不多，分差关键还是在于组内分配分数，就显得我们认真做了的很小丑（x）（不过隔壁老师会严格一些似乎，不同组项目三六九等还是很重要的）
222007,3593,邓水光,2025-06-28 15:20:53,1,1,0,软件工程，浙江大学计算机科学与技术学生都必须亲自吃的⑩课\n\ndsg班的任务是这样的，每4-5人分成一组，项目主题任选，每组除了进行项目本身的开发之外还需要完成所有的报告、翻转课堂展示、总体设计展示、总体展示，dsg大概会亲自上前面一个月左右的课，剩下所有内容都是由每组进行翻转课堂\n\n在这个模式下，选择牛逼的大佬抱大腿可以尽量避免在期末周赶工项目，同时根据了解今年给分其实也一般，而且第一节课说的当组长可以加总评5分变成了大部分项目的组长都拿不到这5分而且5分只能加平时分\n\n毕竟这门课是必修课，所以如果不是大佬不要对绩点抱太高希望吧，dsg感觉相比其他老师也没有好特别多\n\n不过还是要感谢李助教，听说今年是他最后一年当助教了
47104,3648,鲁伟明,2017-01-24 00:20:28,1,5,4,上课无聊，给分勉强（其实是差的）
56818,3648,鲁伟明,2017-07-04 16:23:24,3,4,1,老师很负责，给分很好
57029,3648,鲁伟明,2017-07-05 08:36:48,2,2,0,老师蛮负责的 就是东西有点多 给分还好 认真做就行
57258,3648,鲁伟明,2017-07-06 08:05:30,0,0,0,中上吧
57656,3648,鲁伟明,2017-07-11 15:21:57,9,12,3,讲的还是可以。可惜这课开错了时间。
74178,3648,鲁伟明,2018-02-06 04:44:26,0,4,4,讲课像在催眠……给分……就那样
84525,3648,鲁伟明,2018-07-13 05:16:04,-1,1,2,给分好
84683,3648,鲁伟明,2018-07-13 14:05:06,1,1,0,大规模软件。\n\n事情少，讲得不错，最后给分也还好
86820,3648,鲁伟明,2018-09-19 02:33:28,-1,0,1,人蛮好的，上课一般
88021,3648,鲁伟明,2018-10-20 11:47:04,8,10,2,很认真的老师，知识点丰富
102521,3648,鲁伟明,2019-02-04 07:25:22,6,9,3,Java 和楼sir就不说了 和隔壁翁恺比无小测无期中考无额外网课 作业相对少 只有无规律签到 简直良心老师 上课是一般般了 但给的ppt重点非常详细 考试有错题也十分负责 给分也好
114578,3648,鲁伟明,2019-07-10 22:33:37,3,6,3,老师人很好，非常善解人意。课开错了时间，不过如果在不那么忙时听老师讲课还是能收获挺多～最后给分也挺好，感恩? 期待下个学期与老师再见
132494,3648,鲁伟明,2021-02-02 03:30:39,5,9,4,虽然上课有点无聊，但是老师的java给分很好，老师人也很好，钉钉上回答问题经常秒回
132593,3648,鲁伟明,2021-02-02 13:46:28,6,8,2,感受到了老师浓浓的师生情
136453,3648,鲁伟明,2021-06-18 05:32:12,1,7,6,大规模课今年改革了，需要做一个分布式minisql，不过给分很好，通过验收至少90分吧
137194,3648,鲁伟明,2021-07-02 07:02:37,3,3,0,大规模数据系统讲课很好，而且内容有用，确实能学到东西
138320,3648,鲁伟明,2021-07-08 13:42:17,0,0,0,大规模讲课说实话也就那样，作业的话主要看你架构而对sql本身没啥要求，给分的话还行
150064,3648,鲁伟明,2022-01-18 16:59:31,3,5,2,出分好慢啊
150217,3648,鲁伟明,2022-01-22 06:16:19,6,9,3,我觉得他好push啊🤔，那个说ppt重点详细的我直接笑了，2000+的ppt还重点详细。
169895,3648,鲁伟明,2023-02-28 08:52:48,-4,1,5,唯一神，不解释！
173095,3648,鲁伟明,2023-05-13 09:51:22,-4,4,8,千万别选，老东西
174654,3648,鲁伟明,2023-06-15 06:31:11,0,1,1,为什么老师不让补选啊
176907,3648,鲁伟明,2023-06-30 15:55:47,-6,0,6,大规模课程，软工必修课且算主干课程。老师上课讲的内容其实挺好的，也和工业界比较接近，值得一听。但遗憾的是由于没有考试，我没怎么认真听讲。大作业是实现一个分布式数据库系统，这个就自求多福吧。答辩的时候老师会问的很细，而且不要以为实现了功能就好，要体现出你有用心思在架构设计上。最后给分也还行，推荐选。
189530,3648,鲁伟明,2024-01-25 08:12:58,8,8,0,给分不好
189531,3648,鲁伟明,2024-01-25 09:08:13,7,8,1,java给分一般，问了一下老师期末成绩算下来平时分被扣了10分，平时作业和实验报告我都有认真写的，不知道为什么扣这么多
189532,3648,鲁伟明,2024-01-25 08:37:24,2,2,0,写写吧，23-24秋冬Java应用技术，给分中规中矩，一次名都没有点过，乐\n\n2次pta作业，限时2小时完成+5次project，ddl为考完试\n\nproject4 5任务量大，4写一个爬虫，5完成一个图形化的网络应用程序，会轻度查重，各位注意（\n\n期末建议提前去wk班作业里面训练编程，4道编程题，一道题占总评的3分orz，测试点没有任何坑，纯看代码写不写得出来
189736,3648,鲁伟明,2024-01-28 05:08:41,2,2,0,sb助教，你是懂装死的
193382,3648,鲁伟明,2024-06-08 07:05:37,14,14,0,lwm的23-24年的Java（大三上）和大规模（大三下）都上过，下面都来理中客评价一下。\n\n\n\nJava：Java的平时五次project是上传FTP的，只要期末前传上去就可以，但是平时的PTA练习只有两次，个人感觉略少（对比隔壁wk班），导致期末编程题大寄特寄。期末选填题范围很广，如果平时不认真学，期末突击两三天是绝对来不及的。以及虽然平时分：期末分 = 7:3，但是平时作业并不会认真去改，而是根据期末分数给平时分（例如我和我室友平时作业很认真，但是我期末没考好，我平时分就扣了十多分；但是室友期末不错，平时分就接近满分了）。所以就是大佬/满级佬随意选，普通人给分差（总评70多分），菜鸡是会挂科的。\n\n\n\n大规模：由于课程分数分布都在大project上（没有平时小作业，不过听说下一届就要改革了），所以平时上课大家都是不太认真听的。大project要求3-5人一组，我们组是5个人，分工略细，我负责了client通讯和交互解析，但是lwm在项目答辩时针对我的工作量反复提出质疑，虽然我有近千行的代码及设计工作量，但是lwm仍有偏见地认为这不够，并提出了【客户端为什么不用多语言设计】的逆天问题（意思就是还要用java、python等多种语言写多套客户端），虽然我们反馈说由于实现了通讯api，所以这样是没有意义的，但lwm仍觉得工作量不够，最终导致期末分数比同组低。建议后人如果care分数，不要领客户端的锅，或者写了客户端后，还要再参与一部分主模块的代码工作，毕竟lwm认为只有他的分布式minisql算工作量，轻贱的client是不配算工作量的（难崩）。或者推荐选隔壁班zy，答辩过程很轻松，给分相对合理，但是是3人一组。\n\n\n\n总结：其讲课水平尚可，虽然没那么生动出彩，但是是有备课的，认真听下来还是会有收获的。其人略有刻薄，不足够体谅学生（体现在私下问问题和给分上）。\n\n\n\n姑且让后人自鉴之。
193405,3648,鲁伟明,2024-06-09 16:01:27,2,3,1,有点push，给分不好
193417,3648,鲁伟明,2024-06-10 07:00:55,9,9,0,快跑！！！选隔壁zy和blf都比他强，太push了，答辩pressure拉满，给分还差！
193462,3648,鲁伟明,2024-06-11 07:03:22,13,15,2,java和大规模都是lwm，只能说这辈子最后悔的事就是java吃了lwm这坨屎之后还没有换老师，大规模又被喂了坨屎。\n\njava的内容不多说了，前面有人说的很详细很中肯的，这边补充一下大规模的情况。我们组是master2人region2人client一人，答辩的时候lwm倒是没有质疑过分工的问题，但是结果最后给分也不均衡，组内分数差了三四分，而且不光是client给分低，我做region的给分也低，好歹也写了上千行代码、几十页个人报告的内容，最后给这么一坨，恶心坏了。
194508,3648,鲁伟明,2024-06-24 08:06:30,9,9,0,lwm， wcnm
195170,3648,鲁伟明,2024-06-27 04:14:10,1,1,0,大规模：\n\n授课水平尚可，中规中矩，至少比许多浑水摸鱼的老师好多了。\n\n分数全看3-5人一组的大作业（听说后面可能会加平时小作业），不光是小组整体的完成度，更看重你在组内的工作量，因此不光要跟一个好的组，更需要主动承担工作。如果真的想认真干的话这个项目还是相当有工作量的，从前期设计到后期实现需要花费较多时间，代码量上万，建议预留至少一个月时间来仔细打磨。\n\n答辩时是问的比较细的，会对项目的很多细节提出质疑。老师似乎比较在意“多语言客户端”（其实PPT上也有这个东西），但感觉提供接口以后多语言客户端似乎只是一个堆工作量的过程，从技术角度来看不是那么必要？不过既然老师在意的话建议后人可以考虑实现。答辩时也会特别关注工作量分配的问题，不光是写了多少代码，更关注写了多少“有难度”的代码，因此如果只是单纯实现一个客户端的话工作量必然会较低，建议后人分工时要么将客户端这个锅拆开了均分，要么干客户端的同学再承担别的工作。事实上来说，如果只是单纯写一个客户端调用其他同学的接口而没有其它额外工作量的话，写客户端的同学根本都不需要了解整个项目的具体实现，相当于是完全独立于整个系统，是基本没有技术含量也很难体现工作量的事情，很难体现你对课程内容的掌握，得分肯定会低。\n\n总的来讲大作业只要小组整体完成的不错，其中你的工作量能够体现对课程内容的掌握，最终得分也还是可以的。特别关注分数的同学可以在这个项目上多花时间，多承担工作（或者向其他同学说的那样选别的老师
203017,3648,鲁伟明,2024-11-16 02:26:19,3,3,0,为人刻薄，抠门push，千万别来
205617,3648,鲁伟明,2024-12-10 07:08:18,1,1,0,sb老师，赶紧滚
213912,3648,鲁伟明,2025-01-21 08:31:26,4,4,0,lwm的Java应用技术，体验非常一般：\n\n1. 注意不要被课程说明中的平时分70%，考试30%骗了，本人期末考编程题36/40，理论具体分数不清楚，平时作业和PTA均按要求完成，最终得分是85/100，这可以说明两种可能：一、lwm的平时分给的不好，会扣不少；二、和之前的学长评价一样，期末考和平时成绩强相关。三、本人期末考60分理论题只拿了20分左右。个人认为前两种情况更为可能，所以认为期末考占比少最后得分就一定高的同学一定要注意；\n\n2. lwm讲课感觉还过得去，没有特别离谱，和我之前上过的楼sir之流还是好不少的，会点名，但是次数很少\n\n3. 作业没有很多，四次编程作业都没有特别难，大家注意每次实验都需要对应的文档。最后一次是远古GUI库，学了也没什么用，总之GPT yyds！\n\n4. 期末考理论部分确实比较难，需要好好复习，98上的会议卷多看，然后老掉牙的GUI、流操作和一些上课偶尔提到的知识点也要深入理解，因为看起来出卷人非常喜欢考这些
213913,3648,鲁伟明,2025-01-21 08:37:35,1,1,0,你给我多少 我给你多少 java分数远低于wk班 对于水平一般的同学来说 老师人不坏但别选
214956,3648,鲁伟明,2025-02-19 10:05:10,2,2,0,nlp课，一学期点了一次名，没签上，期末大论文1w5，没写满，照样给分不低，好课
220652,3648,鲁伟明,2025-06-19 05:20:57,1,1,0,在大规模课上确实学到了不少东西，了解了不少分布式相关的知识，最后给分也还不错\n\n\n\n个人认为课程核心就是理解 GFS 的实现细节和 Zookeeper 的使用，然后把它用在你的分布式 MiniSQL/MySQL 上，其余的分布式相关知识也需要会，如Paxos/Raft算法、分布式索引、分布式事务、分布式查询、一致性哈希这类，能有代码实现是最好的\n\n\n\n关于多语言客户端的问题，其实项目完成度高的话这个是无所谓的，如果你觉得自己的项目太简单/不放心最后的得分，可以做一下作为工作量，但是正如前辈所说，这个意义没有这么大。一般来说把各个模块设计完善，全局运行正常，然后编写对应的 Test 已经很够了\n\n\n\n然后建议大家认真对待这个项目，完成度高的话绝对是一个简历上的亮点（对于实习/春秋招），以及尽早开始，总代码量比较大，我们小组的代码量在一万行以上
22169,3681,吴鸿智,2016-03-03 00:48:08,3,10,7,超帅超萌的老师～ ppt图文结合很简明清晰
23418,3681,吴鸿智,2016-03-29 10:09:41,-1,5,6,讲课不错的，循序渐进
23486,3681,吴鸿智,2016-03-31 10:30:29,1,5,4,很负责的老师
31025,3681,吴鸿智,2016-07-03 06:27:10,-1,4,5,老师很帅，但是讲课有些太快了，所以很多地方听不懂，平时有几次quiz，但是都十分友好
32133,3681,吴鸿智,2016-07-05 16:49:01,-2,4,6,老师好帅，上课总是关心我们有没有听懂。但是实践起来有跨度
35249,3681,吴鸿智,2016-11-07 08:29:06,0,4,4,循序渐进，原理分析透，讲课节奏很好
47739,3681,吴鸿智,2017-02-22 21:27:59,7,7,0,上课和作业没什么关系…有时候作业的形式就一脸懵逼。出分的时候突然发现Quiz占比升高？。？
49508,3681,吴鸿智,2017-04-17 08:30:25,15,24,9,老师上课思路清晰，课堂纪律良好，但是作业和课上内容总是没有关系（就当自我提升）不太照顾学的慢的同学（也权当高要求）最大的问题在于，他的TA太不负责了，超级嫌麻烦，不论是平时问一些问题，还是组织作业等等，语气里充满了嫌弃(ʘ言ʘ╬)（好了好了，不气了）希望大家能遇到好TA\n\n
51625,3681,吴鸿智,2017-06-07 15:54:06,4,7,3,我的梦想可能就从这个课开始转变的，图形学奠定了我的基础。尤其是前半个学期，老师的思路非常清晰。后半学期渐渐有点听不懂了，可能我太菜了吧233
53326,3681,吴鸿智,2017-06-26 11:11:34,13,19,6,老师耶鲁博士毕业，水平一流人超nice，给分也很好
53469,3681,吴鸿智,2017-06-26 16:29:29,-1,2,3,讲课清楚，很负责的老师，除了大程之外课程的事情不多，给粉似乎挺不错
56838,3681,吴鸿智,2017-07-05 00:17:17,3,5,2,没有学不到，只有不想学
58753,3681,吴鸿智,2017-09-16 13:54:05,0,3,3,老师认真负责，讲课条理清晰。
58805,3681,吴鸿智,2017-09-18 02:04:33,1,5,4,老师人超级棒！
69223,3681,吴鸿智,2018-01-24 10:27:18,-81,2,83,全学期划水，最后4.8，你说好不好
76722,3681,吴鸿智,2018-04-19 06:23:32,2,4,2,很好，很好的问题\n\n
78987,3681,吴鸿智,2018-05-19 03:26:41,3,5,2,这学期的TA非常非常棒。
81807,3681,吴鸿智,2018-07-06 08:31:34,2,5,3,在计院遇到的最好的老师之一。老师水平很高，而且人也非常nice，同时也非常感谢这门课让我入了图形学的坑。
89479,3681,吴鸿智,2018-11-19 09:07:40,1,2,1,迪达拉哈哈哈哈
97129,3681,吴鸿智,2019-01-21 16:52:59,12,16,4,吾名惠惠，红魔族第一的魔法师兼爆裂魔法的操纵者，好好见识我的力量吧！Explosion!
121207,3681,吴鸿智,2019-12-30 00:41:10,2,8,6,大师风范，可以说无论是水平还是为人都比99%的老师高
131236,3681,吴鸿智,2021-01-26 17:58:51,2,7,5,CG讲的技术真的很现代，老师水平很高，感觉每节课听着都是享受，最后给分也很不错；智能视觉信息采集也很硬核，是真的能学到很多东西
133372,3681,吴鸿智,2021-02-26 11:15:40,1,5,4,老师好帅讲得也引人入胜，可惜课后作业和上课内容关系并不大...(菜狗本狗觉得一学期下来还是挺累人的
133491,3681,吴鸿智,2021-03-01 08:17:43,-1,3,4,一个字，神
141133,3681,吴鸿智,2021-09-25 08:16:11,12,15,3,10分送给助教小姐姐
147034,3681,吴鸿智,2022-01-08 13:24:11,12,14,2,小测一定要好好考，好好准备\n\n作业不能出现大错误，这门课的主要扣分点就在作业和小测\n\n发言不用卷，不占几分，基本3分（3次发言顶天，而且没办法溢出到小测部分）\n\n大作业完成各项任务就差不多了，分差不大，卷这个性价比太低，做得再好小测寄一次就GG\n\n得小测者得天下
147163,3681,吴鸿智,2022-01-09 03:00:16,13,15,2,给分真的差
149170,3681,吴鸿智,2022-01-14 15:23:37,14,17,3,给分差，高投入，低回报
160752,3681,吴鸿智,2022-10-09 13:33:13,-7,0,7,智能视觉的助教很差，讲问题很不耐烦，本来这门课的实验任务老师就讲的不清楚，而且花费的时间很长但却没有什么实际收获，建议非计算机视觉+摄影爱好者慎选
160907,3681,吴鸿智,2022-10-19 05:21:52,6,11,5,老师长得像周杰伦，塞尔达粉丝，第一节课放旷野之息宣传片，建议和原神封面的唐敏老师打一架。讲课深入浅出，能简单把本质讲清楚，很厉害，还会给感兴趣的同学提供实验室实习的机会。唯一的缺点是没有智云，必须去现场听，而且时不时小测，等于其实是要签到的。
161127,3681,吴鸿智,2022-10-28 00:44:55,7,8,1,智能视觉课程难度好大o(╥﹏╥)o，可能我比较菜，，，不知道最后给分如何。我觉得助教很耐心，钉钉上回复也很快。
167116,3681,吴鸿智,2023-01-15 04:02:16,7,9,2,老师很有水平不过感觉没怎么讲出来的样子，很多时候上课听得云里雾里，都是跟着learnopengl学\n\n今年给分还不错
184968,3681,吴鸿智,2023-12-25 01:56:41,10,16,6,快逃
185640,3681,吴鸿智,2024-01-03 08:10:41,-13,3,16,给分还行
185965,3681,吴鸿智,2024-01-06 16:52:36,6,16,10,傻逼东西
186999,3681,吴鸿智,2024-01-14 05:51:42,5,11,6,老师学术水平很高，算是材质领域的顶级学者，上课理论讲解深入浅出，能从数学本质分析图形学问题，知识面很广，但实践部分过时了一点，建议换更新的平台。这学期quiz基本都安排在8点，对没有请过假且晚去的同学不太友好。
187300,3681,吴鸿智,2024-01-15 12:33:39,16,19,3,你说你小测让带a4，可是你不通知什么时候小测，合着我每堂课都要抄满一张a4？\n\n你那个ex人的sb小测，考的稀奇古怪，还洋洋得意地说什么这是中学生的竞赛题，我又不是竞赛生，你ex我干嘛？\n\n你说你大作业给分很好，我们组辛辛苦苦做了半个学期的大程，所有要求全部满足，bonus也做了，上课展示你说效果好，很真实，最后低的很。你说话都前后不一是吧？\n\n上课讲了很多，最后作业就让硬写opengl，我不如听网课。\n\n2.5学分课，让我感觉比5学分的os事都要多，作业留一堆，大程又恶心，纯纯大冤种。高投入，低回报。\n\n抓紧跑，真的逆天这个课。
187736,3681,吴鸿智,2024-01-17 09:11:05,12,14,2,图形学\n\nb事一大堆，给分还不好
188152,3681,吴鸿智,2024-01-18 09:39:57,0,4,4,今年quiz对数学水平要求比较高，不建议数学不好的人选
189260,3681,吴鸿智,2024-01-22 15:45:08,3,5,2,CG 这课事多的真不像2.5分的课，今年基本就是得quiz得天下，quiz有点偏难怪的感觉，给分感觉往上捞了捞，大家酌情选吧。
201151,3681,吴鸿智,2024-10-29 10:52:57,2,5,3,老师水平好像很高，但是作业内容和课堂讲的几乎没啥联系，都要靠自学吗？上课其实感觉也有点水，还经常说PPT不是自己做的，excuse me?这是很值得骄傲的吗？
202743,3681,吴鸿智,2024-11-14 06:14:36,0,0,0,给想入坑图形学的同学一条还算比较可行的自学路径吧：\n\nGAMES101 -> LearnOpenGL（可以跳着看，毕竟最后还是要学Vulkan）-> Vulkan Tutorial（一个类似LearnOpenGL的英文教程，google一搜就能搜到）-> GAMES202（上面这两个顺序其实无所谓）。学完这些就可以去看paper或是引擎源码了，当然上面这些是不涉及计算机动画的。
205462,3681,吴鸿智,2024-12-11 02:19:54,3,4,1,单纯就图形学这门课的作业说一说，给大家一些参考\n\n一共应该是九次小作业加一次大作业\n\n大作业不用说了，用opengl完成一个游戏/demo\n\n小作业分别是用 opengl 绘制椭圆/绘制旗帜/书面作业1（简单变换）/solar system/书面作业2（简单原理解释）/大作业组队交 proposal/dream car/添加光源/添加纹理\n\n单纯从每个作业来说工作量前面还好，后面的工作量相对较大，但是前提是要对 opengl 相应的框架熟悉，说实话没有很好的指导还是很费劲的，而且可上讲的 glut 还是相对过时了，希望以后能给出更多更详细的实验指导
207202,3681,吴鸿智,2024-12-19 18:06:29,7,8,1,大作业好难写（哭）写了一个月了进展也就那样，时间紧任务多，大三一堆专业课一堆实验，根本写不完
207954,3681,吴鸿智,2024-12-25 04:34:19,-4,1,5,很好的老师，教学思想上很注重启迪而不是灌输。留美归来，学术水平很高，也比较关注图形学业界的事情。上课能把很多成熟的应用技术的图形学原理讲明白，让人感觉上课有用不上吃亏，这已经超越90%的老师了。\n\n缺点就是事情确实有点多，小测不提前说，而且还不简单，一般是上课讲过的东西的延申，哪怕准备了cheat paper也不一定会做；平常作业大概一两周一次，有点像为了引导你做出大作业给了你很多阶段性的小任务。\n\n总的来说想水学分拿高绩点的话慎重考虑，选进来之后退课的也有不少人。但如果站在一个零基础的对图形学感兴趣的人的视角，吴老师绝对是你在浙大很难遇到的良师。
208437,3681,吴鸿智,2024-12-27 15:39:11,-3,0,3,神\n\n评价竟然至少3个字。。。\n\n老师讲课很好，内容也有意思，哪怕经常旷课的大三学生也会周周起早八去上\n\n最终学到了很多东西，做完大作业感到非常满足
208996,3681,吴鸿智,2025-01-04 06:32:00,8,9,1,寄，期中没退课是我的错
209004,3681,吴鸿智,2025-01-04 07:11:35,4,6,2,2024-2025秋冬《计算机图形学》\n\n吴老师真的是一个非常有passion和追求的老师，学术水平非常高，是非常有人格魅力的老师。\n\n凭心而论，这门课绝对不是水课，平时作业+大作业的压力也比较大，对于大部分同学来说，不算一门“给分好”的课。（一方面需要能力，一方面需要精力）\n\n同时这门课也不推荐大家来旁听，个人认为课上理论类似上层的指导思想，精髓在于每一次的小作业 + 最后的大作业，不自己上手写代码，真的很难入门图形学。\n\n平时的quiz也不简单，尽管可以看得出来吴老师会悄悄暗示，但题目确实会出人意料。（一个给老师和助教的小建议是，每次小测或许给20min会比较合适，本学期小测时间确实有些紧迫了hhh）\n\n\n\n最后，我仍然推荐大家来选这门课（看重分数的同学请酌情选择），本人上课之前也是0基础，算是很认真在学这门课，也没有投入过分多的精力，因此0基础的同学也不要害怕，相信自己，写代码的话可以参考https://learnopengl-cn.github.io/，个人认为是几乎覆盖这门课的所有代码（除了导入OBJ模型 + Bezier曲面），近乎于是一个非常详细且说人话的实验指导。\n\n\n\n希望吴老师等课题组老师能够把这门课开发成更与时俱进的课程，越来越好！
210264,3681,吴鸿智,2025-01-08 15:07:17,0,3,3,吴老师能把所有内容都以浅显的话语讲得非常清楚（包括数学的推导，比如傅里叶变换基函数、积分的本质等论述非常深入浅出），光这一点已经薄纱你浙计院90%的老师了。\n\n\n\n我在学期开始前粗略学过一遍《GAMES101》，本来以为压力不会太大，从课程知识上确实如此，大部分基本都能很快理解，且吴老师讲的一些新东西能跟《GAMES101》互补（这里也希望老师能更多拓展一些更新、更前沿的东西）。但课程的workload还是出乎我的预料，基本完全自学OpenGL做课程作业与大程，本身OpenGL就过于老旧且略显底层，加上作业和大程工作量非常大，这就让期末大程周非常痛苦（组队也得慎重）。不过现在回头看，感觉还是很有成就感的。\n\n\n\n而且，这学期调课有些多，很多更重要的内容（材质、光照、阴影……）都堆在了最后几周，可能也会间接导致大作业时间不够。另外提个建议，理解老师想要跟同学互动的心情，但在我看来有些问题的设置过多、过于浅显了，虽然也算是给同学们提供加分的机会吧，但其实挺拖课堂节奏的，可以考虑适当减少一些\n\n\n\nPS：不管是课程主页的塞尔达，还是大程展示时的点评，可以感觉出来老师游戏品味也很不错（逃
218587,3681,吴鸿智,2025-04-25 11:33:43,4,5,1,自以为是 云里雾里
218788,3681,吴鸿智,2025-05-05 16:19:16,4,5,1,这个课讲的都是过时的东西，不与时俱进。
218982,3681,吴鸿智,2025-05-16 07:53:36,2,3,1,傻逼东西
219684,3681,吴鸿智,2025-06-04 06:51:12,1,1,0,24-25年初上的计算机图形学课程。吴老师学术水平很强，能把图形学那些深奥的数学原理和渲染技术讲得明白，也会引导你去理解“为什么”，在计算机图形学这门课里你能真切感受到图形学在游戏等领域的实际应用魅力。\n\n这门课也真心硬核，想水是不可能的。很多小作业加一个期末大项目（用OpenGL做游戏/Demo），工作量不小，结果导向，这种挑战确实能对于入坑图形学有所广益。我印象最深的就是期末那四天，基本是通宵达旦肝大作业，虽然辛苦到爆，但代码从无到有、看着自己的“小世界”跑起来那一刻，成就感炸裂， 测验也不轻松，时间经常卡得紧巴巴，总体来看，得分和收获都对得起投入。\n\n强烈推荐给未来想投身游戏开发的同学！ 这门课的实践强度和内容（从基础绘制到光照、纹理、动画），就是游戏引擎渲染管线的核心缩影。经历过这个大作业的“洗礼”，再去面试游戏公司的图形/引擎岗，可以直接聊项目，非常非常有用（亲测有大用）。零基础别怕（learningOpenGl认真跟着学，大作业其实真的每页那么困难），认真投入就能跟上，但务必做好“痛并快乐着”的心理准备，收获对得起你的付出。\n\n总结一下：硬核，但有收获，对于未来想投身游戏开发的同学，很建议选这门课。
30862,3692,张寅,2016-07-02 16:38:03,0,6,6,大规模。很好的老师，作业DDL很宽，给分还不知道。平时太多人翘课就点点名给到的人加分。
31337,3692,张寅,2016-07-03 16:21:12,-1,5,6,大规模给分超好啊，而且论文ddl很宽，还一直帮我们往后拖，鼓励没交的同学不要弃疗→_→。上课有时候会打开qq到群里说几句调侃一下没来的大神←_←点名给来了的人加分，没来的也不扣分。
37930,3692,张寅,2016-11-22 08:18:10,4,8,4,上课简直了，随便换课、读他自己也看不懂的PPT，大学老师的工资也太好赚了。
45560,3692,张寅,2017-01-19 21:20:20,-1,2,3,智能终端给分好良心啊啊啊
51537,3692,张寅,2017-06-07 03:30:05,4,5,1,给分还好，作业所有老师里最多的
54046,3692,张寅,2017-06-28 10:00:52,-1,3,4,老师人超级好啊~
56319,3692,张寅,2017-07-03 13:13:07,0,4,4,经常会坑人啊
79484,3692,张寅,2018-06-06 12:17:34,9,10,1,比较想知道他的小学期怎么样
80066,3692,张寅,2018-06-19 12:05:58,-1,3,4,大规模课程安排不太合理，cuda不先装环境就开始讲也很迷，以后调到大三可能会好些。但老师真的很好，下课缠着老师问问题回答特别耐心。
84752,3692,张寅,2018-07-13 20:24:15,-4,1,5,点名狂魔 课太难基本没人听 做的cuda比较难 但相比软工其他课算少的了 给分又被卡了很难受 老师感觉人很好
85605,3692,张寅,2018-07-21 00:46:18,-5,1,6,小学期上助教和学生共同冒险，也是很有教育性意义了
87186,3692,张寅,2018-09-21 13:11:58,-7,2,9,小学期的课老师很nice和助教都认真，虽然要做的实验比较多但是很有收获！\n\n老师很平易近人的，可以多交流～
108225,3692,张寅,2019-05-17 00:27:02,18,24,6,我的到课率比老师高系列……
109094,3692,张寅,2019-06-08 04:18:51,7,9,2,一分是因为不能再低了，其他课我不知道，就大规模一门，上课到场率老师比我还低，作业巨多，一个夏学期还分期中期末，最后剩三周说来一个期中作业?我服了。本来这门课大二就没学什么本应该大三学的专业，然后被强制预置，老师自己知道我们都没学过什么，就不能体谅体谅出点能做的?最后忠告：慎选，不然你会被恶心到。
109095,3692,张寅,2019-07-07 05:35:55,13,18,5,老师人真的很好，最后给所有人语音或线下答疑这一点确实很负责任。只能说学院排课不合理吧，老师其实也很无奈，想让课不显得那么水，让大家多少能学点东西。其实话说回来，单纯依据事情多少或给分来评判一个老师是很不公平的，也希望大家不要那么功利吧。有问题多找老师，而不是一味地发牢骚。
109096,3692,张寅,2019-06-08 05:55:19,11,12,1,这作业nm是人做的？lwm老师一样的课就两篇报告，上课从来不讲就放没字幕的英文视频，发几篇源代码就指望全学会了？
109120,3692,张寅,2019-06-09 09:23:35,-57,1,58,张老师大好人，这周留的GPU编程好像所有人都不会，碰巧我们srtp做的这个，两天做好，估计大规模期末满绩稳了
109611,3692,张寅,2019-07-07 02:11:08,1,3,2,人确实挺好的，最后大家不会做编程作业，语音答疑。只不过可能比较随性，上课也经常迟到，教学上也没有比较好的规划。最后这个编程作业一再改低要求，但是之前没讲过真不会啊
111182,3692,张寅,2019-06-30 10:41:26,0,2,2,这个编程作业真的吃不消，完全没基础，在期末那么多大作业的基础上实在没法抽出时间来做。老师放英文视频真的，没啥意义。到课率确实不太高。总之，隔壁lwm更好吧。
114912,3692,张寅,2019-07-12 17:12:50,0,3,3,人真的很好 给分也挺不错的
126248,3692,张寅,2020-09-21 01:30:39,4,4,0,讲的什么东西
140213,3692,张寅,2021-09-05 07:43:55,4,4,0,1分给字节跳动的打分老师，有一半的人大程分数只有50%，算下来就是有一半的人绩点从4.2开始往下走。字节的老师打分真的很严格，快逃！
140220,3692,张寅,2021-09-06 03:35:26,5,5,0,短学期下来的感受就是，别从头开始搭app，那样吃力不讨好，不如直接找现成的改一改，反正评委老师都是胡乱打分……
151924,3692,张寅,2022-03-25 10:24:33,1,1,0,连着4次课点名。。。\n\n-----------------------------------\n\n更新：5次了
152296,3692,张寅,2022-04-02 02:58:47,4,4,0,这学期大规模到今天上了11次课，点了7次名（从某次课开始几乎次次点名），这点名频率，属于是在向体育课学习了。隔壁班lwm被吐槽点名的时候，我只想说zy才是名副其实的点名一哥。\n\n但主要还是这门课上课的内容太无聊的原因，想留住人也只能靠点名了。
154573,3692,张寅,2022-06-02 07:33:34,-2,0,2,好！
157216,3692,张寅,2022-06-22 10:51:01,2,2,0,大规模虽然每节课点名，不过老师最后告诉我们点名是为了排除掉教评系统里总是不去上课还给老师打低分的人。\n\n点名似乎不影响成绩，最后只要认真写分数就不会低，但是大概也不会给特别高的分数。\n\n验收的时候老师会和大家聊天，感觉老师对于这门课也有不少无奈和心酸……
170804,3692,张寅,2023-03-10 03:06:23,2,2,0,这学期zy好像改过自新了，目前一次名没点
174703,3692,张寅,2023-06-16 03:38:25,0,0,0,老师给分还行，人也挺有趣负责的
174784,3692,张寅,2023-06-18 02:24:51,0,0,0,2023 spring update：平时不点名，16次课总共点两次，每次都会提前一天通知。大作业给分挺好，基础功能实现了就行。
219875,3692,张寅,2025-06-09 12:53:20,0,0,0,给分随意并且太差
219984,3692,张寅,2025-06-13 06:01:09,0,0,0,给分我个人觉得一般化，感觉不会很高，然后就是验收的时候很随意，一会聊聊天，一会又突然问问这个，PPT上要求实现的功能也不问，也不看，也不知道是怎么确定得分的
220470,3692,张寅,2025-06-18 05:47:51,0,0,0,周边统计学感觉给分比隔壁班差很多。这个学期好像没有点名，大规模慎选，作业任务给的比较模糊全程做的有点懵，大规模验收和隔壁班两个标准，被拷打了一番。
65338,3708,代建华,2018-01-03 06:17:44,0,0,0,，。。
25201,3720,陶煜波,2016-05-08 01:20:10,20,20,0,地理空间数据库作业好多好多好多好多，课本身还不错。。有几次quiz。爱穿格子衫背双肩包\n\n
26371,3720,陶煜波,2016-06-17 07:10:16,7,7,0,听不懂，但是老师挺好的
51330,3720,陶煜波,2017-05-31 14:29:34,8,8,0,老师讲课很快，但是内容很充实～
51375,3720,陶煜波,2017-06-02 13:40:04,7,7,0,为陶老师疯狂打call！！！\n\n超nice的老师
51533,3720,陶煜波,2017-06-07 03:19:12,23,23,0,老师很厉害人也很好有问必答 就是作业很难 每次都做好久好久好久 做到绝望
54516,3720,陶煜波,2017-06-29 13:01:27,6,6,0,作业是真的厉害了，你做你知道～地信的学弟妹们你值得拥有
75324,3720,陶煜波,2018-03-09 02:29:23,9,10,1,老师超厉害，语速较快，蛋智商很高
77772,3720,陶煜波,2018-05-07 15:48:22,2,2,0,很不错。
82416,3720,陶煜波,2018-07-08 06:43:26,37,42,5,学生时代躬耕浙大十年，学成归来继续回报浙大。为人谦逊和善，学术海纳江河。
84214,3720,陶煜波,2018-07-12 08:57:30,0,1,1,陶老师真的超级超级认真！上大学以后就没见过这么认真的老师！虽然作业是真的多，但也挺有收获的！还有以后的sdb学分变少了以后事情应该会少一点..
123201,3720,陶煜波,2020-05-19 06:31:58,5,5,0,陶老师真的是非常厉害，负责，尤其是在对比了whh老师，我真的是感叹真是神仙老师了，讲课非常细致求是。
134919,3720,陶煜波,2021-04-22 10:40:36,60,85,25,第一年将C大程，上课速度极快，以至于都口吐白沫，图形设计等知识几乎没怎么讲就作业压下来，没什么基础的人上他的课完全就是一步步走向绝望的过程，只能说老师个人专业知识水平太高，没什么基础的学生不配上您的课！
135917,3720,陶煜波,2021-07-11 03:53:48,14,17,3,陶老师上课很认真，很专注，但是前紧后松，很多内容讲不明白，理论课上偶尔会有几次在下课的时候进行课堂小测用来检测并点名。\n\n陶老师作业挺难的，挺多的，他的上机课签到会提前通知。\n\n陶老师自己的大程考试难度，和其他班级相比要难非常多，所以如果为了自己的绩点，尽量不要选，去选 王建江 的吧，他的考试是往届原题。 \n\n虽然陶老师的大程考试一道我也没做出来，但还是感谢陶老师的教诲。最后给分还不错
135924,3720,陶煜波,2021-06-03 09:47:02,15,15,0,陶老师知识储备真的很足，很多问题都会努力帮你解决，记得有一次因为我说了一句可能图形库不太对，他专门对图形库进行了大量的压力测试，最后我才发现我自己程序写错了，反正就是很感动，也许有些同学会说他上课讲的东西很难，但我觉得上了他的课后感觉很多知识都升华了，上课听不懂就按着自己听，努力听，使劲听，在听不懂就看智云，去钉钉问他，你能学到很多都。如果觉得真的需要学本领的我是很推荐的。
136175,3720,陶煜波,2021-06-12 02:07:46,5,7,2,c大程，老师讲的有点快而且不是很清晰的样子，也可能与这门课本身的难度有关，真的劝大家一句，这东西非常依赖自学，不然只能绝望！（含泪
138868,3720,陶煜波,2021-07-11 11:42:54,4,6,2,虽然上课真的有点跟不上语速，也不是很懂啦，不过好像大部分老师也都是这样的，大不自多！！！\n\n给分真的不错，超出预期了...期中考满分50理论加上机一共只拿了个位数的分，但是总评85了，感动子！！！谢谢老师捞捞！！！
140661,3720,陶煜波,2021-09-15 02:32:47,3,4,1,未免讲的太快了，没基础听着真的绝望😭😭😭
143663,3720,陶煜波,2021-11-30 18:34:52,2,2,0,地理空间数据库好课
146037,3720,陶煜波,2022-01-05 07:39:52,9,9,0,捞捞我吧
146065,3720,陶煜波,2022-01-05 09:58:02,5,5,0,非常非常非常耐心细心的老师，下午刚考完c程就来了，真的很耐心，钉钉问问题秒回，而且很耐心。语速虽然比较快，但是收获真的很大！
149617,3720,陶煜波,2022-01-16 08:06:41,2,2,0,地理空间数据库真的绝顶好课！！！
149622,3720,陶煜波,2022-01-16 08:25:16,10,10,0,c程序设计基础 上课速度快，讲的内容多，所以需要课下花大量时间巩固，但是这也恰好鞭策自己努力学吧？课后作业也很难，好多要查csdn。 总之对小白可能非常不友好，但是只要最后不掉队，收获是非常大的！
149645,3720,陶煜波,2022-01-16 09:22:20,5,6,1,题目很难，作业要花很多时间 而且我个人感觉给分挺求是的
151192,3720,陶煜波,2022-02-24 08:11:03,5,5,0,人很好，我觉得，而且很厉害
151359,3720,陶煜波,2022-03-01 09:50:46,12,12,0,上过那么多课，这个老师讲的最多，而且还是帮你讲的，只能说标准的好老师的
151525,3720,陶煜波,2022-03-07 01:39:36,17,18,1,只能说煜波老哥牛逼，真能学到东西，只是确实得花时间消化
154579,3720,陶煜波,2022-06-02 08:04:20,7,7,0,tyb老师可以说是很为学生着想的老师了，私信基本上都会得到及时回复，pta作业会不断调整ddl，给的提示也会越来越多。不过他的大程确实难度会高一些，但是能学到东西。把布置的作业全部认真做完后，做期末大程序的时候能轻松许多
156816,3720,陶煜波,2022-06-21 04:27:04,10,10,0,我爱波波！
157238,3720,陶煜波,2022-06-22 13:24:24,9,9,0,给分很棒 非常为学生着想 快到ddl时甚至会把ddl时间往后推
157628,3720,陶煜波,2022-06-24 05:47:50,1,2,1,好棒的老师，问问题会耐心解答而且真的是我见过回复最及时的老师了，平时作业考试设置都很为同学着想，课程讲的真的很清楚很明白，必须10分！
158909,3720,陶煜波,2022-07-03 07:37:31,5,7,2,他真的好，我哭死
160954,3720,陶煜波,2022-10-20 15:53:23,1,1,0,好老师，虽然课上的内容很多，pta比较难，但是认真做了会有收获，老师也会延长ddl（期中的时候还延长了十分钟，虽然我还是没写出来），课下问问题也会及时回复，满分
161438,3720,陶煜波,2022-11-07 03:21:53,5,5,0,会很认真的回答学生的问题
165747,3720,陶煜波,2023-01-09 13:23:19,2,2,0,老师人很好，问问题回复消息很及时
166308,3720,陶煜波,2023-01-12 01:52:04,3,3,0,上了老师的c小，来评价一下。\n\n陶老师上课语速比较快，容易有点结巴，但是课的内容还是很好的，很细致。\n\n在钉钉上问陶老师问题，回复的非常非常快，很及时很耐心。\n\n老师的平时作业和小测难度大，但是如果能把作业题，小测搞定，期末考难度就是洒洒水罢了。\n\n最后虽然成绩很菜（自己小测每次都很垃圾），但是还是要给老师一个好评，我认为陶老师的课更适合有一定基础的同学。
166355,3720,陶煜波,2023-01-12 05:13:04,3,3,0,以前学过一点oi所以上课有时候挺划水，但是老师上课真的很细致。作业和小测难度是挺大的，对0基础同学可能不太友好。平时分估计满了实验两题满理论80分左右，最后4.8。总的来说肯定是很好的老师！
166620,3720,陶煜波,2023-01-13 04:30:02,1,1,0,内容全面，作业有一定难度
166714,3720,陶煜波,2023-01-13 09:36:12,3,3,0,老师人超级好，钉钉回复问题是真的快，回复也很细致。但是上课确实有些快又枯燥，需要好好预习。我一开始就是有点跟不上第一次小测寄了，但后面用老师的ppt和回放复习一直在进步。比较适合学习习惯比较好的同学选吧
169210,3720,陶煜波,2023-02-24 16:00:18,2,2,0,老师很负责，对学生很友好，大赞！最后94分4.8，差点满\n\n学过oi，个人感觉老师前两三节课讲得有些快有些抽象，或许对小白不太友好，比如一上来就用函数，讲一些堆栈的原理之类的。不过之后节奏就慢下来了。有些东西没听懂仅对c小也无关紧要。\n\n本来觉得老师可能是科研型，讲课没有那么厉害，但看了其他老师的课后……没有wk就来冲tyb吧没错的
170063,3720,陶煜波,2023-03-01 07:34:38,4,4,0,c小讲课感觉有一点小紧张，大多时候也是照本宣科在念ppt，这是缺点\n\n发自内心想要提高学生对计算机结构的了解，有时也会把英文版数据储存的堆栈图发在群里，还会分享一些链接，这是优点\n\n综上，如果你水平不够高，那你从这位老师上能获得的东西也会很少
170142,3720,陶煜波,2023-03-01 13:52:55,18,18,0,【地理空间数据库】2022-2023秋冬\n\n笑死了，看了一圈都是大小程在那评价，我地信学弟学妹能看到的sdb热评居然是16年的\n\n只能说陶老师和本学院那群老头老太相比已经胜出太多了，不管这门课是选修还是必修，强烈建议学弟学妹们选！（真心想混日子的算了）\n\n陶老师的语速确实一开始比较难以适应，但是听多了之后其实也还行。而且老师可以做到几乎24小时五分钟内回钉钉！助教也很好，如果作业有问题都可以问\n\n每次作业都是有简单有困难甚至有附加的组合，贴近国外课程作业的设计且会年年根据现状和上一届的反馈更新\n\n小测的话认真学的话两次机会保底9分应该没啥问题\n\n大作业比较复杂但是认真理解了上课内容看懂代码框架的话也不会很难\n\n考试完全就是吃透小测和作业，我只能说如果你作业是自己做的，小测都复习过了的话，考个85+的高分应该是没有问题的\n\n不要过分担心小测扣点分，额外加分机会很多，最后大家平时分基本都是50或接近50的。最后出分群里感谢老师的有一半以上。
171548,3720,陶煜波,2023-03-28 10:44:58,9,9,0,真的巨好，能学到很多东西，点名会提前在群里说，入校以来遇到过的最好的老师
173016,3720,陶煜波,2023-05-11 09:48:45,4,5,1,超级超级好的老师，讲课虽然一开始感觉有点快，但是能学到很多东西，答疑非常及时，助教人也很好，作业大家没完成也会延后ddl，点名还会提前说，可以看得出来水平也很好，超级超级好！
173736,3720,陶煜波,2023-06-02 05:22:39,6,6,0,tyb老师讲课挺快的，但是如果提前看ppt是完全能跟上的。上课会突然叫人回答问题，不过答不出来也不要紧。他每次pta都改ddl，看同学写不完会往后延期。为人和善。
174137,3720,陶煜波,2023-06-06 13:31:08,-2,6,8,上课自顾自讲课，完全听不懂，随时小测
175645,3720,陶煜波,2023-06-26 04:23:38,4,5,1,超级好的老师，两个助教gg也特别特别好。没有小测（记忆里应该没有），点名会在群里提前说，讲课一开始可能感觉有一点点快，但是如果先预习一下ppt的话完全没问题，而且每节上机课都会来机房，真的太感动了，钉钉答疑也回复特别快，而且特别为我们着想，如果真的来不及会适当延后ddl，两个助教gg也特别耐心，班级里互评氛围也很好，真的是非常好的老师啊。
176284,3720,陶煜波,2023-06-28 08:52:58,4,4,0,老师人不错，会延后作业ddl，点名会提前通知，上级可以不去。但是考试爆难。期中这个难度一点不调分。最后私戳了助教问分数，真的一分都没捞。但是总体还行吧，给个8分。
176618,3720,陶煜波,2023-06-29 12:45:33,0,1,1,C大，基本不点名，有时候会抽人起来回答问题（一学期总共三四次，每次只抽一两个），学在浙大点名会提前通知。\n\n老师讲课速度很快，本人高中选了技术没参加过竞赛听起来吃力，建议课前预习PPT，做作业复习PPT，有问题可以问陶老师，陶老师回复很快而且追问也有耐心。\n\n作业任务交代的很清楚，总体作业量中规中矩吧。\n\n给分应该算不错，本人最后两次作业只拿了60%左右的分数，前面的作业拿了95%的分数，期中考的很差，但是大作业有九十分，最后喜提4.5
178264,3720,陶煜波,2023-07-09 05:27:25,1,2,1,陶老师一开始我也会因为上课有点跟不上而内心埋怨，不过后续感觉慢慢会适应。所以还是建议同学们要看看老师课前提前发群里的ppt做好预习。\n\n给分方面，陶老师绝对没问题的，大作业什么的比隔壁班要好很多。平时回答问题也很热情，会很细致的回答，能够感受到老师是真的想教一些东西的。\n\n点名一学期也就点个几次，上机课我印象中没有点过名，还是很好的。\n\n极力推荐。
181848,3720,陶煜波,2023-11-02 07:18:45,7,7,0,上课讲的飞快，以至于口吐白沫，嘴角始终挂着一点白，问问题即使同学没回答出来也不会考虑再详细讲讲这个知识点，还是接着讲下一章，人品很好，对同学很好，回答问题十分及时，但对于对编程接触不多的小白，。真的很不友好！！！
184798,3720,陶煜波,2023-12-23 01:55:28,-3,3,6,C尖，10分推荐。\n\n一学期就点两三次名，每次点名都会提前在群里通知。\n\n小测理论题会稍难，但是实验题会多一套用于补理论题的分数（即一场满分115分，很容易刷满）\n\n有什么问题都会仔细解答，课件和课后都会补充一些英语的资料供进一步了解。\n\n在讲解一些典型程序时候会用课件模拟出程序执行时的变量和堆栈，这点非常细心，必须点赞！
185762,3720,陶煜波,2024-01-04 07:39:59,4,4,0,建议0基础别选 题目很难 容易把心态搞不好 如果有一定基础或者天赋的话tyb老师还是很适合的
185916,3720,陶煜波,2024-01-06 04:21:32,2,2,0,神仙老师，钉钉每次都是秒回，怎么会有这么好的老师，对学生也都很和善，很认真，而且上他的课真的能学到很多东西，必须10分
187243,3720,陶煜波,2024-01-15 09:57:10,4,4,0,永远都是秒回，因为手误教学评价打了1分，真的非常非常不好意思，特别特别好的老师，强推
187376,3720,陶煜波,2024-01-15 16:44:32,0,2,2,地理空间数据库满了，再来感谢一下老师
187462,3720,陶煜波,2024-01-16 08:24:50,3,4,1,神中神！人巨友善，消息回的巨及时，问题解释的非常清晰，学在浙大上的文件又全面又具体。地理空间数据库一定要好好学，补天真的很难补完，读了几年下来感觉收获最多的一门课，没考高确实是自己的问题。
188069,3720,陶煜波,2024-01-18 06:48:50,5,5,0,c尖，无脑冲就完事了，非常好，回问题的速度非常快，很耐心，这是目前接触的大学主讲老师里最亲民的老师了，难度确实很大，小测和作业比室友都难好几倍，但是能学到很多东西，最后给分也很不错，成功满了，很不错的老师
188354,3720,陶煜波,2024-01-18 17:43:16,3,4,1,超级好的一位老师，上课几乎不点名，整个秋冬学期只点过一次而且还会提前通知，上机课做完上机作业就可以提前走，每次问他问题都会耐心做出解答。虽然每次小测和作业的题目又多又难，需要花大量时间，但是也学到了很多东西。给分非常好，简直出乎意料，让我一个预计4.5的人成功拿到满绩（感觉每次小测都考的一般。总体来说，上这个老师的课，你需要认认真真地花心思和时间去学，虽然过程比较痛苦，但是绝对物有所值
188462,3720,陶煜波,2024-01-19 04:40:53,4,4,0,点名会通知，c尖本身比较难，老师很努力想让人搞懂，问问题回的很及时，PPT做的很清楚，给分也不错，被狠狠捞了呜呜老师我爱你
188481,3720,陶煜波,2024-01-19 05:22:01,5,6,1,喜提满绩，给分真的好！！！虽然小测和作业都很难（本人小测成绩78+30，73+30，68+22，60+30，供参考，前面满分100后面实验题满分30），但是到后面会把小测满分设置成100分（比如说最后一次小测满分就是100分但是实际分值有130分，其实是比较容易刷满了，但是本人太菜了=.=）课外补充的内容很多，很早就会开始介绍堆栈相关的原理。上课确实讲的很快需要提前预习。平常基本上不点名，唯一一次点名是在第一次小测之后而且会提前通知要点名。钉钉回复很快很耐心，助教也不错！总之冲就完事儿了！
188705,3720,陶煜波,2024-01-19 15:40:40,1,1,0,老师很好，会延ddl，钉钉上及时回信息。助教老师也很负责👍
188991,3720,陶煜波,2024-01-21 05:16:10,7,8,1,C尖。\n\n（1）关于点名：上课只点过一次名，而且是在钉钉群提前通知的；\n\n（2）关于小测：难度确实很大，是别的班的几倍，而且都是完整的理论考试+实验考试，每次考试大概100分钟左右；\n\n（3）关于作业：作业题量中等，但部分题目也具有一定难度，有些程序题是陶老师原创的，可能连csdn上都抄不出来，这时候就要借助万能的chatgpt；\n\n（4）关于课堂：上课进度与别的班持平，但陶老师会补充一些内容；\n\n（5）关于老师和助教：老师和助教真的非常用心，回复钉钉问题几乎秒回，虽然陶老师课程难度较大，但老师真的会竭力想让你学明白，不想让它成为一门水课；\n\n（6）关于给分：平时小测由于难度较大，因此会有附加题使小测总分超出100分，虽然学起来比别的班吃力一些，但陶老师给分超好，相信自己努力一定会有回报！\n\n（7）其他：如果确实对编程非常不自信的同学，还是建议其他老师，如果是浙江选考基础或者竞赛生，冲就完事了！
197899,3720,陶煜波,2024-08-20 07:58:55,1,1,0,上的最后一届C大，好老师啊，老师思维比较快，同时课上会有深层次的东西，且老师偶尔点名（答不上来也没事），所以还是得上课好好听，C大给分很好
198925,3720,陶煜波,2024-09-13 02:47:48,1,2,1,老师语速很快，但是认真上课的话真的有收获的。课程干货多且不水，上课随机点幸运同学起来回答问题。
200576,3720,陶煜波,2024-10-19 14:32:01,-2,5,7,口吃的太严重了，根本没办法听
200873,3720,陶煜波,2024-10-24 01:27:04,4,4,0,不是啊前面说口吃的哥们，我真的感觉就是因为老师脑子转的太快了，嘴跟不上脑子导致的。听了一节陶老师的课，跟开了倍速似的。感觉老师授课内容丰富，会补充一些有用的东西。如果觉得陶老师讲的快的话可以去隔壁的zhf老师的班里面去听听，那位老师是真正的小白友好型的老师。
201338,3720,陶煜波,2024-11-01 01:52:25,2,2,0,WGN：10分\n\n大师级的谜题设计和极其优秀的难度曲线\n\n以及细心细致的指引\n\n没有完美的老师，但给10分代表着对老师的崇高敬意
205473,3720,陶煜波,2024-12-07 08:31:09,-3,0,3,hhh
207983,3720,陶煜波,2024-12-25 06:35:01,1,4,3,快逃，对小白很不友好
208577,3720,陶煜波,2024-12-29 14:33:55,5,5,0,感谢陶老师，老师人真的很好的，有问必答，甚至秒回，讲课非常细致，备课极其认真，从他身上学到了好多东西。希望以后还能遇到像这样优秀负责的老师
210515,3720,陶煜波,2025-01-09 09:51:29,4,4,0,老师给分太好了，实验考补考还能上4.5，伟大！！
210516,3720,陶煜波,2025-01-09 09:51:32,2,2,0,被狠狠捞了，我爱陶老师😭😭😭
210517,3720,陶煜波,2025-01-09 09:52:37,3,3,0,老师真的超好超捞！\n\n上课语速偏快，有些评论说的口吃我没感觉到；知识点讲解很详细，ppt很清晰完整，还有额外补充的知识点；答疑非常及时，而且很耐心；补充资料很多，每节课后都有知识点总结和重难点分析。\n\n小测难度不算特别大，不过我比较菜，得分不高；然而老师每次都有bonus（实验题额外加分，加总分），所以最后小测基本是满的。\n\n作业不算很多，主要是理论题。期末作业分赋分，基本都是满的。\n\n对学生很好很体贴，超级感谢老师的bonus！！！捞我到了满绩！！本人基础不算好，但是还是收获了很多！\n\n感谢老师！当初是1:15的概率幸运地上到了tyb的课，感谢遇见！
210527,3720,陶煜波,2025-01-09 10:02:03,0,2,2,讲课口吃，对小白很不友好，小测很难
210533,3720,陶煜波,2025-01-09 10:07:53,3,3,0,陶老师讲课非常认真细致，会拓展很多知识点。钉钉上答疑基本什么时候问都是秒回。平时作业也不会太多。期末给分也很好！总之冲就完了！！！
210583,3720,陶煜波,2025-01-09 11:41:41,3,3,0,大一小登，期末4.8，来说一说陶老师的c尖。\n\n我的学习情况：前一个月完全没好好学，一部分是过于相信自己的自学能力导致很多东西没弄懂；还有就是我上课不太能跟上，尤其是座位靠后时，个子较矮看不到课件TT，有时候也听不清老师说话TT。在经历了第一次惨败的小测（实验题0道，理论考低于均分）和第二次惨败的小测（实验题1道，理论考低于均分）后开始认真学。有两次小测考的不错，并且获得是实验考满分TT，最后的理论考也准备充分，基本都能做。\n\n缺点：老师上课语速很快，我经常跟不上，上课内容和小测难度较大（课程有很多拓展内容，这点可以是优点，对于学有余力的同学，确实很有帮助），故慎选\n\n上课可能会随机点同学回答（我上次被选中当场敲代码TT好紧张）\n\n优点：钉钉上答疑秒回，回答有时候不会直接回答，而是会提出问题引导你思考或者实践，对知识巩固很有帮助。\n\n每次上课后或者小测前，都会很仔细的在钉钉群里编辑上课的重点内容和小测的重点知识和细节，干货很多。\n\n前面提到，上课内容比较难，但是能真的学到东西，我这一学期收获很大。\n\n老师不咋点名，就算偶尔被发现没来老师也不会怎么你。\n\n老师很欢迎对计算机有兴趣的同学未来找他做科研。\n\n总之，非常感谢煜波老师，这一学期真的收获很大！
210596,3720,陶煜波,2025-01-09 11:50:22,0,0,0,被老师捞了，前来还愿🙏\n\n老师很好，教的很负责，但是确实更适合基础好的人，感觉小测难度有点大（大概也是因为我太菜了）
210599,3720,陶煜波,2025-01-09 11:53:04,0,0,0,tyb! yyds!!!老师上课难 但是可以学到很多东西！而且期末还被捞了（泪目！
210615,3720,陶煜波,2025-01-09 12:33:45,1,1,0,感谢陶老师赐给我人生第一个满绩！\n\nlz是浙江人有Python学考基础，一开始到第五章的时候都觉得挺简单的，但是后面第六到八章开始觉得有些跟起来累（到期末复习的时候慢慢补回来的）。\n\n个人感觉0编程基础但是愿意努力的uu们可以大胆报陶老师的班，陶老师解答问题很及时，会一针见血指出lz的问题（一定要大胆向老师助教提问口牙）。
210628,3720,陶煜波,2025-01-09 13:12:29,1,1,0,tyb真的是我见过最认真负责的老师，钉钉问问题必在五分钟内有回复，上课速度是快了点，很多内容需要靠课后作业，查csdn和问老师来理解消化，小测一共4次，理论题是比较难的，哪怕是像我这种有信竞基础的也有很多专门考语法的题不会做，所以要经常去问，去实操出真知，但是会有5道实验题来补分，所以最后小测部分的成绩不会很难看。最后拿到了98 5.0，可以说既意满离又收获颇丰，爱死tyb老师了(♡ω♡ ) ~♪
210657,3720,陶煜波,2025-01-09 14:46:09,0,0,0,陶煜波老师真的很好，知识超级渊博，并且有问必答，很耐心，讲课速度略快，但是自己认真消化真的能学到很多很多，无脑冲！
210941,3720,陶煜波,2025-01-10 08:14:29,-7,0,7,卡绩，慎选
211025,3720,陶煜波,2025-01-10 10:56:41,3,3,0,如果c程对你专业或未来发展很重要，冲就对了！老师极其负责，作业小测题难但讲解透澈，回复及时准确，是真能学到东西的。但如果你只是要修c程求个好看的绩点来转专业等等，建议慎重，因为陶老师班里大神莫名其妙有点多，优秀率30%等限制，和小测作业太难你排名靠后可能会受影响。（对了，作业很多，但题目质量贼高！）
211695,3720,陶煜波,2025-01-12 07:59:42,2,2,0,我是一个编程小白，陶老师的课真的很好，不仅能学到东西而且给分很好。只要你认真听讲，老师上课会点人回答问题，作业每次都认真完成，不会的积极搞懂，小测难但是会有作业原题，本人小测其实排名并不高，第三次小测40多分，实验考是一道满分，但是期末理论考的比较好老师还是给捞到4.8了。小白如果想滑水还想要个好点的分就别来了，如果想用心学，想学到东西的，在陶老师这你一定能有个好成绩，包可以的！
212056,3720,陶煜波,2025-01-13 06:51:08,1,1,0,老师非常好，讲的知识点非常全面，但是小测比较难，理论60多，实验题容易全炸（就是我），作业量略多。给分感觉非常好，我以为炸了，我觉得应该是捞了，居然还有95，谢谢谢谢
212109,3720,陶煜波,2025-01-13 07:48:25,1,1,0,地理空间数据库\n\n期末试卷超级难\n\n但是绝对是大放水地去改
212896,3720,陶煜波,2025-01-15 07:52:07,1,1,0,非常非常好的老师！自己水平很高，讲课清晰透彻，会提前发PPT，钉钉答疑秒回，作业会发提示和提醒并且ddl每次都延。对比其他老师，平时作业多且难，小测理论也难。但功在平时，期末时你就知道好了，别的班同学甚至会来要陶老师的小测作业题。给分极好，小测平均60多分最后也给了4.8。总之，完全是好老师的标准，感谢！
219059,3720,陶煜波,2025-05-20 05:53:08,0,0,0,非常耐心负责，认真听课可以额外有所收获
219724,3720,陶煜波,2025-06-05 01:30:52,0,0,0,陶老师上课非常精彩，讲的很清楚（虽然可能有点快哈哈哈哈），但是自己课后消化+课前预习+认真完成作业，学好是没有问题的！而且陶老师布置的作业中的选择判断虽然有点多但是确实是对后期考试很有用的！本人高中没选技术，平时各种小测一般，实验考试重考考过的，估计是理论考拿分比较高，最终4.8 所以说认真学都是可以获得很好的成绩的！
221587,3720,陶煜波,2025-06-24 16:38:07,0,0,0,有问必答，好老师。
79965,3748,赵洲,2019-03-04 06:11:29,3,9,6,没上过课 但是毕设带了一堆大佬
85376,3748,赵洲,2018-07-17 09:37:38,11,27,16,上课水，讲不清东西；大作业事情特别多，最后还给挂真的是无语了。大家千万不要选
86564,3748,赵洲,2018-09-17 07:57:41,2,6,4,非常棒
86816,3748,赵洲,2018-09-19 02:19:51,2,5,3,好像很强
129173,3748,赵洲,2020-12-31 02:08:21,29,55,26,哎，你们这些人，看老师只看教学水平吗?\n\n都大三了，人赵老师每年30+篇的CCF-A了解一下?\n\n好好上课混个脸熟然后进实验室发篇A比啥不强些，真是功利都功利不到点子上
135629,3748,赵洲,2021-05-17 09:01:40,4,7,3,细枝末节的印象：\n\n老师的逗猫激光笔\n\n击穿！击穿！击穿！\n\n是真的厉害，就是有时候一句话重复很多遍有些让人思路跟不上（
136799,3748,赵洲,2021-06-25 00:37:54,3,3,0,上了赵老师的ML。\n\n给分好，和大家商量好所有点名只在最后几次课连着点。\n\n上课语速有时很快，人比较和善。
138845,3748,赵洲,2021-07-11 07:31:05,1,2,1,ML只有期末的报告，老师是想让我们准备时间久一点但是我所知道的大家还都是一个月内肝出来的2333，给分巨好。
139576,3748,赵洲,2021-07-17 13:26:36,3,4,1,上了机器学习与应用，每节课都要签到。赵洲老师每节课间都会来push，对社恐有点不友好了，但给分还是挺好的
159797,3748,赵洲,2022-08-31 15:06:14,0,1,1,就是那种，打分很高人很好，但是又强得有时候跟不上的老师
159828,3748,赵洲,2022-09-04 12:19:26,0,1,1,真的好
159893,3748,赵洲,2022-09-08 05:06:31,0,0,0,ML语速有点快哈哈\n\n感觉有时候跟不上\n\n但是老师人还是很不错的\n\n毕竟也很年轻 课会越讲越好的\n\n学弟学妹们想了解这方面可冲
160901,3748,赵洲,2022-10-22 05:38:36,0,0,0,上课还不错，就是挺迷惑的。问他要ppt每次都答应好好好结果几周过去了啥也不发，以及上课翻页飞快，啥也听不懂。\n\n还是看看远处的PRML吧。
161479,3748,赵洲,2022-11-07 12:26:39,-1,0,1,hh每次都要通知点名\n\n而且挺保护同学们隐私的
162671,3748,赵洲,2022-12-03 11:03:45,0,0,0,现在和之前好像不太一样了\n\n事情的任务量大概是3学分左右\n\n总体还是挺香的
167141,3748,赵洲,2023-01-15 06:51:49,5,6,1,给分不错，上90了，不过感觉有点玄学（随机）
167203,3748,赵洲,2023-01-15 05:27:54,3,3,0,出成绩了，好棒\n\n赵老师机器学习有干货，能学到东西\n\n但是任务量也不重，认真完成就好\n\n但是下一届好像要教改，大家看情况选
167228,3748,赵洲,2023-01-15 06:45:06,5,5,0,定位机器学习，老师一定点名，但每次点名都提前一节课提醒，总不会还有人不到吧\dog。然后是讲课，老师似乎对于蔡登老师PPT不是很熟，但关于神经网络还是讲的有入门效果的。作业量也不多不像是4分的课。因为默认有基础，所以可能上课会稍微有点快跟不太上，需要注意力高度集中。以及大作业真的让人入门网络。听说之后会加GPU资源，没机会享受了悲
174771,3748,赵洲,2023-06-17 11:05:18,1,2,1,赵洲老师水平还是可以的，只是传统机器学习那部分讲课可能不太熟，建议自己学，transformer这些后面的新架构他很能讲
186828,3748,赵洲,2024-01-13 08:05:22,-3,1,4,赵老师你就是给分的神！！！！！！外专业来选最后都上90了！！！！我爱你
193559,3748,赵洲,2024-06-13 04:22:35,4,4,0,讲课真的8太行\n\n人也很难说和课上一样和蔼
199939,3748,赵洲,2024-10-09 02:33:11,3,3,0,典型在本科生课上卖乖\n\n讲课不行水平不够\n\n纯靠给分
202171,3748,赵洲,2024-11-10 09:34:36,2,2,0,六不导师
209927,3748,赵洲,2025-01-07 12:33:04,2,2,0,不太行
215906,3748,赵洲,2025-03-07 02:51:03,4,5,1,课件都是让学生写的，这种水平上课效果一定很好吧。。。
86412,3822,罗悦,2018-09-15 09:57:20,10,11,1,自己拎不清，时间冲突，还来钓鱼执法登记名字，研究生辅导员就这种水平？
117593,3822,罗悦,2019-09-26 11:12:06,1,7,6,不错！
118945,3822,罗悦,2019-11-08 07:33:06,-1,2,3,老师严肃中带有一丝可爱\n\n感谢你们稀稀拉拉的掌声?
120240,3822,罗悦,2019-11-25 07:17:40,8,13,5,助教xgg真好看
123837,3822,罗悦,2020-06-15 01:54:45,1,2,1,思修: 主要看发言和展示，作业不要水，否则得分很差
134472,3822,罗悦,2021-03-29 14:09:56,1,4,3,职业生涯规划A：这门课没有期末考试，成绩取决于平时表现、展示和你最后写的职业生涯规划书。\n\n老师上课质量OK，可选。
140344,3822,罗悦,2021-09-10 01:49:33,7,7,0,呵呵呵
140346,3822,罗悦,2021-09-10 01:57:02,7,8,1,罗悦，非常功利的一个人。带我们军训，经常因为组织入党谈话，推迟晚上回寝时间。晚上组织各种讲座，谈话等，只为多拉几个人写入党申请书，提高自己的业绩。另外，老师表面上看着很善良，其实不为学生着想，不考虑学生的感受。（她情商也有点低）
140832,3822,罗悦,2021-09-16 14:32:55,7,7,0,事儿13体质
142409,3822,罗悦,2021-11-11 05:33:25,0,0,0,职规a，还可以，
143876,3822,罗悦,2021-12-10 02:35:29,7,8,1,疫情当下还逼着我们去完成团体志愿者，就很无语，根本不替学生着想
144785,3822,罗悦,2021-12-23 15:11:46,-4,0,4,好好好
144797,3822,罗悦,2021-12-24 02:38:51,7,7,0,老师不能抓到小组报告重点，容易受到同学观点的影响
144811,3822,罗悦,2021-12-24 05:42:57,3,4,1,对课程的进度上把握很不够。
148747,3822,罗悦,2022-01-13 11:37:49,5,5,0,给分一般般
152971,3822,罗悦,2022-04-22 14:21:37,4,4,0,给分挺不好的
153483,3822,罗悦,2022-05-01 12:15:26,1,3,2,职规A，上课可听可水（还算有意思），作业不多，没有期末考试，给分主要看期末职规书（5000字以内）和小组展示，想水水过的推荐选。（给分的话我个人还可以，但是总体偏低）
167284,3822,罗悦,2023-01-15 11:43:38,10,11,1,就一个脑瘫儿，傻逼
179318,3822,罗悦,2023-09-10 02:04:51,-1,0,1,666
184741,3822,罗悦,2023-12-22 11:39:40,-2,0,2,人美心善！
185522,3822,罗悦,2024-01-01 14:30:31,-1,0,1,老师挺好的但是每节课都点名\n\n职规事情超级超级多，8周的课6个大作业呜呜呜呜呜呜
189797,3822,罗悦,2024-01-29 10:57:20,5,6,1,以下均为个人观点：\n\n本人上的她的职规，课上可以水，课外事情非常多（不知道是不是职规课的通病），半个学期的课有很多大作业要做。\n\n感觉分组很随意，叫大家排队报数就决定分组，私以为职规课同组同学专业不要差太多比较好一些，像采访时很容易出现有同学专业没有兼顾到的问题。\n\n期末考核是小组展示，老师可能会比较晚通知，需要提前问好，会在最后一门课展示，如果展示不完的话会放到期末考的时间继续。\n\n小组展示是有各组互评的，虽然有评分标准，但是大家的打分差距非常大，我打分基本上没什么毛病都会90+保底，但是我看到评分表有的组给别人打分没一个过80……\n\n本人在组内工作上当组长，平时需要合作的大作业都是我负责协调，消耗的精力很大，最后总评84，感觉性价比不是很高。
200818,3822,罗悦,2024-10-23 02:27:31,-3,2,5,罗老师宇宙第一好
200884,3822,罗悦,2024-10-24 05:18:10,0,0,0,傻杯杯
203152,3822,罗悦,2024-11-17 12:27:51,1,1,0,他妈的真的是傻逼 一点也不把学生当人
71386,3982,许威威,2018-01-28 11:23:41,0,2,2,我觉得海星
72008,3982,许威威,2018-01-29 08:02:16,2,4,2,老师讲课一般般，但是人很好
73785,3982,许威威,2018-02-03 05:37:39,22,25,3,威威一笑很倾城
74659,3982,许威威,2018-03-05 04:14:19,2,3,1,讲课实在没什么营养，给分很好（数值分析）
74758,3982,许威威,2018-03-05 14:32:09,2,3,1,数值分析师生情
75719,3982,许威威,2018-03-15 11:47:21,0,2,2,老师人很好，但有些时候会讲的比较快
75937,3982,许威威,2018-03-22 07:21:11,45,50,5,觉得像马化腾的点个赞
76048,3982,许威威,2018-03-26 00:57:52,19,23,4,c++讲得很吃力，听得也很吃力
76435,3982,许威威,2018-07-15 09:04:52,3,8,5,讲课一般，给分挺好的。正常完成作业＋比较水的大作业+很简单的考试=4.8
78986,3982,许威威,2018-05-19 03:24:03,-1,3,4,挺好的。
79968,3982,许威威,2018-06-17 10:32:14,2,4,2,老师人很好，讲的一般，，好吧是我NA学的太菜了……
85136,3982,许威威,2018-07-15 15:47:34,7,9,2,c艹讲的一般般 而且早课要么迟到要么没来... 其实也不是很需要听课自己看ppt就行 似乎有三次签到 作业比别的班少很多 水lab 最后的大作业比较难下手但不麻烦 老师人很好 给分不错
85190,3982,许威威,2018-07-16 04:03:13,0,3,3,讲课还行吧，oop大多数都现场拿vs演示，老师人很好，给分也不错。
99787,3982,许威威,2019-01-25 07:27:26,6,6,0,人帅心善给分好!
100443,3982,许威威,2019-01-26 06:38:00,13,14,1,上的他的NA。老师对学生很和善，上课讲的也很清楚，但课程内容较为硬核，基本处于好不容易听懂之后不复习就都忘掉的状态。平时分最后的计分方式也是真的很宽松了，全勤，作业全交，偶尔发言，平时分基本不会扣。每周的作业可能要写一阵子，不过期末题型跟作业也比较相似，值得认真做一下。绩点应该主要是期末定的吧，期末是开卷，可以带教材，ppt，计算器。认真的话绩点不会太差，本人最后4.8。感恩。
108319,3982,许威威,2019-05-21 03:35:40,-3,0,3,作业要求不清楚
121322,3982,许威威,2019-12-20 04:49:51,2,2,0,NA讲的通透易懂
121911,3982,许威威,2020-01-23 17:15:21,4,5,1,许威威老师给分真的很好\n\n上课的感觉也不错\n\n数值分析平时八道编程题加一次小组展示认真做了基本给满 期末考的有点难但大概是分往高调了
121919,3982,许威威,2020-01-23 23:56:31,6,6,0,老师很好，讲课很清楚，总是能抓住要点。不过NA确实有一点难度，作业和复习确实得花一点时间~建议考试前在看PPT和课本之外复习一遍作业题。最后给分很给力，老师新年快乐！
121927,3982,许威威,2020-01-24 07:12:30,5,5,0,老师特别可爱！讲的挺好的（虽然我上课经常掉线555）。最后有时间复习，期末考的挺好的，老师给分真的超nice
121948,3982,许威威,2020-01-25 10:19:35,5,5,0,课程：数值分析\n\n人比较nice，会布置书上的作业，展示水水的。\n\n只要认真完成作业和lab平时分就很好。\n\n期末考前给了一个考试题型ppt，考试的内容基本上都是上课ppt或者题型ppt里有的，考试开卷，所以只要看一遍ppt和作业就没啥问题，所有题都找到类似的了。
122087,3982,许威威,2020-02-12 13:04:59,6,6,0,好老师，给分很好，人很nice，上课也还行，放心选!
122929,3982,许威威,2020-04-21 16:11:07,1,2,1,当初考研想去他的实验室，接触过，人非常nice，后来阴差阳错没去成，也是遗憾！
139462,3982,许威威,2021-07-16 04:57:20,6,7,1,数值分析给分很好。oop平时分很难满，有一半人平时分都要扣6分，相当于总评扣3分，建议oop选wk
139479,3982,许威威,2021-07-16 10:04:36,1,1,0,老师人真的很好！
139519,3982,许威威,2021-07-17 02:10:17,-3,3,6,oop平时分没想到被阴了一手\n\nwk班都给满的，建议快逃
149055,3982,许威威,2022-01-14 08:45:19,0,2,2,好就一个字！我说累了！！！NA课很难，但老师真的超级好www
150028,3982,许威威,2022-01-18 11:42:46,2,2,0,NA给分还是很好的，比较难的课，平常最好以理解为主要任务。
153719,3982,许威威,2022-05-09 08:18:08,1,1,0,老师很会理解学生，通情达理，真的喜欢他
157557,3982,许威威,2022-06-23 16:58:28,9,11,2,没上过这个老师的课，但今年OOP期末考试里相对最友好的题都是他出的，救我狗命。。。凭着这份善良必须给出十分\n\n\n\n顺便怼李继军，出的什么题，一道不会┭┮﹏┭┮
158239,3982,许威威,2022-06-27 16:35:37,1,1,0,老师有点像小马哥，钉钉问老师问题也回复地超快，很通情达理，给分也超级好！
158707,3982,许威威,2022-07-01 13:29:17,2,2,0,老师很好，oop选他选他，不会让你失望的
158708,3982,许威威,2022-07-01 13:31:14,0,2,2,给分很棒，讲课也不错，最后顺利满绩，10分献上
159563,3982,许威威,2022-08-11 12:58:47,0,0,0,好老师zszs
161219,3982,许威威,2022-11-03 02:30:19,-38,1,39,数值分析，老师的水平真不咋滴。\n\n课件是copy陈越姥姥的，\n\n实验也是copy陈越姥姥的，\n\n上课讲的很多东西感觉自己也不明白。\n\n教室里基本没人听课。\n\n单从数值分析这门课的授课来看，xww真没有一个长江学者的能力和气质。
162503,3982,许威威,2023-01-11 13:00:03,15,16,1,666\n\n前面那个喷他吹陈越的是什么牛马\n\ncy的ds上课有多少人听怎么不说一说？\n\n单从为人处世来说cy和他就没法比\n\n\n\n出分了，真的神仙老师，我问了一圈全是满绩
164848,3982,许威威,2022-12-27 01:42:31,-18,0,18,NA 讲课太拉了
165040,3982,许威威,2022-12-28 15:05:07,-7,1,8,前面那个喷cy的什么牛马。我这学期正好被两个人都教，NA和fds。讲课都算还行的，感觉难分伯仲，属于纯小白不准备==需要重听/上课容易失去同步。别问，问就是就是2号考NA在补天复习智云。发现老师讲的确实有些东西，虽然全是书本上的内容（确信），但是会从中找出要点提炼还是比纯看书效率高的。建议之后上他的NA如果没基础的话，上课还是尽量听一下，就当通识求大体了解，下课再看书（有中文的还是比较容易懂的）或者重听智云（复习用），效果是比较好的——仅保证适用我这种菜菜（因为学分选多没时间分给NA就很折磨，呜呜呜）
165325,3982,许威威,2022-12-31 17:27:42,4,5,1,前面有人喷cy？\n\n人家说的不是事实？也不知道前面那个牛马在给cy洗什么
165515,3982,许威威,2023-01-07 17:32:01,3,3,0,好老师！平时分给的真的好！
166219,3982,许威威,2023-01-11 12:48:10,3,3,0,说NA讲课拉的无法理解，感觉讲得挺清楚的\n\n平时分基本上都能给满，xww我的超人！
166231,3982,许威威,2023-01-11 13:10:02,3,3,0,许威威老师我爱你
166267,3982,许威威,2023-01-11 15:06:11,5,5,0,给分也太好了吧 泪目了\n\nxww真的是我的神\n\n强推NA！！！！平时分全班基本都99以上
166290,3982,许威威,2023-01-11 16:53:39,3,3,0,xww，NA秋冬学期。\n\n许爹我的神，平时分给的好到爆炸，试卷出的也简单，基本上自己不放弃绝对就是高分，强推
166304,3982,许威威,2023-01-12 00:45:23,1,2,1,讲课一般，但是给分绝对无敌。
168182,3982,许威威,2023-02-01 06:17:33,-1,4,5,给分真的逆天\n\n数值分析使劲冲 一个班90%的5.0
174635,3982,许威威,2023-06-15 01:55:03,1,1,0,威威人帅心善给分高
176870,3982,许威威,2023-06-30 13:27:03,4,5,1,考完OOP了，先打个10分，威威捞捞我！
178277,3982,许威威,2023-07-09 09:02:50,0,0,0,讲课比较一般，给分还可以（虽然被卡了）
188680,3982,许威威,2024-01-19 14:06:47,1,1,0,不是，xww的NA真神吧
189123,3982,许威威,2024-01-22 05:04:08,1,1,0,NA真神不解释。\n\n但是今年的题目计算量很大，比起往年来说要难不少，所以提醒后来的同学们平时要多多练习计算\n\n（或者熟练使用计算器，最好考试带那种高级的可运算矩阵的计算器）
195615,3982,许威威,2024-06-29 04:38:30,2,7,5,oop严重不推荐，快逃。
195876,3982,许威威,2024-07-07 13:30:59,-10,0,10,oop 平时分给分比较严格。讲课水平一般，计院平均水平。平时任务量比较小，但是上课体验是远不如陈翔和翁恺的。\n\n\n\nupdate: 成绩出来之后，大家分数普遍比之前自己算出来的高，猜测是老师最后良心发现平时分给的有点差，又捞了平时分。
196593,3982,许威威,2024-07-04 07:06:10,6,7,1,对OOP客观的说一句。讲课确实一般，感觉应该没人听他讲，但是胜在平时作业少，就7个lab没了，且没有期中考。对比之下，翁恺讲课好但任务繁多；陈翔则是任务量适中且讲课不错。因此比较好的选择是选xww但是听wk或cx的课。\n\n关于平时分给分，其实并没有其他同学说的比较严格。今年的主要问题是lab的ddl均在上课时公布，且一开始没有说延期提交lab的penalty政策，有些同学没有听到因此被扣了很多而感到气愤。其实这事的主要责任应该是助教无所作为，学在浙大上给个ddl或者钉钉群里@all宣布一下都不会有这种情况。除此之外的平时lab给分还挺正常的，基本上就是程序有边界情况错误或者代码不规范的情况从20分扣个1分这样子。\n\n综上，个人认为OOP选xww真的挺好的，腾出大量时间你完全可以自学或者听别的老师的课，只要注意一下lab的要求就好了。
196610,3982,许威威,2024-07-04 08:39:29,-2,1,3,OOP可选，任务少很轻松，但这学期的评分机制完全就是一坨非常垃圾。pta上7个lab一起放出来，ddl设在6.30，此外除了某几节课会提一下什么时候要提交哪个lab之外完全没有明确规定各个lab的ddl，也完全没有提到penalty机制，甚至也完全没提到晚于xx时候交会扣分，这种情况下正常就默认以为pta关闭前提交就可以。但是一直到6.28考完试助教才突然在群里公布了penalty机制以及刚讨论出来的各个lab的ddl，并且扣分扣得很多，而这个时候所有lab都是已经过了ddl甚至过了很久的，非常恶心，导致一些人平时分扣了很多。\n\n讲课方面讲得比较乱七八糟思路不清晰，去听其他老师的课或者搜搜网课都比xww讲的强得多，所以听完前几节课后面的就翘了。老师不点名，这也导致翘课的人根本不知道上课有提到lab的ddl的事，显得上面的penalty机制更加不合理。\n\n综合考虑，课可以放心选，但是第一节课一定要先“严刑拷问”老师和助教平时作业的ddl和penalty机制防止平时分吃亏，然后就可以放心去听其他老师或者网课了。
197045,3982,许威威,2024-07-07 02:07:48,-2,2,4,OOP虽然平时分公布的时候大家都在骂，但是最后成绩一出来直接跪了，许老师是我叠你们不许骂😡（也不知道怎么做到的，是改了期末占比还是直接期末动分了？可怕
197104,3982,许威威,2024-07-07 17:09:05,4,4,0,虽然讲课很一般，但是oop给分很好。\n\n\n\n另，lab的ddl上课都会通知。因为不去教室上课导致不知道作业ddl的主要责任难道不在于自己？
197312,3982,许威威,2024-07-11 01:14:17,1,1,0,事最少的oop班级，总评lab和期末五五开，七个lab有六个闭着眼睛写完，最后的大作业内存池难度也不大，给分也很不错。\n\noop这门课本身就是琐碎的c++语法，网上资料也很多，老师讲课其实有点无聊的，不喜欢的话真心建议自学（自己能写出7个lab的水平就可以了）
199016,3982,许威威,2024-09-14 03:45:52,0,0,0,qjqj
213507,3982,许威威,2025-01-18 02:51:54,10,12,2,NA给分不错。今年老师说学校不允许太多平时分满分（大部分同学都是59.5～59.8之间），所以使用向下取整的方法导致大部分同学的平时分是59分，建议上课发言1～2次以获得额外加分。期末考试很多题都是PPT上的原题，考试前把PPT和课后作业过一遍就够了，应该可以获得不错的成绩
214678,3982,许威威,2025-02-16 13:54:30,2,5,3,下面这个评论的人考了5.0，菜的不要来，很容易挂！！
104339,4069,任重,2019-03-18 06:26:25,4,4,0,。。。
109378,4069,任重,2019-07-06 22:52:45,-2,4,6,推荐选任重哈哈哈哈大概是 这学期竺院c程几个老师里面最水的
113540,4069,任重,2019-07-06 23:26:58,0,4,4,上课讲的不是很清楚。不过说实话上课本来也没什么用，更多还是得靠自己。给分还不错吧。
113653,4069,任重,2019-07-07 02:07:47,2,4,2,有点听不懂(尬笑
113686,4069,任重,2019-07-07 03:58:55,20,25,5,听不懂是真的听不懂 全靠自学\n\n给分应该还可以\n\n主要是我自己太菜了
113735,4069,任重,2019-07-07 06:38:33,5,8,3,第一个学期上课，不太有经验，讲的内容不是很贴近考试内容，但是挺拓宽视野的，有利有弊吧。研讨课太水了，大作业学生的project质量和讨论的水平完全和隔壁班比不了。希望老师在这块想办法提高要求。
114898,4069,任重,2019-07-12 15:06:46,0,2,2,老师水平在线，ppt制作很棒，每个pro会给示例程序，据说老师是图像方向的，cad大程还会给opengl相关代码。每节课点名。给分还可以。建议选。
115034,4069,任重,2019-07-14 15:48:19,7,9,2,老师给分可以 但是这门课让我感觉确实很糟糕 就是我平时代码也不太会编 考试的代码题就突然很简单 Project也是花了很多精力但是还是感觉自己不行 结果考试雨Pro无瓜?简单的说这门课你只要找一个完美的队友 然后期末把历年卷全刷了 就可以混个好分了
116256,4069,任重,2019-09-06 16:09:28,0,0,0,。。。
117042,4069,任重,2019-09-18 14:22:58,2,3,1,自学吧
118473,4069,任重,2019-10-27 11:47:38,0,1,1,我觉得OK
118694,4069,任重,2019-10-30 17:29:23,2,4,2,水平很高，拓展很多
120339,4069,任重,2019-11-29 04:28:37,0,2,2,真的 教的根本听不懂 不是我一个人听不懂 大家都这样 就 没什么实质性的帮助 全靠自学 给分一般
120721,4069,任重,2020-01-15 23:15:33,5,9,4,个人认为任老师不应该只有6.9😂😂，其实没有楼上说的那么不堪，听不懂也不至于，而且老师平时在群里答疑什么的也很热情（虽然每次上机课都要去要点名），c程这门课给分应该都不错的，期末考前一定要刷题，不用多，三四份就好，把错题都搞搞明白期末考就没问题了。
128274,4069,任重,2020-12-16 03:22:21,-1,2,3,我觉得很不错
128601,4069,任重,2020-12-24 11:45:58,0,0,0,啊啊啊啊啊啊啊啊啊啊，就这，我上我也行
131984,4069,任重,2021-01-30 01:18:03,0,0,0,老师讲得很一般，本人不太跟得上。幸好没挂，谢谢老师捞人
132002,4069,任重,2021-01-30 02:14:11,4,5,1,给分很差
132486,4069,任重,2021-02-02 02:31:45,2,2,0,没基础一定要自学，重视理论，平时多做PTA编程题
133257,4069,任重,2021-02-21 05:33:41,0,3,3,分不好怪自己菜还不会自学吧，老师很强
133631,4069,任重,2021-03-03 04:20:14,4,5,1,他以为同学们都会了，但我不
134132,4069,任重,2021-03-17 00:37:17,12,15,3,老师能好好讲中文吗？
134280,4069,任重,2021-03-22 23:59:08,2,5,3,老师是个好人！！！真的是好人！！！并不是老师想挂你，不是大佬的可以先多自学一下，我这种完全没学过的和那些高中学过或者搞竞赛的一起上压力很大，但老师真的是好人！
142159,4069,任重,2021-11-08 03:20:20,5,5,0,听不懂
143558,4069,任重,2021-11-26 16:22:58,0,1,1,好老师~
144444,4069,任重,2021-12-21 13:39:52,0,2,2,给老师提提分，虽然老师讲的比较难懂，尤其是有些英语单词让人困惑。但老师人还是不错的，扩展的内容也很有用。
145528,4069,任重,2021-12-30 07:19:14,-1,1,2,虽然教的难， 但是教会了很多东西
145564,4069,任重,2021-12-30 08:52:25,2,4,2,老师是很好的，但是我觉得他讲课就不太好。。至少对于我来说，他过于重视讲课进度，而丧失了对一些本质东西的讲解。但不得不说，老师水平很高！
146263,4069,任重,2022-01-06 05:25:52,3,4,1,讲课着实有点…考试还很难，讲课内容和考试相差太远
148425,4069,任重,2022-01-12 12:10:43,4,5,1,老师答疑很快\n\n但是我上课真的听不懂\n\n期末做历年卷像是预习（哭笑）\n\n但是助教太nice了\n\n基本秒读秒回\n\nch助教还会回复“不客气”（哭笑）\n\n感觉我的C程不挂科全靠的助教（哭笑）
149525,4069,任重,2022-01-16 00:13:16,3,3,0,老师人很好，但是讲课着实不太行，给分一般
149734,4069,任重,2022-01-16 15:07:32,5,6,1,讲课完全没法听，几乎不捞人，没有补考也是神了，就算对学生有自信，也不要对自己的教学太自信好不好
151191,4069,任重,2022-02-24 07:45:05,4,5,1,第一次见到上机课要求必须到的老师
151198,4069,任重,2022-02-24 10:44:14,6,7,1,为什么我觉得老师上课有很多没有必要的中英夹杂
151501,4069,任重,2022-03-08 06:34:58,1,3,2,为什么编程题只能用C写啊大哥\n\n以及pta上能放点自己学校出的题吗
151507,4069,任重,2022-03-06 05:25:49,1,2,1,不太喜欢
151572,4069,任重,2022-03-08 06:36:03,3,4,1,你怎么也开始“一个好的程序员”了
152058,4069,任重,2022-03-24 08:48:41,9,12,3,5分是给助教的。这老师一分得不到。除了助教真的好能救一救，上课不得不说真的讲的差。上课听了跟没听一样，实际写代码的时候不会照样不会，到最后只能面向CSDN，那我来听你讲干什么？纯纯的浪费时间，r**，退钱！
159398,4069,任重,2022-07-16 03:31:25,-7,0,7,CG前沿，很好的老师，很清楚的讲授
160347,4069,任重,2022-09-20 02:06:37,1,3,2,能说脏话吗？不能？那我没话说了
163055,4069,任重,2022-12-07 04:28:37,0,1,1,真的听不懂啊，讲课的内容很碎片化，不成体系，还是自学吧
163058,4069,任重,2022-12-07 04:37:14,0,1,1,老师讲课旁征博引，会把两块体系均匀地混在一起，为理解和做笔记带来极大的困难\n\n但即使如此还有优秀的室友考满分\n\n建议入一本C Primer Plus多多自学
164246,4069,任重,2022-12-20 01:55:22,0,1,1,呵呵，天书
164579,4069,任重,2022-12-22 03:35:18,5,6,1,真的是。。。\n\n助教给满昏，老师上课依托答辩。
164589,4069,任重,2022-12-22 05:30:19,0,1,1,看了上面的老帖，总觉得任老师上c程画风有些怪怪的哈哈哈哈
166338,4069,任重,2023-01-12 03:50:26,1,3,2,上了他的课就是我最大的悲哀\n\n考的不讲 讲的不考\n\n考试和讲的内容完全是两样的\n\n而且很不负责任\n\n要不是预置了我直接。。。
166466,4069,任重,2023-01-19 08:42:24,5,6,1,赞同楼上的，考的不讲讲的不考，期末没被斩杀我已经知足了，班级群出分一片哀号
166609,4069,任重,2023-01-13 03:51:38,6,8,2,助教好好，老师上课讲的根本听不懂，依托答辩
166853,4069,任重,2023-01-14 02:38:07,14,19,5,大爱我陆飞扬助教，满分满分满分!!!只要他留在浙大任教绝对是满分老师!!!然后任重的话，真的挺难听懂的(本人上网课基本没听，自学b站的翁恺，期末靠刷点题，问助教才搞了个半懂不懂，最后绩点3)
166951,4069,任重,2023-01-14 10:24:23,0,1,1,ppt精美，课程难度较大，有深度，中英文混讲，适合牛子（非我也
168555,4069,任重,2023-02-19 10:25:47,1,3,2,有点听不懂😭我好菜
172780,4069,任重,2023-05-06 16:19:19,0,3,3,满嘴之乎者也，真把二十几年前的过时的玩意当成装B的资本了呵呵
173513,4069,任重,2023-05-27 04:49:19,17,21,4,陆飞洋！！！！！！
175460,4069,任重,2023-06-25 04:46:03,2,3,1,讲的依托答辩
176345,4069,任重,2023-06-28 13:02:21,8,9,1,陆飞洋！！！我爱你！！！！！！！
176606,4069,任重,2023-06-29 12:19:01,9,11,2,飞洋gg我的神！！！😭😭😭特别特别有耐心，问了助教gg很多问题都会耐心回答，而且讲的特别清晰明白！！！考完试还告诉我没有被斩杀，让我放松心态复习下一科，我真的哭死！！！😭😭😭怎么会有这么好的助教，幸运幸运幸运！感恩感恩感恩！😘😘😘大爱飞洋gg！！！😘😘😘
177792,4069,任重,2023-07-05 01:57:42,-5,2,7,任老师人很好 给分相当好。编程这东西本来就是靠自学，好好做大作业，学期还是可以收获很多的。
177795,4069,任重,2023-07-05 02:04:15,-3,2,5,挺好的，点名，上课听不懂，全靠自学，给分可以，over
181901,4069,任重,2023-11-04 07:54:34,15,17,2,学的第5课，题目做的第8课，rz你是真的6
181904,4069,任重,2023-11-04 12:25:54,8,10,2,责任重，道不够远啊\n\n黑板字看不到，上课可视化程序看不懂，作业都是没教过的\n\n原来得分高都是因为之前的助教……
181905,4069,任重,2023-11-04 12:27:06,5,7,2,rnm，退钱
185860,4069,任重,2024-01-08 12:18:02,3,4,1,作业超前，有点难。上课感觉把我们当成有基础的人在讲，有些部分真听不懂。\n\n但是我过了一周才发现没签到，老师应该是给我补签了。
189270,4069,任重,2024-01-22 17:22:07,2,2,0,还好，没挂
189283,4069,任重,2024-01-22 22:55:10,1,2,1,我成绩不错给个6分吧，虽然感觉是我自己的功劳\n\n该说的大部分人都说过，只能说遇见任老师就认命吧，自学启动！
189291,4069,任重,2024-01-23 02:47:14,-1,2,3,上课可能一般\n\n但答疑真的很认真负责
189295,4069,任重,2024-01-23 03:09:53,5,6,1,最后成绩也不咋样，一点没捞，很求是，平时分也没拉满，对总评影响还挺大的。
189592,4069,任重,2024-01-25 13:13:46,5,5,0,恪守求是精神，严格按照制定的平时分标准给分，无基础/不愿意整个学期战战兢兢地按照第一课的评分标准行事的慎选
189875,4069,任重,2024-02-01 02:12:57,3,3,0,。。。
196414,4069,任重,2024-07-03 08:59:34,7,7,0,[计算机图形学研究进展]\n\n1.课程评分方式是15%签到+15%论文阅读笔记+70%期末大作业。点名无规律，缺勤一次扣五分；论文阅读笔记要求选一篇有关CG的论文写笔记期末上交；期末大作业要求复现一篇有关CG的顶会/期刊论文，可以组队但如果solo会有加分，第一批报告也会有加分。比较硬核，适合有点基础的朋友们选，如果自己对相关方向完全没有了解或者代码能力比较弱的话不建议选，工作量还是比较大的。\n\n2.课程由很多老师一起上，有点类似讲座，课上确实能学到不少东西。大作业也让人收获满满，lz跟同学两个人一个学期认真复现一篇SIGGRAPH的论文收获还是蛮大的，也很有成就感。\n\n3.这课给分完全是依托，这对lz本就保研边缘的绩点更是雪上加霜，本想4分大课可以选来刷分但出成绩的那一刻我还是很难绷，大作业和论文笔记给分感觉很随便，期末答辩的时候感觉还不错问的都答上来了，但最后给了一个让人很无语的分...完全不知道扣分的理由是什么，给的分挺让人寒心的。但已经出分了lz也懒得跟助教老师打听扣分原因了，反正这个大作业我确实认真付出了问心无愧。建议助教明年增加一个公示环节，别等期末出分了给人一个大惊喜好吧。
205583,4069,任重,2024-12-09 14:59:37,0,0,0,天天点名
205584,4069,任重,2024-12-09 14:59:57,1,1,0,天天点名，纸质点名，我要红温了！\n\n\n\n关键是课上得的确不行呀！真的难绷！
206694,4069,任重,2024-12-17 06:33:34,0,0,0,别指望能听懂任何东西
210863,4069,任重,2025-01-10 05:42:03,-1,0,1,我主观评价一下吧。\n\n\n\n任老师可能自己水平很高，但是上C程课的确不咋地。\n\n\n\n上课的水平极低，讲课属于是基本没有备课，上得也不成体系。\n\n\n\n关键是他口头点名呀！这真的难整！本来你不点名的话我都不会说啥，毕竟C程自学的确比较重要，但是你自己课上得这么烂还强迫我们到课，这不是ex人吗？
212728,4069,任重,2025-01-14 15:18:42,0,0,0,讲不明白
212740,4069,任重,2025-01-14 16:15:03,0,1,1,为任老师洗一洗，rz的课适合有基础的人听。纯小白不推荐选。如果你有一点C语言基础，能跟的上rz讲知识点和部署较复杂程序的话，一个学期下来能有很多收获。只要每节课都去上，应付一下点名，期末考好一点，高绩点绝对不成问题。本人期中70分不到，总评还能有89分。这课，只要你肯认真上，好的绩点绝对没问题。评论区清一色的讲不明白可能是因为rz讲课没有足够的铺垫。反正，这是一个会在介绍printf函数时讲到内存的老师。基础不够慎选。基础够很推荐。
214122,4069,任重,2025-01-24 17:00:39,1,1,0,讲的什么勾史
78645,4353,陈刚,2018-05-14 06:14:56,-5,0,5,一言难尽
82208,4353,陈刚,2018-07-07 11:51:16,-3,2,5,隔壁高云君平时分给满，能选高云君就别来陈刚这边吧。上课的话，尚可吧。
93520,4353,陈刚,2019-01-10 07:27:53,-5,0,5,均绩3.29有点可怕啊\n\n
150680,4353,陈刚,2022-02-12 06:15:33,16,16,0,计院陈刚院长，数据库领域专家，课绝对没的说，人也很好，给分看均绩排名也懂
150681,4353,陈刚,2022-02-12 06:18:45,6,6,0,唉今天听了小朋友问这个老师怎么样来评论一波，我上课的时候感觉他就讲的挺不错的，认真听课我没花额外时间去补这门课，而且这种统一的大课，肯定老师好坏都有，至少我心中老师还是属于中上层次的，选中不亏
150686,4353,陈刚,2022-02-12 16:29:52,5,5,0,给分可，会画重点，考试统一卷也没太多好说的
150695,4353,陈刚,2022-02-13 18:33:41,3,3,0,还不错，挺和蔼
150704,4353,陈刚,2022-02-15 06:27:32,2,3,1,讲课清楚，比平行班老师好
150716,4353,陈刚,2022-02-15 14:06:31,1,1,0,有几次小测，最后讲一节课题型，虽然期末考试与历年卷不尽相同，但给分还不错
151462,4353,陈刚,2022-03-04 01:26:54,2,2,0,上了两次课觉得没有评论那么好？再看看
153249,4353,陈刚,2022-06-24 12:37:23,3,3,0,人挺好，就是如果听网课会声音很小，另外助教人是真的好\n\n期末画的重点基本都考到了，但是我实在是太菜了，求刚哥捞捞呜呜呜\n\n期末考炸了，但是本菜鸡3.3拿怕了已经很感激了（毕竟考前两个晚上速成也不图多好）
155767,4353,陈刚,2022-07-12 17:49:47,0,2,2,助教哥哥很和善 老师讲课比较难听进去吧 不过人很好 回答问题很和蔼 几次小测有同学晚来他都给卷子做也没说什么\n\nbtw查老师均绩都不知道是咋来的 没必要看
156067,4353,陈刚,2022-06-24 08:16:47,3,3,0,考前来打个10分。老师人很好，讲课思路很清晰，助教哥哥人特别好。希望期末能给捞捞🙏\n\n出分补：这个给分认真的吗也太太太太好了吧
156162,4353,陈刚,2022-06-18 03:48:44,2,2,0,老师很靠谱 水平很高 讲课认真听也能听懂\n\nminisql大作业很阴间 助教验收很宽容[doge]\n\n期末没时间复习qwq内容太多了\n\n老师 菜菜 捞捞 呜呜
156232,4353,陈刚,2022-06-24 08:15:32,2,3,1,老师很和蔼，是真的很和蔼，一点架子都没有，捞捞我吧老师！\n\n出分再评：给分好到不知道是从哪里加出来的
156233,4353,陈刚,2022-06-18 11:14:42,0,1,1,老师人很耐心呜呜呜 虽然讲课我容易走神 一定要相信老师考前画的重点，我就是没完全看吃大亏。。。老师捞捞我
156264,4353,陈刚,2022-06-18 14:40:28,2,2,0,院长真的yyds！！！
156715,4353,陈刚,2022-06-20 17:37:58,1,1,0,希望得到一个好成绩，膜一下刚子哥
157655,4353,陈刚,2022-06-24 08:32:06,0,0,0,老师秒回这个很棒呀\n\n最后绩点不好不坏\n\n卷子没做好吧\n\n不过还是谢谢老师和助教
157670,4353,陈刚,2022-06-24 09:33:49,1,1,0,老师讲课不错。给分真的巨好。
158908,4353,陈刚,2022-07-03 07:26:45,-1,2,3,老师很可爱和蔼，给了我这种起不来的fw充分的自学空间，事情少，讲课深入浅出重点分明，最后差一分满(´つヮ⊂︎)
159866,4353,陈刚,2022-09-07 03:15:18,0,0,0,老师人不错的，很和蔼
86567,4389,纪守领,2018-09-17 08:10:51,9,10,1,毫无内容，全是废话
87962,4389,纪守领,2019-09-17 23:54:34,10,17,7,这老师他妈搞笑的吧，布置深度学习的内容，上课只字不提，说你们肯定都会，让同学回答怎么解决问题，张嘴就对抗网络，这不跟小孩过家家吹牛逼吗，开课的初衷不错，课太水，作业写的我心态崩了，希望老师落脚实处吧
116198,4389,纪守领,2019-09-06 03:32:06,4,6,2,据说纪老师还没有决定要上什么课呢，先开了一门数据驱动安全，其实就是机器学习论文研讨的意思（大雾）。先说一下这门课吧，上课讲论文，没有作业考试只有project，也是论文相关（准备了23个题目）。上课讲东西很清楚很负责很有意思，能看出来有功力，有逻辑。以后发现他开课（如果不是很奇怪的课程）可以优先考虑。注重课堂互动，建议多发言（虽然和分数不一定有关系）。然后写报告必用latex，要做好学latex的准备（虽然latex是要比word好看)。希望这不是最后一篇评论，经验足够了肯定大火的老师啊
119219,4389,纪守领,2019-11-11 08:59:08,1,3,2,课确实认真准备了，老师也是有功力的。  但在大多数同学甚至没有学过ai的前提下，要求能做到学会的同时有创新的点，最好还能发paper。有一说一，对初学者蛮不友好，虽然确实能学到知识，但基本做好绩点不会高的准备。\n\n总得来说，是一门两学分，短学期的长度，长学期的内容的课。建议像大三上这种专业必修课事情贼多的时间段别选...
119354,4389,纪守领,2019-11-12 08:17:28,3,6,3,课是好课吗？是。内容都很值得一听。\n\n老师是好老师吗？是。相当负责任。\n\n可惜定位有问题。本来就是一门选修课，但老师却在很多同学完全没有AI、深度学习基础的情况下判断大部分计算机学生都在学相关内容（甚至默认其它课程也在搞机器学习所以可以拿别的课的project代替，学生压力可以减轻？）课上确实有dl同学谈笑风生，课下做出相当厉害的成果。但是对于没有基础或者单纯缺少学分的，还是不建议选这门课。因为其它选修课可以拿时间砸出来成绩，但这门课和真正搞过相关内容的同学的差距不是一个短学期就能弥补的。
120818,4389,纪守领,2020-01-17 15:21:49,0,1,1,纪老师上课还是很用心准备了的，可能是有娃了的原因吧，目前工作重心似乎也不在科研了
127601,4389,纪守领,2020-11-25 02:44:01,11,15,4,重在自学，太难了。。。。。。。。。。。。。
128556,4389,纪守领,2020-12-24 00:54:42,1,3,2,上课太水，只会吹逼
130091,4389,纪守领,2021-01-16 15:45:14,1,2,1,水。。。。。。。。
130965,4389,纪守领,2021-01-25 12:05:28,-3,1,4,值得去选
132230,4389,纪守领,2021-01-31 06:54:29,-2,1,3,值得选，上课蛮轻松的，但需要自觉
132459,4389,纪守领,2021-02-01 16:46:03,-6,1,7,老师给我5分，我双倍奉还
133878,4389,纪守领,2021-03-09 00:16:13,9,10,1,作业……上课完全没讲啊……全靠自学吗……
134579,4389,纪守领,2021-04-02 13:53:43,4,5,1,上课内容少，作业多离谱，考试要手写，真就贼无语
134822,4389,纪守领,2021-04-16 16:08:26,7,7,0,作业多的离谱，花费时间特别多\n\n我寻思讲的也没比别的老师好啊，怎么作业这么难呢？
135096,4389,纪守领,2021-04-30 07:57:48,5,5,0,反正这春学期下来，我是什么都没学到，基本知识还是停留在小程水平。唉，怪我太年轻，太懒，本来觉得老师肯定有水平，教学总不会太差吧，看上去态度挺好的，可是我认真听，就听不到什么知识，不晓得他讲了些什么。作业完全不会写。现在找了别的老师的课听，内容就完全不一样，能学到很多。但是有些晚了，作业可能赶不上了。后悔没开学就找别的课自学，错亿啊。\n\n以后知道了，不能太相信自己的老师(┯_┯)总之察觉到不对劲就要自己更努力才行了。或者主动找老师交流？这看个人性格……
136390,4389,纪守领,2021-06-17 09:31:27,8,8,0,大程期末考试用纸质，大作业一个人完成。应该是一位优秀的学者，但很可能不是一位优质的老师
136862,4389,纪守领,2021-06-26 13:18:22,3,3,0,大作业单人完成，别的班三人完成，互评的时候一个人评三份，别的班三个人评一份，评分分差过大还要扣评分人的分数。真有你的纪守领，嫌我们分还不够低吗。对学生的课业压力没有任何概念，拍拍脑袋做决定。
136873,4389,纪守领,2021-06-27 05:58:52,7,7,0,适合大佬\n\n不适合菜鸡
137734,4389,纪守领,2021-07-06 02:31:39,4,4,0,出了分之后来评一评啦。嗯，一个人完成三个人的任务量，累死我了。隔壁三个计院大佬报团，我一个工学部菜鸡一个人搞，要老命了。互评的时候，两个同学放我一马，一个大佬十分求是，最后大程得分和求是的大佬给的分数一样？老师仲裁的评分标准非但不放宽，还要如此严苛？辛辛苦苦打了快两个月的程序，所有既定要求全部完成，互评的时候，看那个满地bug，要求一半都完不成的，都给了80分，结果最后，害。我承认我是菜鸡，我承认我达不到这门课要求的程序水平，但这个得分着实令我十分失望。最后，对于没有选课的同学，我一句大佬随意，像我一样的菜鸡快跑！对于已经选上课的同学，平时作业记得交，纪老师是不可能同意补交的，不交就直接零分啦！！！
139284,4389,纪守领,2021-07-14 04:42:18,2,2,0,我觉得纸质的试卷倒也还行，做不出来不至于被斩杀....就是前面的作业实在是太多太难，而且匹配不上上课的进度，课是有点水了...互评最后颗粒蛮粗的，分差大也没有扣分，他对查重也做了比较合理的说明，不会因为什么名字忘改而扣分的事。
139369,4389,纪守领,2021-07-15 00:33:07,2,3,1,考试手撕代码真的惊到我了\n\n大程强制solo作业也还好\n\n不过感觉上课确实没讲什么东西\n\n反复讲一些没什么用的东西\n\n重在自学\n\n虽然被卡了但是助教xgg挺可爱的还有一个有意思的名字
141867,4389,纪守领,2021-10-28 08:31:33,0,1,1,可真是只能靠自学，大一新生，c程大学前没碰过，现在崩了。。。
149378,4389,纪守领,2022-01-15 08:01:37,2,3,1,C小程讲课水 卡绩有点难受 不过老师人不错
149411,4389,纪守领,2022-01-15 08:56:29,-18,3,21,老师比较富有启迪性，说人话就是快去自学吧。\n\n不过老师人挺好，很有风度，助教也很nice，不过期中考试对于小白着实过于困难。。。。。\n\n最后还是满绩了，所以自学的重要性就体现出来了
149449,4389,纪守领,2022-01-15 11:10:15,4,4,0,上C小程课不打代码，满嘴跑火车＋PPT reader，小测手撕代码\n\n只能说重在自学
149479,4389,纪守领,2022-01-15 13:41:08,3,4,1,讲课很水，也没有给到足够的指导。 对于新手来说很不友好，只能说如果是完全没有接触过编程的同学建议发挥主观能动性自己学，不要靠老师。 对于人品来说，老师还算可以，课前会找你尬聊，虽然大家都不想理他。但是教学水平实在不敢恭维。
151143,4389,纪守领,2022-02-23 11:37:01,0,2,2,"个人感觉纪老师人很不错，老师更希望给大家一些启发性的东西，上课的时候常问同学们一些课本上没有的东西，印象最深的一句话大概就是：“你可以在自己的电脑上试一试。”就比如说stdio.h用< >括起来与用""  ""括起来的区别，都具有很强的启发性吧。发这个评论大概的意思就是说告诉后来的校友们，没选上心仪的老师的课也没关系，纪老师也很不错，TA也很棒，有问题一定要及时询问就行，老师会非常非常耐心的进行指导的。但是但是，小白一定要做好上课听不懂的准备，确实有一些问题咱们这类人是参与不了对话的，泪目。一定要自学啊，傍不上大佬就老老实实问老师，一定会收获好成绩的。"
152123,4389,纪守领,2022-03-28 00:13:46,8,8,0,奇怪的事一堆，能避则避
152325,4389,纪守领,2022-04-04 07:02:56,12,16,4,事太多了 一个两学分的课花的时间基本比我其他所有课加起来还长 快跑！
152330,4389,纪守领,2022-04-04 09:17:07,6,6,0,事太多了
152802,4389,纪守领,2022-04-20 03:59:45,8,10,2,快跑！c大程期中考试会让你觉得根本没学
153919,4389,纪守领,2022-05-17 02:15:02,2,2,0,老师还是很厉害的，有问题要多问就好
153920,4389,纪守领,2022-05-17 02:14:32,1,1,0,老师还是很厉害的，有问题要多问就好
154721,4389,纪守领,2022-06-04 07:08:46,1,1,0,老师还是很好的，认真学会有收获的
154872,4389,纪守领,2022-06-06 10:28:39,5,6,1,好老师 给分超好 不要听那么多评论瞎说 其实真的还可以的
155147,4389,纪守领,2022-06-08 17:39:11,5,5,0,其实我觉得挺好的\n\n上课也认真教了，期中考试过难，也改赋分制了，并且安排第二次期中考试，自愿参加，两次取高了\n\n大作业solo，至少不会小组成员扯皮，或者被莫名其妙坑一下\n\n也没有小组互评，不会被恶意刷低分\n\n虽然成绩还没出2333
155288,4389,纪守领,2022-06-10 08:10:30,9,9,0,一开始被老师的评分吓到了，想着一定要润，但一学期下来发现真的不错。\n\n1.讲的不错，一些东西讲的很清楚（至少比我c小老师好\n\n2.大程solo，听着离谱，但是没有小组作业真的很省心，至少身边同学很多都说组员摆烂\n\n3.没有互评，互评太恶心了，别的组疯狂打低分\n\n4.对我（菜鸡小白）提升很大，最有意思的一个作业就是文件解密，自己最后解密出来周杰伦的歌真的成就感满满。\n\n5.真的会听同学们的建议。期中考试难度太大，老师又安排了一次自愿考，最后取最高赋分（虽然我考的都很烂）\n\n虽然成绩没出但是还是想给老师打高分！jsl yyds！
155314,4389,纪守领,2022-06-10 16:01:50,4,4,0,老师其实真的还可以的 不要被评论区带节奏了
155382,4389,纪守领,2022-06-19 12:55:07,8,9,1,萝卜白菜
155420,4389,纪守领,2022-06-12 11:48:49,5,5,0,解密的作业真的很有趣哈哈哈哈，助教xgg也很耐心
156399,4389,纪守领,2022-06-19 11:02:29,13,18,5,其实真的可以的，遇到大程不互评不展示的老师可以珍惜一下！虽然大程要求solo，但是选题的时候可以不选图形库相关，不用学图形库他不香吗！（而且工程量真的没想象中那么大）最后助教gg的大程给分真的爱了爱了呜呜呜呜！
156645,4389,纪守领,2022-06-20 13:30:11,1,1,0,上课很好
156668,4389,纪守领,2022-06-20 14:31:46,4,4,0,一开始看到大作业solo也有点被劝退，但是上课体验真的很不戳ヾ(･ε･｀*)感觉老师讲得蛮清楚的，还会强调要多去实践，而且大作业也是按照一个人的代码量布置的，个人大概只写了700行+，基本实现了所有功能（不要求用图形库和可视化），截止时间是第八周，感觉是所有老师里面相对晚的wwww\n\n前期经常去请教助教xgg问题，学长也都很耐心地给我解答了，作业给分也很好(๑ゝω╹๑)真的可以吹爆jsl!!!学弟学妹不要怕，都可以选!!!
156921,4389,纪守领,2022-06-21 10:38:55,4,4,0,大程没有互评 没有展示 不是必须使用libgraphs（所以我libgraphs这个库基本没学，体验还是很好的🤣）\n\n至于讲课，见仁见智吧，我个人挺害怕这种上课抽人回答问题的，不过现在想来这些问题其实还是很有启发性的
157214,4389,纪守领,2022-06-22 10:24:08,3,3,0,我收回我期中的话jsl 大程可冲 yyds
157898,4389,纪守领,2022-06-25 11:37:18,7,7,0,C大程不用互评是真的良心，虽然大程要求一个人完成但是ddl也比较晚，给分是真的好，C大程可冲
157902,4389,纪守领,2022-06-25 11:45:52,10,12,2,不介意作业很多的话还是很好的，大程solo真的是优点不是缺点，小组作业懂得都懂，而且不用互评
157905,4389,纪守领,2022-06-25 11:55:19,3,3,0,大程单刷，不用展示不用互评甚至可以不用图形库，给分更是海底捞，好！\n\n就是全部得自学，平时作业比较劝退。
157906,4389,纪守领,2022-06-25 12:05:39,3,4,1,老师可能不擅长讲课，但c大没有互评，给分还是很好的！！！
157908,4389,纪守领,2022-06-25 12:07:07,6,7,1,纪老师人很好呀，大程作业虽然要自己写，但是这样才真正锻炼自己能力吧，而且选题不是很难。另外课上内容，也没办法讲很多吧。。。c大确实更多考自己打代码，查知识，在实践中学吧~(我是菜鸡，绩点很低，但是我觉得纪老师评分不应该这么低
157909,4389,纪守领,2022-06-25 12:14:39,5,6,1,老师讲课很有启发性，而且真的是会耐心听取学生的意见，不断改进自己的工作。作业的形式很新颖，可能对于初学者要花些时间，但每一项作业都会带给你满满的成就感，大作业虽然solo，没有互评可以说是很良心了，给分也超好。另外，表白助教哥哥，很多程序上的问题都耐心地帮我解答(甚至从玉泉赶到紫金港)，超级感动!总之，jsl yyds，入股不亏，快选他!!!
157911,4389,纪守领,2022-06-25 13:03:34,2,2,0,大程给分不错\n\n没有互评
157922,4389,纪守领,2022-06-25 15:08:51,1,1,0,给分好，很关心学生，虽然自学比较多，但还是挺有收获的
157973,4389,纪守领,2022-06-26 01:31:26,-6,1,7,感谢老师给的两个满绩，不怕作业多的冲就完事了
158473,4389,纪守领,2022-06-29 14:03:17,2,2,0,收回我期中考时候的话\n\njsl的大程yyds（除了没有小组作业导致认识不到新同学）
158690,4389,纪守领,2022-07-01 10:10:51,0,1,1,表白助教哥哥，真的很耐心。\n\n课程事情很多，四次实验作业，每个几乎都要用掉半个周末，但是都很有意思，特别是文件解密解密出来是周杰伦的歌，很开心\n\n大程序不用互评，打分有具体的要求表，写完程序后大概有多少分自己心里很清楚（就是辛苦助教一个一个批改了┭┮﹏┭┮）\n\n给分真的很好！入股不亏！
158802,4389,纪守领,2022-07-02 10:50:23,-2,1,3,给分很好\n\n不过吐槽一下，两个学期都说要点一次名，导致我逃一次课战战兢兢，结果最后两个学期都没点过名。。
160034,4389,纪守领,2022-09-12 05:05:21,2,3,1,纪老师人挺好的 大家可冲！
160839,4389,纪守领,2022-10-17 00:50:50,3,5,2,评分不该这么低
163119,4389,纪守领,2022-12-07 12:35:56,8,9,1,上课水的一批，都要自学，考试难得一批，非常不适合没有基础的同学。
163141,4389,纪守领,2022-12-08 05:34:33,20,25,5,整天笑嘻嘻的，扯淡是真会扯。上课你没点基础完全学不了。考试巨多，作业巨多（每周至少2-3小时，这还不算自学的时间）。
163900,4389,纪守领,2022-12-16 12:54:45,4,7,3,每节课都点名，考试超级多，作业也多。\n\n主要讲得也不好，全靠自学，看起来好像笑嘻嘻的很好相处，实际上好像总觉得自己高人一等。
164458,4389,纪守领,2022-12-21 05:48:43,11,12,1,真的上课没什么用，都靠自学
165827,4389,纪守领,2023-01-10 03:32:37,4,5,1,对计算机很感兴趣的放心冲，不是很感兴趣慎选
165829,4389,纪守领,2023-01-10 03:38:31,8,9,1,老师风格比较风趣，但是可能一节课很大部分程度都是在扯淡。\n\n我想重点说一下缺点\n\n首先，作业真的真的真的很多，一周的作业可能包括12道函数加4道编程，等于16道大题，我每周不花个4、5小时都干不完，如果一道编程case卡住了，那可能直接时间翻倍（我是没接触过的小白）\n\n然后，考试特别多，美名曰复习，但其实期末的题目给的坑都不一样，用处不大，很花时间。一个长学期下来，考了四次小测（线下两次，线上两次），真的无语住了，甚至回家了还得考两次。\n\n其次，说好点名只是完成任务，只点五次，但是次次课都点，次次课！！\n\n最后，很多时候都得靠同学互助答疑，没有其他渠道，可能你一个case卡住了，都是让你自己调试，我咋知道怎么弄orz，全靠舍友帮忙了。\n\n总结一下，小白不要选！！！！！作业很多很难。\n\n但是，如果你是大佬，还是可以考虑一下，平时分还是可以的（只要你作业、小测都很高）
165832,4389,纪守领,2023-01-10 04:10:06,-3,1,4,还好，挺有意思的，给分也不错
165872,4389,纪守领,2023-01-10 07:45:52,2,7,5,首先纪老师是一位很和蔼的老师，很善良，说话很和气。\n\n然后在98上面看到纪老师是一位很好的导师，选他当导师容易出成果。\n\n再说一下我个人的看法吧：\n\n我学过一点竞赛，但不多，指针没学，函数数组结构本来就会，对我来说，每一章节除了指针我觉得都掌握的还不错吧，然后纪老师讲课有一点PPT reader的感觉，但是有时候他讲着讲着会提出一些“上机尝试”，认真听认真实践的同学想必是会有收获的。而且无论课上课下，你问他一些问题他还是会认真回复的，即使该内容未必和C程有关。当然有人说课不适合小白，这是有可能的，从每次小测成绩也能看出来一点。\n\n作业的话主要是选择填空编程之类，有十次作业，就做作业的题型而言，和考试、小测是契合的，小测的题目以作业的变式题为主。另外还有自选完成的练习（不计入平时分），感觉还是有助于我们备考的。然后作业的量个人感觉还行，ddl给的很长，一般是会在上课前一周发布，上课后一周截止，甚至有时候习题集题目多ddl是三周，做完会有好成绩的，毕竟今年的期末上机“阅读理解”只是突发事件吧……（同时一般来说上机课可以完成相当一部分作业，甚至早期就是全部）\n\n选题的缺点可能是TA选的很多是教材配套练习吧，没有选什么其他学校的题目导致平时作业出题点单一了吧可能不太利于期末（或者涉及算法内容可能较少）。\n\n点名点了十几次，线下是数字点名，都是课间，线上是统计直播和回放的观看时长，所以不想听的这一点完全不用担心吧（笑），更何况还不强制上机。\n\n然后对我来说平时分是给的真好，比我想象给的高，大概帮我总评抬了一档。\n\n只要平时认真，纪老师完全可冲！当然，有点基础会更好！
173805,4389,纪守领,2023-06-03 06:24:37,1,2,1,基本靠自学
176142,4389,纪守领,2023-06-28 02:51:51,1,2,1,大程，jsl的大程的特色就是solo，如果害怕组队会受气或者不想在互评的时候会恶心的可选，而且听说有的班还要做ppt答辩什么的，感觉jsl班除了大程solo别的都还是蛮轻松的，这学期我们只考了一次期中考，没有期末考
176310,4389,纪守领,2023-06-28 10:42:01,0,2,2,C小和C大都是jsl老师的，拿了两个4.5，老师和助教gg给分还是很好的，就是大程solo的确有点难
176446,4389,纪守领,2023-06-29 02:41:35,4,5,1,大程可冲，不互评不展示，solo大程所以相对来说要求会低一些，不过这门课已经成为历史啦！最后表白助教gg，真的太赞啦，给分好人也超级nice！
176668,4389,纪守领,2023-06-29 15:54:12,3,4,1,不怎么样，给分一般般
181640,4389,纪守领,2023-10-25 04:26:08,11,13,2,一句话，绝对真实：适合自学能力强的，收获会很多，能力会有大提升，基本都是要自学，但极度不适合一般人（更何况菜鸡）。
183826,4389,纪守领,2023-11-30 13:56:52,4,6,2,有一说一，签到很频繁，习题课都要签到，这在c程老师里是不太常见的。
184347,4389,纪守领,2023-12-18 05:53:24,6,7,1,他的课，小测贼多，千万别选他，他讲的非常快，还是得靠自己学，虽然很多课都这样
186668,4389,纪守领,2024-01-12 11:51:35,-5,0,5,老师水平高 给分好
186854,4389,纪守领,2024-01-13 09:05:04,0,4,4,老师的课程真的不错，人特别好，跟着讲课节奏做完平时作业期末实验考、理论考百分百过，而且分数不错，小测都是作业题，给分也很不错
188795,4389,纪守领,2024-01-20 03:27:16,5,9,4,老师很负责也挺严厉，平时要多花心思好好学，小测也是要好好考，虽然出的题可能比其他班难一点。不能指望期末考好了绩点就高。
188837,4389,纪守领,2024-01-20 07:19:05,-2,3,5,纪老师讲课很快，小测范围跟的也很快，要是没点自学能力不太能得高分，不过人挺负责的，在考试前还给我们发红包鼓励，助教小哥哥也很耐心负责，最后3.9也满足了（毕竟实验考崩了）
199014,4389,纪守领,2024-09-14 03:27:26,-6,6,12,老师很有趣
199427,4389,纪守领,2024-09-23 09:21:58,-9,6,15,上课讲得挺好，也会布置思考题，锻炼同学自学能力，我觉得这是必要的教育
199797,4389,纪守领,2024-10-02 09:32:23,21,32,11,md 上课随机点名回答问题 对于上课自学的同学纯恶心 因为他还会问你刚才在干嘛 最后等你坐下了还会在全班面前继续拷打你并建议你退课    \n\n\n\n再补充一点 感觉这个人心理阴暗 整个九月份就点一次名 可是是在9月30号的课上点名
199798,4389,纪守领,2024-09-30 03:55:37,17,21,4,不知道哪里来的优越感
199941,4389,纪守领,2024-10-09 02:59:40,2,7,5,小测都说范围了，看了好久ppt复习，结果还是考超纲的
200078,4389,纪守领,2024-10-12 10:58:30,7,11,4,随机点名，答不上来就劝你退课
201348,4389,纪守领,2024-11-01 03:52:19,9,14,5,客观评价：1.适合自学能力强、热爱编程的学生。2.讲课速度较快，知识面宽(所以需要预习)。3.上课点名，问问题没人主动回答就会随机点名(这一点比较受吐槽)。助教cby很耐心上心。听jsl的课能学到真东西(列个数据，他C程101个学生，有十几个进了计院)
202237,4389,纪守领,2024-11-11 03:18:44,-3,7,10,有毛病，自己讲的不行，还tm爱上课提问，不让人好好自学。
204297,4389,纪守领,2024-11-25 06:59:51,3,4,1,老师就是喜欢点名提问，这点是真的烦，但是像我一样边自学边听课也能应付。其实讲课而言可以学到不少，作业还算可以，确实适合自学能力强或者有一定基础的人。助教真的很耐性，上机课也会在场答疑（好像说很多老师都不在比如我室友），总之还可以接受，希望给分能好
206868,4389,纪守领,2024-12-18 05:32:34,21,21,0,这课建议自学能力强的选，老师喜欢点名+点名提问，但助教常博宇真的是很好的人，给jsl打8分有90％是因为助教人真的很好
207712,4389,纪守领,2024-12-24 03:25:01,4,4,0,认真学有回报
208940,4389,纪守领,2025-01-03 12:49:24,6,6,0,平时分相比于别的老师确实比较低一点，但是助教老师真的太好了！！！
209022,4389,纪守领,2025-01-04 08:35:19,7,8,1,老师讲解速度较快 适合有基础的同学\n\n（重度点名爱好者\n\n助教cby小哥哥人超级好超级负责！！！
209660,4389,纪守领,2025-01-09 01:23:19,-4,4,8,出分来感谢老师，被捞满绩了🤓\n\n高大帅气的助教gg超负责\n\n老师每天乐呵呵的感觉挺好，分流前问了几个问题也都耐心回答了，但非常喜欢点名，还会叫人回答问题😰\n\n平时小测的题基本上都是练习题里挑的，稍微准备一下拿高分挺简单，应该算是比较友好的?)
209838,4389,纪守领,2025-01-07 08:20:42,4,6,2,就那样吧，反正我也是一学期全是自学，另外说一句，不要被他假惺惺的“和蔼”微笑骗了，人很阴暗
210354,4389,纪守领,2025-01-09 03:35:51,11,12,1,老师教的不错，但确实很push很压力。小测比其他班难，但看最后成绩应该是会调分的。最后助教cby人太好了！！！
210926,4389,纪守领,2025-01-10 07:35:08,5,7,2,出分了 一分没捞 学在浙大上是多少分就是多少分 上他课满绩的都是佬
210982,4389,纪守领,2025-01-10 09:19:04,7,7,0,满绩了，但他确实上课水平一般，助教人到挺好，自学能力不好的别选
211290,4389,纪守领,2025-01-11 06:41:00,11,11,0,老师经常点名，喜欢抽人回答问题，喜欢自学的同学不建议选，有点push\n\n表白cby助教！人超级好，回答问题很耐心，还会给我们带鲜花饼吃，非常非常好
212981,4389,纪守领,2025-01-15 11:59:52,7,7,0,老师很push，但也是因为真的希望同学们能学好……会奖励主动回答问题的同学饮料hhh如果没有四次小测前的疯狂复习我C程肯定学得依托\n\n感觉能在老师这里拿高分的确实是佬，小测还是有难度的，笨人拼劲全力无法战胜\n\n表白助教cby，超级无敌大暖男一枚！！！回答问题很耐心！如果没有他我这门课的学习体验绝对会差很多\n\n有一点编程基础的、大佬无脑选就对了；但是小白谨慎，本菜菜浙江考生虽然有编程基础而且助教捞了但最后只有4.2
215109,4389,纪守领,2025-02-21 08:12:51,4,5,1,【C程序设计基础及实验】\n\n\n\n先说一些课程基本信息。C尖每周有5节课，3节理论课+2节实验上机课，几乎每次课都要点名，共计有理论课点名12次+实验课点名4次，最后取全班出勤率最高的10次计入成绩，缺勤1次扣0.5分。\n\n对于作业，纪守领会布置3种类型的作业，教材例题、必做作业和选做作业，只有必做作业会计入成绩。这个学期布置了12次必做作业，一次最多会有10单选+10程序填空+5编程，难度尚可，有两个星期完成时间。选做作业大概会有30编程，难度更高，全部做完小测基本稳90以上。\n\n对于考核，纪守领会安排4次小测，占25分，也就是每次小测成绩会折算成6.2分左右。这4次小测大致均匀分布在整个长学期，最后一次小测可能会放在实验考之后，难度最大，这个学期出了一个递归的题目。小测满分不容易，但拿个九十几分还是比较轻松的。\n\n对于绩点，5%考勤+20%作业+25%小测+15%期末实验+35%期末理论。我们班共100人，全部通过，其中23人实验考满分。而最后原始总成绩约有40人在89分及以上。这可能得益于那4次小测逼着同学们要经常复习。\n\n纪守领上课进度是比较快的，别的班还在上数组，我们已经把指针上了一大半，最后挤出了整一次三节课用于期末复习，他说课上1小时课外起码要花3小时去跟进。纪守领上课喜欢随机提问同学，如果你回答不出来，他可能会劝你退课或者骂你几句，但只要你有思路，不论对错，他都会鼓励你。另外，他在课上会提出一些思考题，还有一些课外的知识，认真听肯定有收获，但我本人感觉为此认真听不值得。至于课外答疑，纪守领还是很耐心的，回答得也很清晰。总的来说，这门课可能更适合自学+随时问老师。学校配的何钦铭的教材有不少小错，整体架构也不是很好，建议自己另选一本，何书主要用来考试前扫一遍知识漏洞。\n\n最后，我满绩了，以上对难度的评价请辩证看待（
102270,4489,单珏慧,2019-01-31 15:48:44,-7,1,8,听老师上课真的能学到很多知识，也能有很多思考，老师会认真听每一个同学的发言，也会认真接受每个发言。思修是两个老师分秋冬教的，感觉单老师真的很不错。
115865,4489,单珏慧,2019-08-22 07:03:40,5,6,1,唉，一门水课给分这么差
115982,4489,单珏慧,2019-08-27 15:57:58,5,6,1,给分很迷
117626,4489,单珏慧,2019-09-27 02:01:30,-3,2,5,听了第一节课，感觉非常好
127831,4489,单珏慧,2020-11-28 04:46:42,-2,1,3,老师可好了
128209,4489,单珏慧,2020-12-13 11:47:56,-6,1,7,很有气质，很有意思，很温柔可爱的老师
141251,4489,单珏慧,2021-09-27 10:58:21,14,15,1,nnd 辩论赛能办成我12个选手我也是服了  准备工作都难以进行
147817,4489,单珏慧,2022-01-11 02:44:03,4,7,3,上课普通，给分…只能说很求是。不过思修给分差也不能说是老师的错，要怪就怪sb学校。
150959,4489,单珏慧,2022-02-21 10:43:33,1,3,2,思修被卡绩，真的难受，唯一下4的课，组内贡献度还不能平均，很为难我们组长
151574,4489,单珏慧,2022-03-08 06:51:29,5,6,1,上课事情少，给分也很少
166390,4489,单珏慧,2023-01-12 06:51:33,5,7,2,22 级取消正态之后给分变好了
166447,4489,单珏慧,2023-01-12 09:35:29,2,4,2,给分变好了
166764,4489,单珏慧,2023-01-13 13:21:28,-1,2,3,22级给分似乎变好了，班里一大群4.2和4.5的同学
169225,4489,单珏慧,2023-02-25 01:17:21,-1,3,4,上课很无聊，无情的观点输出机器，搞一堆没有营养的活动（比如完全不是辩论的辩论），破事很多，虽然给分不错
187650,4489,单珏慧,2024-01-17 03:26:28,5,6,1,服了，卡绩是真的难受，上课也一般，念PPT罢了，隔一段时间就来点杂七杂八的活给你，给分很迷，哎，就不能慷慨一点吗，问了一圈同学，被卡的人还不少，反正我是有点后悔选这个老师的
187659,4489,单珏慧,2024-01-17 03:42:27,-2,0,2,总的来说事情还好
215124,4489,单珏慧,2025-02-21 16:55:29,1,1,0,事情很多，给分一般
77011,4582,游瑞杰,2018-04-28 10:38:34,1,2,1,体验极差
71693,4615,陈翔,2018-01-29 01:13:06,0,1,1,老师讲课还算清晰明白，但会有些无聊。给分很不错，最后竟然满了。最后想水的同学注意了，每节课都会有小测（点名）的。
71695,4615,陈翔,2018-01-29 01:13:55,0,0,0,挺好的，老师很温和，给分也很好的。
75492,4615,陈翔,2018-03-12 11:31:28,-1,0,1,不清楚
85244,4615,陈翔,2018-07-16 13:21:17,-21,3,24,查老师找出来竟然找出来还是一个建筑学的老师的评分，emmm原来本仙女是第一个哈哈哈。讲真，老师讲面向对象的思想和具体代码结合的是很好滴，可惜是本仙女水平不够，不能领会到老师的精髓，有很多cplus plus的工程实践方向的应用说明和介绍，考虑到本仙女的编程实践，不确认未来还记得起来，缺点，考试不用pta平台，exm？？？还有就是从玉泉去紫金港早上八点上课emmm略痛苦，虽然我没逃过课
100935,4615,陈翔,2019-01-27 06:59:18,14,17,3,老师上课很清楚啊，然后乱七八糟的要求基本没有。我三次小测只去了一次，最后也满了，给分真的好~强推的老师!
103667,4615,陈翔,2019-03-04 03:27:18,1,1,0,老师不错
113737,4615,陈翔,2019-07-07 06:42:59,5,5,0,老师竟然是个星战迷！常常有意想不到的小幽默，现场编程这个形式很不错，真的让人学到很多！老师会讲很多很细的知识点，重要的考点也在里面，但是混在其中不容易复习。老师对Cpp的理解确实很透彻，但是希望能讲评一下作业
114196,4615,陈翔,2019-07-09 04:02:38,5,6,1,DS和OOP都是陈老师，DS会有若干次quiz（点名），OOP不点名。老师人很好。讲课也比较清楚，给分厚道，上课会用vim写代码）
120665,4615,陈翔,2020-01-14 23:00:11,1,2,1,好老师 给俺调高了一分
123046,4615,陈翔,2020-05-05 11:42:42,12,14,2,没有什么能够阻挡...（至今还记得oop讲到指针时的这个梗）
125544,4615,陈翔,2020-09-11 07:40:22,7,7,0,老师的OOP很好
125556,4615,陈翔,2020-09-11 12:02:40,0,0,0,老师给分也太好了8！！！！
131679,4615,陈翔,2021-01-28 11:44:26,3,3,0,ds给分真好
131804,4615,陈翔,2021-01-29 04:01:51,2,2,0,老师人很好，讲课也挺多干货的，而且给分特别特别好！
132082,4615,陈翔,2021-01-30 06:49:07,11,13,2,陈翔老师的ds班，客观给出事实并给出我的评价。\n\n总评：老师人很好，讲课一般，给分很好。\n\n老师讲课个人感觉中规中矩，该讲的都会讲，不出色也不差，ppt做的还行。\n\n老师不点名，有几次小测，但是都会提前在群里通知下节课会小测，所以不用担心小测没去。小测题目都是作业题(pta的选择题)，是大家错的较多的，把作业答案弄明白就行，很容易。\n\n平时作业就是pta，中规中矩。\n\n互评没什么好说的，但是老师会打击一些恶意评分的人(比如有的人就很恶心，给所有人打75分(满分100)，老师会把他挂出来)。\n\n期中期末考试也没什么好说的，统一考。\n\n最后，给分相当好，我期中80，期末92老师总评给满了。我一同学互评有一次忘提交，还有一次忘了评分被仲裁扣分，但是老师也给了4.5还是4.8来着。\n\n还是推荐大家选，毕竟主要靠自学嘛，老师相当不错了
133570,4615,陈翔,2021-03-02 08:36:57,1,1,0,老师给分非常好 上课挺有趣的
137964,4615,陈翔,2021-07-07 02:15:40,2,2,0,老师人很好啊
139442,4615,陈翔,2021-07-15 14:40:05,6,6,0,老师水平很高，oop给分也很好
147643,4615,陈翔,2022-01-10 10:54:28,1,1,0,好老师 选就完事了
148015,4615,陈翔,2022-01-11 10:16:02,2,2,0,ds给分非常好
151598,4615,陈翔,2022-03-09 01:00:02,5,5,0,陈翔老师上课非常认真，给分好，事情不复杂，预置到了偷着乐系列
157370,4615,陈翔,2022-06-30 05:30:38,5,6,1,老师人很好！可惜我太菜，考的太低orz出分前拜一拜 希望能捞捞呜呜\n\n来还愿了，老师我爱你！！
158529,4615,陈翔,2022-06-30 04:37:12,5,5,0,oop，讲课的很细、挺不错的，最后给分超级无敌好！！！
158530,4615,陈翔,2022-06-30 04:52:25,5,5,0,oop这给分，会不会太好了，靠，给得有点多了我去
158531,4615,陈翔,2022-06-30 04:52:20,4,4,0,oop这给分，会不会太好了，靠，给得有点多了我去
158542,4615,陈翔,2022-06-30 06:01:14,3,3,0,给分好，推荐
158550,4615,陈翔,2022-06-30 07:24:06,4,5,1,ds和oop都是cx老师的，这给分也太好了吧呜呜呜
158601,4615,陈翔,2022-06-30 14:21:11,4,4,0,啊啊啊啊啊啊OOP出分了\n\n陈老师，你～是～我的神！！！
158779,4615,陈翔,2022-07-02 05:23:01,6,6,0,oop cx平时分基本不为难大家，最后能考到多高，全靠期末能考多好
158957,4615,陈翔,2022-07-04 02:33:42,7,7,0,平时分高，给分好，你还可以不来上课听自己喜欢的第三方资源，10分！
177517,4615,陈翔,2023-07-03 14:34:44,2,2,0,oop给分过于好了吧，平时缺了次小作业又迟交了次project，最后感觉平时分应该满了？（可能有bonus啥的，不清楚。）我的神！
177583,4615,陈翔,2023-07-04 00:21:26,1,1,0,真的强推cxgg！！！！讲得好，不拘泥于C++基础内容，讲很多比较新的性质，平时作业适量而且不死板，给分真的太太太好了！！
184363,4615,陈翔,2023-12-18 07:41:53,24,26,2,老师主页很好看！
188583,4615,陈翔,2024-01-19 10:09:55,1,2,1,陈老师是我爹😭\n\n讲课好 给分好 容易沟通 班上互评氛围好😭😭😭
195686,4615,陈翔,2024-06-29 14:24:08,4,4,0,OOP唯一推荐老师！老师很和善，钉钉消息也回得很快，而且感觉cx老师是计院屈指可数的真的懂自己在讲什么东西的。老师上课思路非常清晰，如果能跟上真的会有飞起来的感觉，而且超强vim手，上课会vim写代码，对理解很有帮助。老师不拘泥于课程内容，还会在xzzd上放一些further reading，对想提升的同学是很好的阅读材料。cx老师的PPT也是非常好看的（反观隔壁xww）。一次点名也没有，没有小测，没有期中考，每两周一个assignment编程题共六次，每两周一次作业，内容也很少，一或两道填空题/程序填空题。assignment给分也很好，基本功能完成了都会给满，不会有逮住扣分的情况（这一点可能看助教？23春夏的助教是很好的）。总之强推！
196261,4615,陈翔,2024-07-02 17:14:42,2,3,1,爹，平时分做了bonus给满了
196264,4615,陈翔,2024-07-02 17:19:18,5,5,0,oop超人，无期中考，不点名，assignment做完基本上就是满分，给分也很好
196275,4615,陈翔,2024-07-02 17:50:15,3,3,0,oop神！！！！！无点名无小测无期中assignment做了给满，期末客观题拿高点就行。
196289,4615,陈翔,2024-07-03 00:06:08,5,5,0,今年的ds期末卷子是谁出的（吐血）
196312,4615,陈翔,2024-07-03 00:59:20,1,2,1,OOP唯一的神！！！！上课基本上拿代码做范例而不是照本宣科地念PPT，PPT做的很简洁好看，基本上讲的是c++11及以前的东西，给分真的超级好！！！\n\n就是上课代码看不到，智云回放不方便需要自己敲
196331,4615,陈翔,2024-07-03 02:17:23,0,0,0,oop大爹
216398,4615,陈翔,2025-03-15 12:27:35,4,4,0,非常好！
217210,4615,陈翔,2025-04-04 11:33:51,4,4,0,fds课，老师人很nice，讲课也很好，project给的时间也很充分
219730,4615,陈翔,2025-06-05 02:33:01,4,4,0,好老师！！！\n\n\n\n很体贴学生，上课也很有意思
221762,4615,陈翔,2025-06-26 05:10:24,1,1,0,上的fds 很好的老师\n\n不点名 小测也很宽松（基本上是课后题 甚至可以翘课然后钉钉私发助教提交）\n\nproject的互评也是很公平的 老师和助教的大手会发力 恶意打低分的情况基本没有\n\n相当推荐
221845,4615,陈翔,2025-06-27 00:32:55,0,0,0,fds，个人认为是计院里综合看来最好的fds老师！不点名+给分好+互评氛围好+知识点讲解深入浅出+小小的幽默感，非常推荐选的老师！
221978,4615,陈翔,2025-06-28 07:41:02,0,0,0,cx老师的oop强推！上课用vim演示代码，专注于oop的核心思想。平时分也很好！
221999,4615,陈翔,2025-06-28 12:32:34,0,0,0,fds和oop都是cx老师的，一学期下来我会说不上cx的课是一种损失。人帅课好给分高，oop一边讲一边vim实操溜的飞起，fds大手一挥优化掉了互评制度，随便一样拿出来都能夸一篇小作文。讲课风格尤其吸引人，在cx老师的课上切实感受到了技术知识是酷而好玩的，满分送上！
124871,4912,何钦铭,2020-07-14 05:26:15,2,8,6,何老师讲课很牛，网课期间每个知识点都有重难点小视频，以后复习好资料啊。计院高水平的老师！
74528,5048,李玺,2018-05-18 10:24:33,-19,8,27,老师很认真
76713,5048,李玺,2018-05-17 03:49:39,15,21,6,是故才德全尽谓之圣人，才德兼亡谓之愚人，德胜才谓之君子，才胜德谓之小人。凡取人之术，苟不得圣人，君子而与之，与其得小人，不若得愚人\n\n\n\n此人小人
76872,5048,李玺,2018-04-25 04:30:43,9,14,5,李玺三连\n\n这个大家都用过吧\n\n这个大家课下看一下吧 \n\n今天讲的差不多了，讲的也没个啥
76916,5048,李玺,2018-04-26 02:16:47,19,27,8,讲课很差，以为学生什么都学过。
76930,5048,李玺,2018-04-26 05:07:02,12,16,4,感觉是适合做科研不适合教课的老师……上课如同听天书，还喜欢站在制高点指责学生。比较自负的一个老师，不推荐他的人工智能。
76942,5048,李玺,2018-04-26 07:41:54,8,10,2,讲的真的垃圾
77872,5048,李玺,2018-05-08 09:38:56,23,27,4,科研很强，讲课不行。适合做科研，不适合教学。\n\n浙大应该改一改教授的制度。不要让不适合和不喜欢讲课的老师来讲课。既耽误老师的科研时间，又苦了听讲的同学。
78839,5048,李玺,2018-05-15 14:46:55,10,12,2,真的讲课很差，AI只能去旁听别的老师的课，他真的上课，全在说空的，课件半个学期才给，作业半个学期了也不布置，期末爆炸的节奏\n\n
78926,5048,李玺,2018-05-22 16:52:32,6,9,3,辣鸡！
79809,5048,李玺,2018-06-14 02:29:52,1,1,0,看到楼上的评价我就放心了
82797,5048,李玺,2018-07-09 06:56:44,1,1,0,李老师的科研还是挺强的，他的实验室也是发了很多顶会。就是讲课的内容比较难，很多数学内容他都默认我们已经学会的，然而除了那些接触过这个方向的同学，其他同学基本上不会阿…比如很多线性代数和概率论的东西，完全远远超出大一大二学的！听舍友说王东辉老师讲的比较好，可能吧
82823,5048,李玺,2018-07-09 07:41:58,10,10,0,李老师论文发的是真的多，李老师的AI课是真的“以点带面”。想在老师的指导下，认认真真学人工智能的话，不建议选李老师的课，他讲的不是说没有价值，但是层次太高，太务虚，要是之前没学过，听着就很没意义。布置作业也不靠谱，期中之后才布置第一个作业，最后只能比别的班少做一个project。唯一好一点的，李老师给分应该还可以。
83836,5048,李玺,2018-07-11 09:36:41,7,7,0,李老师人不错，就是不太了解我们的水平。
113035,5048,李玺,2019-07-05 18:25:23,0,0,0,大数据原理的报告过于硬?
161762,5048,李玺,2022-11-12 12:50:43,0,0,0,懂得人不需要听他的课，不懂的人听他的课也没用。
172679,5048,李玺,2023-05-04 08:54:56,1,1,0,上课就是傻逼一个
173265,5048,李玺,2023-05-17 07:40:27,3,3,0,逆天，见\n\nhttps://www.zhihu.com/answer/3028481556\n\n和98帖子
191628,5048,李玺,2024-04-26 06:38:25,6,6,0,国际化，sum（视频时长）=上课时长
193690,5048,李玺,2024-06-15 11:38:54,2,2,0,选了老师的机器学习国际化 以前不知道至少这个课上老师真的挺认真负责的 每次课还会自费带咖啡和零食给大家分享 事也不多大作业就是一个展示 平时也没有小作业 给分很好最后也满了
196413,5048,李玺,2024-07-03 08:50:21,0,0,0,机器学习国际化挺好的
206469,5048,李玺,2024-12-15 10:58:29,0,0,0,国际化给分挺好的\n\n但是其他课没上过，姑且打个平均分
220838,5048,李玺,2025-06-20 05:29:50,1,1,0,国际化扣分全部来自中方，扣的还贼多，离谱！千万别选，快跑！
73379,5068,Janice Regon,2018-02-01 12:49:40,0,0,0,不错哦
141968,5068,Janice Regon,2021-11-02 08:41:45,0,0,0,每次打JR都会达成个嘉然。。。。。
119614,5102,应晶,2019-11-14 06:33:52,1,1,0,为什么没人评分？
125937,5102,应晶,2020-09-16 01:59:39,2,2,0,芜湖快乐
133292,5102,应晶,2021-02-23 13:14:28,5,7,2,老师非常负责，讲课新手向，有个小组大作业的要求。期末批大作业的时候还会一个一个鼓励同学。但是编程这事再新手向也得靠自己。
133644,5102,应晶,2021-03-03 06:32:30,5,5,0,老师人很耐心，讲到也很不错，比较喜欢叫后排的同学回答问题，课程很不错哒。
134173,5102,应晶,2021-03-18 02:20:50,-4,0,4,事情多
143748,5102,应晶,2021-12-04 07:20:46,2,2,0,老师非常棒
145583,5102,应晶,2021-12-30 10:38:49,2,2,0,老师人好
148334,5102,应晶,2022-01-12 07:05:34,8,10,2,1.老师人真的很好，这个没得说，讲课会一再问有没有没听懂的地方，考试考的不好去问他会耐心开解鼓励\n\n2.是真的希望学生能独立思考学出成绩，上课提问希望得到的是经过认真思考的答案\n\n3.助教缪老师也很好，认真负责，问他问题有问必答，编程大作业他负责打分的时候还会很耐心地解答同学的疑惑，甚至帮忙完善程序（不是作弊放水意味，就是同学编的时候可能有地方不够完善他会指出来然后教你怎么做更好，打分还是看你一开始交上来的成果）
149912,5102,应晶,2022-01-17 17:28:55,6,7,1,是绝世大好人没错了，好到已经找不到什么词来形容了，选上他的课就是一种幸运吧。
152175,5102,应晶,2022-03-29 12:00:05,4,4,0,讲课讲得非常好，为了保证同学们听懂了，经常向同学提问，同学不会时他还会给很多提示。给同学们的成绩也非常高。吹爆！\n\n满绩学生前来感谢！
154156,5102,应晶,2022-05-25 01:12:31,-34,2,36,这名字😅
167491,5102,应晶,2023-01-16 16:08:49,3,3,0,呜呜  应晶老师太棒啦  激动得连夜来写评论！！！\n\n本人C零基础，整个学期也都学的很忐忑。\n\n老师让看英文原著，可我一个学期就啃下来三章[暴风哭泣]\n\n老师让做小组作业，看到队友的各种高级操作，分给我的任务也做的一塌糊涂（最后队友把我做的全改了（此处匿名感谢[合十]\n\n不过惊喜的是，期末竟然飘过啦。\n\n应老师讲课循循善诱，课间课后去问问题也都超级耐心。记得刚开始我经常去问一些现在看来很低级的问题，但是老师还是会一点一点的解释，并且还会给我一些小问题让我回去自己编编试验。\n\n应老师讲课幽默风趣，伴随着一些他与师兄(zhgg)的小故事，以及窃取别人账号（bushi）的各种故事让我对于知识的记忆也更加深刻。\n\n应老师为人和蔼可亲，刚开始我不知道选课原理就退掉了C小，但是和应老师邮件沟通后他很爽快的就同意了我的补选，后期在钉钉上也很和蔼，从来不会已读不回[可怜]尤其线上考试以及模拟测试的时候，老师的话语都让我莫名的心暖。\n\n顺便bd缪学长（助教），PTA上的无数bug，mfgg都是一点一点帮我找的（其实我做的思路特别绕，完全不是出题人要的那种），但是每次学长都会先指出我编的问题然后才会告诉我更好的思路，而不是直接就告诉我标准答案。这一点吹爆mfgg!\n\n感谢应老师和缪学长，大家都来选吖！
188659,5102,应晶,2024-01-19 13:15:01,1,1,0,上课会抽取幸运观众到讲台领讲
189618,5102,应晶,2024-01-26 03:43:26,1,1,0,期末谢谢谢谢谢谢\n\n男神！
189819,5102,应晶,2024-01-30 08:04:05,0,1,1,程设\n\n期末大题5道只做出三道半，小组作业认真对待，绩点4.8\n\n老师是很好的老师，混合班的前辈学长\n\n（上课抽取幸运观众到讲台领讲是讲课一大特色（为的是让学生试错、真正搞懂））
201722,5102,应晶,2024-11-05 15:54:36,0,0,0,非常负责任，上课会随机抽取幸运观众上台回答问题，但绝对不会为难你，即使你一头雾水他也会耐心地帮你把这个问题搞明白，上应老师的课有一种被手把手教学的感觉；但是高中没有选秀信息技术的同学学习c语言基础这门课可能还是比较有难度的，如果英语教材比较难读也可以去mooc上找公开课自学一下。
204603,5102,应晶,2024-11-27 03:40:40,0,0,0,应老师上课确实非常细致耐心，属于会手把手教的那种老师。但是对于想要专心自学的同学，上课高强度点人发言并不是非常友好。
205918,5102,应晶,2024-12-12 16:03:21,1,1,0,上课笑眯眯的！ppt和板书结合，讲得很清楚，很详细，适合不太有基础的同学。上课会点人回答，但是不会为难你，回答对了会鼓励！！下课去问他问题也会很有耐心地回答，总之选上他你们就偷着乐吧！
207717,5102,应晶,2024-12-24 03:35:12,1,1,0,非常非常非常好的老师！
207941,5102,应晶,2024-12-25 04:09:29,2,2,0,很好的老师，讲解很清楚，会追着你一直到你把这个概念弄懂，讲课也超有意思
212110,5102,应晶,2025-01-13 07:50:04,2,2,0,期末被狠狠捞起来！老师人特别好！冲！！
212122,5102,应晶,2025-01-13 08:24:19,1,1,0,应老师男神！\n\n上课循循善诱非常有耐心，会点人检验成果，如果你不会他会一点一点讲清楚，课堂效果非常好这能学到很多东西\n\n机房课比较水，不过作业一定要认真完成，个人感觉pta还挺好玩（？）\n\n平时有问题随时问，大型作业应老师非常爱夸夸，鼓励引导进步\n\n从来没学过c语言，最后感觉收获颇多\n\n赞赞赞！
212355,5102,应晶,2025-01-14 02:06:47,0,0,0,巨好巨好的老师，没上过他的课就是亏了
215043,5102,应晶,2025-02-20 08:50:15,1,1,0,会努力使每个学生都学会了，很耐心。给分好！
74436,5173,巫英才,2018-02-24 01:17:27,4,10,6,作为毕设导师，尽心尽责，超棒的老师！如果想认真搞科研，欢迎来zjuvis！巫老师绝对不会让你失望！
79350,5173,巫英才,2018-05-31 10:37:53,-27,15,42,巫英才就是个大垃圾垃圾。
103934,5173,巫英才,2019-03-07 12:46:47,3,6,3,非常好呀
116051,5173,巫英才,2019-09-01 12:18:08,2,8,6,上了小学期，还8错！
122302,5173,巫英才,2020-02-23 16:03:34,2,9,7,我觉得老师非常可！冬学期只点了一次名，作业难度的确有点，大作业花点心思设计的别出心裁一点完全可，没参加实验室项目，但是老师依然给了满绩！用心了，成绩不会差！
125040,5173,巫英才,2020-08-17 12:58:17,0,7,7,反正小学期👴满了
132402,5173,巫英才,2021-02-01 10:20:14,4,20,16,个人观点\n\n1… 作业要求说的并不清楚 可以说是什么要求都没有说 等你做完以后又提出一大堆其他的要求 这点并不是很满意\n\n2… 建议老师去学一门课叫说话的艺术 展示的时候动不动凶学生超时 但是上课又经常拖堂 甚至拖堂点名 个人不是很能理解 您有何资格跟学生谈时间观念\n\n3… 不知道这么大架子哪里来的 我认为不过是个色厉内荏的草包 自身素养可能需要提高\n\n4… 建议课堂可以多出一些有用的知识 而不是高谈阔论 学生都在自学 也好意思说学以致用 可以问问您讲了什么可以用到的吗
132409,5173,巫英才,2021-02-01 10:46:47,0,6,6,老师非常严格，讲话起来凶凶的。平时会点名，而且没办法水，扣分很多。上课还行，但是比较虚不实用，作业比较多，对前端小白很不友好。给分应该还可以。
136266,5173,巫英才,2021-06-14 18:27:16,5,7,2,暑期的课，被大力推荐！
136434,5173,巫英才,2021-06-18 02:25:31,10,17,7,巫老师为人很好，授课也会认真备课\n\n可视化不只是前端，很多同学前端基础薄弱所以会感到有点吃力\n\n因为要学习一些前端框架，还要学习可视化的理论（啊喂，不要把可视化当做excel图表！！！）\n\n理论加实践才是一门课应该有的样子嘛\n\n老师给分是非常OK的，要求严格是应该的\n\n上过老师三门课了，给分非常棒，非常推荐学弟学妹来选！
138809,5173,巫英才,2021-07-11 03:12:25,0,3,3,上了思想史，一节课只需要最后一次课到场展示（一定要到场，会点名）再交一份综述就有4.5以上，强烈推荐。
138813,5173,巫英才,2021-07-11 03:53:05,1,2,1,思想史水是真的水，给分也是真的挺好
138814,5173,巫英才,2021-07-11 03:53:06,0,2,2,思想史水是真的水，给分也是真的挺好
165229,5173,巫英才,2022-12-30 10:15:00,12,15,3,感觉“个人观点”开头的那条评价其实很客观。\n\n几条问题都是真实存在的，感觉和大家公认的好老师之间还是有很大差距的吧。\n\n也许有人说给分挺好？但是课程的感受确实不敢恭维。
168284,5173,巫英才,2023-02-09 08:24:14,0,1,1,挺好的老师
179250,5173,巫英才,2023-09-03 19:36:20,1,5,4,大一暑假的可视化短学期：课程体验一般，课程的大作业基本靠自学，零基础短时间入门一个前端框架挺痛苦的，而且和上课的内容没什么关系，不过做出来之后确实挺有成就感的，给分也不错（班上很卷，做完pre真的觉得被别的组碾压…
181285,5173,巫英才,2023-10-13 02:50:20,8,10,2,可视化短学期做了个有意思的小项目，稍微肝一肝就出货了，收了满绩
189317,5173,巫英才,2024-01-23 07:08:49,3,3,0,跨媒体数据可视化是哪个天才安排成工设必修课的？这屌课大作业随便给分的？
202141,5173,巫英才,2024-11-10 04:29:58,1,2,1,上课不让用电脑有点离谱了
212698,5173,巫英才,2025-01-14 13:36:17,2,2,0,数据可视化导论，冬学期的课。课的形式就是好几个老师轮流分享各种可视化形式和自己的工作，了解了解挺有意思。并且有直接报名进实验室做大作业的机会，但我没有选。平时事比较简单，但大作业是得认真做一做的。给分不错
221532,5173,巫英才,2025-06-24 09:23:58,0,0,0,思想史出分了，好课bd，今年是个人调研报告+小组调研报告，全程基本上没有工作量，突击几天调研报告就OK了，虽然说给分标准不太清楚，但是身边同学感觉都还不错
164738,5227,姚敏,2022-12-24 12:58:56,0,0,0,姚老师，让我飞！
199933,5250,董金祥,2024-10-08 16:00:32,0,0,0,和我室友一个名字，给满分！
129628,5290,杨小虎,2021-01-09 07:29:37,0,2,2,区块链与数字货币本身的概念比较新，但是老师讲解还是通俗易懂，比如在fabric讲解中老师把整个流程比作财务报销，一下子就明白了。
131830,5290,杨小虎,2021-01-29 04:25:35,4,7,3,区块链课不点名大家几乎都不怎么去，平时有三个小作业，最后有一个大程序。总的来说课程不水而且挺费时间的，但是只要作业好好写给分真的特别良心，给分巨好
161067,5290,杨小虎,2022-10-25 12:39:50,-1,0,1,最好有前端基础
161333,5290,杨小虎,2022-11-04 07:29:36,0,0,0,非常负责的老师
162020,5290,杨小虎,2022-11-16 04:59:18,0,1,1,上课不点名，讲课也很有趣，并且课件和讲课的内容也是与时俱进的，最后给分也不错，推荐选。
183850,5290,杨小虎,2023-12-01 07:37:05,4,4,0,刚刚出分来评一下，上课不点名，老师算是资历比较老的的，讲课水平还可以，但是三个作业挺麻烦的（尤其第二个），助教可以看得出很厉害，但是能提供的帮助不多。总体感觉事多分少，不是很推荐。
124836,5302,袁昕,2020-07-12 00:10:56,5,11,6,讲课感觉不怎么样，基本上都是放牛吃草，作业的检查好像还挺严格的有点麻烦，主要遇到了一个很认真但是不想做事的队友，好难受
150134,5302,袁昕,2022-01-19 09:18:16,6,8,2,给分很好
154133,5302,袁昕,2022-05-24 08:53:08,4,4,0,小学期打分没想象中那么好，可能安卓和金融会好一些，个人感觉）
160591,5302,袁昕,2022-09-30 05:16:04,0,1,1,[课程综合实践Ⅱ] 老师脾气有点怪，比如验收的那几天早上来的时候喜欢先水一小时手机再干活，期间不喜欢人打扰，但总体还是挺关心学生有没有学懂思想的。结合我们组个人的经历就是感觉作业好一点差一点，只要基本符合要求，都在92上下浮动，所以想拿满绩有点难。
174874,5302,袁昕,2023-06-19 08:51:35,-1,0,1,答辩时讲解比较耐心。还没出分，先给9分
178083,5302,袁昕,2023-07-06 17:17:24,2,2,0,短学期讲课不清不楚（也没什么人听），但是老师人还不错，上课不点名，工作量有点大，如果组内有大腿还是可以的。
178580,5302,袁昕,2023-07-16 02:07:42,5,5,0,我来记录一下，今天是7.16验收，现在10：07，老师在水手机
196687,5302,袁昕,2024-07-04 18:02:42,2,2,0,大规模给分无敌好，事少分高，还不点名，包好的！
197061,5302,袁昕,2024-07-07 04:19:20,2,2,0,十人组队，做的事情不是很多，课就去过2次，最后满了～神仙老师！\n\n估计全队都满了hh
197686,5302,袁昕,2024-07-29 15:08:26,-2,0,2,研究生课给分高
221287,5302,袁昕,2025-06-22 13:38:02,2,2,0,很水很佛系，最后给分很好
122066,5344,周波,2020-02-10 21:31:58,4,7,3,上课喜欢吹自己，课讲的还行，比较和蔼可亲
124626,5344,周波,2020-07-04 05:34:10,-3,0,3,人很好，而且教学水平和业务水平都很高，答辩的时候提的问题挺精准的
125758,5344,周波,2020-09-14 04:18:52,3,3,0,老师人很好 教的一般 助教改实验全班按提交时间统一给分(2分钟批完全班的全部实验给统一分数) 大程给的时间比较多 期末不调分不调分! 想要追求绩点的还是建议去选孙建伶老师
125871,5344,周波,2020-09-15 06:42:50,0,0,0,讲得好，但是给分不好
126083,5344,周波,2020-09-17 08:29:01,1,1,0,还可以，但是数据库总体给分不太高
131801,5344,周波,2021-01-29 03:58:05,0,0,0,老师人很好，但是给分一般，只能说比较务实吧不怎么调分
138934,5344,周波,2021-07-12 01:06:32,1,1,0,老师课讲得很清楚，平时事少不点名，给分确实不太行(可能是我太菜了)
139223,5344,周波,2021-07-13 10:45:06,2,2,0,老师感觉是典型的大学老师，懂得特别多，讲解起来思路清晰，一副很轻松的样子。所以有些地方比较轻描淡写，整体也略显枯燥，如果追求讲课效果的话感觉sjl老师是讲的最好最有激情的（考前靠sjl补天~）。平常事少不点名，答疑也很及时，是个很好的老师。给分的确比较一般。
151127,5344,周波,2022-02-23 09:16:35,3,3,0,老师更适合去欧美那边的学校，感觉zju不太适合他
152321,5344,周波,2022-04-05 11:09:30,1,1,0,讲得还行，就这样
158555,5344,周波,2022-06-30 07:40:13,5,5,0,讲得一般吧，给分不大好
158563,5344,周波,2022-06-30 08:34:47,4,4,0,关于讲课：大多评价是一般，我觉得其实还行。老师自己是非常懂的，私下问问题可以感受得到，也很愿意和你交流。上课是会把所有知识点都讲过来，分不清主次，讲到重点还会兴奋起来越讲越快。也听过sjl网课，相比之下，关于有没有讲清楚，我认为如果有预习的话是讲清楚的(不过大多数人应该都没有预习)，只是有些地方比较快，期末看书再看回放时候是可以感受到确实是有讲的。\n\n另外老师的风格我非常喜欢，第一节课就说大学老师上课没人听是老师的问题，绝对不会点名。\n\n都说给分不行，可能是我期末考得比较好，加上是组长，最后92。事正常多。没有额外的，就是每节课课后理论题+5个实验+minisql。\n\n另外助教验收比较恶心，另外自己也不懂数据库，有问题也没法问。但好像给分不错，自己说老师交代过平时分不可能全部给满，但会尽量给大家高。\n\n总得来说要是选的上孙建伶那当然选，选不上的话周波也可以。\n\n另：微博@周波v
158800,5344,周波,2022-07-02 10:13:16,1,1,0,好老师。。。
158883,5344,周波,2022-07-03 04:05:33,-4,1,5,事情少，学习靠你自己。大程验收严但是给分好，我最后分很低完全是不好好学的个人原因，老师助教都很好。
170484,5344,周波,2023-03-05 16:33:36,2,2,0,长得好像温家宝总理
176089,5344,周波,2023-06-27 16:58:38,13,13,0,老师其实挺好的，助教......😅
176189,5344,周波,2023-06-28 04:14:46,15,15,0,助教不要太离谱
177281,5344,周波,2023-07-02 14:34:40,8,9,1,老师其实人还可以的，只是给分比较求是完全不会调分。今年数据库的助教纯逆天，从来不回同学的私信，甚至同学问他问题他会回你别问了，miniSQL明说组队扣分，只有Solo能拿到正常的分数，离谱至极。只能说对自己期末考试有绝对信心或者只是想过的来选，否则付出很多结果会大大低于预期，均绩会比别的班低0.3-0.5。4学分的大课，大家可以权衡一下
177555,5344,周波,2023-07-03 16:17:05,1,2,1,老师很好，不点名，鼓励自学。助教纯纯逆天
187561,5344,周波,2024-01-16 14:38:33,3,3,0,可靠消息，2024春夏助教换了
196175,5344,周波,2024-07-02 03:57:45,0,1,1,出分也太慢了吧，干什么呢
196265,5344,周波,2024-07-02 17:22:12,4,4,0,这届助教属实良心，在期末考试稀烂的情况下给分意外地好。
208071,5355,陈珂,2024-12-25 12:41:29,1,1,0,心理学系的陈珂老师，非常善良热情有活力的美女老师～最后一节课还给我们带了糖！
209993,5355,陈珂,2025-01-08 00:27:53,2,2,0,看完好东西之后去上课，惊觉老师长得也太像钟楚曦了，美美美！！
214444,5355,陈珂,2025-02-04 11:13:52,1,1,0,老师亲切可爱，最后一节课还给我们带了糖果，讲课善于联系生活实际，虽然略显紧张，但态度认真负责
129973,5371,任奎,2021-01-14 09:02:28,-33,29,62,2021年1月14日，国际计算机学会公布了2020年新选会士名单（ACM Fellow），浙江大学网络空间安全学院院长、计算机科学与技术学院副院长任奎教授因其在无线系统安全和云数据安全上的卓越贡献当选。
184674,5371,任奎,2023-12-22 06:34:02,5,8,3,来图灵的理想：成为任奎
121957,5403,高艺,2020-01-26 02:16:08,2,4,2,上过他的计网，讲的很快，不明觉厉
132857,5403,高艺,2021-02-04 15:53:05,4,7,3,讲课干干的，有点没激情，但专注听会发现老师讲课思路是很清晰的，全程跟上可以节省很多课后学习的时间。会有突发小测，题目很简单，考当堂课讲的内容。实验节奏比别的班快，ddl稍赶，但另一方面早早结束实验能留时间给别的课程也挺爽的。最后两周是展示课，没有期末复习，私以为这种展示对能力提升帮助不大，纯增加工作量。\n\n关于期末考试没必要教材全过一遍，记得多刷历年卷选择题和考研题。
167544,5403,高艺,2023-01-17 07:34:34,8,8,0,给后来选高老师的学弟学妹们一点建议，其实这也是计网这门课的特点：王道上的题目要看，但是如果你时间充足的话，不要n刷王道，考试并不是将知识往深度考的，而是注重你知识的广度，很可能王道上三四十道题目最后只对应期末的1道题，还是那种口算就能算出来的题
184284,5403,高艺,2023-12-15 08:34:40,4,4,0,正在看智云补天，老师的讲课水平其实挺高的，讲的其实挺清楚挺有逻辑，但是不知道为啥当时坐在教室愣是一个字都听不懂也听不进去...
187670,5403,高艺,2024-01-17 04:44:33,3,3,0,高老师讲课水平很高，上课很清楚。但是平时分正太是真的难绷
197432,5403,高艺,2024-07-15 06:10:28,6,6,0,半年之后越想越气，来评个分。。\n\n平时分所有人平均会扣10分，折合总评也就是扣6分总评，直接掉两档\n\n而且这课的作业和lab根本没有多少区分度，所以就等于你正常做作业就一定会被扣，可能只有全抄答案+实验写一堆文字才会算作助教眼中的能过关吧\n\n更幽默的是，助教说这是各个班助教统一商量的；结果实施下来，有些班基本上平时分都是满的hh
211273,5403,高艺,2025-01-11 06:02:32,11,12,1,实验和别的班不一样 好 可以的\n\n但是考试考到了别的班的实验内容 而且你声称你“做过卷子” 能不能至少提前说一声 至少提前发一点相关资料也行……  期末直接12分大题没了
213947,5403,高艺,2025-01-22 03:22:47,2,2,0,感觉扣了不少平时分 和估分有不小差距 上课水平是不错的 但期末属于背刺本班同学
218257,5403,高艺,2025-04-22 08:40:41,0,0,0,做新实验，期末考旧实验，一点也不带提醒的
122071,5448,潘之杰,2020-02-11 05:12:07,8,14,6,巨坑，人工智能引论不知在讲啥，虚头巴脑的堪比政治课，还要每周写论文“人工智能的新应用”，立马退了。貌似最后100多人退的就20来个
207636,5448,潘之杰,2024-12-23 11:30:52,8,8,0,快跑！
208251,5448,潘之杰,2024-12-26 11:15:51,8,8,0,不知所云
208252,5448,潘之杰,2024-12-26 11:17:10,9,10,1,自动驾驶课，讲的跟自动驾驶有关系吗
214200,5448,潘之杰,2025-01-28 04:27:12,7,7,0,虚头巴脑，不知所云
214236,5448,潘之杰,2025-01-30 09:02:26,7,7,0,。。。
214533,5448,潘之杰,2025-02-11 13:10:43,6,6,0,讲课和自动驾驶没关系，不知道为什么非要扯上自动驾驶
216931,5448,潘之杰,2025-03-29 08:50:23,1,1,0,1111
217585,5448,潘之杰,2025-04-14 01:43:43,2,2,0,机器人水课要求学生用ai写论文，一周之内从0写，还一本正经说可以投稿给期刊，神经啊
123525,5580,周亚金,2020-06-09 10:33:02,-19,10,29,破课事贼多
126351,5580,周亚金,2020-10-01 16:17:53,-15,7,22,有些护主的可能听不惯实话
127978,5580,周亚金,2020-12-02 05:09:05,-6,8,14,这老师能高于0分？
128194,5580,周亚金,2020-12-12 03:23:45,7,9,2,对不起，lab4我写自闭了，上来吐个槽，同时劝下一届的朋友们快逃。
128357,5580,周亚金,2020-12-21 07:09:14,39,40,1,老师很专业，even不懂的下课也可以问，实验eventually学到很多，so far十分。
129144,5580,周亚金,2020-12-30 11:31:06,7,8,1,虽然老师的教学内容难到我开学几乎就放弃过OS的幻想，作业还偶尔混杂一些实验一起出，实验的内容巨难无比即使老师偶尔会讲解一部分内容。但我觉得这是个关心学生的好老师，就凭这点我给10分。虽然选课我肯定是不建议学弟学妹去选的（除非你被预置或是觉得自己积点过高想体会一下拿低分是什么感受），但是这个10分我还是会给。
129178,5580,周亚金,2020-12-31 02:29:46,-6,3,9,事情多，难度大，至于给分，看查老师均绩就知道了，比其它老师低一大截。
129578,5580,周亚金,2021-01-26 23:09:38,18,20,2,老师很懂，助教认真负责（xjy学长虽然有点凶但还是很好der），课程质量真的超高，最后给分也很不错。谢谢老师，谢谢助教们。
129579,5580,周亚金,2021-01-07 18:05:22,25,28,3,我是废物，我写不出来，不退掉zyj的课是我三年来最愚蠢的决定，没有之一。你们都是很好的老师，很好的学生，但麻烦能不能给只是想拿到学分的人一个机会？
129600,5580,周亚金,2021-01-08 09:15:08,-1,2,3,软件安全100分，yyds
129813,5580,周亚金,2021-01-12 13:32:40,7,7,0,楼下的兄弟，提高lab56的占比虽然确实是为学生考虑，但是你有没有考虑过想直接放弃lab6的废物（比如我）的感受
130081,5580,周亚金,2021-01-23 13:48:47,6,6,0,考完试出分前来评价一下：上课大部分时候很靠谱，偶尔会卡一卡或讲错什么东西，不过一般都会在下一节课时纠正过来；每次上课的前半部分都会复习一遍上次上课的内容；实验确实很有难度。如果下次是全面教改，很建议选；如果不是的话，建议很想学 OS 或想挑战一下自己的同学们选。
130186,5580,周亚金,2021-01-18 15:46:32,2,3,1,老师是真的关心同学的好老师，奈何今年第一年教改后勤工作实在太差，相信后面会有改进的！想水不推荐，想认真学的就选他好了
130853,5580,周亚金,2021-01-31 02:28:13,5,5,0,os是真的不错，学到很多，给分也很好！
131259,5580,周亚金,2021-01-27 01:08:04,4,4,0,实验难；上课比较充实，拓展的东西很多
131266,5580,周亚金,2021-01-27 01:50:49,2,3,1,实验是真的难，作业偶尔也有比较繁琐的编程任务，但给分很不错~
132841,5580,周亚金,2021-02-04 05:47:19,21,21,0,给学弟学妹们以下中肯的建议：\n\n1.这门课老师非常厉害，讲课有条理，只要认真听课考试不复习都基本没问题\n\n2.但是老师可能对我们要求非常高，作业非常多，实验非常难，但是真的能学到很多东西（这是其他班完全学不到的）\n\n总之，希望对自己有要求的同学、希望学到知识的同学选这门课，如果只是为了拿学分则另选高明
132964,5580,周亚金,2021-02-05 14:00:16,2,3,1,老师很nice，上课解答非常耐心。虽然实验难，但我们是第一年教改，很多在实验指导方面都还不完善，之后肯定会有改进，而且最后为了照顾大家，给实验的分数分配做了很大的调整（整整60分的bonus！使我这种之前lab几乎一半没有做出来的人最后lab分也满了）。之后教改也会推开，如果大家实验一样，很建议选周老师的课
138713,5580,周亚金,2021-07-10 13:03:23,1,1,0,恁妈，周亚金老师yyds！
141758,5580,周亚金,2021-10-24 22:26:02,1,1,0,在一个比较不好的时间点遇到了这个老师，其实是很好的老师，只能说在错的时间遇到了对的人吧，突然想起来过来评个分
147519,5580,周亚金,2022-01-10 06:31:07,3,3,0,周老师的课程质量很高，lab很challenging的同时也很rewarding！难度不小哦～很考验代码能力
149642,5580,周亚金,2022-01-16 08:50:26,1,1,0,even比较难，但是很nice。会微笑着回答学生的问题。
152177,5580,周亚金,2022-03-29 12:15:00,5,5,0,软安lab写不出来，救命
157454,5580,周亚金,2022-06-23 09:30:54,13,13,0,每次老师面对几个人的空荡荡的教室还是笑得很开心（雾\n\n老师很nice，水平很高，必须10分
208175,5580,周亚金,2024-12-26 04:58:29,5,5,0,软安，本人CS专业\n\n\n\n老师讲课水平挺好，但这门课确实有难度\n\n如果代码水平比较差建议不要选，不然自讨苦吃\n\n如果水平还好的话这门课还是挺有意思的，能学到很多软件安全的知识，对编程的安全思维有很大帮助\n\n作业也很好玩（前提是得做出来hhhh，我做不出来的时候就很绝望）
132840,5591,韩劲松,2021-02-04 05:29:02,7,7,0,讲课有些平平淡淡，给分蛮好的
132855,5591,韩劲松,2021-02-04 07:36:51,1,2,1,给分是真的不错
138344,5591,韩劲松,2021-07-08 14:40:15,0,0,0,给分真的好
144132,5591,韩劲松,2021-12-19 08:36:12,1,2,1,计网比别的班多一个论文复现，太折磨了。
147164,5591,韩劲松,2022-01-09 03:05:55,1,3,2,给分很好，教课也很好，学到了很多，比别的班多一个论文复现，但是做不出来也没关系（\n\n平时分基本拉满
147173,5591,韩劲松,2022-01-09 03:34:19,0,0,0,教改班 实验单人做 讲课很好 不点名 大作业水水过 给分挺好
147181,5591,韩劲松,2022-01-09 04:43:41,1,1,0,韩老师上课挺好的，尽量讲得有趣。虽然在浙大，计网这门课普遍存在课堂内容比较枯燥；GNS3相关的实验大多只是照搬指令，或许直到考试前，看起来才有些明白。\n\n平时分宽是确实的。不过今年把lab8改成大作业了，对于前面说这大作业水的，不敢苟同，甚至想给你点踩。给的绝大多数选题是没有指导的，有的甚至只是一个词、一段描述，做起来非常困难。算是初步的探索性工作吧，经历上收获了不少。展示的时候，绝大多数组也都做出了结果，想必都花费了很多时间。
168710,5591,韩劲松,2023-02-21 09:22:55,-3,1,4,。。。
179468,5591,韩劲松,2023-09-16 12:21:54,0,0,0,老师人真的很好，会很关心班里的同学，只要你肯和老师沟通，他甚至会一步一步教你做lab
186339,5591,韩劲松,2024-01-10 14:15:21,1,1,0,韩老师人很好，班上实验做的是改革之后的实验，主要是cs144的内容，比GNS3好做一些\n\n但是比别的班多一个大作业，有点折磨
213922,5591,韩劲松,2025-01-21 10:53:01,1,3,2,喜欢我五个作业+八个实验+论文复现大作业吗
214008,5591,韩劲松,2025-01-24 14:00:20,5,5,0,老老师人挺好\n\n今年助教平时分逆天\n\n实验报告全班没满的 proj也是狠狠扣\n\n如果还是陈佳彤当助教就赶紧跑吧 孩子们
214023,5591,韩劲松,2025-01-23 03:55:25,4,4,0,老师讲课还行，有什么问题课后问他也会仔细解答。但是实验和作业很多，在cs144的几个实验的基础上又加了二层交换机和三层交换机的实验、socket实验，以及最头疼的期末论文复现的大作业。真不知道这个课改是改了还是没改。虽然最后三层交换机的实验改为了选做加分，但是助教又非常逆天，平时分狠狠扣，没做加分实验的人有难了。就今年这卷子出的难度，还要扣这么多平时分吗，真是雪上加霜。
134580,5650,周晓巍,2021-04-02 13:56:32,6,9,3,老师讲得很清楚
134627,5650,周晓巍,2021-04-06 07:06:34,9,12,3,讲课比章国锋老师高到不知道哪里去了
150230,5650,周晓巍,2022-01-20 16:52:32,9,9,0,讲课清楚易懂，给分好。cv课程配套资源也很丰富
166165,5650,周晓巍,2023-01-15 03:39:22,10,12,2,老师人超级好！很温柔也绝对是学术大牛，上课水平也很强悍，思路清楚，拓展面广，比较有启发性。助教团队好强，最后大作业一路指点大家。给分还没出但相信还行×
167130,5650,周晓巍,2023-01-15 04:14:05,7,7,0,3DCV国内大牛，对学生很有耐心，会给本科生详细的解答问题\n\ncv导论课程的内容很硬核也很丰富，虽然讲的比较快有些没太理解\n\n不点名不小测，大好评，模范老师！\n\n实验不用写报告，基本交了就满；\n\n大作业巨巨巨巨巨巨巨巨肝，采用类似kaggle的打榜形式；排名前三有bonus加分，所以排名极卷；不过配套资源很丰富，给了gpu资源，助教团队也很强；\n\n考试题量不大，对于听了课的难度也不大，后程基本睡觉；最后给分不错
167223,5650,周晓巍,2023-01-15 06:38:49,3,3,0,大作业开摆的话主要是大家用的方法都基本差不多，全看算法随机的好坏，大家很大一部分基本效果一样，建议早点开始多尝试新的东西。个人感觉最后答辩说点新东西比较好。最最重要的是考试要好好考，最后满不满基本就看考试，其他按时完成基本就满了。以及老师人很好，讲课很清楚。
167240,5650,周晓巍,2023-01-15 07:28:51,1,1,0,讲课很清楚，很耐心
167805,5650,周晓巍,2023-01-19 07:21:54,0,1,1,非常好的老师，讲解清楚
173789,5650,周晓巍,2023-06-03 02:20:08,0,0,0,非常好
159946,5743,杨国青,2022-09-09 12:03:43,7,9,2,杨老师太帅了！！！！！！！！！！！！！！！！！！！！！！！！！！！
164046,5743,杨国青,2022-12-17 12:08:21,0,1,1,这里居然有人吗
169536,5743,杨国青,2023-02-27 00:19:19,0,2,2,杨老师超帅嘚🤩
218577,5743,杨国青,2025-04-25 01:43:20,1,1,0,差劲，人品也差
122846,5811,郑友怡,2020-04-14 07:26:49,1,12,11,这老师怎么说，感觉不是很负责，而且讲课也讲的不是很清楚，慎选吧。。。。一言难尽。。。
123050,5811,郑友怡,2020-05-06 03:44:32,3,11,8,感觉讲完了啥都不会
123105,5811,郑友怡,2020-05-10 03:25:07,10,20,10,科研挺牛，课程设计准备不是很好，上课体验较差
123132,5811,郑友怡,2020-05-11 15:49:39,2,10,8,上课完了感觉什么也不会，感觉是很强，但是讲不出来，听完什么也不会。。。。
123358,5811,郑友怡,2020-06-05 11:33:44,1,7,6,讲课确实有点不太擅长，有时候就是念ppt，不念的时候基本上get不到point（学一下老师说话）\n\n但是其实还是比较负责的！更多的需要自己去问，基本上有问必答，私聊的时候确实讲的很详细！大程更多还是要靠自学吧，老师的作用更多的其实还是解惑而已。（不过刚开始写图形编程大程的时候确实什么都不会，只能对着demo一点点理解）
123530,5811,郑友怡,2020-06-09 12:47:06,-3,3,6,。。。
126329,5811,郑友怡,2020-09-23 01:05:24,7,14,7,强推郑友怡老师，不要害怕上课听不懂，期末考就算你觉得要挂了他也能把你拉回来。（大程序可能完全需要自己摸索了。）
126795,5811,郑友怡,2020-10-20 08:38:10,29,47,18,听说voting tree是你出的题😡
127155,5811,郑友怡,2020-11-11 05:49:37,2,3,1,c程课体验尚可，平时讲得可能不是很透彻，不过这种课一般也只靠自学。有问必答，助教xjj也很负责，最后zyy超可爱！
127942,5811,郑友怡,2020-12-01 02:38:37,6,8,2,超可爱的老师，说话声音很好听，有问题也会耐心的解答
130251,5811,郑友怡,2021-01-20 07:33:11,6,6,0,老师实力很强！但是上课水平有待提高哈！不过问问题的时候老师真的非常耐心！
130949,5811,郑友怡,2021-01-25 11:21:03,8,8,0,老师水平有。可能不太擅长表达吧。但是老师人很好
131564,5811,郑友怡,2021-01-28 04:35:29,1,5,4,请大家务必认真自学，不要寄希望于老师，计算机学院的老师能把ppt念清楚已经是他们水平的极限了
133182,5811,郑友怡,2021-02-14 18:15:12,-4,1,5,虽然不点名不小测也不记录发言，但是平时分会给的比较低
133949,5811,郑友怡,2021-03-10 10:11:44,1,6,5,平时分给分不好，作业很少，上课讲的比较混乱，可以锻炼自学能力，还是要感谢翁恺老师。
141751,5811,郑友怡,2021-10-24 11:59:49,-9,5,14,voting foryour ass👿
142794,5811,郑友怡,2021-11-16 07:48:51,3,3,0,虽然第一次讲DS感觉语音语调很催眠， 但整体还可以
143270,5811,郑友怡,2021-11-27 09:36:25,-2,3,5,讲得不好
143820,5811,郑友怡,2021-12-07 14:06:53,-3,1,4,很考验自学能力
144360,5811,郑友怡,2021-12-21 07:14:53,1,5,4,每次小测都是10min手写代码，小测和作业也从来不讲，作业也只有编程题，唯一的理论题布置了一堆结果全部答案只有期末了才公布。平时真的很难巩固理论基础，不会的程序要是问助教一来问题问不清楚，二来不会的如果比较多也怕太麻烦助教。
144596,5811,郑友怡,2021-12-28 16:14:08,-3,4,7,考前一周我开始理论题补天，大家润吧
144782,5811,郑友怡,2021-12-23 14:48:05,5,21,16,强烈避雷！\n\n跟着这个老师，就是学了个寂寞。\n\n他不能保证你能学会上机，但保证你在他那学不会理论。因为平时作业从来只有上机题，理论题从不涉及。\n\n掉入坑的同学就当培养自学能力吧。\n\n平时上课会安排quiz，有时不提前通知，quiz题目纯英文，难度远高于作业。\n\n作业吧，经常布置一些还没学过的题目。你说让我们边完成作业边预习我也认了吧，然而下一堂课一个字也没提及上次作业的新知识点。\n\n上课只会读ppt，知识点讲不清楚。\n\n一次作业直接布置了17道题目，过了两天删去了九道，留了八道，然后告诉同学们那九道是链表，期末不考。导致部分同学因为做的快而白做了九道题。请问您布置作业这么随意的吗？\n\n总之，老师研究水平很高，教书水平不如与我同级的信竞大哥。\n\n上他的课我学会了自学，提高了英语水平，别的没了。\n\n能润就快润了吧。
145104,5811,郑友怡,2021-12-27 11:51:02,4,10,6,不知道给分怎么样，反正我自学wk网课，上课基本没听，作业全部独立完成，感觉效果还行。老师讲的挺清楚的，他本人科研也很厉害，但是上课很无聊。小测10min手写题，有难度，略难于作业题。至于楼下说布置链表然后又删了的情况…我表示我就是那个315拿满的人😅不过的确会写链表了也不亏。\n\n建议自学能力强的同学报，平时不会有恶心的细节基础题（赞），全都是函数和编程，认真完成对编程能力提高还是很有帮助的，考前刷一刷基础细节题应该就no problem辣～
145353,5811,郑友怡,2021-12-29 07:10:40,3,3,0,讲课水平确实一般，讲的不是很清楚。但是老师教学的思想我还是很认可的。学习C小程这门课的目的是学习如何使用这门语言，不是为了背诵那些语法规则。
146277,5811,郑友怡,2022-01-06 06:24:25,5,6,1,期末考试在考场里说你们题目看不懂的可以问，直接救了我几个题，凭这一点就值十分
146519,5811,郑友怡,2022-01-06 23:51:30,-1,1,2,希望老师捞
146570,5811,郑友怡,2022-01-09 09:28:04,6,8,2,有点呆萌的老师，不过平时理论确实基本上靠自学；不过我觉得选上他的课也别急着退，毕竟作业是真的少……如果害怕自己理论出问题的朋友就去认真地做一下往年题目、认真地看一下书本，我觉得问题还是不大的。\n\n讲课的话确实有点催眠，但是认真听讲收获还是很多的，以及不点名，有小测验的话前一节课会通知，还是不错的。\n\n另：助教xjj颜值好高（羞涩
146847,5811,郑友怡,2022-01-07 15:18:29,6,6,0,考验自学能力\n\n小测虽说是英语，但是会现场口头翻译几个关键词的
146850,5811,郑友怡,2022-01-07 15:36:43,2,2,0,前面那位说可以提问是真的吗？是ds吗？什么时候说的？\n\n我提前半个小时走了，难道是后面才说的😭追悔莫及
147833,5811,郑友怡,2022-01-11 03:21:28,8,9,1,挺好的不是
149406,5811,郑友怡,2022-01-15 08:50:15,4,5,1,顶顶顶
149802,5811,郑友怡,2022-01-17 04:04:50,3,4,1,感觉没捞
151753,5811,郑友怡,2022-03-14 14:49:31,-8,2,10,呵呵呵
154590,5811,郑友怡,2022-06-02 09:22:06,5,8,3,不错的老师
160661,5811,郑友怡,2022-09-29 15:48:55,23,25,2,我对zyy老师的评价，经历了 不推荐-一般-吹爆 的三个阶段。\n\n一开始上他的c小程，觉得讲课实在是太不清楚了，于是非常不推荐选他的课。\n\n后来发现很多老师讲课水平也差不多，zyy班上作业又少，平时只有小测还不点名，于是觉得zyy的课可以上，但不要有太高期待。\n\n再后来我学了ds，发现在sb互评制度的衬托下，zyy这样一位实用主义至上，本着“只要把代码写清楚了注释少一点也没关系”的思想来互评的老师简直是瑰宝，希望大家都来选他的ds。（理论课部分可以听cy姥姥的智云，互评还是在zyy班里好）\n\n\n\n郑老师两个让我非常认同的观点：\n\n“c小程里背诵各级运算符的优先级、结合律是没有意义的，真正要提升的是自己使用c语言编程的能力。”\n\n“30%注释的硬性要求是没必要的，只要代码足够清晰让人看懂，注释达不到30%也没事的”
161133,5811,郑友怡,2022-10-28 06:07:47,15,20,5,这学期fds老师挺负责的，钉钉里都在答疑，上课有时候会磕磕绊绊不过讲得挺清楚的。另外颜值计院最帅不过分吧
163712,5811,郑友怡,2022-12-16 04:06:14,12,15,3,很棒的老师，刚开始感觉一般，几节课后发现老师人真的超级好，作业也不多，虽然感觉老师上课有点无奈，但想到博导和本科生的水平差也可以理解，真的特别有耐心，解答的时候还会安慰鼓励小白，私信解答一级棒，人也很幽默，而且很负责，大佬小白均可，老师的科研水平也很高，上课不点到，人也很温柔，还可以问数学题（嘿嘿嘿，相信我），赞赞赞，顶我上去。
164874,5811,郑友怡,2022-12-27 06:28:14,6,8,2,上了郑老师fds，个人认为老师讲课真的是太棒了！每一块内容都讲得很清晰，每节课前还会复习一遍上节课的内容，吹爆！
166250,5811,郑友怡,2023-01-12 01:36:42,5,7,2,上的c小，刚开始第一二节课老师讲的有点乱，但上到后面认真听发现后面还是讲的比较清晰的，建议和mooc配合着食用，相互补充。不点名。老师捞了我，男神。
166381,5811,郑友怡,2023-01-12 06:25:08,5,5,0,老师很棒 老师加油！
166952,5811,郑友怡,2023-01-14 10:24:30,0,6,6,如果是ds建议选郑老师，但上课听其他老师的；郑老师班互评很友好，平时分给的也很好，体验很不错
167526,5811,郑友怡,2023-01-17 04:13:43,4,9,5,fds讲的蛮清楚的 小测会提前通知 给分是课程组统一的给分方案\n\n建议选hard模式，这门课99难度不大
168199,5811,郑友怡,2023-02-01 13:54:54,12,14,2,1.赞赞赞，超级赞，上了一学期的课，我就是最喜欢zyy\n\n2.颜值计院最帅不过分吧hhh\n\n3.不用担心上课听不懂，哪怕之前从没碰过电脑hhh，因为，私信绝对是我见过的最有耐心的老师没有之一，真的从来没见过可以在休息时花几个小时耐心讲解的老师（就凭这一点，我要吹爆zyy，hhhh)\n\n4.老师的课，挺好的不是（hhhh学一下老师说话）\n\n5.大佬小白均可的课，你值得拥有
168839,5811,郑友怡,2023-02-22 15:10:34,9,10,1,帅帅帅
173590,5811,郑友怡,2023-05-29 12:57:09,1,1,0,上学期c小捞我，感恩
174070,5811,郑友怡,2023-06-06 04:58:50,2,2,0,c小是郑老师的，郑老师上课进度确实快主要是串讲整个知识体系，所以需要一定的预习和自学，感觉在刚进大学就让我明白，自学是学计算机所必备的技能，询问问题也能及时回答，助教实力也很强，感觉在一开始就能让你明白计算机学习该是自学和询问，而听讲只是用来构建体系的，所以我认为是很不错的
181773,5811,郑友怡,2023-10-31 08:06:34,0,0,0,上过最难的大c
185015,5811,郑友怡,2023-12-25 15:41:26,1,1,0,人美心善zyy 前面几节课可能听不懂 后面会好的
189390,5811,郑友怡,2024-01-23 16:04:05,3,3,0,ds课，老师和两位助教人都非常好\n\nProject互评氛围非常好，个人没遇到恶评恶心人的事件（跟助教反馈互评问题后，助教对不合理的互评做出自己的评判）\n\nds课有几次小测，类型是手写代码，比较新奇，不过只要交了应该就不太扣？\n\n老师的期中考试可能会有点难度，比如今年期中有一道比较难、几乎无人做出的编程题，不过老师会根据最后完成情况调整给分。而且期末可覆盖期中。\n\n作业量适中，期末会开启补交\n\n最后给分很好，应该说相当相当好。\n\n总的来说，老师讲课一般，平时的考核比较新颖，不死板，有自己的想法，可能上的时候会有些郁闷，但最后给分很好。\n\n（btw两位助教也真的很好，钉钉回答问题及时，作业、project上都非常体谅学生）
189519,5811,郑友怡,2024-01-25 07:33:04,1,1,0,轻松的课堂氛围
189559,5811,郑友怡,2024-01-25 11:11:54,3,3,0,老师讲的还可以吧\n\n出分很慢，确实是在捞
189624,5811,郑友怡,2024-01-26 05:23:19,4,4,0,c尖小测前几次都全班倒数，相对作业难度，小测难度比其他老师会高一些，但是认真做下来真的会学到一些东西。期中考比平均分低几分，期末理论考感觉也不是考得很好，但是最后会有bonus做可以加平时分，我认真做了几道，被老师捞到4.2了真的很感动。而且你问老师问题，老师会很耐心地帮你解答问题。总而言之，我很喜欢友怡老师，在大学第一次感受到努力一定有回报！
189687,5811,郑友怡,2024-01-27 01:51:28,1,2,1,坐标c程序及实验。平时上课不点名，课堂氛围不错，老师上课也还有意思。平时作业和小测略多，难度和量可能算略大，但是好好做好好学老师给分还算不错。有问题问老师也会认真回答。\n\n就是老师上课不太按书本进度，一般按自己的节奏跟着ppt来，讲的时候可能涉及一些后面的知识，对完全初学的同学来说可能难懂一些。\n\n总的来讲老师挺不错，更推荐有基础的或者勤预习，自学能力比较强的同学选老师的课。
191041,5811,郑友怡,2024-03-29 10:31:18,-6,2,8,你出的题真是依托史。\n\n郑__，你_什么时候_啊
192930,5811,郑友怡,2024-05-31 16:04:57,4,4,0,帅帅帅！讲课有时候磕磕绊绊，但总体还是挺不错的，小测会提前通知，最后给分超好，老师人也很好，问问题会耐心解答，互评的氛围也很好，不会那么形式主义。总而言之，很好！很帅！
195031,5811,郑友怡,2024-06-26 12:04:06,5,6,1,据说是计院最帅的老师(doge)确实如此\n\n坐标2023-2024秋冬FDS，zyy老师讲课非常温柔，语速不快也不慢，但是长时间听可能会有点想睡觉(?)具体的内容讲解，不会有很多的对细节的拆分，总体上都是和PPT的内容差不多，所以有时候可能需要自己课后再去了解一下相关的概念\n\n老师人很好，上课前会问问大家大程进度如何，需不需要往后延ddl（他确实延了）\n\n最后出分应该是捞捞了，只不过本人期末考犯蠢考了很烂\n\n以及在zyy的课上找到了npy(doge)
197716,5811,郑友怡,2024-08-04 07:30:52,5,6,1,郑老师好温柔的，讲课感觉挺简单易懂的，考点讲的很明确，就是确实有点催眠。然后班里互评氛围比较好的，自带一种松弛感，唯一不足就是期中编程题出太难了，虽然后面也有调分。然后非常感谢郑老师，在课上收获了npy一枚\(*^*)/
198064,5811,郑友怡,2024-08-27 13:48:15,2,2,0,楼下两个是一起的吗
202424,5811,郑友怡,2024-11-12 14:24:00,1,2,1,郑老师真的超好！！！
205562,5811,郑友怡,2024-12-09 08:40:47,2,3,1,嘻嘻，好帅好帅好帅
205563,5811,郑友怡,2024-12-09 08:47:26,0,1,1,帅帅帅，棒棒棒，赞赞赞
206400,5811,郑友怡,2024-12-15 02:46:48,0,1,1,很好，来还愿了
207471,5811,郑友怡,2024-12-22 06:48:22,0,1,1,上课不点名，讲课还可以，不过我感觉比较无聊，而且如果没有编程基础刚上他的课会很痛苦，需要自学。不过认真听讲还是会有收获的。可选。
207537,5811,郑友怡,2024-12-23 02:12:36,0,2,2,优点：人帅，讲得比较通俗易懂，不点名，小测会提前通知，也会捞\n\n缺点：\n\n（1）作业虾几把布置，作业布置的进度总是比课程进度快不少\n\n（2）作业进度比较快就算了，小测的进度也比课程快！课上讲解一个考试卷子感觉像是在上新课。\n\n（3）经常课上讲着讲着就自顾自地陷入深度思考，经常出现班上长时间没人说话的尴尬情况。最后快期末考了课程内容都差点没讲完。\n\n其实根本问题就是讲得太慢了，可能对于基础比较好，或者自学能力强的同学来说不是事
208879,5811,郑友怡,2025-01-03 04:01:30,4,5,1,在C程老师里讲的算不错了，有细节有拓展，虽然昏昏欲睡但是全听下来的话理论会比较扎实。不太同意楼下，作业只是提前布置防止有些人没事干，截止时间是绝对充裕的，小测范围个人也感觉没超。
209959,5811,郑友怡,2025-01-07 14:39:39,0,1,1,人帅事少，作业少，会捞，不点名，其实我觉得在所有老师里面已经非常棒了。不过讲的可能会随性一点，对于我这种没什么基础的人来说还是有难度的。然后作业的话会置下一章的内容，应该是想我们去预习的。总体来说还是很不错的，给个10分支持一下。
211545,5811,郑友怡,2025-01-12 01:48:45,2,3,1,上课很迷，作业总是快他一步，需要提前预习。但老师挺捞的，小测分会比较高，个人期末扣了五分都能满绩
211649,5811,郑友怡,2025-01-12 06:04:35,1,3,2,不点名，讲的一坨，全英PPT一句看不懂，乱七八糟的讲的，作业布置的还永远是下周甚至下下周才会讲到的东西，期末前最后一节课了狂赶也没赶完哈，全靠自己，不过客观评价，不点名，作业做不起会给你延迟时间，小测分都特别高，给分挺高的
212025,5811,郑友怡,2025-01-13 05:05:28,0,1,1,人帅，上课从不点名，会捞，但ppt是全英文的，可能需要自学。作业给的时间挺充裕的，有时候还会延长一周。小测给分也不错。还是蛮不错的一个选择
213463,5811,郑友怡,2025-01-17 13:32:00,1,1,0,从不点名所以一节课都没去上过，不知道讲课怎么样，纯靠B站翁恺自学。平时分有6道编程题bonus（都是比较难的），全做出来平时分直接加5分，善用AI能做出来八九十分，所以平时分满是没啥问题的（当然小测不能太差扣太多）（第二次小测难度太高了，老师还调分了）。实验考只全做出来一道，另一道蒙了一个数据点4分，给了12/15，期末89，最后总评93分4.8，确实实验考搞不出来，略微遗憾。
214988,5811,郑友怡,2025-02-20 01:10:35,7,7,0,1.上课课件全英文，一开始可能不适应，但是后期其实影响不大\n\n2.上课节奏很迷，有时候会忽然愣住，慢条斯理的\n\n3.老师人很帅，去问问题他也会非常耐心的解答\n\n4.从不点名，班上的人越上越少，最后感觉至少四分之一的人没来\n\n5.小测有点难，考的很细节，但是期末有附加题，做了能加平时分。附加题难度比较大，有信竞基础可能好些，善用ai也能差不多做掉，所以总的来说还好\n\n6.助教董老师真的人超好，特别特别贴心，发消息几乎秒回。pta的作业也会经常给我们延期。\n\n\n\n总而言之自己认真学肯定没问题
123390,5927,秦湛,2020-06-08 04:47:05,8,13,5,老师可能很厉害，但是他的概统，也许是排课的问题，啥也没学到。声音也真的催眠。
125918,5927,秦湛,2020-09-15 14:42:59,4,8,4,老师讲课、作业、考试都以理解掌握基本概念为主，考试题目很直接，没有阅读理解一样的各种坑。如果讲课时能更生动热情一点就更好啦~
136958,5927,秦湛,2021-06-29 02:21:52,1,8,7,老师很可爱，善解人意，专业性也很强，性感男低音
154222,5927,秦湛,2022-05-26 07:27:59,9,11,2,老师的概统真是把我讲懵了
158848,5927,秦湛,2022-07-02 17:13:03,17,24,7,不正态的课也搞绩杀？\n\n无非就一个pre和一篇论文，论文格式要求给的巨多真的浪费时间，都这样了还是非要在成绩上为难学生是吧？
158852,5927,秦湛,2022-07-02 17:48:56,7,10,3,课上的不行，给分也不好
158855,5927,秦湛,2022-07-02 22:37:36,5,7,2,逆天老师，给分像shit一样，快跑
158858,5927,秦湛,2022-07-02 23:48:58,6,9,3,搁这搁这 把专业课整成思政课是吧
158863,5927,秦湛,2022-07-03 01:52:49,9,11,2,数据安全这课，事情多，完全不知道怎么给的分，我的评价是，纯纯的逆天
158888,5927,秦湛,2022-07-03 04:34:52,4,6,2,无语了
158894,5927,秦湛,2022-07-03 04:59:03,2,7,5,信息安全专业最大的不确定因素，上课学不到很多，评分标准也比较主观，给分也比较主观
174570,5927,秦湛,2023-06-14 07:40:14,11,13,2,只能说一坨💩，只会念ppt，没事放个题搁那待半天，讲答案或者概念也只是念，看上去在分析其实只局限于一条式子里各个量的关系，跟没说一样。生怕我们学到知识一样。声音还轻还整个气泡音。还没期末考但已经预料到结局了（每节课都到但完全无法吸收知识，只能靠补天了，看前面评论说还搞绩杀，更恶心了🤢）
196296,5927,秦湛,2024-07-03 00:21:49,0,2,2,信安原和数学基础中的概率论部分。\n\n讲的还不错，比较清晰。我是习惯于携带GPT学习的，秦老师的一些讲解作为很有力的补充，可以很清楚的点透我，并且在分析概念之间的关系时也有清晰的表述。我觉得是认真备过课的。\n\n和往年同学体验不一样或许是因为我一直是看智云学的（划掉
197302,5927,秦湛,2024-07-10 13:22:09,1,1,0,很无语
199080,5927,秦湛,2024-09-16 04:04:58,0,1,1,好老师！
204815,5927,秦湛,2024-11-28 03:56:17,1,2,1,概率论讲的很清楚
205788,5927,秦湛,2024-12-12 03:56:15,0,2,2,伟大无需多言
219814,5927,秦湛,2025-06-07 07:52:03,0,0,0,信息安全原理与数学基础概率论部分。\n\n？
220704,5927,秦湛,2025-06-19 08:56:16,0,0,0,概率论部分不知道在讲些什么，对ppt也不熟悉，动不动找人演板随机提问，到最后都没几个人去上课了。一共16次课，请假了1次，调休忘来了1次，有事又请假了1次，后面也没补课，不过概率论部分也没什么内容所以也是讲完了。好消息是不点名、没作业、期末简单。
122319,5929,申文博,2020-02-24 05:01:19,21,27,6,今年老师第一次开课，给我一种老师已经带过20多届学生的稳重，对操作系统内容如数家珍，科研能力也很强，以后应该会成为所有学生必争的os老师。有幸，今年老师还叫外聘，我随意就补到了hhh
129903,5929,申文博,2021-01-13 10:37:48,6,6,0,虽然没有出分，但很难不给到10分。
130191,5929,申文博,2021-01-18 17:41:26,7,7,0,老师非常好，讲课清楚，很耐心。因为我们听不懂英文，硬把全英改成了基本全中，总之选他就对了。虽然lab很难&&分还没出，但相信出分之后我还是会给他打10分滴！
130350,5929,申文博,2021-01-21 08:36:12,7,7,0,人很萌，讲课很好，助教很好
131240,5929,申文博,2021-01-26 18:41:59,8,8,0,申老师太萌了，给分超级好，36人的教学班有19个不少于90分的。教改班头有点秃，其他简直完美。
134201,5929,申文博,2021-03-19 07:01:22,13,13,0,申老师是我上大学以来接触到的最强的老师了。
142275,5929,申文博,2021-11-09 16:16:44,1,2,1,绝对是好老师
142276,5929,申文博,2021-11-09 16:18:36,4,4,0,如果你对操作系统感兴趣，申老师绝对是你的第一选择
142277,5929,申文博,2021-11-09 16:26:28,4,5,1,申老师在系统方面很有经验和心得，绝对算得上青年才俊了，对学生也很好，会认真地给向他咨询的同学给出中肯的建议（学习和生涯规划等等都是），每个lab和作业布置之前都会和助教沟通完善文档，是一位很优秀的研究者和教师！
143016,5929,申文博,2021-11-18 08:18:56,1,2,1,非常好！
147398,5929,申文博,2022-01-10 02:36:09,11,11,0,我们都很nice的
148540,5929,申文博,2022-01-13 00:11:39,4,4,0,我们都很nice的
148649,5929,申文博,2022-01-13 06:07:13,8,8,0,我们都很nice的
148722,5929,申文博,2022-01-13 10:02:35,4,4,0,我们都很nice的~
148741,5929,申文博,2022-01-13 11:17:55,3,3,0,我们都很nice的
148746,5929,申文博,2022-01-13 11:36:13,3,3,0,我们都很nice的
148757,5929,申文博,2022-01-13 12:20:50,3,3,0,我们都很nice的
149640,5929,申文博,2022-01-16 08:49:26,3,3,0,nice~的老师
159279,5929,申文博,2022-07-10 14:08:02,4,4,0,挺好，但是人push，lab的指导也不是特别清楚，美中不足
162302,5929,申文博,2022-11-19 14:06:48,-5,10,15,普信男 😅
166460,5929,申文博,2023-01-12 10:00:40,-5,1,6,楼下那个是刷分吗\n\n老师确实还不错
166729,5929,申文博,2023-01-13 10:31:51,16,17,1,申士本人还是可以的，上课讲的也比别的老师会清晰一些\n\n但是。。。\n\n今年这lab为啥能比去年多这么多啊，而且实验指导写的也就一般般，有的地方不是很清晰\n\n而且这查重系统是不是有些毛病，八竿子打不着的说我抄袭\n\n然后拉扯半天也不说咋搞\n\n为啥有的助教很好有的助教脾气很差呢\n\n很烦\n\n今年的期末考线上考也巨难，emmm课程组的锅吧，不是申士的锅\n\n本来给申士能打10分，加上一些不对的只能给点低了
166732,5929,申文博,2023-01-13 11:00:02,5,5,0,老师上课讲得很好，水平很高，但是实验希望改进，唉
166958,5929,申文博,2023-01-14 10:45:07,4,5,1,professional in professionals!\n\n\n\n客观地讲，老师课讲得很不错，今年的大部分助教也很负责。基本上有问必答，而且还组织了答疑群。文档虽然写的确实不够好，但是可以看出助教还是在努力的，会接受反馈并多次更新。\n\n\n\n但是期末考试题目有些偏且怪，老师细讲的很多深入的东西没考，反而考了很多边边角角的细节，不过这应该是课程组的问题，老师本人还是很 nice 的~\n\n\n\n在上课之前也与申老师有过一些交流，可以说他对于本科生还是很用心的，总之绝对是个不错的老师~
166965,5929,申文博,2023-01-14 11:27:04,3,3,0,好课十分！
166970,5929,申文博,2023-01-14 12:20:43,6,7,1,老师人很有意思，对待教学很认真，虽然感觉讲的不是特别有条理，听得有点云里雾里\n\n实验部分一言难尽吧，虽然感觉助教们也挺努力的了，但是总感觉让人有点摸不着头脑，花很多时间才知道想让我们实现什么，不过最后把fork作为bonus，实验补满了\n\n今年考试比较偏怪，大家整体比较低；也没调分，最后总绩没上4，当然也有我的问题，没复习到位吧；给分算是中规中矩，比较求是，对于我这种平均水平的普通学生也就这样了\n\n今年整体来讲期末卷面平均大概70左右，所以总成绩3.9-4.2左右的人居多，4.5以上比较困难，我认为给分要比去年差一些\n\n总之考试还得认真复习，另外实验要认真做，查重很严别乱抄，好好做这部分还是能满的
167046,5929,申文博,2023-01-14 17:19:16,8,10,2,老师确实很好，从备课角度来说就很认真，每节课前都会提炼一下之前所学的重点，并且发现同学掌握不好的情况下还会及时更改自己的PPT等方式重新给大家讲一遍，很负责。实验内容方面就一言难尽了，本身设计就很难让人读懂具体要做什么，另外在群里问问题某个助教态度也很不尊重。另外每个班的实验内容以及考察的点也有差异（感觉是一份祖传文档以及代码，每个班的助教自己魔改一些）个人觉得计院课程一个很大的问题就在这里，考核标准不统一，就像之前体验很差的计组，某班的助教要求极高且验收极其严格，倒不是说要求高不好，只是对比另外的平行班实验报告两三页解决我们要十几页还不一定拿高分，心理多少有点不平衡。不过申士这边的课程号和其他班不同，实验多一些也无可厚非，可是最后考卷却和其他班一样，一些平时讲授的重点考卷上反而考察较少，让人感觉很不公平。个人觉得课程的难度等等都可以接受，就是很不能接受：1.班级之间关于考试的信息差过大问题。2.考核给分标准的差别过大问题。
167176,5929,申文博,2023-01-15 04:50:10,6,6,0,老师很好，很professional，个人认为讲课讲的挺不错的，实验部分确实实验指导可以再清晰明确一些
167239,5929,申文博,2023-01-15 07:27:30,-1,0,1,很nice，很professional
167475,5929,申文博,2023-01-16 14:11:45,-1,0,1,professional
171929,5929,申文博,2023-04-12 18:07:57,8,8,0,上课很认真，能结合实际进行讲解，不过听学长说申士有点push，导学关系不太好。。。
181545,5929,申文博,2023-10-22 10:56:15,1,3,2,听课两分钟思绪就满天飞、所有课摆摆烂、课本和PPT战士的我，听申士的课听的津津有味
186261,5929,申文博,2024-01-10 07:26:41,0,1,1,professional的大神
187337,5929,申文博,2024-01-15 13:46:18,1,2,1,老师就是太nice了
188679,5929,申文博,2024-01-19 14:05:57,0,1,1,23秋冬OS（图灵），能感觉到老师是朝着professional的方向去讲了。重点的内容喜欢多次课重复很多遍，大部分内容感觉讲的还是很清楚的（虽然我感觉文件系统有些乱，也许是我没学好，悲）。50分lab50分期末，lab有5分不溢出的bonus。上课前喜欢数人头但是不点名。后半学期看人数稀少开始有预告和没预告的小测，但基本都是讲答案的那种，最后也不拿来扣分说是只拿来捞及格边缘的同学，据说明年可能考虑加小测分。总之推荐。
189255,5929,申文博,2024-01-22 15:35:52,6,8,2,OS，能感觉出来老师的水平很高，科研能力也非常强，人也非常好，也挺有趣的。老师的授课也是很不错的，个人感觉有些比重要比较难的地方讲的有些快，但会重复地讲很多遍尽量让大家弄懂\n\n关于实验， OS的实验设计是非常不错的，虽然有难度，但本身是非常成体系的，一整套下来确实能让你巩固、学到不少东西。个人觉得是真得给申老师课程组积累下来的这套实验本身点赞的\n\n但我认为实验也有很多问题，部分实验指导个人认为有待完善，很多细节和问题都没有涉及，这往往需要我们花费很多额外的时间。其次就是给分，个人体验是实验报告中记录的过程和思路详不详细不重要，差不多的话分就会给，反而真正的扣分往往都在思考题上。做不对的话扣的也比较多，有的一下就是-5，反映到总评基本就是0.4-0.5之间，个人认为还是挺多的，这种扣分方式我个人认为有点畸形的，如果思考题都必须写对，我认为其称之为问答题更合适。另外某些助教的评分方式实在是让人有点难以接受，会因为“没有回答问题中没有的问题”扣分，以及还会因为“心情不同”导致同样的问题扣分不同，这是我不太认可的\n\n最重要的，希望后面的学弟学妹们注意查重的问题。在这里只要你“以任何方式让你的代码被别人看到并被鉴定为抄袭”，不论是否知情，你扣分是跑不了的了。查重的逻辑大概是是否有完全相同的变量名，和完全相似的控制逻辑，而且总体是比较严的。据我所知，这学期班上有挺多大佬也被卷入这个问题中了，导致有的大佬最后就算bonus做满也补不满平时分，真的很可惜，因为一般来说其实只要正常得分了，最后即使只做bonus简单的前半部分，平时分就能满或者很高。所以在这里再次奉劝大家自重，如果有人找你借代码学习，一定要掂量掂量\n\n大佬们在这门课一定会收获非常好的体验，但如果能力一般的话就需要考虑一下如何应对Labs写不出来的问题了。最后祝选择了申士的同学们实验没困难，绩点棒棒棒，也祝申士和这门课越来越好
189542,5929,申文博,2024-01-25 09:51:38,0,0,0,实验会查重哦，而且挺严的，一定认真对待
195735,5929,申文博,2024-06-30 19:12:17,4,5,1,课程跟实验考试都结合得很好，而且老师本身就是手撕源代码的大牛，把实验带着virtio文件系统的bonus做一遍，你能对操作系统kernel和体系结构的概念有深刻理解\n\n实验设计为数不多的不足就是思考题出得太糊了，而且事后只有第一章思考题有助教解析。有个思考题导致我搓了一个openSBI之后才得知只要给出想法就可以，有点黑色幽默了\n\n查重确实很严，每个实验代码量一般几十行汇编或者十几行C，最麻烦的虚拟内存与fork调用估计100行C左右，主要是理解，工作量真算是其次。要抄就自己重构一遍为好，理解之后记得改变量名再乱插几个goto，会赢的
200058,5929,申文博,2024-10-12 03:38:34,-11,11,22,逆天玩意，刁难学生，讲的不知所云，让最后一排一个个站起来回答为什么坐在最后一排，第一次见到这样的
203669,5929,申文博,2024-11-20 11:48:24,-1,3,4,普信男，网安转导第一
205593,5929,申文博,2024-12-10 03:05:15,11,11,0,professional!\n\n能回答出来这个的一定是大神啦！
209926,5929,申文博,2025-01-07 12:32:11,14,14,0,我们首先有几个 announcement ～\n\n这是小白的回答，有没有更 professional 一点的回答\n\n最后一排的同学准备一下，来回答一下这个问题
210952,5929,申文博,2025-01-10 08:32:06,3,5,2,sys2课堂小测相当于就是考勤，一次不去总评扣1.5，哈哈
212618,5929,申文博,2025-01-14 09:41:29,0,0,0,os给分挺好，老师上课有些地方感觉讲不清楚，但总体还行。大家上课一定要区分 stack 和 heap ，还要记住 virtual page 和 physical frame 的区别。非常professional。
212708,5929,申文博,2025-01-14 14:04:47,0,0,0,讲课水平真的很高
214024,5929,申文博,2025-01-23 04:01:22,0,0,0,无需多言
215587,5929,申文博,2025-03-02 01:27:43,0,0,0,能看得出来老师在尽力把课上的有趣，最后考试前的实验课，感觉老师也在尽力把分喂给大家。如果要是小测点名少一点就好了。
217780,5929,申文博,2025-04-16 10:13:48,0,0,0,操作系统领域唯一真神
135775,5941,侯启明,2021-05-25 05:35:58,7,11,4,这老师是OI大佬……我之前打OI用的C++教程有一部分就是他编的……
163690,5941,侯启明,2022-12-16 03:02:09,18,20,2,初中的时候在知乎上刷到过这位老师，没想到今年开C程了
163941,5941,侯启明,2022-12-18 12:02:05,12,14,2,"最有用混乱代码奖:中国 侯启明(候大神也是20届IOCCC的获奖者之一)\n\n\n\n#include <stdio.h>#include <string.h\n\n#define Q(B，q，b)s=j[B];e=*s; *s=0: printf(q，b，b，b); *s=e; H=s#define W(a，b) r[0].c=a， r [0].f=b，0++#define X(B) { int y=A: B; &=y; }#define R return#define M 1<<18#define If char#define fi ""%s#define IF for#define FI ""r""#define long#define do\n\n\n\ntypedef struct{int c，(*f)();If*t，*h;} T;T*a，*r; int I[M]，c[M]= {'\0'} ，n，Ni do，p:char*s，*H，*z[M]，f[M]，o[M ]，*_[M ]，**1 =_ ，e : int O=6，A='\5'，x=5，y='\0'，g=2;k(p){a[p+2].h=H:R p+2:}S(p){ a[I[nt+]=a[p].c>>8].h=H; return p-’\1':}J(p) {R~a[p].c>>8;}C(){ A=0:W(0+1<<8，J):} B(p){ c[g+'\1']=0;C(do):c [ g+=’\2’]=’\0’;R 1:}h(p){ Z(p);r[0-3].c+=256; R 1;}V(){ *I=n=’\1’: for(; *a ->t:do){"
169852,5941,侯启明,2023-02-28 06:21:10,7,8,1,我直呼妈耶
169857,5941,侯启明,2023-02-28 06:39:51,48,50,2,“技术可以学一辈子，但是青春只有一次”
170060,5941,侯启明,2023-03-01 07:20:55,8,9,1,老师真的有实力，希望可以学到真本领，真心谢谢选课系统
170069,5941,侯启明,2023-03-01 08:21:29,1,3,2,很有意思
170228,5941,侯启明,2023-03-02 05:32:31,5,5,0,幽默的东北口音好亲切！
170242,5941,侯启明,2023-03-02 07:04:27,22,25,3,“我拼着KPI不要了也不考小测期中了，给你们满分”
170316,5941,侯启明,2023-03-02 23:40:22,1,2,1,很好的老师
170422,5941,侯启明,2023-03-04 11:26:42,12,15,3,可爱的大男孩，四次小测全班给满分，平时作业量很少，很有实力，非常好的老师
170581,5941,侯启明,2023-03-07 02:11:34,4,5,1,老师讲课风趣，平时成绩还给全满，宝藏男孩
172829,5941,侯启明,2023-05-08 04:34:03,2,2,0,智云补天，太喜欢侯老师的课了，简直是精神上的享受，这个男人会让代码唱歌
173428,5941,侯启明,2023-05-24 06:06:11,4,4,0,老师很有趣，水平也很好，但没基础不建议选可能会跟不上，有基础的来学更高深的东西
173432,5941,侯启明,2023-05-24 07:38:26,0,0,0,逐渐听不懂( T_T)
173660,5941,侯启明,2023-05-31 07:50:04,2,2,0,师强我菜，但是能听到很多
173739,5941,侯启明,2023-06-02 06:03:44,7,7,0,在学分爆炸c小c大一起上的春夏学期，他救了我一命
173958,5941,侯启明,2023-06-05 08:17:36,1,1,0,老师很强，只是我听不懂
174472,5941,侯启明,2023-06-13 01:08:57,2,2,0,实力无疑顶尖，给分也好\n\n听他的课最好有一定基础，讲课不面向考试，比较天马行空
174610,5941,侯启明,2023-06-14 13:18:15,4,4,0,放心吧，完全不点名，完全不考试但平时分也基本会给满的宝藏老师。\n\n讲课比较天马行空，想听可听，不听也没事，毕竟c小自学也没那么难。：）
175366,5941,侯启明,2023-06-24 08:39:21,3,3,0,老师真的好
175398,5941,侯启明,2023-06-24 14:13:12,1,1,0,你是我的神！
175527,5941,侯启明,2023-06-25 10:51:10,4,5,1,建议有点基础的人可以上，平时分拉满，大大的赞，或者可以在他的课上听其他老师，他上课不用PPT很难受，完全get不到知识点
176341,5941,侯启明,2023-06-28 12:52:46,6,6,0,很好\n\n不点名\n\n平时满\n\n直接听张ty爸爸网课 刷课后题 省时省力\n\n\n\n但是提醒一下因为不点名选他课的人\n\n不要抱有侥幸心理 不要放轻松 一定要听张tongyu或者其他老师的课
177884,5941,侯启明,2023-07-05 08:54:03,1,1,0,给分好到不行
177887,5941,侯启明,2023-07-05 09:13:08,4,4,0,是一个很好的老师，平时分拉满，没有期中和小测，讲课也很幽默，讲的东西也很实用，但是没点基础是真的不建议选他的课，后期逐渐变成听天书。但是老师人是真的很好，也很厉害，水平很高，大神级别的
177893,5941,侯启明,2023-07-05 09:29:01,0,0,0,给分真的好，平时分溢出了，最后给的总评甚至都比我自己靠科技手段查理论查出来的分高三分
177902,5941,侯启明,2023-07-05 10:55:28,0,0,0,给分非常好的老师，完全不用担心平时，不过一定要自学起来。
177941,5941,侯启明,2023-07-05 16:05:19,0,0,0,给分真的好
178010,5941,侯启明,2023-07-06 07:30:35,1,1,0,给分贼好
178548,5941,侯启明,2023-07-14 08:15:00,1,2,1,侯启明yyds！c小因为听不懂就去了一两节课 理论和实验都是一晚突击 最后满了！
180726,5941,侯启明,2023-09-25 11:12:17,0,1,1,后期逐渐听不懂，但是平时真的超轻松，平时作业很少，期末一定要专门面向考试复习
184556,5941,侯启明,2023-12-21 15:23:19,0,1,1,太好了
184557,5941,侯启明,2023-12-21 15:24:08,1,2,1,超级好的老师
184818,5941,侯启明,2023-12-23 05:24:30,1,2,1,您是真的救了我啊，平时分拉满，让我平时没怎么花时间最后再补天，活过了春夏学期，最后给分还那么好
191745,5941,侯启明,2024-04-29 12:14:47,1,3,2,平时分满分，没有小测和期中
193032,5941,侯启明,2024-06-03 00:39:26,9,9,0,侯老师是大神级别的人物，现在在知乎上也能搜到他的事迹，工程经验极为丰富，无论是上课还是作业中都有体现，是真的在把你当作未来要进行c开发在教。\n\n但是这对初学者可能不太友好，侯老师上课进度快，也不会反复讲，上课不点名，没有小测，作业截止时期很晚，水几节课后可能进度差很多。同时上课也很平淡，至少我本人听课时经常走神。\n\n如果你是初学者或者对自己不自信，我推荐同时看cs50的内容，一共5个week的内容，基本包含c的所有内容，前四个week和对应作业写完应付实验考基本很轻松，此时再听侯老师的课就会另有收获，是从两个视角向你介绍c。链接 https://cs50.harvard.edu/x/2024/weeks/1/
193572,5941,侯启明,2024-06-13 06:36:45,-25,5,30,靠给分好上位的老师，不想说什么，破坏教育公平
196531,5941,侯启明,2024-07-04 02:52:34,0,1,1,有基础的来绝对锦上添花，平时基本没作业没小测，只需要做好期末两次大考，讲的内容比较拓展，不过纯新手的话比较坐牢
196548,5941,侯启明,2024-07-04 04:37:49,2,3,1,如果你有一定自学能力，选侯老师就行了。平时上课不用去（我认为他教的方式不太适合一般人吧），去b站上搜网课看，整个学期也就只有一个作业一次期中测试，期末考的题目也不难，自学完全够用了，不会的地方可以钉钉提问，老师虽然回复不快但回答很耐心仔细。最后96满了，也是对得起一学期的自学了
196640,5941,侯启明,2024-07-04 12:20:37,-6,1,7,pta上一堆错题，流毒千古
196654,5941,侯启明,2024-07-04 14:10:49,1,2,1,普通人上他课绩点巨低，甚至挂科，因为根本听不懂，慎选
196860,5941,侯启明,2024-07-05 13:54:36,11,11,0,上课真不用去，作业是真的少，小测是根本没有，期末是各显神通，给分是超级好
196936,5941,侯启明,2024-07-06 03:46:05,-1,0,1,给了6分，因为这学期c没怎么听懂过，纯靠自学，pta靠的是bhh和zty的作业，基础差的同学慎选，有能力的同学冲！
198443,5941,侯启明,2024-09-09 03:05:10,-1,0,1,不知道为什么挂了，6月2号实验考做出了第一题\n\n难道27号理论考没分
217094,5941,侯启明,2025-04-01 17:48:26,2,2,0,老师是初代OI大佬！也是00这一代OIer的偶像！
125582,5952,万志远,2020-09-12 00:48:22,-11,18,29,超可爱！
140861,5952,万志远,2021-09-17 02:37:38,-9,11,20,楼上说的对
141426,5952,万志远,2021-10-15 04:52:10,10,36,26,计算机学院，上课不让用电脑真的大丈夫吗？？？QAQ\n\n老师人看起来挺好的，但软需这门课实在伞兵，作业布置的不清不楚，教的也不清不楚\n\n——————————————————————————分割线，以下是最新回答\n\n能不能不要讲不够时间，就拿抽人展示来水时间\n\n水时间也不要问“讲讲你昨天作业是怎么做的”这种问题好不
141539,5952,万志远,2021-10-13 14:40:25,12,33,21,作业布置不明白，真不知道做啥
145699,5952,万志远,2021-12-31 09:18:33,-7,20,27,老师还挺和蔼的，不过软需这课安排有点问题
148169,5952,万志远,2022-01-11 17:29:32,-6,23,29,老师基本能认出全班同学名字，报告限制页数。软需今年课改了给分也挺好的，不过上课不让用电脑
148170,5952,万志远,2022-01-11 17:30:37,-10,21,31,老师人很和蔼，很好交流，给分也很棒。课程内容可能有些令人疑惑，可能主要是软工专业课程设计有些问题，期待软工的课程规划有所改善~
148192,5952,万志远,2022-01-12 00:23:09,-10,20,30,感谢老师捞人之恩
151332,5952,万志远,2022-02-28 15:42:29,-12,22,34,别的不说，给分是真的好
160513,5952,万志远,2022-09-25 08:13:55,11,37,26,有大病，上课不能用电脑就算了，作业还布置得乱七八糟的，让学生用笔记本跑深度学习的模型？？？我他妈跑着跑着系统崩溃了，之前跑的全没了，真的是有大病，净搞别人心态
165687,5952,万志远,2023-01-09 09:14:22,-8,21,29,老师人很好，很喜欢，但是课程是个sb课
165958,5952,万志远,2023-01-10 13:34:56,12,38,26,任务量大，课上不让用电脑，最后给分也不太行，只能说慎选吧
165991,5952,万志远,2023-01-18 04:50:26,11,35,24,给分不行 课没内容 不能用电脑 大作业要求从来说不清楚 建议别选
167531,5952,万志远,2023-01-17 05:05:34,10,41,31,真的无语，软件需求工程这学期是花的时间最多的一门课，wzy布置的小作业，各种文档，大程，无一例外全都好好做了，任务量是真的很大，结果出分了就这？😅一学期陪你瞎胡闹，出分就这？
167726,5952,万志远,2023-01-18 15:37:39,10,33,23,事多工作量大给分差全让你占了
168226,5952,万志远,2023-02-04 03:31:57,-10,23,33,真的很感激万老师，对待每一位学生都很好。
169293,5952,万志远,2023-02-25 09:06:56,12,28,16,快跑把
197637,5952,万志远,2024-07-23 05:40:09,1,25,24,真恶心
197678,5952,万志远,2024-11-11 04:01:56,3,29,26,垃圾！
200847,5952,万志远,2024-10-23 23:43:06,-9,16,25,室友说万老师人很好
200848,5952,万志远,2024-11-15 04:41:02,-1,23,24,软需今年课改了，上课让用电脑啦
200857,5952,万志远,2024-10-23 12:42:28,-9,14,23,很好的老师~
200862,5952,万志远,2024-10-23 13:49:33,-4,20,24,今年这门软需，本来以为还和以前一样是那老一套，没想到老师不仅讲基础，还拓展了全英文内容，整了些行业实践的案例，搞得还挺专业。不过这课任务量是真不少，现在就盼着最后能有个好分
201019,5952,万志远,2024-10-27 04:17:57,-7,15,22,老师认真负责，讲课很有激情也非常细致，ddl设置也为学生着想，建议大家选择
201125,5952,万志远,2024-10-29 05:34:09,9,24,15,水军都来了
201449,5952,万志远,2024-11-03 06:09:41,10,25,15,短短几天从6.5分刷到9分  真有你的
202316,5952,万志远,2024-11-11 14:00:53,10,21,11,咱水军就是厉害呀！\n\n上着课中途一起来发好评，真巧！
202926,5952,万志远,2024-11-15 17:16:54,21,25,4,24/65756 谁都逃不了优绩主义 一个老师只想着用什么手段提升自己的评分 可悲
203185,5952,万志远,2024-11-17 17:50:31,16,16,0,好评刷得跟大众点评似的 -_-||\n\n评论区和评分意义不大 水军太严重 没什么参考意义\n\n后面的学弟学妹自己去看智云吧\n\n人怎么样课怎么样一看就能看出来 智云是最客观的\n\n在这老师刷好评学生刷差评的 有意义吗？
203186,5952,万志远,2024-11-17 17:55:04,13,14,1,支持楼上 这评分和评论区意义不大了
203233,5952,万志远,2024-11-18 07:55:09,1,1,0,不是出完分再评吗 中期就这么热闹QAQ
205200,5952,万志远,2024-12-02 15:05:22,3,3,0,相当不推荐
205461,5952,万志远,2024-12-06 17:31:44,2,2,0,确实一般
208627,5952,万志远,2024-12-30 07:50:07,4,4,0,不是哥们，我短学期的时候记得wzy评分没那么高啊，这也是我没选软需的原因之一，怎么现在8点多了？\n\n如果是真的上课质量提升了，那当然最好，要是刷出来的，我只能说老师您注意有前车之鉴
214521,5952,万志远,2025-02-11 05:04:05,3,3,0,shame on you
165107,5958,赵莎,2022-12-29 07:06:08,9,9,0,赵老师人十分的温柔和蔼（这个是真的，上过课的应该都有体会），另外研究生课程普适计算的考核是两次PPT展示（做了提交即可，也可以主动报名上台展示，然后根据报名人数决定是否再随机挑人展示）+一次Kaggle大作业（代码Kaggle都有，很简单的任务，交报告文档和展示PPT），所以第四节第六节和最后一节课都可能随机点人上台展示，除此之外可以不去上课。所以这门课必选。
170757,5958,赵莎,2023-03-09 06:02:53,9,9,0,第一届本科生课程：计算机组成\n\n人很和蔼，实验用的md老师的PPT[ac01]
174105,5958,赵莎,2023-06-06 09:08:01,2,3,1,计组救大命了
174656,5958,赵莎,2023-06-15 06:40:28,13,13,0,老师人太好了，虽然是第一次上计组，但老师很认真很有热情，对学生也很好很好！\n\n老师也经常提到自己凌晨还在备课，有作业有考试先问我们的意愿，还会认真地把班上每一个同学的名字和脸对起来！\n\n刚上完最后一节课，老师跟大家告别的时候都有点想哭，看得出来老师的用心，也希望未来还能有机会上老师的课！\n\n虽然还没出分，但是老师人太好了先在查老师拉满了！遇到赵莎姐姐的课选就对了！
174770,5958,赵莎,2023-06-17 10:58:51,6,7,1,赵莎老师我哭死，助教哥哥也超好，感觉计组压力比数逻小多了
175529,5958,赵莎,2023-06-25 10:57:11,6,6,0,我永远喜欢赵莎姐姐😭😭😭
176005,5958,赵莎,2023-06-27 11:43:49,4,4,0,赵老师真的很温柔，也很可爱！计组讲课超级细致，并且真的很用心的希望可以教会我们！\n\n助教gg超温柔！问问题基本都秒回
176105,5958,赵莎,2023-06-27 18:21:06,0,1,1,非常好的老师！
176752,5958,赵莎,2023-06-30 04:03:50,1,1,0,特别好的老师，不过今年是第一次讲计组。
177353,5958,赵莎,2023-07-03 03:44:10,1,1,0,神仙老师！！！真的特别特别温柔，中午来不及吃饭赵老师就开车带我们去；计组排课阴间，老师好几次喉咙都哑了还在讲，最后一节课我看智云的时候发现老师上完了课好久没走，特别特别舍不得，后来也给大家拉了vx群，成绩还是特意等最后一门ADS考完了再出的hhh（平时分都是拉满了，太捞了真的（另外好喜欢和老师唠嗑hhh）），学弟学妹无脑冲！！！
177480,5958,赵莎,2023-07-03 11:19:37,1,1,0,我永远喜欢赵莎姐姐
178555,5958,赵莎,2023-07-14 11:15:20,3,3,0,赵莎姐姐好温柔！好可爱！
195738,5958,赵莎,2024-06-29 23:14:21,2,2,0,计组出完分第一时间来给老师打满分\n\n\n\n老师平时很少点名 这学期只点了一次 \n\n平时分给分很好 实验有很多bonus 最后还有讲课后作业题加平时分 \n\n赵莎老师很体谅学生，有一次下午连上四节课还给我们买雪糕吃\n\n\n\n助教小哥哥也很好，总之选赵莎老师就对了
196035,5958,赵莎,2024-07-01 08:32:54,0,0,0,好好好好好好好好好好好我没意见选到就是赚到
196097,5958,赵莎,2024-07-01 15:20:33,1,1,0,很好的老师~
211913,5958,赵莎,2025-01-13 01:43:46,2,2,0,实验人性化，考试捞
131739,5979,何水兵,2021-01-28 16:02:42,-4,3,7,就...真不知道怎么说啊...反正体系上课和没上也没多大区别，虽然全套都是jxh的课程设计，但给分确实还可以
141349,5979,何水兵,2021-09-30 08:11:11,2,6,4,助教哥哥很棒
141350,5979,何水兵,2021-09-30 08:11:19,2,6,4,给老师个满分，希望期末也给我个满分:)
141436,5979,何水兵,2021-10-09 02:50:16,-5,0,5,上课认真，老师也是认真准备的，希望期末给分也好！
141581,5979,何水兵,2021-10-15 12:40:35,-5,0,5,很nice
141783,5979,何水兵,2021-10-25 13:49:42,4,5,1,老师留的作业好难啊，感觉题目也不清楚，甚至感觉有些题有问题，废了好多时间很抓狂。希望以后能不能留一些质量好一点的题？
145725,5979,何水兵,2022-01-01 03:50:59,0,2,2,老师讲课很负责认真，助教哥哥也很nice，实验作业给分都超好，希望期末给分也好！就是偶尔会点名，大家一定要去上课！
146002,5979,何水兵,2022-01-05 03:19:03,-1,3,4,体系确实难，但是老师很认真的在讲了，助教gg也很认真负责，给分不错
146004,5979,何水兵,2022-01-05 03:27:42,-2,1,3,老师很和蔼，期末复习课直抓重点，非常救命。助教gg人也超好！给分也很棒！
146010,5979,何水兵,2022-01-05 03:56:33,0,4,4,hsb，我的超人！！！
146337,5979,何水兵,2022-01-06 08:59:30,4,9,5,之前大二因为一些原因没修计组，大三硬刚体系，预置了何老师的课。本来从一开始就做好了挂掉的准备，因为硬件知识的薄弱，我甚至连流水线概念都还不清楚，还有cache原理等一些需要在组成中就了解的我也一概不知，再加上我们是体系课改的第一届，增加了大量研究生高级体系结构课的内容，像是第三章的scoreboard、tomasolu、投机动态预测还有第五章的snooping、directory这些，这些重点也几乎是必考的，初次接触确实让人感觉害怕。\n\n但是在学习过程中，何老师讲的却很透彻，还有助教gg的帮助，对于我这一个硬件上几乎零基础的同学来说也能听得下来，偶尔会点名但是分数占比很少。老实来说，我后面还是翘了很多课（第四第五章基本没听），感觉也挺对不起何老师的，奈何自己实在对硬件原理不感兴趣，后来考前刷了两天夜靠回放补回来了，最后考试的内容也挺基础的，包括了一些送分题，达到及格还是不难的。最后我的总评到了八十，对于一个几乎零基础的摸鱼选手来说已经很感恩了，也非常感谢助教pz哥哥的帮助，他真的既温柔又强大。\n\n实验方面可以两人组队，我几乎全是靠着我队友苟过去的，助教gg验收也很快，会问一些基础的概念，比jxh那班不知道高到哪里去了。（另外稍微建议下出实验的老师记得把git文件删掉，不然可以直接通过git命令回滚到初始未删减的版本）\n\n来查何老师的同学们请放心，何老师和pzgg让体系这个计科的三大孤儿课程之一有了人文关怀的温度。
147268,5979,何水兵,2022-01-09 10:38:41,-4,2,6,好老师，非常推荐
154036,5979,何水兵,2022-05-20 02:31:16,-2,2,4,助教潘宝救我体系结构！
170851,5979,何水兵,2023-03-10 11:23:01,-2,7,9,给分真的香
171429,5979,何水兵,2023-03-24 02:45:07,10,10,0,平时比较忙，好几次其他老师甚至助教讲理论课。\n\n今年疫情网上考且题型大变，一堆选择题都是自以为对了其实错许多。因此给分不好评价，可能我自己的卡绩分也是被捞的吧
181187,5979,何水兵,2023-10-11 06:08:29,8,11,3,何老师人很好\n\n会点名（昨天点了一次），要来上课\n\n今年助教shz比较认真负责，对实验非常严格
185595,5979,何水兵,2024-01-02 13:33:34,-10,3,13,很好的老师，非常关心学生，真的很好
187221,5979,何水兵,2024-01-21 05:09:03,9,11,2,作业按照对错给分，很求是\n\n实验报告要求比较多，尤其注意要自己画原理图，否则被扣大分\n\n实验验收的话，\n\nzwx很严格，总是挑刺，验收结果会写“1”“不熟练”“很不熟练”（前两次验收通过的情况下）\n\nshz相比之下没有那么严格，验收结果只会写“1”\n\n感觉平时分给分其实也就那样\n\n------------------------\n\n推荐选卜凯\n\n-----------------------------------------\n\n何老师也挺惨的，被今年两个助教弄得晚节不保
187974,5979,何水兵,2024-01-18 02:35:16,7,8,1,今年那俩助教什么玩意儿，给学生扣分，自己工资就能涨了？
188053,5979,何水兵,2024-01-18 06:14:02,8,8,0,平时分给的不咋滴很求是甚至可以说是很严了 对着答案实打实扣的 没啥什么捞不捞的\n\n不如wxh cwz bk，这三个班好像平时分都是满的\n\n最后附上经典语录：最近体力消耗有点大，浩喆你来帮我上下课。。。
188315,5979,何水兵,2024-01-18 15:26:58,4,4,0,助教很负责，但是平时分给的很不好。老师今年身体不太好，但是总让助教讲课。推荐cwz、wxh、bk
188741,5979,何水兵,2024-01-19 18:53:07,8,8,0,先不管你期末捞不捞，不好好上课是什么意思？十节课有八节课是让助教讲的，那么我选您的课有什么意义？？本科教学不搞好，研究生课下方目的又在哪里？ppt很多时候都念不明白！
189453,5979,何水兵,2024-01-24 09:46:54,4,6,2,理性评价下hsb老师：\n\n1.抛开给分，hsb老师师生情还是很浓的，经常会叫大家注意身体，课后跟老师的一些交流也发现老师非常和蔼可亲。（但不得不诟病的是，老师的点名不到是扣分，而且本学期点名有一次是因为自己有事调课到周六上课，还要点大家的名，私以为十分不合理，不知道后面有没有给大家补）\n\n2.讲课方面，这学期老师确实经常“体力消耗太大了”，让助教讲课。助教们的讲课缺乏经验，特别是shz讲课特别快，往往3节课的课就只用上2节不到，第三章开始之后明显感觉听课有些力不从心。（但这也有这门课的问题，点名批评jxh，ppt弄得云里雾里，还要求考试按照ppt出题，纯纯的牛马；附：cr班虽然讲的清晰但是与考纲不符，期末考很痛苦，只能说有利有弊）课程的内容说实话已经有点超出硬件的感觉了，但是何老师把重点出大题的部分都自己亲自讲过，我觉得讲的还是很清晰的，至于选择题只能看ppt复习了。\n\n3.实验方面，必须要认真写报告画原理图，这是最重要的！！！只要画了分数不会差。而且验收今年宗助教比较严格，shz只是简单看一下，比较简单。问过助教bonus可以加到平时分，但是今年的实验布置的bonus不明确而且很少，十分让人迷惑（课程简介明确说有7分bonus让人以为和os一样有一个完整的bonus实验）\n\n4.作业方面，只能说必须认真做，网上搜到的答案有错，不要盲信，建议和大家认真校对研讨，扣起分来还是很狠的。（国外的硬件课教材课后题总是十分迷惑，老师也得认真选下题）\n\n总而言之，从功利性的角度来说或许不如bk，cwz等老师给分好（这还是和助教关系比较大），但老师的实力感觉还是很强的，人也很好。\n\n但我觉得jxh的课改才是真正的弊病，优化掉她的考纲和ppt限制或许才是这门课的出路！！！
201492,5979,何水兵,2024-11-04 01:30:05,3,3,0,会纸质签到
211723,5979,何水兵,2025-01-12 09:14:36,5,5,0,给分好拉
212692,5979,何水兵,2025-01-14 13:27:31,2,3,1,你这给分认真的吗？平时分扣这么多？\n\n\n\n我真的真的很痛恨不同教改班给分差别这么大的现象\n\n\n\n请问公平何在
214462,5979,何水兵,2025-02-05 13:43:40,0,0,0,老师人挺好，实验给分好，作业扣分严格，中规中矩吧
215176,5979,何水兵,2025-02-23 16:24:06,0,0,0,神，本来觉得要挂穿了，结果硬是给我捞到七十多。
221883,5979,何水兵,2025-06-27 06:03:46,0,0,0,今年体系放到了大二下上，何老师还没适应，有一节课甚至忘了。。。\n\n\n\n其实也由于何老师太忙，上课也很耗精力，助教也来代班了不少。考勤也只考了一次。。。\n\n\n\n但何老师还是非常关心学生的，上课也很认真，虽然说课大家都不是很听。。。\n\n\n\n\n\n实验今年改的很松，bonus我只做了一个四路组相联，今年的卷子也相对来说比较简单。最后被捞了也拿了一个很好的成绩。感谢何老师和两位助教。
171830,5999,祁玉,2023-04-07 03:25:07,5,6,1,能做她的学生，真的很幸运
174141,5999,祁玉,2023-06-06 14:18:23,2,3,1,111
179308,5999,祁玉,2023-09-09 05:13:34,3,3,0,好老师！
188461,5999,祁玉,2024-01-19 04:40:09,3,4,1,祁玉老师在脑启发人工智能这门课里讲的真的特别好！！！\n\n这门课是两个老师一起上的，神经元动力学部分和类脑计算基本是唐老师负责，祁老师讲了深度学习基础，视觉对于算法的启发，卡尔曼滤波和脑机接口相关的内容\n\n老师上课非常有激情，深度学习部分真的讲的特别好，会带着你去理解为什么要加某个trick或者这个trick为什么有作用\n\n非常非常推荐祁玉老师和这门课
191018,5999,祁玉,2024-03-28 10:55:44,5,7,2,讲课清晰，富有激情，难得一见的好老师了
208193,5999,祁玉,2024-12-26 06:39:16,2,2,0,上课水平很高，讲得很好
217934,5999,祁玉,2025-04-18 06:46:49,1,1,0,很好的老师，听课可以收获到特别多
219776,5999,祁玉,2025-06-05 13:09:58,0,0,0,表白祁老师(｡･ω･｡)ﾉ♡
220379,5999,祁玉,2025-06-17 13:59:20,0,0,0,老师很温柔，教的很认真
169492,6096,于智,2023-02-26 12:03:20,0,0,0,是很好的老师
125719,6169,马德,2020-09-13 13:44:51,4,16,12,妈的
125834,6169,马德,2020-09-14 15:20:49,2,10,8,出题王，i了i了
126029,6169,马德,2020-09-16 15:50:44,56,64,8,马德马德，歪瑞古德！
126242,6169,马德,2020-09-20 15:53:51,18,29,11,超前的教学理念。别人考的是知识，他考的是悟性。
126945,6169,马德,2020-10-29 05:38:33,1,5,4,计组王
127676,6169,马德,2020-11-25 16:16:53,-37,6,43,真滴8行\n\n被点名点了两次\n\n出卷子贼难\n\n加长了2h都没做完\n\n我们都哭了\n\n浙大被水淹了，怎么办？？？
128376,6169,马德,2020-12-22 02:07:47,-1,7,8,“高校计算机专业优秀教师奖励计划”获奖者\n\nhttps://mp.weixin.qq.com/s/gS-EejNky1vatcH6YQloKg\n\n马德，浙江大学计算机学院副教授。2013年获得浙江大学超大规模集成电路研究所博士，同年进入杭州电子科技大学任教，2018年2月加入浙江大学计算机学院。其中，2010年与2014年在法国VERIMAG实验室和欧洲微电子中心(IMEC)访问交流。主要承担本科生课程《计算机组成》《数字逻辑设计》的教学工作，并参与浙大计算机学院硬件课程方向教学体系建设，历年学生对课程评价均为优秀。主要研究方向为神经形态计算，计算机体系结构，片上系统芯片等。先后主持国家自然科学基金面上项目、青年基金项目，国家级重点项目，累计主持经费超千万，在TCAD、 JSA、EL等期刊发表论文10余篇，申请发明专利10多项。
137533,6169,马德,2021-07-05 03:55:05,1,6,5,上课很生动，很认真，重点经常强调，上课认真听能学很多东西！推荐推荐
138731,6169,马德,2021-07-10 14:52:15,-1,1,2,讲课一流，给分超好，强推
138739,6169,马德,2021-07-10 15:18:21,2,6,4,出分前想打10分，出分后更想打10分。\n\n讲课水平高，幽默，段子多，作业安排不错，给分厚道，与校长合作办课。缺点可能是不让玩手机。\n\n马德马德，歪瑞古德！
138828,6169,马德,2021-07-11 06:11:46,0,2,2,感谢马德老师智云课堂捞我祭祖不挂QAQ
138945,6169,马德,2021-07-12 02:16:55,13,20,7,马德老师的讲课水平相当之高，基本上好好听课的话最后不会有太大问题，有没听懂的最后智云课堂上补一下(雾)。\n\n讲课过程中会说考点和重点，实测还是挺准的。\n\n期中会有一次考试，还是比较有难度的，但步骤分给得比较足，就算写不出正确答案有时候也能捞到不少分。\n\n本学期(2020-2021学年春夏学期)实验是亲自管理的，验收比较严格，难度和工作量也不低。我们是第一年用RISC-V做实验，所以代码很多都得自己写，也遇到了很多不成熟的地方，下学期应该都会改进，所以学弟学妹应该能轻松一点。\n\n助教很负责，实验的时候如果有问题就大胆地问。如果来不及线下验收可以考虑一下线上验收。\n\n不推荐在课上玩手机，容易被马老师看到然后橄榄，以后就得每节课坐第一排接受马老师提问。
141633,6169,马德,2021-10-18 11:12:26,1,3,2,每次听老师说英语就想笑
142008,6169,马德,2021-11-03 17:37:03,0,1,1,怎么还没到9+， 这么好的老师居然不是9.9分， 来刷一波
142673,6169,马德,2021-11-15 04:01:04,5,9,4,哈哈哈哈哈每次听老师努力说英语就感觉好好笑
144076,6169,马德,2021-12-17 08:46:09,0,2,2,非常好的老师，讲课能抓重点。很负责，会去管不认真听课的同学。
144180,6169,马德,2021-12-20 06:47:39,28,29,1,马德，我滴超人🤤🤤🤤
144181,6169,马德,2022-01-06 15:35:06,40,41,1,老师长的又帅，讲课又好，超喜欢上马德的课呢
144967,6169,马德,2021-12-26 05:55:54,0,2,2,马德马德，歪瑞古德！
146347,6169,马德,2022-01-15 02:19:40,1,5,4,真的是很负责的老师，上课会经常确认我们能不能跟上进度，虽然有些地方有点超出考试范围，但提供了一种更深刻的视角（考试你就觉得比他讲的简单了）。数逻考前通过看智云课堂补了些缺漏的地方。从弄懂知识的效率上看，看他的智云比看书还是快了不少的
146596,6169,马德,2022-06-24 05:06:15,32,33,1,马德点名怎么这么好笑啊哈哈哈哈哈哈哈哈哈哈哈哈哈哈哈哈\n\n出分了！马德，你～是～我的神！
149976,6169,马德,2022-01-18 06:35:09,0,4,4,讲的很清楚的老师\n\n上课千万不要玩手机、睡觉、写其他作业哦~\n\n给分超赞！
150210,6169,马德,2022-01-20 11:05:12,0,2,2,毕竟是硬件出生的老师，讲得很清楚，上课认真听基本上最后不会差，虽然最后小卡绩，但是不妨碍给老师10分
151315,6169,马德,2022-02-28 10:00:30,0,2,2,马德不是9.9我不接受
151467,6169,马德,2022-03-04 03:21:22,0,2,2,好好好好好好
152178,6169,马德,2022-03-29 12:23:44,5,7,2,马德数字逻辑和计组都讲的很好，强烈建议两门都选。计组课上，数逻的重复知识点会很快过去，重难点被他一讲都变得很容易理解。听马德上课点名非常快乐😂
152356,6169,马德,2022-04-06 10:44:09,1,2,1,知识点超级讲得清楚对学生很负责给分好还幽默，马德这样的老师哪里找
153374,6169,马德,2022-04-28 17:38:06,79,82,3,马德🤤🤤🤤 为了你😨😨😨 我变成狼人摸样🐺🐺🐺 为了你😱😱😱 染上了疯狂🤡🤡🤡 为了你😰😰😰 穿上厚厚的伪装👹👹👹 为了你🤗🤗🤗 换了心肠💀💀💀 我们还能不能再见面🥺🥺🥺 我在佛前苦苦求了几千年🙇‍♂️🙇‍♂️🙇‍♂️ 愿意用几世🥰🥰🥰 换我们一世情缘💞💞💞 希望可以感动上天😭😭😭 我们还能不能能不能再见​
153412,6169,马德,2022-04-29 08:30:00,2,4,2,马德老师不会辜负你每一节认真去听的课。马德马德，歪瑞古德！
157625,6169,马德,2022-06-24 05:13:33,3,4,1,出分了，马德nb!!
158477,6169,马德,2022-06-29 14:10:14,0,2,2,好老师ooo
158933,6169,马德,2022-07-03 13:02:16,5,6,1,马德老师讲的真的好，会叫教室最后一排的小伙伴回答问题，还会给我们介绍intel的比赛，还有神秘zhgg讲三节课，这样的计组老师哪里找？
159684,6169,马德,2022-08-23 07:39:40,58,61,3,硬件课不跟着马德老师学，就像四大名著不看红楼梦，说明这个人文学造诣和自我修养不足，他理解不了这种内在的阳春白雪的高雅艺术，他只能看到外表的辞藻堆砌，参不透其中深‌​‌‌‌‌​‌‌‌‌‌‌​​‌‌‌​​‌‌奥的精神内核，他整个人的层次就卡在这里了，只能度过一个相对失败的人生
160095,6169,马德,2022-09-13 06:52:30,3,5,2,马德马德，歪瑞古德！
167914,6169,马德,2023-01-20 08:00:18,3,6,3,马德马德，歪瑞古德！
167916,6169,马德,2023-01-20 08:00:36,0,3,3,给分巨好！谢谢老师～
167918,6169,马德,2023-01-20 08:48:27,-1,1,2,马德马德，歪瑞古德!!
168312,6169,马德,2023-02-10 13:57:32,0,3,3,马德老师没有9.9我不是很认可
170027,6169,马德,2023-03-01 05:00:56,0,3,3,感觉不错
170860,6169,马德,2023-03-10 15:04:23,1,4,3,好帅的老男人，讲话又好听，这样的老师谁不要呢
173101,6169,马德,2023-05-13 11:37:41,0,4,4,浙大计院讲课最好的老师没有之一。\n\n可惜我硬件不太行。
173645,6169,马德,2023-06-01 03:39:29,9,10,1,讲的不错，但是搞鹅颈
174285,6169,马德,2023-06-09 01:21:39,16,17,1,马老师讲课挺好的，hyn助教也是有求必应\n\n就是让学生讲题的时候可以把控一下质量。。。一个同学抢了两个名额的情况下还不好好做PPT，真的又浪费时间又很难绷
178156,6169,马德,2023-07-07 09:27:19,2,3,1,讲课好\n\n点名一次不到扣的分数还挺多的，但是除了点名之外的地方想尽办法送平时分
185505,6169,马德,2023-12-31 13:23:32,-1,0,1,"""啊，二次元？“"
191526,6169,马德,2024-04-24 08:22:08,-1,0,1,很棒的老师
196186,6169,马德,2024-07-02 05:45:18,9,12,3,觉得今年给分不好的来bd一下
200157,6169,马德,2024-10-14 07:19:08,7,8,1,马德为啥不上体系，真的想马德了，更想马德的助教......
212233,6169,马德,2025-01-14 04:08:57,15,17,2,隔壁杨坤老师班的，马德老师无愧浙大硬件之光，这学期全靠马德老师的智云续命，感恩戴德，给老师打10分表达感恩！
213314,6169,马德,2025-01-17 02:21:19,3,4,1,马德马德 歪瑞古德 没想到专业课竟然成了我提高绩点的地方 讲课好 给分好！学弟学妹们快冲
215331,6169,马德,2025-02-25 07:34:14,0,1,1,正在上体系，再次回来怀念一下马德的计组
215862,6169,马德,2025-03-06 06:16:09,3,4,1,ppt只是辅助，感觉老师的水平十分之高以至于听讲时有种大道至简的灌顶之感
216857,6169,马德,2025-03-27 06:27:32,0,1,1,man！
218250,6169,马德,2025-06-29 01:34:30,4,5,1,上课很好 给分很捞 唯一的美中不足是ppt的英语有点难顶 但是问题不大\n\n\n\n以及那天上课我真的没笑啊\n\n\n\n出分二更：我是md老师的狗🥵 捞我的恩情还不完🖐️️😭🖐️️
219867,6169,马德,2025-06-09 08:29:25,1,2,1,马德😍😍😍
222020,6169,马德,2025-06-29 02:27:40,1,1,0,我为什么49我为什么49我为什么49？？？
222022,6169,马德,2025-06-29 03:02:06,0,0,0,马德老师上课水平高超，人很随和，虽然喜欢点人回答问题，但不会为难学生，主要目的还是督促大家好好听课（毕竟别的班的同学也听他的智云）。感谢马德老师，可惜下学期的计组不是你😭😭😭
126951,6257,张东祥,2020-10-29 09:25:33,4,6,2,活下来前途一片光明
154525,6257,张东祥,2022-06-02 03:59:32,0,3,3,他太温柔了，哭死
155108,6257,张东祥,2022-06-08 10:40:40,-1,1,2,很认真的老师，讲算法很清晰，ppt和内容安排比另一个老师好很多
155109,6257,张东祥,2022-06-08 10:40:39,-2,0,2,很认真的老师，讲算法很清晰，ppt和内容安排比另一个老师好很多
156711,6257,张东祥,2022-06-20 17:13:03,1,3,2,他真的好温柔，上课的时候就很温和，答辩的时候被问住了会给台阶下，感觉和研究生关系也不错很亲和。跨专业菜狗来上课，大作业付出很多学习精力（因为你要拿高分的话，绝对不能之前作业跑跑就结束的，那太简单了，会发现本专业的同学一堆不来上课但大作业一套一套的），结果出来了很不错，感觉有被肯定！数据挖掘导论，选他的课！
176882,6257,张东祥,2023-06-30 14:02:50,-1,1,2,数据挖掘导论，老师人很温和，讲课也还可以，但是内容基本都是一带而过，平时作业有4个分基本给满，大作业给分比较一般，建议选人少的项目去做
177475,6257,张东祥,2023-07-03 11:04:56,-1,1,2,平时分给分很好，大作业给分感觉一般
177921,6257,张东祥,2023-07-05 12:30:06,-1,2,3,老师人很好，数据挖掘导论第一节课讲的很吓人，但是大作业并不难，只要自己做了就会有一个比较不错的分数，平时的四次作业一般只要交了就会给满，答辩也比较宽容，会给台阶。总之是一个非常不错的老师。
181027,6257,张东祥,2023-10-05 04:52:38,0,1,1,666
220783,6257,张东祥,2025-06-19 16:44:25,0,0,0,无敌，数据挖掘导论给分真的好，不要被他一开始说的吓到了，实际上没考试3个小lab一个大porject任务量都不高
127365,6263,邹宁,2020-11-21 09:31:47,15,17,2,老师超级超级超级好，耐心且有涵养，很乐意听学生说然后一起交流之类的，超级喜欢
133226,6263,邹宁,2021-02-19 09:43:18,6,6,0,邹老师真的是颜值担当，而且很和善
141822,6263,邹宁,2021-10-27 04:38:45,1,1,0,相当nice 温柔善良
143158,6263,邹宁,2021-11-20 09:11:22,1,1,0,老师超好！
143159,6263,邹宁,2021-11-20 09:14:02,6,6,0,人又帅，学历又高，还有涵养，素质很高，给分还好。很有学问，我的偶像。而且给分也太好了
144143,6263,邹宁,2021-12-19 13:22:57,1,1,0,用心做设计！！
144179,6263,邹宁,2021-12-20 06:47:28,1,1,0,老师真的很好，上课讲的好，给分也好，真的是白月光啊！
150597,6263,邹宁,2022-02-03 08:41:21,2,2,0,男神啊aaa 人很温柔讲课还很有意思 特别是课上放的相关视频都很有趣 给分不错
155478,6263,邹宁,2022-06-13 11:02:45,1,1,0,讲课好好T T\n\n我很少有被老师的自身气质和专业性完全折服的，邹老师就是其中之一\n\n管理和作业怎样先不论，真的有学到东西，收获很大
157268,6263,邹宁,2022-06-22 17:08:46,1,1,0,有风度且善解人意的老师 男神！
181416,6263,邹宁,2023-10-17 07:45:07,1,1,0,帅死了！
188794,6263,邹宁,2024-01-20 03:22:24,0,0,0,特别特别好老师，爱来自温州
201509,6263,邹宁,2024-11-04 03:48:51,0,0,0,非常优秀的能够寓教于乐的老师：联系多方资源让学生能获得尽可能全面的知识，同时将课程核心和小组项目非常紧密地结合，保证学生能够有所收获
134949,6344,张亶,2021-04-24 16:20:13,4,5,1,教了一门《研究生论文写作指导》，大作业不仅要写论文，还要写程序，就离谱。程序作业是用编程语言处理论文文档，检测论文格式。就是把不知道从哪里来的任务外包给了学生，把学生当免费苦力。属实恶心。
135801,6344,张亶,2021-05-26 11:51:01,9,9,0,把要写的程序拆给学生，叫学生帮你做外包？课讲的也不怎么样，根本就不按照本学院的要求讲，任务布置的也不清楚。上完课完全没收获，还更混乱了。
122615,6500,张秉晟,2020-03-09 00:17:13,27,31,4,老师真的太幽默了，而且很博学
133817,6500,张秉晟,2021-03-06 12:58:31,2,3,1,真的好
133911,6500,张秉晟,2021-03-09 10:51:22,1,1,0,。。。
136948,6500,张秉晟,2021-06-28 14:53:00,3,5,2,给分好，上课好
138182,6500,张秉晟,2021-07-07 21:34:27,1,2,1,给分很好啊，上课也很好
139747,6500,张秉晟,2021-07-22 16:28:29,4,5,1,讲课热情
146884,6500,张秉晟,2022-01-08 02:06:46,3,3,0,密码学上的有点不知所云。。
147679,6500,张秉晟,2022-01-10 12:29:05,20,20,0,不会了吧 哈哈 活该
148138,6500,张秉晟,2022-01-20 15:43:55,3,6,3,你永远可以相信zbs，除了在一些给分的时候
150022,6500,张秉晟,2022-01-18 10:38:14,1,3,2,背刺。
152535,6500,张秉晟,2022-04-14 06:55:42,2,3,1,上课挺有激情的，老师比较幽默，好
154854,6500,张秉晟,2022-06-06 08:07:53,2,3,1,上课挺好玩的，有亲和力就像学长一样
154858,6500,张秉晟,2022-06-06 08:23:00,2,3,1,授课风趣幽默，概念讲解清晰
154859,6500,张秉晟,2022-06-06 08:23:43,2,3,1,张老师上课幽默又生动，宝藏老师i了i了
154860,6500,张秉晟,2022-06-06 08:26:34,1,2,1,幽默且博学！
154868,6500,张秉晟,2022-06-06 09:35:55,0,0,0,老师很牛逼！
154880,6500,张秉晟,2022-06-06 11:57:52,1,1,0,张老师yyds！
156318,6500,张秉晟,2022-06-19 03:35:11,0,1,1,不错不错
172355,6500,张秉晟,2023-04-25 09:54:22,2,3,1,他看起来好像gch老师啊！！！
196298,6500,张秉晟,2024-07-03 00:26:16,0,5,5,信安原和数学基础的离散部分。\n\n体验不是特别好。学期内完全没有听的欲望，原因有两方面，一是ppt内容过于庞杂广泛（且不考）二是老师对考的不考的知识点，都一视同仁的念ppt。还有经常跑题去讲数学危机（雾\n\n可能也有离散这门课的属性问题吧，老师至少人特别好。给分也不错呢
219962,6500,张秉晟,2025-06-12 09:09:03,12,12,0,老师我不好评价，但助教一坨，代码给你了让你创新，不创新就往死里扣，我请问了
219965,6500,张秉晟,2025-06-12 12:56:07,9,9,0,第一届隐私计算来评价一下，平时分70（60分实验，10分考勤，但似乎白送了十分），期末占30，上课用的是老师自己写的教材，但是教材其实相对晦涩难懂，可能得花很多时间去复习，我们这届上课比较抽象，两个老师来回讲，但是内容衔接得不是很好，最后其实大家上课反应都不太能听懂，最好不要漏课，否则后面的内容可能出现不理解的地方。考试内容会给大纲，照着大纲复习，但是最后的卷子是英文的，但教材是中文的，比较抽象。最后想吐槽一点实验相关的内容，要求在合作平台上完成四个给定案例的实验和一个最后的大程，事实上上课跟实验内容的关系并不大（仅有理论），代码部分得去自己学习，而官方给定的参考代码仅能用于前四个实验，最后的大程可以参考一些样例但不允许照搬（事实上，即使你参考了没照搬，如果内容大同小异，给分也很不好），最后大部分的同学可能也只能靠AI来完成这个大程，60分的内容跟上课基本没有关系，全靠自己去理解别人提供的接口来设计一个云里雾里的实验，我个人觉得这样的设计其实并不合理。
220347,6500,张秉晟,2025-06-22 09:02:51,6,7,1,信息安全原理与数学基础这门课真逆天啊\n\n上课内容散乱不知所云；作业占总评50分，居然不是按照是否及时提交作业，而是按照做对了几个题给分，这样做的意义是什么？\n\n你们信安的这辈子有了\n\n\n\n期末考完更新：\n\n考试比较基础，所以最后分数还凑合；但是不影响因为作业扣了接近5分，呵呵。\n\n以后的同学一定要注意平时作业的准确和规范，平时作业拿满的话这课应该还算比较简单、容易拿高分的。
220394,6500,张秉晟,2025-06-17 15:20:55,6,6,0,信息安全最恶心的一系列课。开学的时候布置实验，给了一份极为简单的实验要求，什么都没说。最后给分跟实验“创新”程度关联极大。没有“创新”的只有80%的分数。不满意的点是，给分政策和实验要求一句不提的，到最后是猛扣的，扣（60*0.2）=12分的。一门完全没有准备就匆匆给学生上的垃圾课程
220419,6500,张秉晟,2025-06-18 01:48:07,-5,0,5,给分不错
220706,6500,张秉晟,2025-06-19 08:58:31,1,1,0,教离散数学部分，网红老师，不点名，挺幽默的，但是思维太发散经常讲课讲着讲着讲到别的地方，课程ppt都有及时传，还行吧，虽然感觉一个学期下来啥也没学会。作业分数占比大，等出分了再来评价吧。
221032,6500,张秉晟,2025-06-21 02:55:28,1,1,0,平时作业无明确标准，期末不捞，想拿高分得投入大量时间
137001,6528,向为,2021-07-02 14:49:22,17,18,1,虽然没有上过老师的课 但还是打了10分
137002,6528,向为,2021-06-29 09:51:39,9,9,0,老师上课十分细心
137003,6528,向为,2021-06-29 09:53:35,7,7,0,好老师Bd
137004,6528,向为,2021-06-29 09:54:13,5,5,0,BDBD！
137005,6528,向为,2021-06-29 09:55:07,3,4,1,BDBDBDBD
137006,6528,向为,2021-06-29 09:55:34,1,3,2,话不多说，好老师
137007,6528,向为,2021-06-29 09:57:35,3,3,0,好老师bd
137256,6528,向为,2021-07-02 14:47:18,7,7,0,我爱你
137258,6528,向为,2021-07-02 14:50:01,4,4,0,真的好老师，
148724,6528,向为,2022-01-13 10:05:22,1,2,1,年轻的老师，课程设计仍有优化空间，但是课堂体验很好，老师有学识、真诚、友好包容，给分好到我觉得我都配不上。。
154370,6528,向为,2022-05-31 07:40:42,0,0,0,好好好！
157818,6528,向为,2022-06-25 03:19:53,0,0,0,老师挺好的；课程也能学到东西
178597,6528,向为,2023-07-16 09:11:46,7,8,1,向为打击~向为猛冲~
182375,6528,向为,2023-11-15 09:43:03,0,0,0,虽然没有上过老师的课，但还是打了10分
188989,6528,向为,2024-01-21 04:53:41,1,1,0,老师很严谨认真，与本科生平等交流没有架子，科研指导很细心，虽然很忙不能给出所有方面，但是向GPT还是非常擅长指导和规划
220691,6615,胡高权,2025-06-19 08:31:55,2,2,0,最后一节课突击点名，卡绩了，给分求是，明明感觉答的挺好的
221870,6615,胡高权,2025-06-27 03:54:17,0,0,0,好老师，上课水水的，还会提前下课，给分也不错
134682,6663,况琨,2021-04-09 05:18:29,10,11,1,老师很认真，讲课很清楚
137812,6663,况琨,2021-07-06 09:01:22,-3,3,6,老师给点分吧😭😭😭
151785,6663,况琨,2022-03-15 16:06:04,7,8,1,很好的老师，年轻有为
152593,6663,况琨,2022-04-15 11:34:21,6,7,1,人很好，很负责
153006,6663,况琨,2022-04-23 13:00:32,5,6,1,讲课很清楚
153537,6663,况琨,2022-05-04 06:32:59,4,5,1,讲课非常清楚，很耐心解答问题，感觉研究很前沿
153837,6663,况琨,2022-05-12 14:06:16,3,4,1,人工智能课讲课很到位，助教也很负责
158464,6663,况琨,2022-06-29 13:00:55,0,2,2,研究方向非常前沿，探索AI命运，非常赞
166469,6663,况琨,2023-01-12 10:29:39,2,2,0,人工智能给分很好，事情的话和其它平行班差不多，就是平台不太方便，总之还是听推荐的
169531,6663,况琨,2023-02-26 18:01:13,2,2,0,人工智能给分很高，谢谢老师，不过我也有很认真做作业😊
177427,6663,况琨,2023-07-03 08:44:40,2,2,0,好老师，讲课比较清晰，对学生也很负责
178209,6663,况琨,2023-07-08 04:26:41,4,4,0,老师讲课很详细，也很平易近人，感觉和同龄人一样。
197351,6663,况琨,2024-07-11 06:58:34,4,5,1,这课就是一文科课，本来就是冲着给分好选的，谁料今年人工智能给分很烂，没有选的必要了，快跑！！！
220275,6663,况琨,2025-06-17 04:37:07,2,2,0,刚考完，还没出分，但是说说自己的体验吧。老师人很好很温柔，没有考勤之类的，唯一一次有个课堂作业还是提前群里面发了通知。课程作业依旧是Mo平台完成6个实验，时间给的算是比较充足。考试面向ppt和最后一节课复习，重点考察你对一些重要的基础概念的掌握（如几个算法和学习），复杂的好像只有一个Q-learning大题计算甚至公式还给你了。今年考试是中文试卷，40填空30选择30主观，考了非常多的概念题，而且基本上所有的填空题都会给你几个预选项让你选，相当于是在做选择题，选择题答案也很明显，故意搞几个非常极端的说法送分。大题计算量不多，感觉通宵复习还复习多了（doge）
221771,6663,况琨,2025-06-26 07:03:13,2,2,0,好老师好助教妙妙妙！！！
123035,6749,史杨,2020-05-03 23:37:24,-18,20,38,史杨老师的职规A，疫情期间上的网课，平时全勤，网课全刷完，小组讨论积极一点（没当组长），作业都写，职业生涯规划书稍微鹅颈一下（其实就是把平时做的测验附上去），92分，供参考。
127054,6749,史杨,2020-11-04 11:45:11,18,21,3,组内展示排序\n\n组内参与度排序\n\n真就恶心人呗，就硬卷？恶心
127099,6749,史杨,2020-11-07 10:22:51,13,15,2,史杨老师人很好，说话也很温柔，是个pljj，每节课上课的主题跟职规都有关，会有游戏、看视频等等\n\n但是希望改变评分方式，职业规划书的分数由小组和全班评出来，无意义的鹅颈\n\n性格内向、组内存在感低的同学不建议选
127292,6749,史杨,2020-11-20 00:50:33,12,12,0,老师很好，上课很轻松，但期末评分有点让人难受，
127405,6749,史杨,2020-11-22 14:33:59,2,4,2,建议别选
127413,6749,史杨,2020-11-22 15:43:39,2,3,1,职业生涯规划书好好写了，团队成长手册也好好写了，组内评分也不算低，结果拉低我均绩不知道多少？？我就想知道到底是如何评分的？？
127593,6749,史杨,2020-11-25 01:22:22,12,12,0,老师还好其实，但是，哎，分组很重要，祈祷大家可以分到一个好的组。我们组全是大一，小组展示就比不过其他有学长带的组，（虽然我觉得我们挺好的），然后，绩点就有一点，不忍直视。但是其他有学长带的组，就很离谱，随随便便4.2以上。\n\n课上玩得开开心心，期末分数哭哭唧唧。\n\n课是比较水的，但个人感觉比较有意义吧，还是有一定价值的。
128595,6749,史杨,2020-12-24 09:48:06,3,3,0,绩杀坑死了！给分是真的迷
129004,6749,史杨,2020-12-28 08:30:50,1,2,1,职业规划A。老师人挺好，温柔耐心，课上也会有有趣的游戏来认识自己。小组团队合作比较重要，组间、组内互评确实存在。但是平时积极参与分数也不会太差。事也没有很多，总的来说还算有意思
130061,6749,史杨,2021-01-16 05:33:36,5,5,0,绩杀 鹅颈 除了老师人美以外 不建议选
135025,6749,史杨,2021-04-27 09:42:55,-2,7,9,心理测试堂堂做，小组手册次次写。\n\n无用生涯规划书，5000上限称减负。\n\n小组展示翻天卷，组内排完再组外。\n\n没有考试硬安排，考场座位喜自习。\n\n\n\n课本身设计就垃圾，讲的也不怎么样，还硬卷，卷的还沾沾自喜\n\n不如修读创业启程起码破事少点
135151,6749,史杨,2021-05-04 09:42:13,16,17,1,课程活动丰富，对认真上课的人来说还是挺有意思。给分的话，大部分课还是取决于自己的付出吧。如果你抱着水课的态度去学的话，即使是1.5分的课，也不要指望能给你高分。这门课最大的问题，是明明没有考试还要在考试时间去教室签到？！我为此还得专程从玉泉赶到紫金港。
135814,6749,史杨,2021-05-27 05:47:05,3,7,4,职规，上课放过成功学大湿的视频打鸡血，也宣扬过并不被大多数人认可的一些观念。以及鼓励内卷鹅颈，选上这课就只有后悔。。。
138693,6749,史杨,2021-07-10 11:15:00,6,7,1,我所佩服的只有一点，那就是这样的人，是怎么当上浙大的老师的
138736,6749,史杨,2021-07-10 15:15:33,-2,0,2,职规课本身就是教奴才怎么当好奴才的课，授课内容这块也没啥好评价的了。\n\n老师上课也就是很正常的按着流程走，要说特点可能是人美声甜，给人一种正能量是发自内心而不是装出来的感觉。有几次迟到，还有一次是请假了，因为“回家结婚”，还行。\n\n事情确实很多，5000字职规书，好几个展示，还有每节课的活动，不知道其他班怎么样。要求考试自习，但出考场的时候看到隔壁还有应该是搞职规展示的，更离谱了。可能因为被大佬带了，上课也表现得积极参与，最后分数还是可以的，给分应该不至于很离谱。
140498,6749,史杨,2021-09-13 05:29:50,-2,1,3,助教人非常好，几乎半个班都是4.5+
141030,6749,史杨,2021-09-22 04:01:36,1,3,2,只想说，我很好奇，这样的人是怎么来浙大当老师的？\n\n她是我大一时候的军训指导员，强制要求全连都写入党申请书，不写就扣分；我们都在那里站军姿，就她一个人连军靴都不穿，穿个运动鞋。
184700,6945,霍宇驰,2023-12-22 08:43:01,0,2,2,先给霍博打个10分
192306,6945,霍宇驰,2024-05-14 12:27:23,0,0,0,霍博nice!!!
192887,6945,霍宇驰,2024-05-31 08:53:33,0,0,0,霍博good
198090,6945,霍宇驰,2024-08-30 05:43:35,0,0,0,霍博great
200481,6945,霍宇驰,2024-10-17 13:30:00,6,6,0,woc 这老师是真不错啊 \n\n\n\n讲的是真好啊
200801,6945,霍宇驰,2024-10-22 13:23:27,2,2,0,好极了
201833,6945,霍宇驰,2024-11-07 00:19:49,1,1,0,霍博太nice了，i人的福音。
213281,6945,霍宇驰,2025-01-16 17:55:50,0,0,0,国际化：算法在游戏软件设计中的应用\n\n事少分高
213679,6945,霍宇驰,2025-01-19 05:57:14,3,3,0,国际化还是挺不错的 给分很好，但是那个机构感觉像骗钱的，第二阶段老贵了，查了一下上课的教授也老早就退休了，网站上的优秀论文案例说是ICML结果查了一下发现是国内一个双非大学搞的碰瓷的会议，根本不是顶会还是三个国际高中的高中生发表的，论文内容也是一坨😇感觉这个机构也应该好好查查😡
214332,6945,霍宇驰,2025-02-01 07:52:14,2,2,0,oop很推荐，点名提前通知，事少分高，作业只有7个assignment基本写了就满
125051,7459,常瑞,2020-08-21 00:26:58,6,7,1,课讲得很好啊，老师人很nice，备课内容很丰富，还有重点知识点的小视频，选到超幸运的，虽然是疫情期间上课，仍收获满满～实验选错队友，不过老师及时调整了，棒棒，给分也很赞的ヽ(^0^)ﾉ
126861,7459,常瑞,2020-10-25 09:50:21,4,9,5,极其混乱，尤其是作业实验布置。布置好的任务在学在浙大上仍然改动，并且不统一通知改了。。。
128306,7459,常瑞,2020-12-17 08:59:19,6,6,0,上课信息量有点大，有一些来蹭课的，老师经常分不清学生是不是自己班上的，问了我好几次。。。上课还挺有趣的，实验进度有点快，不过还好。作业布置得不多，不过都不太好做的样子。。。课上有小测。
132335,7459,常瑞,2021-02-01 00:24:54,1,2,1,体系结构给分太香了
132979,7459,常瑞,2021-02-05 17:08:35,8,17,9,常老师人非常的好！会非常考虑学生的感受（比如顺延DDL之类的hhhh）助教是我遇到过最最负责任的助教！先吹一波～\n\n1.上课学的很多内容是拓展知识，考试之前需要自学很多东西\n\n2.作业少但是相对来讲比较难\n\n3.实验相对其他班要求更高一些，但是如果实在困难助教会手把手教哦hhhh\n\n4.给分还不错吧～\n\n5.上课有小测\n\n最后再吹一波hsr助教gg！yyds！
139589,7459,常瑞,2021-07-17 17:20:16,7,7,0,网安导给分狂好 甚至感觉得到了自己不配的分数
139590,7459,常瑞,2021-07-17 22:40:40,2,2,0,超好的老师！
139592,7459,常瑞,2021-07-18 00:59:33,3,3,0,爆吹一波网安导！！！！
142333,7459,常瑞,2021-11-10 08:49:05,4,4,0,吹一波，常老师人非常好啊，讲课逻辑清晰，课件也很清爽，不像有些满屏乱糟糟的，体系给分很赞，上课不点名，TA水平都很高，实验要求会高一些，作业不多但是有难度，吹爆～
143969,7459,常瑞,2021-12-14 15:30:51,2,2,0,吹一波~上课很多欢声笑语，讲课娓娓道来，人又很随和，老师人很好的，注意上课会小测，体系吹爆常老师！
146071,7459,常瑞,2022-01-05 11:04:30,3,3,0,老师思路清楚，超级温柔、体贴学生，还有吹爆助教，yyds！
146166,7459,常瑞,2022-01-05 15:16:51,3,3,0,常瑞老师非常温柔，给分非常好。平时作业不多，由于老师的体系比其他老师做教改早一届，所以平时的实验会有1-2次和其他班同学不一样，但是不一样的这几次实验不算很难，期末老师也会给划重点。
147619,7459,常瑞,2022-01-10 10:15:17,2,2,0,去年就教改过了，相比其他班安排的更合理一些。\n\n老师期末会划重点，标注的习题一定要做，说不重要的部分是真的不重要！
147986,7459,常瑞,2022-01-11 09:05:38,4,4,0,平时分60%：两次平时作业12%；五次实验36%，前三次实验可能有点难，最后两次实验非常简单；其他Presentation+小测之类的12%。助教和老师非常好，平时分应该都给得很高。\n\n期末40%：最后会划重点，给分好得不知道怎么形容（按照最后结果来看）。\n\n其他：上课体验很好；老师人很有耐心；助教验收体验也非常好。\n\n综上，绝对值得选。
158201,7459,常瑞,2022-06-27 12:35:45,15,17,2,给常老师和所有为计算机系统这门课作出贡献的老师和助教们10分好评！
158746,7459,常瑞,2022-07-01 23:33:28,2,2,0,常瑞姐姐，我滴超人，网安导给分能满则满，选她的作业做就对了
158915,7459,常瑞,2022-07-03 08:50:13,-5,12,17,课程综合实践一\n\n完全听不懂上课在讲些什么东西
159414,7459,常瑞,2022-07-18 03:41:37,1,2,1,课程综合实践一，不点名，内容难度不小但是作业给分好而且水。没有考试，推荐来选
159899,7459,常瑞,2022-09-08 12:31:55,1,1,0,好老师呀，感觉给分很好人也很棒，总体十分喜欢的
161247,7459,常瑞,2022-11-02 07:21:04,-2,6,8,实践一详见https://www.cc98.org/topic/5393510\n\n很中肯。
164945,7459,常瑞,2023-01-03 15:54:52,3,3,0,常老师对学生很关心\n\n上课也十分nice\n\n面对考试的内容都会讲\n\n也会补充自己觉得必要的\n\n还会自己邀请芯片设计师给我们开讲座\n\n助教人也很好 真的很温柔\n\n虽然还没考试 但是我先给老师打个10分\n\n也希望期末能顺利！\n\n（btw查老师均绩比实际低了太多
166303,7459,常瑞,2023-01-12 00:10:33,1,1,0,瑞姐人很好\n\n等待出分前给她打10分
166537,7459,常瑞,2023-01-12 16:24:03,3,3,0,常瑞老师人很好，至今还记得她让我们带早餐到课堂上吃别饿着
168338,7459,常瑞,2023-03-01 11:40:50,2,2,0,常老师班的验收去年就做好了\n\n但是因为课程组要下学期再统一改卷\n\n现在也没有出分\n\n嘿嘿，但是小板子真香\n\n------------------------------\n\n出分了\n\n师生情！！！
168577,7459,常瑞,2023-03-01 11:54:20,1,2,1,常老师人很不错！但是可惜的是，本学期的体系结构真的学的云里雾里，不是说这门课程有多难，而是很多老师之间讲课的内容都甚至没有统一（严重怀疑课题组之间所谓的统一就是说要考哪个大模块），以至于期末考试的内容可以说和上课学的相关度不超过0.6，也就是意味着如果你没有自己单独去听其他老师的课的情况下，如果你没有把书中要考的章节背的滚瓜烂熟，那么当你看考卷的时候，你就会发现选择35题中有超过15题你都没见过（而且见过的也不一定做对）。\n\n\n\n真的希望体系结构这门课好好统一一下讲课标准，并按照考纲严格授课。\n\n-------------------------\n\n出分了，感觉给分很好了！
169049,7459,常瑞,2023-02-24 06:35:45,2,2,0,cr老师人非常好\n\n是真的很想让我们了解体系结构\n\n班级的实验总体也整体合理一些\n\n但是知识点确实今年很杂\n\n不能说都教到了\n\n具体只能看出分了 唉
170109,7459,常瑞,2023-03-01 11:36:38,-1,0,1,讲课好，给分浓浓师生情
170122,7459,常瑞,2023-03-01 11:59:33,-1,0,1,浓浓师生情QWQ复习PPT立大功
170127,7459,常瑞,2023-03-01 12:19:16,0,0,0,【体系结构】最后一次复习课和给分都是浓浓的师生情，吹爆！！！十分建议选cr老师的体系，体验绝对好
170468,7459,常瑞,2023-03-05 09:29:55,0,1,1,不点名\n\n讲课很清楚\n\n(体系结构难的部分网上都有)\n\n跟着老师的ppt复习可以覆盖80-90%的题目\n\n但是必须一个地方都不放过！\n\n22年期末的教训，看了所有的ppt细节才能去考\n\n但是ppt全看完就不用复习别的了
170673,7459,常瑞,2023-03-08 02:42:01,0,0,0,太好了
186764,7459,常瑞,2024-01-13 05:07:03,3,3,0,23 秋冬体系结构。\n\n老师很好，据她所说讲课十多年从不点名（今年最后一节课有一次不计分的签到）\n\n讲的很丝滑，课程内容如数家珍，而且可以看出来，常老师是真的在教“体系结构”，而不是“体系结构课程”。很多时候大篇幅都是在讲背后的思想，表面的算法、例子涉及较少，这也导致最后考试的时候有相当的部分是老师没怎么讲，或者一笔带过的内容。今年特殊原因考前也没有面向考试的复习课。
186991,7459,常瑞,2024-01-14 04:46:49,0,0,0,23秋冬体系结构，给个9分 扣一分是因为一个小时不到讲的东西考了30分导致爆炸（）\n\n23体系班的不用担心，我们班据了解是没有人因为期末太低给斩杀了的，平时分不摆烂就不会挂\n\n首先说下实验，一共5+1个\n\n第一个实验就是流水线+forwarding，流水线框架给你了你只需要加上forwarding\n\n第二个实验是流水线中断异常处理\n\n第三个实验是给你一个完整的流水线，你在里面加上分支预测\n\n第四个实验室是实现一个二路组相联缓存，不过第一路以及其他都好了直接copy就行（注意copy后记得改编号，我没改编号导致debug爆炸最后重写）\n\n第五个实验记分板乱序，照着流程图抄就行\n\n第六个是托马斯路算bonus\n\n\n\n一共两次作业，都很简单\n\n然后有一次组队展示。基本认真做下去平时分只会丢两三分，做bonus就满了\n\n\n\n说下考试，为什么是9分呢。。最后第五章部分考的一小时不到速通（期末这部分考了30分两道大题，爆），不考的花大部分篇幅再讲，面向绩点的建议快润（）面向知识的确实不错的选择\n\n\n\n而且体系这门课重点也不多，速通不挂是完全可以的（五个小时足够了，记分板+托马斯路看看，然后把第五章看看就够了，前面都是计组学过的，少部分没学的占比也不大）
187231,7459,常瑞,2024-01-15 08:20:44,0,1,1,老师还是不错的 不签到 但是最后一次纸质签到了 再过去也不给补...最后一次课大家都在复习或者赶ddl 前面讲课的去了不管用 最后一节复习课签到 讲课说不上特别好不过也不错 平时分绩杀 bonus几乎最后才放出来 难度又很大 自己写的代码量很多 至少要调个几天 各科最后一周的复习和bonus自己选... 另外其中有一个助教验收和给分都不咋地 给七分纯纯是给老师人好的面子了 自己慎重吧 除了平时分 另外考试题出的是真抽象 怎么期末os 计网那么多课就体系这课出题这么恶心人呢 给我气的语无伦次了 无语
187606,7459,常瑞,2024-01-16 19:35:32,3,3,0,体系\n\n感谢老师捞我，感觉这个课实验报告要好好写，大部分老师报告还是会扣一些的（不过今年wxh实验基本全是满的还似乎不用验收，很轻松，真好啊）\n\n以及尽量去上cr的课，老师真挺好的我感觉，是真想让你学到一点体系到底是什么的，以及我觉得我也占了总去上课的便宜，平时分就有种被捞的感觉。\n\n另外cr的pre感觉也要好好做的，不难，用心讲清楚自己选的题就好。\n\n最后的期末可能需要面向其他老师的东西复习一下，毕竟个人感觉cr老师后半学期讲的可能确实不是那么面向考试，但是最后一次复习课提到的内容也都是很重要的。\n\n再次感谢cr老师！鞠躬！！
189544,7459,常瑞,2024-01-25 10:32:14,0,0,0,rt，bonus在最后放出来而且是tomasolu这种比较硬的确实难顶\n\n今年期末考也是真的难顶\n\n老师是很好的老师，会有单独的小板子可以带走，人也很好\n\n但是今年冬15点了一次名orz，会给到的同学加一点分\n\n给分中规中矩，不过隔壁cwz回答问题就算bonus给孩子羡慕坏了
189601,7459,常瑞,2024-01-25 15:17:53,0,0,0,体系\n\n常老师可以说是很会捞了，注意平时实验一定要好好做，平时分不要给扣太多，最后复习的时候建议重点复习一些和计组没有交集的东西
207662,7459,常瑞,2024-12-23 14:29:29,0,0,0,CTF101，好老师，好助教
208786,7459,常瑞,2025-01-02 02:40:07,1,4,3,体系结构避雷。。。。\n\n常老师讲得确实不错，逻辑很清晰很深入同时通俗易懂，但是体系结构的教学内容和其他教学班差别实在是太大了，甚至同个内容同个算法的名字都不一样，导致期末考考到很多没讲过或者是讲得不一样的东西。。。虽然老师的讲课思路很流畅，但是好歹还是得考虑一下学生要期末考，和其他班级同步教学内容吧。。。
208792,7459,常瑞,2025-01-02 04:00:03,5,5,0,cr老师讲课很清楚，但是体系考试问题很大，每个班授课内容有差别，一个老师讲的不能覆盖全部内容。另外，一定要看历年卷！！！
208845,7459,常瑞,2025-01-02 12:37:55,0,0,0,体系课程本身有一定的问题，但是个人觉得常老师把讲到的地方都说得算比较清晰了，总体感受和之前有学长/学姐在评论区说的一样，老师是好老师，希望教给我们很多东西，但是我自己水平不够好，连应付考试都很困难。虽有考试不涉及的部分，还是觉得喜欢常老师讲课的风格ღ( ´･ᴗ･` )，还是觉得收获满满。
208924,7459,常瑞,2025-01-03 11:57:51,-2,1,3,出分了，cr还是挺捞的\n\n\n\n但是如果复习的话，尽量以jxh的ppt为准吧，不然没考到的地方会很多。Cache和乱序执行这一块可以听常瑞的加深理解
208926,7459,常瑞,2025-01-03 12:06:00,1,1,0,早八考完第二天晚上就出分了。战斗，爽
208998,7459,常瑞,2025-01-04 06:50:34,0,1,1,2024-2025 学年秋冬，课程不点名，一共有 5 + 1 实验（一个 bonus），三次 homework，一次组队展示。感觉如果每次内容都完成的话，即使不做 bonus，平时分也接近满分。常瑞老师讲课还是很清楚的，最后给分也好。不过确实存在授课内容有差别的问题。一定要做历年卷，抄 sheeting paper 的时候也可以参考一下学长学姐的笔记（抄了 cache 相关的内容救我大命）
211016,7459,常瑞,2025-01-10 10:42:38,3,3,0,crjj好温柔！系统2不点名，期末卷子自己改，狠狠地捞了
211071,7459,常瑞,2025-01-10 13:06:29,2,4,2,为啥要欺骗学生考试范围
211793,7459,常瑞,2025-01-12 12:36:01,1,1,0,好老师，哈哈哦好好
212734,7459,常瑞,2025-01-14 15:43:27,0,0,0,体系结构好老师cr！！！\n\n给分感觉还挺好的，自己本身硬件课学的不好所以考试也没有考好，最后出分感觉还是比较符合自己水平+老师助教捞捞的\n\n上课体验来说，常瑞老师确实是希望能教会学生一些知识，不同于直接对着ppt讲课的老师，非常赞\n\n至于24-25秋冬期末考的考卷方面，因为我那几题本来也不会，所以对我来说没什么影响☝️🥸
220681,7459,常瑞,2025-06-19 08:06:06,1,1,0,就评老师平时的负责和今天考试时耐心解答同学对题目的疑惑，我先给个10分
221018,7459,常瑞,2025-06-21 01:01:03,7,7,0,cr 是我的妈妈😭 我的好妈妈😭
221091,7459,常瑞,2025-06-21 08:18:22,2,2,0,上的是体系结构\n\n给分很好，cr老师就是我的神！！！\n\n\n\n老师很和蔼温柔，讲课也很认真
221243,7459,常瑞,2025-06-22 07:23:22,1,1,0,老师特别耐心特别好！！！
221614,7459,常瑞,2025-06-25 02:38:43,0,0,0,非常耐心\n\n一定要看考前的PPT\n\n我是cwz班的，剽窃了她的复习PPT\n\n所有重要考点全部罗列在里面\n\n比如：cache technology一章的选择题\n\n我当时还纳闷，为什么用这么多篇幅来把\n\n缩短命中时间、降低miss rate全部列出来\n\n事实就是考试考了3道选择题\n\n你说难吧 知道的人肯定觉得不难\n\n你说不难吧 里面有几个技术像我这种其他班的人\n\n听都没听过\n\n索性我抄进去了\n\n只要比对比对就行了\n\n\n\n不过感觉大学的课吧\n\n包括这门课\n\n其实没有到非常严谨，老师考察也主要是看你到底懂不懂\n\n因为纯粹的背书没有意思\n\n但是我认为像我们这次考试\n\n除了动态调度，带分支：平时接触比较少\n\n其他的题完全就是模板啊\n\n考前好好听出题老师的复习课\n\n大题都能猜到\n\n选择题面比较广，平常还是要好好学\n\n但真心不难
188524,7657,刘健,2024-01-19 07:09:34,3,4,1,。。。
191097,7657,刘健,2024-04-02 11:03:10,4,12,8,问：如何评价该老师的上课水平？\n\n答：无法评价。\n\n问：为什么？\n\n答：他甚至不亲自来上课，都是博士生/硕士生上课，样本过少，无法评价。客观来说，比ljj还要糟糕
191563,7657,刘健,2024-04-25 04:02:03,5,9,4,逆天老师九周上了三节课，还有一节是引言\n\n实在难评
219380,7657,刘健,2025-05-30 14:32:46,2,2,0,挺好的，不点名，不用去。\n\n--------------\n\n本来少了lab的，后来在白洪欢的强烈要求下lab又多出来了。bhh你是真的出生啊
219552,7657,刘健,2025-05-29 13:58:58,0,1,1,今年比隔壁小白少个lab！好耶！
128106,7660,梁秀波,2020-12-07 10:29:41,0,1,1,波波老师是很好的老师，课程easy，给分爽快。
133316,7660,梁秀波,2021-02-25 03:06:37,0,1,1,有一次，老师投影仪没开，硬是讲了一章，竟无同学提醒他。。。
139838,7686,张启飞,2021-07-31 02:56:30,0,2,2,上课没有条理和逻辑，完全没有啥实用的东西，一会教这一会教那。完全即兴发挥
168787,7686,张启飞,2023-02-22 08:08:37,1,2,1,给分真好！！
216288,7686,张启飞,2025-03-13 02:26:04,1,1,0,煞笔一个
134060,7845,唐华锦,2021-03-14 16:16:57,2,7,5,华锦yyds
135149,7845,唐华锦,2021-05-04 00:58:34,0,5,5,好老师！真的是好老师
153861,7845,唐华锦,2022-05-13 14:30:43,-11,0,11,老师讲课非常好，没有课后作业，只有课前小测(可以看书的哦)，给分也很好！
153862,7845,唐华锦,2022-05-13 14:30:43,-6,1,7,老师讲课非常好，没有课后作业，只有课前小测(可以看书的哦)，给分也很好！
206316,7845,唐华锦,2024-12-14 05:29:53,0,0,0,脑启发大作业啥意思？就把项目扔给我们然后让我们自学框架把算法集成进去？
154707,7851,鲍凌峰,2022-06-04 03:10:49,1,2,1,讲课不清楚，不点名，给分还行，注意小组分工要均匀一点
214710,7851,鲍凌峰,2025-02-17 02:50:47,2,2,0,口吃很严重
219815,7851,鲍凌峰,2025-06-07 09:00:31,3,3,0,验收宽松，给分很好
141637,7908,王则可,2021-10-18 13:38:42,4,16,12,很好的老师～很耐心很负责呀
197165,7908,王则可,2024-07-08 10:16:00,14,17,3,计院第一养鱼，画饼大师，push怪。
197511,7908,王则可,2024-07-18 01:02:57,7,7,0,楼上细说
200015,7908,王则可,2024-10-11 02:42:39,2,2,0,。。。
204996,7908,王则可,2024-11-29 10:16:54,2,2,0,垃圾人
180316,7913,张宁豫,2023-09-21 05:28:26,0,0,0,张老师！神中神中神
136730,7942,卢立,2021-06-23 14:21:20,5,5,0,讲课不错~
137262,7942,卢立,2021-07-02 15:30:34,3,3,0,讲课好～
148651,7942,卢立,2022-01-13 06:08:48,0,1,1,nice
148759,7942,卢立,2022-01-13 12:22:20,2,3,1,讲课好哇
150514,7942,卢立,2022-01-28 06:21:06,2,4,2,讲课的话，老师虽然是第一次上，但是表达能力还是很不错的，老师也很希望同学们能学明白这些内容。就是老师讲的这部分内容本来就很零散难成体系，个人感觉也没教材能讲清楚这些东西，个人觉得可以多举几个例子加强理解，然后逻辑也更顺一点，当然总的来说还是很不错的了。\n\n划重点能力和申文博老师一样都是一流的，总之计算机系统课程老师都很nice就对了！
150849,7942,卢立,2022-02-19 12:57:39,1,1,0,蛮好的
154524,7942,卢立,2022-06-02 03:58:49,7,8,1,老师讲课很清楚，是我最喜欢的老师之一。
160466,7942,卢立,2022-09-23 07:09:42,1,1,0,好老师嘿嘿嘿
161017,7942,卢立,2022-10-24 00:23:02,2,2,0,老师很好捏
167165,7942,卢立,2023-01-15 04:31:07,2,3,1,nice
174346,7942,卢立,2023-06-10 07:45:25,-1,3,4,感觉老师不太懂硬件，和实验脱节比较严重。。。
178987,7942,卢立,2023-08-13 17:48:18,3,3,0,上课挺好的，有一次课程点到算5分的bonous
184187,7942,卢立,2023-12-12 06:37:06,0,0,0,ll真的特别管我的死活
184744,7942,卢立,2023-12-22 11:54:39,2,2,0,老师的讲课水平毋庸置疑，表达非常清晰，人也很好，同学不管遇到什么问题都会帮助
196294,7942,卢立,2024-07-03 00:16:55,0,0,0,讲课水平很高，表达能力、逻辑水平很强
196310,7942,卢立,2024-07-03 00:48:19,0,0,0,学得很痛苦， 给分很不错
197088,7942,卢立,2024-07-07 12:23:54,0,0,0,讲课超好，人也非常好
197971,7942,卢立,2024-08-22 03:08:52,0,0,0,神，唯一能说明白的sys老师
219234,7942,卢立,2025-05-23 08:30:12,1,1,0,讲课清晰 个人主页很可爱
219813,7942,卢立,2025-06-07 07:51:09,1,1,0,24-25春夏计算机系统Ⅰ计算机组成部分。老师讲得还是很清楚的。但是在一次放假前一天的课上做了一次小测点名。。。
141970,7967,陈柳青,2021-11-02 09:28:30,-9,8,17,是我班主任，人很好，能一起玩耍
144214,7967,陈柳青,2021-12-20 13:07:55,-5,11,16,和蔼可亲，90后能一起玩耍
146112,7967,陈柳青,2022-01-05 13:34:27,22,28,6,一个星期三节课，两节半在小组展示夹杂着他经常打断性的骂人，最后半节课再布置下节课作业。上课啥也学不到，期末作业完全自学，给分垃圾。期末作业还要互评，互评完了看他脸色调分。
154228,7967,陈柳青,2022-05-26 11:57:48,10,13,3,让学生讲课讲得不好不说还布置作业很不公平
159580,7967,陈柳青,2022-08-20 06:20:52,9,12,3,整天就知道骂人
165083,7967,陈柳青,2022-12-29 04:21:27,18,19,1,垃圾老师垃圾课，大作业全是fly bitch，上的课全是答辩还想要作业做出什么高级东西来，麻烦学校下次别在必修课表里塞这种大粪了
167236,7967,陈柳青,2023-01-15 07:23:22,8,8,0,lj，选课绕着走
167238,7967,陈柳青,2023-01-15 07:26:12,15,15,0,设计认知和设计智能实在垃圾，课程没内容，考试给分巨烂无比，能不选的千万别选
167541,7967,陈柳青,2023-01-17 07:16:04,12,13,1,不评价老师只评价课程\n\n设计认知与设计智能，垃圾课，给分烂，课表里塞这样一坨屎专门针对AI学生是吧
171655,7967,陈柳青,2023-06-02 08:38:47,8,8,0,SBSBSB
171840,7967,陈柳青,2023-06-13 14:15:39,8,8,0,纯纯dinner，鉴定为唐氏
171894,7967,陈柳青,2023-04-11 10:03:35,12,13,1,没见过这么没耐心、不尊重学生、歧视学生的老师，以为自己什么都懂
190007,7967,陈柳青,2024-02-08 10:00:50,11,11,0,水平很低，爱招牛马，不尊重人，提出一堆自以为是的意见，要不是要毕业早骂他了
190373,7967,陈柳青,2024-02-28 18:58:28,10,10,0,看到都在骂他就放心了，在他实验室完全是痛苦折磨没有希望
191838,7967,陈柳青,2024-05-01 13:16:11,4,4,0,真的唐
196469,7967,陈柳青,2024-07-03 15:19:57,7,7,0,本科生别傻愣愣去他那当牛马
219774,7967,陈柳青,2025-06-05 12:25:58,1,1,0,数数sly以及底下的王gy陈lq乃至月牙楼hci有关的老师一作paper数量 \n\n是老师太努力？还是学生太没用？怎么学生就发不出自己的一作paper呢？
136352,7976,邵天甲,2021-06-17 02:19:49,11,14,3,作业贼多，上课感觉抓不到重点，尤其是图形那一块，学吐了
136821,7976,邵天甲,2021-06-25 06:14:55,5,11,6,什么妖魔鬼怪
139140,7976,邵天甲,2021-07-15 21:02:34,3,6,3,给分还可以
139404,7976,邵天甲,2021-07-15 07:40:56,-1,1,2,老师课讲的比较高深，不太好理解，但还是能学到东西的\n\n老师给分非常好\n\n老师也比较用心
139408,7976,邵天甲,2021-07-15 08:04:48,-2,0,2,老师很牛\n\n是我太菜了听不懂
139416,7976,邵天甲,2021-07-15 09:32:15,21,30,9,上了老师的C大程。\n\n关于老师本身及授课\n\n老师很好，很厉害，清华自动化毕业，留学经历也很好，知识渊博，年轻有为。教课友好程度一般……他课上会问学生有没有听懂，但令人绝望的不是“没有听懂”，而是他问我们“有没有听懂”的时候，我们不知道自己是否听懂了……即使知道自己不懂，也不知道自己哪里不懂，不知道该问什么。（PS：此种情况，主要出现在讲图形库、回调函数那一部分，讲授C大程其他内容的时候，这种情况比较少）\n\n总之，看着老师耿直的脸，我只能说：没有问题，可以继续讲下去。\n\n\n\n关于pta作业：作业难度比较有区分度，会有一些比较难的题目，但是给的时间很充裕（所有pta作业几乎到了学期末才截止）如果执行力强一些，做完所有作业完全没问题。\n\n\n\n关于大作业：没有互评，完全由老师和助教评分。我觉得这一点是比较好的。我不相信学生之间的互评质量，更愿意相信老师和助教的公正性。
139423,7976,邵天甲,2021-07-15 11:03:38,2,3,1,老师很厉害，不过上课有些时候会听不明白，需要自己多看多想。不过毕竟c大程这种只听课是未必能学会的。上课的时候总会问我们有没有听懂，可以看出来他是真的想让我们听懂。/doge
139443,7976,邵天甲,2021-07-15 15:09:59,0,1,1,老师很努力，技术很强大。\n\n但讲课确实有点混乱，有时候要去旁听隔壁zy老师的课。\n\n大程没有互评，很不错，给分还可以。
139451,7976,邵天甲,2021-07-15 23:44:55,4,5,1,大程无互评，大小作业给的时间都很多，大作业给到了考试周最后一天。新老师头回上课，讲课还有提升空间。
139464,7976,邵天甲,2021-07-16 06:10:20,6,7,1,水平挺高的，有自己上课的理念，希望把更好的知识带给大家（比如会推荐大家用斯坦福C语言艺术），但是讲课能力还有待提升。大作业无互评很好，给分也挺好的。
139618,7976,邵天甲,2021-07-18 11:05:36,4,9,5,是新老师，老师很厉害很有才，但是讲课emm还是有不少提升空间，听下来全程云里雾里..但是老师和助教态度都是挺负责的 看得出来很用心，有评论说作业多，我觉得还行啊，横向和其他c大程班比较作业量是差不多的（某些班据我所知作业比我们多不少..，而且ddl设得很晚时间很充裕，过程挺坎坷的但是给分还可以。
141600,7976,邵天甲,2021-10-16 18:16:00,4,6,2,老师讲课希望可以更清晰点 给分很好！
153468,7976,邵天甲,2022-04-30 14:31:28,5,11,6,英文ppt、几乎只有第一排同学才看得清的代码、近似于语无伦次的讲述，劝退了
154820,7976,邵天甲,2022-06-06 01:31:04,7,12,5,老师，菜菜，捞捞，呜呜😭 🥺🥺🥺🥺🥺🥺🥺🥺🥺🥺🥺🥺🥺🥺🥺🥺🥺
158571,7976,邵天甲,2022-06-30 09:09:31,-12,5,17,老师很年轻，也很厉害，清华的，也有留学经历。感觉上面说的老师不管你听不听得懂这个问题老师有改进，他曾经一个知识点反复讲了很多遍确保我们能听懂。助教也很好，pta的作业ddl我们可能是最晚的。给分也很好，我并没有编程基础，大作业写了一个文本编辑器，最后也拿了4.5
173938,7976,邵天甲,2023-06-05 03:49:27,0,2,2,老师确实感觉很厉害，但是C大除了指针进阶感觉都是自己在学
177090,7976,邵天甲,2023-07-01 15:24:08,1,2,1,只能说老师人挺不错的，技术也很厉害，但可能讲课还有问题，或许是C大这门课的原因。但是两个助教态度。。。呵呵就像助教回我的一样，就像我欠钱找他办事一样
177587,7976,邵天甲,2023-07-04 00:45:22,-16,4,20,老师很好，推荐选
200805,7976,邵天甲,2024-10-22 16:13:51,3,4,1,上课是只会念PPT的，作业是把人累成傻碧的
202286,7976,邵天甲,2024-11-11 08:13:52,1,3,2,其实还可以，跟着正常学不会有什么大问题
204816,7976,邵天甲,2024-11-28 03:59:17,7,8,1,已经一分了
207096,7976,邵天甲,2024-12-19 08:30:38,8,8,0,脾气差经常摆个臭脸，很会pua压力学生，动不动就说你能力不行，劝退...
207436,7976,邵天甲,2024-12-21 15:06:30,8,9,1,出生登场
208358,7976,邵天甲,2024-12-27 04:44:18,3,4,1,本人是浙江考生，学过信息技术，老师学术功底很好，对代码的运行原理理解得很透彻，但是讲课能力不太行，上课听的很累。助教老师上大分，人美心善回答问题及时，态度非常好。如果有编程基础的同学把这节课当做学习进阶的辅助是非常好的，如果是零基础，没有计算机语言的思维的话可能会学的有点折磨
210304,7976,邵天甲,2025-01-09 01:29:23,4,5,1,根本不捞人，甚至卡及格线
210355,7976,邵天甲,2025-01-09 03:36:54,11,11,0,已经一分了，根本不捞，小测扣多少就是多少，对比隔壁xsy老师的话，真的难评
210608,7976,邵天甲,2025-01-09 12:18:39,3,3,0,屎
210865,7976,邵天甲,2025-01-10 05:43:07,1,2,1,0.1分卡绩也就他干的出来
211382,7976,邵天甲,2025-01-11 09:31:21,1,2,1,缺点：上课念ppt，且自顾自念自己的（但有时也会问一下大家有没有搞懂，或者问一下结果是什么，但是总是没人答），且态度较差？（个人感觉就是很典型的理科男），给分应该是不捞的呃呃\n\n\n\n优点：老师其实挺负责的，有些知识点比较难和没搞懂重复问的会在课上再讲，并且上课较快（我觉得算是优点吧，可能就是学到链表了但是小测只考到指针这样），无签到，上机课也不用签到。上完课就讲习题，习题都是从历年卷以及常错知识点里收集过来的，我觉得挺好\n\n\n\n还行吧中规中矩 勤勤恳恳的一个老师
211644,7976,邵天甲,2025-01-12 05:59:00,0,1,1,还行，就是下午第一节的课实在太困。上课不点名，讲的内容都是书上的原代码。小测难度有一次略难。反正中规中矩吧。
215285,7976,邵天甲,2025-02-25 03:49:30,4,5,1,心情不好，来看一下，记录我绩点被C尖击落，导致转专业失败的大一上。
215700,7976,邵天甲,2025-03-04 09:27:07,0,0,0,这作业真是保量又保量啊
222061,7976,邵天甲,2025-06-29 10:02:14,1,1,0,虚拟现实：事情很多，两次报告，一次小测（难蹦的是有的题目答案PPT上没有），一个大作业，一个开卷考试（基本都在PPT上）。大作业事情还是蛮多的。想上水课的快逃，想要高绩点的这门课也不容易给高绩点。
161365,7977,杨易,2022-11-05 07:01:40,29,33,4,杨易老师是神
173607,7977,杨易,2023-05-30 03:55:48,4,5,1,先挂楼占个位置，真的从杨易老师来浙大就有关注了。下学期选他的课去玩玩！回来再跟大家说
183591,7977,杨易,2023-11-27 13:39:21,1,1,0,肉眼可见的nb
189575,7977,杨易,2024-01-25 12:31:54,1,1,0,长话短说，cs排名可查，很🐮
218887,7977,杨易,2025-05-11 07:23:37,0,1,1,短学期给分好。但想进他组的同学快跑吧。快跑。快。
134685,7978,刘金飞,2021-04-09 06:33:20,12,14,2,老师真的好
160435,7978,刘金飞,2022-09-22 16:02:12,3,9,6,上的刘老师的课程综合实践二\n\n课程内容新 领域广 但难度不算高\n\n只要会python 计算机基础扎实一些就没问题\n\n可能感觉作业有点折磨 但是一定要坚持住\n\n作业在理念上较难 但工程量很小\n\n100飘过
165043,7978,刘金飞,2022-12-28 15:50:24,3,6,3,占个楼\n\nads选了他 没评分开盲盒！\n\n最后补选的时候也干脆不尝试去换其它评分高的老师了！\n\n主要是怕选不上被塞到更差的（x）\n\n求求了这次运气好一点吧！！！
176022,7978,刘金飞,2023-06-28 12:15:17,0,1,1,。。。
176162,7978,刘金飞,2023-06-28 03:34:32,0,4,4,复习ads中，不知道给分怎么样。\n\n回顾一个学期，完全在此人的带领下混过来的。\n\n无故不上最后一节课，上课讲的混乱不堪，全班就几个人在听。\n\n复习时才发现了myc老师的网课，对比之下，一个天上，一个底下。
176582,7978,刘金飞,2023-06-29 09:57:12,-1,3,4,ADS 平时分很松，很容易满分，前几节课收随堂discussion，后面不收了。老师会有板书，比较闷，得认真跟。。。
176616,7978,刘金飞,2023-06-29 12:40:04,3,4,1,刘老师讲的很认真 希望课程越来越好
177070,7978,刘金飞,2023-07-01 13:27:35,5,7,2,可以感觉到老师人很好，不过可能是因为是新老师，教学经验不是很足，对课堂节奏掌握的火候还不是很到位，以至于经常出现大片的discussion空白，建议复习的时候看毛老师的网课。\n\n平时分给的很好，期中考得好还请同学们喝奶茶，就是偶尔会拿老婆出来炫耀（不是）（狗头保命）先给个8分，希望老师越来越好！
177391,7978,刘金飞,2023-07-09 15:21:08,3,7,4,讲课真心不行，建议听yy老师或者myc老师智云\n\n不收讨论，没点名，上课真的轻松\n\n互评不占分，神中神\n\n期中考好了全班会有奶茶奖励\n\nADS难度越来越低了，今年低于斩杀线只有七个好像\n\n\n\n出分了捏，低的有点难以想象，感觉老师第一年教ads平时分给的有点那啥（笑），反正都是听别人智云，能的话还是选平时分好点的老师吧
178284,7978,刘金飞,2023-07-09 12:36:47,0,2,2,讲课一般，给分一般，不过人比较好
178716,7978,刘金飞,2023-07-19 12:52:20,0,1,1,刘老师不但教大家某个算法是什么，还告诉大家这个算法为什么这样，特别是NP那部分。。。。。。。。。。。。
178960,7978,刘金飞,2023-08-06 06:12:52,0,2,2,ADS讲的真不行，感觉比较钻牛角尖，甚至还出现了讲错的地方，给分也比较一般，拉低了计院老师的平均质量
179280,7978,刘金飞,2023-09-07 06:42:23,4,6,2,讲的很好，非常通俗易懂，两位助教学长人都特别好（大帅哥，大美女！！！），ads给分也挺不错。老师人特别好，期中给我们都买了奶茶，赞爆！！！
180750,7978,刘金飞,2023-09-25 17:06:43,1,2,1,半夜想起来上学期的ads 如果能再来一次还是选别的老师吧
182086,7978,刘金飞,2023-11-09 18:40:08,0,2,2,。。。
184297,7978,刘金飞,2023-12-15 17:03:06,0,0,0,给写了推荐信，还给改了下~~~~~
189603,7978,刘金飞,2024-01-26 01:17:01,1,2,1,讲的实在一般，不太清楚，给分也很一般，慎选
191687,7978,刘金飞,2024-04-28 04:08:11,1,1,0,老师上课内容很硬核，能学到很多东西，上课不点名，助教gg非常耐心，课后问题耐心解答，是个非常负责的助教。
193696,7978,刘金飞,2024-06-15 13:00:46,1,1,0,老师很好，助教 wyy 更好，又帅又温柔！！！
193766,7978,刘金飞,2024-06-17 15:16:15,0,0,0,wyy好帅~~~
195432,7978,刘金飞,2024-06-28 04:30:50,0,1,1,老师和助教都挺认真的，给分也不错～\n\n可惜以后好像不开ADS了
196361,7978,刘金飞,2024-07-03 05:37:47,3,3,0,老师和助教gg认真负责的态度就值得十分！
197849,7978,刘金飞,2024-08-16 00:43:51,2,2,0,课程综合实践Ⅱ（数据要素市场）。讲课和给分仰赖wyh（就是其他评论中的wyy）学长。今年是第二次开，上次开是在两年前，而且是跟公司合作，因此授课内容很不同，因此实际相当于第一次开课。主要是讲博弈论相关知识，数学性很强，因此作业也会稍显困难。以后大概率会降低难度，但是个人认为数学性强这一点不会改变。作业和大作业尽力做的话给分应该不错。助教学长是个有理想的人，而且和蔼可亲，建议大家跟学长多多交流。
197870,7978,刘金飞,2024-08-18 04:10:03,2,2,0,短学期\n\n每天都有很多数学内容，完全掌握很难\n\n但张张见识也挺好，并且小测没有要求推导，作业比较有难度，要好好思考\n\n给分无敌
210977,7978,刘金飞,2025-01-10 09:08:48,1,1,0,两年前上的综合实践Ⅱ课程，当时是首次开课，所以课程内容的准备上显得有点不够完善，像草台班子。不过可以看出刘老师是想认真设计好这门课程的。可能因为刘老师也是新教师，有时候讲课会有点卡顿，但这个时候无敌的助教学姐会出手。作业方面，那次是和蚂蚁合作的缘故，部分作业内容会感觉有些奇怪。全靠两位人美心善的助教姐姐（谁不喜欢美女姐姐呢），不仅提供答疑解惑的支持，还尽可能地降低了作业的外部难度。如果对核心知识点有一定理解的话，其实工作量不会太大，最后的评分也都很好（身边统计学）。刘老师的课堂福利蛮好的，不仅给大家买奶茶，还给期末成绩好的同学申请了一笔奖学金，最后还因为疫情不用去蚂蚁线下，可以说是很舒适了。
127389,7986,毛宇尘,2020-11-22 09:44:41,1,3,2,老师太好了。
130995,7986,毛宇尘,2021-01-25 13:31:17,3,6,3,计算理论课的一股清流\n\n就算还没看到给分如何，光凭扎实的理论功底和优秀的备课讲课水平，我也愿意给他10分
132578,7986,毛宇尘,2021-02-02 12:08:44,0,1,1,老师人很好，非常的耐心，也会整理学生的疑问并附上解答发出来，非常非常棒的老师！
132935,7986,毛宇尘,2021-02-05 07:09:13,16,16,0,老师上课用的是手写投影，记笔记的话要一边听讲一边跟着他一起写。备课认真，回答同学们的问题也十分及时。\n\n以下是一些问题：\n\n1.略有一些照本宣科的意思，教给我们“怎么做”，但不讲“为什么”，这对于这门十分数学的课是有些致命的\n\n2.给分真的铁面无私...完全看各成绩比例给分，最惨的是平常作业的分扣得很严...全程认真记笔记认真写作业认真学认真复习认真考试拿了个3.3QAQ\n\n这门课真的很难，考试更难，奉劝各位学弟学妹们多花点时间...
133386,7986,毛宇尘,2021-02-26 11:39:23,0,1,1,人好可爱的，第一节课就暴露了“老婆大人”hhhhhh\n\n讲课挺细致的，但有时候可能太过细致导致后面分配的课时少了点（？\n\n问问题钉钉私戳都会细心解答。\n\n上课边抄笔记边听梦回高中，所以感觉学得不错。\n\n作业也少，唯一就是居然只能交纸质作业（明明是个先进的青年？
133439,7986,毛宇尘,2021-02-28 16:04:28,0,0,0,老师非常年轻，讲课非常清楚。\n\n但是感觉严格的给分稍微低于期望，平时学的也算认真，作业分扣一点点，期末考了八十多，最后按照比例算下来刚到3.9。
136565,7986,毛宇尘,2021-06-21 06:17:16,0,0,0,大三上最喜欢的一门课，老师讲的很细致，也让人能学的进去，期末答疑也很耐心人很可爱！平常作业有认真做认真思考，期末结合历年卷复习一下也不会觉得压力很大，整体体验很好！！
146987,7986,毛宇尘,2022-01-08 09:59:06,5,5,0,讲课思路清晰、推导耐心细致。期末答疑十分敬业，甚至秒回。不管怎么样，先给老师10分了！
147231,7986,毛宇尘,2022-01-09 07:55:49,4,4,0,我tm吹爆毛老师！
147261,7986,毛宇尘,2022-01-11 08:41:15,8,8,0,先给个10分老师千万别挂我\n\n出分了，浓浓的师生情
147975,7986,毛宇尘,2022-01-11 08:42:23,1,1,0,年轻负责的好老师
147977,7986,毛宇尘,2022-01-11 08:43:13,1,1,0,好老师，上课很认真，答疑也很负责，就是平时分有点小严格，还是10分好评
148038,7986,毛宇尘,2022-01-11 11:31:17,0,1,1,上课体验极佳 给分也很厚道
148357,7986,毛宇尘,2022-01-12 08:27:28,7,7,0,清流 敬业
148363,7986,毛宇尘,2022-01-12 08:53:07,1,1,0,计算理论没有什么给分的好坏，各个班都一样，期末考70%，考高点
148391,7986,毛宇尘,2022-01-12 10:23:32,1,1,0,上课挺好，大头是考试，还是要刷jxg的卷子
148769,7986,毛宇尘,2022-01-13 12:45:25,5,6,1,全都说难要挂要挂，出分一半人90分以上，这就是cs的卖弱吗😄\n\n老师自然是不错的，平时作业算分得认真找人对答案
148818,7986,毛宇尘,2022-01-13 15:12:29,0,0,0,想选上老师的课！
149608,7986,毛宇尘,2022-01-16 07:50:11,0,2,2,楼下不要凭空污人清白，首先没有很多人都说难（我身边的人都在说体型和往年差不多），其次没有一半90分以上（1/3多一点，和大多数cs专业课差不多吧）。\n\n毛老师人很好，有卡绩的同学可以找老师，老师会看看你的卷子帮你找找还有没有能拿的过程分。但个人觉得作业扣平时分太多了，大部分作业分高的同学都是互相对答案，不利于学生独立思考。甚至还有直接对比多份作业拿满分，题目完全没有思考的同学。
149744,7986,毛宇尘,2022-01-16 15:52:32,8,8,0,[计算理论] 上课形式是板书， 如果一个学期跟着把笔记抄一遍等于抄了一遍书， 印象会非常深刻， 期末都不需要怎么复习. 考前直接刷题过一下套路即可， 每年的卷子都是那几个套路来回排列组合， 直接在历年卷上overfit一遍泛化效果就特别好， 所以说jxg老师说这门课的成绩完全不是正态分布而是0-1分布hhhh. 今年老师平时分给的貌似比去年好了很多， 没有期中考试， 平时作业认真做基本平时分就能拿到一个比较高的分数. 最终成绩比例楼上有说， 可以说是给分相当好了.
151177,7986,毛宇尘,2022-02-24 05:10:13,2,2,0,年轻负责的好老师，给同学答疑真的很有耐心(0 o 0 )
151256,7986,毛宇尘,2022-02-26 09:45:50,3,3,0,老师怎么这么年轻呜呜呜呜\n\n怎么感觉和我们年纪差不多呜呜呜呜
151694,7986,毛宇尘,2022-03-15 11:42:43,4,4,0,一个自带体系的男人
152106,7986,毛宇尘,2022-03-27 03:45:33,1,1,0,讲的非常好，直观性非常强
152837,7986,毛宇尘,2022-04-20 10:06:57,46,50,4,我大毛哥威武\n\n每周两瓶东方树叶闷下去眼睛都不带眨的
153697,7986,毛宇尘,2022-05-08 12:43:02,8,10,2,ADS\n\n讲课超级清楚，人也特别好，问问题秒回\n\n还非常可爱\n\n就是有时候可能在细节上花太多时间讲了，对于懂的同学来说速度有些慢，但是对不懂的同学来说非常非常合适！\n\nlx的东方树叶笑死我了
153710,7986,毛宇尘,2022-06-08 15:29:11,6,8,2,老师讲的很好很细致，课程的内容并不是纯过ppt，很明显有一套他自己的框架，很多内容经过他的加工以后明显变得更容易理解了。感觉老师在他本身水平很高的基础上又能很懂学生，应该是我见过的最好的老师之一
154255,7986,毛宇尘,2022-05-27 07:21:45,24,25,1,这点大家听明白的举手
156599,7986,毛宇尘,2022-06-20 11:22:17,12,13,1,期中期末考试前都会开放三套真题卷我真的会爱😍
157809,7986,毛宇尘,2022-06-25 02:13:16,16,17,1,毛宇尘老师绝对是年轻老师的典范啊，长得帅，讲课仔细认真，科研也强。毛老师对教学的态度，真的得让某个计算机高级工程师好好儿学一下。
157854,7986,毛宇尘,2022-06-25 06:27:41,3,3,0,确实好老师，ads认真听课期末感觉基本都有讲到
158313,7986,毛宇尘,2022-06-28 08:34:41,6,6,0,很认真负责，人很nice，project给分也很好，期末题出得也都是贴近教学大纲的，ads选他！
158336,7986,毛宇尘,2022-06-28 12:05:17,5,5,0,少见的认真讲课并且讲课效果很好的老师
158892,7986,毛宇尘,2022-07-03 04:58:31,9,11,2,ADS：神！！！！！！！！！讲课不用课程组PPT，全部手写数学推导，也会扩展知识点，自带体系，非常清楚。期末直接发3套历年卷，线下和线上问问题都非常及时地回答！主要还是我水平太差，对不起老师……
160017,7986,毛宇尘,2022-09-12 00:54:50,0,0,0,非常年轻的老师，讲课准备认真思路清晰，快选！！！
160430,7986,毛宇尘,2022-09-22 05:40:32,1,1,0,毛哥牛逼
167474,7986,毛宇尘,2023-01-16 14:06:07,0,0,0,yyds
168503,7986,毛宇尘,2023-02-19 03:52:13,2,2,0,考试前给毛哥打个10分，毛哥牛逼！
168862,7986,毛宇尘,2023-02-23 04:36:56,0,0,0,出分等待中......\n\n希望被捞捞
168872,7986,毛宇尘,2023-02-23 06:16:59,13,13,0,计算理论喜提所有课程最低分
168875,7986,毛宇尘,2023-02-23 07:24:26,15,15,0,毛哥讲的很nice，但是计算理论喜提最低绩点
168955,7986,毛宇尘,2023-02-23 16:41:05,4,4,0,今年的题目好难\n\n救了命了
170114,7986,毛宇尘,2023-03-01 11:42:33,2,2,0,毛老师讲课真的好，是我太菜了QAQ
170946,7986,毛宇尘,2023-03-13 06:05:20,1,1,0,上课非常清晰，我这种基础很垃圾的也跟得上\n\n。\n\n而且老师好可爱🤤
172096,7986,毛宇尘,2023-04-19 08:50:28,0,2,2,讲课很好，人很好，不过期中考试有编程题
174284,7986,毛宇尘,2023-06-09 01:13:37,1,2,1,浙大微软俱乐部的题目只有他会写题解，我真的哭死
178381,7986,毛宇尘,2023-07-11 08:10:47,2,5,3,2023ADS 给分好 讲课好
183748,7986,毛宇尘,2023-11-29 13:49:55,2,2,0,今年计算理论，20作业，10小测，70期末。小测2次，有一定难度。感觉jxg小测可能容易些。
186099,7986,毛宇尘,2024-01-08 10:42:05,10,11,1,浙大但凡多点这样的年轻老师，本科的教育也不会这么差
186338,7986,毛宇尘,2024-01-10 14:11:42,9,9,0,high level！
186647,7986,毛宇尘,2024-01-12 10:25:23,17,17,0,非常逆天，只能说计算理论这门课的考试非常逆天。。绩点杀手
186657,7986,毛宇尘,2024-01-12 11:17:48,5,6,1,看到期末成绩的时候我还以为我看的是这个学年修读的总学分呢，闹麻了\n\n老师挺好的，就是期末一点不捞，不知道最后总评能不能再拔一拔了。。。
186881,7986,毛宇尘,2024-01-13 10:52:07,15,15,0,老师人本身很好，讲课很好\n\n---------------------------------------------------\n\n但是\n\n计算理论\n\n能不能让辛苦认真学了一学期的人\n\n安心地考完这门而不用担惊受怕\n\n计算理论 70% 期末\n\n大题先判断后证明，最少的一个小题都要8分\n\n判断错了直接不给分\n\n今年几乎没有送分的大题\n\n还多了不定项选择\n\n我只能说\n\n这狗B课\n\n--------To 2023/2024 秋冬 逆天计算理论期末考
187601,7986,毛宇尘,2024-01-16 17:36:51,4,5,1,quiz和考试出这么难是跟我有仇吗
187708,7986,毛宇尘,2024-01-17 08:01:51,6,6,0,虽然教学是真的很不错，什么不懂的点网课听个几遍也能弄明白。可是计算理论占比70%的期末难得离谱，还连分都不调。大寄特寄。
187899,7986,毛宇尘,2024-01-17 17:28:01,3,3,0,计算理论，讲得是真的好，但也是真的会挂人。30%平时70%期末，一分不调。
188022,7986,毛宇尘,2024-01-18 04:43:43,6,6,0,出分了，尽量客观地给老师评价一下\n\n\n\n老师上课很认真，思路也非常清晰，水平没得说，没讲清楚的地方会跟学生确认；课上不让用电脑，手写笔记跟着听确实容易听懂一些。教学层面上老师没有任何问题；\n\n\n\n说说考试，这次还出得很怪很难，不是像往常的八股，没有送分大题，myc考前还说“题型不会有特别大的变换”，于是安心按八股复习，结果考场上被创飞... 像我本人平常听课作业一次没落下，期末正常节奏补天+刷了四五份历年卷，到最后考试写得我汗流浃背，看一道不会一道。这种情况对我是第一次经历...\n\n\n\n总评部分，给分也真的太求是了，真的是一丁点也不捞啊... 平时分和期末卷面分最后全都会提前登在学在浙大，3：7比例计算出来，该挂的挂，该低分的也不会调。哎，计算理论喜提大学最低分🤡 学弟学妹们慎重选择
188055,7986,毛宇尘,2024-01-18 06:16:19,3,3,0,非常好的老师 讲课很清晰有自己的思路\n\n浙大多些这样的老师上课大家也不至于上课不听×\n\n不过给分确实非常求是 没啥捞不捞的
189546,7986,毛宇尘,2024-01-25 10:27:32,-5,7,12,考试你可以出的难一点，但是能不能正态分布一下呢？为什么图灵考的就简单不少呢？cs开的数学课都去四吧\n\n考前说好不会考的内容，NP和P，还有一般文法，出来大题，这是不是教学事故呢？\n\n23cs期末考让我长见识了说实话，毛哥的计算理论，不知道谁出的体系结构，上大学这么久唯二不是八股文的期末考（wk出的Java能算么
189725,7986,毛宇尘,2024-01-27 15:27:09,1,4,3,计算理论这课也太难拿分啦！\n\n平时分和期末分都不好拿，本人上课学的比较认真，看见期末卷子觉得还挺简单，就一个大题没啥思路，感觉别的答的都还行，结果最后期末86，虽然确实挺高，但是离自己的预期还是有一定距离的。而且毛哥是不调分的，这还是有一点点残酷的。各位如果不太想好好学这门课的，要小心别挂掉，感觉还是比较容易挂的。\n\n最后，毛哥讲课真的是非常的好，环环相扣，层层深入，感觉是我入校以来计院这边遇到的讲课最好的老师，瑞思拜~
189771,7986,毛宇尘,2024-01-28 13:54:15,6,6,0,上课非常认真，是本科期间遇到的为数不多好好上课的老师，虽然小测和考试都超级难考的稀烂，但确实是自己没学好，给毛哥一个十分了
198859,7986,毛宇尘,2024-09-12 07:59:55,-5,3,8,一节课讲两节课内容，下课还拖堂，快逃
205646,7986,毛宇尘,2024-12-10 13:52:48,1,3,2,讲课水平非常非常好，非常敬业，这才是我理想中的大学老师。\n\n不敢想象如果计网这史课如果有毛哥这样的老师会有多么幸福
208206,7986,毛宇尘,2024-12-26 07:29:46,-1,0,1,不错的
208873,7986,毛宇尘,2025-01-10 15:31:43,0,6,6,老师水平很高
209156,7986,毛宇尘,2025-01-05 01:13:12,2,3,1,这门课是绩杀，凭的是理解图灵。
212290,7986,毛宇尘,2025-01-14 00:52:55,1,2,1,老师讲课水平非常高，认真听课➕认真做作业基本上绩点上4不是问题，但是给分很求是，普通计院的班好多平时分给满，但是毛哥平时分也很求是，严格按照平时作业和小测的得分来，考试认真听课基本上上80不是问题
212679,7986,毛宇尘,2025-01-14 12:24:21,1,1,0,总体上来说TCS这门课体验很不错，老师讲得很好，不过这个学期感觉节奏拉得很快，前面有些东西没讲清楚。平时认真一些考试不会有大问题
212833,7986,毛宇尘,2025-01-15 04:23:36,-3,0,3,老师总体上不错，人非常nice\n\n不过讲课水平有点过誉了，个人感觉一般
213993,7986,毛宇尘,2025-01-22 14:11:48,0,0,0,我❤️TCS，但TCS不❤️我。
157289,8007,杨子祺,2022-06-23 01:06:34,1,4,3,老师脾气温和，给分很好，没有点到，会布置作业，要下一次上课交纸质版。期末没有考试，是两人一组大作业，实验课的话春学期不上课，夏学期上课的时候一周是蚂蚁的工程师线上讲课，一周是上机实验做实验。
165516,8007,杨子祺,2023-01-07 17:32:29,0,1,1,好老师！很认真！
167230,8007,杨子祺,2023-01-15 06:52:03,7,10,3,fds 9/10\n\n应该是新老师，在第三轮选课的时候发现fds新开了一个班，本外院人士就试着去选了一下，没想到选中了\n\n老师上课中规中矩，该覆盖到的知识点都有覆盖，但是涉及到一些算法的细节时可能不是很清晰 因为班里大部分都是非计院的同学，感觉lab互评时也相对友好一些
167315,8007,杨子祺,2023-01-15 13:30:51,2,2,0,fds给分和其他班没什么不同，老师挺好的，作业也不是很多，每周就几道判断选择外加最多一道函数题一道编程题。project给一周时间，不过题目都提前给了，可以提前就做起来。总的来说上课体验还不错
176855,8007,杨子祺,2023-06-30 11:45:31,0,0,0,杨sir\n\nai安全什么时候出分呀
176920,8007,杨子祺,2023-07-02 16:33:54,3,3,0,随机会点到一部分名\n\n人很不错\n\nai安全打造的确实很好\n\n结合配套实验\n\n了解了很多有用的知识\n\n但是给分就是正常\n\n每次认真做作业\n\n跑实验 而且会自主探索\n\n感觉比别的选修投入了更多的时间\n\n最后4.5 感觉纯看助教
176921,8007,杨子祺,2023-06-30 16:56:07,1,1,0,ai安全\n\n和22年那个评论一样\n\n课程设置挺合理\n\n任务量不重\n\n可以了解到很多有趣的东西\n\n在大三下的选修课里属于\n\n有趣+比较有用+老师讲课很清楚的\n\n可以选
189680,8007,杨子祺,2024-01-26 15:04:14,-2,0,2,fds\n\n老师中规中矩，但该讲的算法也很清晰了\n\n老师小测会放在课堂最后，不通知\n\n纸质交，很老六，交了就给满基本上\n\n一次会扣3分，我缺两次平时分直接g了QAQ
189709,8007,杨子祺,2024-01-27 07:21:21,0,0,0,老师讲课可以，但是选FDS的同学要注意小测要到，三次小测占了平时分里面的10分，小测可以在课前一天晚上看他的下节课PPT最后一页，但是这个方法不太准，担心意外的话最好每节课都去
193552,8007,杨子祺,2024-06-13 03:43:25,3,4,1,ai安全，给分属实一般，卷了半天好像也没用，顺其自然，想水过很推荐
195829,8007,杨子祺,2024-06-30 06:26:33,0,5,5,AI安全，鉴定为逆天课程。平时 Lab 没有需要自己写的代码，纯卷报告。大作业也只有 10 行之内的代码，用 GPT 都能生成，同样是纯卷报告。最终分数会进行正太，控制 90 分以上的人数比例，但是控制的方法不是给你打 89，而是给你一个令你感到非常惊喜的分数 :)，可能这就是助教非浙本的坏处（？）。总的来说这两点导致该门课程的得分极不可控，不推荐在万姓助教仍然当助教的时候选。
195860,8007,杨子祺,2024-06-30 11:10:51,6,6,0,ai安全，上课不点名，作业就是几个问答题，lab就是跑代码，有时候可以自己根据框架稍微拓展探索一下；最后的大作业是论文阅读&复现（就是补几行代码），整体难度不大，给分个人觉得比期望的稍微低一些
196299,8007,杨子祺,2024-07-03 00:29:59,3,3,0,FDS。\n\n讲课水平还可以的，但是对比隔壁cyll还有一定差距，cyll更清晰（毕竟PPT也是cyll做的）\n\n但是老师亲和力很强、给分也不会压，选到就是赚到。\n\n会在课上不定时纸质小测，题目很简单，主要是起点到的作用，所以推荐上课方式是坐在教室里听cyll的回放（划掉
196309,8007,杨子祺,2024-07-03 00:46:31,3,3,0,fds中最松的几个老师之一，真神！
198747,8007,杨子祺,2024-09-11 08:38:28,1,1,0,fds老师上课基本就是依托PPT来上，因此自学也可以，老师很和善，给分还不错，选杨老师也是很好的
216378,8007,杨子祺,2025-04-07 02:59:42,2,2,0,pr时间要比其他班早一点
217599,8007,杨子祺,2025-04-14 03:50:47,0,2,2,上课到期中突然查重……😇
221012,8007,杨子祺,2025-06-20 22:27:07,4,4,0,人工智能安全，这学期助教是tang姓助教，人好给分也感觉不错，虽然实验布置的晚但是任务量不大，而且跟大作业一个ddl，花一晚上就能搞定全部内容+报告 感觉并不需要像之前评论里说的那么卷
206370,8011,冯尊磊,2024-12-14 15:00:44,1,1,0,认真负责
133588,8020,陈璐,2021-03-02 11:10:10,5,6,1,英文授课，讲的很好，而且给分很高。
145403,8020,陈璐,2021-12-29 10:36:52,5,5,0,研究生课高级数据库上得很好，老师人很温柔
147244,8020,陈璐,2022-01-09 08:22:37,5,5,0,高级数据库 认真负责，非常耐心，讲课也非常细致
151559,8020,陈璐,2022-03-07 15:53:52,2,2,0,老师为什么不用学在浙大呜呜呜\n\n每次都登ftp好麻烦
152577,8020,陈璐,2022-04-15 04:38:01,4,4,0,老师十分温柔！
155054,8020,陈璐,2022-06-08 03:03:01,5,5,0,老师人真的很好，考前会嘱咐很多，上课也比较细致，还是很推荐的。
155057,8020,陈璐,2022-06-08 03:22:38,4,4,0,老师人很好，上课也很细致
155066,8020,陈璐,2022-06-08 03:48:47,1,1,0,人很好，讲课比较一般，但是ppt写的很详细，每节课都会上传，自己看完全没问题\n\n（另外助教姐姐真的很可爱啊）
155917,8020,陈璐,2022-06-16 14:04:16,5,5,0,讲课真的超级清楚
158067,8020,陈璐,2022-06-26 15:12:52,4,4,0,爱老师！！
158099,8020,陈璐,2022-06-27 03:55:53,8,8,0,平时不点名，小测都会提前通知，小测还可以补测。给分超好！！！
158103,8020,陈璐,2022-06-27 04:10:56,16,16,0,老师上课讲的很全面也很清晰，全程跟听的话感觉马上就能理解，其实讲课并不比孙健伶老师差，而且特别温柔，也很体谅同学，给分也超级好！
158131,8020,陈璐,2022-06-27 06:13:27,4,4,0,老师讲课挺清晰的，跟着思路走就能听懂，平时也不点名，给分超级好！！
174967,8020,陈璐,2023-06-20 13:05:36,0,3,3,好坏处都说一说：好处是老师整体算是负责，不点名，讲课思路基本清晰，单独问问题会回复，五次小测提前一周通知，每次小测改完后发下来，骑电动车摔伤了仍然坚持给我们上课；\n\n坏处感觉是讲课速度较快，讲课不如孙老师细致，比如说query processing那一块感觉讲的比较粗糙，如何选择和计算每次读写的buffer大小Bb这个问题就没有讲明白，相应的公式也就有点问题，对比孙老师的PPt和讲课，就可以看出来；讲得快就大概提前20分钟下课；
176056,8020,陈璐,2023-06-27 13:56:06,-2,3,5,我辛辛苦苦复习了小十几天，最后拿一个3.3是真的不甘心，上了大学第一次被背刺的一门课。
176059,8020,陈璐,2023-06-28 03:19:12,3,4,1,刚刚数据库出分了，比想象中的要高一些，老师给分很好！一个学期下来的体验是，内容真的很多很难，但是老师也是真的很负责很耐心，在意外受伤的情况下还是坚持给我们上课，很感动；然后助教姐姐也很温柔！推荐大家选陈老师~\n\n一些经验教训：虽然作业可以考试前几天再一起交，但是建议大家还是要按时完成才好（\n\n关于minisql，三人一组组队完成，找靠谱的同学组队真的很重要qwq，我的几个队友挺厉害的，但是最后大家一起debug也花了将近一周，期末季非常的痛苦，所以一定一定要早一点开始orz（如果遇到了奇怪的错误不妨先考虑一下是不是助教的框架错了(bushi\n\n最后的期末考试在改革之后算是新八股了，多刷一下历年卷还是有帮助的~平时陈老师讲课就很详细很好，另外sjl老师的讲课也很好，我在复习的时候有结合两个老师的回放一起看，效果不错hhh
176069,8020,陈璐,2023-06-28 05:28:12,0,1,1,…哎好难过
176070,8020,陈璐,2023-06-27 14:22:41,0,1,1,…哎好难过
176106,8020,陈璐,2023-06-27 18:26:33,-5,1,6,努力了很多3.3，真的很失望
176807,8020,陈璐,2023-06-30 08:36:41,4,4,0,cljjyyds！数据库只要平时作业、实验什么的都认真地做，大程按时验收，期末考的不是太离谱就没什么问题，给分也真的很好~\n\n还是比较推荐陈老师滴
195875,8020,陈璐,2024-06-30 13:32:23,0,0,0,数据库系统。老师讲课清晰认真，感觉应该是数据库这门课里面讲课比较好的老师之一了。不点名但是小测测 5 次，一般使用往年的期末题，开卷当堂测，但是每次都有补测机会。平时分给的挺好的。
133753,8024,赵永望,2021-03-04 12:20:06,8,12,4,2021年2月，浙江大学网络空间安全学院的论文“CSim2: Compositional Top-down Verification of Concurrent Systems using Rely-Guarantee”发表于《ACM Transactions on Programming Languages and Systems》（TOPLAS）期刊上，浙江大学为通讯作者单位\n\n\n\nhttps://mp.weixin.qq.com/s/AmA94pktiWJcebv06pPljA
136039,8024,赵永望,2021-06-10 05:36:03,5,10,5,老师好帅\n\n还很温柔
138219,8024,赵永望,2021-07-08 03:59:11,6,8,2,老师挺好的，就是我太菜了qwq 1.8飘过
138308,8024,赵永望,2021-07-08 12:38:40,12,12,0,教考分离，老师连考纲都不清楚，上课基本念PPT，声音还催眠。问老师问题回答都是错的，无语了。建议隔壁翁老师。
138428,8024,赵永望,2021-07-09 06:18:58,26,28,2,人好真的不能掩盖上课糟糕和考评不完备的问题\n\n别杠 杠就是你对
150867,8024,赵永望,2022-02-20 08:56:51,-4,7,11,2020-2021春夏，上的是赵老师开设的离散数学及其应用。老师人很好，有问题也会耐心地解答，钉钉也会回（lz曾对期中考试一题给分有疑惑，钉钉上请老师再审一遍，老师也很耐心地指出证明错误）。至于讲课水平，确实有待提高，声音比较小有点催眠，也是对着ppt讲。楼上说老师不熟悉教学大纲，我倒觉得可以理解。可以去看看老师的个人主页，老师是21年9月从北航来的浙大，不熟悉教学方法和教学大纲情有可原。\n\n本身离散就很难，需要自己下很大功夫，期末更是。希望能客观评价一位老师，给打9分！\n\np.s.：老师的科研水平很强，可以去看看个人主页
151997,8024,赵永望,2022-03-23 00:28:42,3,4,1,讲得很烂
156310,8024,赵永望,2022-06-26 06:02:00,3,7,4,老师中规中矩，助教xh有大病，从没见过这种态度的助教，也从来不发任何的讲解，大开眼界\n\n出分后回来评 因为为这次考试简单，所以大家的绩点都还不错，但不知道为什么群里没有谢谢老师。老师还是挺好的一个人，助教最后也允许了补交作业。
156452,8024,赵永望,2022-06-19 21:16:32,3,3,0,离散应用，课程安排原因，内容巨多加英文考试，期末考试又难如上青天，需要硬卷平时分，不然挂科在所难免，老师讲的一般，助教有点不舒服
158052,8024,赵永望,2022-06-26 12:56:41,-4,0,4,比较一板一眼的老师，可以是褒义，也可以是贬义
158097,8024,赵永望,2022-06-27 03:48:07,12,12,0,老师表面看上去挺和善的，讲课基本只会念ppt，作业有的时候是真的多，最糟糕的就是完全不调分，期末连平时成绩都不公布，怎么死的都不知道
171654,8024,赵永望,2023-04-05 04:36:50,8,11,3,小测难度巨大，习题也不讲解，上课声音小到听不见，体验很差，建议快跑
176442,8024,赵永望,2023-06-29 02:19:58,3,4,1,大绩杀，死板
193098,8024,赵永望,2024-06-03 11:46:56,5,5,0,讲课讲的太烂了……
193266,8024,赵永望,2024-06-05 12:18:02,6,6,0,退退退 真不行啊
194243,8024,赵永望,2024-06-23 01:14:16,4,4,0,不是你在教毛线我感觉自己上课什么也学不会\n\n习题课能不能讲一讲
215201,8024,赵永望,2025-02-24 06:36:51,4,4,0,古希腊掌管念ppt的神\n\n古希腊掌管点名的神\n\n古希腊掌管调课的神\n\n古希腊掌管作业的神
218768,8024,赵永望,2025-05-03 16:22:59,0,0,0,作业真的好多啊...
133229,8032,周磊晶,2021-02-19 10:09:38,3,7,4,爱找代课；\n\n喜欢白嫖；\n\n天天DDL；\n\n开会迟到。
159783,8032,周磊晶,2022-08-29 16:32:44,1,1,0,白嫖怪，嫖得神乎其技超凡脱俗
159782,8052,赵艺钧,2022-08-29 16:29:28,0,1,1,emmmm，怎么说呢。不咋样
171694,8063,赵俊博,2023-04-02 07:37:56,1,16,15,别进他组
173726,8063,赵俊博,2023-06-02 04:31:57,8,14,6,楼上细说
179131,8063,赵俊博,2023-08-28 08:28:57,1,6,5,楼上细说
180063,8063,赵俊博,2023-09-20 08:19:04,8,10,2,老师课上的很清楚，助教xgg很帅，而且还是单身哦
197126,8063,赵俊博,2024-07-27 10:28:57,8,11,3,关于实验室情况，不太了解不好评价。就ml的课来说，比隔壁zz用心多了，还是能学到些东西的。给分好评，复习都接近弃疗了，真没想到最后绩点这么高！
197615,8063,赵俊博,2024-07-22 06:21:26,4,4,0,海底捞😭！
197680,8063,赵俊博,2024-07-28 16:31:15,1,10,9,袁神的事情怎么说，昧着良心接受采访吗
197684,8063,赵俊博,2024-07-29 10:28:10,-10,12,22,强烈建议取消这位老师的职称。\n\n看完计院之子被爆破唯一的收获就是看清了浙江大学竺可桢学院金玉其外败絮其中的真相，一众所谓杰出人才皆欺世盗名之徒，这位老师更如跳梁小丑一般哗众取宠，真乃百年求是之大耻！
197685,8063,赵俊博,2024-07-29 13:31:39,10,13,3,connection拉满的老师，愿意给学生顶级资源，虽然袁神这人不好评，老师视角没啥问题
198665,8063,赵俊博,2024-09-10 13:42:02,1,5,4,计院之子
198946,8063,赵俊博,2024-09-13 09:51:26,6,7,1,外专业修的23-24年ml课，过了半年多才来评论\n\n不点名，讲的很好，大作业说着唬人实际上pre的时候并不严格，给了很好的建议，老师还找了组里同学一起来听pre，感觉对课挺用心的；最后考试非常友好。\n\n不清楚组里情况但这课不错
212685,8063,赵俊博,2025-01-14 12:58:28,3,3,0,不清楚组内情况，就机器学习课程而言，赵老师讲课还是很清楚的，并且以小测的形式点名，每次都会提前通知，最后给分也很好
212879,8063,赵俊博,2025-01-15 06:49:33,1,2,1,坐标机器学习，外专业修的，老师人很好，讲的很好，任务量不大，给分很好，期末考试难度也不大，但是我当时时间没安排好最后空了一整道题以为炸了没想到最后还是给到90+，很好的课，谢谢老师和助教哥哥！
213033,8063,赵俊博,2025-01-15 17:53:33,2,3,1,这不是课程评价吗，怎么全在喷场外事件。课的话只能说蛮好的，虽然有考试，但不难，给分高的离谱，老师讲的也很清晰。楼上都是课都没上过就跑这骂的，要骂去98。。。
155899,8171,尹可挺,2022-06-16 13:20:51,1,2,1,不太行
204304,8171,尹可挺,2024-11-25 07:17:24,0,0,0,说说课程实验最后闭卷考试，上课点名且喜欢抽人回答问题
142053,8236,张志猛,2021-11-05 00:52:39,6,7,1,事情贼多
215006,8236,张志猛,2025-02-20 03:56:46,1,1,0,沙币一个，混子东西讲个水课感觉自己可渊博了。节节点名，压堂不下课，sb东西
216322,8236,张志猛,2025-03-13 09:16:35,0,0,0,签到，事情多
217161,8236,张志猛,2025-04-03 00:55:52,0,0,0,傻逼东西成天翻转课堂，怎么不把你妈逼也翻转一下。ppt用了5，6年都不带改的，成天点名，祝这撒比早点去阎王爷那点名
218485,8236,张志猛,2025-04-24 03:57:35,0,0,0,工程伦理，水课一门，次次签到，事情很多，给分又低
139277,8286,Yale Patt,2021-07-14 04:22:13,27,29,2,patt教授讲的很不错，就是进度有点快，好像不喜欢特朗普
139392,8286,Yale Patt,2021-07-15 04:19:44,6,7,1,进度很快，花时间看书很重要
139509,8286,Yale Patt,2021-07-16 16:49:35,14,15,1,害搁这查老师呢，滑雪做完了吗( ´▽｀)
139532,8286,Yale Patt,2021-07-17 04:42:06,18,18,0,“Trump actually destroyed the country”
139608,8286,Yale Patt,2021-07-18 10:37:30,4,4,0,妙啊🌸🤩🤩
139610,8286,Yale Patt,2021-07-18 10:37:56,5,5,0,上课被Patt翻牌子 被他写我的名字了哈哈哈\n\n讲课真的很好 幽默风趣 和蔼可亲\n\nOK！
139639,8286,Yale Patt,2021-07-18 17:27:44,5,7,2,老师很棒，就是今年某位助教有点太跳了，自己写的东西给大家造成了不少麻烦，希望有点自知之明。
139730,8286,Yale Patt,2021-07-22 01:42:01,13,13,0,professor patt has a bad memory so you need to finish labs to help him
139776,8286,Yale Patt,2021-07-26 08:37:20,0,1,1,很好xixi
154976,8286,Yale Patt,2022-06-07 07:35:43,8,8,0,根据本人经验，计概只要能认真把课本前十章一字不落看完，就能满绩，上课不怎么听都行，考试非常基于教材。而且这门课学会后计组就会了一大半，还不快冲！
159346,8286,Yale Patt,2022-07-14 06:27:47,8,8,0,Shame on me for screwing up， and shame on you for not listening carefully.
159396,8286,Yale Patt,2022-07-16 01:55:39,16,16,0,心疼Patt...\n\n在Zoom里乱改名字发癫的梗小鬼差不多得了..\n\n大学生可以这么幼稚的么
159481,8286,Yale Patt,2022-07-25 02:16:29,1,1,0,书写的非常好\n\n可能因为考虑到大部分同学的英语水平，讲课有点慢，但是无伤大雅\n\n没了jxh计概会更好
160327,8286,Yale Patt,2022-09-19 05:36:38,1,1,0,plus plus good
178578,8286,Yale Patt,2023-07-15 07:35:31,3,3,0,传奇！
179244,8286,Yale Patt,2023-09-02 15:55:39,2,2,0,传奇还在继续，Patt 为什么是神！
184908,8286,Yale Patt,2023-12-24 09:48:19,1,1,0,好老师，水平很高，可惜好像以后都不来了
131829,8288,陈锰,2021-01-29 04:24:17,1,2,1,共同基金概论大水课，平时不用听最后一个随堂考一个论文。随堂考的话题目全是英文的而且难度挺大的，但是给分超级好
145797,8288,陈锰,2022-01-02 11:43:04,2,2,0,《后续我会写一份详细的考试情况报告，和学院一起处理这个事情，请同学们放心，考试公平是一定会保证的》然后老师没了2333
145799,8288,陈锰,2022-01-02 11:42:36,2,2,0,老师:(请同学们放心，我会配合学校处理这件事情的，考试公平是会一定保证的\n\n辅导员(^_^):(老师没了，学生放心飞
128358,8383,Klaus-Dieter Schewe,2020-12-21 08:14:04,-15,4,19,goodgooodgodd
129700,8383,Klaus-Dieter Schewe,2021-01-11 04:53:59,3,11,8,送分老人
129737,8383,Klaus-Dieter Schewe,2021-01-12 01:03:16,-6,4,10,牛plus
131391,8383,Klaus-Dieter Schewe,2021-01-27 10:13:28,-11,4,15,以一己之力，直接十分
132425,8383,Klaus-Dieter Schewe,2021-02-01 12:31:20,-13,3,16,good
141207,8383,Klaus-Dieter Schewe,2021-10-01 00:44:56,19,21,2,老师人不错，但是这374的课件是给人看的？？？
145768,8383,Klaus-Dieter Schewe,2022-01-01 18:42:05,29,31,2,哪招来这么多的抽象人？这课是讲给人听的？PPT是做给人看的？
149752,8383,Klaus-Dieter Schewe,2022-01-16 16:32:43,22,24,2,以一己之力揭露了ZJUI学院没有老师了的事实
150244,8383,Klaus-Dieter Schewe,2022-01-21 01:11:05,0,3,3,上啥课呢，考啥试呢？直接A+得了
150295,8383,Klaus-Dieter Schewe,2022-01-21 17:20:04,1,2,1,讲课内容差，不太行
150305,8383,Klaus-Dieter Schewe,2022-01-22 04:26:22,9,12,3,You may learn nothing from his lectures. If possible， don’t choose his courses!
151919,8383,Klaus-Dieter Schewe,2022-03-20 16:13:23,3,4,1,其实还好吧，老师人不错，给分也很好。听说UIUC的374更抽象更离谱，分给的还很低
152136,8383,Klaus-Dieter Schewe,2022-03-28 12:19:37,0,1,1,给分不错，但讲的东西和做的作业都是屎\n\n完全不会说英语，出的东西错漏百出\n\n太蠢了
152137,8383,Klaus-Dieter Schewe,2022-03-28 12:20:32,4,6,2,225男默女泪
152138,8383,Klaus-Dieter Schewe,2022-03-28 12:45:38,9,10,1,太抽象了\n\n德国国家队头牌
152143,8383,Klaus-Dieter Schewe,2022-03-28 16:43:14,1,3,2,不会英语一堆错词是小事，不会说人话怎么治？-225深夜有感
152147,8383,Klaus-Dieter Schewe,2022-03-29 00:36:28,3,4,1,uiuc两门好课直接毁于一旦
152462,8383,Klaus-Dieter Schewe,2022-04-12 08:00:05,0,1,1,呵呵。
152786,8383,Klaus-Dieter Schewe,2022-04-20 01:39:04,0,1,1,225学不下去了
153763,8383,Klaus-Dieter Schewe,2022-05-10 09:53:02,3,4,1,现阶段在zjui遇到的最辣鸡的老师，主要表现在上课不说人话和作业不写人话两个点上
153917,8383,Klaus-Dieter Schewe,2022-05-16 23:51:33,1,1,0,好像不如陈昊
154277,8383,Klaus-Dieter Schewe,2022-05-28 03:56:26,2,2,0,期末考出前一年的原题最后被学院取消期末考试成绩😅偷懒摆烂还是你第一，讲课不讲人话作业不写人话，你别教书了行吧
154340,8383,Klaus-Dieter Schewe,2022-05-30 12:15:28,2,2,0,不如丁真
186413,8383,Klaus-Dieter Schewe,2024-01-11 03:54:50,0,0,0,送分老仙
159456,8445,吴明晖,2022-07-21 08:36:57,2,2,0,好好的老师啊
178989,8660,朱凡微,2023-08-15 02:27:17,1,1,0,很好的研究生导师，没有项目，专注于科研
132200,8791,Whitfield Diffie,2021-01-31 02:32:33,1,2,1,真的不戳
133501,8791,Whitfield Diffie,2021-03-01 10:21:39,1,2,1,这给分\n\n尼玛爷专业课没这么低过
133920,8791,Whitfield Diffie,2021-03-09 12:13:29,3,4,1,这改分是在羞辱谁呢
135020,8917,杨枨,2021-04-27 07:24:25,3,3,0,中二患者
171865,8917,杨枨,2023-04-09 07:53:13,2,2,0,官瘾很大，你没写好就骂人，还扣分，小组作业还有个人作业，要求死多死多
133300,8977,赵晓亮,2021-02-24 04:51:51,32,40,8,非常优秀的老师，拥有诸多头衔：\n\n\n\n1.亮子波动速读创始人\n\n“我每天坚持阅读10本书，一个月读完了300本书”\n\n“设计心理学我读了4遍，但还是分不清这套书是4本，还是5本”\n\n\n\n2.星巴克咖啡品鉴宗师\n\n“星巴克咖啡，我唯独钟爱摩卡可可碎片星冰乐”\n\n\n\n3.潮汕火锅推广大使\n\n“我相信还有很多同学没有吃过潮汕牛肉火锅，一定要去吃一次”\n\n\n\n4.设计竞赛高级决策师\n\n“红点和iF我早已摸清楚了套路，同学不用担心，这学期，咱们先精心准备一个和丰杯”\n\n\n\n5.大师作品信仰者\n\n课堂内容高强度、高频率致敬梁宁《产品思维30讲》\n\n\n\n6.学生负担添柴人\n\n保质保量，要求每周迭代；\n\n尽心尽责，作业基本不看。
143832,8977,赵晓亮,2021-12-08 03:42:23,14,21,7,非常厉害的老师，是浙大车神\n\n“开车的时候有一种驾驶的喜悦，浑身充满了力量”
190350,9041,王志波,2024-02-28 10:27:27,9,10,1,AI 安全\n\n10 点名\n\n20 assignment\n\n30 lab\n\n40 大作业
195757,9041,王志波,2024-07-03 08:24:08,7,9,2,王sir AI安全给分真好啊
221317,9041,王志波,2025-06-23 02:20:57,3,3,0,人工智能安全。上课需要去，有签到，实验课基本不需要。上课基本没人听，老师有一次因为这个当堂破防。实验基本只是跑通代码，难度不大。想要取得理想分数需要卷报告，自己写的分数不如LLM生成的高。
222012,9041,王志波,2025-06-29 00:59:27,0,0,0,AI安全，可以说是相当轻松了，甚至整个春学期几乎没有作业，给分我觉得还不错
222037,9041,王志波,2025-06-29 06:03:36,1,1,0,王老师是一个有志向，有理想的老师，在课上他希望把自己的知识真正传给下面的同学，但是限于现实原因，下面的同学往往也在干自己的事情hhh\n\n这门课的压力不是很大，有点名，第一节课下课现场喊名字，应该是接受晚点补签的，会有四个作业，三个实验，两个报告，一个大程序——都不难，想用AI都能完美解决，不想用AI的话自己做也未尝不可\n\n实验是挖空让你填，其实还是相对简单的。。\n\n给分也挺好，实验不用去实验室，对设备要求也不高，老师很和蔼，总的来说是一门不可多得的好课，可冲\n\n——zszm
150696,9057,章敏,2022-02-14 02:24:31,19,22,3,章敏女神没有开课但是人真的好好!
155541,9057,章敏,2022-06-14 07:22:26,10,24,14,老师人还不错 但是学术水平不怎么好
188589,9057,章敏,2024-01-19 10:22:25,5,5,0,人工智能引论（基础）。老师人很好，尽管每次去的人只有个位数，还是把出勤分给大家算满了。对这个课不多做评价，这个课比较烂。最后期末感觉也很捞。
192967,9057,章敏,2024-06-01 09:09:11,1,1,0,上过AI导，老师人很好很nice，但是课比较干燥（也可能是课程内容原因）
199742,9057,章敏,2024-09-28 15:12:06,2,2,0,人还可以
157269,9060,王冠云,2022-06-22 17:10:16,7,21,14,温柔男神 审美极佳 有趣！
176646,9060,王冠云,2023-06-29 14:22:08,3,12,9,yyds！
192055,9060,王冠云,2024-05-08 09:26:21,-1,7,8,官僚，自大，漫不经心
192462,9060,王冠云,2024-05-21 03:27:33,-2,6,8,兵家之大忌，我看你是个大G
192463,9060,王冠云,2024-05-21 03:28:07,2,11,9,天哪男神你是真的喜欢当爹~~~
192464,9060,王冠云,2024-05-21 04:19:04,0,8,8,面向王冠云的设计，快到学期末了搁着质疑方案，我寻思之前都汇报这么多次了你不提，都要结束了你全盘否定，真笑了
193996,9060,王冠云,2024-06-21 08:48:40,-2,7,9,你说的有道理，但不是只有你说的有道理
215230,9060,王冠云,2025-02-24 17:19:48,2,4,2,很有设计才华的一位老师 讲课好 对学生有耐心 喜欢！
218935,9060,王冠云,2025-05-13 16:11:06,1,2,1,案例都挺有意思的，挺受启发的
152594,9068,崔兆鹏,2022-04-15 11:37:43,4,4,0,讲课很用心，作业比较锻炼能力，给分很好
154513,9068,崔兆鹏,2022-06-02 03:10:19,9,11,2,sfbd
159789,9068,崔兆鹏,2022-08-30 16:25:31,1,2,1,老师人特别好，很Nice，我很喜欢
160000,9068,崔兆鹏,2022-09-11 10:20:08,1,1,0,崔老师是个很好的老师，一定要选他的课
160443,9068,崔兆鹏,2022-09-22 14:49:37,2,2,0,老师人真的很好，毕设跟着老师做的，感觉非常的supporting
160773,9068,崔兆鹏,2022-10-11 02:20:08,0,0,0,???Null
161144,9068,崔兆鹏,2022-10-29 05:43:42,-5,7,12,讲的是什么啊？别选。
165355,9068,崔兆鹏,2023-01-19 04:21:06,2,2,0,挺好的老师
167759,9068,崔兆鹏,2023-01-19 03:03:18,10,10,0,老师是新老师讲课会有点不熟练，但作业质量好给分好，助教老师们都很负责，好评！
167760,9068,崔兆鹏,2023-01-19 03:06:56,0,2,2,很好的老师
167839,9068,崔兆鹏,2023-01-19 11:44:52,4,4,0,讲课很烂，但给分超级好！
170265,9068,崔兆鹏,2023-03-02 10:17:22,2,2,0,老师很负责任
171433,9068,崔兆鹏,2023-03-24 03:55:46,8,8,0,下课找老师问问题，老师非常乐意解答，给分也非常好，oop相较于同时期隔壁班的ljj感觉好的不要太多
173722,9068,崔兆鹏,2023-06-02 03:42:32,3,3,0,秋冬oop的神
173788,9068,崔兆鹏,2023-06-03 02:13:56,0,1,1,好老师给分好bd
181735,9068,崔兆鹏,2023-10-30 10:06:33,17,17,0,不愧是讲面向对象的老师，上课讲的东西都是封装好的
189288,9068,崔兆鹏,2024-01-23 01:33:29,3,3,0,oop，事少分高，上课细致，答疑认真。就是ppt不是很利于复习，平时不发理论题期末才发可能需要自学一些理论细节应付考试，总体很好。
190187,9068,崔兆鹏,2024-02-25 03:27:58,2,2,0,oop给分超好！崔老师真的很好很好，助教老师也很捞
200149,9068,崔兆鹏,2024-10-14 04:15:05,0,0,0,讲的不行 但是事也确实少\n\n建议直接b站朋辈辅学（
205846,9068,崔兆鹏,2024-12-12 08:56:27,0,0,0,讲的怎么说  感觉怪乱的  不过事少人好
213895,9068,崔兆鹏,2025-01-21 05:04:24,1,1,0,滴，好人卡
213897,9068,崔兆鹏,2025-01-21 05:07:22,1,1,0,大学第一个满绩，老师简直就是我的神
213898,9068,崔兆鹏,2025-01-21 05:14:47,0,0,0,老师人好好^ - ^
213901,9068,崔兆鹏,2025-01-21 05:59:30,0,0,0,真好真好真好啊czp😭😭\n\n课程作业因为编译问题两次60期末考前速成但是还是拿到了很满意的分数 对于c++小白来说是特别特别满意的🥺🥺
213909,9068,崔兆鹏,2025-01-21 08:06:42,0,0,0,虽然上课好像没学到什么东西，但是给分也太好了…妈呀 做梦都不敢想的分数
168328,9089,许海涛,2023-02-11 16:02:23,2,3,1,有没有相关评价啊sos
172850,9089,许海涛,2023-05-08 11:01:57,2,2,0,每节课必点名\n\n上机课不用去\n\n助教老师感觉都很和蔼\n\n老师的英语也算是计院里比较流畅的\n\n整体感觉不错\n\n另外作业感觉很有趣
172944,9089,许海涛,2023-07-01 03:00:50,1,2,1,感觉作业很有意思\n\n上课也不难\n\n英语还挺清楚\n\n等出分后补评
174718,9089,许海涛,2023-06-16 07:18:01,0,0,0,老师人很好，👏欢迎大家来选
174738,9089,许海涛,2023-06-16 12:26:31,1,1,0,每节课必点名，老师人特别特别好，对学生态度温和有耐心，讲的东西也比较有意思
176919,9089,许海涛,2023-07-24 16:30:00,0,0,0,点名 不能咕咕课\n\n相对于来说讲的有意思 不难\n\n而且给分宽\n\n值得选\n\n（另:没有正态，老师帮所有人把分加回来了）
176922,9089,许海涛,2023-06-30 16:57:20,2,2,0,国际化课程\n\n不算难 但是需要会python\n\n作业和爬虫有关\n\n所以有代码基础就可以选\n\n另外老师人很随和温柔\n\n经常在群里给我们发一些有趣的推荐
176994,9089,许海涛,2023-07-01 03:43:55,0,0,0,为许老师举大旗！许老师人真的很负责认真~
177274,9089,许海涛,2023-07-02 13:52:02,-4,5,9,社交网络刚刚出分来评。\n\n我是信安专业的，不是建议外专业的同学来选，这课今年课改了，没有之前说的那么水了。没有考试，但有大作业和实验，实验指南一言难尽，基本全靠自己去查资料来写。点名也非常频繁。是专业课还要按照通识课的正态来调分（目前来看是这样，如果有变化我之后来编辑）。总之，大家慎重考虑，前几年的经验不再有效。
178944,9089,许海涛,2023-08-03 03:39:27,3,3,0,许老师人真的特别细心有耐心，助教也很nice，基本上帮我从0基础到完成了整个作业，给他俩点个👍
186560,9089,许海涛,2024-01-11 18:26:23,5,5,0,考前打分~\n\n老师今年第一次教计算机网络，讲课不太熟练但是很用心，还买了课本让大家传阅。\n\n助教姐姐也很细致很温柔，是我看过的给学生的作业的评语最多的助教！
186605,9089,许海涛,2024-01-12 05:00:40,5,8,3,xht yyds，计网考试考了好多复习PPT上的知识点，平时实验也不多，助教姐姐人也很好，会对作业认真地回复。强烈推荐！
186642,9089,许海涛,2024-01-12 09:31:36,6,11,5,自费买教材给学生参考！\n\n除了小测以外平时分给满！\n\n每次作业和实验助教姐姐评语都会写得很用心！\n\n实验只有4次，比其他班任务量小！\n\n复习切中要点！\n\n最后给分无敌好，感谢许老师！！！！
186646,9089,许海涛,2024-01-12 10:19:03,5,7,2,许神伟大，无需多言。\n\nlhy 助教姐姐是神。
186712,9089,许海涛,2024-01-12 15:15:21,5,7,2,涛神伟大，无需多言。\n\n林神伟大，无需多言。
186786,9089,许海涛,2024-01-13 05:08:13,5,6,1,许老师是一个有伟大人格的老师，助教是一个有伟大人格的助教
187014,9089,许海涛,2024-01-14 07:02:10,5,5,0,是真神！
189134,9089,许海涛,2024-01-22 05:39:44,3,3,0,xht yyds！
192578,9089,许海涛,2024-05-24 08:22:00,1,1,0,计网唯一真神！给分断档高，复习切中重点！
192797,9089,许海涛,2024-05-30 12:53:30,1,1,0,计网唯一真神，无脑冲
192913,9089,许海涛,2024-05-31 13:45:53,6,6,0,选择了涛神就几乎是选择了计网平时分满分
193352,9089,许海涛,2024-06-07 01:46:53,0,0,0,不是计院的慎选他的国际化，作业量很大
195808,9089,许海涛,2024-06-30 03:59:02,4,4,0,社交网络安全与隐私满了，简单介绍下：整个课程只有两个project，分别占40%和60%，基本上每节课会有数字点名，分数应该是算在第二个project里。\n\nProject1是单人项目，要求是从一个网站上爬取大量数据并进行分析，如果是计院的或者自己做过程序网页等等，并且会用python、mysql，懂得http请求等，可以放心选这门课，花个两三天就能做好了，但如果你是外专业非转码的，千万不要选这门课，不然project1的难度可以参考c大程，虽然听起来简单，但对小白来说使用python处理数据、数据库、网络请求的各种细节还是很麻烦的\n\nproject2是小组项目，老师会给出十几个项目，大家拼手速去选，有很水的项目也有很难的项目，我们组做的就很容易了，像通识课一样搜集下资料做ppt写报告，没什么技术含量
207042,9089,许海涛,2024-12-19 05:18:37,4,4,0,计网 点名\n\n神中神
208170,9089,许海涛,2024-12-28 06:57:58,9,11,2,计网无脑选徐海涛老师，选上了你就是其他班羡慕的对象\n\n\n\n犹豫哪怕1ms都是对徐老师的罪过
208236,9089,许海涛,2024-12-26 09:23:39,9,12,3,助教真的好，别的班的羡慕死了，狗屎教学组唯一的清流\n\n\n\n一个寝室（一个班的）的其他三个预置都是 xht，就我一个他妈的囚禁松，这逆天的对比给我恶心的痛不欲生
212278,9089,许海涛,2025-01-13 23:48:30,10,11,1,计网唯一真神！今年复习课在曹西上，来的时候正好遇到老师，一边走路一边捧着电脑改PPT，老师对待教学如此认真的态度真的让人感动，更别提助教也很负责，给分更是无敌，涛神就是计网唯一的光
212401,9089,许海涛,2025-01-14 03:11:13,9,11,2,许海涛老师，多的不谈，就一句话：整个计网教学组唯一真神。\n\n\n\n1.ppt自己制作全中文上课，期末考试虽然是英文，但是考前会给中英对照表供大家参考——其他老师是全英文\n\n2.实验会根据当年的情况进行调整，一般来说就是1个wireshark，3-4个GNS3，1个socket，本身就可以抄，理解了就行，也不查重，助教嫌多还删了不少——点名对比牢邱\n\n3.老师是超人！认真负责，考前专门找了一个晚上在曹西开复习课，老师一直在手改ppt，还找了湖科大的相关讲解ppt，估计王道也看过不少遍\n\n4.助教ggjj更是超人！钉钉问问题秒回，作业全部给满（小测和点名这个确实看你自己了），期末考试出现教学事故更是改卷现场据理力争——点名没有助教的土人\n\n5.给分是超人中的超人！期末占比50%，助教ggjj据理力争拉到40%，多出来的10分无条件拉上去，是的，无条件给！\n\n\n\n其他像什么作业少，每个人都会认真看，写评语这些就不谈了，整个学期学下来没感觉到有任何不足的地方，从课上到课下，你能看到的，你看不到的，老师和助教全都拉的满中爆满，原来伟大真的无需多言！\n\n——zszm
212466,9089,许海涛,2025-01-14 05:01:23,2,2,0,老师人很好，两位助教也非常好，实验的负担相对其他班算比较小的。虽然老师上课水平不是很高，但是很认真。唯一要注意的是老师喜欢点名，这个学期点了 5 次名，每次都是数字点名但是时限只有 1 分钟到 3 分钟，基本上就是你只有到线下或者在听智云才能签上，一次点名算总分 1 分，如果翘课了没点上还是很亏的。
213009,9089,许海涛,2025-01-15 14:43:56,6,6,0,许老师非常好\n\nxwh和lhy助教也非常好\n\n计网教学组的清流！
213130,9089,许海涛,2025-01-16 05:20:18,1,1,0,老师和助教人都超级棒！！！ 平时分能给满的都给满了，会有两次小测但是都比较松（第二次还是做了就给满）
219881,9089,许海涛,2025-06-09 15:51:43,-4,0,4,许海涛不接受补选，补选的同学全都流放到别的老师班里，补选一定绕路
221330,9089,许海涛,2025-06-23 03:38:03,1,1,0,社交网络给分很好，不过有点名
221487,9089,许海涛,2025-06-24 04:42:23,0,0,0,社交网络学在浙大上成绩是对应某档最高分，许老师甚至多调了一分 感恩
154018,9135,邹强,2022-05-19 07:04:54,10,14,4,1. 上课不能看手机或电脑，只能干坐着度过这两节课\n\n2. 随时准备好老师的提问\n\n3. 设计模式的Pre是互评（不过同学们都互相给满了）\n\n来上课的同学的位置分布在以老师为圆心，4个座位的距离为半径的圆的外侧，可以看出同学们对该课程和该老师的喜爱程度 :-)
154224,9135,邹强,2022-05-26 10:24:12,3,4,1,外班沙发，看看今天发生了啥
154238,9135,邹强,2022-05-26 18:40:11,3,6,3,说话阴阳
155071,9135,邹强,2022-06-08 05:16:16,5,8,3,老师不熟悉软件工程作业要求和给分细则，曾经和同学确认不用pre，最后一节课头一天说要课上展示系统，令人汗颜
155201,9135,邹强,2022-06-09 09:08:55,10,11,1,纯纯 NT
155208,9135,邹强,2022-06-09 10:02:23,6,9,3,全新的软工老师，带来全新的折磨
156643,9135,邹强,2022-06-20 13:19:55,-4,2,6,老师讲课还是很清晰负责的，有用心备课
156980,9135,邹强,2022-06-21 13:06:34,1,2,1,傻逼软工
156981,9135,邹强,2022-06-21 13:06:55,2,6,4,乌鸡鲅鱼，不干好事儿
157934,9135,邹强,2022-06-25 16:11:15,1,4,3,老师人还是不错的 上课也有认真上 但是感觉对整个课程的安排不是很熟悉 自己脾气也有点奇怪
158793,9135,邹强,2022-07-02 08:41:20,2,7,5,zq！我的超人！
158794,9135,邹强,2022-07-02 09:06:45,15,27,12,老师人还是很不错的，对课堂纪律要求有点高（不准用电脑，有些太过离谱的（比如斗地主不小心外放，要求电脑收进去还放在桌上，点名被抢点名记录的本子）的直接开怼了(不过感觉更像是同学逆天hhhh)），比较严格，给分规则有点不太合群（可能是海归老师受国外教育熏陶的原因），不过和大伙争论后还是得到了大家都认可的给分方案。其实事情相比其他老师的课来说相对算少了，给分也相对较好（对比隔壁lys）班。上课的时候看的出来也是精心备课了的，有些重点也会反复强调，也知道软工这课大伙都不爱听也无可奈何，还请了阿里的大佬来讲座。而且口头禅有点抽象（毕竟非常年轻也挺冲），科研能力感觉是拉满的（从个人主页上看的）。出分前看隔壁lys班感觉要凉，出分后好到想哭。
158796,9135,邹强,2022-07-02 09:51:37,2,4,2,给分有点好
158798,9135,邹强,2022-07-02 10:08:59,4,9,5,老师个人上课态度比较认真，相对来说会有点严格（有点像初高中课堂的感觉？\n\n不过讲课、给分什么的都很不错，最后一次课还安排了课外讲座，感觉比课件那堆假大空的东西有意义得多。\n\nps: 其他软工老师建议都向zq学学。
158799,9135,邹强,2022-07-02 10:10:54,1,3,2,挺好的。。。
158850,9135,邹强,2022-07-02 17:24:48,2,7,5,给分好（至少比lys班好一大截），但是上课不能用电脑，点名一次不到总评扣5分
158981,9135,邹强,2022-07-04 07:40:08,1,4,3,和lys比就是天使
159071,9135,邹强,2022-07-05 13:58:12,0,5,5,给分一般
159091,9135,邹强,2022-07-06 04:51:14,1,3,2,平心而论，大程比别的班工作量小一些
170785,9135,邹强,2023-03-09 16:03:51,1,5,4,上课氛围挺好的！
178089,9135,邹强,2023-07-06 23:56:12,0,4,4,只有一个字：好
178112,9135,邹强,2023-07-07 03:23:08,0,2,2,给分不好。。。。
178134,9135,邹强,2023-07-07 05:41:26,3,11,8,新的老师，感觉给分不错，上课氛围也很好，至少不用翻转课堂\n\n下面给学弟学妹们一点复习的建议，毕竟大三下大家基本都忙得一批，留给复习的时间也不可能很充足，所以最重要的是复习要尽量瞄准考点\n\n1. 考试前把所有老师智云的最后一节课都过一遍，考试题就基本知道七七八八了，今年王章野的最后一节课，直接给了套题，基本也就对应考试的题型，他也给了答案（这可能是大题为数不多的答案来源）\n\n2. 尹建伟最后的复习课有些强调的地方，比如说“要知道stakeholder是什么”，比如说“要会算缺陷放大模型”等等，最后就对应着考试的两道简答题\n\n3. wzy的quiz，感觉这是个bug，直接原题出来了好几道，这属实有点难蚌\n\n4. zq最后一节复习课会闭麦，大家如果复习的差不多可以跟着老师把知识点勾一下，如果完全没复习可以带个录音的东西（当时看智云的时候发现没声音感觉非常离谱），等考前好好听一下\n\n5. 选择题大家看自己能力吧，刷题库感觉性价比超级低，如果你没有吃透，那基本就是在纯纯浪费时间。软工复习如果时间来不及，切记：大题才是最重要的，选择题的特殊改卷方式即使你啥也不会，也能得到差不多的分数。
178263,9135,邹强,2023-07-09 05:20:52,0,3,3,给分不好
191070,9135,邹强,2024-04-01 02:32:24,12,12,0,很难说话的老师，快跑
195099,9135,邹强,2024-06-26 18:43:20,6,7,1,不懂总是闭麦干什么？智云存在的意义不就是用来看的吗？复习时候想找testing相关的那节课来听，22/23年全都是讲到关键处闭麦，24年好了，所有课程全闭麦。又不是什么多有价值的课，还这么小气
195230,9135,邹强,2024-06-27 10:13:33,31,34,3,锐评一下我们最爱的软工课程和邹强老师 \n\n细数邹强的几宗罪：\n\n1. 10点到11点的课，zq能给你10：15上课，11点多一点下课，可见他自己也不想上这b课，但是你不上课了还不提前通知，10:28你说不上了，多少有点出生\n\n2. 智云全闭麦。你自己复习课闭麦我还能理解，nmb你复习课说去看你讲的test，你自己那节课还闭麦，我就搞不懂你是怕你讲的东西泄密吗？不想讲可以不开这个课\n\n3. 考试你也能迟到。我本以为一堂课上半个小时就完成任务已经是你的极限，你考试带着卷子还能迟到？十点考试你9:45出发，屎不堵定门你不拉是吧\n\n4. 考试答题区通知的极其混乱。一开始说写在卷子后面，一会又不行了，最后更来了个逆天发言：“你们哪次考试发草稿纸啊，很明显答题纸啊！”，你的精彩演出更是给这门史一样的课勾上了浓厚的一笔。\n\n\n\n再说软工这门课：\n\n1. 36章ppt，逻辑混乱，胡言胡语，抱着八百年前的东西啃的津津有味，35-6都能算错，前言不搭后语，真真正正是一坨建立在史山上的厕所。你问我该怎么翻新这门课？拆了扔进下水道才是他的归宿。\n\n2. 题库狗市，大量错题，英语语法乱七八糟，单词全是生僻词，严重怀疑出题库的人精神状态不好，可能有精神疾病。\n\n3. 烂中烂的考试。课改后还是这个样子，全是像八股文一样的东西，完全感受不到任何知识含量，就好像是嚼了八百遍的甘蔗渣，没有一点营养。\n\n4.考试卷子打印也有问题，选择题漏了题号，还有明明应该多选，答案数目还用is这种低级错误，你们直接从题库摘题，连改都懒得改是吧\n\n\n\n总结：矬子里挑大个，邹强在一群逆天摆烂老师的衬托下显得初具人形，但是依然改变不了软工和带这个的老师sb的事实，计院能够设计出这门课的人，将来他孩子也“翻转”一下，皮炎吃饭，口中排泄。
196371,9135,邹强,2024-07-03 06:54:25,5,6,1,这几年下来我发现智云闭麦的原因一般是授课老师水平太差，不好意思开麦
196392,9135,邹强,2024-07-03 08:14:42,8,8,0,谁选谁后悔，快跑
196480,9135,邹强,2024-07-03 17:04:25,1,6,5,虽然评论说的几宗罪都是事实（真的很难绷），但是期末给分非常好，这就够了
196483,9135,邹强,2024-07-03 17:14:04,0,5,5,zqnb
197769,9135,邹强,2024-08-12 01:35:09,-2,3,5,真的真的非常讽刺\n\n整个学期就三门课，有一门选修课花的时间最长最后效果也还不错但是给了个超级低的分数\n\n软工花的时间最少，但是给的分是三个里面最高的\n\n计院你怎么了，这个世界你怎么了
205681,9135,邹强,2024-12-11 05:57:12,3,4,1,迟到大王闹麻了
216708,9135,邹强,2025-03-21 15:43:55,-2,34,36,希望正在选导师的同学看到。避雷！！！快跑！ 底下学生已经跑了两个了（实在受不了 换导师了）。\n\n本科扬州大学（90%确定）。极其虚伪自大，极其油腻的一个人，纯纯一个NT。维护着良师的人设，真的是又当又立。\n\n抢学生一作，让人干杂活，一个不落。让人恶心的是，抢一作这种事是不会明着跟你说的，就是可能投稿前突然就发现论文一作变成他了，或者投稿后你才发现自己不是一作了（组里论文都得经由他投稿）。\n\n干杂活这种事他还是会另外多给你几百块钱作为报酬的，但令人恶心的是，他自诩是不会让学生干除了科研以外的事情的。\n\n对学生的指导基本属于是点菜式，给不了什么建设性的指导。（就像是，我想要这道菜，你应该把这道菜做得色香味俱全:) 呵呵）\n\n假大空典型，擅长玩概念和包装，真正肚子里有多少东西是存疑的。对于与他意见相左的想法是会疯狂贬低的，他是不容置疑的😀。\n\n学生的课题都是围绕着他的需要，他的布局，有成果了好让他包装自己。\n\n组里氛围只能说极差，大家都在苟活。\n\n希望想选他的人都能看到，能救一个是一个了
218968,9135,邹强,2025-05-23 13:31:52,0,5,5,👍👍👍~
219003,9135,邹强,2025-05-17 17:50:00,-2,3,5,~~~
219259,9135,邹强,2025-05-23 14:15:19,-2,4,6,lll
219262,9135,邹强,2025-05-23 14:18:26,-4,2,6,lll
219481,9135,邹强,2025-05-28 08:50:46,3,4,1,今年zq不上软工后，有对比才有伤害，看往年课堂录像，比我们摆烂lh好太多了，现在整个软工课程组老师一个比一个摆烂
219905,9135,邹强,2025-06-10 16:23:42,0,2,2,~~~
161163,9156,林芃,2022-10-30 07:28:30,3,4,1,讲课还行，给分还行，回答问题也比较积极，推荐选
174454,9156,林芃,2023-06-29 11:52:59,4,5,1,放心选，很好的老师
176383,9156,林芃,2023-06-28 15:52:10,2,3,1,给分真的很好
176385,9156,林芃,2023-06-28 16:02:10,3,4,1,lp老师上课真的挺认真的，且有任何问题都会很仔细的回答，计组给分也不错，是个很为学生着想的老师。
176406,9156,林芃,2023-06-28 17:59:48,8,9,1,计算机组成\n\n吹爆林爹和助教gg！！！\n\n\n\n林老师超级认真负责，是我大学见过唯一自己做作业+批作业+讲作业的老师，会修正课题组祖传ppt和课本答案的错误；而且讲课幽默，会加入自己的理解～\n\n人也超好超可爱，钉钉回消息很快，有一两次点名但是应该不怎么影响（甚至一次点完就不小心把excel删了），感觉为了大家交齐作业和lab操碎了心（\n\n助教gg也很好很耐心！\n\n\n\n总之作为评分N/A的新老师，感觉是超级惊喜的盲盒！祝老师越来越好～
178705,9156,林芃,2023-07-19 00:48:45,6,7,1,lp老师真的是大学里少见的为教学负责的老师
183859,9156,林芃,2023-12-01 09:23:20,0,1,1,上了体系才明白lp为什么是神
184391,9156,林芃,2023-12-18 18:38:20,0,1,1,推荐选
191305,9156,林芃,2024-04-17 06:57:25,10,11,1,计组\n\n春学期结束了\n\n一开始有点不适应，感觉是无感情念PPT\n\n多听了两次，发现林老师不是无感情，而是有点青涩；不是念PPT，而语气平淡但内容精彩\n\n认真跟着听，真的能很轻松地学到很多东西\n\n而且林老师能和学生打成一片，下课后我和几个同学偶尔会留下来和老师聊天，老师其实挺喜欢聊天的，也会了解大家的学习压力\n\n而且，期末考的小炒他允许打印，不强制写，他说手写会很累\n\n他真的，我哭死
193168,9156,林芃,2024-06-04 06:54:28,1,3,2,讲课我觉得一般般，问题很大，一直吞吞吐吐的
196114,9156,林芃,2024-07-01 17:02:33,1,4,3,可能有一次点名，讲课一般，给分一般
196134,9156,林芃,2024-07-01 22:48:46,7,7,0,对学生很用心，想办法给学生减轻压（A4本来是可以打印的，不过被同学在大群里走漏了消息哈哈哈）实验时间也非常宽松，验收也水。考前也有针对性复习，复习课要好好听，会改多年来错误的PPT，有点过一次名，但那次后来说不算了，小测和期中考试会反复通知，凭良心讲真的对学生好\n\n  稍微有点不足的可能是因为才讲了两年，讲课经验不足，上课没有用光标指着讲的位置，导致我有时候抛锚，但并不是朗读PPT，讲的是有思路的，只是不够熟练吧\n\n  总的来讲非常值得选，并且未来讲课应该会更好
196422,9156,林芃,2024-07-03 09:12:09,1,4,3,讲课一般，甚至可以说很不行，给分一般，但是挺关心学生的，不太建议选，还是尽量冲马德吧
196797,9156,林芃,2024-07-05 07:43:43,0,1,1,课讲得确实一般般，有些地方课上听不明白，还是得课下看隔壁md的智云。\n\n给分好，很为学生考虑（试图允许学生打印cheat paper，结果走漏了风声；平时实验也不强求bonus的部分）\n\n总体来说还是比较推荐
196906,9156,林芃,2024-07-06 01:06:17,1,2,1,lp真的很好，放心选没问题。课下答疑很耐心，很多细节和模糊的地方会查资料后下节课给大家讲。实验基本过验收分数就很高，不用卷报告。最后讲题加分和允许打印cheating sheet，看得出来老师真的很用心很棒。\n\n至于讲课，相比于数逻时我上的马德，确实有欠缺。md的知识讲得纯熟、清晰，lp在用心讲，但可能因为教学经验的问题，有些时候会从科研或现实之类的角度看问题，觉得有些细节可能不太用care，有些问题有其他角度来解决，没那么直截了当，但总归是能把问题讲清楚明白的。我觉得计组学的很明白，当然也完全可以智云看md
199787,9156,林芃,2024-09-30 01:33:11,2,3,1,yyds
206585,9156,林芃,2024-12-16 08:00:50,2,3,1,大家补药放过这个可爱的林芃啊，真的感觉非常为学生着想的老师，温柔和善，助教gg也很温柔
208618,9156,林芃,2024-12-30 06:08:56,1,1,0,林老师是真正为学生着想的老师，对教学非常认真负责，人也挺可爱的。一学期都说了要人少的时候点名但是最后还是没有点名。助教gg也很温柔，对学生很负责。下辈子还选
209571,9156,林芃,2025-01-06 09:21:10,2,3,1,林老师绝对好老师！讲课水平在开课老师里也绝对算高了（前几个学期可能还没这么有经验），看起来对学生也非常好（因为我只听过他的智云，是别的班的）
211738,9156,林芃,2025-01-12 09:48:07,2,3,1,出分后立马来感谢老师\n\n本菜鸡啥也不会 被大捞了一把
211919,9156,林芃,2025-01-13 01:51:23,1,2,1,老(l)婆(p)大人太贴心了！给分真好！期末考感觉错了一堆，最后一道大题审错题，竟然还有4.5！开心！
212113,9156,林芃,2025-01-13 07:56:03,0,1,1,啊啊啊啊啊老师好好，虽然期末考试有点逆天没写完题但是最后得分不错捏
219848,9156,林芃,2025-06-20 13:15:17,-2,1,3,出分3.6，无缘清北
169488,9378,丁尧相,2023-02-26 11:48:39,8,9,1,很好~
171782,9378,丁尧相,2023-04-05 07:05:49,3,3,0,老师很好，答疑很积极~
173680,9378,丁尧相,2023-06-01 06:28:46,3,3,0,老师讲得非常好，必选！
191365,9378,丁尧相,2024-04-18 12:57:05,-2,1,3,老师人挺好的，但是ads的上课水平确实不敢恭维。
192071,9378,丁尧相,2024-05-08 16:54:09,2,2,0,老师还是很好的，只是因为第一次上课，教学水平还需进一步在实践中培养。估计明年上ADS，老师的水平可以提高很多；但是那些计院老油条们的水平就一直是那样了~
193054,9378,丁尧相,2024-06-03 06:17:01,10,10,0,上了老师的ADS，上课不点名，project只布置两次，ddl也都在最后一周，bonus的给分相当好，可以不做展示，展示和多做一次project就bonus给满，discussion的给分也非常容易，还没有出分，但是感觉老师的ADS的平时成绩算是给的很好的了，期中考甚至是开卷，老师人也很好，对于同学很友善，也会耐心回答同学提出的问题。可能是因为第一次开课，老师人有点紧张，讲课上可能差强人意，但认真听的话还是能听懂的。
194474,9378,丁尧相,2024-06-24 05:32:09,6,6,0,非常好老师，应该是第一次上ads这门课，虽然讲课的水平确实很有上升空间，但每节课都会额外补充一些除了陈老师ppt上以外的内容，坏处是可能上课脉络没那么清晰，但好处是了解地更深入了，对期末复习面对一堆新算法题有帮助。平时事少分高，bonus的形式很多很容易拿满，project的分数给的也挺高的，discussion只需要交两次课程提议就行。
194500,9378,丁尧相,2024-06-24 07:47:05,2,2,0,很好的老师，平时分给的很好，上课可能不像其他上过很多次的老师那么流畅，会补充一些其他学校的ppt，可冲！
194627,9378,丁尧相,2024-06-24 16:31:06,2,2,0,超级超级好老师，一句话说不清楚，选就对了！！
194673,9378,丁尧相,2024-06-25 02:23:01,5,5,0,神！不点名 平时分无敌好 人非常好 回答问题基本秒回且回答的很详细 对学生很照顾
196115,9378,丁尧相,2024-07-01 17:05:39,1,1,0,老师完全不点名，平时分给的特别好，随便满分
196151,9378,丁尧相,2024-07-02 01:16:05,1,1,0,伟大，无须多言
196366,9378,丁尧相,2024-07-03 06:20:10,1,1,0,老师平时分给我拉满了😭😭
196507,9378,丁尧相,2024-07-04 01:07:08,1,1,0,事少分高，神中神
196913,9378,丁尧相,2024-07-06 01:25:41,3,3,0,ads新老师，事情很少，体谅学生，人很好。\n\n讲课的话感觉不如myc、wc这种有口皆碑的老师，但也不错。喜欢上课拓展很多内容，但这就导致本来基础内容大家就学不明白，加进来更多速度更快就更犯迷糊。后来老师也逐渐往课内回归，还有完善的空间\n\nbtw老师是二次元，出分后大家还在群里催老师去看京吹三，可以说人真的超级nice了
197036,9378,丁尧相,2024-07-07 01:00:24,1,1,0,强推，平时分给分友好，期中开卷，期末答疑积极
209085,9378,丁尧相,2025-01-04 11:41:49,1,1,0,是个好老师，可以放心选
210006,9378,丁尧相,2025-01-08 01:43:49,2,2,0,不点名 没有课堂内答题(对比其他ads老师，比如yds) 讨论part只要交课程建议和意见即可 平时分基本上做了bonus，其他没有太大问题都给满\n\n事少，考试过了斩杀线包稳过的ADS老师\n\n而且授课也有特色 参考了mit，princeton等校的slides 至少从我个人角度要比课题组的传统slides(有点过于简洁，加上有一些细节藏在动画里(重叠的ppt文本框)，不播放都不知道这回事，)要易于理解，也一定程度节省了信息检索的时间，且有横向的对比\n\n基本上参考课题组slides(主要是确定考试范围) 把dyx老师slides中的主要内容和算法案例(各模块的算法案例可能会直接在期末考试考到)把握住 课后可以做点luogu，leetcode之类平台的贪心，dp，搜索，剪枝题单练练手 就能不错地掌握知识点\n\n在把握期中前的数据结构的结构，操作，复杂度(最好记一下各数据结构的摊还分析后的复杂度特点)基础上，参考github上学长发的关于ads >= 40的定向复习(主要侧重于期中后的算法部分)，大概就能比较不错地通过期末考试\n\n答疑也有及时的回复 并且助教哥哥很贴心 很认真 很负责 而且是曾经在ads几乎满绩的高手\n\n吴迪了 感觉还有说不尽的话but我想伟大无需多言！\n\n感谢dyx老师和助教qza对ads课程的辛勤付出！
210053,9378,丁尧相,2025-01-08 04:28:10,3,3,0,拯救了我学计科信心的好老师，算总成绩时不知道从哪里给我弄来了那么多加分，真的感激不尽。因为丁老师是新老师，图灵那边ADS老师介绍甚至没有他（我就多写一些向学弟学妹推荐一下\n\n丁老师上课用的自己的ppt，是cy的ppt+其他学校的ppt组合起来的，但老师自己加进去的扩展部分不是考试的内容，期末复习时要注意（\n\n关于上课，个人觉得老师上课的水平虽然不算最顶尖的一批，但很有耐心，一些难的知识点也会放慢速度好好讲，至少数据结构的部分我接受还是很良好的，到NP问题之后会变得比较抽象，上课时因为讲的比较凌乱也很难消化，不过算法这玩意自己不好好钻研也很难搞懂，不能全怪老师。\n\n关于成绩，老师的成绩组成是40%期末+10%期中+30%project+10%平时+10%讨论，project是8选2，在两个中选择其中一个展示。bonus政策为多做project，或者个人报名进行课前的数据结构/算法介绍pre，怕平时分不满的童鞋可以做做；这学期的期中是开卷考试，题目较简单且有一道摊还分析的手写题用来捞分，大可放心；讨论就写一写对课程的感想和想听的期末复习内容。总之丁老师ADS的平时分都比较好拿，基本不用担心平时成绩，好好完成project和bonus基本就满了\n\n关于期末考试，ADS的期末考也是臭名昭著的难。考前老师组织一次线上的期末复习，请助教gg去讲期中的题目，然后老师会选一些比较难的考点选讲，还是挺有帮助的。期末个人认为把NP前比较直观的部分看明白基本就不会被斩杀，想要争取更高的分数可以把后面ppt的各种算法手推一遍，搞清楚那些例子的算法思想，毕竟期末考也基本上是依赖上课讲过的算法出题的。\n\n最后还是非常感谢丁老师和助教qzagg一学期的付出，祝后辈们都能顺利通过ADS
210096,9378,丁尧相,2025-01-08 06:41:13,1,1,0,强推，丁老师非常好，放心选！！！\n\n    上课不会抽人答题，没有到课要求也没有签到；平时分叠满，期中开卷+手写题捞分，project是8选2，多做一次project或者pre是bonus，基本上好好做都能满的；\n\n    老师答疑也很积极，基本上当天问当天都会回复，老师人也很友好亲和！\n\n    期末考完了折算了一下分数，结果出分之后比预期总评高了好几分（是的，好几分）总评直接又上了一个台阶；期末好好考，剩下的交给丁老师！\n\n    印象最深刻的是期末考试完出分之后，钉钉群里一片的谢谢老师；以及丁老师最后的回复：“应该的”，真的感动了啊啊啊TAT\n\n    \n\n    至于ADS学习部分的话，建议平时好好下功夫，不要指望考前突击；每周上完了一定要好好复习，一定要搞懂，作业认真做；多的时间可以多刷一下力扣的dp之类的算法题练练手；不懂的地方问老师or同学or学长，总之就是平时一定要学好！
210139,9378,丁尧相,2025-01-08 08:19:03,0,0,0,伟大，无需多言，
210173,9378,丁尧相,2025-01-08 17:02:10,2,2,0,ads，建议无脑选dyx老师。\n\n    老师完全不点名。老师的project是8选2，并且不用展示，展示一次或者多做一个project，即可将bonus拿满5分。相比与别的老师必须要求展示以及多做一个project加一分，在dyx老师班相当于做了别的班最基础的任务即可拿满bonus，同时discussion内容只需要提交一次课程提议，加上期中考开卷，所以只要努力一点平时分基本上是满的。\n\n    同时，老师上课的ppt拓展了别的学校的内容，不止于cy ppt的八股文，虽然有些原理真的很深，几乎完全听不懂，但是个人认为学习ads不应该止于八股文。要是对拓展知识不感兴趣只需不听即可。\n\n    dyx老师回答问题也很有耐心，要是发现作业有问题或者上课哪里讲错了都会在钉钉群里发。
218964,9378,丁尧相,2025-05-15 07:28:35,0,0,0,强推！
171814,9381,刘忠鑫,2023-04-06 10:33:34,6,6,0,非常好，科研能力很高
173129,9381,刘忠鑫,2023-05-14 04:43:23,-13,4,17,编译原理不要选，否则你将体验单撸编译器的快乐[黄豆流汗]
173438,9381,刘忠鑫,2023-05-24 11:19:11,-7,3,10,编译原理大作业一个人干别的班三个人的活儿，慎选
174446,9381,刘忠鑫,2023-06-12 08:45:55,3,3,0,年轻老师，有激情，讲的也很好。\n\n但是编译原理这门课比较难，需要认真听才能跟上老师节奏。\n\n编译器大作业评分规则是助教定的，跟老师没关系。可以组队做只不过不能用太多llvm，助教给的指导文档也比别的班多
174882,9381,刘忠鑫,2023-06-19 09:46:06,0,0,0,室友说刘老师人很好
175389,9381,刘忠鑫,2023-06-24 12:43:26,1,2,1,期末补天看老师智云的感想：老师讲的真好真有激情啊。到期末补天才慢慢听懂CP这课。感觉在做完了大程之后回头听才慢慢能够听懂，之前都是听天书，所以这样看solo compiler也不是没有用的对吧（逃
176587,9381,刘忠鑫,2023-06-29 10:14:54,18,20,2,期末有点炸，出分之前来评论下\n\n---------------------\n\n上课不点名(唯一一次手写名字点名，刘老师强调过点名不计入平时成绩，可能为了应付jwc?)，有小测，题目不难，而且小测会提前在钉钉预告，平时作业按照老师最后一节课的说法应该是交了就给分(原话:大家作业不管做不做得来都交一下，你们不交作业我怎么给分)\n\n关于大程，计院祖传的fly bitch，但是要求是比其他班低的，而且还特意嘱咐助教只要autograder通过了验收过了就可以给满分，而且不强制要求展示，展示自愿报名，可以加平时分\n\n而且大程实际上是可以组队的，只不过组队要求会高一些，对llvm的使用有限制，solo的话只需要做到AST然后用llvm调用IR接口就行，所以几乎整个班都是solo，但刘老师本意也是让同学们参与实验，别划水，编译原理本来就是一门重实践轻理论的课程，大程好好写了基本上这门课就学明白了\n\n大程相比其他班已经好太多了，楼下吐槽单人手搓编译器的怕不是之前的大程都是抱大腿划水的吧，说实话根据三年在计院组队的经验个人认为组队还不如solo来的效率高\n\n---------------------\n\n再说说教学方面\n\n刘老师是第一次来浙大教书，恰好碰上编译原理教改，教材换成虎书，相比之前加了很多编译器后端的内容，舍友评价某个此前风评较好的老师前端讲的不错，后端的部分就是念ppt，这也反映了一些资历老的教师不太适应教学内容的更替.而刘老师的上课是明显听的出来有备过课的，讲课逻辑清晰，很有激情，对教材的理解很深，上完课会告诉我们课后去看中文版教材的哪一部分，课后的作业老师也是做过的，期末的时候有开放出来给大家复习，最后一节课还很诚恳地让大家可以发邮件给他提对课程教学方面的建议\n\n还是很推荐学弟学妹选刘老师的编译原理，值得一听，我浙太缺这样年轻有为还对教学方面肯认真负责的新老师了
177166,9381,刘忠鑫,2023-07-02 02:51:58,2,2,0,刘老师从学生角度出发考虑问题，为学生着想，这一点就非常好了，建议选择，小测前有预告，平时不想来可以去实习的，非常好，建议大家选择
177272,9381,刘忠鑫,2023-07-02 13:24:27,0,0,0,认真教学的好老师
177442,9381,刘忠鑫,2023-07-03 09:20:00,0,1,1,老师讲得非常清晰，感觉是所有老师里讲得最好的，基本上课听一遍就可以听懂。大程虽然是单人完成但是实际的任务量比别的班要少，展示是自愿，展示了就有加分，中间会有一次签到。最后给分也很好，科研能力也很强，是很优秀的老师。
177445,9381,刘忠鑫,2023-07-03 09:30:36,2,2,0,期末出分来评价一下\n\n刘老师是给分最好，讲的最好的老师了。\n\n虽然平时会点名，但是不怎么扣分。大作业虽然是solo有测试样例要求，但是只要达到就给满了。\n\n其他班即使以展示代替验收，该有的功能一样要有。\n\n最后期末复习，讲课也是最清楚的。\n\n难为老师平时上课很多人不听课，依然很认真在将，以及认真负责的助教zq gg，人真的很好很负责。\n\n最后编译原理，个人感觉一定要先提前花两周写一遍编译器，写完之后，理论的知识就好懂很多。不然很多内容会觉得云里雾里不明其妙。\n\n另外虎书更像是一本工具书的介绍书，初学者硬看看懂很难，还是要动手实践，建议学期初就立马写大作业。
177610,9381,刘忠鑫,2023-07-04 02:20:18,1,1,0,byyl 之光
178434,9381,刘忠鑫,2023-07-11 12:41:52,0,0,0,刘老师专业知识扎实，讲解浅显易懂，对学生关爱有加，认真负责！
178435,9381,刘忠鑫,2023-07-11 12:41:51,0,0,0,刘老师专业知识扎实，讲解浅显易懂，对学生关爱有加，认真负责！
178540,9381,刘忠鑫,2023-07-14 03:24:03,4,4,0,给分亲民友好、考勤小测佛系、上课求是认真，实乃学生之友、CP之光。善哉善哉！
178596,9381,刘忠鑫,2023-07-16 08:56:13,1,1,0,老师给分太好了，听说老师很会捞人
196401,9381,刘忠鑫,2024-07-03 08:27:30,2,3,1,刘老师真的太好了😭讲得好，给分好，平时分基本只要作业做了、实验过了都给满，实验设计感觉是所有教学班（乃至计院课程）最好的，做了基本实验和图染色对理论学习和期末考试有挺大帮助的。老师平时会随机叫人回答问题，小测前会在群里预告
196666,9381,刘忠鑫,2024-07-04 17:19:22,0,0,0,老师给分很好的！这学期两位助教也很好！\n\n实验基本是按照测试点给分的，所以大家尽量通过所有测试点！作业感觉是交了就会有满分的\n\n但是助教哥哥和老师可能没办法在考试分数上努力的，考试一定要拿出时间过一遍书+ppt+作业题，而且期末考是一年比一年难的\n\n老师会随机点人回答问题，小测提前通知\n\n给10分还有一个原因是，刘老师身上还是有对教学的热情，以及认真和拿学生当朋友的品格，这一点我相信在计院众多老师中并不那么常见
221831,9381,刘忠鑫,2025-06-26 14:42:19,2,2,0,byyl \n\n\n\n课程质量比较高，个人感觉讲得还是比较清晰的，有一次纸质点名，小测三次提醒了一次没提醒，没提醒的那次可以线上交（不过线下交似乎可以加分，类似点名吧）\n\n\n\n实验几个助教都很好，看了一圈都是按照 lab 本身的测试点来，即只要你过了就会给满。平时分扣分点可能会在于作业（有零点几）和小测（有一分左右），当然这个还是根据个人做作业和小测的情况来的。建议做一下实验 bonus 补小测，因为看下来我认识的人基本上都有扣 1 分。\n\n\n\n期末考试难度比较大吧，不过题型上还是八股，如果做不完的可以看着跳过一两题，基本上一个小问也就两三分。先把每道题前几小问做好。
222014,9381,刘忠鑫,2025-06-29 01:11:43,4,4,0,伟大，无需多言
222017,9381,刘忠鑫,2025-06-29 01:51:10,2,2,0,老师讲课非常清晰非常热情，小测提前通知，考前公布答案供复习。实验设计感受非常好，而且感觉会一年比一年好，感谢助教们的付出。平时分给分也很好，是自己期末考低了稍稍有点可惜
172594,9385,章方铭,2023-05-01 08:50:08,3,6,3,绩杀。
172635,9385,章方铭,2023-05-11 05:36:17,-2,8,10,很好的老师一枚啊，让我美美水掉了创新创业，这垃圾课程还必修真是搞笑，不过老师上课真的很认真，但是框架本身有问题老师也发挥不出来自己的能力
172858,9385,章方铭,2023-05-08 15:43:48,5,14,9,不是老师的问题是课程设置的问题吧，创业职规必修反正我觉得很离谱\n\n所有任务都切实完成了，出勤全勤，还是3.3，也不知道为什么
173310,9385,章方铭,2023-05-18 07:49:51,14,17,3,很无聊 而且已读不回
178891,9385,章方铭,2023-07-28 11:18:47,6,8,2,符合我对一位过气的、旧时代的老师的绝大多数幻想，自以为是的优越感，课上会炫耀自己的人脉，ppt做的还行（仅限于画面上不像是十年前的祖传ppt），课堂是无聊的，讲课是不可能的，只能读读ppt这样子，学生是要参与度高的，所以填充了各种课堂活动，可惜不仅这些活动是到处抄来的（完全无法与班级里小组人数相匹配，也许是网上抄来的？），并且它们之间并没有什么联系，好像只是用来逗老师开心的，哦，不止于此，还可以用来填充那漫长的，无聊的三节晚课。总而言之，我不明白这种浙江大学教师主页里搜都搜索不到的老师能来给我们讲课，要不是为了这点破学分，我是一刻都不愿意在他的课上多呆。最后附上我唯一搜索到浙江大学页面里对章老师的介绍：http://www.cs.zju.edu.cn/csen/2019/0611/c27061a1223520/page.htm
182385,9385,章方铭,2023-11-15 11:53:52,1,1,0,上课很无聊，脱离实际有点，老师事多
183972,9385,章方铭,2023-12-05 07:29:42,14,18,4,马不想要了是吧
184326,9385,章方铭,2023-12-17 09:03:18,3,3,0,点名次次都到，小组作业也全认真完成了，结果绩点3，服了我迄今为止最低的一门课。。。
184564,9385,章方铭,2023-12-21 16:22:21,-1,0,1,无需多言
184795,9385,章方铭,2023-12-23 01:00:40,6,7,1,老师人还是不错的，但是这个给分吗有点尴尬，反正我是3\n\n上课对参与度的要求比较低，我刚开始认真听过，后面基本上在水自己的事情\n\n主要是创业基础这门课离我们有点远吧，而且对于真正有构想去创业的同学，恐怕这门课所教的内容只是推进他创业想法的一小步\n\n短学期的课结束地蛮快的，最后一节课两位优秀学长的分享还是蛮有意思，有些话语记忆犹新啊
184907,9385,章方铭,2023-12-24 09:46:00,0,1,1,水掉创业必修挺好的，我的给分还行，纸质签到，事情还好不算多吧，书单+创业小实践+策划书和偶尔的小任务，都可以抄，不难解决。和小组成员一起摆摊还挺有趣的
188775,9385,章方铭,2024-01-20 02:18:38,3,3,0,绩杀！快逃
188836,9385,章方铭,2024-01-20 07:14:59,1,2,1,其实讲课水平还行，冬学期请的几位学长学姐也讲的很好，就是给的绩点普遍低，认真完成作业最多也就3.9的样子
192864,9385,章方铭,2024-05-31 05:41:17,1,6,5,看大家评论说绩杀，我觉得不会啊。相反，在我看来，这是一门挺轻松的水课了，和小组同学分着做案例分析和商业计划书，其实一个人的作业量完全不多，后面也没有别的大作业，就填了个阅读情况统计表呀。其他时间我都在摸鱼或者自习，每天只要到场签个到就行了，老师人也挺好的，看你低头做自己的事情，虽然落寞也不会说什么。最后我是拿了4.5，不是巨高那种，但是因为我感觉真的没干什么事，所以后面就是一个意满离的状态。\n\n当然因为我是把它当水课，我对创业没有太大的兴趣，但是老师也会邀请创业成功的学长、创赛国奖的学姐来分享，我觉得如果真有创业意向的应该会受益匪浅，毕竟我一个外行人都听的很震撼。
193478,9385,章方铭,2024-06-11 11:00:26,5,6,1,只想吐槽一点，春学期上的这门课，现在夏学期都快结束了成绩还没出，在群里被毕业生催，答应在一周内成绩出来，结果……成绩还是没出\n\n肿么说呢，课是挺水的，上课是挺尬的，点名是纸质的，给分，呃呃，目前还没看到\n\n最后只希望绩点不要太低，让我顺利结束创新创业类课程
193746,9385,章方铭,2024-06-17 11:23:54,5,7,2,绩杀2.1\n\n给分非常幽默
199663,9385,章方铭,2024-09-27 07:15:53,-1,0,1,。。。
203667,9385,章方铭,2024-11-20 11:30:52,2,2,0,节节课点名，事还贼多，发布限期三天的作业群里线下一句话不说，给你打两分是我害怕被绩杀给你留扣一分的空间
205974,9385,章方铭,2024-12-13 02:28:01,-1,1,2,秋学期成绩现在才出是有点慢 但不妨碍老师给分挺不错的 平时上课不听期末没考试就一篇论文 感觉啥事没干都有4.5
206030,9385,章方铭,2024-12-13 03:34:35,1,3,2,刚出分就来了，88还是比较满意的毕竟没怎么投入…平时每节课都会传名单但是没什么事（坐的第一排也没怎么听），小组作业可以水一水，期末有一个1500+的论文占比很大
206231,9385,章方铭,2024-12-13 09:54:39,-1,1,2,纸质点名，上课很水，作业也没多少，最后要交一篇论文 第一节课会非常尴尬，度过前期就好了，给分不错
206234,9385,章方铭,2024-12-13 10:07:29,0,3,3,给分好高啊！！！感觉和查老师之前说的不太一样。有时课上会纸质签到，平常会布置一些杂七杂八的任务（个人感觉量不大，容易完成），期末是一篇论文。老师一看授课风格就是那种典型的理工男（难怪是计院的，而且感觉有点像沈qx，hhhh），钉钉上面态度也挺好的。虽然平时课上喜欢摸鱼或者是自顾自自习，但是也拿到了4.5，必须10分好评!
206371,9385,章方铭,2024-12-14 15:02:16,-1,1,2,纸质签到，事少，给分也不错，不知道为啥查老师上评分这么低，差点就错过了
206543,9385,章方铭,2024-12-16 03:12:55,3,3,0,不多说了👍避雷就完了，绩点忒低
206545,9385,章方铭,2024-12-16 03:17:43,2,2,0,给分巨低，已知全班最高4.5
206658,9385,章方铭,2024-12-17 03:24:56,1,1,0,4.5 谢谢老师
211686,9385,章方铭,2025-01-12 07:26:28,1,1,0,给分很迷
211697,9385,章方铭,2025-01-12 08:03:39,1,1,0,逆天玩意
211707,9385,章方铭,2025-01-12 08:35:17,0,0,0,诗人握持
211728,9385,章方铭,2025-01-12 09:29:23,0,0,0,纯低分
211754,9385,章方铭,2025-01-12 10:22:05,1,1,0,果然査老师不会说谎
212064,9385,章方铭,2025-01-13 06:32:29,0,0,0,老师讲课很无聊\n如果要拿高分论文要好好写
212427,9385,章方铭,2025-01-14 03:50:48,2,2,0,搞笑，当了组长，作业都交了，论文写了五千字，喜提3.0。给分极差，要么就是随便给。每节课都纸质签到，要不是被调剂根本不可能选他，别来！
214867,9385,章方铭,2025-02-18 13:21:48,1,1,0,幽默至极，绩点随机，互评就是笑话，认真没好报
215888,9385,章方铭,2025-03-06 13:26:33,3,3,0,拖堂，事多，不讲清楚作业
215889,9385,章方铭,2025-03-06 13:27:40,2,2,0,史中史，自己安排下课时间，拖课严重，作业抽象
221990,9385,章方铭,2025-06-28 08:56:32,0,0,0,春学期的课拖到现在才出。。。还有老师你怎么突然变成五级制了😭😭
168011,9386,赵晓琼,2023-01-22 06:47:28,2,3,1,垃圾垃圾垃圾垃圾
168043,9386,赵晓琼,2023-01-24 02:56:00,2,3,1,给分玄学 同组差两档 事不多也没啥内容
182688,9386,赵晓琼,2023-11-19 13:11:20,13,13,0,你玩原神吗？
184555,9386,赵晓琼,2023-12-21 15:19:20,1,1,0,逆天老师，逆天作业
185967,9386,赵晓琼,2024-01-06 20:18:35,6,7,1,我给你讲个故事吧
185968,9386,赵晓琼,2024-01-06 20:22:13,21,21,0,长相神似包贝尔，人比较闹潭，给人感觉有些自以为是和小人得志，你问他不懂的问题他甚至会嘲讽你。\n\n讲课不存在任何的中心，或许有实质的内容，但是由于他本人发散的思维和极其莫名其妙的比喻逻辑，往往会让人完全找不到重点，讲软件测试能给你扯到三国时期诸葛亮和司马懿打仗，比喻了半天说不出个所以然，还给你说“这其实是一样的”，我一样你个大光头
186130,9386,赵晓琼,2024-01-08 19:11:05,10,10,0,软测课程 非常离谱\n\n1. 作业要求不明确，算是靠同学自己私下去和他讨论来得出一些具体的要求\n\n2. 课程ppt抽象，得听他讲\n\n3. 讲又讲不清楚，喜欢简单东西复杂化，被我们称为“防御性授课”，生怕学生听懂\n\n4. 和他私下还是群里沟通都是有障碍，没有逻辑，喜欢嘲讽，不正常的沟通状态\n\n5. 软工课已经都摆烂了，没有软工需，只能软工测
186351,9386,赵晓琼,2024-01-10 14:47:52,6,6,0,哈哈，当然，不能
189294,9386,赵晓琼,2024-01-23 03:09:13,7,7,0,软测课程：\n\n1. 上课体验比较差，语速很慢喜欢把同样的事情重复讲，信息密度极低，五分钟的事情可以扯一个小时。而且讲话很绕没有逻辑，理解起来很费劲。上课时喜欢将一些过时的冷笑话。\n\n2. 考前最后一节课会把要考什么几乎都明说，只听最后一次课就行，考试开卷，提前把复习PPT打印即可，注意PPT中的注释也需要打印。PPT上的中文内容可以在打印前自己翻译为英文（考试要求英语作答），不然考场上就是在考中译英。\n\n3. 总体老师人还可以，给分也不错，作为软工臭名昭著的烂课之一，不要指望课程能学到多少实质性内容，满足毕业要求即可。
207091,9386,赵晓琼,2024-12-19 08:17:34,3,3,0,软测上课主打一个意义不明，说了一大堆说不出个所以然，可能到最后他自己都快忘了重点是什么了；干的一些事情也是意义不明，比如说莫名其妙的点名之类\n\n没事干喜欢问问学生知不知道这个知不知道那个，要是没啥人响应就直接开嘲讽，我表示不理解\n\n这种课是如何存活到2024年的？
213584,9386,赵晓琼,2025-01-18 11:19:23,1,1,0,上课不敢恭维，给分超好
213604,9386,赵晓琼,2025-01-18 13:14:06,0,0,0,讲的一坨，给分不错
213619,9386,赵晓琼,2025-01-18 15:10:49,0,0,0,这学期给分可以，比较意外。如果能持续下去的话建议考虑选修此课。\n\n开卷，打印ppt时一定要打印备注，最好对备注和ppt里的术语做一个按字母排序的索引表，便于查找。
175458,9468,郑乾,2023-06-25 04:31:22,11,16,5,好简单粗暴的名字……
187815,9468,郑乾,2024-01-17 13:52:41,5,9,4,看myc的智云，拿zq的分（懂的都懂）
187818,9468,郑乾,2024-01-17 13:54:37,3,4,1,小测是选填形式的，比较难，但平时分给分好中好
187830,9468,郑乾,2024-01-17 14:07:26,4,6,2,啊啊啊上课不点名，期末猛猛捞，老师太好了！
187837,9468,郑乾,2024-01-17 14:14:39,4,5,1,计算理论出分了，恭恭敬敬给老师和助教哥哥磕大头555
187855,9468,郑乾,2024-01-17 15:10:01,4,4,0,非常感动！郑老师是我大爹！感觉必挂无疑的计算理论硬生生捞了回来！分还很高！讲课有调理，作业非常少，小测还很轻松，相比于myc和jxg来说给分超级好！！！
195650,9468,郑乾,2024-06-29 07:58:02,4,4,0,感谢郑乾老师海捞，平时分给的超好！
210580,9468,郑乾,2025-01-09 11:33:09,8,10,2,上课不点名，早八的课小测开到12点，是问卷星\n\n期中有一次作业，平时没作业。\n\n期末有一次复习课，有40个题，全是历年卷上的，很推荐看一下\n\n今年是金小刚出的八股试卷，那些题还是很有用的，虽然他说不考（
212295,9468,郑乾,2025-01-14 01:00:07,10,10,0,伟大，无需多言\n\n平时分给的高爆了，期末也能捞尽捞，真神
212338,9468,郑乾,2025-01-14 02:15:59,7,7,0,不点名，两次问卷星小测（10道选择而且9点开到12点）和一次期中作业各10，感觉平时分给满了，然后卷面我感觉写了的都给分了（今年是仿八股），感谢zq大爹和助教zcx哥哥猛猛捞我！！❤️
212388,9468,郑乾,2025-01-14 02:49:07,2,4,2,老师上课讲得还行，不点名，小测时间很长，平时分很好。但是考试的时候问他exactly的意思，他说是高中词汇（但是我是先问的助教，助教也不知道，去问他……
212396,9468,郑乾,2025-01-14 02:59:05,4,4,0,老师人特别好，赞美！有时凌晨三四点发课件，不知道是没睡还是醒了，总之注意身体啊
212414,9468,郑乾,2025-01-14 03:19:15,4,4,0,真的好，两次小测会提前通知，平时分应该都是拉满的 期末也是海底捞，老师经常半夜四点在群里发早八的课件，（虽然大部分人早八都起不来不去），讲完课的复习课质量还是很高的 可以听一听。
212441,9468,郑乾,2025-01-14 04:10:26,4,4,0,给分的神
212450,9468,郑乾,2025-01-14 04:20:23,3,3,0,大三上唯一给分巨好的老师，平时分应该做了就给满，期末应该死命捞了\n\n觉得考的不错的OS最后总评没有觉得考的不好的计算理论高（前情提要：os期末占比50%，计算理论占比70%）（笑）\n\n选择大于努力最正确的一集
212487,9468,郑乾,2025-01-14 05:26:17,3,3,0,老师给分好！！！期末课一定要听 计算理论课程难度还是比较大..直到期末才厘清，平时尽量听课
212494,9468,郑乾,2025-01-14 05:46:15,2,2,0,无敌好老师，无需多言😍😍
212602,9468,郑乾,2025-01-14 09:07:40,2,2,0,伟大无需多言
212695,9468,郑乾,2025-01-14 13:31:15,-8,1,9,计算理论满了，谢谢老师。虽然 exactly 确实有点难绷（x）
212733,9468,郑乾,2025-01-14 15:39:44,3,3,0,计算理论给分真神，无需多言\n\n老师是好老师，感觉比学生大不了多少岁\n\n这课如果平时没有好好学或者做一些题的话其实期末补天难度还是太大了，也怪自己平时没有好好学（其实是一学期因为周一早八计算理论都没怎么认真上过课），所以最后成绩也就只能是这样，感谢老师的不挂之恩
213640,9468,郑乾,2025-01-18 16:03:43,4,4,0,郑老师认真负责、热爱教学，时常深夜凌晨犹在钉钉群里上传课件。他上课不点名；然有两次小测（本学期以扫码答问卷星之方式）当限时提交，与一次期中作业需线下上交：郑老师小测时间充裕，大可不必过于担忧。对我而言，他期末给分非常理想，我付出有匮，课业不精，收获之丰竟如此出乎意料，诚惶诚恐，自惭形秽；谢谢郑老师！\n\n请看到这一句：郑老师给分非常理想！
173599,9494,卢丽强,2023-05-29 18:29:09,7,14,7,不好评价
215125,9494,卢丽强,2025-02-22 00:00:55,4,4,0,南平/
216853,9494,卢丽强,2025-03-27 03:44:32,1,1,0,：）：）
216942,9494,卢丽强,2025-03-30 02:16:42,0,0,0,hhh
219299,9494,卢丽强,2025-05-24 10:36:28,0,0,0,课程作业项目目标不清楚，完成了莫名其妙扣一堆分
187756,9516,陈超超,2024-01-17 10:01:02,7,9,2,陈超超怎么样？陈超超非常不错，陈超超上课超强，陈超超有很好的bonus机制，陈超超有很好的演艺
192825,9516,陈超超,2024-05-31 02:24:09,11,11,0,按课程规矩办事，不会刁难学生，小测题目也简单
193171,9516,陈超超,2024-06-04 07:13:00,19,22,3,非常好的老师，上课清晰，小测简单，从不签到（虽然我也每次都来了），还经常提前下课，每次上课都能令人十分专注地听下去，有良好的课程体验！
214761,9516,陈超超,2025-02-17 13:05:28,1,1,0,数据挖掘讲的很有道理，非常有意思，有工业界经验，感觉不错，也不会太为难学生。
215702,9516,陈超超,2025-03-04 10:52:47,1,1,0,讲的挺清楚的，人也挺好的
219423,9516,陈超超,2025-05-27 04:53:44,1,1,0,上完fds，还没期末考，先来评一条。\n\n老师很好说话，上课清楚，有谦谦君子之范。\n\n针对某次project同学间出现的恶评情况也有公正的评论，教导同学要行正道，不要恶意竞争。\n\n真的遇到了不合理的互评分数请放心，TA会出手。\n\n小测都是课后作业的原题，没点名，可冲
217770,9537,沈春华,2025-04-16 07:40:58,1,1,0,你最好不要冲着他讲的课来选研究生机器学习，他来讲课之前连PPT都没看过
218227,9537,沈春华,2025-04-22 06:25:28,1,1,0,还是比隔壁好，隔壁杨莹春讲得跟💩一样，这课还是必修，yue
183891,9539,张文,2023-12-03 02:48:33,2,3,1,张老师yyds
196293,9645,沈浩頲,2024-07-03 00:15:59,8,9,1,很谦逊的老师，听老师讲课特别舒服特别放松。知识点会面面俱到，而且会想尽办法让你听懂（不过与之而来的是速度稍慢）考前会很不吝啬的给划重点，最后给分也特别好。体验感很好！
197970,9645,沈浩頲,2024-08-22 03:07:56,8,9,1,给分特别好，不点名，很努力地想让我们听懂
218771,9645,沈浩頲,2025-06-04 07:14:37,2,2,0,很为学生着想的老师，上课风格比较温和呢
219812,9645,沈浩頲,2025-06-07 07:48:33,0,0,0,24-25春夏计算机系统Ⅰ数字逻辑部分。老师讲课水平在线，也很体谅同学；偶尔有几次随机小测点名（据说是学院要求）
221075,9645,沈浩頲,2025-06-21 06:46:46,0,0,0,出分之前先来评价一下\n\n点名小测可以线上补交，赞！
189812,9652,周晟,2024-01-29 18:10:41,4,6,2,上课干货很多，讲课认真负责，也不点名。不过这并不影响给分不高。如果你不是他自己的学生，又想拿高分的，别选。
208478,9678,王海帅,2024-12-28 07:43:19,0,0,0,讲课还行
210510,9678,王海帅,2025-01-09 09:38:34,1,1,0,还行，os不点名，平平淡淡才是真
213642,9678,王海帅,2025-01-18 16:13:16,1,3,2,王老师认真负责，恪尽职守。他负责《作业系统》课程中部分章节之讲授。他和蔼可亲，平易近人，设身处地为学生着想，耐心回答问题，作业布置题量合理且题目对乎期末考试有较大帮助。他尝认为上课不听者不如不到教室，是故鲜见点名，虽有时有其它教学要求而不得不关注出勤率，他亦采用小测之方式以灵活应对。谢谢王老师！
217659,9678,王海帅,2025-04-15 02:13:12,0,0,0,看着很认真很凶的老师，实际上上课不小测不点名，都是留作业，给分非常好。
219387,9678,王海帅,2025-05-26 07:54:13,1,1,0,这老师可好啦！人工智能B还要pre，还pua我们做ppt。一开始说鼓励做ppt后面就全部上交。上课讲的是图灵是计算机之父，作业是答案几百行的代码🤣还老喜欢随堂小测😂没吃过🪨的可以来试试
216276,9753,毛玉仁,2025-03-13 01:54:08,0,0,0,压榨学生
181375,9766,朱霖潮,2023-10-16 05:35:31,1,2,1,讲得还蛮清楚
182754,9766,朱霖潮,2023-11-20 05:31:16,1,1,0,讲课很好
189573,9766,朱霖潮,2024-01-25 12:28:27,3,3,0,ai导课程，老师讲的很清楚，质量很好有求必应。ps：上课掉落零食，睡觉也发（
190005,9766,朱霖潮,2024-02-08 08:05:51,9,9,0,老师讲课不错，也很用心。他讲课可能不是很久，所以他希望上课的同学可以多多互动反馈一下教学情况，对于发言的同学有小零食奖励，总之是不错的老师
206235,9766,朱霖潮,2024-12-13 10:08:34,2,2,0,讲的太好了
214998,9766,朱霖潮,2025-02-20 03:25:43,0,0,0,人基（A）老师很年轻活力，讲课特别有激情，而且很多时候能预判到学生的想法和需求，在讲课有很对实验的时候马上和我们说不用怕，都是一些很简单易完成的小任务。课堂也特别宽松“觉得能学到东西的那你就来，如果觉得没意思也可以不来做其他事”\n\nPs：回答问题随机掉落小零食
216823,9766,朱霖潮,2025-03-26 07:11:29,1,2,1,“**我已经管得足够宽了，你用任何工具我都不管你”\n\n“不不不，我不是这个意思，不能使用旁边的（停顿）智能体，至少不要影响旁边同学。。。”
221156,9766,朱霖潮,2025-06-21 14:07:54,3,3,0,分数还没出，我只想说人基（A）这门课就是答辩，答辩中的答辩\n\n不过zlc老师人还是很好的，虽然我没听课但是能感受出他讲课讲得也很好，而且会积极地和同学们互动，同时倾听同学们的学习情况，总体来说是一个年轻有活力、很不错的老师。\n\n最后希望期末考能捞捞我orz
221952,9766,朱霖潮,2025-06-27 15:49:29,0,0,0,非常好的老师
222002,9766,朱霖潮,2025-06-28 13:07:20,1,1,0,人基A这门课本身存在设计问题，上课对于代码讲解时间有限，有的lab难度很高，有的要很多截图比较繁琐，比较考察AI的运用能力(doge)，期末闭卷ppt重点也没有完全覆盖，而且是比较难的。但是，抛开这些问题不谈，朱老师是非常好的一位老师，人长得帅，也经常投喂小零食来活跃课堂气氛，上课也是很有趣的，专业也对口，对于同学的发言总是有积极的反馈，最后给分也还是比较捞的。我认为老师完全值得一个10分，希望老师能够让人基A这门课变得更好，让以后的同学能以学人基A为乐趣，而非痛苦。感谢老师!
216280,9903,柯翔宇,2025-03-13 02:00:39,1,1,0,无敌，给分高，不点名，其乐融融，老师还很友善
196623,9937,尤伟涛,2024-07-04 09:50:15,4,5,1,上了尤老师的dip，老师怎么说呢，是个正常的程序员出身的产品经理，做事儿也挺严谨，也接受概念设计，就是不那么人性化
196792,9937,尤伟涛,2024-07-05 07:28:58,2,2,0,呃呃呃
216000,9937,尤伟涛,2025-03-09 07:40:15,4,4,0,Good！
216264,9962,赵新奎,2025-03-12 23:13:50,0,0,0,老师人很好
193561,9981,姚培森,2024-06-13 04:39:44,11,11,0,很萌很可爱，课程压力小还会给我们发复习材料，爱了
193782,9981,姚培森,2024-06-18 05:03:36,2,2,0,无敌了
195431,9981,姚培森,2024-06-28 04:24:43,4,4,0,神，老师是做纯正 PL/SE 研究的，很懂编译这方面，上课可以看出老师自己的理解，而且有一些前沿拓展，给分也很好
195623,9981,姚培森,2024-06-29 05:20:31,8,8,0,森森很可爱，科研强，备课认真，懂学生，给分好！真男神😍😍😍！
195711,9981,姚培森,2024-06-29 17:26:31,1,1,0,非常体谅学生
196475,9981,姚培森,2024-07-03 16:17:32,1,2,1,能捞则捞，
197590,9981,姚培森,2024-07-20 11:30:29,2,2,0,温暖的人 温暖的心
198031,9981,姚培森,2024-08-26 03:47:20,2,3,1,森森上课深入浅出，很容易让人理解，科研上也很强；老师声音比较小，经常发散，听课时需要集中精神（不过实践发现走神了回来也能跟上？）；应试方面，复习可以看姚老师的ppt，比较容易懂
221590,9981,姚培森,2025-06-24 17:04:53,1,1,0,出分前先评论：人很好，不点名，没小测，这部分就直接给100了\n\n有一次课去了会加分
221956,9981,姚培森,2025-06-28 01:01:23,2,2,0,最后一学期选了编译原理，收获良多。
207194,10065,袁巩生,2024-12-19 16:28:37,0,0,0,很有亲和力
179050,10077,罗梦,2023-08-26 00:28:48,5,7,2,先给个班主任好评
184288,10077,罗梦,2023-12-15 12:25:32,2,4,2,我先来给我温柔美丽善良大方的班主任来个好评！
222031,10077,罗梦,2025-06-29 04:46:15,4,4,0,课是讲不明白的，给分是要阴人的。实验指导只说提交代码和思考题，因为报告分析少扣几十分，早说要卷报告啊，早说我就卷给你看😅
222036,10077,罗梦,2025-06-29 06:01:04,4,4,0,答辩给分。上课内容与其他课也是重叠的，作业是祖传的毫无心意的，最后给分也要强行在“一些无意义”的方面分个三六九等的。
218609,10103,周羿旭,2025-04-26 14:36:06,0,0,0,123
179339,10106,邹常青,2023-09-12 05:05:33,0,13,13,非常赞
179877,10106,邹常青,2023-09-20 02:41:24,0,10,10,自己讲给自己听\n\n根本听不懂\n\n磕磕巴巴
179885,10106,邹常青,2023-09-20 02:54:27,2,5,3,老师水平还是不错的，但是是第一次教本科生所以还是有点紧张哈哈哈
179918,10106,邹常青,2023-09-27 08:43:17,0,4,4,人蛮好的
179940,10106,邹常青,2023-09-20 10:30:10,12,15,3,老师上课态度，个人能力都是很不错的；但是毕竟是博导第一次上本科生的课；还是有点难抓重点，不是很具体，节奏掌握欠佳；不过是第一节课啦hhhh老师加油哇加油哇（老师可以自己在智云偷偷学一下其他老牌老师的讲课，翁凯，张彤yu，刘新国都OK
180607,10106,邹常青,2023-09-23 10:27:07,6,9,3,老师人很好呐～可能缺少教学经验但是真的很真诚负责啦！有问题问基本上都会回答滴。ps，盛赞助教！
180945,10106,邹常青,2023-09-28 14:49:34,29,33,4,这儿是一门助教不在一秒就会全然崩盘全员蒙蔽的课
181101,10106,邹常青,2023-10-08 13:17:24,9,11,2,讲课只有讲到华为和美国的时候是流畅的，作业超前布置，新手劝退
181177,10106,邹常青,2023-10-11 02:43:31,4,8,4,客观评价，上课确实上的不行，基本全凭自学，课外方面没了解过。
181795,10106,邹常青,2023-11-01 02:11:59,0,2,2,授课很认真负责
181935,10106,邹常青,2023-11-06 00:03:30,3,3,0,人很温柔，而且有助于提升自学能力
183942,10106,邹常青,2023-12-04 11:37:54,1,1,0,还不错
183999,10106,邹常青,2023-12-06 02:25:04,3,3,0,老师人还是不错的，问问题都会仔细解答…但是上课的确有点不太流畅，但这并不重要，因为基本得自学😇
185423,10106,邹常青,2023-12-29 06:25:10,5,5,0,这很难评，就是新手听不懂，学着很崩溃
185424,10106,邹常青,2023-12-29 06:43:30,5,5,0,人不错，就是上课基本没啥用
185679,10106,邹常青,2024-01-03 13:07:27,1,1,0,人很温柔，有不会的问题下课也可以去问，会耐心解答
187721,10106,邹常青,2024-01-17 08:14:25,2,2,0,温柔，但不太能听下去
188641,10106,邹常青,2024-01-19 12:43:13,2,2,0,人不错，课得自学。（助教gg太好了www，超级耐心，有问必答，平时分加满！！！）
188938,10106,邹常青,2024-01-20 17:12:33,9,10,1,10分中有九点九分送给助教🌹
188967,10106,邹常青,2024-01-21 02:14:02,5,5,0,助教是亲爹中的亲爹\n\n当然我觉得背后也肯定有老师参与（虽然老师上课讲的不太行）\n\n再次感谢sxk
191559,10151,陈明帅,2024-04-25 02:29:18,4,4,0,好老师，可选
191692,10151,陈明帅,2024-04-28 07:51:27,2,2,0,老师讲的挺好
194390,10151,陈明帅,2024-06-23 15:04:57,3,3,0,帅哥是我大学期间为数不多的认为讲课非常好的老师\n\n条理非常清晰，智云基本二倍速过一遍就能全听懂，ppt也做的很好\n\n选就完事儿了
195046,10151,陈明帅,2024-06-26 13:34:57,4,4,0,讲课很好，小测建议学在浙大交\n\n还没出分，来求捞一个
195633,10151,陈明帅,2024-06-29 06:08:18,4,4,0,老师讲课很好，人也很好。quiz可以学在浙大本周交，没点过名，但是偶尔会点人提问。期中出的题也比较友善，期末小寄，但是和老师没关系。放心选
195635,10151,陈明帅,2024-06-29 06:17:40,2,4,2,陈老师真的是很好的老师，虽然是新来的老师，但讲课我觉得真的比很多老教师好很多了。老师最后一节课也提到每周大概有一半的时间在准备这门课，真的是非常认真辛苦了！说回讲课，感觉老师的讲课算是计院我上过的课里top级别的，整体主打一个娓娓道来，讲的非常的清楚！我最后期末复习的时候感觉，因为平时基本每节课都有听，复习起来就很快，看看历年题目完善下A4准备准备大题就差不多了，最后考的也还行（就是题太多了，没完全写完，建议是选择和判断不要纠结...）。\n\n实验目前时间挺松的，虽然基本都是拖到最后做（ 难度微难？主要是类似的没太接触过可能，但问题不大\n\n我是平时分因为期中考的很不错，就基本满了，最后期末85左右，总评差一点点点点点点点点满(真的是一点点hh)，总体感觉体验非常良好，感觉可以无脑选，老师真的nice！
196104,10151,陈明帅,2024-07-01 15:56:44,4,4,0,帅哥讲课真的非常清晰，只要上课认真听基本都能听懂。课下因为上课有走神的地方找他问问题他也会很耐心的解答，绝对是我专业课里上过最好的老师之一了。虽然老师很年轻但讲课水平绝对是可以放心选的
221609,10151,陈明帅,2025-06-25 02:19:53,1,1,0,老师讲课很好！表白助教gg！冲！
197813,10209,范鹤鹤,2024-08-15 02:18:26,-2,3,5,AI背刺
202425,10209,范鹤鹤,2024-11-12 14:37:43,-9,2,11,人品有点问题
216220,10209,范鹤鹤,2025-03-12 14:04:08,-5,0,5,抽象怪
216926,10209,范鹤鹤,2025-03-29 07:24:18,6,6,0,老师非常棒
221885,10209,范鹤鹤,2025-06-27 06:18:37,0,0,0,很好的老师和助教，人工智能课给分很好，每一节课会带小零食给大家，ai课期末背背分不会低的
197983,10215,朱梦莹,2024-08-22 08:53:38,5,8,3,懂得都懂
201666,10215,朱梦莹,2024-11-05 08:08:25,3,4,1,哈哈哈哈
216824,10215,朱梦莹,2025-03-26 07:24:44,0,1,1,dddd
216826,10215,朱梦莹,2025-03-26 07:29:52,-5,0,5,讲课生动形象，为人和善
200076,10223,王小航,2024-10-12 10:49:01,1,1,0,还行，就是上课有点无聊
207301,10223,王小航,2024-12-20 08:43:34,1,1,0,还行吧
208580,10223,王小航,2024-12-29 14:56:46,0,0,0,上的体系结构，老师人挺好的就是好像对课程要求什么的不是很熟悉，甚至说出了平时分三十分这种话（甚至每次实验课都会去机房x），助教们特别nice，几次作业ddl都在学期末，验收实验的时候讲错了他们还会提醒点拨
211805,10223,王小航,2025-01-12 13:40:44,4,4,0,授课给予学生更多的学习方式选择，自学能力较强的学生灵活安排课程学习的时间
212838,10223,王小航,2025-01-15 04:35:12,0,0,0,老师确实很了解这个领域，但讲课不是很清楚，感觉他也不太知道哪些是考点（课件里写scoreboard不考，结果今年期末最后一道大题就是scoreboard），不过也不点名，可以去听别的老师的课，平时事也很少，考完应该是努力捞了，比较推荐
212851,10223,王小航,2025-01-15 05:06:26,6,6,0,上课事少给分高，没有小测和签到，体系选他准没错。
214673,10223,王小航,2025-02-16 10:48:31,3,3,0,非常欢迎同学提问，并耐心解答，人还是很不错的。
217977,10223,王小航,2025-04-18 15:21:20,0,0,0,很nice的老师，努力捞，对学生好。
220662,10223,王小航,2025-06-19 06:07:43,0,0,0,老师回答问题很耐心
220815,10223,王小航,2025-06-20 03:09:51,3,4,1,考完试了，来给wxh老师打个评分。说实话wxh老师很符合我身边一些人对于好老师的定义，没有点名，没有小测，没有其他体系结构班级有的pre。验收虽然会问一些问题，但都是课堂上讲过的，只要认真听课（听谁的无所谓）都能回答上来。bonus还比较简单且有意思，算是期末周的一种放松吧。而且考试完还会开放作业、实验和bonus让没提交的重新提交。先十分奉上，等出分再回来打一个awa
221854,10223,王小航,2025-06-27 02:36:49,1,1,0,事情少给分高，有自学能力非常适合
221856,10223,王小航,2025-06-27 02:41:58,1,1,0,事少分高，如果有一定自学能力的话能上的很轻松并且拿到一个很好的分数
221857,10223,王小航,2025-06-27 03:56:23,2,2,0,不点名，不小测，给分好。强推！
221858,10223,王小航,2025-06-27 02:53:26,2,2,0,2024-2025春夏学期上王小航老师的体系结构课，无点名，无小测，无期中考，虽然讲课略显无聊、PPT质量一言难尽，但是这门课是我上大学以来遇到给分最好的一门课，身边很多同学也给出了类似的评价。为了绩点选王小航老师准没错，强力推荐！！！
221860,10223,王小航,2025-06-27 02:56:40,1,1,0,事少分高，强推！
221862,10223,王小航,2025-06-27 03:22:39,0,0,0,出分了，wxh老师是我心中的真神\n\n上课不点名，没有任何pre之类的任务，实验PPT写得很清楚，只要把实验PPT看一遍（记得关注PPT每页的备注，写得非常清楚明白）实验和验收就不是问题。\n\n航门！
221896,10223,王小航,2025-06-27 08:31:53,0,0,0,老师人很好，有问题都很耐心解答，作业ddl是最晚的，别的班出分好几天我们作业还没截止，事少分高，重点是很有个人魅力～ 期末考试的时候半小时提醒一次注意事项，生怕我们拿不到分
215884,10247,陈佳伟,2025-03-06 12:34:18,1,1,0,0.0
216307,10247,陈佳伟,2025-03-13 04:31:58,4,4,0,适合学过信竞的同学听课，实力应该很强，挺幽默的，但表达0分。大佬听他的课应该挺惬意可以当小品听，但没基础的同学就挺痛苦的(）
207195,10266,王皓波,2024-12-19 16:29:03,5,6,1,很好的年轻老师
214243,10266,王皓波,2025-01-30 17:14:57,5,6,1,个人认为现阶段来说，可能是浙大最好的老师之一。
215871,10266,王皓波,2025-03-06 07:37:13,0,1,1,学术大牛
208503,10286,刘振广,2024-12-28 13:01:20,1,1,0,非常好老师，课程综合实践2事情相对别的班多一点 7个小实验1个大作业 会点6次名，早上正课，下午实验课，实验指导比较细，一步步跟着做就行，大作业一个月后展示答辩 最后收获了满绩
213773,10286,刘振广,2025-01-19 16:41:07,0,1,1,‎‎‎
204044,10290,房子荃,2024-11-23 11:14:25,0,1,1,老师人很好啊
209833,10313,周经森,2025-01-07 07:59:29,1,1,0,呵呵了
210577,10323,柳晴,2025-01-09 11:30:00,3,3,0,李环/柳晴老师今年第一次上os，班上的同学主要是软工专业的。楼主室友基本是jjm老师班上的，所以平时也有一些比较\n\n李环/柳晴老师是非常年轻的老师，也很认真负责，貌似是浙大直系学长？\n\n各种意义上不输jjm等老牌教师，班级ddl时间合理，碰到期中考试周会延长，期末也放宽了bonus期限，比jjm班紧凑的ddl导致没时间做bonus舒服很多\n\n小测也是十分放水，柳晴老师以Aha Slides的形式进行，答对50%以上就给满分，否则得一半得分，李环老师的纸质quiz只要去了就是满分\n\n平时课上也会用Aha Slides进行互动答题，但是不要求实名，所以你参不参加都行（\n\n平时没有签到，上课发言可能有bonus，但是我不怎么去教室\n\n这学期的三位助教哥哥姐姐也很nice，验收只问一两个问题，而且不会刁难，貌似也只有1和0的区别，验收压力没jjm班那么大（体系下课去参观过他们班验收，人山人海x）\n\n总是选到就是赚到\n\nPS: 还没出分，环哥/晴哥捞我！
198200,10335,甘磊磊,2024-09-04 17:02:07,0,0,0,慎选吧，养鱼
219022,10335,甘磊磊,2025-05-19 05:43:27,0,0,0,浙大院校代码处打卡
200049,10357,李环,2024-10-12 01:55:09,18,22,4,好老师！
203951,10357,李环,2024-11-22 08:12:23,9,12,3,好老师，好助教，希望期末有个好绩点~
210573,10357,李环,2025-01-09 11:28:57,8,9,1,李环老师今年第一次上os，班上的同学主要是软工专业的。楼主室友基本是jjm老师班上的，所以平时也有一些比较\n\n李环老师是非常年轻的老师，也很认真负责，貌似是浙大直系学长？\n\n各种意义上不输jjm等老牌教师，班级ddl时间合理，碰到期中考试周会延长，期末也放宽了bonus期限，比jjm班紧凑的ddl导致没时间做bonus舒服很多\n\n小测也是十分放水，柳晴老师以Aha Slides的形式进行，答对50%以上就给满分，否则得一半得分，李环老师的纸质quiz只要去了就是满分\n\n平时课上也会用Aha Slides进行互动答题，但是不要求实名，所以你参不参加都行（\n\n平时没有签到，上课发言可能有bonus，但是我不怎么去教室\n\n这学期的三位助教哥哥姐姐也很nice，验收只问一两个问题，而且不会刁难，貌似也只有1和0的区别，验收压力没jjm班那么大（体系下课去参观过他们班验收，人山人海x）\n\n总是选到就是赚到\n\nPS: 还没出分，环哥捞我！
211009,10357,李环,2025-01-10 10:25:03,4,5,1,操作系统体验很好。李环老师和柳晴老师都很年轻，讲课不错，很为同学着想，从作业到ahaslides的“quiz”到单元总结都是以让同学们学会操作系统为目的设计的。三位助教也幽默风趣认真负责。选了肯定没错
212116,10357,李环,2025-01-13 08:02:55,-1,1,2,认真负责，幽默风趣的好老师
212123,10357,李环,2025-01-13 08:26:20,2,2,0,对一个比较划水的学生而言 给分超过预期 上课体验也很好！助教gg jj都很好
212130,10357,李环,2025-01-13 08:34:36,-5,0,5,充满诚意的老师和博学负责的助教，直接把OS的体验拉满了ovo，可以说是大学四年体验最好的课程之一了。\n\n环哥上课相当给力，每节课有ahaslides(不计入总评的答题游戏)，第一有咖啡券/奖品；助教哥哥姐姐也在实验部分各种加持，整个实验流程+bonus走完以后会有很多额外的收获。\n\n小测甚至只要50%对就算满，两次作业也主要以自主复习为主，最后给分也相当好。环哥伟大！\^o^/
212379,10357,李环,2025-01-14 02:30:41,0,1,1,超级无敌好的老师！
213390,10357,李环,2025-01-17 07:23:34,0,1,1,很不错的老师！
214449,10357,李环,2025-02-05 03:31:30,0,1,1,好老师，操作系统课程整体体验很好。\n\n在理论作业上，只有两次作业，第一次是让AI出题做相对来讲量比较多但是比较水也能帮助我期中复习一下之前学的知识，第二次是正常出题做量不多，作业应该是交了就有分；\n\n在授课上，老师一般依照着PPT内容讲述课程同时会拓展一些内容便于理解和深化，PPT上的内容其实就是英文教材对应章节的简化版(当然不是完整的)，每次课前会有课前小游戏帮助同学们回顾上一次课的知识(课前小游戏就是单纯的回顾是不算分的)，因此如果认真跟着老师上的话基本能够掌握并记住课堂讲授的内容，但是最终考试肯定还是要刷刷王道考研题或历年卷的嘛，这点可以看看操作系统的经验贴；\n\n在小测上，柳晴老师是Slides形式的小测(就和课前小游戏的形式相同，这种形式小测最烦时间紧凑但是经过反馈之后的答题时间应该都会比较长了)50%正确即满分，李环老师是纸质小测应该是交了就满分，如果过于担心小测就在平时多看看王道书上对应章节的考研真题，Slides上的题目很多都是考研真题；\n\n在平时实验上，实验与课题组的整体实验是一致的都是采用MiniOS，理论上可以组队完成，但是同学们大多都是solo完成的，整体实验安排比较紧凑和合理，验收也不会太刁难，而且应该在平常实验(除了bonus外)不会做的时候可以请教助教，同时平时实验的分数据助教所说都给在90分以上。在最终考试上，老师给了我们一份之前学长的3页A4纸作为复习参考，但是真正复习的时候最好能够过一遍考研真题（3页A4纸的参考上也有一些小错误大家复习的时候要注意）。\n\n整体体验上来讲，李环和柳晴老师的操作系统课体验很好值得推荐。
216770,10357,李环,2025-03-24 11:45:38,1,2,1,好老师！！
218615,10357,李环,2025-04-27 03:27:11,0,3,3,byd老师装的很好，看似真诚实则虚假，有点pua。（不评价上课）
199466,10416,彭思达,2024-09-24 06:48:26,1,2,1,cv好好好
198320,10548,冯博,2024-09-07 02:17:02,10,10,0,系统1理论课，讲得是真的晦涩枯燥且助眠，我觉得能听下来他一节课的都是神人了\n\n偶尔还有雷达/数字点名\n\n硬件的大门就此对我关闭.jpg
198688,10548,冯博,2024-09-11 01:26:37,3,3,0,不是很有备课痕迹的样子，非常清澈的课的上，认真读ppt+时不把自己挂黑板，听课体验很难评XD
198745,10548,冯博,2024-09-11 08:29:47,7,7,0,大一下上了冯博老师的系统一，老师为人很和善，但感觉授课方面不太行，上课的时候语气过于平淡，很难让人聚精会神地听课，讲的内容也基本与PPT重合，系统一也是我迄今见过缺课人数最多的课了，到学期后半段每节课几乎只有不到十个人去听课（当然我也没去，我也是后来观看智云回放的时候发现的），不过因为很少去听课，我的系统一理论也学得一塌糊涂。
198837,10548,冯博,2024-09-12 05:38:20,6,7,1,第一个让我觉得课堂效果不如智云课堂的老师，上课水平一言难尽……上课很催眠，有点让人不知所云。\n\n另外，2023-2024学年计算机系统1挂名的是常瑞老师，但是实际上课的都是冯博老师。
202720,10548,冯博,2024-11-14 03:48:16,2,3,1,人挺和善，上课巨烂
214684,10548,冯博,2025-02-16 17:16:47,12,12,0,诗人握持~
215540,10548,冯博,2025-02-28 02:19:56,6,6,0,讲课听不明白在干什么
215677,10548,冯博,2025-03-04 03:38:35,4,4,0,讲课确实不行啊
215793,10548,冯博,2025-03-05 14:21:24,4,4,0,上课感觉自说自话，实验课也是全靠TA
216349,10548,冯博,2025-03-14 02:20:29,3,3,0,老师是有水平的，性格也平和，也很好交流。但是教学一言难尽。感觉不是知识讲不明白，而是计算机系统课程安排就不合理，经常会有学生要在实验课上完成某个项目，相应知识只能自学，而这些知识后来才被教授。有种割裂感…
217050,10548,冯博,2025-04-01 02:22:13,2,2,0,老师人挺温和，问的问题也会回答。\n\n但是…感觉是个科研佬，虽然年轻但看着挺憔悴的…也没时间备课估计，他的计算机系统Ⅰ还是适合自学
217873,10548,冯博,2025-04-17 09:47:44,0,0,0,要注意有雷达点名…
197316,10707,陈昊,2024-07-11 01:46:36,7,8,1,之前上过老师的ads，看了一下发现査老师上怎么没有评论，帮顶一下，老师很好，上课有激情，体谅学生
198590,10707,陈昊,2024-09-10 05:58:54,3,3,0,真的是一个超级nice的老师吧 讲课条理清晰 课后也会非常耐心回答问题，真的是超级好的老师！（推荐要是有科研也可以来找他哟！
201469,10707,陈昊,2024-11-03 13:50:08,2,2,0,非常非常好的老师ovo
201699,10707,陈昊,2024-11-05 13:21:31,5,5,0,陈昊老师人很好！上课之前还会放Instant crush，非常好听！♪(´▽｀)
206642,10707,陈昊,2024-12-17 02:15:29,2,2,0,上过ch老师的ads\n\n老师每个学期都会改进课件，课上对课程内容也会提出自己的思考跟理解。另外每个学期老师也会发布每一讲对应的题库方便同学们复习。\n\nch老师平时分给分非常慷慨，体现为加分途径非常多而且简单易行。课上发言可以全组（3人）加分，在群里提出值得思考的问题可以加分，同理在钉钉群或者课上回答同学提出的问题也可以加分。pre做的好可以加分等等。以上所有途径都可以直接+平时分1～2分，而且是全组共享，结果就是一个班期末有2/3的同学平时分满分，非常值得一试！
206866,10707,陈昊,2024-12-18 04:51:28,10,10,0,昊哥是年轻老师，上课态度很好，平易近人，与他交流沟通都很容易，有科研（特别是ai）问题也可以问他。唯一的不足点是老师是搞人工智能方向研究的，可能在某些特别刁钻深入的问题上不如课题组里那几位搞算法研究的老师，但瑕不掩玉，昊哥真的很nice，而且平时分给的也很好
207578,10707,陈昊,2024-12-23 07:19:44,2,2,0,从不点名，平易近人，喜欢daft punk，讲课讲的也很有活力，平时一直想办法提高学生们平时分。完全值得一个10分！
208224,10707,陈昊,2024-12-26 08:14:52,0,0,0,好老师！一个学期从来没点过名，很关心学生，变着法儿给加平时分
210614,10707,陈昊,2025-01-09 12:32:13,0,0,0,ads，老师平时分很大方，讲的也是比较清楚的。
216457,10707,陈昊,2025-03-17 00:23:31,0,0,0,超好的老师～
198809,10709,张聪,2024-09-26 13:42:42,3,3,0,第一节课感觉不错，希望后续老师少点名（硬币一定要出现反面啊！），也希望老师多给点分在平时分上。\n\n老师的授课很“阿妹你坎”，用的是传统的黑板板书，并且会时不时问大家听懂了么
201359,10709,张聪,2024-11-01 05:45:54,4,5,1,数据安全与密码学基础： 很有耐心也很细致。课比较新，所以老师询问我们上课内容的意见，比如偏向证明或者是应用
208207,10709,张聪,2024-12-26 07:31:35,0,1,1,授课速度、授课方式都很完美，也很考虑学生的感受。注重打好学生的基础，学期体验很nice（就是早八我起不来
213417,10709,张聪,2025-01-17 08:55:20,2,3,1,数据安全与密码学基础：我们是张老师第一次上这个课的学生，所以有些东西张老师才在摸索。上课不用PPT，是纯手写版书，而且是英文版书（但授课讲话还是用中文）。课程内容是纯理论的，就跟一门数学课一样，与先前白老师的密码学不太一样，因为上课不用PPT，所以建议要么认真听课，要么抱着原著自学，反正看智云比较困难，也没有补天用的PPT。张老师还比较体谅学生，反正有好多次操作都是帮我们减轻负担（包括第二次作业说是参加期末考试就给满分），上课也会经常问大家明白没有。给分也比较好，通过期中考试就能看出来改卷特别松，很多题言之有理就给分。然后还有一个学期四次点名，点名也会占总评的一部分。总体而言事不多，两次作业，四次点名，一次期中，一次期末。课程本身的难度就看自己了，想深究的话有些证明感觉挺难的，但想只应付一下考试倒还好。
214443,10709,张聪,2025-02-04 10:43:25,0,1,1,作为专业课给分较为随意......
198436,10710,张明雪,2024-09-09 02:39:54,13,13,0,讲的真好（虽然我是预习过后的）但是老师确实有自己的理解，学完Cplus后再听还是有收获^_^ 声音很温柔
200053,10710,张明雪,2024-10-12 02:19:01,7,7,0,不像第一次讲课的\n\n比计院的其他讲了几十年的煞鸟讲的好多了
202303,10710,张明雪,2024-11-11 11:04:11,6,6,0,上完一半了，讲课挺好的，感觉比隔壁czp好，虽然都是用的czp的ppt \n\n等期末出分看看给分咋样，先点个9
202385,10710,张明雪,2024-11-12 08:09:25,4,4,0,上了一半了讲的挺好的，也不点名，等期末出分了再来看看
208887,10710,张明雪,2025-01-03 05:51:11,2,2,0,好，选就完事了
213655,10710,张明雪,2025-01-19 02:00:50,4,4,0,出分后来评价，我愿称张老师和她的助教azx学长为神！给分超好，平时作业只要及时上交，认真完成不会给差分，期末认真复习，多做历年卷熟悉题型大概率也不会考很差（我们这一届期末的题目有点偏向于概念题，有很多考概念辨析这种的）。老师上课时会温温柔柔地将一个个知识点细化拆分讲给我们，下课去问问题也是很耐心地帮忙解决。助教哥哥也超级超级好，会在实验课等大家来问问题，帮忙指导大作业，平时和期末去问问题也超及时地回复，能力很强！
213667,10710,张明雪,2025-01-19 03:28:20,3,3,0,外专业来修的oop，老师超级好，讲课很好很清楚，很有耐心很温柔，下课答疑对同学也很有耐心，前面几节课稍微随机点了几次名字后面没再点过，可能老师第一次带oop的课还没安排太好。老师的课给分超级好，本来考前感觉自己没太学懂很慌，最后期末周熬夜补天没想到拿到了本科分数最高的一门课，大三老狗真的开心死了，非常感谢老师和助教哥哥，明雪姐姐的课强推！！
213728,10710,张明雪,2025-01-19 10:13:58,1,1,0,老师讲得很好（虽然上课比较快并且声音有点轻），ppt也很清晰，\n\n无点名（虽然一开始说是算成加分的但是最后一次没点），\n\n没有布置乱七八糟的选择题作业，一个学期只有七次project。\n\n\n\n老师和助教给分也非常好！
214150,10710,张明雪,2025-01-25 16:17:25,2,2,0,老师不点名，讲课真的算很好了！讲的很清楚上课的人都挺多，ppt稍微有些潦草但是讲课很好！助教和老师的给分也很好！
214854,10710,张明雪,2025-02-18 09:44:37,1,1,0,很好很好，讲课好，给分好，照顾学生，调休课堆在一起/期中考试还会给学生作业延期ddl
220693,10710,张明雪,2025-06-19 08:37:20,0,0,0,讲的清楚明白，速度稍快，期末看回放能听懂
216984,10749,杨坤,2025-03-31 02:45:07,3,3,0,杨坤老师，您来啦！欢迎您来到查老师平台，这下轮到我给你签到了————杨坤同学你到了吗？
217813,10749,杨坤,2025-04-17 02:18:25,2,2,0,yk老师居然被加进来了，那么我把原来的评论搬运一下:\n\n上课水平一般，点名严格。但最后给分不错（主要有助教gg的功劳）。考虑到计组课大家都听马德智云，如果选不上马德老师，yk老师可选，认真学习马德智云加上助教gg捞捞实验，同样可以获得好成绩。\n\nPS: 助教gg真的很捞， yk有次上课说: 这个助教很nice， 有的时候我都觉得太宽松了
219097,10749,杨坤,2025-05-21 11:02:41,1,1,0,坤哥也有主页了，打分支持一下
219100,10749,杨坤,2025-05-21 11:08:06,3,3,0,yk老师终于有自己的主页了，我哭死，喜欢搞那纸质签名数人头，一到早八就点名；上课固定迟到10分钟起步，同学们我从萧山来，路上太堵了；早八全班来上课，唯独昂们坤哥没来上，杨坤同学，你这节课没来是什么意思，平时分给你扣光光；没来上课也就不说了，一句道歉没有，就调课到周六周天，周天还赠送一次小测，你不得不来。。。。。。临近期末，坤哥美其名曰划重点，实则贪玩ppt，鼠标滚轮快速滚动量子教学法，最后不想讲了让同学起来说重点。。。。。。好在是两位助教gg特别给力特别nice，验收不用上板，只看仿真，而且有小问题也给你算过。总结，助教决定一切
219388,10749,杨坤,2025-05-26 08:04:40,2,2,0,评价的是网安学院的老师。老师每节课都迟到，有时候找助教代课，两次早八翘课，事后来一句：同学们，调课忘记通知了，我们下次补吧！调课调到周日晚上，还要小测。。
220759,10749,杨坤,2025-06-19 14:12:05,1,1,0,笑死了。。。上课迟到起步十分钟，总是忘记调休上课，美名其曰自己没收到通知or忘了。。。一天到晚纸质点名，但是助教人还是很好的
