评论id,老师id,老师姓名,发表时间,点赞减去点踩数量,点赞量,点踩量,内容
52607,34,翁小乐,2017-06-21 11:11:20,1,2,1,讲的很清楚  很细  看得出来老师备课也很充分  一级棒！\n\n
124263,34,翁小乐,2020-06-28 07:08:09,1,2,1,老师上辐射防护就是拉低自己评分
159292,34,翁小乐,2022-07-11 02:43:35,0,1,1,呵呵呵呵呵呵
185855,34,翁小乐,2024-01-05 03:15:47,0,0,0,辐射防护这门课极不适合非环资同学报，但是老师挺好的
23182,303,刘杏梅,2016-03-21 06:12:21,1,1,0,太无聊了。完全念ppt。为什么会有这样的老师，啊啊啊啊啊
90393,303,刘杏梅,2018-11-23 10:44:47,-1,0,1,好老师！强推！给分好，还有KFC！
124163,303,刘杏梅,2020-06-26 04:19:31,2,2,0,上课有点无聊，也没学到啥。自然资源学留念。\n\n
180356,303,刘杏梅,2023-09-21 08:01:10,0,0,0,刘老师人超级好！对学生很温柔！
202662,303,刘杏梅,2024-11-13 16:07:35,0,0,0,老师人很好 上课稍微有点水水的 给分超级好！！第一门满绩的专业课 感谢老师！！
117397,409,朱利中,2019-09-24 02:20:13,0,4,4,很有激情
28060,421,翁棣,2016-06-28 08:03:09,5,8,3,老师有病，期末了幺蛾子还多，虽然给分高，但不会给你时间复习其他课（好生气但还是要保持维笑）
78403,421,翁棣,2018-05-11 10:50:33,-3,1,4,只能说真的老了，上课有点搞不清楚，但给分很高。
83100,421,翁棣,2018-07-09 16:20:45,-2,4,6,老师挺不错的，人很好，要注意与同学相处方式，很多同学都有看法，但相信老师心里挺好的，给7分吧
109959,421,翁棣,2019-06-20 13:59:35,9,9,0,噪声念zaosheng不念caosheng
122966,421,翁棣,2020-04-26 13:16:18,0,1,1,事贼多，报告可以改好几遍，步骤3000字抄写
124943,421,翁棣,2020-07-23 05:48:00,-17,1,18,典型的刀子嘴豆腐心\n\n老师好可爱
151866,421,翁棣,2022-03-18 13:23:44,0,0,0,奥楚蔑洛夫
153246,421,翁棣,2022-04-27 05:23:24,4,4,0,但凡带点脑子也不会觉得才提前几分钟到就没问题的纯沙口
153994,421,翁棣,2022-05-18 14:43:42,16,17,1,😅😅😅😅😅😅😅😅😅😅😅😅😅😅😅😅😅😅😅😅😅😅😅😅😅😅😅😅😅😅😅😅😅😅😅😅😅😅😅😅😅😅🤗🤗🤗🤗🤗🤗🤗🤗🤗🤗🤗🤗🤗🤗🤗🤗🤗🤗🤗🤗🤗🤗🤗🤗🤗🤗🤗🤗🤗🤗🤗🤗🤗🤗🤗🤗🤗🤗🤗🤗🤗🤗😀😀😀😀😀😀😀😀😀😀😀😀😀😀😀😀😀😀😀😀😀😀😀😀😀😀😀😀😀😀😀😀😀😀😀😀😀😀😀😀😀😀
153995,421,翁棣,2022-05-18 14:31:06,11,11,0,呵呵呵
154116,421,翁棣,2022-05-24 04:19:16,6,6,0,可以说是大学体验最差的一门课
154161,421,翁棣,2022-05-25 02:41:10,7,7,0,一言难尽😄☂️🌧️
154171,421,翁棣,2022-05-25 03:58:18,7,7,0,zhaidai（窄带）不念zhadan（炸弹）
154179,421,翁棣,2022-05-25 07:05:00,7,7,0,4:40下课的课每次都拖到七八点，还从不改变上课进度，真无语
154211,421,翁棣,2022-05-26 05:45:05,9,9,0,提前祝您退休快乐😄以后就没有人欺负您了😅您也不用祸害下一届了🤡
155354,421,翁棣,2022-06-11 12:02:45,1,3,2,你要是不退休，每年想润的学生会更多😅 充分诠释了什么叫 Sb也能当老师😅
155368,421,翁棣,2022-06-11 15:33:10,4,4,0,返聘10分，不返聘就地退休0分
155592,421,翁棣,2022-06-14 14:09:22,1,1,0,谢谢老师退休 再见了您内
156393,421,翁棣,2022-06-19 10:26:29,1,1,0,…………
157122,421,翁棣,2022-06-22 03:27:03,1,1,0,一言难尽，不过退休了就不会祸害以后的学生了
158329,421,翁棣,2022-06-28 11:01:40,5,7,2,一锤子敲烂你婊子妈的狗头😅
4911,432,赵和平,2017-12-22 13:57:19,41,64,23,不点名是真不点名，就是展示有点多
6349,432,赵和平,2015-07-13 06:28:34,-26,13,39,没用，一堆废话，上课还很烦
6396,432,赵和平,2015-07-13 14:17:08,5,20,15,通识课 上课内容太专业 又爱放没有字幕的英语视频 闭卷考 给我们11个ppt背 考的比我专业课还难 给分是这学期所有课程中最低 还做了三次小组展示。
6601,432,赵和平,2015-07-16 06:32:49,33,42,9,发音巨好听
6764,432,赵和平,2015-07-22 12:37:40,8,20,12,不点名，长学期的课会有4次小组展示，最后闭卷考试，11份的ppt要背专业术语，比如：“请写出响度级的定义”等等。最后得分个人很低，是目前为止所有课中最低的。
6945,432,赵和平,2015-08-22 23:36:24,22,27,5,会讲很多有意思的东西
8820,432,赵和平,2015-09-28 09:03:06,10,18,8,很棒的老师
15915,432,赵和平,2016-01-16 15:09:22,29,36,7,老师坚持上一门“不水的通识课”。科学技术与环境健康是一门长学期通识，老师很负责备课，也有很多独到社会经验。向前面的人所说展示的确多，最后考试有点细。
16543,432,赵和平,2016-01-18 10:37:51,-29,7,36,一个自负又不考虑学生感受的老师
18576,432,赵和平,2016-01-22 05:16:21,12,23,11,做了组长，很努力地完成了任务，小组也得了前3，但是作为组长只被打了3.9，下面小兵惨不忍睹。考试真TMD难。事多很烦
19061,432,赵和平,2016-01-23 07:16:19,2,8,6,和平oba简直男神，给分超级棒，讲课特别认真，与学生关系都非常好！
22599,432,赵和平,2016-03-08 10:44:55,19,23,4,上了他很不水的通识课。确实是非常好的教育者，第一节课就能感受到他很深刻的教育理念。边上的一圈新生听得津津有味，虽然我并不是对环境很感兴趣，听多了会有点枯燥。但确实能学到比知识更重要的事。
22606,432,赵和平,2016-03-08 14:25:08,11,15,4,His sincere passion to education will make you moved.
22637,432,赵和平,2016-03-09 03:54:21,6,9,3,特别喜欢这个老师，上课超级好玩，老师传授很多有趣的知识，老师说话声音特别迷人！
26006,432,赵和平,2016-06-15 04:13:23,6,10,4,展示太多，但是确实是一位好老师
26607,432,赵和平,2016-06-20 10:42:30,2,6,4,因为是秋冬学期的课，所以主讲不是赵老师，但是赵老师一开始有来上过，后来还来代课一次，感觉老师口语吼吼听，讲课很有热情，ppt嘛，自己整理一遍背一下考试还是可以应付的啦，最后成绩还是可以的
28338,432,赵和平,2016-06-28 08:35:57,5,9,4,男神！以后还有机会上他的专业课，感觉吼开心！
29565,432,赵和平,2016-06-30 03:39:42,2,6,4,人蛮好，会分享很多在国外的小故事，上课也挺有趣，虽然平时讨论课有点多但是最后居然给分不错呐
29591,432,赵和平,2016-06-30 04:27:36,2,6,4,和平老师太男神！！讲课很有意思！！说话很好听！！如果放的视频有字幕就更好了！！给分还不错！！
29621,432,赵和平,2016-06-30 05:13:32,0,5,5,老师人很用心，给分很好
29647,432,赵和平,2016-06-30 06:15:32,4,4,0,展示比较多 会点名 会讲段子 给分一般
35638,432,赵和平,2016-11-10 07:37:08,5,9,4,真男神，很man，讲课很好还会讲讲自己的有趣经历，很专业
37492,432,赵和平,2016-11-19 06:09:01,3,7,4,讲课很不错，会讲一些实例，以及他自己的一些经历。讲课很有意思，会学到很多东西。展示可能有点多，但很喜欢这老师的课。
38358,432,赵和平,2016-12-01 01:04:35,2,5,3,超级有意思。
39375,432,赵和平,2016-12-22 09:00:38,0,8,8,非常有趣！！！！！！！！！
44869,432,赵和平,2017-01-18 12:03:19,7,11,4,事情多，给分完全靠运气，展示明明做的前四前三，自己也出了很多力，绩点还这么低\n\n
48120,432,赵和平,2017-02-28 14:43:32,0,10,10,很喜欢赵老师，虽然课堂会随机点名回答，但上课是真的很有趣很多干货，上了一次课就成了赵老师的迷妹。开卷考挺简单的，内容都在ppt上，三次小组展示稍烦。小组展示排名一般，考试还不错，最后4.8
51913,432,赵和平,2017-06-13 12:31:08,6,8,2,老师人超好~上课很有趣~
52901,432,赵和平,2017-06-23 12:00:28,22,28,6,大学课堂应该有的模样就是赵老师的课
53822,432,赵和平,2017-06-27 17:21:09,18,21,3,赵老师能带你环游世界哦(´-ω-`)
55200,432,赵和平,2017-07-01 03:36:36,13,16,3,老师课讲的很棒，会讲在国外的一些经历，最后考试50分书本知识，另外50分论述题要了解一下平时展示的主题的相关内容，考的有点细，但是大部分都是划重点的地方，写定义的第一题是环境污染，然鹅没有背这一条而不会（摔）。展示有点多，three presentations and a debate.还有最好不要水课吧，from一个上课玩手机被老师打头的人（哭）
55638,432,赵和平,2017-07-02 05:28:47,22,23,1,课堂互动很多\n\n其实感觉课程整体都已经可以当通核课了\n\n通识教育精神发扬的非常棒\n\n每节课都有独到的人生哲理和外国经历\n\n课程干货很多很丰富\n\n英语德语也讲的很棒\n\n不要水过这么有意义有内容的课！\n\n没有想到可以在通识课中遇到这么认真的老师\n\n满分满分
57334,432,赵和平,2017-07-06 22:56:49,8,10,2,老师很好的，坚持不上水课。每节课都认真备课，把故事融进课题里，展示有点多，但还好，小组成员都很努力，不抱怨，展示排名也很满意。考试的话，上课听一听，考前强化记忆背诵一下那些专业术语就好了。那些说给分低的恐怕大多原因在自己吧。最后给分也不错，谢谢老师
75353,432,赵和平,2018-03-09 06:21:40,15,18,3,考虑学生的感受，课下答复特别认真，尊重学生。上课很有意思，很期待上老师的专业课。\n\n声音特别好听，喜欢赵老师。
76839,432,赵和平,2018-04-24 10:49:16,25,28,3,老师的who tm care是最骚的
76842,432,赵和平,2018-04-24 12:14:46,15,22,7,展示的恶竞是真的严重
76848,432,赵和平,2018-04-24 13:09:41,5,11,6,赵老师是我见过少有的如此热情专业地对待通识课的老师，课程展示虽然很费时间，但真的锻炼了我的表达能力！
79534,432,赵和平,2018-06-08 09:28:27,-6,10,16,我觉得 一个老师站在讲台上就不应该把今天的糟糕心情显现出来 冲学生发火 还有一个受国外教育这么多年的老师 不能容忍上课开电脑我tm也是醉\n\n还有 老师并不每次都很认真的回邮件好吗……\n\n还有觉得在课堂上不是环境工程专业的学生 及其没有存在感 好像他上课全都是给环境工程学院的学生上课似的...
79613,432,赵和平,2018-06-21 00:00:15,2,6,4,能学到学习之外的很多东西，展示和辩论只是老师给的一次锻炼的机会。
79666,432,赵和平,2018-06-12 13:39:01,7,16,9,千万不要选科学技术与环境健康，事情真的超级多，三次展示和一次辩论，不亚于通核课，恶竞超级超级严重，虽然老师上课还可以，但是对中国文化了解太少。要再次强调恶竞非常非常严重！！！
79967,432,赵和平,2018-06-28 14:24:12,0,0,0,
80430,432,赵和平,2018-06-26 11:37:52,8,12,4,老师本身还可以，但是不要选这门通识课啊！！并没有很大收获，和时间付出绝对绝对不成正比，老师对同学期待和要求太太太高了，这只是通识课啊！真的很费事
80431,432,赵和平,2018-06-26 11:43:52,2,4,2,超级好
80634,432,赵和平,2019-06-10 05:48:38,4,8,4,以前总认为人感冒了声音会变得更好听，但老师无论是感冒了还是没生病，声音都特别好听。\n\n   最让人心暖的一点是老师特别尊重和关心学生，课后解答或回复都特别认真(想到别的老师一天内收到的邮件数量就明白了。记得赵老师从没提到过一天内收到多少邮件)。还有，个人觉得老师身体里面装的是一个既充满活力又充满好奇心的纯真的孩子。至于课堂，学到的课堂外的东西比课堂上的多很多很多。唯一烦的是考试有点....\n\n总之，个人认为教授应该有的才能、品德、思想等在老师身上都能找到。超级超级喜欢赵老师。
84284,432,赵和平,2018-07-12 12:25:37,4,5,1,给分真的差。做了展示参与了辩论最后背了这么多东西，结果被正态了
84286,432,赵和平,2018-07-12 12:35:35,3,3,0,请不要让我卡绩点 ????
84290,432,赵和平,2018-07-12 12:43:58,2,3,1,\n\n\n\n小组展示成绩很好，考前背了一天半，倒数第二、三次课透露总评看平时作业的。绩点2.7(^_^)
84292,432,赵和平,2018-07-12 12:46:20,2,2,0,看了一下学习帝，感觉考得好的人挺多的，慢慢的羡慕啊\n\n
84349,432,赵和平,2018-07-12 15:26:05,0,0,0,233
86083,432,赵和平,2018-09-05 02:47:20,2,2,0,不知不觉地让人很专注，课堂及课后学习效果也很好，给分也不错。特别是老师的幽默和对课程的热情，值得推荐。
108342,432,赵和平,2019-07-20 04:15:58,0,2,2,课程偏水，不过挺有趣的，老师也会提问和同学们一起互动，小组四次展示，认真准备，花样多一点，考试之前好好背，卷子认真写，多写点，字写好，收获还是不错的
108576,432,赵和平,2019-05-29 02:34:03,3,3,0,老师超好
108932,432,赵和平,2019-06-04 10:41:25,1,4,3,老师打破他不点名的规矩啦，快把我顶上去
111545,432,赵和平,2019-07-02 01:57:58,3,3,0,会跟你讲他在各个国家时候的故事，也会教你一些做人的道理。怎么说呢，上完课后即使绩点低，我也觉得值得- ̗̀(๑ᵔ⌔ᵔ๑)
111603,432,赵和平,2019-07-02 06:34:40,3,3,0,还没考试先来评价一波，老师和助教都很棒。特别是上课时的tips很赞。今天出了几门血崩的成绩，很丧地复习的时候突然看到老师的‘年轻没有失败’，顿时感觉好多了。
114415,432,赵和平,2019-07-10 01:20:14,2,3,1,老师真的好，废话少说赶紧选课。
114525,432,赵和平,2019-07-10 10:13:11,1,1,0,老师好逗啊
114713,432,赵和平,2019-07-11 05:23:25,1,2,1,老师超有趣，还有助教老师，助教老师是个逗比。老师课堂上超有意思，还会讲与几个助教的事。\n\n就是就是，老师以后放视频能有中文字幕吗?大英绩点爆炸的人真的听不懂。\n\n最后最后，考试很重要，尽量写满卷子，重要的事说三遍，写满写满写满！！！
115420,432,赵和平,2019-07-22 13:33:24,2,3,1,赵老师真的是我上大学以来最喜欢的老师，认真的时候认真，玩的时候和我们玩的特别来，认知实习遇到他真的好幸运
115457,432,赵和平,2019-07-25 03:53:20,-1,3,4,实锤了，是个逗B
115534,432,赵和平,2019-08-01 15:24:49,0,2,2,真心喜欢这样的课程
116207,432,赵和平,2019-09-06 07:55:45,3,4,1,老师本人是挺风趣的，但是也就第一节课吧，后面就感觉一般般。作为组长最后3.0真的很震惊，我不知道自己做错了什么？给分挺迷的...我琢磨了很久，想了个大概，建议后面的同学多多给他发邮件哦，他贼喜欢营造一种全班同学都在跟他邮件学术交流的氛围，你也发邮件你就赢了呢科科：）也最好别让他认识你，不然就知道你的名字正太你哦～
117235,432,赵和平,2019-09-20 23:25:12,0,0,0,获益良多，兼学德语
117668,432,赵和平,2019-09-28 09:44:26,-4,2,6,给分太烂了，76 3.3
124198,432,赵和平,2020-06-27 02:11:21,1,1,0,本学期线上授课，考试也变成了论文，四次展示加上1篇2千到4千字的论文，组长，有好好学习，4.5，还不错，老师和助教都很好，学到很多。
124837,432,赵和平,2020-07-12 06:52:16,0,2,2,呵呵呵
135032,432,赵和平,2021-04-27 10:32:50,4,6,2,科学技术与环境健康\n\n首先老师和助教人都非常的好，讲课也比较生动，有干货\n\n但是选了你会发现大佬云集和躲不开的恶竞\n\n讨论课平均一节课讨论两个问题\n\n有的人一讲就停不下来还多次举手完全不给别人留机会\n\n很多人经常想发言都没机会\n\n平时作业也能看出恶竞来...\n\n非兴趣很浓厚的慎选
137958,432,赵和平,2021-07-12 16:29:56,13,13,0,赵老师水平高而且超级有趣啊(´，，•ω•，，)♡\n\n『他把我叫到办公室里，严肃地说：和平，是不是你们中国人喝太多牛奶。莫名其妙！我们中国人喝牛奶和你们牛奶涨价有什么关系啊？』\n\n『我回国之后，中国的环境就变好了~』\n\n『我们一起去打台球，他是这么说的，‘诶！这个球你要去哪里喔！我生气了喔！~’我在一旁都给听懵了，我只会说：他妈的这臭球。』（bushi）\n\n『你们应该有吧？没有你们市长就完蛋了。』\n\n『武汉大学年年看海，我们紫金港早不划游艇了。』\n\n『Who tm cares？』\n\n『坐在学渣的位置上也可以考出好成绩。』\n\n然后表白助教wz小哥哥~和赵老师一样都是有趣、博学又有一点点呆萌（？）的人！非常感谢~
139034,432,赵和平,2021-07-12 08:28:53,1,1,0,老师上课还是非常有趣的，干货满满，助教小哥哥也很好。但是这门课大佬非常多，很多相关专业的，感觉恶竟有点严重，非大佬慎重。
151616,432,赵和平,2022-03-09 22:59:39,8,10,2,表白徐秋瑾助教小姐姐，好美啊啊啊啊
152517,432,赵和平,2022-04-14 00:51:58,-1,0,1,很好，超赞，讲的又有意思 干货满满，很关心学生，尊重学生
155198,432,赵和平,2022-06-09 08:19:45,4,4,0,老师和助教小哥哥都很负责，课堂很风趣也有意思。内容确实有点硬核，会分模块讲很多环境问题，春夏学期各一次小组展示，小组展示各路大神很多。总的来说，如果只想水课不建议选，但要是对这方面比较感兴趣，选吧不会后悔的。
158576,432,赵和平,2022-06-30 09:42:29,-8,4,12,真的宝藏通核课啊！事少分高，老师幽默，助教知性温柔，讲的内容也很窸窣平常，文科同学也可以放心选，不要被双语劝退哦（也就平时放视频会有英文，PPT、考试都是中文）。讨论课积极发言，pre上点心，考试前复习了了大概3h，轻松4.8。拜托但凡有一个人不选我都会伤心的，ok？
158686,432,赵和平,2022-07-01 09:34:21,1,3,2,课程内容比较水，但讨论课的内容有点硬核，这学期讨论课发言没有几次，但最后给分很好，可冲
164465,432,赵和平,2022-12-21 06:27:39,0,2,2,老师很好，助教很负责。但是遇上摆烂小组，展示寄寄，被绩杀了。
181672,432,赵和平,2023-10-27 16:17:08,0,1,1,让人无语😓
195580,432,赵和平,2024-06-29 01:14:40,4,5,1,上的老师的科学技术与环境健康，考前认真复习老师划的重点，考试挺有把握的，出了个烂分，还是卡绩的，给分太烂了
195593,432,赵和平,2024-06-29 02:43:51,1,3,2,成绩出来前满怀憧憬，出来后心如死灰。真搞不懂了，从未旷课，认真讨论，认真pre，考前也认真复习了重点，考试内容也很有把握（有蛮多考的理论知识我都死记住了），结果成绩一出竟给我拉低不少均绩？！不仅低，还被卡绩！！虽然赵老师上课很有一套，风趣幽默，但这个给分，额，大家还是小心为妙，希望不要到最后跟我一样绝望。
195617,432,赵和平,2024-06-29 04:56:16,-2,2,4,很好的一门课！老师讲的东西很有意思，作为一门通核课也没有占用太多的课外时间，考前最后一节课划重点，最后给分也听不错的。
195848,432,赵和平,2024-06-30 09:47:17,-1,1,2,科环，给分一般般吧\n\n闭卷考还是有点难度的
214866,432,赵和平,2025-02-18 13:21:48,0,0,0,心悦诚服\n\n上完第一节课，大概明白了老师是什么样的人(自律，高要求，人品好)\n\n感觉整节课都诚惶诚恐
217391,432,赵和平,2025-04-09 12:35:01,0,0,0,讨论课太恶心了\n\n坐中间的人举手了都先被叫，然后他们讲了很多，坐旁边的人后发言都没什么好说的
221667,432,赵和平,2025-06-25 07:12:37,0,0,0,赵和平是真的很厉害很好的老师，另外的老师有点水。后面上课还签到了，明明说好不签的。出分很慢，现在还没出。
50576,450,汪海珍,2017-05-03 15:24:31,0,2,2,普地怎么还不出啊
50767,450,汪海珍,2017-05-05 05:19:35,1,5,4,给分超级好！
56723,450,汪海珍,2017-07-04 12:32:14,9,13,4,温柔给分好，没上过亏了
58686,450,汪海珍,2017-09-15 00:25:08,6,10,4,普地好课，推荐外专业的人修，能学东西给分高
59539,450,汪海珍,2017-09-22 10:07:20,1,4,3,给分超好！
76344,450,汪海珍,2018-09-11 16:08:07,4,18,14,恶心巴拉，很啰嗦很聒噪
78138,450,汪海珍,2018-05-09 12:48:37,-7,5,12,很好很负责的老师，第一门满绩的专业课。好好上课真的会有收获。
107137,450,汪海珍,2019-05-02 01:25:24,1,4,3,老师上的课很好，很有意思，会和我们讲很多生活中常见的地质学知识，我学到了很多。嘿嘿，现在出门看山看石头看水都可以向别人装逼了。我复习的比较认真，最后分数不错，不过如果能再给我加一分就更好了。感谢老师！
116058,450,汪海珍,2019-09-02 02:09:16,0,2,2,很好啊
116781,450,汪海珍,2019-09-15 23:26:48,0,2,2,心疼你被学院摆布失掉自我 随心所欲给分又没有胆量的样子
123851,450,汪海珍,2020-06-15 03:35:52,2,5,3,这个老师上课有点迷，经常给出难以想象的任务，比如找矿，找岩石，对于城市人口来讲真的困难重重令人抓狂。而且讲课也不是很有意思，找本宣科，最关键的是还讲错了好多概念。最关键的是她不是研究地质学的老师，给我们举的例子还是在土壤学方向的例子。最后留了一篇巨困难的综述，问题是他给的例文还是土壤学的范文。感觉这老师和这门课不搭。给分不甚好。
139427,450,汪海珍,2021-07-15 11:26:15,1,3,2,自我，想到一出是一出
140790,450,汪海珍,2021-09-16 05:23:26,0,1,1,不要靠近，会变得不幸。哦，必修课呀，打扰了。
160304,450,汪海珍,2022-09-18 11:20:35,0,0,0,老师人很温柔，而且给分真的算很好的了
172716,450,汪海珍,2023-05-05 04:21:23,0,0,0,emmm总体来说老师很好的
178131,450,汪海珍,2023-07-07 05:31:52,3,3,0,珍珍很好，但是环资行政是坨shit
192081,450,汪海珍,2024-05-09 02:38:16,5,5,0,给分太主观了，没有固定的给分标准，出题也很刁钻，喜欢出的边边角角的东西，而且改卷也严苛，上课还啰嗦，重点自己看，废话一大堆
197627,450,汪海珍,2024-07-23 01:38:15,1,1,0,老师非常非常用心，非常非常关心学生。出题很难很细节给分也比较求是可能算是“缺点”，但是我依然认为汪老师是最好那一档的优秀老师！
92100,479,田光明,2018-12-26 10:35:59,4,5,1,很棒棒的老师！\n\n
4140,516,张丽萍,2015-06-18 01:58:59,10,16,6,张老师上课很认真，会给很多课外资料
6459,516,张丽萍,2015-07-14 05:49:07,9,14,5,口音啊。。。
22749,516,张丽萍,2019-09-20 06:11:27,-9,1,10,我分不清她的口音到底是河南还是河北的……
23044,516,张丽萍,2016-03-16 11:46:07,25,34,9,他是老公，她是老婆，他们是一对呼户～
29547,516,张丽萍,2016-06-30 03:02:52,-2,5,7,好老师，上课挺好给分也挺好
31406,516,张丽萍,2016-07-04 01:01:01,2,8,6,给分好 老师人很好 助教小哥也很萌
31526,516,张丽萍,2016-07-04 05:15:10,4,6,2,感谢助教啊真的超级好！老师上课有点口音别的还好，是个理想主义者，从各个方面都由体现。
32944,516,张丽萍,2019-01-04 13:38:25,3,7,4,老师很不错 给分看猪脚
34204,516,张丽萍,2016-09-28 10:29:08,14,15,1,上课蛮好，只是讨论课的PPT不好做，我是自然资源科学导论的。
39640,516,张丽萍,2016-12-26 10:50:48,2,4,2,老师上课绝对认真，飞机晚点不吃饭直接赶到学校上课，好老师！
40250,516,张丽萍,2016-12-30 14:22:18,29,30,1,绩点资料那边弄串了，传媒与国际文化学院也有一位张丽萍老师，是汉语国际教育专业的！
44736,516,张丽萍,2017-01-18 07:32:39,0,3,3,助教人真的特别好，讨论课氛围也很好，给分变成等级制了也没办法
44812,516,张丽萍,2017-01-18 09:31:03,-3,3,6,人好，事少，分高。可爱的马克思主义老太太
45957,516,张丽萍,2017-01-20 09:52:58,0,6,6,老师很好啊而且给分超级好好好٩(˃̶͈̀௰˂̶͈́)و 虽然讨论课的ppt的确要精心准备需要蛮长时间  不过助教和老师都超好的辣！推荐啊蛤蛤蛤
54290,516,张丽萍,2017-06-29 03:30:06,1,6,5,给分好
55508,516,张丽萍,2017-07-01 16:31:39,-3,8,11,自然资源科学导论来的\n\n晚上八点半考完零点出分我服气…\n\n这门通核给分挺好的，老师也蛮可爱，讨论课每个人一共需要展示两次，准备起来也不太难，可以选。
55512,516,张丽萍,2017-07-01 17:33:25,-1,12,13,一个通识从没下四的人在这里跌倒了谷底?
55894,516,张丽萍,2017-07-02 14:57:47,-3,4,7,老师讲的有点无聊，主要是听不太懂，但讨论课参与度很高、主角也很好，认真了就能A
64408,516,张丽萍,2017-12-23 09:06:56,18,21,3,一门通核课两次个人展示，两篇论文加上期末考试，讨论课助教什么都不讲就只记录谁回答问题，有没意思事又多，看在是通核的份上就不骂人了。
71728,516,张丽萍,2018-01-29 02:00:47,2,6,4,怎么说呢，这门课给分是挺好的，助教人也挺好的。\n\n但是老师上课水平也太差了吧，很无聊，也听不懂，几乎没人要听，口音也很重，每次都要签到，后来都要按序号坐了，真是从未见过！
71743,516,张丽萍,2018-01-29 02:23:46,-1,8,9,自然资源导论课，上课虽然口音重，但讲的内容还挺不错的，讨论课挺活跃，大作业也不算繁重，期末考开卷，先看看书，不难，给分高
71779,516,张丽萍,2018-01-29 03:02:29,-2,6,8,我上的是张老师的一门通核课，自然资源学导论，这门课说实话事情有点多，两篇论文，两次个人展示，还有期末考试，但是只要按要求完成作业，平时上讨论课每节课都提一个问题，成绩会很好啦
73372,516,张丽萍,2018-08-10 08:49:13,0,9,9,傻逼一个
75650,516,张丽萍,2018-03-14 16:58:05,2,4,2,自然资源科学导论，似乎胡建口音？个人觉得专业素养平平比较古板，2次个人作业，平均2次讨论课个人展示，期末开卷考。给分迷。
83356,516,张丽萍,2018-07-10 07:24:13,0,2,2,老师挺好的，助教呵呵，小组组长要是不负责? ? ? ?
83421,516,张丽萍,2018-07-10 08:52:19,4,10,6,感觉这个老师有点刻薄，每次都要点名还强迫我们按序号坐，不来一次扣2分，最反感这种了，人家不想听课你逼也没用，自己讲的本身就很无聊，还说什么公不公平。给分也是低到爆炸，作业都是认真写的展示也是认真准备的，每次讨论课都去怎么就这样了，真的太刻薄，这个成绩真想骂人
83469,516,张丽萍,2018-08-10 08:48:17,0,5,5,垃圾垃圾
84622,516,张丽萍,2018-07-13 10:48:12,0,2,2,感觉老师有一点冷漠
87059,516,张丽萍,2018-09-20 06:04:55,-1,3,4,巨垃圾
91214,516,张丽萍,2018-12-03 12:02:08,1,4,3,通核是个什么样的课没点数的嘛？真以为我们喜欢这节课才选的？
94554,516,张丽萍,2019-01-17 07:44:36,5,9,4,第一门考试，考完试第二天出分，严重左右考试心情。上课个人觉得理论性太强了，很无趣。讨论课就是轮流ppt展示，平均每人两次。目测没发言分数会超低。恶竞严重。感觉事情太多了，而且又不好拿分。不说了...
94559,516,张丽萍,2019-01-17 08:14:57,5,6,1,出分超快，感觉展示决定了很多。两次展示一般，只有B+，虽然几乎每次发言了，但是最后绩点一般。期末开卷还是简单的拉不开多少差距
94828,516,张丽萍,2019-01-18 09:22:59,1,3,2,课很水 老师人也不错，但为啥每次讨论课都回答问题，考试也都找到了，才给3.5？
103707,516,张丽萍,2019-03-04 10:50:00,1,1,0,最好先学了地球科学概论再学这个
108032,516,张丽萍,2019-05-13 09:58:37,-1,1,2,课无聊 还每节课签到 自己的课怎么样看教室多少人没点b数吗
111040,516,张丽萍,2019-06-29 10:09:24,0,1,1,这届助教不太行啊 一天了都还没出分
111756,516,张丽萍,2019-07-02 18:35:36,1,4,3,本以为选上了一节通核课很快乐，没想到能收获入学以来超低绩点。一学期两次展示两篇论文，还有期末考试。不知道自己到底做错了什么...直接说吧，绩点2.7大家看着办?
111767,516,张丽萍,2019-07-02 21:59:58,5,6,1,单论上课还是比较水的。不是老师水平不行，而是很多人不听，老师知道，但是上课不会特意点出来。老师准备的很充分。之前出分一直很快，这次倒是比较慢。上课没事，平时任务两次展示，两篇论文，一次期末考试。事情比较多，但是相对其他通核不算多。期末考试她说很难，复习了一天，但是还是简单的，就是有一道题超出考试范围。最后一节课认真听的同学错了，不听的同学反而对，感觉有点不太好。至于给分，老师也讲过，她不懂系统，也不会调分，所以得分全看自己平时表现和期末卷面。总有人拿高分，有人拿低分。分数低了不应该一直吐槽抱怨老师，你想想平时任务自己的努力是多少，花了多少时间，用心了，分数自然高。还有我们是老师最后一届学生，教完我们老师就退休了，其他同学也没有机会上老师的课了。
111833,516,张丽萍,2019-07-03 00:35:54,1,5,4,老实说，这门课有些无聊，老师授课方式也让人没有深入了解的兴趣。两篇小论文+两次展示的考核方式尚在可接受范围内，因为期末开卷考不难，考前看了两个小时书，就比较容易找到所有答案，所以主要靠平时分拉开差距。ppt展示充分些+论文规范标准+平时发言积极些=4.8
112102,516,张丽萍,2019-07-03 14:30:00,2,3,1,这个通核不是五级制的，不用担心因为一分拉开一级。但是事情有点多，2次讨论加2篇论文加期末开卷。讨论和论文都准备得很用心，展示也都是A，最后只有平均分，大概是班内大佬太多了?
118309,516,张丽萍,2019-10-24 14:59:36,0,0,0,太催眠
121098,516,张丽萍,2020-01-19 14:46:45,0,1,1,还不错
54910,524,黄敬峰,2017-06-30 12:43:51,1,1,0,老师很可爱
57496,524,黄敬峰,2017-07-09 01:29:08,0,1,1,男神！
15555,526,刘维屏,2016-01-15 10:22:10,6,8,2,老师我爱你
35451,526,刘维屏,2016-11-10 07:17:34,0,0,0,挺好的老师，上课不念ppt按照自己觉得有用的给我们讲，嘻嘻下课之后还和我们聊了很久，各种关心学生
52770,526,刘维屏,2017-06-22 16:32:49,-1,0,1,院长很棒啊
57410,526,刘维屏,2017-07-07 10:34:30,0,0,0,院长超可爱的！上课喜欢讲故事，很有趣！出题比较出人意料。
110099,526,刘维屏,2019-06-22 23:29:44,0,0,0,挺有意思
28172,543,杨肖娥,2016-06-28 08:12:30,4,5,1,老师好像很厉害，但是上课互动差了点
32215,543,杨肖娥,2016-07-06 03:26:09,-6,0,6,上课一般，给分挺好
36120,543,杨肖娥,2016-11-10 12:56:16,-2,2,4,挺轻松的
36315,543,杨肖娥,2016-11-11 15:43:59,-3,2,5,挺好的，认真听能学到东西
37322,543,杨肖娥,2016-11-18 09:56:54,1,7,6,给分并不好 上课内容也有点无聊 就是干巴巴地讲 通识课的两位老师都是这样 很容易听不进去。
76797,543,杨肖娥,2018-04-23 12:53:35,-1,3,4,很有心的老师，讲的东西很多，老师也很有理想和想法，就是讲课有些催眠。然后我是在出分前写的评论，因为我认为给分是你学生的问题，跟老师较啥劲？
77284,543,杨肖娥,2018-05-15 07:06:00,0,4,4,每次都到了，没翘过课，作业认真完成，考试写满了，可绩点真的不高，不知道老师怎么评的分。
78770,543,杨肖娥,2018-05-15 06:21:52,0,3,3,做同样的作业，同样的卷子，结果绩点巨低，完全不知道它是怎么评分的
78771,543,杨肖娥,2018-05-15 06:35:54,0,1,1,讲的东西挺多的。每次思考题都认真做的，从不缺课的，结果最后绩点凉凉，心态崩了，室友强推的轻松给分又好的通识课，结果这学期不知道为什么给分很差。
78783,543,杨肖娥,2018-05-15 07:03:39,1,3,2,绩点凉凉，不是特别有兴趣的就不要选了，上课挺无聊的，ppt没有条理，给的是pdf版打印改背景很烦，一节课也就120 130张ppt吧 ，诸君保重
78793,543,杨肖娥,2018-05-15 07:27:55,0,1,1,上课的內容有无聊 完全听不进 分数也不太好 作业也很多 不水 考试也抄得很辛苦 ppt也很多
78795,543,杨肖娥,2018-05-15 07:29:06,0,0,0,呵呵哦
78812,543,杨肖娥,2018-05-15 09:21:17,0,0,0,ppt巨多，改格式是最难的，以为自己在上大计基实验课。上课知识很多，想听的可以听听。每节课必点名，两周交一次平时作业，期末开卷不知道怎么给的分……
78823,543,杨肖娥,2018-05-15 10:54:24,0,3,3,老师是业界大牛，人很和蔼。有四次作业，几乎都能在ppt上找到。考试是开卷考试，如果选择纯黑白打印，8×100+的ppt，十几块就能拿下。平时会有三四次点名，也会有签到。除了点名，感觉作业和考试的主观因素太少，所以一直疑惑哪里来的区分度，因为不可能所有人都上4吧。有学分就好。虽然3.9，但是依然打9分。
78858,543,杨肖娥,2018-05-16 01:02:01,1,2,1,老师是个很好的科学家，但是，绩点先不谈，上课真的很催眠，老师声音还小，要坐前排才能听清。我一个上课从来不走神的人竟然忍不住看手机，真正学习都是看PPT学的。。。。\n\n
81195,543,杨肖娥,2018-07-04 08:49:35,0,0,0,事情多的一批 给分贼低 上课极其无聊 又没学到啥 醉了 别选
83363,543,杨肖娥,2018-07-10 07:27:36,1,1,0,期末考资料整理≈信息技术处理考核\n\n整PPT整PDF整到头秃\n\n总体……还行吧，半水不水的课程
106091,543,杨肖娥,2019-04-25 02:31:17,0,0,0,老师纯念ppt\n\n真的，我统计过，一节课发散的几乎没有\n\n而且声音蜜汁想睡觉，，，，，\n\n每节课都有作业\n\n经常点名\n\n有期末考试\n\n
159635,543,杨肖娥,2022-08-22 10:20:10,3,6,3,杨老师是业界大佬，能学到非常多东西，身上散发出科学家的魅力，让我深受感染，所谓的给分低感觉不是很重要
161749,543,杨肖娥,2022-11-12 05:28:19,2,3,1,秋学期上了杨老师的环境修复与生态保护，绩点4.5，真的很惊喜…\n\n杨老师本身很博学很厉害，助教姐姐也很负责。平时上课确实是纯念ppt，杨老师声音也比较小，但是念英语的时候很有趣（doge\n\n上课没咋听过，因为几乎每节课都点名所以也不敢缺课，就在后排快乐自习。\n\n每节课都有作业，我一般就是合理地抄写ppt，后面不想手写了就交的是word\n\n需要着重强调的是！！这次考试老师让带电子产品！！终于不用打印几百页的ppt和讲义了！！考前甚至可以不复习了！！体验感极佳！！老师真的有在进步（再次doge\n\n总之秋学期上下来感觉还行，确实也学到了一些知识，感觉作业认真写就不会有啥大问题，算是我选的课里最轻松的一门了。
161777,543,杨肖娥,2022-11-13 04:37:33,0,1,1,感觉老师很好啊，助教小姐姐也很好。每节课都点名也会有课后思考题，但都很简单的。期末开卷考，是可以带电子设备的那种开卷考，真的是超好的啦！作为文科生平时一直水水最后绩点也还不错
162024,543,杨肖娥,2022-11-16 05:40:34,-1,0,1,4.5（91）谢谢老师，老师很好
162034,543,杨肖娥,2022-11-16 07:08:24,1,1,0,老师学识渊博，事少，给分很好。
163965,543,杨肖娥,2022-12-17 03:28:01,-1,1,2,杨老师真的非常博学，也很在乎环境修复与生态健康阿哈哈哈\n\n很爱助教小姐姐特别是点名的时候嘿嘿\n\n事情真的很少，只要认真写每节课的思考题\n\n期末是！带电子设备的开卷考啊～\n\n杨老师很和蔼可爱捏\n\n最后4.8啊啊啊毕竟是第一门出绩点的课诶～～
164654,543,杨肖娥,2022-12-22 14:21:49,6,16,10,秋学期上了杨老师的环境修复与生态保护，绩点4.5。\n\n杨老师很亲切和蔼，她的笑容很治愈我，作业迟交也完全无所谓。考试可带电子产品。强推
167943,543,杨肖娥,2023-01-20 14:38:53,-2,0,2,老师讲得很好，考试是开卷的，在老师的ppt里，最后助教会发复习讲义（一本电子书）助教也很负责
173796,543,杨肖娥,2023-06-03 05:00:32,0,3,3,虽然互动少，可能课程有点无聊，\n\n但是考试可以带电子设备啊！！！\n\n好好写作业和考试分数很高啊！
177793,543,杨肖娥,2023-07-05 01:58:05,-6,0,6,虽然上课会有点无聊，但只要认真完成作业考试写完就能得到很好的成绩，而且考试可以带电脑啊啊啊
193590,543,杨肖娥,2024-06-13 10:51:25,5,6,1,给分很迷。
214163,543,杨肖娥,2025-01-26 08:09:31,5,5,0,节节课点名，平时作业一周一次，PPT每个几百页量很大不说，考核标准也不透明，最后期末考更是看不懂怎么给分，迷的很，劝退。
214164,543,杨肖娥,2025-01-26 08:15:40,3,3,0,垃圾助教\n\n不要因为前面的评论选这门课，助教换了。
214183,543,杨肖娥,2025-01-27 04:16:06,5,5,0,快逃，均绩给这课害死了
214810,543,杨肖娥,2025-02-18 04:46:39,1,1,0,辛辛苦苦勤勤恳恳的备考，3.9你在开玩笑吗
50252,581,王飞儿,2017-05-02 03:51:48,1,1,0,给分呵呵
56202,581,王飞儿,2017-07-03 08:47:22,1,1,0,事情一堆，给分差，绩杀
82087,581,王飞儿,2018-07-07 05:30:55,1,2,1,给分极差
105490,581,王飞儿,2019-04-15 09:55:36,1,1,0,无聊。
111788,581,王飞儿,2019-07-02 23:07:05,1,2,1,绩点没高过她评分
123938,581,王飞儿,2020-06-17 06:51:01,0,0,0,给分不行！
125509,581,王飞儿,2020-09-10 17:28:02,10,11,1,大家把分压压低，不然绩点高不过评分
135492,581,王飞儿,2021-05-11 13:17:27,-9,2,11,老师挺好哒
183511,581,王飞儿,2023-11-27 03:27:15,4,5,1,上课一般般，给分真不行，好像那个和学生的分数有仇。
183512,581,王飞儿,2023-11-27 03:29:39,2,2,0,真的不是很理解她的给分，很混乱，一开始连评分标准都没有，然后东西都搞了，但是分数很低，给分一点理由都没有，我真的很不理解，难怪评分这么低
183574,581,王飞儿,2023-11-27 12:02:24,2,2,0,课比较水，，，给分比较玄
202722,581,王飞儿,2024-11-14 04:10:01,-10,0,10,老师挺好的
202792,581,王飞儿,2024-11-14 11:31:17,2,2,0,开卷ppt没给全
203571,581,王飞儿,2024-11-20 05:27:18,-1,0,1,真牛。
203882,581,王飞儿,2024-11-21 16:20:14,4,4,0,真是÷生
214337,581,王飞儿,2025-02-01 11:48:19,0,0,0,开卷考为了检验大家是否听课特地在考前告诉我们她没给全PPT
36062,615,杨方星,2016-11-10 11:12:32,1,1,0,课讲的细致，老师很可爱
48015,615,杨方星,2017-02-28 05:06:28,-13,1,14,老师娘娘腔 环境仪器分析给分极差
55374,615,杨方星,2017-07-01 11:42:23,1,1,0,曾经考完环境仪器分析之后给老师发邮件，8个月之后回复了我表示感谢，挺可爱的，感觉老师还是蛮好的，就是环工这个课千万不要作死提前修！考试是背背背，修完之后给分好像就变好了？平时上课是三个老师，还有院长，但是总体比较无趣。
119010,615,杨方星,2019-11-09 10:36:36,5,5,0,老师上课挺有趣的，就是环境仪器分析这门课限制了他的发挥哈哈
147725,615,杨方星,2022-01-10 14:36:23,0,0,0,背书背成啥b了
147727,615,杨方星,2022-01-10 14:37:54,0,0,0,背背背
154214,615,杨方星,2022-05-26 05:37:12,1,1,0,还行吧
184469,615,杨方星,2023-12-20 09:51:34,2,3,1,老师人很好，上课时候很温柔~
184470,615,杨方星,2023-12-20 09:55:01,2,2,0,老师很温柔，很好的呀
215665,615,杨方星,2025-03-04 00:39:51,0,0,0,老师人很好
23483,675,张志剑,2016-03-31 06:20:41,-1,7,8,有趣的老师
27931,675,张志剑,2016-06-28 05:58:59,2,5,3,课堂要求比较高，讲课也是比较生动有趣的，虽说有时忍不住犯困。
62220,675,张志剑,2017-11-23 08:27:43,-3,3,6,老师很有趣，课程很轻松，就一篇论文和3次课堂小测，还会去实地参观。给分很好！
63714,675,张志剑,2017-12-13 09:57:28,5,8,3,每年吃苍蝇～
74609,675,张志剑,2018-03-04 14:56:00,-6,0,6,不错不错，讲得好像很新的，还能组织大家课程见习
85837,675,张志剑,2018-08-21 06:00:36,9,11,2,讲课很有热情 但是千万别选他做研究生导师 神坑
89609,675,张志剑,2018-11-20 02:52:12,-4,1,5,敲击棒，就是给分太宽松
100054,675,张志剑,2019-01-25 13:31:17,13,14,1,每次点名都去 试题也都找到了就是低分 服了 瞎几把给分
100063,675,张志剑,2019-01-25 13:32:32,5,6,1,环境与人类文明，三次点名，期末考抄书就好。老老实实按所有流程走了，只是绩点太低。不过感谢没有卡绩
100135,675,张志剑,2019-01-25 15:30:28,6,7,1,3次点名都去，考试试卷上就1.5分的题没查到，然后他给了我3.6，呵呵！事儿是真的少，想水学分的同学可以过来，不过如果是对自己的绩点有要求的话，我劝你还是别来。
100193,675,张志剑,2019-01-25 18:06:17,5,5,0,为什么没有零分
100333,675,张志剑,2019-01-26 03:13:55,4,4,0,这个给分我也是服气的，唉，感觉自己考的没那么差啊。
100393,675,张志剑,2019-01-26 05:01:44,-4,3,7,很好的老师呀，保证到课率，考前好好看一遍书，考试的内容书上都找得到，卷面把字写好看些，稳！
100638,675,张志剑,2019-01-26 13:03:10,2,3,1,上课睡觉会被叫起来。。。服了
108334,675,张志剑,2019-06-10 05:11:13,10,11,1,您觉得用课外时间参观还把时间冲突的同学记缺课合理吗？
108335,675,张志剑,2019-05-21 08:41:34,9,9,0,上课体验极其恐怖?
108336,675,张志剑,2019-05-21 08:42:37,10,10,0,疯狂提问心慌慌
108337,675,张志剑,2019-05-21 08:44:08,5,5,0,我的马鸭！好怕怕啊！一直在教室游荡！答不出问题还问你什么什么专业！
108338,675,张志剑,2019-05-21 08:58:09,2,2,0,现在缩在角落瑟瑟发抖。。。
108339,675,张志剑,2019-05-21 09:11:22,4,4,0,你提问你?呢
109185,675,张志剑,2019-06-11 07:59:30,3,3,0,表情逐渐凝固
112123,675,张志剑,2019-07-03 16:29:40,1,1,0,不咋地，给分差事情多
112124,675,张志剑,2019-07-03 16:31:21,1,1,0,一位精致的“老师”\n\n
124816,675,张志剑,2020-07-10 10:19:55,1,2,1,因为交作业的邮件没写名称和落款，只写了附件名称和主题名称，就骂学生没教养
189900,675,张志剑,2024-02-01 16:47:01,1,1,0,和其他老师相比就是狗屎中的狗屎，永远觉得自己没问题，都是学生不行，谁上他的课谁倒霉
55381,738,林琦,2017-07-01 11:48:59,2,2,0,为什么要难为口音这样的老师上英文环境学概论？
156358,738,林琦,2022-06-19 08:12:36,2,2,0,无语😓
77778,784,杨坤,2018-05-07 17:07:19,14,17,3,拽上天\n\n\n\n
83068,784,杨坤,2018-07-09 15:01:56,-36,4,40,所有的出发点都是好的，确实为了学生着想，但是方式方法很有问题，容易与学生计划矛盾。另外水厂如果提前准备，好好设计的话，给分还是不错的。
173074,784,杨坤,2023-05-12 11:37:30,8,9,1,作业好多…………………………………………………………………………
174915,784,杨坤,2023-06-19 17:44:34,16,18,2,2023.6.20.1:44，污水处理厂设计作业进行中，签到打卡。
176849,784,杨坤,2023-06-30 11:28:03,12,13,1,太牛了哥、没人比你更牛\n\n不把学生当人的典型
177026,784,杨坤,2023-07-01 07:23:02,16,16,0,只有这么少的评论我是没想到的，我的建议是去暑
177027,784,杨坤,2023-07-01 07:31:56,40,42,2,这辈子没遇到这种牛马老师，怎么什么物种都可以来当老师了？除了会CPU学生还会干什么？上课讲课依托答辩，布置作业从不考虑作业量和时间，高高在上的样子从头到脚都写着两个字：爹味。
180721,784,杨坤,2023-09-25 10:51:41,6,7,1,我是ikun
183667,784,杨坤,2023-11-28 09:04:25,7,8,1,我在骟÷，你也来助力一刀吧~
191317,784,杨坤,2024-04-17 14:37:09,109,116,7,2024.4.17 写诗哥事件合影！
191318,784,杨坤,2024-04-17 14:29:58,66,68,2,写诗哥的亲戚，太好了！！，xdm快来！！！
191319,784,杨坤,2024-04-17 14:38:43,40,43,3,我是写诗哥
191320,784,杨坤,2024-04-17 14:51:24,48,51,3,诗出冥门
191321,784,杨坤,2024-04-17 15:00:22,28,31,3,四·一七诗变事件合影
191322,784,杨坤,2024-04-17 15:06:44,31,33,2,名师出高徒[ac01]为什么不能打4.7分
191323,784,杨坤,2024-04-17 15:26:46,17,19,2,都诗丽人
191325,784,杨坤,2024-04-17 15:48:04,16,18,2,你是不是有个亲戚在读
191326,784,杨坤,2024-04-17 16:02:01,16,18,2,写诗哥时代打卡
191327,784,杨坤,2024-04-17 16:06:59,14,16,2,朵朵来的这里集合
191328,784,杨坤,2024-04-17 16:41:22,56,61,5,舅舅，你可以帮我立项SRTP吗（我是一个纯洁可爱的小男生）
191329,784,杨坤,2024-04-17 16:41:25,8,11,3,写诗哥留念！
191330,784,杨坤,2024-04-17 16:46:13,39,43,4,写诗哥4.18打卡留念！\n\n\n\n有点好奇23级怎么立srtp的心b心\n\n\n\n不是海纳院的，我是环科的，但平时自己在学无机有机，修了数分高代，然后想去求化/求数\n\n导师是我亲戚(让不然我肯定选化学\n\n\n\n那直接挺好的吧\n\n\n\n但是感觉我导师可能是我最大的资源优势，而且中国这样的社会，亲戚关系真比较硬，\n\n我导师是环境化学方向的，基本上全是化学的内容，我现在真挺犹豫的，uu怎么觉得\n\n\n\n***\n\n\n\n2023级“灯塔计划”负责人代表杨宸沣同志上台发言。在对“灯塔计划”的理解上，他谈到学生党支部同志下沉到班级帮助构建老师与班级同学的沟通桥梁，深入联系群众，走进群众生活，了解群众所需，帮助群众排忧解难。这不仅能够发挥“以老带新”、“榜样指引”作用，而且能够帮助支部同志真正理解感悟我党“全心全意为人民服务”的根本宗旨\n\n在“灯塔计划”的工作过程上，他强调了沟通的重要性，并希望在工作过程中与各位同志一齐发力建立起长期沟通机制，保障每月防与班级同学进行定期的沟通交流。同时，还分享了自己在担任军训教官时的工作经验，希望各位同志学会共情，用真诚、平等的态度去对待所在班级的同学们。\n\n\n\n***\n\n\n\n之前有人给你转述过，你别介意，其实我是那种很可爱的小男生\n\n就是有的时候有点幼稚\n\n不好意思啊我不乱评价每个人各自的生活习惯，对不起，uu过一下申请吧\n\n我一定会教你微积分和python的\n\nuu已读了稍微回几个字吧，这么已读不回怪纠心的\n\n我加了那个小姐姐微信一定把她约出来自习，既教她微积分，又看看美女\n\n\n\n***\n\n\n\n来自cc98@杨**\n\n能力素养加分能力素养加分能力素养加分能力素养加分能力素养加分能力素养加分能力素养加分能力素养加分能力素养加分能力素养加分能力素养加分能力素养加分能力素养加分
191331,784,杨坤,2024-04-17 18:17:06,6,8,2,24.4.17 写诗哥事件打卡
191332,784,杨坤,2024-04-18 00:04:18,14,16,2,慕名前来合影
191333,784,杨坤,2024-04-18 01:00:34,61,65,4,是不是有个在读的亲戚叫杨宸沣
191335,784,杨坤,2024-04-18 01:13:47,16,20,4,傻逼傻逼，写诗哥的脑瘫亲戚
191339,784,杨坤,2024-04-18 04:02:45,4,6,2,来合影捏
191341,784,杨坤,2024-04-18 04:28:01,4,6,2,慕名而来
191342,784,杨坤,2024-04-18 04:44:07,-14,5,19,这是一个非常好的老师，德高望重
191344,784,杨坤,2024-04-18 04:50:53,7,10,3,这位教授诗写得不错
191347,784,杨坤,2024-04-18 05:48:30,12,14,2,我会写诗可以立院级srtp吗
191349,784,杨坤,2024-04-18 06:57:26,9,11,2,书香门第，诗礼世家
191352,784,杨坤,2024-04-18 08:32:22,5,7,2,会不会写诗
191355,784,杨坤,2024-04-18 10:06:35,-6,1,7,嗯嗯嗯
191358,784,杨坤,2024-04-18 10:49:53,0,4,4,2010年“浙江大学优秀研究生德育导师”，6
191359,784,杨坤,2024-04-18 11:30:54,1,3,2,诗出冥门
191360,784,杨坤,2024-04-18 11:43:30,1,3,2,写诗哥打卡
191366,784,杨坤,2024-04-18 14:15:24,1,3,2,。。。包庇亲戚。。。
191369,784,杨坤,2024-04-18 14:39:47,2,4,2,老师可以教我写诗吗
191380,784,杨坤,2024-04-19 02:46:48,9,10,1,老师写诗特别强
191384,784,杨坤,2024-04-19 03:10:11,3,4,1,学术不端
191388,784,杨坤,2024-04-19 04:29:31,0,0,0,嗯嗯嗯
191389,784,杨坤,2024-04-19 04:42:30,0,0,0,合影了
191391,784,杨坤,2024-04-19 05:27:02,3,4,1,吊毛一个一个吊毛
191395,784,杨坤,2024-04-19 05:52:35,3,3,0,讨厌学阀..
191396,784,杨坤,2024-04-19 05:52:33,3,3,0,讨厌学阀..
191398,784,杨坤,2024-04-19 07:08:20,3,4,1,老师可以教我写诗吗
191401,784,杨坤,2024-04-19 08:12:03,4,4,0,坤坤舅舅
191412,784,杨坤,2024-04-20 09:27:04,3,3,0,不多说 烂死了
192875,784,杨坤,2024-05-31 07:21:22,7,7,0,写诗歌
193745,784,杨坤,2024-06-17 11:08:06,12,12,0,你这期末作业也太逆天了，给你那个写诗哥也做一做
195347,784,杨坤,2024-06-27 23:46:26,4,5,1,爹味，其余评价出门左转同邬文浩…
197818,784,杨坤,2024-08-15 11:53:13,18,18,0,说一下网安学院教计算机组成（计组）的杨坤老师。老师自己对PPT都不是很熟悉，讲课质量可想而知，好像没几个人听的，指路马德老师，虽然也有点拖沓但是在计组这些授课老师里面算好的了。大概率后面几年还是今年的助教，如果还是lzy和ytm两位学长，给分上大概是很有师生情的。都到现在这个阶段了，大家应该也知道历年卷的重要性了吧，考前好好看看历年卷，有的考法不是做作业就能知道的。其他东西跟其他班级差别不会很大。
199352,784,杨坤,2024-09-21 13:33:19,15,15,0,老师今天早上睡眠质量真高（网安）
205325,784,杨坤,2024-12-04 10:28:38,3,3,0,写诗哥
206938,784,杨坤,2024-12-18 14:59:25,13,13,0,评价的是网安学院的老师。老师每节课都迟到，有时候找助教代课，两次早八翘课，事后来一句：同学们，调课忘记通知了，我们下次补吧！调课调到周日晚上，还要小测。。
208180,784,杨坤,2024-12-26 05:34:19,9,10,1,评价一下网安学院上计组的杨坤，上课催眠，每节课都迟到十分钟以上，非常严格的点名手段，喜欢调课，经常让助教代课（助教讲的比他好），不熟悉ppt，讲课只会念ppt，给分不知道
208201,784,杨坤,2024-12-26 07:17:07,6,6,0,本学期多次迟到早退，多次调课，纸质点名，核对人头，上课催眠，喜欢抽人回答问题，不熟悉ppt，但是助教哥哥人真的好（wyp和xxk学长），验收和指导尽心尽力，可以每节课带个排插听md智云（网安）
212217,784,杨坤,2025-01-13 11:55:34,8,10,2,网安学院的杨坤喜欢眯眯眼看看你有没有没来啊没来是吧，没来让你飞起来卧槽似need吗
212446,784,杨坤,2025-01-15 07:26:07,10,13,3,（网安学院）上课水平一般，点名严格。但最后给分不错（主要有助教gg的功劳）。考虑到计组课大家都听马德智云，如果选不上马德老师，yk老师可选，认真学习同样可以获得好成绩。
214792,784,杨坤,2025-02-18 02:56:23,1,2,1,（网安杨坤）老师1/10，两个助教10/10，故均分7/10\n\n缺点：讲课极差，低头念ppt，且开火车叫人回答问题给教室自学的人带来不幸，建议最后一排学自己的，被点到就看着他尴尬地笑\n\n优点：点名四次到两次就满（虽然纸质点名+数人头），小测会提前通知，给分挺捞的（虽然这多半是助教给的实验分很高的功劳）
216129,784,杨坤,2025-03-11 02:24:33,0,0,0,爹味十足，鼓励内卷，不是什么好人
217454,784,杨坤,2025-04-10 14:09:20,2,2,0,丢啊丢啊丢手绢，老师认识四川芬达吗
217816,784,杨坤,2025-04-17 02:45:36,3,3,0,他们朝我扔粑粑，我拿粑粑做蛋挞
21714,836,胡宝兰,2016-03-01 01:20:08,8,11,3,不怎么样\n\n
87510,836,胡宝兰,2018-09-30 04:03:23,-60,26,86,废狗东西，婊子
99562,836,胡宝兰,2019-01-25 03:22:21,-7,2,9,认真负责
127880,836,胡宝兰,2020-11-29 16:14:04,8,9,1,不好不好 感觉不会上课
130433,836,胡宝兰,2021-01-22 09:44:00,0,7,7,老师很好！人很和善温柔！希望不要正态我！
130494,836,胡宝兰,2021-01-23 03:40:27,-2,5,7,很好的老师，教授级别的人物
138306,836,胡宝兰,2021-07-08 12:15:08,-3,4,7,好老师，给分也不错，教学很认真
139822,836,胡宝兰,2021-07-29 02:29:40,12,12,0,干啥啥不行，吹牛第一名
140133,836,胡宝兰,2021-08-28 04:22:56,40,45,5,老师的确还算用心，但我也从这里看到了环境被誉为天坑的真正原因。主要不是毕业后工资如何如何，而是你会感觉根本学不到东西，把一大坨没有理解的东西灌给你，这真的合理吗。
143568,836,胡宝兰,2021-11-27 07:19:29,21,23,2,push怪，硕博千万别选。
154633,836,胡宝兰,2022-06-02 14:21:44,-4,3,7,给分真的好好
155035,836,胡宝兰,2022-06-07 16:05:47,19,20,1,“因为硕士的毕业论文要查重率10％，那你们也10%吧”\n\n我谢谢您嘞，一个文献综述还他妈查重10%
191353,836,胡宝兰,2024-04-18 09:28:32,14,16,2,我想问问这门课还有其它教学班，孙成亮老师的班评分略高于您。我现在还可以补退选，想问问老师我应该选哪个老师？
192277,836,胡宝兰,2024-05-13 09:11:24,0,1,1,讲课无趣，期末考难
202941,836,胡宝兰,2024-11-15 09:35:50,0,0,0,给我们将前沿，讲nsc，但是这个绩点让人根本没机会进修接触前沿了吧
217927,836,胡宝兰,2025-04-18 04:09:26,5,5,0,讲的很拉 事儿特别多 不让上课玩手机但其实自己讲的也是一坨 汇报pre怼人很烦事儿特别多
218891,836,胡宝兰,2025-05-11 15:31:06,4,5,1,最喜欢的美女老师
31854,892,刘璟,2016-07-24 18:57:20,1,6,5,给分不好
35472,892,刘璟,2016-11-10 07:20:04,-3,6,9,什么鬼！老师自己也弄不清楚，被同学问到问题一脸懵逼。就这样吧希望老师上课的时候可以不要只念ppt，虽然能结合应用挺好。
76093,892,刘璟,2018-03-26 15:00:23,7,14,7,该老师妄自尊大，目中无人。
95187,892,刘璟,2019-01-19 04:22:32,2,5,3,讲得还是比较清楚的，重点好好背。今年光谱基本只考了红外光谱和原子吸收，色谱考了很多，大题基本给了重点。选择题考的很细。
110100,892,刘璟,2019-06-22 23:31:13,-2,2,4,还行吧
112471,892,刘璟,2019-07-04 09:58:34,-3,4,7,讲课很严谨，条理清楚，虽然可能缺乏点活泼性，但我个人更喜欢这种不抖机灵的老师。而且老师还很美啊。
112472,892,刘璟,2019-07-04 09:58:58,0,5,5,课讲的挺清晰，有条理
131135,892,刘璟,2021-01-26 06:51:11,-2,7,9,我的评分一向客观，绩点乘二。\n\n（生科导）老师很不错，很温柔，认真听课的话会很有启发。会经常谈到前沿的生物知识，感觉学识挺渊博的。对一般的社会问题和伦理方面也会倾听同学的意见。上课不大有趣的亚子但是老师很好看就足够了。\n\n不是吗?_(´□`」 ∠)_
136015,892,刘璟,2021-06-09 09:18:34,9,11,2,莫名其妙的老师
138675,892,刘璟,2021-07-10 09:17:10,2,9,7,上的刘老师的大学生物学，老师人挺好的，只是个人感觉上这门课的设置有点问题，按照老师的要求来最后结果不会差。
140827,892,刘璟,2021-09-16 14:14:31,-7,3,10,老师很好，大学生物学这门通识课，她教出了真谛。很喜欢她♡
141888,892,刘璟,2021-10-30 04:54:05,7,9,2,慎选。
156501,892,刘璟,2022-06-20 05:10:55,-9,2,11,很有思想的老师
164196,892,刘璟,2022-12-19 07:00:37,15,17,2,什么破老师啊，避雷啊，说话巨难听，而且语气特别难听，有色眼光一样，对于好的就语气好行，不满意的同学就各种怼，小分享大分享也是乱怼，无语死了
166076,892,刘璟,2023-01-11 04:39:48,2,3,1,一般般，没学到什么
170344,892,刘璟,2023-03-17 02:36:21,4,4,0,避雷 令人无语的老师 高高在上  咄咄逼人 事多 分少 态度差
171935,892,刘璟,2023-04-17 13:34:59,2,2,0,莫名其妙的老师，课讲的没重点，屁事还贼多，推荐去教小学生
172833,892,刘璟,2023-05-08 05:44:08,1,1,0,给分低，要求多
174224,892,刘璟,2023-06-08 02:25:27,2,2,0,别选这个老师的课，大生课确实高高在上，没带盘用钉钉传文件也要怼，不友善咄咄逼人
178515,892,刘璟,2023-07-13 05:31:14,-2,0,2,求是老师，很严肃，如同前面的评论所说，因此大生不要想着这样那样，也许只有延续中学传统，做个“乖学生”，才能让你在大生课上活得滋润。
183638,892,刘璟,2023-11-28 05:38:37,3,3,0,高高在上个什么劲
35660,951,冯英,2016-11-10 07:40:07,0,1,1,有点小无聊
39960,951,冯英,2019-01-04 13:45:08,3,4,1,环境修复与生态健康，够水，好课。点到，一定要到
62955,951,冯英,2017-11-27 12:43:07,2,2,0,点过一次名，只要每次去上课，交作业，考试开卷，翻一翻就好了，绩点也还不错
62986,951,冯英,2017-11-27 23:50:57,4,5,1,老师很可爱啊?
63003,951,冯英,2017-11-28 01:41:46,0,0,0,老师很可爱的～～
63010,951,冯英,2017-11-28 02:17:28,0,0,0,老师人很好，很理解我们，作业也很少，考试也很容易，其实平时的课听听还是很有趣的
64395,951,冯英,2017-12-23 07:54:51,1,1,0,老师很好，课水，不怎么提问，偶尔点名，开卷考，有平时作业，没有论文
65272,951,冯英,2018-01-02 07:55:38,4,4,0,老师很温和 人也超好！！但不知道打分的是谁= =
83365,951,冯英,2018-07-10 07:28:23,1,1,0,老师真的挺可爱
91857,951,冯英,2018-12-23 09:04:36,0,0,0,满分！必须满分！老师人真的太好了
123538,951,冯英,2020-06-09 13:37:50,1,1,0,上了三门冯英老师的课，门门4+，我爱了
145577,951,冯英,2021-12-30 10:04:46,-3,1,4,点名占比太高
153548,951,冯英,2022-05-04 12:57:20,0,1,1,fy老师人真的挺好的，课程任务不会太多，同时还会给你有关期末考试或者论文的反馈，最后给分也挺不错的！
186920,951,冯英,2024-01-13 14:05:54,0,1,1,冯老师真的超级好啊啊啊啊啊啊啊啊啊啊啊啊啊啊啊啊啊啊
211984,951,冯英,2025-01-13 03:39:31,0,1,1,环资难得的耐心仔细的好老师，会答疑，会体谅学生，是个难得的好老师，而且钉钉不会已读不回
50789,970,吕军,2017-05-05 11:21:16,0,0,0,先打上\n\n
78451,970,吕军,2018-05-12 03:13:47,0,0,0,怎么还不出分啊
49416,986,徐新华,2017-04-11 06:45:04,2,3,1,嘿嘿嘿
55379,986,徐新华,2017-07-01 11:47:54,1,3,2,老师是很好的老师，辐射防护课平时一直很为我们着想，期末考试前还和我们说很简单的不会挂我们。确实挺简单的，但是拿高分并不容易，已经告诉老师15级88分和89分GPA不一样了，估计之后会有改观。祝大家选课愉快。（可水，上课时间在678经常听得很困
63306,986,徐新华,2017-11-30 09:24:25,3,3,0,环境学概论上完感觉老师不适合课堂教学，上课挺枯燥的，没什么互动。课后没有作业
115987,986,徐新华,2019-08-28 03:29:15,1,3,2,。。。。。。。
1106,1000,陈红,2015-03-21 16:10:27,-1,5,6,讲课很认真，不点名
2906,1000,陈红,2015-05-11 00:22:00,1,6,5,通识课要求手写论文...写英文的或字好看的分高...上课一般没什么意思
24158,1000,陈红,2016-04-28 02:35:07,1,3,2,没意思
31952,1000,陈红,2016-07-05 08:25:52,-2,4,6,老师上课很认真，讲的东西你感觉很浅显，其实正是你不不知道的，且是考试难点所在。给分也超好，大家一定要每堂课认认真真听。
50955,1000,陈红,2017-05-10 05:29:51,3,4,1,退了噢
55371,1000,陈红,2017-07-01 11:38:08,0,1,1,老师挺好的，就是作为大二选了环境生物学不知道在学啥？不考试，期末是展示和论文，大概作为大三选修的话还可以（水）。老师鼓励大家用英语，然后展示时候有创意。15级环工环科还有原味课程，不知道怎么样。
57069,1000,陈红,2017-07-05 11:23:33,1,4,3,蟹蟹老师给我上4！
57130,1000,陈红,2017-07-05 15:15:19,1,1,0,上课就是刷PPT，算是科普课。最后考试很多内容都是PPT上的，一定要打下来。
57250,1000,陈红,2017-07-06 07:04:02,2,5,3,很水，然后给分不好
206265,1000,陈红,2024-12-13 12:18:53,0,0,0,111
218568,1000,陈红,2025-04-24 15:57:48,0,0,0,老师很温柔
20960,1026,谢晓梅,2016-02-05 12:37:55,-7,3,10,老师对实验报告的要求很高很高很高，相当严格，但是老师会很耐心地一对一地指导学生写实验报告，这样负责的老师很难得！
21732,1026,谢晓梅,2016-03-01 02:12:08,1,2,1,老师对实验报告要求真的很高，做她的实验能学到很多，但有时候实验报告真的神烦
79266,1026,谢晓梅,2018-05-29 10:10:54,9,14,5,垃圾实验课毁我青春浪费时间
79917,1026,谢晓梅,2018-06-15 07:35:07,2,4,2,屁事多，才一学分的课不知道瞎折腾些什么，给分还差?
83425,1026,谢晓梅,2018-07-10 09:04:25,6,8,2,辣鸡老师\n\n土壤学实验 1学分的课还搞什么自主实验 占据周末时间 平时实验课照常上\n\n做完自主实验 期末还得交一份实验论文\n\n注意：这个要求是在最后一节课 结题答辩的时候才说的\n\n对 你没有看错 自主实验也有开题和结题答辩\n\n不说了 考试周结束还得肝论文 今晚就截止了
83529,1026,谢晓梅,2018-07-10 13:49:56,1,2,1,呵呵呵\n\n
83611,1026,谢晓梅,2018-07-10 23:39:50,1,2,1,不是很好
85209,1026,谢晓梅,2018-07-16 04:56:12,1,2,1,很认真…但绩点真的很烂…心很累
85246,1026,谢晓梅,2018-11-07 06:07:24,1,3,2,谢老师挺认真负责的，不过的确事太多了，1分的实验课的事比4.5的土壤学还多?
89736,1026,谢晓梅,2018-11-20 12:46:45,3,4,1,我搞不懂，明明旁边有那么多机器可以用，或者是明明有备用的多的滴定管啊什么的，从来不肯拿出来用，藏着是能变金子么？？？一整排的八个人只有两根滴定管，其中一根还是坏的？？？wtf把坏的拿走也不拿出新的来，完完全全不为学生着想。学生的时间就不是时间了么？就可以随便浪费了么？课程设置两节课从来没准时下过课，我服了...
96676,1026,谢晓梅,2019-01-21 08:57:17,2,3,1,言而无信，朝三暮四。\n\n我感觉一个老师起码要为自己说过的话负责吧，想一出是一出学生很难受啊。另外环化实验巨麻烦事还多。
100894,1026,谢晓梅,2019-01-27 04:51:41,0,0,0,很差劲，千万别信了她的邪，自主实验人少做小实验，人多做大实验，其实她根本分不清每个实验的工作量。所以，尽量组6人组。
112776,1026,谢晓梅,2019-07-05 02:53:54,17,17,0,老师人很好！教学很严谨，为老师疯狂打call！
117579,1026,谢晓梅,2019-09-26 07:28:50,0,0,0,都不说扣分点，然后莫名其妙给分？？？
144156,1026,谢晓梅,2021-12-20 00:54:13,3,3,0,老师还是很认真负责的
159037,1026,谢晓梅,2022-07-05 02:28:41,1,4,3,豆腐嘴，刀子心
174938,1026,谢晓梅,2023-06-20 07:20:43,7,7,0,上的老师土壤学实验，真的，我哭死。老师是真的很好的老师，实验过程指导都很详细，之前身体原因跟老师请假老师也非常照顾学生感受！真的很温暖！
174941,1026,谢晓梅,2023-06-20 07:42:42,3,3,0,老师真的很好 感觉没有之前说的毛病了 真的好老师。
176620,1026,谢晓梅,2023-06-29 12:46:05,0,0,0,前三周不用写实验报告真的很nice，老师认人贼快上课也很亲切，最后一次实验手上打着石膏板给我们上课有点感动，就是一直让坐第一排的同学多负责空白组的实验可能安排的不是很好，尽量轮着来吧；有俩次实验迟到了，报告写得其实也比较一般，还是被老师捞起来叻大爱
182204,1026,谢晓梅,2023-11-12 13:25:48,5,5,0,老师很和善
191301,1026,谢晓梅,2024-04-17 04:03:01,2,2,0,我叫一声谢妈妈，应该没人反对吧
193784,1026,谢晓梅,2024-06-18 05:17:50,0,0,0,对实验报告挺严格要求挺高的，但是人挺亲切，会和我们闲聊，有种妈妈的感觉？？
193988,1026,谢晓梅,2024-06-21 07:58:13,0,0,0,棒，全A过，但是只有91，足以说明老师想要拉高低分了
219376,1026,谢晓梅,2025-05-26 06:25:15,0,0,0,言而无信，随便占用学生课外时间，想一出是一出，1学分的课，对自己的课程没有一点b数
220325,1026,谢晓梅,2025-06-17 09:03:41,0,0,0,上的土壤学实验，老师人很好很温柔，上课指导很细致。作为1学分的课来说确实任务量比较大（八次实验报告+一个自主设计实验），但一学期下来收获颇多，个人认为是很不错的一门课！
24845,1085,王莉红,2016-05-04 04:15:18,-4,8,12,好老师，有自己的看法，为人也nice\n\n
59638,1085,王莉红,2017-10-01 02:07:21,0,6,6,好像在教初中生一样，要在桌子上放一个名牌，还要拍一张人和名牌的照片传到群相册，最后考试还在考场观察，如果考试带了PPT要记下来扣分，还说会拍考试的视频。开学两周后交论文题目大纲，4周交初稿，6周交5000字终稿。。。。。她还说，台湾这个国家ヽ(#`Д´)ノ（虽然可能是口误，但是超不爽）发个邮件事情都超多，文件名一定要按她说的那样，错一个空格也不行。发到哪里上课也不说，在qq群里随便回复了一个人的，导致有人发错邮箱还被骂。总之，就是有毛病（╯‵□′）╯︵┴─┴
59660,1085,王莉红,2017-09-25 12:33:37,2,6,4,事儿多，上课特无聊
59661,1085,王莉红,2017-09-25 12:35:11,2,7,5,破事儿贼多
59662,1085,王莉红,2017-09-25 12:35:17,2,6,4,一上她课就困，神奇的魔力
69892,1085,王莉红,2018-01-25 15:32:10,-1,3,4,老师很认真，比较严格，喜欢听她讲案例\n\n
75730,1085,王莉红,2018-03-15 16:27:05,-1,1,2,不建议选
76122,1085,王莉红,2018-03-27 09:25:38,2,5,3,傻逼老师
76943,1085,王莉红,2018-04-26 08:21:38,12,12,0,第一个学期选她的课 觉得她要求很多很烦 但第二个学期完全改变了对她的看法 真的是个好老师 很和蔼 有时候也很可爱 虽然明年就要退休了 虽然对我们要求很多 但她也不至于一句话就能否认我们花了很长时间的成果
79650,1085,王莉红,2018-06-12 09:44:10,0,0,0,为lh姐姐爆灯啊爆灯！上课超级有活力经常会拿自己的工作经验举例子，干货很多认真学真的能学到很多东西！人也很好虽然平时要求很严格但是人真的好！【虽然一年下来最后还是跟lh姐姐的要求差了一大截】但还是要pick一下！超棒！【不过lh姐姐走路真的太快了穿皮鞋都能甩你八条街的那种快
89361,1085,王莉红,2018-11-18 16:47:43,0,0,0,王老师有情怀有理想有温度\n\n是我在浙大见过的最好的老师之一\n\n
99946,1085,王莉红,2019-01-25 10:27:32,0,0,0,建议大家不要选环境管理学当个性，否则就算是期末开卷成绩也很难看
125488,1272,王珂,2020-09-10 10:28:20,0,1,1,哦哦哦
126373,1272,王珂,2020-09-24 04:18:30,9,11,2,大格局，大视野，biger
124147,1290,许红卫,2020-06-25 14:25:34,0,0,0,老师认真负责，不过每次讲理论课我都昏昏欲睡，感觉不怎么调分。
23594,1315,尧一骏,2016-04-08 04:25:14,0,0,0,。。。
26784,1315,尧一骏,2016-06-21 06:06:55,0,0,0,人超级可爱
30823,1315,尧一骏,2016-07-02 14:36:58,0,0,0,老师人超级好 很可爱
20123,1399,李廷强,2016-01-26 07:10:31,-2,1,3,呵呵呵
20958,1399,李廷强,2016-02-05 12:31:59,11,14,3,上课全是重点，但是回答同学的问题很耐心，能学到很多～
21730,1399,李廷强,2016-03-01 02:10:38,-1,1,2,老师上课说实话挺无聊的
21731,1399,李廷强,2016-03-01 02:09:06,-1,1,2,浪费时间
24729,1399,李廷强,2016-05-03 08:21:37,6,6,0,老师讲的很清晰的。上课有时会问问题，尤其是找困的同学。人很好。
24731,1399,李廷强,2016-05-03 08:29:39,-2,0,2,还行吧，讲课都是重点，但是课确实无聊。\n\n
35379,1399,李廷强,2016-11-09 12:34:50,1,1,0,嗯嗯嗯
35487,1399,李廷强,2016-11-10 07:21:16,0,1,1,除非是真的感兴趣 不然真心学不到东西
35652,1399,李廷强,2016-11-21 06:55:19,1,3,2,
35994,1399,李廷强,2016-11-19 14:57:28,0,2,2,课怎么说呢...内容无聊...偶尔开个玩笑什么的，但给分，怕被正态就不要选...
36365,1399,李廷强,2016-11-12 09:59:53,5,5,0,认真听的话会有收获的
37200,1399,李廷强,2016-11-18 01:51:31,0,2,2,不说了，低于均绩
37227,1399,李廷强,2016-11-18 03:10:45,-1,0,1,上课很无聊，而且曾经说过考试看字迹\n\n
37230,1399,李廷强,2016-11-18 03:19:22,2,3,1,很有意思，但是给分超差
37234,1399,李廷强,2016-11-18 03:42:13,5,7,2,很多人抱怨，但我想说一切看自己的重视程度。按照老师的要求来，上课别肆无忌惮地玩手机，打印下所有PPT并且翻一遍，考试时字迹清楚条理清晰，给分不会低。真的。
37602,1399,李廷强,2016-11-19 15:47:51,0,0,0,看字秒杀。 不公平。
37946,1399,李廷强,2016-11-22 06:58:45,2,2,0,通识课给分真的不好????
38123,1399,李廷强,2016-11-25 00:40:37,1,2,1,老师强调过看重字迹，但这也不意味着会把对的答案批错。认真翻翻ppt，考试还是容易找到答案的，给分不错，虽然最后差一分就上0.3。老师比较幽默，能结合生活实际讲解
38248,1399,李廷强,2016-11-28 06:48:08,1,1,0,还好啦，考试监考呵呵了
38801,1399,李廷强,2016-12-19 06:03:05,0,0,0,我觉得干货满满啊（可能因为是文科生，对这些有熟悉感吧）老师上课真的让人觉得很有收获，如果好好听的话。考试重点都会告诉你，超棒棒
39961,1399,李廷强,2016-12-28 10:32:59,3,3,0,环境修复与生态健康，够水，没听过课，考试开卷，打好PPT狂翻，成绩还算可以的。老师人不错，看没人提前交卷还觉得自己卷子出难了哈哈
41442,1399,李廷强,2017-01-11 15:06:41,0,0,0,给分 呵呵呵呵呵呵呵呵
63009,1399,李廷强,2017-11-28 02:16:30,0,0,0,讲的内容可能不大用得到，但了解一下很不错的，作业不多，考试也都能找得到！
63803,1399,李廷强,2017-12-15 05:06:02,0,0,0,祝愿李老师全家幸福
64397,1399,李廷强,2017-12-23 07:56:06,0,0,0,通识课水，不点名，开卷考，有平时作业
76678,1399,李廷强,2018-04-18 05:40:39,0,0,0,老师人挺好的\n\n
106267,1399,李廷强,2019-04-26 04:33:32,0,5,5,见过老师考场给答案的么？他就是。呵呵哒了，复习那么多遍那么久，他考场上几句话就把分数差距缩没了。当然，大部分人对这种情况都是喜闻乐见，但我还是想呵呵呵呵呵
137871,1399,李廷强,2021-07-06 12:33:24,0,0,0,很可爱的老师
205430,1399,李廷强,2024-12-06 06:23:16,1,1,0,对博士生还挺好，不喜欢不努力的学生。不过可能硕博更合适天赋型学生，自己没有想法的话，推进课题也比较难。有的学硕也是专利毕业，没有做出来文章。有的硕士又有英文。课题组整体颜值都比较高。
24530,1429,李勇,2016-05-01 06:24:52,-558,42,600,老师上课很用心，虽然会点名，但都是第二节课点，给同学们互相通知的时间。给分也超好，讲的挺生动的，全程板书无ppt，总之是个有趣的老头。哈哈。
26636,1429,李勇,2016-06-20 12:39:16,-503,35,538,老师写板书，用心，可爱，很亲切，讲的也好。但是比较迷糊，统分给我少加了20，最后给我加上了，一个劲的向我道歉，老师人很好
76539,1429,李勇,2018-04-13 03:00:03,45,65,20,不知所云！！？！？
179514,1429,李勇,2023-09-18 01:21:05,1578,1727,149,听说他手下的硕士5年不给毕业，最近几天失联了？
179642,1429,李勇,2023-09-19 04:14:25,1031,1055,24,murderer
179688,1429,李勇,2023-09-19 09:26:51,1365,1428,63,2023.9.19，浙江大学环资李勇之硕士，毕业论文早已写好但五年未毕业梁某遗体于紫金港被打捞上岸。
179712,1429,李勇,2023-09-19 12:36:33,943,958,15,2023年9月19日，前来吊唁不曾谋面的梁学长：等待他的理应是繁花似锦的未来，绝非这冰冷的湖水。
179721,1429,李勇,2023-09-19 13:21:38,601,623,22,亖马的东西就想找人给你打白工是吧，一直卡着别人不毕业，纯脑瘫，早点去亖吧
179722,1429,李勇,2023-09-19 13:32:52,224,228,4,******
179729,1429,李勇,2023-09-19 14:45:08,312,319,7,杀人犯
179736,1429,李勇,2023-09-19 15:42:27,97,99,2,建议0分
179738,1429,李勇,2023-09-19 15:53:47,254,259,5,德不配位，岩壁硕士真的牛
179739,1429,李勇,2023-09-19 15:57:59,144,145,1,师兄，一路走好啊
179741,1429,李勇,2023-09-19 16:05:13,104,107,3,不配为人师
179742,1429,李勇,2023-09-19 16:15:14,605,610,5,灿若星辰的背后，是多少看不见的灰烬呢。
179743,1429,李勇,2023-09-19 16:18:10,77,78,1,什么j8东西
179744,1429,李勇,2023-09-19 16:19:03,25,29,4,….
179746,1429,李勇,2023-09-19 16:26:04,48,49,1,黑心狗
179747,1429,李勇,2023-09-19 16:24:14,81,83,2,学长。。。不管怎么说，一路走好
179749,1429,李勇,2023-09-19 16:40:09,237,253,16,不知事件全貌，不予置评。但无论真相是什么，作为一位老师，他的回应让人心凉。
179750,1429,李勇,2023-09-19 16:40:53,406,412,6,事实就是人死了，很好奇李勇晚上会做噩梦吗？尸体睁着眼睛的那种
179752,1429,李勇,2023-09-19 17:12:36,39,40,1,怎么没有0分？
179754,1429,李勇,2023-09-20 00:48:09,205,211,6,李勇副叫兽，祝好死
179755,1429,李勇,2023-09-19 17:02:29,710,728,18,"我联系上梁师兄家属了\n\n加上了他姐姐\n\n\n\n他不知道\n\n\n\n33'\n\n他姐姐说学校事不关己，完全不管\n\n这件事情，然后给的补偿也是像打\n\n发要饭的一样。然后李勇当天晚上\n\n去指认尸体了，之后在派出所说他\n\n毕不了业，是因为他自己能力不行。\n\n不用，把自己的关系撇的非常的清\n\n然后导致现在警方以及学校就觉得\n\n说是杨师兄自己心理问题不想活了\n\n然后就是这件事情就在这停止了。\n\n他姐姐打接电话的时候哭得不行。\n\n\n\n51\n\n我后来问他姐姐，我说那梁师兄有，就是向家里人透露过任何关于退学这方面的信息吗？他说梁师兄，他说他没跟家里面说过，他一直跟他妈妈说的是他今年六月份会毕业的。然后说梁生也在骗他妈妈，我说他没有骗他妈妈，是李勇单方面宣布说他要退学，梁书生毕业论文都已经写完了，然后反正他姐姐就觉得说现在大家不举证，然后他就是。专一线跟学校对接没有任何的办法，学校就跟打饭要饭的一样，然后联系不上，完全就之后就不沟通了，他就希望我们能够站出来，然后举举证说就是。关于李勇的一些事情课题组的一些事情，然后他说想要再去报一下案，嗯。\n\n你把你手机号发给我\n\n我给他姐姐发一下\n\n到时候他姐姐问啥你就提供一下信息\n\n能帮点就帮点\n\n\n\n他姐姐一边哭一边说\n\n梁师兄捞起来的时候眼睛都是睁开的\n\n死不瞑目\n\n\n\n10""\n\n\n\n妈的 ly 真是人渣"
179756,1429,李勇,2023-09-19 16:53:46,479,497,18,点进评价，提示我要以事实为根据，以公正为准生，否则网站之崩殂近矣。那学长的身死能否得到公正的对待呢？还是，师德之崩殂令人心寒？这种舆论影响巨大的事情，浙大什么时候敢真正站出来主持公道作出声明而不是在背后包庇默许啊
179757,1429,李勇,2023-09-19 16:54:05,188,197,9,"我联系上梁师兄家属了\n\n加上了他姐姐\n\n\n\n他不知道\n\n\n\n33'\n\n他姐姐说学校事不关己，完全不管\n\n这件事情，然后给的补偿也是像打\n\n发要饭的一样。然后李勇当天晚上\n\n去指认尸体了，之后在派出所说他\n\n毕不了业，是因为他自己能力不行。\n\n不用，把自己的关系撇的非常的清\n\n然后导致现在警方以及学校就觉得\n\n说是杨师兄自己心理问题不想活了\n\n然后就是这件事情就在这停止了。\n\n他姐姐打接电话的时候哭得不行。\n\n\n\n51\n\n我后来问他姐姐，我说那梁师兄有，就是向家里人透露过任何关于退学这方面的信息吗？他说梁师兄，他说他没跟家里面说过，他一直跟他妈妈说的是他今年六月份会毕业的。然后说梁生也在骗他妈妈，我说他没有骗他妈妈，是李勇单方面宣布说他要退学，梁书生毕业论文都已经写完了，然后反正他姐姐就觉得说现在大家不举证，然后他就是。专一线跟学校对接没有任何的办法，学校就跟打饭要饭的一样，然后联系不上，完全就之后就不沟通了，他就希望我们能够站出来，然后举举证说就是。关于李勇的一些事情课题组的一些事情，然后他说想要再去报一下案，嗯。\n\n你把你手机号发给我\n\n我给他姐姐发一下\n\n到时候他姐姐问啥你就提供一下信息\n\n能帮点就帮点\n\n\n\n他姐姐一边哭一边说\n\n梁师兄捞起来的时候眼睛都是睁开的\n\n死不瞑目\n\n\n\n10""\n\n\n\n妈的 ly 真是人渣"
179758,1429,李勇,2023-09-19 17:00:01,70,73,3,🦈人要偿命！
179759,1429,李勇,2023-09-19 17:17:03,553,565,12,师兄呀，你我本无缘，但确实是在时代洪流里的同代人，在相似的轨道里拼命呼吸探头。\n\n师兄你定不是个自私的人，因为自私的人最贪生。中国革命先烈已用血肉身躯搬走压在人群群众胸膛的大山，而在学术环境可能有些畸形的现在，师兄您走的时候是否也在想，真正学术自由、趋于理想而不是屈于现实的那天会不会来到？\n\n仅此用这微薄数行字来悼念梁师兄您。
179760,1429,李勇,2023-09-19 17:17:33,48,50,2,你妈的你怎么不退学？
179761,1429,李勇,2023-09-19 17:28:55,46,46,0,啊？？
179762,1429,李勇,2023-09-19 17:31:21,29,34,5,………
179763,1429,李勇,2023-09-19 17:40:00,42,42,0,人渣！！！
179764,1429,李勇,2023-09-19 17:43:12,116,124,8,缅怀。。。不了解情况，但是没人会轻轻松松放弃自己的家人和生命。该死的人总有一天是该死的
179765,1429,李勇,2023-09-19 17:56:41,54,56,2,永远怀念
179766,1429,李勇,2023-09-19 17:58:53,49,52,3,德不配位
179767,1429,李勇,2023-09-19 18:16:04,48,52,4,出生啊
179770,1429,李勇,2023-09-19 18:21:38,97,100,3,chusheng，早点亖去吧，怎么不出门给车创亖啊，怎么还活着
179771,1429,李勇,2023-09-19 18:44:56,37,46,9,为什么还有八点几分。。。。。
179774,1429,李勇,2023-09-19 23:13:56,46,48,2,彼阳晚意 初升东羲
179776,1429,李勇,2023-09-19 23:25:22,31,39,8,害群之马\n\n也可能群也不怎么样
179777,1429,李勇,2023-09-19 23:26:31,23,24,1,我去你🐴的
179778,1429,李勇,2023-09-19 23:38:56,23,23,0,垃圾玩意
179779,1429,李勇,2023-09-19 23:44:41,21,24,3,太可怕了杀人犯
179781,1429,李勇,2023-09-19 23:57:32,29,32,3,唉 真该死啊你
179782,1429,李勇,2023-09-20 00:01:52,70,74,4,杀人犯
179783,1429,李勇,2023-09-20 00:09:20,36,37,1,畜生啊
179785,1429,李勇,2023-09-20 00:20:38,31,33,2,呵呵呵
179787,1429,李勇,2023-09-20 00:22:29,40,40,0,逆天初生
179788,1429,李勇,2023-09-20 02:10:21,154,164,10,勇淹顶真，鉴定为：真没，你不浮起？
179789,1429,李勇,2023-09-20 00:25:34,16,19,3,nmsl
179790,1429,李勇,2023-09-20 00:26:25,12,13,1,。。。
179791,1429,李勇,2023-09-20 00:27:46,55,59,4,为什么没有0分
179792,1429,李勇,2023-09-20 00:44:49,14,14,0,司马玩意给爷s
179793,1429,李勇,2023-09-20 00:31:16,19,22,3,建议0分
179795,1429,李勇,2023-09-20 00:37:08,37,38,1,杀人犯
179797,1429,李勇,2023-09-20 00:57:01,137,138,1,选的点名，因为阎王点卯
179798,1429,李勇,2023-09-20 01:02:17,8,11,3,lj导师
179799,1429,李勇,2023-09-20 01:01:28,12,13,1,垃圾战斗机
179800,1429,李勇,2023-09-20 01:04:00,10,11,1,啊啊啊啊啊啊啊啊唉
179801,1429,李勇,2023-09-20 01:05:11,27,28,1,R.I.P
179802,1429,李勇,2023-09-20 01:06:00,12,12,0,…….
179804,1429,李勇,2023-09-20 01:10:13,14,14,0,R.I.p
179805,1429,李勇,2023-09-20 01:11:09,11,13,2,德不配位
179807,1429,李勇,2023-09-20 01:14:55,42,43,1,地狱空荡荡，恶魔在人间
179808,1429,李勇,2023-09-20 01:17:29,15,16,1,来刷0分
179809,1429,李勇,2023-09-20 01:18:12,28,31,3,Damn you， motherfucker murderer!
179810,1429,李勇,2023-09-20 01:25:13,14,15,1,murderer
179811,1429,李勇,2023-09-20 01:30:38,8,8,0,呵呵，6
179812,1429,李勇,2023-09-20 01:33:19,9,11,2,杀人犯
179813,1429,李勇,2023-09-20 01:33:54,10,12,2,杀人犯
179815,1429,李勇,2023-09-21 13:54:23,43,45,2,不知全貌不予评论，但请ly不要逃避
179816,1429,李勇,2023-09-20 01:43:28,8,9,1,……自己品
179817,1429,李勇,2023-09-20 01:46:32,11,11,0,杀人犯，你什么时候去死
179818,1429,李勇,2023-09-20 01:47:55,4,6,2,出生
179819,1429,李勇,2023-09-20 01:48:33,7,7,0,？？？
179821,1429,李勇,2023-09-20 01:50:28,11,13,2,一条年轻生命不应该消逝在这种地方
179822,1429,李勇,2023-09-20 01:52:15,12,14,2,你能不能去死啊，还有脸说是学生能力不足？
179824,1429,李勇,2023-09-20 01:55:30,79,88,9,该老师要求5年级硕士必须发顶刊，间接导致学生死亡。
179826,1429,李勇,2023-09-20 01:59:33,5,5,0,好好好
179827,1429,李勇,2023-09-20 02:01:58,22,23,1,杀人犯，你逃避了法律，却迟早有一天会受到道德的谴责和良心的折磨！你所做的一切，都将把你被钉在浙大的耻辱柱上！
179828,1429,李勇,2023-09-20 02:01:23,1,3,2,house
179829,1429,李勇,2023-09-20 02:03:19,2,5,3,这是杀人犯，刽子手
179831,1429,李勇,2023-09-20 02:09:23,3,4,1,司马老师
179836,1429,李勇,2023-09-20 02:07:45,5,6,1,shame every day
179837,1429,李勇,2023-09-20 02:07:53,-51,6,57,不知全貌
179838,1429,李勇,2023-09-20 02:08:22,5,6,1,这是谋杀
179839,1429,李勇,2023-09-20 08:37:00,1,4,3,杀人犯
179841,1429,李勇,2023-09-20 02:09:44,2,2,0,1111
179843,1429,李勇,2023-09-20 02:10:54,-1,1,2,呵呵呵
179844,1429,李勇,2023-09-20 02:12:36,0,1,1,鄙视🖕🏻
179847,1429,李勇,2023-09-20 02:12:33,9,10,1,午夜梦回，小心了
179849,1429,李勇,2023-09-20 02:12:53,2,3,1,杀人犯快死了得了
179850,1429,李勇,2023-09-21 02:33:16,22,23,1,murderer
179852,1429,李勇,2023-09-20 02:13:28,3,3,0,murderer
179854,1429,李勇,2023-09-20 07:47:21,3,5,2,逝者安息
179856,1429,李勇,2023-09-20 02:15:43,1,2,1,R·I·P 兄弟
179857,1429,李勇,2023-09-20 02:17:37,2,2,0,rip
179858,1429,李勇,2023-09-20 02:19:45,30,32,2,没人在意一个生命的消逝，只在意这个“能力不够”的人的投湖会不会给这位老师带来前程上的影响
179859,1429,李勇,2023-09-21 16:26:17,26,28,2,太过分了!愿天堂没有痛苦🙏🏻\n\n又有硕士生自杀了，ly畜牲制造的前一起血案能逃脱关系吗？
179860,1429,李勇,2023-09-25 08:15:16,3,5,2,出生狗玩意
179862,1429,李勇,2023-09-20 02:22:15,-70,8,78,未知全貌
179863,1429,李勇,2023-09-20 03:00:29,4,4,0,渣滓导师，逼死学生
179864,1429,李勇,2023-09-20 07:41:14,-1,2,3,师兄一路走好
179865,1429,李勇,2023-09-20 02:22:46,-82,9,91,有人刷分是吧，阴兵过境？
179866,1429,李勇,2023-10-07 03:23:58,40,45,5,鲜活的生命不应该悄无声息的逝去
179867,1429,李勇,2023-09-20 02:25:19,4,5,1,杀人犯
179868,1429,李勇,2023-09-20 02:27:41,4,4,0,杀人犯
179869,1429,李勇,2023-09-20 02:27:53,1,4,3,缅怀师兄
179870,1429,李勇,2023-09-20 02:28:01,1,1,0,hhh
179871,1429,李勇,2023-09-20 02:28:26,6,6,0,师兄，一路走好
179873,1429,李勇,2023-09-20 02:33:34,2,5,3,杀人犯
179874,1429,李勇,2023-09-20 02:35:29,13,14,1,你就是那个让学生读了五年硕士毕不了业的杀人凶手是吧
179875,1429,李勇,2023-09-20 02:40:55,-2,1,3,。。。
179878,1429,李勇,2023-09-20 02:39:52,0,1,1,杀人犯nmsl
179879,1429,李勇,2023-09-20 02:42:00,2,2,0,by晚意
179880,1429,李勇,2023-09-20 02:51:04,4,5,1,专门来问候下chushen货色，做这种事晚上睡觉记得睁眼，呵呵
179881,1429,李勇,2023-09-20 02:59:07,0,1,1,老出生了
179883,1429,李勇,2023-09-20 02:52:42,0,1,1,刑 xing
179884,1429,李勇,2023-09-22 10:37:31,26,28,2,murderer
179886,1429,李勇,2023-09-20 02:54:52,2,2,0,RIP
179888,1429,李勇,2023-09-20 02:57:06,0,0,0,。。。
179889,1429,李勇,2023-09-20 02:57:35,1,1,0,R.I.P
179891,1429,李勇,2023-09-20 03:01:08,72,75,3,农生环c座13楼，你也知道心虚把地址电话啥的都改了啊？murderer!
179893,1429,李勇,2023-09-20 03:06:19,2,2,0,murder
179894,1429,李勇,2023-09-20 03:07:31,-1,1,2,畜生东西
179895,1429,李勇,2023-09-20 03:09:42,17,18,1,我要是毕业失败了带走害我那个的时候顺便帮你也带走
179896,1429,李勇,2023-09-21 06:06:17,3,4,1,狗东西
179897,1429,李勇,2023-09-20 03:12:48,5,5,0,杀人偿命 不得安宁 苟活人世
179899,1429,李勇,2023-09-20 03:17:01,1,2,1,妥妥cs
179900,1429,李勇,2023-09-20 03:17:11,55,59,4,什么murderer，不管你几个母亲都不够死了给你学生赎罪的，沟酿羊的崽肿，硕士卡五年？你他骂人一辈子有几个五年？我是学生家属的话你活不过明天。
179901,1429,李勇,2023-09-20 03:21:15,-1,0,1,它的评分为什么不是1……
179902,1429,李勇,2023-09-20 03:24:22,1,3,2,。。。
179903,1429,李勇,2023-09-20 03:22:54,3,4,1,。。。
179904,1429,李勇,2023-09-20 03:22:55,5,6,1,。。。
179905,1429,李勇,2023-09-20 03:22:57,-1,2,3,李勇，yydss，永远的杀手
179906,1429,李勇,2023-09-20 03:22:57,1,3,2,李勇，yydss，永远的杀手
179908,1429,李勇,2023-09-20 09:25:47,9,11,2,岩壁的鲨必
179910,1429,李勇,2023-09-20 03:30:21,2,2,0,杀人犯
179912,1429,李勇,2023-09-20 03:37:07,-1,0,1,让人心寒
179913,1429,李勇,2023-09-20 03:34:04,0,0,0,看不懂
179914,1429,李勇,2023-09-20 08:23:48,0,0,0,杀人犯
179917,1429,李勇,2023-09-25 15:53:32,42,44,2,今日，我为他人发声，但他人不为我发声，学校更是捂住我的嘴。他日轮到我头上时，我也只能自认倒霉。
179919,1429,李勇,2023-09-20 03:42:21,0,2,2,出生啊
179920,1429,李勇,2023-09-20 03:42:50,1,1,0,bdbd
179922,1429,李勇,2023-09-20 03:49:05,12,14,2,实在不行让孟学士和你自爆一下吧，煞笔玩意
179923,1429,李勇,2023-09-20 03:48:20,3,3,0,是个测桑
179925,1429,李勇,2023-09-20 04:00:51,13,14,1,司马玩意，评分还被控得涨起来了
179927,1429,李勇,2023-09-20 04:11:09,2,2,0,😭😭😭👊👊👊🙏🙏🙄😊
179929,1429,李勇,2023-09-20 04:09:37,4,6,2,彼阳晚意，初生东曦
179930,1429,李勇,2023-09-20 04:12:12,0,1,1,真恶心，人渣，魔鬼
179931,1429,李勇,2023-09-22 02:10:39,1,4,3,光辉之后，是一将功成万骨枯
179933,1429,李勇,2023-09-20 04:20:52,43,58,15,希望大家理智发声，不要转发一些带有或是涉及到在校生个人隐私的信息类似聊天记录截图或是文字，会给在校生带来很大的影响，希望大家也能力所能及地保护好这些同学，斟酌发声
179934,1429,李勇,2023-09-20 04:24:07,-1,1,2,杀人犯
179935,1429,李勇,2023-09-20 04:26:47,83,88,5,听说老师非常好，喜欢游泳，希望下次可以和您一起共游启真湖。
179937,1429,李勇,2023-09-20 04:33:02,-1,0,1,草泥马
179938,1429,李勇,2023-09-20 04:35:56,1,1,0,666
179939,1429,李勇,2023-09-20 04:36:08,141,148,7,如果你不心虚，请问你为什么要把教师个人主页的头像和电话号码都改成假的？？？\n\n我本来还在想有没有可能是梁学长自己或者家里的原因导致想不开，但是看了你后续的一系列操作，我反而确信了你就是那个杀人凶手。
179941,1429,李勇,2023-09-20 04:41:49,2,2,0,R.I.P
179942,1429,李勇,2023-09-20 04:46:49,2,4,2,杀人凶手
179943,1429,李勇,2023-09-20 05:18:17,0,1,1,sb不解释
179945,1429,李勇,2023-09-20 04:49:56,2,2,0,逼死研究生
179946,1429,李勇,2023-09-20 04:51:42,-1,0,1,111
179947,1429,李勇,2023-09-20 04:52:56,0,2,2,垃圾人，畜生不如
179948,1429,李勇,2023-09-27 09:56:06,7,7,0,怎么还不被解聘啊
179949,1429,李勇,2023-09-20 04:55:22,3,3,0,杀人犯，杀人犯
179950,1429,李勇,2023-09-20 04:57:12,-1,0,1,nmsl
179951,1429,李勇,2023-09-20 08:02:23,0,1,1,不要再祸害其他人了
179952,1429,李勇,2023-09-20 05:00:51,1,2,1,murder
179953,1429,李勇,2023-09-20 05:10:50,0,1,1,去死吧
179954,1429,李勇,2023-09-20 05:07:57,1,1,0,Murderer
179955,1429,李勇,2023-09-20 05:11:35,20,21,1,不知道事情全貌，但我却知道生命的分量，我不敢多想，倘若是长久的考虑决定如此，那么这位老师是做了什么会让一个人放弃自己的家人，自己所爱的一切？我不愿多想，逝者安息，愿正义虽迟但到，愿星星不再陨落。
179956,1429,李勇,2023-09-20 14:58:42,10,13,3,2023.9.19，浙江大学环资李勇之硕士，毕业论文早已写好但五年未毕业梁某遗体于紫金港被打捞上岸。
179959,1429,李勇,2023-09-20 06:16:32,1,2,1,➗生啊
179960,1429,李勇,2023-09-20 05:20:16,-1,1,2,初生牛犊不怕虎
179961,1429,李勇,2023-09-20 08:18:30,2,2,0,初生东曦
179962,1429,李勇,2023-09-22 04:05:26,7,8,1,chushen
179963,1429,李勇,2023-09-20 05:19:13,1,2,1,你好？
179964,1429,李勇,2023-09-20 05:22:01,2,2,0,杀人偿命
179965,1429,李勇,2023-09-20 05:23:12,0,1,1,无话可说
179966,1429,李勇,2023-09-20 05:23:13,2,2,0,无话可说
179967,1429,李勇,2023-09-20 05:24:30,3,3,0,杀人犯爬
179968,1429,李勇,2023-09-20 17:20:29,0,2,2,畜生都比你有良心
179969,1429,李勇,2023-09-20 05:28:50,3,4,1,快滚吧
179972,1429,李勇,2023-09-20 06:24:41,-1,1,2,狗东西
179975,1429,李勇,2023-09-20 23:47:19,-1,0,1,murder
179976,1429,李勇,2023-09-20 05:35:56,3,4,1,。。。
179978,1429,李勇,2023-09-20 05:44:35,0,0,0,RIP
179979,1429,李勇,2023-09-20 05:44:57,1,1,0,老师。教授。专家。博导。。。
179980,1429,李勇,2023-09-20 10:21:56,3,5,2,李勇怎么还没上热门搜索呀？\n\n以及这么多条评论怎么显示不出来啊？
179981,1429,李勇,2023-09-20 05:48:31,1,3,2,murder
179982,1429,李勇,2023-09-24 07:32:14,-1,1,2,垃圾傻逼
179983,1429,李勇,2023-09-20 05:54:34,1,2,1,逼死人的垃圾导师
179985,1429,李勇,2023-09-20 05:55:30,1,2,1,你是真的6
179986,1429,李勇,2023-09-20 05:59:43,2,2,0,可以这很野种
179987,1429,李勇,2023-09-20 06:03:27,-1,1,2,呵呵呵呵，对待多年的学生都能这样恶心，颠倒是非黑白，更别说上课的同学了
179988,1429,李勇,2023-09-20 07:24:14,0,1,1,唉。唉。唉。
179990,1429,李勇,2023-09-20 06:10:06,-1,0,1,滚。。
179991,1429,李勇,2023-09-20 06:10:08,2,2,0,师兄辛苦了
179992,1429,李勇,2023-09-28 15:22:57,4,4,0,………
179994,1429,李勇,2023-09-20 06:11:18,-1,0,1,无言以对，呜呼哀哉
179995,1429,李勇,2023-09-20 06:14:06,0,0,0,nmsl
179996,1429,李勇,2023-09-20 06:18:19,0,1,1,不配做老师
179997,1429,李勇,2023-09-20 06:18:07,-1,0,1,he he
179998,1429,李勇,2023-09-20 06:18:35,1,1,0,渣导，不多说
179999,1429,李勇,2023-09-20 06:19:58,0,1,1,murderer
180000,1429,李勇,2023-09-20 06:20:37,1,1,0,。。。
180001,1429,李勇,2023-09-20 06:20:46,4,4,0,助力一下
180002,1429,李勇,2023-09-20 06:21:50,0,1,1,杀人犯
180003,1429,李勇,2023-09-20 06:22:41,1,1,0,睡得着吗
180004,1429,李勇,2023-09-20 06:24:02,0,1,1,你是砂仁饭
180006,1429,李勇,2023-09-20 06:25:42,2,2,0,逝者安息
180008,1429,李勇,2023-09-21 02:37:09,71,75,4,今日，我不为他人发声，他日轮到我头上时又该如何？
180010,1429,李勇,2023-09-20 06:31:00,0,1,1,....
180012,1429,李勇,2023-09-20 06:35:24,0,1,1,杀人犯
180013,1429,李勇,2023-09-20 06:36:57,0,1,1,不愧是环资
180014,1429,李勇,2023-09-20 06:37:07,2,3,1,不知道李老师喜欢在启真湖游泳嘛】
180015,1429,李勇,2023-09-20 06:37:43,2,2,0,杀人犯
180016,1429,李勇,2023-09-20 06:37:43,0,1,1,杀人犯
180017,1429,李勇,2023-09-27 14:52:54,0,2,2,rip
180018,1429,李勇,2023-09-20 07:48:18,0,1,1,cs 晚上小心点，你给我等着，哪天就把你拖到湖底去了
180019,1429,李勇,2023-09-20 06:39:16,1,1,0,食不食仁啊？
180020,1429,李勇,2023-09-20 06:40:56,1,1,0,傻逼去死
180021,1429,李勇,2023-09-20 06:41:18,1,1,0,R.I.P
180022,1429,李勇,2023-09-27 05:33:43,4,4,0,这就是浙大
180023,1429,李勇,2023-09-20 06:44:22,0,1,1,梁兄，RIP
180024,1429,李勇,2023-09-20 08:38:12,3,3,0,是谁在刷高分 笑死
180025,1429,李勇,2023-09-20 06:50:57,2,2,0,出生东西
180026,1429,李勇,2023-09-20 11:45:10,3,3,0,杂种人渣
180027,1429,李勇,2023-09-20 06:57:59,62,65,3,给你一分是因为最低只能打一分，没有更低的选项。临时带课题组学生出差让课题组学生参加不了梁同学的葬礼，可真有你的。
180029,1429,李勇,2023-09-20 07:03:51,0,1,1,。。。
180032,1429,李勇,2023-09-20 17:11:18,19,19,0,下面，我命令，法警！\n\n对故意杀人罪犯，李勇，验明正身，押赴刑场，执行枪决！\n\n“砰！”
180034,1429,李勇,2023-09-20 07:12:59,5,5,0,学长一路走好 希望这些垃圾导师得到惩治
180035,1429,李勇,2023-09-20 07:15:52,1,2,1,杀人犯
180038,1429,李勇,2023-09-20 07:26:11,-32,8,40,浙奸大学整体素质也就那样了只能说
180039,1429,李勇,2023-09-20 07:32:23,0,1,1,杀人犯
180040,1429,李勇,2023-09-20 07:38:08,0,1,1,唉 活生生一条生命啊
180041,1429,李勇,2023-09-20 07:39:12,0,0,0,她该有多痛苦
180043,1429,李勇,2023-09-20 07:41:38,0,1,1,sbsb
180044,1429,李勇,2023-09-20 07:42:15,0,1,1,大学是干什么的？\n\n大学要把学生塑造成怎样的人？
180045,1429,李勇,2023-09-20 07:43:12,0,2,2,出生出身
180046,1429,李勇,2023-09-20 07:45:52,0,1,1,mmp
180047,1429,李勇,2023-09-20 12:30:55,1,1,0,热度不能下去！！
180048,1429,李勇,2023-09-20 07:50:20,-1,0,1,nmsl
180049,1429,李勇,2023-09-20 07:51:22,1,2,1,。。。
180050,1429,李勇,2023-09-20 07:54:46,0,1,1,.......
180052,1429,李勇,2023-09-20 07:57:15,1,1,0,sbdx
180053,1429,李勇,2023-09-20 07:58:01,0,1,1,。。。
180054,1429,李勇,2023-09-20 07:59:23,2,2,0,去死吧
180055,1429,李勇,2023-09-20 08:00:37,0,1,1,。。。。。
180056,1429,李勇,2023-09-20 08:00:55,2,4,2,逆天导，垃圾战斗机
180057,1429,李勇,2023-09-20 08:03:44,0,1,1,murderer
180058,1429,李勇,2023-09-20 08:06:02,0,0,0,...
180059,1429,李勇,2023-09-20 08:07:44,0,0,0,出生早点4啊
180060,1429,李勇,2023-09-20 08:51:32,1,2,1,令人愤慨
180062,1429,李勇,2023-09-20 15:41:30,-1,0,1,666
180065,1429,李勇,2023-09-20 08:20:47,0,1,1,渣导qs
180066,1429,李勇,2023-09-20 08:23:18,0,1,1,杀人犯
180067,1429,李勇,2023-09-22 15:01:39,1,3,2,枪毙！枪毙！
180068,1429,李勇,2023-09-20 11:49:00,0,2,2,草菅人命
180069,1429,李勇,2023-09-20 08:33:21,1,1,0,狗屎！
180070,1429,李勇,2023-09-20 08:34:41,0,1,1,呵呵呵
180071,1429,李勇,2023-09-20 08:38:33,2,2,0,渣滓。。。
180077,1429,李勇,2023-09-21 15:09:43,0,0,0,不多说了。。。。。。
180080,1429,李勇,2023-09-20 09:01:39,2,2,0,希望和老师一起游泳
180082,1429,李勇,2023-09-20 09:05:34,3,5,2,20230919
180083,1429,李勇,2023-09-21 16:12:40,5,5,0,人模狗样
180084,1429,李勇,2023-09-23 02:35:44,0,3,3,很失望
180086,1429,李勇,2023-09-20 09:17:30,0,1,1,狗屎狗屎
180087,1429,李勇,2023-09-20 09:23:34,0,1,1,纯出生啊
180089,1429,李勇,2023-09-20 09:27:29,0,1,1,。。。
180091,1429,李勇,2023-09-23 11:43:18,6,7,1,亖🐎玩意\n\n\n\n\n\n\n\n学长安息
180093,1429,李勇,2023-09-20 09:33:27,1,7,6,等待一个真相
180094,1429,李勇,2023-09-20 09:40:16,13,15,2,不能沉默，因为这有可能是我。\n\n不能闭嘴，因为我的痛苦也可能被漠视。
180100,1429,李勇,2023-09-20 09:50:49,1,1,0,zhuhaosi!
180101,1429,李勇,2023-09-20 09:51:18,1,2,1,晚上别睡得太死
180102,1429,李勇,2023-09-21 08:07:03,-1,1,2,不好说
180103,1429,李勇,2023-09-20 09:56:31,6,6,0,听说是杀人犯
180104,1429,李勇,2023-09-20 09:57:34,0,1,1,畜生禽兽
180107,1429,李勇,2023-09-20 09:59:27,1,1,0,杀人犯
180108,1429,李勇,2023-09-20 10:05:56,0,1,1,全家死光的混蛋
180110,1429,李勇,2023-09-20 10:21:47,2,4,2,不是谴责学长，但是无数实例真的证明了，任何时候都不要自己放弃生命，伤心的只会是自己的家人朋友，而那些出生依旧逍遥法外。
180111,1429,李勇,2023-09-20 10:16:24,2,2,0,默哀。。。
180112,1429,李勇,2023-09-20 10:16:24,0,1,1,默哀。。。
180113,1429,李勇,2023-09-20 10:17:22,0,0,0,默哀.
180115,1429,李勇,2023-09-20 16:15:26,3,5,2,2023年9月20日，为逝去的学长默哀，1分是系统的极限，不是我的极限
180116,1429,李勇,2023-09-20 16:27:17,0,0,0,一个出生
180118,1429,李勇,2023-09-20 10:20:25,1,2,1,师兄一路走好
180119,1429,李勇,2023-09-20 14:20:13,0,1,1,出生东西
180120,1429,李勇,2023-09-20 10:22:56,0,1,1,真的6
180122,1429,李勇,2023-09-20 10:28:37,4,4,0,杀人犯
180123,1429,李勇,2023-09-20 10:31:10,0,2,2,午夜梦回，你会不会想起那个被你害死的学生？
180124,1429,李勇,2023-09-20 10:33:52,1,1,0,这种老师也配继续待在这？
180127,1429,李勇,2023-09-20 11:32:41,1,1,0,“画面背后有人死去”\n\n\n\n（以及……不知道是写给谁\n\nそれでも僕らは必死に生きて，\n\n命を必死に抱えて生きて，\n\n殺してあがいて笑って抱えて，\n\n生きて生きて生きて生きて生きろ。
180129,1429,李勇,2023-09-20 10:43:24,2,4,2,心虚了？还改网页电话
180132,1429,李勇,2023-09-20 10:55:51,0,1,1,人神共愤
180133,1429,李勇,2023-09-20 10:55:01,2,2,0,不要选杀人犯的课，不要到杀人犯那里读研究生，让杀人犯自生自灭吧
180134,1429,李勇,2023-09-20 10:54:56,3,5,2,不要选杀人犯的课，不要到杀人犯那里读研究生，让杀人犯自生自灭吧
180135,1429,李勇,2023-09-20 10:59:23,0,1,1,jbwy
180136,1429,李勇,2023-09-20 10:59:23,0,0,0,jbwy
180138,1429,李勇,2023-09-20 11:01:14,0,2,2,愿师兄的家人节哀，希望学校hui ying q
180140,1429,李勇,2023-09-20 11:14:39,0,1,1,出生东西
180142,1429,李勇,2023-09-23 04:50:06,9,11,2,垃圾玩意，逼死学生，还能通过官方手段成功洗脱嫌疑？\n\n还好这个剑冢1.04分追上徐小洲了，收敛于一指日可待\n\n还有最下面的那个评论，不是评论错人了就是在无脑乱洗，狸蛹这个逼06年本科毕业，16年的时候才32岁左右，怎么可能被叫做“老头”呢？
180143,1429,李勇,2023-09-20 11:18:20,1,2,1,逼养的玩意 去死吧
180145,1429,李勇,2023-09-20 11:19:42,0,3,3,杀人犯
180146,1429,李勇,2023-09-20 11:21:58,-33,0,33,哈哈哈
180148,1429,李勇,2023-09-20 11:25:55,0,1,1,000
180149,1429,李勇,2023-10-01 08:06:51,1,3,2,好似喵
180150,1429,李勇,2023-09-28 03:08:44,2,3,1,死马玩意
180151,1429,李勇,2023-09-20 11:31:57,1,2,1,杀人犯
180152,1429,李勇,2023-09-20 11:35:55,1,1,0,go fuck yourself
180154,1429,李勇,2023-09-20 11:53:19,2,2,0,nmsl
180155,1429,李勇,2023-09-26 02:16:40,17,18,1,收敛于1
180156,1429,李勇,2023-09-20 11:58:49,2,2,0,不怕半夜睡觉学生变鬼找你嘛
180158,1429,李勇,2023-09-20 12:05:05,0,3,3,就是sb
180159,1429,李勇,2023-09-20 12:06:15,4,5,1,1分只是因为最低是1分而不是0分......\n\n等待学长的本来应该是前程似锦，而不是冰冷的湖水。
180163,1429,李勇,2023-09-20 14:12:32,4,4,0,老师有喝过湖水嘛
180164,1429,李勇,2023-09-20 12:13:30,0,1,1,出生啊
180165,1429,李勇,2023-09-20 12:21:38,2,3,1,自己怎么不延毕
180166,1429,李勇,2023-09-20 12:26:34,10,10,0,今日我不发声，明日无人为我摇旗呐喊。
180175,1429,李勇,2023-09-20 13:08:54,0,2,2,分为什么会涨
180176,1429,李勇,2023-09-20 12:56:56,0,1,1,德不配位
180179,1429,李勇,2023-09-20 13:02:27,0,1,1,....
180180,1429,李勇,2023-09-20 13:03:40,1,1,0,狗东西
180183,1429,李勇,2023-09-20 13:15:12,1,2,1,闻讯来报
180186,1429,李勇,2023-09-20 13:18:52,3,4,1,SHAME ON ZJU
180187,1429,李勇,2023-09-20 13:21:35,0,2,2,什么时候招了个非人类东西进来？
180189,1429,李勇,2023-09-20 13:22:27,3,4,1,老师这个词语也是你能侮辱的
180193,1429,李勇,2023-09-20 13:37:09,0,0,0,师兄，一路走好啊
180194,1429,李勇,2023-09-20 13:39:25,1,2,1,不了解详情，但老师的回应真的逆天
180195,1429,李勇,2023-09-20 13:46:11,4,4,0,非人哉
180200,1429,李勇,2023-09-20 13:54:46,2,3,1,杀人犯！该死！
180201,1429,李勇,2023-09-20 13:56:35,1,4,3,我现在需要一个比初生碗艺更有攻击性的词
180203,1429,李勇,2023-09-20 14:08:17,-1,0,1,出生啊
180204,1429,李勇,2023-09-20 14:12:53,2,2,0,莎β早点趋势
180207,1429,李勇,2023-09-20 14:23:53,2,2,0,。。。
180210,1429,李勇,2023-09-20 14:31:28,0,1,1,l j
180211,1429,李勇,2023-09-20 14:36:46,0,1,1,司马东西
180212,1429,李勇,2023-09-20 14:40:49,0,2,2,murderer
180213,1429,李勇,2023-09-20 14:55:23,0,1,1,mbjy
180214,1429,李勇,2023-09-20 14:55:46,4,4,0,安息学长
180215,1429,李勇,2023-09-20 15:01:16,1,2,1,你睡得着嘛
180216,1429,李勇,2023-09-28 05:59:18,4,4,0,垃圾。
180218,1429,李勇,2023-09-20 15:06:18,3,4,1,启真湖
180219,1429,李勇,2023-09-20 15:06:41,0,1,1,出生玩意儿
180220,1429,李勇,2023-09-20 15:06:42,1,2,1,逼死学生是吧？
180221,1429,李勇,2023-09-20 15:10:18,2,3,1,呵呵，果然地狱空荡荡，魔鬼在人间。
180222,1429,李勇,2023-09-20 15:10:18,-1,1,2,呵呵，果然地狱空荡荡，魔鬼在人间。
180223,1429,李勇,2023-09-20 15:11:28,1,2,1,。。。
180225,1429,李勇,2023-09-20 15:21:52,2,3,1,命不久矣
180226,1429,李勇,2023-09-20 15:28:28,0,1,1,纯纯沙币
180227,1429,李勇,2023-09-20 15:30:48,1,2,1,师兄一路走好。李叫兽杀人偿命。
180228,1429,李勇,2023-09-20 15:35:58,1,3,2,启真之水清兮，可以濯吾缨；启真之水浊兮，可以濯我足。
180232,1429,李勇,2023-09-21 05:34:48,2,4,2,阿米诺斯，杀人犯
180233,1429,李勇,2023-09-20 15:56:28,2,3,1,先质疑
180235,1429,李勇,2023-09-20 16:12:21,3,4,1,翳眼丁真\n\n鍳定為：\n\n緋霧初升東兮，似瑪在中
180236,1429,李勇,2023-09-20 16:15:31,0,2,2,翳眼丁真\n\n鍳定為：\n\n緋霧初升東兮，似瑪在中
180237,1429,李勇,2023-09-20 16:18:09,1,2,1,管管这马出生玩意
180238,1429,李勇,2023-09-20 16:23:24,0,2,2,亖马玩意，不想评论。
180239,1429,李勇,2023-09-20 16:23:28,3,3,0,启真底，学子殇
180241,1429,李勇,2023-09-20 16:37:15,5,10,5,在真相公布之前，希望大家理智一点，不要带节奏，让子弹飞一会，很多时候你对别人进行的网暴也会成为一把杀人的利刃
180245,1429,李勇,2023-09-20 16:43:45,0,1,1,希望师兄以后都只遇到温暖
180246,1429,李勇,2023-09-21 14:11:55,2,2,0,rip
180252,1429,李勇,2023-09-21 11:22:36,11,12,1,murder
180253,1429,李勇,2023-09-21 00:16:48,0,3,3,。。。
180254,1429,李勇,2023-09-21 00:17:33,4,5,1,zzzz
180255,1429,李勇,2023-09-21 00:49:36,3,5,2,唉，不想说什么了
180256,1429,李勇,2023-09-21 00:50:06,3,5,2,杀人犯
180257,1429,李勇,2023-09-21 00:52:45,1,3,2,666
180258,1429,李勇,2023-09-21 01:10:22,2,3,1,人渣导师
180259,1429,李勇,2023-09-21 01:26:36,4,5,1,老出生！
180260,1429,李勇,2023-09-21 01:35:33,10,10,0,杀人凶手，给我下地狱
180261,1429,李勇,2023-09-21 01:43:34,2,3,1,杀人犯
180262,1429,李勇,2023-09-21 05:32:19,2,4,2,没道德
180265,1429,李勇,2023-09-21 01:59:56,3,3,0,🐈‍⬛
180269,1429,李勇,2023-09-21 02:32:25,5,5,0,纯出生
180270,1429,李勇,2023-09-21 02:20:23,17,18,1,希望学长以生命为代价的“栽树”，能为后来的学子撑起一片“绿荫”，逝者安息
180271,1429,李勇,2023-09-21 02:24:27,13,14,1,浮尸沉下去，浮木也跟着下地狱😋
180273,1429,李勇,2023-09-21 02:28:11,14,15,1,去尼玛的渣导！你午夜梦回不会看见死人在对你笑吗？他自己心理有问题自己死的不关你事对吧？那你小心自己说的话还给你自己！
180277,1429,李勇,2023-09-21 02:31:23,27,29,2,真正的猛士，敢于直面惨淡的人生，敢于直面淋漓的鲜血。\n\n\n\n—《纪念刘和珍君》
180280,1429,李勇,2023-09-21 02:47:58,3,3,0,rip
180282,1429,李勇,2023-09-21 02:57:32,14,15,1,一分是评分系统的下线，不是你的下线
180283,1429,李勇,2023-09-21 03:02:41,4,4,0,murderer
180284,1429,李勇,2023-09-21 03:03:26,25,28,3,＂风吹过，成片的秸秆们倒下了，在繁华的希望之地，一群群无面人的生死和来去都无人在意，他们只是可以被替换的螺丝，这是最好的时代，也是最坏的时代。＂
180285,1429,李勇,2023-09-21 03:04:03,-1,1,2,哈哈哈
180287,1429,李勇,2023-09-21 03:07:36,1,2,1,你为什么不去死
180288,1429,李勇,2023-09-21 03:09:28,0,0,0,cnm
180291,1429,李勇,2023-09-21 03:17:00,1,1,0,杀人蜂
180294,1429,李勇,2023-09-22 01:28:08,29,29,0,如果今天我们选择沉默，那么明天这就是我们的结局
180296,1429,李勇,2023-09-21 03:52:12,1,2,1,？？？
180297,1429,李勇,2023-09-21 03:53:34,-1,0,1,逝者安息
180298,1429,李勇,2023-09-21 04:12:17,-1,1,2,RIP
180299,1429,李勇,2023-09-28 09:06:51,-1,2,3,抛开事实不谈，这玩意也是老师？
180300,1429,李勇,2023-09-21 04:23:22,0,0,0,唉😮‍💨
180301,1429,李勇,2023-09-21 04:35:22,2,3,1,逝者安息
180302,1429,李勇,2023-09-21 04:37:16,3,4,1,杀人犯
180304,1429,李勇,2023-09-21 04:42:48,0,1,1,杀人犯
180306,1429,李勇,2023-09-21 04:54:05,1,2,1,纯减除
180307,1429,李勇,2023-09-21 04:56:27,2,3,1,弱智……
180308,1429,李勇,2023-09-22 10:47:13,11,14,3,启真湖水…好冷…
180310,1429,李勇,2023-09-21 05:14:39,0,1,1,逝者安息
180311,1429,李勇,2023-09-21 05:15:59,4,6,2,444
180314,1429,李勇,2023-09-21 05:25:56,2,4,2,听说你逼硕士退学导致他投湖，简直不是人
180321,1429,李勇,2023-10-03 01:17:45,20,21,1,我燃烧你的梦
180323,1429,李勇,2023-09-21 05:45:44,2,3,1,murderer
180324,1429,李勇,2023-09-21 05:54:46,4,4,0,司马玩意儿
180325,1429,李勇,2023-09-21 06:11:16,-1,1,2,murderer
180334,1429,李勇,2023-09-21 06:37:06,1,2,1,r.i.p
180344,1429,李勇,2023-09-21 07:18:14,1,1,0,垃圾玩意哦
180347,1429,李勇,2023-09-21 07:22:48,2,3,1,murderer
180349,1429,李勇,2023-09-21 07:26:38,-1,1,2,学长rip
180350,1429,李勇,2023-09-27 13:17:19,12,13,1,分数有极限，人格无下限
180353,1429,李勇,2023-09-21 08:51:46,3,3,0,murdere
180359,1429,李勇,2023-09-21 08:11:27,1,2,1,ljr
180361,1429,李勇,2023-09-22 14:28:58,31,33,2,恭喜杀人犯成功洗脱嫌疑，感谢浙江大学公关人员的高效率工作，感谢浙江大学尊重每一位教职人员的工作态度，感谢调查小组求是的工作作风！
180363,1429,李勇,2023-09-21 08:22:38,0,2,2,。。。
180364,1429,李勇,2023-09-21 08:41:10,-1,2,3,000
180369,1429,李勇,2023-09-21 08:46:13,-9,0,9,哈哈哈
180370,1429,李勇,2023-09-21 08:51:01,8,8,0,所谓高绩老师是想骗本科生打工吧。学校还在公关，建议直接去似。
180375,1429,李勇,2023-09-21 09:31:52,1,2,1,助力一下
180385,1429,李勇,2023-09-21 10:37:33,2,2,0,給爺䶕
180388,1429,李勇,2023-09-21 10:45:43,0,2,2,垃圾东西
180397,1429,李勇,2023-09-21 11:23:04,1,1,0,。。。
180398,1429,李勇,2023-09-21 11:23:26,1,1,0,浙大公关保留节目
180401,1429,李勇,2023-09-21 11:33:45,3,3,0,杀人犯
180404,1429,李勇,2023-09-25 04:52:37,7,9,2,怎么都骂它
180406,1429,李勇,2023-09-21 12:32:08,5,6,1,彼阳若至，初升东曦。\n\n\n\n绯雾飒蔽，似幕绡绸。\n\n\n\n彼阳篝碧，雾霂涧滁。\n\n\n\n赤石冬溪，似玛瑙潭。\n\n\n\n彼阳晚意，暖梦似乐。\n\n\n\n寐游浮沐，若雉飞舞。
180414,1429,李勇,2023-09-21 13:15:08,-1,1,2,心痛，愤怒。
180416,1429,李勇,2023-09-21 13:33:39,3,3,0,公道自在人心
180419,1429,李勇,2023-09-21 13:47:21,2,3,1,赤石去吧，出生。
180421,1429,李勇,2023-09-21 13:53:13,-1,0,1,murderer
180422,1429,李勇,2023-09-21 16:49:13,0,0,0,去你妈的！吃人！
180424,1429,李勇,2023-09-21 14:01:11,2,2,0,dinner
180425,1429,李勇,2023-09-21 14:15:15,1,3,2,杀人犯
180426,1429,李勇,2023-09-21 14:34:10,-13,0,13,非常期待😊
180427,1429,李勇,2023-09-21 14:51:29,-1,0,1,很难绷
180428,1429,李勇,2023-09-21 14:52:19,-1,0,1,………
180429,1429,李勇,2023-09-21 14:52:20,0,1,1,………
180430,1429,李勇,2023-09-21 14:52:21,1,1,0,………
180431,1429,李勇,2023-09-21 14:59:53,-1,1,2,为什么最低分不是0
180439,1429,李勇,2023-09-21 15:22:08,1,1,0,不予评价
180440,1429,李勇,2023-09-21 15:25:14,3,3,0,既定事实：该老师的硕士五年级研究生投湖
180442,1429,李勇,2023-09-21 15:40:48,2,3,1,lakers
180443,1429,李勇,2023-09-21 15:48:30,1,3,2,改天和老李去启真湖游泳
180444,1429,李勇,2023-09-21 15:49:26,2,2,0,虾仁饭
180446,1429,李勇,2023-09-21 15:54:21,-1,1,2,出生榜榜首
180447,1429,李勇,2023-09-21 15:59:26,0,0,0,...
180448,1429,李勇,2023-09-21 16:00:00,4,4,0,。。。
180449,1429,李勇,2023-09-21 16:04:03,0,1,1,murderer！
180450,1429,李勇,2023-09-21 16:06:14,3,4,1,傻逼 去si
180453,1429,李勇,2023-09-21 16:37:51,1,3,2,启真湖很浅，但也能研四人。
180454,1429,李勇,2023-09-21 16:47:53,0,2,2,murder
180466,1429,李勇,2023-09-22 00:56:25,1,2,1,老逼登
180469,1429,李勇,2023-09-22 01:11:36,5,5,0,杀人犯
180472,1429,李勇,2023-09-22 02:05:44,1,2,1,吊唁学长
180474,1429,李勇,2023-09-22 01:54:44,2,3,1,是傻逼
180475,1429,李勇,2023-09-22 02:08:16,3,4,1,smwy
180488,1429,李勇,2023-09-22 03:08:49,1,2,1,顺天易
180494,1429,李勇,2023-09-22 03:35:16,-1,0,1,唉唉唉，
180495,1429,李勇,2023-09-22 03:40:24,2,2,0,昆虫一般的男人
180496,1429,李勇,2023-09-22 03:41:25,10,13,3,梁师兄只是被爆出来的，那以前遭受不公待遇的学长学姐呢，有多少是不被我们知道的，真的很可恶，如果这种事情不严肃处理，以后受苦受难的就是我们，必须严惩！！！
180498,1429,李勇,2023-09-22 03:40:14,2,4,2,看看你这个彼阳晚意干的好事，以后谁还敢在本校读研
180499,1429,李勇,2023-09-22 03:50:35,-1,0,1,帮顶帮顶
180500,1429,李勇,2023-09-22 03:50:35,-1,0,1,帮顶帮顶
180504,1429,李勇,2023-09-22 04:07:43,0,1,1,1分给多了
180507,1429,李勇,2023-09-22 05:37:44,2,3,1,唉，没有无限逼近一分是你我过错啊
180523,1429,李勇,2023-09-22 09:38:27,3,3,0,外校的，微博看到的，司马老师
180534,1429,李勇,2023-09-22 12:25:14,-1,0,1,自古以来，杀人就得偿命！
180535,1429,李勇,2023-09-22 12:34:59,0,0,0,...
180540,1429,李勇,2023-09-22 14:28:17,0,1,1,呃呃呃
180550,1429,李勇,2023-09-22 15:43:41,1,2,1,赶紧滚吧
180551,1429,李勇,2023-09-22 15:43:54,1,2,1,你活该1分
180557,1429,李勇,2023-09-22 23:58:35,2,2,0,En su agua calmaré\n\nEste amargo dolor
180573,1429,李勇,2023-09-23 04:03:09,6,6,0,杀人偿命
180580,1429,李勇,2023-09-23 04:55:41,3,3,0,杀人犯
180581,1429,李勇,2023-09-23 04:40:37,4,5,1,配做老师吗
180583,1429,李勇,2023-09-23 04:51:24,1,3,2,什么牛马
180586,1429,李勇,2023-09-23 05:51:14,6,6,0,给1分是因为只有1分
180589,1429,李勇,2023-09-30 16:51:31,36,37,1,没有收敛到1.01每个浙大学子都有责任\n\n枪毙都不解恨
180592,1429,李勇,2023-09-23 07:01:19,7,7,0,食人者，人共唾之
180612,1429,李勇,2023-09-23 11:09:09,2,3,1,见鬼去吧
180618,1429,李勇,2023-09-23 14:19:33,-1,0,1,SBB
180621,1429,李勇,2023-09-23 14:47:46,-1,0,1,逆天导师
180622,1429,李勇,2023-09-23 14:50:44,-1,0,1,以事实为依据
180629,1429,李勇,2023-09-23 16:31:13,0,1,1,垃圾！收敛吧！！
180635,1429,李勇,2023-09-24 04:20:33,-1,0,1,害人凶手啊
180639,1429,李勇,2023-09-24 05:10:48,4,6,2,这不收敛于1能行？藏真湖呵呵
180640,1429,李勇,2023-09-24 05:32:06,0,0,0,杀人犯
180660,1429,李勇,2023-09-24 11:39:47,3,3,0,murderer
180670,1429,李勇,2023-09-24 16:03:26,1,1,0,......
180672,1429,李勇,2023-09-24 18:07:28,1,1,0,😅😅😅
180698,1429,李勇,2023-09-25 03:53:07,48,51,3,彼阳的晚意\n\n初升的东曦\n\n美目的顾耳\n\n似暮的篝壁\n\n温柔是你的梦\n\n宛如少女的梦\n\n但我扯碎你梦的翅膀\n\n并阐述你的梦\n\n我骑上尤热烈的马\n\n来摩洛哥城堡\n\n似玛瑙潭\n\n柠檬酸了\n\n暖梦熟了\n\n柠檬熟了，暖梦死了\n\n未成熟难梦到愁般\n\n笙变，失败，伤悲\n\n丝般暖梦似乐\n\n溺梦愁编
180704,1429,李勇,2023-09-25 05:15:37,4,5,1,。。。只能沉默，沉没
180719,1429,李勇,2023-09-25 09:56:30,24,24,0,等我毕不了业，除了我的导师顺道把你也带走去一个美好的地方
180734,1429,李勇,2023-09-25 11:56:54,-1,0,1,逼养的
180744,1429,李勇,2023-09-25 15:03:01,1,4,3,其人性之卑劣无耻，骇人听闻，令人发指
180746,1429,李勇,2023-09-25 15:39:08,-1,0,1,死去吧
180751,1429,李勇,2023-09-25 17:42:12,0,0,0,丟咖煲芝愁溪仙钓泥
180754,1429,李勇,2023-09-26 15:21:09,5,6,1,不要脸
180769,1429,李勇,2023-09-26 03:42:38,32,33,1,请你滚出浙大好吗，带上那些帮你洗裤子的领导。滚吧，滚，记住你们这些人都会遗臭万年。不是不报，时候未到
180773,1429,李勇,2023-09-26 04:50:18,3,4,1,🤬🤬😰
180774,1429,李勇,2023-09-26 05:29:00,2,3,1,sb..
180787,1429,李勇,2023-09-26 07:43:42,6,8,2,傻逼学校
180788,1429,李勇,2023-09-26 07:44:13,2,3,1,smwy
180790,1429,李勇,2023-09-26 08:18:15,2,4,2,1.0
180810,1429,李勇,2023-09-26 13:09:41,1,3,2,l，;l
180830,1429,李勇,2023-09-27 04:06:09,-1,1,2,rzqs
180844,1429,李勇,2023-09-27 06:19:12,2,2,0,RIP
180884,1429,李勇,2023-09-27 14:46:15,3,3,0,smshs
180921,1429,李勇,2023-09-28 07:20:38,-1,0,1,gswy
180926,1429,李勇,2023-09-28 07:49:46,0,2,2,还所有人一个真相
180935,1429,李勇,2023-09-28 11:42:09,3,3,0,杀人凶手下地狱
180950,1429,李勇,2023-09-29 00:08:08,1,1,0,逝者安息
180955,1429,李勇,2023-09-29 05:45:51,-32,0,32,非常棒
180957,1429,李勇,2023-09-29 10:03:56,-30,1,31,非常棒
180959,1429,李勇,2023-09-29 11:31:59,-1,0,1,逝者安息
180971,1429,李勇,2023-09-30 04:58:03,5,7,2,嘈思泥锝👵
180972,1429,李勇,2023-09-30 05:59:05,1,2,1,杀人犯
180978,1429,李勇,2023-09-30 10:42:50,4,6,2,把你全家杀光，把你碎尸都不解恨
180993,1429,李勇,2023-10-01 03:04:56,0,2,2,不要逃避
180999,1429,李勇,2023-10-01 11:26:57,0,0,0,沙杯老师
181010,1429,李勇,2023-10-02 07:41:07,3,3,0,岩淹丁真，鉴定为一宴宴就胜
181016,1429,李勇,2023-10-02 14:25:12,-6,0,6,为什么
181019,1429,李勇,2023-10-03 07:27:13,2,2,0,👮‍♀️👮👮‍♂️
181021,1429,李勇,2023-10-03 09:03:38,-1,0,1,murder
181024,1429,李勇,2023-10-04 04:37:04,5,6,1,滚出浙大
181028,1429,李勇,2023-10-05 13:03:13,21,25,4,今天是2023年10月5日，还没听说学校层面对这件事，这个出生的处理结果。去了此出生的办公室，估计是出差还没回来。现在已经不指望它能滚出浙大了，因为浙大和它一样烂
181043,1429,李勇,2023-10-06 14:23:02,4,4,0,杀人犯
181044,1429,李勇,2023-10-06 14:38:34,1,2,1,收敛
181053,1429,李勇,2023-10-07 03:26:19,1,3,2,murderer
181060,1429,李勇,2023-10-07 04:13:29,0,1,1,狗东西一个
181073,1429,李勇,2023-10-07 10:39:23,5,5,0,2023/10/07学校未响应
181075,1429,李勇,2023-10-07 11:00:31,0,1,1,666
181087,1429,李勇,2023-10-08 02:21:42,4,5,1,争取早日收敛于1
181093,1429,李勇,2023-10-08 06:24:22,7,7,0,亚运不是挡箭牌。
181103,1429,李勇,2023-10-08 13:50:45,6,7,1,我扯碎你梦的翅膀！
181117,1429,李勇,2023-10-09 03:51:12,19,21,2,非常好的老师，希望能与您共游启真湖
181118,1429,李勇,2023-10-09 03:52:01,0,1,1,纯啥比
181121,1429,李勇,2023-10-09 07:41:45,0,0,0,fvv
181126,1429,李勇,2023-10-09 10:00:51,0,1,1,思穆东曦
181129,1429,李勇,2023-10-09 13:41:48,1,1,0,滚滚滚
181135,1429,李勇,2023-10-09 16:04:48,-4,1,5,10.10
181152,1429,李勇,2023-10-10 06:14:30,-1,0,1,真相总在心里
181158,1429,李勇,2023-10-10 09:50:28,1,2,1,执行枪决
181159,1429,李勇,2023-10-10 09:59:46,4,5,1,彼阳若至，初升东曦。
181200,1429,李勇,2023-10-11 09:41:13,0,1,1,傻逼啊
181211,1429,李勇,2023-10-11 15:18:08,1,1,0,cnm
181216,1429,李勇,2023-10-12 01:02:07,2,2,0,德育教师
181249,1429,李勇,2023-10-18 11:30:59,12,12,0,怎么还是1.04，不能1.00吗？
181272,1429,李勇,2023-10-13 01:11:19,2,4,2,不怕鬼敲门么？
181305,1429,李勇,2023-10-13 13:17:32,0,1,1,垃圾拉
181320,1429,李勇,2023-10-14 06:57:15,29,33,4,老师太好了，送给老师一首诗经：\n\n彼阳若至，初升东曦。\n\n\n\n绯雾飒蔽，似幕绡绸。\n\n\n\n彼阳篝碧，雾霂涧滁。\n\n\n\n赤石冬溪，似玛瑙潭。\n\n\n\n彼阳晚意，暖梦似乐。\n\n\n\n寐游浮沐，若雉飞舞
181325,1429,李勇,2023-10-14 12:33:50,2,2,0,哈哈哈
181356,1429,李勇,2023-10-16 00:37:33,0,2,2,杀人犯
181362,1429,李勇,2023-10-16 03:18:30,2,4,2,2023/10/16\n\n学校未回应
181374,1429,李勇,2023-10-16 05:17:15,-1,0,1,nmly
181378,1429,李勇,2023-10-16 06:14:50,0,0,0,大傻逼
181393,1429,李勇,2023-10-16 13:13:04,1,2,1,cs一个
181398,1429,李勇,2023-10-17 00:32:00,3,4,1,不知所云
181414,1429,李勇,2023-10-17 07:37:01,6,8,2,把你剁成肉泥冲到下水道
181432,1429,李勇,2023-10-17 13:36:06,1,1,0,纯纯出生
181467,1429,李勇,2023-10-18 08:35:19,1,3,2,滚滚滚
181490,1429,李勇,2023-10-19 05:14:31,3,4,1,不要逃避，站出来解释
181550,1429,李勇,2023-10-22 12:17:42,1,1,0,。。。。。。。。
181572,1429,李勇,2023-10-23 06:29:25,5,6,1,听说它复活了？
181573,1429,李勇,2023-10-25 05:24:32,0,1,1,滚滚滚
181578,1429,李勇,2023-10-23 08:56:09,0,1,1,怎么还敢出来讲座
181618,1429,李勇,2023-10-24 11:29:11,0,1,1,复活了？
181658,1429,李勇,2023-10-25 13:15:32,0,2,2,人在做天在看
181707,1429,李勇,2023-10-29 11:04:32,2,2,0,exa
181821,1429,李勇,2023-11-01 17:44:47,0,1,1,杀人犯不得好死
181880,1429,李勇,2023-11-03 04:12:44,1,1,0,...
181885,1429,李勇,2023-11-03 08:25:42,-1,0,1,。。。
181987,1429,李勇,2023-11-07 10:04:31,0,1,1,离谱...
182036,1429,李勇,2023-11-08 14:46:23,0,1,1,杀人偿命
182091,1429,李勇,2023-11-10 01:18:28,2,2,0,收敛于1
182099,1429,李勇,2023-11-10 02:32:35,0,1,1,司马减重
182103,1429,李勇,2023-11-10 03:15:26,0,0,0,受不了了
182115,1429,李勇,2023-11-10 07:21:12,1,1,0,狗东西
182126,1429,李勇,2023-11-10 10:56:36,-1,0,1,踩一脚
182193,1429,李勇,2023-11-12 07:04:23,1,1,0,...
182212,1429,李勇,2023-11-13 00:13:01,-1,0,1,？。。？。。。。。。
182221,1429,李勇,2023-11-13 02:41:22,1,1,0,........................
182227,1429,李勇,2023-11-13 03:18:58,0,1,1,gun'yuan'dian
182243,1429,李勇,2023-11-13 07:35:33,0,0,0,四码洞悉
182376,1429,李勇,2023-11-15 09:58:57,3,3,0,向1看齐
182377,1429,李勇,2023-11-15 10:05:17,0,1,1,砂仁犯
182407,1429,李勇,2023-11-15 15:02:27,-3,0,3,不清楚
182424,1429,李勇,2023-11-16 02:48:04,2,3,1,启真湖底见
182468,1429,李勇,2023-11-16 08:27:50,0,1,1,狗屁老师
182588,1429,李勇,2023-11-21 16:18:00,1,1,0,向1看齐
182612,1429,李勇,2023-11-18 08:31:21,0,1,1,斯慕玩意，吃人的构洞悉
182644,1429,李勇,2023-11-18 16:08:02,1,1,0,murderer
182663,1429,李勇,2023-11-19 06:02:19,1,1,0,心凉了
182813,1429,李勇,2023-11-20 11:34:29,-9,0,9,???
182903,1429,李勇,2023-11-21 04:18:35,8,8,0,师兄的冤魂每天都会在李勇身上缠绕不散
182972,1429,李勇,2023-11-21 09:03:07,4,4,0,你的良心不会痛吗
183096,1429,李勇,2023-11-22 06:15:23,-1,0,1,😀🥲🥲
183246,1429,李勇,2023-11-23 06:22:11,5,8,3,草菅人命的导尸，手上沾满鲜血的叫兽
183261,1429,李勇,2023-11-23 08:40:54,2,3,1,你死了
183359,1429,李勇,2023-11-24 05:41:17,2,2,0,姒犸鸫烯
183452,1429,李勇,2023-11-26 11:38:26,-1,0,1,，，，
183596,1429,李勇,2023-11-27 14:43:52,0,0,0,嘿嘿嘿
183743,1429,李勇,2023-11-29 13:03:04,0,0,0,cnm
183796,1429,李勇,2023-11-30 06:58:09,0,2,2,杀人犯
183895,1429,李勇,2023-12-03 06:50:09,1,1,0,每天来鞭尸一次
183896,1429,李勇,2023-12-03 07:00:49,3,4,1,Forgetting is a betrayal of history
183924,1429,李勇,2023-12-04 01:25:35,7,7,0,怎么又在教师个人主页秽土转生了？一定要狠狠鞭尸！
184071,1429,李勇,2023-12-08 00:40:11,14,14,0,环资学科的科研本身就要实地采样，做长期实验，在折大我们正好可以李勇启真湖的天然优势，培养五年制硕士，早日发天堂列车、地府专快等一系列高质量期刊。
184110,1429,李勇,2023-12-09 14:31:00,8,9,1,四码洞悉，怎么在教师个人主页复活了？
184121,1429,李勇,2023-12-10 06:10:44,1,2,1,默哀……
184128,1429,李勇,2023-12-10 08:24:38,3,4,1,本温怒了，真的，本温怒怒？！！
184184,1429,李勇,2023-12-12 04:33:59,0,2,2,逼样玩意，处生东西
184238,1429,李勇,2023-12-13 17:16:33,0,1,1,缅怀前辈
184246,1429,李勇,2023-12-14 02:10:10,8,8,0,启真湖底的冤魂
184255,1429,李勇,2023-12-19 12:37:35,21,25,4,想必你🐴下面都长针眼了吧，全丢的隔壁老王的液体，咸死了，建议你堤防一下你ba，毕竟这么大的儿子还是杂种，不得哪天🐔都被🈹了，这杂种怎么还在教师个人主页复活了？全家死绝的东西，一定要狠狠鞭尸！
184317,1429,李勇,2023-12-17 03:16:18,0,1,1,a piece of shit
184332,1429,李勇,2023-12-18 00:24:39,4,6,2,先生千古
184334,1429,李勇,2023-12-18 03:16:30,1,1,0,哈哈哈
184345,1429,李勇,2023-12-18 05:45:08,-1,0,1,6666
184406,1429,李勇,2023-12-19 04:08:54,-2,1,3,要3个字怎么说
184420,1429,李勇,2023-12-19 09:05:20,-1,0,1,呵呵呵
184552,1429,李勇,2023-12-21 14:59:40,2,3,1,纯纯的珄寇，屮氼孖铩濞
184678,1429,李勇,2023-12-22 06:57:20,1,2,1,杀人犯
184725,1429,李勇,2023-12-26 15:59:30,0,0,0,666
184773,1429,李勇,2023-12-22 14:53:01,2,3,1,cnm
184778,1429,李勇,2023-12-22 15:34:47,0,0,0,haha
184805,1429,李勇,2023-12-23 02:31:56,1,3,2,杀人犯
184867,1429,李勇,2023-12-23 15:44:23,4,5,1,师兄一路走好...
184900,1429,李勇,2023-12-24 08:43:10,3,3,0,shagou
185016,1429,李勇,2023-12-25 16:06:09,2,3,1,初升对象
185020,1429,李勇,2023-12-26 00:20:41,1,1,0,hhhhh
185079,1429,李勇,2023-12-26 06:24:54,3,5,2,初生的东西还能打复活赛。
185356,1429,李勇,2023-12-28 07:30:19,5,5,0,杀人不偿生死债，来日自用尸血还
185390,1429,李勇,2023-12-28 15:53:06,2,3,1,阎王点卯
185435,1429,李勇,2023-12-29 09:02:56,-1,0,1,chu
185468,1429,李勇,2024-01-01 18:26:26,3,4,1,什么牛马东西还敢在教师个人主页复活！日常鞭尸
185476,1429,李勇,2023-12-30 06:25:08,0,1,1,晚上怎么睡得着的
185487,1429,李勇,2023-12-30 11:51:01,0,1,1,。。。。
185488,1429,李勇,2023-12-30 11:51:01,1,1,0,。。。。
185496,1429,李勇,2023-12-31 06:40:25,4,4,0,呵呵呵
185633,1429,李勇,2024-01-03 06:43:30,0,1,1,纯出生
185639,1429,李勇,2024-01-03 07:40:13,2,3,1,hywc
185710,1429,李勇,2024-01-03 18:03:02,1,3,2,真的是cs
185942,1429,李勇,2024-01-06 08:38:16,0,2,2,避雷这种人
186043,1429,李勇,2024-01-08 03:54:25,11,11,0,污染了我的主页
186682,1429,李勇,2024-01-12 12:21:12,4,4,0,成功收敛！
187145,1429,李勇,2024-01-14 17:10:55,0,1,1,四码洞悉
187271,1429,李勇,2024-01-15 10:49:52,5,5,0,启真湖的水好冷……
187369,1429,李勇,2024-01-15 15:27:22,1,2,1,害人不浅
187532,1429,李勇,2024-01-16 12:39:13,0,1,1,亖亖亖
188348,1429,李勇,2024-01-18 17:33:29,1,2,1,sb
188539,1429,李勇,2024-01-19 07:50:59,5,6,1,真是良心啊 sb一个
188572,1429,李勇,2024-01-24 14:49:52,20,21,1,科学研究表明，李勇体内可以合成一种特殊的烯烃，叫做四马鸫烯
188944,1429,李勇,2024-01-20 17:23:22,2,4,2,李勇安在哉？
189165,1429,李勇,2024-01-22 08:11:50,8,9,1,加加油，争取在过年前刷到1.00
189345,1429,李勇,2024-01-23 09:51:56,2,3,1,出生李勇
189401,1429,李勇,2024-01-24 02:32:01,5,6,1,收敛于0
189440,1429,李勇,2024-01-24 07:36:37,3,4,1,加速收敛
189461,1429,李勇,2024-01-24 11:12:24,3,4,1,日常踩
189466,1429,李勇,2024-01-24 13:47:50,3,4,1,。。。
189682,1429,李勇,2024-01-26 15:34:14,3,4,1,狗东西
189895,1429,李勇,2024-02-07 11:37:30,12,14,2,初升东曦，收敛于0.1145141919810，真他妈想一巴掌呼死这个比
189914,1429,李勇,2024-02-02 09:02:14,6,6,0,骂你傻逼都是在玷污傻逼这个词
189930,1429,李勇,2024-02-03 03:40:24,1,3,2,为这个出生评分收敛贡献一下
189989,1429,李勇,2024-02-06 05:02:12,6,7,1,杀人犯
190011,1429,李勇,2024-02-08 14:26:45,4,5,1,草泥马你个人渣，你的良心不会痛吗
190027,1429,李勇,2024-02-11 03:38:04,4,4,0,。。。
190090,1429,李勇,2024-02-20 10:16:19,1,3,2,傻逼一个
190134,1429,李勇,2024-02-23 13:00:11,-4,0,4,///
190311,1429,李勇,2024-02-28 01:20:05,2,5,3,murder
190334,1429,李勇,2024-02-28 06:37:57,2,3,1,司马东西
190498,1429,李勇,2024-03-06 04:17:33,2,2,0,1分还是太高了
190704,1429,李勇,2024-03-15 07:01:17,-1,0,1,hhh
190740,1429,李勇,2024-03-17 02:31:50,0,1,1,傻逼
190761,1429,李勇,2024-03-18 04:15:55,4,5,1,傻逼sb
190990,1429,李勇,2024-03-27 14:59:08,29,30,1,半年了。还记得我当时发现了李勇 facebook 反党言论，并贴在 cc98，结果也是不了了之。
191037,1429,李勇,2024-04-01 08:26:07,9,9,0,提前祝老师4月4日节日快乐！
191110,1429,李勇,2024-04-04 03:53:54,6,8,2,祝老师节日快乐！
191126,1429,李勇,2024-04-07 00:12:26,4,8,4,祝老💩清明节快乐
191218,1429,李勇,2024-04-12 13:32:57,3,4,1,没上过他的课，随便跟一下
191505,1429,李勇,2024-04-24 03:22:31,3,4,1,史💩💩
191580,1429,李勇,2024-04-25 09:40:04,15,16,1,今天又经过了启真湖，想起这位衣冠禽兽
191591,1429,李勇,2024-04-25 11:53:05,5,5,0,悲由心起，当真禽兽
191750,1429,李勇,2024-04-29 16:45:12,2,3,1,答辩💩
191975,1429,李勇,2024-05-06 13:56:39,0,1,1,䎭猊遤鎩翍
192384,1429,李勇,2024-05-17 05:26:55,3,4,1,值得全校最低分
192385,1429,李勇,2024-05-17 05:30:48,5,5,0,sb玩意
192572,1429,李勇,2024-05-24 03:56:09,1,2,1,lllll
192677,1429,李勇,2024-05-27 13:37:28,0,1,1,cs啊
192705,1429,李勇,2024-05-29 03:44:47,3,3,0,大狗屎
192726,1429,李勇,2024-05-29 12:38:36,0,2,2,shabi
192756,1429,李勇,2024-05-30 05:16:34,4,4,0,出生东西 害人
192893,1429,李勇,2024-05-31 10:33:44,0,0,0,。。。。
192941,1429,李勇,2024-06-01 03:55:38,0,0,0,srf
193120,1429,李勇,2024-06-03 16:14:58,1,3,2,纯傻逼
193169,1429,李勇,2024-06-04 07:02:37,1,1,0,无需多言
193176,1429,李勇,2024-06-04 07:39:41,1,2,1,💩💩💩
193185,1429,李勇,2024-06-04 08:42:30,-1,1,2,cs！
193265,1429,李勇,2024-06-05 12:12:26,1,2,1,没救了孩子
193451,1429,李勇,2024-06-11 05:19:16,2,3,1,贡献1分收敛
193614,1429,李勇,2024-06-14 02:48:55,2,2,0,收敛于1
193711,1429,李勇,2024-06-16 03:28:59,0,0,0,哈哈哈
193712,1429,李勇,2024-06-16 03:36:23,5,6,1,1分是打分系统的极限，不是 它 在浙大学生心中的底线
193978,1429,李勇,2024-06-21 07:17:07,0,1,1,💩💩💩💩💩💩
194021,1429,李勇,2024-06-21 12:43:22,1,1,0,哈哈哈
194051,1429,李勇,2024-06-21 15:27:39,4,4,0,为1.01做出贡献
194287,1429,李勇,2024-06-23 06:28:08,8,9,1,这种人暴毙荒野才算死得其所，被点天灯才算物尽其用
194406,1429,李勇,2024-06-23 16:13:26,-1,0,1,///
194622,1429,李勇,2024-06-24 16:07:49,0,2,2,希望大家不要忘记
194968,1429,李勇,2024-06-26 06:19:30,0,1,1,我们没有忘记
195497,1429,李勇,2024-06-28 11:27:51,1,3,2,真的猛士，将更奋然而前行。
195832,1429,李勇,2024-06-30 06:44:21,0,2,2,懂得都懂
196236,1429,李勇,2024-07-02 11:18:06,2,2,0,出生老师，压榨学生
196437,1429,李勇,2024-07-03 11:13:03,6,7,1,我不认识他，但是我帮你们收敛到一
196618,1429,李勇,2024-07-04 09:06:59,0,0,0,畜生，无师德
196652,1429,李勇,2024-07-04 14:00:14,0,0,0,1111
196691,1429,李勇,2024-07-23 08:50:37,2,3,1,执行枪决
196783,1429,李勇,2024-07-05 06:17:03,1,1,0,冲刺1.0！
196957,1429,李勇,2024-07-06 06:23:19,6,6,0,勿忘历史 早日收敛
196991,1429,李勇,2024-07-06 09:41:04,0,2,2,上香吐痰
197086,1429,李勇,2024-07-07 11:46:54,0,1,1,快速收敛到1
197108,1429,李勇,2024-07-07 18:45:50,0,0,0,尽快收敛
197155,1429,李勇,2024-07-08 08:28:59,1,1,0,助力同1个梦想
197195,1429,李勇,2024-07-09 02:11:22,0,1,1,收敛到1
197209,1429,李勇,2024-07-09 06:50:57,-1,0,1,？\n\n？？
197272,1429,李勇,2024-07-10 05:45:08,0,2,2,苟东西死全家
197407,1429,李勇,2024-07-13 04:37:21,3,4,1,呸，恶心玩意
197421,1429,李勇,2024-07-14 06:16:53,0,0,0,111
197563,1429,李勇,2024-07-19 07:32:02,0,0,0,蓸鲵溤翣裨
197593,1429,李勇,2024-07-20 13:20:33,1,2,1,正义扣1
197594,1429,李勇,2024-07-20 14:16:33,3,3,0,拉个屎
197663,1429,李勇,2024-07-25 10:47:35,1,2,1,...
197935,1429,李勇,2024-12-19 05:05:03,2,2,0,...
197978,1429,李勇,2024-08-22 04:26:22,3,5,2,出生！
197995,1429,李勇,2024-08-23 03:37:50,4,5,1,出生！
198014,1429,李勇,2024-08-23 14:34:06,-1,0,1,111
198039,1429,李勇,2024-08-26 10:57:28,0,2,2,还有脸苟活
198069,1429,李勇,2024-08-28 04:42:35,0,0,0,呵呸狗
198095,1429,李勇,2024-08-30 12:05:05,1,2,1,我就呵呵了
198156,1429,李勇,2024-09-03 05:12:24,4,6,2,跟一个1分
198245,1429,李勇,2024-09-06 01:35:42,2,2,0,真煞笔
198246,1429,李勇,2024-09-06 01:36:42,3,5,2,狗东西，生孩子没屁眼
198247,1429,李勇,2024-09-06 01:45:11,1,1,0,111
198263,1429,李勇,2024-09-06 03:14:47,2,3,1,我来收敛了
198325,1429,李勇,2024-09-07 04:58:33,0,1,1,emmmmmsb
198432,1429,李勇,2024-09-09 02:27:10,0,1,1,杀人犯
198451,1429,李勇,2024-09-09 04:13:46,0,0,0,1分收敛
198466,1429,李勇,2024-09-09 06:08:47,1,1,0,一分收敛
198489,1429,李勇,2024-09-09 08:10:32,0,1,1,懂得都懂 给1星
198500,1429,李勇,2024-09-09 09:55:00,0,0,0,缅怀学长
198521,1429,李勇,2024-09-09 11:51:16,-1,0,1,哈哈哈
198535,1429,李勇,2024-09-09 16:11:10,0,1,1,学长安息
198573,1429,李勇,2024-09-10 04:12:58,2,3,1,逆天老师
198622,1429,李勇,2024-09-10 09:13:02,1,2,1,smdx
198690,1429,李勇,2024-09-11 01:59:11,0,1,1,垃圾🗑️人渣
198707,1429,李勇,2024-10-08 10:40:19,3,4,1,尽快收敛
198742,1429,李勇,2024-09-11 07:48:45,1,2,1,答辩，不多说
198751,1429,李勇,2024-09-11 09:46:53,-1,0,1,额额额要不是最低是1
198807,1429,李勇,2024-09-12 00:13:21,1,1,0,中道崩殂，命不久矣。
198892,1429,李勇,2024-09-12 12:57:16,1,2,1,怎么没有0分
198902,1429,李勇,2024-09-12 15:49:12,0,0,0,司马玩意
198977,1429,李勇,2024-09-13 14:25:27,1,2,1,私人玩意儿
199030,1429,李勇,2024-10-15 16:22:01,5,5,0,愧为人师，cs一个
199073,1429,李勇,2024-09-15 10:23:35,1,1,0,0000000
199089,1429,李勇,2024-10-12 07:51:51,2,2,0,可惜不能给0分
199254,1429,李勇,2024-09-20 03:55:57,-1,1,2,000
199294,1429,李勇,2024-09-20 13:00:53,2,2,0,出生东西 杀人偿命
199306,1429,李勇,2024-09-20 15:16:20,2,2,0,去s吧
199373,1429,李勇,2024-09-22 11:41:36,3,3,0,间接杀人犯！
199430,1429,李勇,2024-09-23 09:48:57,0,1,1,冲刺一
199443,1429,李勇,2024-09-24 00:05:37,0,1,1,唉。。。
199518,1429,李勇,2024-09-25 01:53:06,0,1,1,sbb
199578,1429,李勇,2024-09-25 17:19:10,1,2,1,杀人犯
199686,1429,李勇,2024-09-27 13:44:45,3,4,1,这私募煞笔怎么还不速速去亖啊
199698,1429,李勇,2024-09-27 15:59:44,3,4,1,杀人犯，，，我会一直看着你👁👁👁
199701,1429,李勇,2024-09-27 18:04:19,1,2,1,前德育导师hhh
199794,1429,李勇,2024-09-30 03:15:47,1,1,0,为什么他还是老师
199822,1429,李勇,2024-09-30 10:37:03,1,2,1,亖吗？
199881,1429,李勇,2024-12-06 17:09:18,2,3,1,类人生物
199911,1429,李勇,2024-10-08 06:53:43,4,4,0,单调有下界，收敛于一
199987,1429,李勇,2024-10-10 08:15:08,0,3,3,Murderer
200028,1429,李勇,2024-10-11 08:48:32,2,2,0,murderer
200268,1429,李勇,2024-10-15 08:14:38,3,3,0,师兄走好
200295,1429,李勇,2024-10-15 12:50:27,0,1,1,出生出生
200305,1429,李勇,2024-10-15 14:43:22,2,2,0,勾史玩意
200311,1429,李勇,2024-10-16 00:32:20,4,4,0,1分不是我的极限，是系统的下限
200345,1429,李勇,2024-10-16 06:35:09,0,1,1,rnm
200496,1429,李勇,2024-10-17 16:02:38,1,2,1,NEVER FORGET
200518,1429,李勇,2024-10-18 05:34:57,0,1,1,mur～  der
200810,1429,李勇,2024-10-23 01:24:45,3,3,0,murderer
200828,1429,李勇,2024-10-23 04:48:40,1,2,1,怎么还没有到1.00
200895,1429,李勇,2024-10-24 06:50:18,1,2,1,狗屎哈
201071,1429,李勇,2024-10-28 06:50:40,0,1,1,狗屎啊
201100,1429,李勇,2024-10-28 13:43:59,0,0,0,这个老师的评分的极限值应该是1.0吧
201245,1429,李勇,2024-10-30 15:14:34,0,0,0,所以这件事就不了了之了吗，这种人渣为什么还配待在浙大
201274,1429,李勇,2024-10-31 03:06:59,2,2,0,jdjditifkdopw
201500,1429,李勇,2024-11-04 02:35:16,1,2,1,人？人？人？
201650,1429,李勇,2024-11-05 07:51:45,8,10,2,垃圾老师，枉为人师，厚颜无耻，寡廉鲜耻，恬不知耻。此獠实乃浙江大学之耻辱，中国高等教育之墓碑，世界研究生教育之贼寇，人人得而诛之，远追秦桧，近比豫章，必遗臭万年，永载耻册，以供唾弃。
201718,1429,李勇,2024-11-05 15:39:03,8,9,1,祝你全家批演被轮着桶
201934,1429,李勇,2024-11-07 12:51:27,2,3,1,Sb.
202103,1429,李勇,2024-11-09 12:05:45,1,1,0,sbsbsb
202481,1429,李勇,2024-11-13 01:40:18,5,5,0,加速收敛至1.00
202956,1429,李勇,2024-11-15 11:26:11,27,28,1,他也是67656之一吗，如果没有在上个秋天投湖的话？\n\n\n\n还是会在另一个时空里顺利毕业，迎来新人生呢？
202975,1429,李勇,2024-11-15 14:58:42,2,2,0,烂到家了
203337,1429,李勇,2024-11-19 08:26:07,0,1,1,tmdsb
203953,1429,李勇,2024-11-22 08:14:17,2,3,1,去死吧
203991,1429,李勇,2024-11-22 13:49:26,7,8,1,杀死梁学长的是冰冷的湖水，也是既得利益者的自私与冷漠
204073,1429,李勇,2024-11-23 14:48:51,12,14,2,本来想给你打五分，但是被界徐盛古锭刀酒杀砍了四分，给你一分
204167,1429,李勇,2024-11-25 01:18:08,3,3,0,踩一脚
204400,1429,李勇,2024-11-25 15:40:53,0,3,3,踩一脚
204466,1429,李勇,2024-11-26 05:21:26,3,3,0,就是想骂他
204557,1429,李勇,2024-11-26 15:51:26,8,8,0,垃圾，每天路过还要看您的海报真的干呕
204810,1429,李勇,2024-11-28 03:21:11,7,8,1,助力收敛\n\n启真湖水真冷，这又过去了多久
204865,1429,李勇,2024-11-28 08:11:02,4,4,0,助力收敛
204933,1429,李勇,2024-11-28 17:05:56,8,9,1,恶魔。时隔一年再看到这这件事，看到他的嘴脸，我还是没绷住。完全是浙大的耻辱，学者的耻辱，人类的耻辱。\n\n我再没什么好说的了，已经超出了言语的范畴。\n\nmurderer！
205073,1429,李勇,2024-11-30 19:41:52,0,1,1,csb
205157,1429,李勇,2024-12-02 08:42:30,0,1,1,早点死
205840,1429,李勇,2024-12-12 08:12:46,2,2,0,shit
205861,1429,李勇,2024-12-12 10:47:13,1,4,3,我们还没有忘记梁学长。
205923,1429,李勇,2024-12-12 16:59:19,1,1,0,一定要收敛啊
206003,1429,李勇,2024-12-13 02:56:54,-1,0,1,好好好
206119,1429,李勇,2024-12-13 05:47:21,2,2,0,给1分
206211,1429,李勇,2024-12-13 08:43:40,0,1,1,SEZbFOWNOFPNOEnfsf
206525,1429,李勇,2024-12-15 23:53:36,3,3,0,前来缅怀，现在冬天了，启真湖的水真很冷
206538,1429,李勇,2024-12-16 02:29:27,0,0,0,………
206679,1429,李勇,2024-12-17 05:10:52,0,1,1,murder
206779,1429,李勇,2024-12-17 13:42:25,1,1,0,史史史史史
206805,1429,李勇,2024-12-17 15:23:42,0,1,1,…………
206821,1429,李勇,2024-12-17 18:19:38,0,0,0,又是一个寒冷的冬天\n\n启真湖底很冷吧
206945,1429,李勇,2024-12-18 16:15:37,0,0,0,不配做人
207088,1429,李勇,2024-12-19 07:49:03,1,3,2,垃圾东西
207197,1429,李勇,2024-12-19 17:00:13,0,1,1,...
207678,1429,李勇,2024-12-23 16:31:33,3,3,0,しね!
208038,1429,李勇,2024-12-25 09:30:38,0,0,0,-1。
208287,1429,李勇,2024-12-26 13:18:52,0,1,1,煞笔。
208425,1429,李勇,2024-12-30 09:10:47,7,8,1,至今李勇未受到任何处分，望周知
208671,1429,李勇,2024-12-30 15:35:07,0,0,0,sx!!!
208731,1429,李勇,2025-01-01 03:58:41,1,1,0,尚未沈冤得雪
209486,1429,李勇,2025-01-06 05:22:52,0,1,1,助力收敛
209633,1429,李勇,2025-01-06 11:38:49,0,0,0,史史史史史史
210488,1429,李勇,2025-01-09 08:40:03,0,0,0,前来缅怀
212149,1429,李勇,2025-01-13 09:14:05,2,2,0,不配做人
213776,1429,李勇,2025-02-03 07:05:31,10,13,3,狸蛹这个畜生还活的风生水起，真tm晦气\n\n还有哪个没有🐴的玩意累死累活的翻评论然后把所有评论都点一遍踩的？是不是狸蛹本人上号了？
213996,1429,李勇,2025-01-22 14:15:44,1,1,0,收敛收敛
214071,1429,李勇,2025-01-23 11:55:02,0,0,0,666
214370,1429,李勇,2025-02-02 07:31:11,0,1,1,。。。
214579,1429,李勇,2025-02-13 13:28:01,3,3,0,钱喇叭盖i和该吃饭观察法很尬，你们
214707,1429,李勇,2025-02-17 02:39:21,1,1,0,助力收敛
214753,1429,李勇,2025-02-17 10:39:15,1,1,0,是人？
214992,1429,李勇,2025-02-20 01:50:08,1,1,0,助力收敛
215058,1429,李勇,2025-02-20 10:55:41,0,0,0,路人踩一脚
215062,1429,李勇,2025-02-20 11:23:14,0,0,0,。。。
215133,1429,李勇,2025-02-22 08:14:32,0,0,0,把权力的碾压用到极致的杀人犯
215282,1429,李勇,2025-02-25 03:40:32,1,1,0,狗日的sb
215674,1429,李勇,2025-03-04 02:45:12,1,1,0,傻逼傻逼
215971,1429,李勇,2025-03-08 11:56:20,0,0,0,杀人犯，🤮
216025,1429,李勇,2025-03-09 13:19:19,0,0,0,murderer。不要去他那读研！
216063,1429,李勇,2025-03-10 05:41:24,0,0,0,助力收敛
216085,1429,李勇,2025-03-10 09:12:43,0,0,0,murder吗，那快似吧哈哈哈
216487,1429,李勇,2025-03-17 08:56:26,0,0,0,murderer
216712,1429,李勇,2025-03-22 05:14:15,0,0,0,收敛zsbd
216728,1429,李勇,2025-03-23 04:55:06,0,0,0,助力1.0
216891,1429,李勇,2025-03-28 06:54:20,0,0,0,SB玩意
216964,1429,李勇,2025-03-30 13:05:33,0,0,0,真出生
217154,1429,李勇,2025-04-02 16:27:56,0,0,0,司马李勇
217192,1429,李勇,2025-04-03 15:11:25,0,0,0,逼死硕士
217205,1429,李勇,2025-04-04 08:57:30,0,0,0,ccc
217467,1429,李勇,2025-04-11 01:43:11,0,0,0,逼死学生，人渣一枚。
217875,1429,李勇,2025-04-17 10:04:46,0,0,0,助力收敛
218729,1429,李勇,2025-04-29 15:08:13,0,0,0,可惜不能打负分
219041,1429,李勇,2025-05-20 01:26:45,1,1,0,为什么你还可以冠冕堂皇地留在浙大？
219188,1429,李勇,2025-05-23 02:09:32,0,0,0,真正的人渣死不足惜
219255,1429,李勇,2025-05-23 12:50:19,0,0,0,助理收敛
219286,1429,李勇,2025-05-24 07:30:40,2,3,1,死了妈的我把他妈逼干烂，用小刀给他妈逼划成十字花刀
219632,1429,李勇,2025-06-02 09:58:55,0,0,0,狸蛹应该被用熔化的液态银灌满五官。喜欢让学生给你打白工是吧？喜欢钱是吧？给你灌满钱
221700,1429,李勇,2025-06-25 10:02:51,0,0,0,1.0
47835,1448,朱亮,2017-02-26 04:00:10,0,0,0,很好的
48782,1448,朱亮,2017-03-13 02:44:24,0,0,0,活动活动了四百多分觉得很简单
99561,1448,朱亮,2019-01-25 03:21:43,0,0,0,温文尔雅
140006,1448,朱亮,2021-08-23 05:15:32,0,0,0,非常nice
149763,1448,朱亮,2022-01-16 22:52:08,8,8,0,出分巨慢，平时分还不太好拿
151033,1448,朱亮,2022-02-22 05:56:10,0,0,0,很好的老师 超nice
160114,1448,朱亮,2022-09-13 10:41:28,0,0,0,很棒的老师
202940,1448,朱亮,2024-11-15 09:31:34,2,2,0,半开卷基本都答出来了只有3.9，感觉对不起自己抄A4纸的十几个小时
82089,1454,陈曙光,2018-07-07 05:32:24,0,0,0,不会上课，一直在强调高逼格，其实就是水课而已
83347,1454,陈曙光,2018-07-10 07:14:20,0,0,0,孤儿老师，没有之一
145161,1454,陈曙光,2021-12-28 02:14:03,0,1,1,PPT毫无重点，很乱而且到处出错，给发差的离谱
174450,1454,陈曙光,2023-06-12 09:40:25,3,3,0,为什么不能打负分…为什么不能打负分…为什么不能打负分…为什么不能打负分…为什么不能打负分…为什么不能打负分…为什么不能打负分…为什么不能打负分…为什么不能打负分…平时作业手写就算了，大作业考试周中间截止还手写…………………………………………………………………逆天………
182346,1454,陈曙光,2023-11-15 03:51:32,1,3,2,sb老师，环境影响评价课，上课不讲知识点，光在那bb自己搞的项目，最离谱的是，明明有钉钉群，最后的大作业要求居然传到了上学期固废课程的微信群，那些跨专业的、大二环境的完全没有收到，真的让人一言难尽…
194964,1454,陈曙光,2024-06-26 05:39:41,0,0,0,sb老师，自我意识过剩，自以为自己很牛逼，讲的一坨
195351,1454,陈曙光,2024-06-28 00:14:50,0,1,1,先说优点吧。老师还是很通融的，有几次其他课作业很多的时候，他听我们讲把作业时间延后了。上课会讲一些自己经手的环评案例，当故事听挺精彩的（狗头）。以及仅我个人而言给分算很好了。当然问题也很多，作业和课程相关度不太大，需要自己找各种国标并且自己判断，难度比较高，很多题目都还挺有争议的。平时作业不反馈甚至几周都没改这很难评……期末大作业还要手写我会裂开，写完水污染根本没时间了…最后，大作业我猜老师您乱改的吧……
201623,1454,陈曙光,2024-11-05 03:03:07,1,1,0,自视甚高，讲课毫无逻辑无内容，水
216502,1454,陈曙光,2025-03-17 12:38:29,1,1,0,整个人充斥着一种迷之自信，PPT做的很混乱，上课没什么内容。作业还要手写，没事吧您......
219804,1454,陈曙光,2025-06-06 14:29:00,0,0,0,全部手写的作业让人崩溃，每次作业都要整整写好几面A4纸 大作业更是要手写十多面A4纸
87645,1461,吴伟祥,2018-10-09 04:39:18,0,2,2,很不错
123955,1461,吴伟祥,2020-06-17 15:15:38,0,2,2,固废课讲了不知道要怎么用，老师还是很实在的
181252,1461,吴伟祥,2023-10-12 08:19:09,-3,2,5,有高度，有兴趣，有引导
197901,1461,吴伟祥,2024-08-20 10:13:21,0,0,0,还可以
7848,1487,陈宝梁,2015-09-15 15:35:12,-6,4,10,陈老师讲课很认真，细致，旁征博引，知识渊博，从他的环境化学进展和环境污染修复课上收获了许多专业知识，不愧是环境领域的杰青！
51990,1487,陈宝梁,2017-06-14 04:35:45,-1,0,1,作业略多，上课还是很有趣的
96708,1487,陈宝梁,2019-01-21 09:30:01,-4,2,6,半白的头发很有风度，为人和蔼有条理，讲课也还可以。不过要不要划个重点啊？考的东西好多，没重点背了马东什么都不知道。环化，环境科学专业没有重点的清流。O_o
110129,1487,陈宝梁,2019-06-23 11:18:17,2,4,2,。。。。
160627,1487,陈宝梁,2022-09-28 19:00:17,-5,0,5,是一位很好的老师
167911,1487,陈宝梁,2023-01-20 07:37:01,-13,0,13,老师很亲民也很可爱
180456,1487,陈宝梁,2023-09-21 18:06:55,21,25,4,（删我评的biss😀）one supporter of patriarchal society爹味十足的一个。。。经典发言1⃣️全班女生应该在26岁之前找到nanpy结婚2⃣️学费应该是一万每学分，而不是现在的一百多，然后毕业后赚更多的钱3⃣️有学生大三想进牠的实验室，牠其实觉得不太喜欢，因为会被别的老师训练过，就灌输不了牠的价值体系。研究生才跟牠的人 牠也感觉怎么都培养不起来。\n\n当院长这么明目张胆在课堂说这种话？？？（有些人可能确实也是这么想只是没说出来而已🤭🤭🤭）你也配申院士？btw请问zju是喜欢这样的老师并且更喜欢给这种人官职吗？我请问呢？
180548,1487,陈宝梁,2023-09-22 15:14:56,1,1,0,。。。
194013,1487,陈宝梁,2024-06-21 11:29:33,22,22,0,傻逼爹味PUA男，谁读他的研究生谁sb。看起来笑眯眯的，其实一肚子坏水
195348,1487,陈宝梁,2024-06-27 23:49:31,4,4,0,我想问…污染修复到底在上什么啊………
210087,1487,陈宝梁,2025-01-08 06:17:05,0,0,0,。。。
63208,1497,刘越,2017-11-29 07:33:50,1,1,0,原谅我完全听不懂  虽然老师人很好
115411,1497,刘越,2019-07-22 01:42:04,3,4,1,你～们～先～走～别～管～我～
170841,1497,刘越,2023-03-10 08:40:21,1,1,0,刘老师真的很认真的在为大家讲解专业知识，而且人非常NICE，上课能学到不少东西。
24685,1538,楼莉萍,2016-05-03 05:43:51,10,14,4,老师人很好 很有修养 有亲和力
44280,1538,楼莉萍,2017-01-17 14:04:58,-1,2,3,老师超好的
56133,1538,楼莉萍,2017-07-03 06:32:40,-1,3,4,老师讲得还可以，平时1000字的论文，不能抄。期末好好准备吧，我平时没展示、点名时回答问题错误、论文也是赶出来的，就期末准备了一下，上4了。
61722,1538,楼莉萍,2017-11-20 09:25:27,-3,1,4,不错的老师，上课有一定的要求，但不会为难学生
63281,1538,楼莉萍,2017-11-30 03:48:43,-18,5,23,烦的一笔，辣鸡老师
64301,1538,楼莉萍,2017-12-22 09:33:58,-1,2,3,...\n\n
76331,1538,楼莉萍,2018-04-03 07:34:02,0,0,0,老师具有一种独特的女性美，喜欢老师的风格。相处很愉快~
77827,1538,楼莉萍,2018-05-08 04:06:08,0,1,1,一位有修养的学者
77890,1538,楼莉萍,2019-01-04 03:44:25,0,1,1,作为理科生 觉得内容不感兴趣，但是老师人挺好，事也少，平时基本没听，考前好好准备一下基本上4没问题
77897,1538,楼莉萍,2018-05-08 11:12:15,0,2,2,老师为人很亲和，虽然课程内容是烂大街的环境问题，但是也会有一些收获的，而且事情超级少。
105019,1538,楼莉萍,2019-04-02 08:59:12,0,2,2,因为通核作为毕业必修课 多少学生这个选上这门完全不感兴趣的课 然后老师又以绩点为诱饵渴望调动底下的同学 得到的也是恶竞者的私利敷衍罢了 terrible/老师可 讨论课每周小组展示 还可能有辩论赛等等 可怕的是学期才过半
204695,1538,楼莉萍,2024-11-27 11:40:58,1,1,0,楼老师人很好，很有亲和力，相处很舒服
217527,1538,楼莉萍,2025-04-12 10:08:44,0,0,0,算环资上课比较好的老师了
5988,1610,陈英旭,2015-07-10 06:59:26,7,7,0,不知道老师在监狱里过的可好？
102598,1610,陈英旭,2019-02-12 06:46:34,0,0,0,讲得好
72650,1749,沈学优,2018-01-30 15:54:07,0,0,0,难得的好老师
9888,1794,何云峰,2015-11-12 02:33:58,0,1,1,感觉蛮帅的老师，上课认真
22508,1794,何云峰,2016-03-07 05:43:38,2,3,1,讲课认真
24081,1794,何云峰,2016-04-26 14:40:55,0,2,2,讲课激情很充足，喜欢、敬佩这位老师！
25066,1794,何云峰,2016-05-05 06:12:36,3,3,0,一般般吧，讲课还行。给分差
34864,1794,何云峰,2016-10-25 13:54:01,1,2,1,又高又帅的老师～人超好就是作业有点多…
35247,1794,何云峰,2016-11-07 07:56:34,28,38,10,环境与可持续发展这门课怎么没有(>﹏<)
35491,1794,何云峰,2016-11-10 07:21:25,6,9,3,老师给人一种温润的感觉，讲课也不错
36146,1794,何云峰,2016-11-10 15:00:58,11,15,4,上环境与可持续发展这门课，他讲得比较好。
37549,1794,何云峰,2016-11-19 10:48:26,11,11,0,环境与可持续 他上的挺好 虽然我也没怎么听  另一个老师简直不能更水  最后给分 个人觉得不是很好
50325,1794,何云峰,2017-05-02 10:42:08,3,6,3,环境与可持续发展#何老师人不错，讲课也很好（虽然没怎么听过）。但是给分…我*我两次作业认真写考试写满了两张纸我最后还是被正态了……心塞
52056,1794,何云峰,2017-06-14 11:10:08,1,4,3,环境与可持续发展的.. 个人觉得给分还可以.. 总的来说比较水 最后的开卷考基本能在书里找到
62231,1794,何云峰,2017-11-23 10:10:23,-1,6,7,#环境与可持续发展\n\n老师每次上课穿的都很正式啊，感觉人很精神，讲的也挺好的，ppt里出现的内容有些就出现在了试卷中，所以还是做下笔记比较好，第二次作业迟交了，但是得分还是不错的，感谢老师。
89974,1794,何云峰,2018-11-21 12:09:55,6,7,1,作业每次很用心地完成，连考试都特别认真准备，没想到啊，绩点才3.3，要哭
89994,1794,何云峰,2018-11-21 13:16:30,4,5,1,给分炸了
90218,1794,何云峰,2018-11-22 13:38:48,1,1,0,给分超垃圾，认真写了很多，结果被正态
91061,1794,何云峰,2018-11-29 10:12:53,1,1,0,老师会讲很多他自己科研或者调查的经历，干货挺多，而且老师人超级谦虚和善，最后一节课在班里鞠了一躬，90度，敬佩之情油然而生。\n\n虽然我的得分不是很高，3.9但是还是挺喜欢上课的，能学到挺多东西的，比如为什么小孩子血铅更高，抗生素污染，微塑料balabala，课程结束了真的有点舍不得。\n\n平时有两个思考题，字数不限，期末开卷考，而且期末的思考题考前都会给题库，但是准备时间不太充足。。毕竟是在考试周。
106000,1794,何云峰,2019-04-24 06:41:42,3,3,0,#环境与可持续发展科学导论#\n\n这门课上真的了解到了不少知识，开阔了眼界，总的来说还是挺有趣的吧。出分之前看到以前的评论说给分感人还是一直很慌hhh 但最后4.2感觉也还行 毕竟平时也没花多少时间在这门课上 论文也没有像其他评论一样写四五千字，只求把意思表述清楚并加入了自己的思考 期末试题在书上都能找到 也给了题库但我没准备呜呜呜(我以为不会考原题) 最后老师也挺帅的耶\n\n作为一门通识课还是挺推荐上的\n\n
119209,1794,何云峰,2019-11-11 07:52:13,2,2,0,何老师讲的好，还是有一些干货的，很认真
120094,1794,何云峰,2019-11-17 11:57:10,1,1,0,老师长得很帅！平时讲课虽然差不多是读ppt，但是很有精神，不容易让人睡着那种。只有一次大作业：两个问题，详答或者写小论文，字数不限。考前会放复习提纲，考试会考给的原题，认真准备就不慌了( ´▽｀)。认真写论文也认真准备了考试，最后4.5，大家都说给分烂，可能我的运气比较好:-P。（老师长得真的很帅！！）
120396,1794,何云峰,2019-12-03 07:50:01,3,3,0,老师讲课很棒！分也不错吧，不造4.2算高还是低  平时作业认真完成，考试前老师给的思考题都是考试原题，认真做完，带资料上场就没得问题  还是收获蛮多
123695,1794,何云峰,2020-06-11 15:18:12,5,5,0,何老师挺不错的。课堂内容比较广，如果认真听会很有收获，而且难度不大，毕竟答案什么的都在课本还会给题库
127602,1794,何云峰,2020-11-25 02:47:34,11,11,0,老师很敬业，最后的90度鞠躬让人感觉很感动，和另一个杨京平形成鲜明对比
128949,1794,何云峰,2020-12-27 10:46:00,0,0,0,讲课很认真
136576,1794,何云峰,2021-06-21 07:56:58,1,1,0,老师真的很有热情也很和蔼  给人一种很亲和的感觉 但是自己的性格真的不喜欢听通识课 所以感觉很对不起老师害  要是我是环资学子我一定好好听课
142570,1794,何云峰,2021-11-13 12:37:20,5,5,0,虽然因为是通识听的人不多，自己也没有太认真。但是从有时抬头听课来说，老师很认真，很和蔼，真的是在传授知识，交卷时还会对学生回以微笑。和另一个老师完全不一样。
148315,1794,何云峰,2022-01-12 06:22:48,1,2,1,何老师和杨老师形成鲜明的对比，何老师为人和气，最后一堂课还告诉我们重点，虽然不知道最后是哪个老师给分的，但是别选环境与资源导论，真的要吐了，教材贵就不说了，给分还差，让人想跳楼。
201098,1794,何云峰,2024-10-28 13:12:24,6,6,0,期末考试题原模原样提供给你让你准备，含金量多少我不多说了。\n\n老师上课也很生动幽默，但受限于学科，内容是相对枯燥的，是一门水课吧，你可以坐在后排做自己的事，也可以坐在前面仔细听，都会有一定收获的。
201116,1794,何云峰,2024-10-29 02:40:29,2,2,0,老师人好，和蔼可亲，为人谦逊，毫无架子，明年就要退休了，舍不得；现在后悔自己把课程水过去了
202550,1794,何云峰,2024-11-13 05:48:08,2,2,0,老师明年就退休了，应该不会再有人搜到这个老师或者这门课程了，老师人很好，和蔼可亲，课上虽然点名但是是数字点名很水，考试前会给原题让你准备，感谢老师长久以来的付出。\n\n打个10分，也算祝他退休快乐了（虽然他看不到
202591,1794,何云峰,2024-11-13 08:46:22,0,0,0,老师真的很好
202607,1794,何云峰,2024-11-13 10:30:23,1,1,0,老师真的很认真啊，每节课下课都会鞠躬，给分也给的很高呜呜呜呜呜真的好老师
202663,1794,何云峰,2024-11-13 16:11:29,1,1,0,老师很好很好，特别特别负责，讲课很有热情，人也很儒雅，每节课后都会鞠躬，超级感动，但明年就退休了。课程而言，难度较小，数字点名，会有几次课后作业，期末考试也是给了你原题让你准备，然后开卷考试。本人作业也没有特别认真对待，所以最后拿了4.2，挺满意的，再次申明，老师真的真的超级无敌好！！！
205287,1794,何云峰,2024-12-04 02:17:12,2,2,0,很有耐心的老师，加了老师的微信有消息都会回复，上课还和大家解释，他可能会回复的晚点但是一定会回复大家😭。讲课也很热情，虽然是一门通识课，老师的授课态度也很认真，认真备课，最后课程结束还向大家鞠躬😭
206552,1794,何云峰,2024-12-16 04:22:00,0,0,0,非常非常好的一个老师，注重互动，课也轻松，人也很和蔼，除了准备期末的那段时间外都没花太多时间在这门课上，最后也拿到了4.8。可惜何老师退休了，以后不能再上他的课了呜呜
208896,1794,何云峰,2025-01-03 07:55:23,1,1,0,老师是好老师，捞是一点不捞，真的一点点都不捞，第一门历史最低绩点3.3平时认认真真考勤作业平时分也给的不好。真的想学就来，想要高分有风险。
209084,1794,何云峰,2025-01-04 11:40:39,0,0,0,很好的老师，祝退休快乐
20959,1801,张奇春,2016-02-05 12:34:35,1,3,2,上课很认真负责，讲知识点很细致，很喜欢老师的土壤学～
76313,1801,张奇春,2018-04-03 01:53:51,1,1,0,沙发\n\n
135426,1801,张奇春,2021-05-10 07:56:06,2,2,0,老师很平易近人，喜欢老师的土壤学
103744,1834,吴忠标,2019-03-05 03:05:22,6,9,3,把书照样搬上去就是ppt，把所有英文蹩脚地读一遍就叫上课，公式怎么来的、狼，单位怎么换算，一概不讲，反正你们都会的，这也叫上课？！！不给1分也就给个面子
124351,1834,吴忠标,2020-06-29 13:54:02,1,1,0,不怎么样\n\n
191411,1834,吴忠标,2024-04-20 07:53:40,1,1,0,不怎么样
214727,1834,吴忠标,2025-02-17 06:09:52,0,0,0,老爱提问
60728,1847,章明奎,2017-10-28 14:18:13,-1,2,3,一口听不懂的方言
103205,1847,章明奎,2019-02-27 00:08:21,-1,2,3,不知道老师在讲什么，地方口音太重了
103802,1847,章明奎,2019-03-06 01:26:02,-1,2,3,哎，北方人听课如同外语课
123535,1847,章明奎,2020-06-09 13:10:06,0,1,1,老师很和蔼，会认真回答同学的问题，感谢老师！
151440,1847,章明奎,2022-03-03 08:07:05,3,3,0,老师很好，很和蔼，上课很认真
151686,1847,章明奎,2022-03-11 16:23:34,7,7,0,老师很和蔼，上课认真！
164529,1847,章明奎,2022-12-21 12:45:02,0,0,0,哈哈哈
959,1850,杨京平,2015-03-19 14:36:01,44,63,19,这个老师给我的感觉是他不想上课，上课就照ppt读一遍再放个两节课的纪录片，讨论课的话题也很空泛。所以觉得学到的东西太少。  期末一篇三千字论文即可。
5058,1850,杨京平,2015-07-02 23:46:56,19,23,4,上课古板，没有生气，昏昏欲睡
7427,1850,杨京平,2015-09-14 10:47:45,2,4,2,死气沉沉
8576,1850,杨京平,2017-04-26 12:02:34,34,39,5,2 billion are dying for water 翻译成20亿人死于水
11313,1850,杨京平,2015-11-26 23:52:41,7,12,5,上了节新生研讨课，感觉讲的不错呀，上课认真听的话收获还是蛮多的。。有点后悔有时不认真了。。不太会调动气氛是真的。
16917,1850,杨京平,2016-01-19 09:02:59,2,4,2,小组报告较多，给分还可以
21024,1850,杨京平,2016-02-10 14:29:19,-9,1,10,老师讲的还不错的。
22507,1850,杨京平,2016-03-07 05:39:50,6,8,2,老师很博学课本很完备但讲课不够生动。
25065,1850,杨京平,2016-05-05 06:11:46,2,4,2,讲课昏昏欲睡念PPT，给分也差
32168,1850,杨京平,2016-07-06 00:26:28,0,0,0,比较无聊吧，其他也还好
35248,1850,杨京平,2016-11-07 07:57:12,39,42,3,环境与可持续发展这门课怎么没有
35470,1850,杨京平,2016-11-20 03:01:26,13,14,1,麻蛋，劳资认认真真听课写作业查资料准备考试，还被正态，呵呵。讲课还无聊。一生黑。
35805,1850,杨京平,2017-01-16 09:48:39,6,8,2,渣老师，给你要睡觉的感觉，不想睡的也被弄睡\n\n
36144,1850,杨京平,2016-11-10 14:59:15,1,1,0,老师很博学，但讲课不太合适。
36210,1850,杨京平,2016-11-11 05:45:28,-2,0,2,不知道\n\n
36348,1850,杨京平,2016-11-12 05:40:48,2,2,0,挺水的，上课是互不干扰吧，他讲他的，不管学生，不过事情倒是不多，整个秋学期，两次作业吧
36520,1850,杨京平,2016-11-14 13:27:47,-12,3,15,老师人很好，高大上，给分可以，就是上课有点沉闷……不太会调动气氛。\n\n作为新生研讨课，总会让你学到点东西的(ง •̀_•́)ง
36576,1850,杨京平,2017-01-17 03:27:04,2,6,4,承包了小组一个学期的ppt 期末展示也完全没问题\n\n最后绩点低的没法看！\n\n老师给分很随便  事情又多 慎选慎选
36754,1850,杨京平,2016-11-16 02:07:13,3,5,2,本来觉得还不错 但他评分很低，我论文都写了，发给他，自动回复都没有。。。
36815,1850,杨京平,2016-11-16 06:36:59,-3,0,3,
38250,1850,杨京平,2016-11-28 07:16:58,4,6,2,学不到东西，他也混时间
39828,1850,杨京平,2016-12-28 02:21:51,6,7,1,每周都有一个小组展示，期末还有论文和个人展示，总之事情很多，他上课玩玩手机，放几个视频，再让我们讨论一会就过去了
43782,1850,杨京平,2017-01-17 16:39:20,1,1,0,分太低了
43810,1850,杨京平,2017-01-17 03:53:11,7,8,1,3.6不解释
50327,1850,杨京平,2017-05-02 10:43:40,6,9,3,环境与可持续发展#杨老师人不错，讲课也很好，是有点不想讲课的感觉，不过上课放的视频蛮好看的。但是给分…我*我两次作业认真写考试写满了两张纸点名也到了，为啥最后还是被正态了……心塞
52058,1850,杨京平,2017-06-14 11:13:24,0,3,3,环境与可持续发展的.. 个人觉得给分还可以.. 总的来说比较水 最后的开卷考基本能在书里找到
53194,1850,杨京平,2017-06-26 07:31:22,2,4,2,上课极无聊，给分极低，强烈不推荐
53195,1850,杨京平,2017-06-26 07:31:33,12,14,2,换个课吧，后辈。
53442,1850,杨京平,2017-06-26 15:12:24,3,4,1,课程核心不明确，如果不是没别的课学的话别选。
60863,1850,杨京平,2017-10-31 13:26:55,-12,2,14,真的很好，他非常认真，上课有深度
60947,1850,杨京平,2017-11-04 16:12:30,2,2,0,水水的
62159,1850,杨京平,2017-11-27 11:30:46,6,7,1,辣鸡 3.6不解释
62223,1850,杨京平,2017-11-23 08:53:01,110,128,18,环境与可持续发展，每节课都到，两次作业均认真完成，规定1000字均写了近三千，为了准备考试用了两个下午去准备他给的题目，结果给了2.7?你说我想骂人吗？查老师上没有这个课，想了解的就顶我上去
62225,1850,杨京平,2017-11-23 09:06:47,3,3,0,贼无聊
62230,1850,杨京平,2017-11-23 10:06:35,-12,3,15,#环境与可持续发展\n\n老师的PPT内容是和书上差不多的，上课是挺枯燥的，考试前会给复习提纲，详答题就是从提纲里出的，还有一个是上课时讲过的当时刚好拍下来了放进了资料里所以用上了。自己得分还是不错的，绩点上4了，没拖后腿。
65796,1850,杨京平,2018-01-09 07:28:26,0,0,0,念幻灯片\n\n
66823,1850,杨京平,2018-01-19 07:20:23,4,4,0,每次很认真讨论，论文认真写，PPT认真讲还是3.6，不想解释
66941,1850,杨京平,2018-01-19 11:27:59,4,5,1,什么文明老师，真是瞎扯，上课感觉是在应付。从来没讲过什么有用的东西，课上就知道让人讨论，讨论的东西都是从网上弄下来的，真正想学东西的同学学不到东西。想水的同学拿不到高分，给分瞎文明给。按组正态，你脑子是进水了吗？我被坑了就算了，劝你们别选！！！！
77572,1850,杨京平,2018-05-06 14:41:54,1,1,0,生态安全的系统分析，每节课讨论，每节课上台展示ppt，还有论文，结果给分极其低。。。自行体会
78265,1850,杨京平,2018-05-10 09:19:44,0,1,1,这么说吧 知道这老师给分差 小作业恶竞写5000字 最后给了3.9 前面同学3000字2.7我懂你
84351,1850,杨京平,2018-07-12 15:28:01,2,2,0,不论多么精神，不论多么认真，他的课一定让你昏昏欲睡，醉生梦死。
85493,1850,杨京平,2018-07-18 13:11:45,0,0,0,给分巨差，辣鸡
89805,1850,杨京平,2018-11-21 01:44:35,3,3,0,环境与可持续发展导论:)小作业五千加。。。被正态。。。感觉上课和考试没什么关系。。。上课贼水，读PPT加看纪录片
89824,1850,杨京平,2018-11-21 02:41:37,5,5,0,上课超水，给分超差。\n\n两次作业篇均3000给我3.6？！！
89827,1850,杨京平,2018-11-21 02:42:25,3,3,0,上课很水，给分很差，环境与可持续发展导论千万别选
89848,1850,杨京平,2018-11-21 04:21:22,4,4,0,认真写课后问题，认真答题满满两页，3.6
89856,1850,杨京平,2018-11-21 04:52:02,2,2,0,真的难受 平时小论文字数3000+ 考试认真准备开卷考写了好多 居然只给了3.6 上课真的无聊 难受 很气 真心气 凭什么?
89943,1850,杨京平,2018-11-21 10:45:25,1,1,0,怒怒怒
90037,1850,杨京平,2018-11-22 01:42:20,1,2,1,垃圾老师，三点三
90134,1850,杨京平,2018-11-22 07:43:00,3,3,0,十分水了
90217,1850,杨京平,2018-11-22 13:36:35,3,4,1,很垃圾，超垃圾，给分低
90232,1850,杨京平,2018-11-22 14:57:06,2,2,0,绩点超低…认真似乎没用…从不点名，也没有发言机会，小作文交上去没有任何回复，期末考题目简答题直接抄书简单得不行，论述题格局大与课本关系不密切。可以说，考多少看天分和积累。
90497,1850,杨京平,2018-11-23 16:05:08,2,2,0,我自己感觉也挺认真了吧 作业3k+ 考试也很认真 都回答了课上答案 写的也很多 最后三点几
90675,1850,杨京平,2018-11-25 06:24:56,6,7,1,课程：环境与可持续发展导论\n\n上课基本上就是读PPT(PPT 内容和书一样)和看纪录片，两次思考题形式是详答题，每次都是2k＋的回答，期末考试开卷，很认真地准备了资料也看了书，课也一次都没有缺，最后3.0。\n\nfine.\n\n打扰了
91062,1850,杨京平,2018-11-29 10:17:41,3,3,0,老师上课约等于念书，有点催眠。。\n\n但是纪录片还是很棒的哦！尤其克鲁格国家公园鳄鱼死亡事件，我在网上竟然搜不到。。。很有意义的一部纪录片，看完真的想哭
92155,1850,杨京平,2018-12-26 17:18:27,1,1,0,emmm
107218,1850,杨京平,2019-05-02 10:11:09,-4,3,7,环境不需要人类，人类需要环境。每次课都有视频教学片，超级推荐！！！学习主要是兴趣＋努力吧。环境与可持续发展导论，我专业就是能源与环境系统工程，老师给分很好，两次作业2000字，期末考试认真答满2小时，内容尽量充实，有理有据，自圆其说，不论对错都能得高分。我平时的通识课基本在4以下，这门课4.2，真的感谢杨老师，不仅学了些专业相关知识，还顺便拉高了均绩? ，偷偷说一句，杨老师比何老师长得帅?
120028,1850,杨京平,2019-11-17 06:14:38,3,3,0,抱歉了，我与浙大的环境专业无缘，\n\n打扰了，低绩点的我被您实力劝退。\n\n事实告诉我，光有一颗热爱环保的心的话还是去社团水水，搞什么导论，唉
120093,1850,杨京平,2019-11-17 11:46:39,0,1,1,大一的第一门通识。上课确实挺水的，就是照着书本和ppt讲知识点，所以几乎没怎么听，都在刷作业水手机了:-I；上课会放一些纪录片，看一下还是挺有意思的。四节课会布置一次大作业，详答题或者小论文，爆肝了一天一夜写了几千字。考前会给复习提纲和要点，考前准备了两天，最后考的是原题，写起来比较得心应手。最后4.5，感觉还是付出了就有收获（虽然一直在水课:P）。
123696,1850,杨京平,2020-06-11 15:21:37,2,2,0,平心而论，老师作为老师，不错，问题出在授课内容上，如果看过课本就会知道，在半个学期讲完那么多理论知识是非常不容易，所以，，，，，，，，，，，，
123828,1850,杨京平,2020-06-15 01:02:25,1,2,1,环境与可持续发展导论  水课必选  事少开卷  最后一节课记得拍题  会考原思考题 我觉得挺轻松课从来没听过4.2
124067,1850,杨京平,2020-06-23 06:43:11,1,1,0,什么鬼，认真准备了考试写了多的要死、认真写的3k作业，你tm告诉我3.6
125911,1850,杨京平,2020-09-15 14:00:05,0,0,0,极度枯燥，水课是真的强。。。
127523,1850,杨京平,2020-11-24 02:06:17,2,2,0,上课很水，你可以更水，作业两篇论文，期末开卷考，但就算你认真完成作业，认真查了考试题目资料绩点也只能碰运气，真的只是碰运气（也有可能按照字写得好坏给分，建议书法家们去选）
127529,1850,杨京平,2020-11-24 04:35:58,5,6,1,垃圾课程，虽然出分了以后有4.5，但是课程垃圾无话可说，上课极其枯燥，平时就是两篇论文看你愿不愿意肝字数，期末考试有题库，努力抄满两小时，主要看你字写的好不好看。体验极差，建议慎选
127530,1850,杨京平,2020-11-24 04:43:42,5,6,1,沙币老师，考前准备整整一天，资料打了48页，作业每次都查三小时资料结果3.6。沙币老师
127531,1850,杨京平,2020-11-24 05:00:29,4,4,0,诸位来浙江大学怎么也是想学点东西回去的吧，那么环境与可持续这门课不适合你。两个老师一正一反对比鲜明，一个十分敬业，最后一节课讲完还会给大家鞠躬，很谦虚的老师；另一个毫无生气，又给人以恃才傲物之感，学生发言还会打断(说什么我知道了)，考前问他要ppt（不是我，是有人在群里问的），什么内部资料不能泄露，找其他拍了照的同学要，这样的算老师？真相问问他来教通识课做什么？我不能妄议他在专业领域的成就，但就这门课而言是真的没有一点让人想要尊重他的意思。出了分立刻来评价一下，倒不是分很低，也有近4分，只是平心而论。如果这门课只由另一位老师上应该会很热门吧。
127551,1850,杨京平,2020-11-24 08:20:37,0,0,0,刚过均绩啊，觉得不值得。太水了，还好这课成绩影响不大，愿意来碰运气的可以来，反正我不推荐
129141,1850,杨京平,2020-12-30 11:05:16,2,2,0,上课及其枯燥，基本读ppt，都没有多少人听全都在后排做自己的事。上课姿态很高，感觉比学生高了一等的样子。大一第一门通识就被绩杀了。所以说查老师的评分还是要相信的唉……
129432,1850,杨京平,2021-01-05 09:11:47,1,1,0,答应我，别选他的课，好吗？
131038,1850,杨京平,2021-01-25 15:55:04,0,1,1,实话实话，有感觉到老师对环境与可持续发展导论这门课并没有付出很大的心思，根据之前的评价来看老师的ppt应该是用了比较长一段时间了。而且，中间有一堂录制课，这节课老师应该是准备过的，跟之前的上课风格有明显的反差，希望老师也可以稍微对这门课加入一点心思。\n\n就作业而言，事情并不多，主要是两篇小论文，我写的时候特意查询了论文的格式照着写，对大一的我来说还是有帮助的，加深了对论文格式的理解。\n\n考试的话主要是简答题和思考题形式，简答题都是书上的定义，思考题基本都是给的题目，只要提前做好准备写起来还算顺手（不过字数挺多），最后得分4.2。
142571,1850,杨京平,2021-11-13 12:40:19,1,1,0,上课极其无聊，板着脸，而且就感觉好像自己比学生厉害了不少的样子。另一个老师和他形成鲜明对比，但是大部分内容还是杨京平上的。刚考完试，看查老师还挺怕被绩杀的。
148313,1850,杨京平,2022-01-12 06:18:16,0,0,0,每次上课点名，次次都到，结果没想到这个老师居然是个绩杀，给分相当不好，高中学地理和生物学了个寂寞，他的作业也在好好完成，没想到，这给分，给了个寂寞。建议不要靠近 会变得不幸。想要别人死
148324,1850,杨京平,2022-01-12 06:46:34,2,2,0,别报他的 环境与可持续发展，我为数不多几个上课认真听，还积极回答问题的。所有作业提前交，还看了上传的视频，你跟我说我值3.3？瞎给分，付出和收获不成正比。再次点踩，不愧是评分3的老师
148326,1850,杨京平,2022-01-12 06:52:50,0,0,0,事多分少，找罪自选
148807,1850,杨京平,2022-01-13 14:45:37,0,0,0,屁事多得不得了，每周上课（环境与可持续发展导论），只要上他的课，他必上课提前签到，13：15上课，他提前到13：10让你签到，离大谱，除了这个以外，给分不好。和隔壁老师形成鲜明对比。咱就是说这种课，能不选就不选。建议最好别选。
164536,1850,杨京平,2022-12-21 13:16:42,0,0,0,上课很无聊，但是纪录片有意思，事少，我的给分还行。
182532,1850,杨京平,2023-11-17 07:16:30,2,2,0,最后一节课的题库和考试内容还是有出入的，但是翻还是容易翻到的。每节课前都点名，后面爱咋水咋水，反正我是当自习课在上。两次作业一次认真一次摆烂，期末考文科生天赋小小觉醒1.5h狂写四面A4提前交卷，最后就3.9，只能说和我摆烂的投入还算匹配吧
182659,1850,杨京平,2023-11-19 04:46:00,3,4,1,我选的是环境与可持续发展导论，开始选课时看评分很低还有点害怕，不过上课之后感觉不错，课比较水，视频蛮有意思的，就上课之前点个名（提醒一下点名比较早，最好提早5分钟到），之后就随便划水。总共就两次小作业加一次考试，我上课也不怎么听，就写写作业，玩玩手机，小作业一次比较认真，一次比较水，考试简答题基本上都找得到，详答题自己乱编（毕竟是地理考生），最后分也有4.2，感觉不错。老师也挺和蔼的，并没有像之前评论说的那么不好。对于想划水的本人来说，只能说这是天堂（＞ｙ＜）。
183159,1850,杨京平,2023-11-22 12:39:13,1,1,0,不想花太多精力，就想混个学分，可以考虑……
183238,1850,杨京平,2023-11-23 04:38:30,2,2,0,上课有点无聊，知识内容和高中地理可以说一模一样，属实没有学到什么东西。但是老师人还是很好的，很和蔼可亲，考试也会提醒注意点，给题目准备。
3326,1855,邓劲松,2015-06-02 03:39:24,-12,11,23,老师不能更好
25914,1855,邓劲松,2016-06-14 09:17:26,-22,3,25,老师太帅了
32116,1855,邓劲松,2016-07-05 16:01:02,3,9,6,感觉老师打分会看专业。。。
45808,1855,邓劲松,2017-01-20 06:27:44,-24,3,27,老师有趣！会和学生开玩笑互动！还有，给分很赞！
45810,1855,邓劲松,2017-01-20 06:28:17,-13,7,20,数字农业超级棒，老师思想很不错啊，强推
45836,1855,邓劲松,2017-01-20 07:08:19,-23,3,26,老师的课很开放，简直男神！
62756,1855,邓劲松,2018-08-02 06:32:39,10,13,3,上课不让玩手机，呵呵呵。
70289,1855,邓劲松,2018-01-26 11:06:58,20,25,5,emmm大概我太菜了。。分数非常非常低，那个4+均? 怎么刷上去的。。。。。
75622,1855,邓劲松,2018-03-14 06:30:33,-14,2,16,为双双打call！我爱双双！！！
89884,1855,邓劲松,2018-11-21 06:56:12,7,8,1,呵呵呵
103677,1855,邓劲松,2019-03-04 06:10:49,-20,4,24,给老师打十分，是因为满分只有这么多
118716,1855,邓劲松,2019-10-31 04:54:11,12,12,0,听老师的课就感觉在瞎讲，讲的还真不错呢！！非常不喜欢这个老师
121441,1855,邓劲松,2019-12-16 06:12:58,12,13,1,大概就是从来没想过要教什么，前两节课瞎逼逼，一页ppt封面讲一节课，剩下五节课让学生上去轮流展示就这样把课给水过去，感觉比学生还想水课呢，关键是给分还不好我去
124148,1855,邓劲松,2020-06-25 14:26:34,1,2,1,很水。GIS课基本没学到啥，最后的大作业也是平时的课堂练习改改就能交的。轻松，不过可能学不到什么东西。
135622,1855,邓劲松,2021-05-17 05:21:02,-3,0,3,还行吧 上课没啥重点  但是给分还行
152013,1855,邓劲松,2022-03-23 05:38:22,22,22,0,乌克兰\n\n乌克兰\n\n俄罗斯\n\n俄罗斯\n\n美国\n\n美国\n\n股票\n\n股票
152201,1855,邓劲松,2022-03-30 06:30:54,17,18,1,老师上课讲乌克兰讲俄罗斯讲美国，怎么都不讲讲原理呢？😅两周把一整个春学期的课糊弄过去可真有你的呢！
152206,1855,邓劲松,2022-03-30 09:29:23,23,26,3,智云观摩沈某展示\n\n给我看笑了\n\n😅
153004,1855,邓劲松,2022-04-23 12:13:25,-7,1,8,吹爆，我直接吹爆，超级高水平
155597,1855,邓劲松,2022-06-14 14:21:39,3,3,0,很资本家
157764,1855,邓劲松,2022-06-24 17:34:51,1,2,1,我不理解，打分下手能不能轻点
170669,1855,邓劲松,2023-03-08 02:09:11,3,4,1,某棋同学的表演太精彩了！强烈推荐智云课堂循环播放，经典咏流传
190935,1855,邓劲松,2024-03-25 02:32:16,3,3,0,你不知道你讲的很差吗
191180,1855,邓劲松,2024-04-11 05:58:29,9,9,0,垃圾玩意，总共七节课，自己讲两节绪论，让别的老师讲两三节，让同学展示展两三节课，煞笔玩意，自己不讲，啥屁也讲不到，展示自己坐后面，不让我们坐，合着教室是你家开的啊？？？挑刺毛病一流，自我感觉良好，给分乱给，建议这样的败类滚出zju。
191194,1855,邓劲松,2024-04-11 10:25:21,4,4,0,着实让我见识了一波物种多样性\n\n优越感极强，高高在上完全不尊重人\n\n说好听点是没有情商，说难听点是师风师德有问题\n\n真不明白这种完全不尊重学生的人凭什么当老师\n\n快180+学分了第一次评价一个老师师风师德极差无比
191676,1855,邓劲松,2024-04-27 13:04:32,3,3,0,讲得烂而不自知，课堂上不让学生用电脑手机，美其名曰尊重老师；\n\n学生展示的时候自己坐最后一排闭目养神或者看手机😅你是懂尊重的
191707,1855,邓劲松,2024-04-28 13:49:38,1,1,0,mlgbz
191802,1855,邓劲松,2024-04-30 09:57:13,3,3,0,不负责任，考试作业要求都没有准确地通知
219856,1855,邓劲松,2025-06-09 03:48:59,0,0,0,纯水，一股资本家的味道，高高在上，师德师风有问题
49967,1920,倪吾钟,2017-04-28 01:05:41,3,3,0,每次都点名教的又烂的垃圾
52378,1920,倪吾钟,2017-06-19 08:23:40,3,4,1,可能是环资学院最烂的老师
52943,1920,倪吾钟,2017-06-24 02:12:42,2,2,0,老师本身很和蔼 但期末给的提纲完全是放屁 完全按照自己意愿出卷 这么不讲信用的吗！！来自悲愤的背了4遍20页提纲的客户端
79113,1920,倪吾钟,2018-05-23 07:42:04,1,2,1,我觉得吧，他是不是，有点躁狂？
83737,1920,倪吾钟,2018-07-11 06:42:11,1,1,0,……唉
83987,1920,倪吾钟,2018-07-11 16:03:30,6,6,0,shit
106367,1920,倪吾钟,2019-04-26 18:45:27,10,10,0,实乃人间之屑
172329,1920,倪吾钟,2023-04-25 05:44:21,0,0,0,老顽固一个，无语
9083,1943,卢升高,2015-10-12 12:10:45,4,8,4,老师讲课很无聊的，不过你在下面做什么他都不会管，脾气很好的老师\n\n
10105,1943,卢升高,2015-11-16 07:39:12,4,8,4,老卢人很好啊，可以一张PPT讲n久，认真听很有收获
17370,1943,卢升高,2016-01-20 06:25:40,11,13,2,超级无聊
36446,1943,卢升高,2017-01-12 11:18:24,8,12,4,负分滚粗
43255,1943,卢升高,2017-01-16 04:55:15,2,4,2,上课水
43276,1943,卢升高,2017-01-16 05:15:46,-2,3,5,老师脾气很好  上课不管你干什么 最后给分不错
57191,1943,卢升高,2017-07-06 03:31:42,0,3,3,彩笔！！
58369,1943,卢升高,2017-08-30 03:22:29,-4,5,9,老师脾气很好，可拿高分
59668,1943,卢升高,2017-09-25 14:55:50,0,5,5,以后没有老卢的课了还真是想念呢，脾气超好，努力和回报成正比
68932,1943,卢升高,2018-01-24 06:35:38,21,23,2,明明很认真的复习还是gg，心态崩了
75156,1943,卢升高,2018-03-07 14:55:19,-5,3,8,不错啦！
75986,1943,卢升高,2018-03-23 04:39:18,9,11,2,真的是屁事多
80169,1943,卢升高,2018-06-21 02:51:27,12,13,1,期末考300多页的书不划重点? ，难道我们就只有这一门考试?
85400,1943,卢升高,2018-07-17 11:42:55,6,7,1,这个给分，真的是没话说?
90676,1943,卢升高,2018-11-27 02:28:58,-2,7,9,上上面那个说考前两天可拿高分，问老师评分标准的。老师的评分标准自然是相对的，他只能以考试成绩去评判一个人的好坏，如果两天能背完书，说明老师讲课的精华也都浓缩在了书里。且自古就有记忆力超群和平时勤勤恳恳的人，他们都能拿高分这有什么奇怪的。
90686,1943,卢升高,2018-11-27 00:02:42,6,10,4,可悲可叹，浙大的学子以考前背两天书记住拿高分为傲，这种功利的学习方式，能培养出人才吗？
90737,1943,卢升高,2018-11-25 13:36:10,0,4,4,感觉老师上课很认真，很有激情，很热爱这个专业。我复习得挺认真的，算有付出就有回报吧。不过如果老师给我再加一分就好了?。
90740,1943,卢升高,2018-11-25 13:56:37,9,11,2,上课听没有用，复习只要把整本书背下来你就完全非常非非常okkkk。真的只要背完整本书，好成绩一定是你的!!!!!!
90744,1943,卢升高,2018-11-25 14:24:38,3,5,2,接上一条，手动狗头
90802,1943,卢升高,2018-11-27 00:06:12,-1,4,5,上面那个说考前看两天就拿高分，问老师评分标准的。首先，我想老师不知道我们到底看了几天书吧，其次，你有本事和别人一样考前看两天书，好好背完拿高分啊…好好背书、上课的时候及时做笔记，不会很差的…
90953,1943,卢升高,2018-11-28 04:06:48,1,7,6,上面那个问评价标准的。只能对你说 兄弟 你认没认真复习 听没听课 走没走心 最后该拿几分 作为一名浙大学子 应该有点数吧
91102,1943,卢升高,2018-11-30 02:27:20,4,5,1,5000字论文，我记忆力又不好，期末考试背诵整本书300页真的要死人，还不给PPT，期末又不是只考这一门课，最后果不其然，绩杀！！！！慎重选此门课
119675,1943,卢升高,2019-11-14 23:52:32,-3,0,3,很好，有趣
127773,1943,卢升高,2020-11-27 00:31:22,1,1,0,很糟糕的一门课
135623,1943,卢升高,2021-05-17 05:27:57,1,1,0,给分一般 上课挺无聊的
142569,1943,卢升高,2021-11-13 12:36:48,0,1,1,就很烂
163784,1943,卢升高,2022-12-16 05:54:58,1,3,2,很喜欢这个老师，讲课蛮有意思的，会吐槽自己当时编课本哪里没有编好。\n\n不过考试确确实实是和平时上课没有关系的，但这门课只要好好看书、好好背，就会答题了。而且评分标准是第一节课就有讲的。\n\n本人是大一学的，很喜欢生物和地理，就提前选了这门课，老师讲得都也很有意思，会提到一些有名的生态学家，经典事例等，管老师还会放小破站的视频。\n\n前一半是卢老师上的，后一半是管冬兴老师上的，据管老师说他是第一次上课，看得出来他努力想把课讲好，但是讲得有点磕磕绊绊感觉每节课仿佛都很紧张哈哈哈。两位老师都蛮有意思的，很和蔼，有时会讲自己的一些经历。\n\n关于给分的话，感觉还好吧，可能会稍低一点但还好，毕竟最后一道大题我是真的没背到，全靠编。
191079,1943,卢升高,2024-04-01 07:30:28,2,2,0,老东西自己没什么学术水平还要对别人评头论足挑三拣四，学术偏见还见不得别人好，浙大教授师风尚且如此，嗟乎
56898,2092,赵伟荣,2017-07-05 02:52:19,1,1,0,强行引导恶竞，每组差五分，绩杀再见
189625,2092,赵伟荣,2024-01-26 05:47:38,0,0,0,虽然是大四的课吧，也不影响保研，但这绩点未免也太难看了\n\n所以不建议选大气组\n\n往年都是小组形式，每个组都要做水、气、固的项目；今年变成个人作业，只需要选一个项目，独立完成就行（但事实上固废组还是小组，水组的话大家题目也都类似，只有大气是真的一人一个题目）\n\n论工作量来说，大气组每个同学都做的挺多的，而且CAD的图没法直接抄，所以挺辛苦的\n\n但是最终成绩真的很拉垮，不知道怎么评的，如果是组内正态，那凭什么大气的同学做的比别人多，成绩却更差\n\n槽多无口
171632,2098,吴东雷,2023-03-30 09:43:40,0,0,0,很棒的老师
201859,2098,吴东雷,2024-11-07 03:39:51,0,0,0,人如其名…避雷。
214338,2098,吴东雷,2025-02-01 11:55:15,0,0,0,对着PPT阐述了半小时的人才培养理念和环工发展理念，画大饼第一名，非常符合对环工老师的刻板印象
47655,2191,徐建明,2017-02-13 03:10:14,0,2,2,上的生物地球化学。老师挺好的，一般是签到纸。讲课ppt挺好的，内容也很深入浅出。
85402,2191,徐建明,2018-07-17 11:43:28,4,5,1,就不能给分的好一点吗？别人的付出看不见吗？
152657,2191,徐建明,2022-04-17 13:40:12,0,0,0,无语死了
152658,2191,徐建明,2022-04-17 14:06:58,0,0,0,真的。。。
159952,2191,徐建明,2022-09-09 15:49:03,4,4,0,讲课讲得不错
81045,2208,黄益丽,2018-07-03 12:11:21,0,2,2,不是很好
117878,2208,黄益丽,2019-10-07 11:54:51,1,3,2,老师上课讲
126555,2208,黄益丽,2020-09-30 11:14:32,1,3,2,不很好
127672,2208,黄益丽,2020-11-25 15:33:44,0,3,3,室友让我打的
127688,2208,黄益丽,2020-11-26 00:38:40,1,5,4,很烂 太烂
130808,2208,黄益丽,2021-01-24 16:09:32,5,5,0,很不好 生命科学导论选上建议退
131525,2208,黄益丽,2021-01-28 01:52:50,1,2,1,生科导是因为没选上啥课上的，老师还行，就是课程事有点多，两周一次课，要看巨多网课。
132389,2208,黄益丽,2021-02-01 08:54:27,2,8,6,老师很温柔啊…\n\n虽然生科导事情确实多，但个人觉得认真做了不会差！
134315,2208,黄益丽,2021-03-23 10:23:47,1,3,2,老师还挺好的，只是感觉生科导这门课还有些地方需要改进...
153628,2208,黄益丽,2022-05-06 12:12:58,5,7,2,她永远不听人把话说完……
154509,2208,黄益丽,2022-06-02 03:00:55,7,10,3,生科导这门课开得很好，下次不要再开了
156502,2208,黄益丽,2022-06-20 05:12:24,4,4,0,课讲得比较一般捏
162045,2208,黄益丽,2022-11-16 09:03:35,1,4,3,老师挺好的
177014,2208,黄益丽,2023-07-01 05:06:19,-3,2,5,2022年-2023年夏学期上的老师的环境生物化学，班上只有四个同学选这门课。\n\n当时老师准备把这门课国际化，所以是全英文上课，能感到老师上课很认真负责，平时也会和我们交流。
216196,2208,黄益丽,2025-03-12 08:14:20,4,4,0,别选，push学生，环境生物化学事情贼多，好几次全英pre（环境生物化学），讲的英文也有口音不流利。
218382,2208,黄益丽,2025-04-23 05:02:40,0,0,0,唉唉唉
221035,2208,黄益丽,2025-06-21 03:04:10,0,0,0,给分差卷子难事情多 一个国际化课三四次pre 每次都有作业 都点名 期末卷子也难
5065,2258,程丽华,2015-07-03 05:35:25,23,28,5,千万别上她的课，自以为是，看你不顺眼教你站起来回答问题然后把你驳倒！
34954,2258,程丽华,2016-10-27 05:12:21,22,25,3,垃圾老师，布置作业，只看字数不看内容。认真写的还不如复制黏贴。上课还喜欢点名回答问题
34955,2258,程丽华,2016-10-27 05:13:31,20,24,4,垃圾老师毁我青春
40663,2258,程丽华,2017-04-14 13:16:32,22,27,5,有毒并且是个傻逼
44283,2258,程丽华,2017-01-17 14:06:38,31,37,6,渣得不行，给你无聊的作业，上课抽你起来然后怼你，上课一个教室到处跑活脱脱一高中班主任
47391,2258,程丽华,2017-01-26 01:13:04,20,21,1,有毒，绝对有毒
49460,2258,程丽华,2019-03-06 04:01:28,-53,9,62,老师讲课感觉还不错呀，每堂课都像一场别开生面的讲座，而且很热情，很有正能量。平常上课爱点同学回答问题，就是有时候过头了一些。
49461,2258,程丽华,2017-04-25 14:02:17,21,23,2,不管你会不会，一定点你起来考察她上节课说的没有一点意义的知识点，诸如标志事件的时间点。只会念ppt，自己都不清楚的知识，硬要学生理解，上课没有任何想听的愿望，但是她会走到学生座位旁边，所以，分分钟点你
60896,2258,程丽华,2017-11-02 00:21:42,18,18,0,有毒……作业简直就是小学语文的水平，课堂上又考英语又考口才，事实上自己也烂得一比。Unbelievable……
61006,2258,程丽华,2017-11-07 02:13:34,12,13,1,我日……
61121,2258,程丽华,2017-11-09 00:04:26,11,12,1,自行体会
63282,2258,程丽华,2017-11-30 03:50:57,11,12,1,屁事多的一逼，每次课都要签到，上课走来走去看你有没有听课，活脱脱一个高中女班主任，太差！
63308,2258,程丽华,2017-11-30 09:27:54,10,10,0,有毒，作业很多，上课体验不好。
92167,2258,程丽华,2018-12-27 01:53:30,8,8,0,脑子有坑
92168,2258,程丽华,2018-12-27 01:54:42,10,10,0,屎一样的体验
104271,2258,程丽华,2019-03-15 11:28:47,-20,3,23,好老师！
128224,2258,程丽华,2020-12-14 07:28:57,8,11,3,这老师真的很会找麻烦！！而且讲的不行，每节课都要选几个同学来回答问题。
166677,2258,程丽华,2023-01-13 08:10:19,1,2,1,课程要求与培养目标和学分设置不匹配。。任务繁重，给分差
182681,2258,程丽华,2023-11-19 11:49:24,3,3,0,日 第一次知道什么叫智商受到侮辱
192332,2258,程丽华,2024-05-15 11:28:23,3,3,0,很无聊的老师，不是什么大师，妥妥自以为是的人(自以为教的很好)，上的课很无聊，也没东西，大学写作这课也没东西，但能上的这么无聊我也是没想到
198277,2258,程丽华,2024-09-06 05:10:17,1,1,0,一坨……
199704,2258,程丽华,2024-09-27 18:21:44,1,1,0,认识她的研究生，都非常劝退，不建议报考她的研究生。水平很一般，事还比较多。
202627,2258,程丽华,2024-11-13 12:17:31,4,4,0,不知道这种东西为什么会出现在大学写作课上，严重怀疑有关系
203174,2258,程丽华,2024-11-17 15:00:24,6,6,0,PPT很古早，不知道是多少年前的了。讲课内容无趣，昏昏欲睡，点人提问，还会鼓励同学用AI回答问题\n\n真的是忍无可忍。。。期末认真写了好久的论文还没有同学GPT得分高，上课公然声称可以用GPT写论文，不知道这样的教学和风气有什么作用。
203775,2258,程丽华,2024-11-21 03:42:31,1,2,1,上她的课是折磨啊
203843,2258,程丽华,2024-11-21 12:30:24,5,5,0,作业是多的，绩点是低的，上课要找人回答的，屁事是多的，老师人是爱装逼说英语的，选她课是要人老命的。\n\n后来的各位，如果想要低绩点的可以来试试；如果不想活的可以来试试；如果不信邪的也可以来试试。\n\n大学写作上她的课，就像打卡用浙大体艺，工程图学听zyg，概论统计小测用学在浙大，抢课用浙大校网。
204720,2258,程丽华,2024-11-27 13:25:22,0,1,1,建议都选，上了她的课才知道别的老师9分的含金量。
204898,2258,程丽华,2024-11-28 11:24:36,8,8,0,语速慢，昏昏欲睡，课上没有任何有用的内容\n\n大学写作课上破事多，各种抽人回答\n\n教室里到处转\n\n不是必修的慎选大学写作，必修写作的慎选程丽华
205396,2258,程丽华,2024-12-05 12:18:39,5,6,1,事情多，明知道快期末了学生很多硬课都忙不过来，还布置很烦人的任务
205771,2258,程丽华,2024-12-12 03:19:03,-4,0,4,事情很多 要求很多 但是给分还可以 都按要求做了最后给了4.8
206052,2258,程丽华,2024-12-13 04:16:07,4,5,1,大学写作—自然。（本人尽量客观）怎么说呢，看到1.7本来很害怕，但是emmm，还不至于1.7。可能是因为老师是环境学院的，然后选了瓦尔登湖，之后再写一篇科普文章，我其他的同学都是看学术论文写笔记好像。上课随机叫人，爱追问，感觉挺尴尬的……ppt没得说，确实没什么用。大家写的文章会叫其他人评价分析，确实爱叫人….反正社恐千万别来。会叫你去面批，对文章格式要求挺高的，（幸好会叫助教发格式样版）。瓦尔登湖1000字，科普论文1500-2000。个人感觉量还好。老师其实脾气挺好的，感觉不至于分数这么低，虽然我瓦尔登湖读书笔记面批的时候被指出了很多问题….还挺难过的….没什么干货，水课倒是确实的
206135,2258,程丽华,2024-12-13 06:06:26,-1,2,3,好老师啊，谁选到是谁的幸运
208069,2258,程丽华,2024-12-25 12:25:45,1,2,1,我真的，老师讲课其实可以，能学到东西。但是只能她反驳你，你要是有解释，她要么挑别的刺，回来又继续说你这个点不行，容不得你一点解释（超绝转移话题加不听解释）\n\n钉钉更是已读不回
211661,2258,程丽华,2025-01-12 06:14:53,1,1,0,说实话，真的没什么干货。上课就是重复讲那么几句话，比如清华大学的写作课，她从第一节课讲到最后一节课，ppt也是那一张。有两次作业，都要小组互评加修改。挺麻烦的，而且小组完成任务会感觉时间很紧。反正建议别选吧，虽然老师脾气挺好的，但是没什么内容啊。
213310,2258,程丽华,2025-01-17 01:55:35,1,2,1,老师真的很好（感觉评分低只是因为每节课都会叫同学回答问题，上课不好摸鱼）虽然任务重，但是一次次的修改对于写作真的很重要。老师还有面批的环节，平时找老师改论文老师也会很耐心的给你提供建议，很细心的给你指导哪里有问题，真的会收获很多。是一位很负责任的老师
213486,2258,程丽华,2025-01-18 00:12:47,-2,1,3,事多 给分好
217214,2258,程丽华,2025-04-04 15:25:11,2,2,0,跟我面批读书报告的时候，我说读完书没有什么问题，她质疑我怎么考上浙大的，真的，好好完成作业根本没有高绩点，慎选
58022,2386,梁永超,2017-07-24 00:41:50,-6,6,12,无语 傻逼老师 自己永远是对的 不听你解释 他说你错你就是错 像小学二年级一样 叫你写检查 说什么你再这样就扣分了 没什么说的
58035,2386,梁永超,2017-07-25 07:27:43,10,14,4,认知实习，很好的老师，堂堂长江学者跟我们一起晒太阳（今年平均温度40简直可怕），一边不停讲解，很辛苦，师者风范，敬佩
177796,2386,梁永超,2023-07-05 02:08:38,6,7,1,老师像坨大便一样，b话又多，把学生当弱智😅\n\n谢谢梁老师让我们知道了浙大还有这样的低水平和普信的老师
195913,2386,梁永超,2024-07-01 00:31:07,3,3,0,沙卵一个
117933,2407,陈雪明,2019-10-14 11:33:24,1,1,0,哈哈哈哈哈哈哈哈
124350,2407,陈雪明,2020-06-29 13:52:48,0,0,0,good
162283,2407,陈雪明,2022-11-19 05:27:51,0,0,0,上课超级认真的老师，就是方言有点重，听不懂，需要全神贯注听他讲话
11779,2412,王凤平,2015-12-15 07:16:50,6,6,0,平易近人的老师
30693,2412,王凤平,2016-07-02 08:23:52,1,1,0,推荐~
54679,2412,王凤平,2017-06-30 04:07:24,4,4,0,老师人超好的，有趣又温柔，没有考试最棒啦啦啦～给分也很不错
55635,2412,王凤平,2017-07-02 05:25:48,1,1,0,老师超级和蔼可亲，讲课清楚，还会有各种小故事，给分好！
55636,2412,王凤平,2017-07-02 05:27:09,1,1,0,老师很和蔼也很可爱
63081,2412,王凤平,2017-11-28 07:57:56,2,2,0,老师上课幽默风趣，说故事能说一小时，带着各种冷笑话，非常好玩~
68470,2412,王凤平,2018-01-23 08:45:58,2,2,0,老师牛逼
153261,2412,王凤平,2022-04-27 07:51:23,8,8,0,绝对的好老师，目前大学生涯中体验最好的一门实验课
153367,2412,王凤平,2022-04-28 14:51:44,6,6,0,好老师
154163,2412,王凤平,2022-05-25 02:42:53,12,14,2,上大学以来最好的实验老师，和某人形成鲜明对比，不管给分怎么样我都给她打满分。
154213,2412,王凤平,2022-05-26 05:36:05,5,5,0,好爱王老师
205373,2412,王凤平,2024-12-05 07:29:31,16,16,0,我frh实名10分
205374,2412,王凤平,2024-12-05 07:30:42,3,8,5,我shy实名10分
205375,2412,王凤平,2024-12-05 07:31:17,2,2,0,王老师赛高！！！
205377,2412,王凤平,2024-12-05 07:32:05,2,2,0,好爱王老师，上大学以来最好的实验课，给分高，还帮我们减负。
205378,2412,王凤平,2024-12-05 07:32:50,1,1,0,实验，爽！
219609,2412,王凤平,2025-05-31 14:10:46,1,1,0,我zjs实名10分
16863,2473,童裳伦,2016-01-19 06:03:10,0,1,1,不知道该说什么好……
25072,2473,童裳伦,2016-05-05 07:15:40,-2,1,3,挺实在的一个老师
57409,2473,童裳伦,2017-07-07 10:33:21,0,2,2,环境监测有点无聊，考试没重点，给分还可以
67440,2473,童裳伦,2018-01-21 08:02:42,7,8,1,教学能力一般，上完课也不觉得有什么收获，个人认为是挺混的老师
83426,2473,童裳伦,2018-07-10 09:08:19,5,6,1,SB老师
119937,2473,童裳伦,2019-11-17 01:25:27,2,3,1,总而言之，这老师脑子可能不大好??
221633,2473,童裳伦,2025-06-25 04:39:03,1,1,0,给分很差，虽然但是好像环境的专业课给分都不咋地
13052,2508,高超超,2015-12-24 15:51:51,7,13,6,科环，不能缺课，必点名。发了一次零食。内容还算有趣。4次展示，有考试
14844,2508,高超超,2016-01-10 04:45:16,2,5,3,给分差！
18584,2508,高超超,2016-01-22 05:31:36,3,4,1,讲课很无聊，每次都要签到，专业性太强，考试给分很低
18604,2508,高超超,2016-01-22 06:07:59,1,5,4,点名只是签到本子打钩 你们懂的 课堂展示四次有点崩溃 小组很重要⋯⋯考试坑 内容多且专业 背了很久 给分尚可 宝宝4.2
18651,2508,高超超,2016-01-22 08:34:11,0,1,1,点名 4次小组展示 组长给分还行
18655,2508,高超超,2016-01-22 08:40:08,3,4,1,平时好水，4次展示亚历山大，考试难但不必害怕，认真写就没问题，给分不太好。
18705,2508,高超超,2016-01-22 11:12:51,2,2,0,科环 点名是纸质的。上课很水，只是拓展知识题目10分名词解释：比如让你解释，什么是生化五日需氧量（比较难背）填空题十分，与名词解释类似。论述题50分
18876,2508,高超超,2016-01-22 16:13:06,3,5,2,死都不知怎么死的！
19044,2508,高超超,2016-01-23 06:30:43,7,8,1,科环，给分略差，2.5学分呢，略坑
21126,2508,高超超,2016-02-19 09:54:22,4,4,0,2.5分的科环给分非常烂
33330,2508,高超超,2016-09-18 08:21:31,0,2,2,很好很和蔼的老师啊，不知道为什么大家会不喜欢。老师英语口语也很好。
33461,2508,高超超,2016-09-19 12:00:00,0,2,2,老师人挺好的，暂时不知道小组展示和考试给分有多麻烦，但是挺愿意学下去的
35624,2508,高超超,2016-11-10 07:35:12,-1,0,1,每次都会签到，课程内容不水，老师很好
39964,2508,高超超,2016-12-28 10:53:51,0,1,1,环境地学，和另一个老师一起上的，上课容易困，期末反正是背屁屁提，背出来就高分
42227,2508,高超超,2017-03-06 01:55:49,4,6,2,。。唉
44861,2508,高超超,2017-01-18 11:52:03,0,2,2,考试容易，给分也挺好的，有4.5，
44866,2508,高超超,2017-01-18 11:59:11,0,1,1,辣鸡科环，毁我青春，拉我绩点！
44867,2508,高超超,2017-01-18 12:01:43,0,1,1,三次展示一次考试  老师不错  给分不错 课程略无聊
44870,2508,高超超,2017-01-18 12:04:36,0,1,1,给分超级好，平时划水，4.8的绩点，ps:期末考一定要打印ppt
44916,2508,高超超,2017-01-18 13:36:37,0,2,2,平时展示有点小多，期末占百分之70，所以开卷考试一定要记得打印课件。总之老师还挺好的把，最后绩点4.5
44927,2508,高超超,2017-01-18 14:02:20,5,5,0,高分不多，想拿高分得努力还要一点运气。还有，小组不好的话上这个课真的很烦的。
46103,2508,高超超,2017-01-20 15:14:14,0,0,0,老师人是不错的，不过有点小严肃。很多展示，不过重点区分还是期末考。
46228,2508,高超超,2017-01-21 03:24:05,0,1,1,老师给分很好呀 只要最后考试的时候一定要带课件就好！展示认真做就好
47399,2508,高超超,2017-01-26 03:47:46,3,3,0,科学技术与环境健康，考试一定要带课件，极其重要，没带课件的我跪了10多分，最后3.6(ಥ_ಥ)明明说好课件上的是拓展内容不考试的呢。。。
48122,2508,高超超,2017-02-28 14:51:16,-2,0,2,纸质点名，上课有点无聊，三次展示有点烦，但最后考试简单，答案都在ppt上，最后4.8还挺满意的
73870,2508,高超超,2018-02-03 09:31:35,0,1,1,科学技术与环境健康 被正态 事情多 不知道有没有啥k类不坑啊
101319,2508,高超超,2019-01-28 04:02:16,0,0,0,。。。\n\n
116646,2508,高超超,2019-09-12 07:36:04,0,3,3,呜呜呜我的第一个满绩。。。高老师我爱你(ღ♡‿♡ღ)\n\n认知实习的老师，和蔼负责，就是可能这个实习也没啥用
154254,2508,高超超,2022-05-27 06:52:33,0,0,0,123
165769,2508,高超超,2023-01-09 14:50:34,0,1,1,老师很好
208516,2508,高超超,2024-12-28 17:07:56,0,0,0,老师人很好，挺有趣亲和的一个人哈哈
217392,2508,高超超,2025-04-09 12:35:33,0,0,0,讨论课太恶心了\n\n坐中间的人举手了都先被叫，然后他们讲了很多，坐旁边的人后发言都没什么好说的
142547,2540,文岳中,2021-11-13 03:26:47,0,1,1,不整活的老师。
107346,2565,史舟,2019-05-04 05:46:48,0,5,5,高分需要恶竞，竺院某个班的所谓专业课去感受了一下，就是展示恶竞就好，大佬不大佬不知道，但是全班恶竞猛如虎
121902,2565,史舟,2020-01-23 09:09:03,0,3,3,老师平时分不给打满的。呜呜呜 \n\n
154148,2565,史舟,2022-05-24 15:34:28,0,3,3,工于心计，人品不行，非常精明，当学生小心被利用和算计
176129,2565,史舟,2023-06-28 01:48:57,0,2,2,这个老师真的有违师德，小人形象，请学校加强师德教育。本着求是的精神，请调研其周围师生。报考的时候请避雷
177701,2565,史舟,2023-07-04 10:46:20,-1,1,2,避雷啊，这个老师真是不咋地
179516,2565,史舟,2023-09-18 01:29:09,0,4,4,作为他的研究生来说，这个导师非常好，建议报考，还会帮学生找工作
44591,2686,郑平,2017-01-18 03:43:03,0,0,0,良心老师，赞！
63085,2686,郑平,2017-11-28 08:05:47,0,0,0,老师上课声音很催眠，人很nice，期中试卷超简单。
99803,2686,郑平,2019-01-25 07:46:03,0,0,0,英文考试，平时上课却全是中文授课。本身是非常有学术水平的一位老师，课程内容设置得不合理
53625,2784,张清宇,2017-06-27 07:51:41,7,9,2,很心累
79462,2784,张清宇,2018-06-06 02:06:00,1,1,0,...
125508,2784,张清宇,2020-09-10 17:27:06,1,2,1,环评就离谱儿
131977,2784,张清宇,2021-01-30 00:53:31,8,8,0,做最多的事，得最少的分，没想到一个学期绩点最低的是一门通识……是怎么做到一个通识课的任务比通核还多的……
132320,2784,张清宇,2021-01-31 17:29:58,22,26,4,1.生态文明这门通识课，事情多，学不到东西。\n\n2.真的不明白为什么一门通识课采用五级制评分？？？
132501,2784,张清宇,2021-02-02 04:03:24,15,17,2,生态文明给分很离谱的，选上了建议快跑
138228,2784,张清宇,2021-07-08 04:49:44,1,3,2,呵呵呵
142034,2784,张清宇,2021-11-04 08:21:42,4,6,2,上课只会吹牛，别的厉害的老师吹吹牛我们觉得他是真厉害，zqy一没实力二也吹不好，只让人觉得是个sb，说是不点名，结果还是要点，快跑
145825,2784,张清宇,2022-01-03 04:20:04,4,4,0,她自己看不看查老师，赶紧来看看查老师，看看自己什么✓⑧样，ctnd
146863,2784,张清宇,2022-01-07 23:13:32,8,8,0,课也听了，复习也做的比较充分，最后的测试也不错，为什么只有1.5，太伤心了，建议不要选
146870,2784,张清宇,2022-01-08 00:39:05,12,14,2,为什么用五级制给分啊？事情很多，要做四次小组展示和期末考，就很离谱，快跑吧，给分也难看
146875,2784,张清宇,2022-01-08 05:43:26,9,10,1,首先是犯下傲慢之罪的我，不听前辈的评价选了这门课，到头来花了大把时间还拉了均绩。（小熊摊手）
146990,2784,张清宇,2022-01-08 10:17:04,7,7,0,老师上课主要讲故事（大多为自己的经历），开卷考简单，无论文，主要就小组分享。不容易挂科，但同样，绩点很低，按五级制就很离谱。水课推荐，追求绩点就快逃。（生态文明）
147027,2784,张清宇,2022-01-08 12:57:18,9,10,1,生态文明，上课毫无体验感。老师讲自己去某地和某领导商讨某工程的事，言语间感受得到她的自豪和夸耀，声音慢条斯理没有起伏。给分烂的很，一个学期四次展示，事超级多，但我还是认认真真完成了，小组内分配的任务我都好好做，还额外承担摆烂的组员的活，平时上课有听，期末有看PPT还自己整理了复习资料，最后拿了个2.5绩，是所有学科拿到过的最低绩点。没有给分制度，完全不知道是怎么评出来的。最后还有一场期末考，可以带电脑，我和我一朋友都是百度搜的答案抄的，最后ta4.5，（ta在一个一般的小组（临展示赶工之类，都懂）），总之就是给分巨迷，看了査老师才知道不止我这样。别选，快逃，现在才明白老师一开始上课的时候说：“今年选我们课的同学还挺多”是什么意思了，选上了快逃！
147099,2784,张清宇,2022-01-08 16:31:33,2,2,0,快跑吧，狗都不去上
147123,2784,张清宇,2022-01-08 23:51:01,3,3,0,喜提2绩点 哈哈 牛逼 没见过这么恶心事这么多分这么低的课 牛逼牛逼
149786,2784,张清宇,2022-01-17 03:16:42,1,1,0,|x|不属于C^1(R)
149910,2784,张清宇,2022-01-17 17:19:54,7,13,6,不知道为啥老师分这么低。感觉老师上课是真的想要教授生态相关的内容（虽然大部分都是非专业），人看上去是学术型的那种但是感觉很实事求是，是我喜欢的那种认真型的老师。展示和期末考都有认真准备分数就还不错。
154774,2784,张清宇,2022-06-05 05:05:30,10,10,0,生态文明laji课程！一个学期做了四次小组展示！组员一半摆烂，我干了小组50%以上的活！考前复习了PPT，自己整理了知识点，考试因为可以用电脑，查了百度、翻了PPT，尽力写了试卷。结果2.5，狂拉均绩！老师上课也没意思，别选生态文明！
165504,2784,张清宇,2023-01-07 12:07:18,-5,2,7,老师很可爱，是真心会为学生着想的
166001,2784,张清宇,2023-01-10 16:44:01,-8,2,10,争取当一下组长 组员摆烂的话可以在最后给老师或者助教姐姐写一个参与度的评价 老师真的会认真为学生考虑的  今年疫情管控放开了 老师也每次上课都会关心学生的   至于老师的课嘛～确实听着有亿丢丢无聊 上课的时候一般水实验报告
166016,2784,张清宇,2023-01-10 22:16:46,3,5,2,记录一下，这课今年还是五级制
185791,2784,张清宇,2024-01-04 12:01:47,2,2,0,老师你有老年痴呆就别这么辛苦来上课了好不好...
186743,2784,张清宇,2024-01-13 01:53:04,0,0,0,纯傻逼
196984,2784,张清宇,2024-07-06 09:29:21,3,3,0,大四了都要来骂一遍的程度，五级制真是害死人，连浙大出国成绩单4分制度如此力挽狂澜的制度都救不回来的程度！！！老师是有多讨厌学生呀？看不得学生好？大一不懂事埋下的雷呀，每看一次成绩单就要骂一次！
10027,2789,陈丁江,2015-11-14 11:52:31,-48,4,52,上课很有趣，之前也都是不点名的，然后在我们的强烈建议下每节课签到了哈哈哈\n\n最后考试也比较简单，按照提纲来复习，计算题也有例题，感觉其实比写论文轻松
50791,2789,陈丁江,2017-05-05 11:21:57,9,11,2,负分。
86198,2789,陈丁江,2018-09-10 11:00:12,2,2,0,。。。。。。。
106370,2789,陈丁江,2019-04-26 18:55:18,8,8,0,真的屑
106371,2789,陈丁江,2019-04-26 18:57:38,-1,1,2,当年的同学成了今天的同事 （指另一农资老师）
107316,2789,陈丁江,2019-05-03 12:40:04,1,2,1,一般般
110147,2789,陈丁江,2019-06-24 02:25:47,14,16,2,弟中弟，水土实习撑着把伞躲在树荫下玩手机，还嘲讽挖土的速度慢，您牛逼您来啊
110159,2789,陈丁江,2019-06-24 03:25:19,16,16,0,挖土实习，下着暴雨，cdj就自己打着伞就站在zmk老师身后，也不给他打个伞，就让老先生淋雨；实习cdj每秒都在摸鱼，打伞玩手机大家有目共睹，每天说得最多的一句话就是“快点快点！”催债一样催催催你是阿南婶吗？？作为教学副院长从来不为学生考虑，实习没有固定的吃饭地点甚至没有卫生间，真厉害。不过真正惊人的还是实习第二天早上暴雨挖完土，我们上车前在地上把鞋子上的土弄干净，一转头看到他锃亮的一尘不染的黑皮鞋。\n\n（查老师怎么没有负分，太不人性化了）
110186,2789,陈丁江,2019-06-24 09:00:02,12,13,1,我寻思着你一个男老师，出去实习一直玩手机划水就算了，下雨天一个人打伞不管学生和其他老师也算了，大晴天打伞我也认了，阴天都还在一边打伞划水？？您是白素贞变的么？？
116350,2789,陈丁江,2019-09-09 00:55:08,3,4,1,不合格
117859,2789,陈丁江,2019-10-06 06:40:09,8,8,0,在环资算差了
126882,2789,陈丁江,2020-10-26 14:51:36,14,21,7,农资面试，“你们说非常想进我们农资专业我觉得是要打问号的”“我觉得你们根本没去了解我们专业”“你连今后四年学什么都不知道我怎么让你们进来”
128934,2789,陈丁江,2020-12-27 05:39:00,-10,2,12,还不错
134379,2789,陈丁江,2021-03-25 09:50:48,-10,1,11,好老师啊！
139222,2789,陈丁江,2021-07-13 10:14:19,4,4,0,“快点快点”
154055,2789,陈丁江,2022-05-21 09:13:23,10,10,0,一点不为学生考虑，不是非要上他的课绝对不要选，谁选谁后悔，这货纯***
154057,2789,陈丁江,2022-05-21 09:43:42,11,11,0,😅🤡👎
154080,2789,陈丁江,2022-05-22 16:07:57,17,21,4,1.5分的课一点都没有自知之明，至少加到3才对得起这么多事情以及这么多人的服务
154136,2789,陈丁江,2022-05-24 11:18:10,9,9,0,给分极差
154137,2789,陈丁江,2022-05-24 11:18:19,10,10,0,恶心，恶心，还是他妈的恶心！
154266,2789,陈丁江,2022-05-27 12:19:51,7,8,1,别选他的选修课，选了百分百后悔。真的很可怕
156296,2789,陈丁江,2022-06-18 22:21:09,9,9,0,给分这么差？别人的努力看不到吗？
171827,2789,陈丁江,2023-04-06 17:18:59,0,2,2,祝陈书记高升
172554,2789,陈丁江,2023-04-29 16:14:08,1,2,1,真就无语，学院书记非要找存在感能不能找个选修课开开，别来必修课和实习来玩我们
172558,2789,陈丁江,2023-04-29 23:11:38,4,4,0,你没事吧？付出与实际不成正比，不知道怎么给得分
190443,2789,陈丁江,2024-03-04 09:17:01,5,6,1,每次上课都要把“我是书记”几个字挂在嘴边，是没什么其他值得称道的成就了吗？还美其名曰为学生着想，重视本科生教育。与其掩耳盗铃，不准学生使用手机电脑，塑造认真听课的假象，不如好好想想怎么改革农资的这些烂课。
190602,2789,陈丁江,2024-03-11 09:06:35,6,6,0,一身烟味还非要走来走去，突出的额头不是畸形的股价，而是学院书记的高傲呀。
190603,2789,陈丁江,2024-03-11 09:18:42,3,3,0,真jb恶心啊 这么老逼讲的一坨还不让做其他事 直接收学生手机还玩小学生那套呢
199702,2789,陈丁江,2024-09-27 18:10:13,-2,0,2,看重形式大于看重内容。其实是能力缺失的体现。或者说相比于学者更像一位官员吧。\n\n\n\n祝陈书记官运亨通。
220,2851,周文军,2015-03-14 17:01:10,3,8,5,环境学概论很好的，水水的给分还特别好
32731,2851,周文军,2016-07-12 03:48:18,3,5,2,环境学概论事情多了点，但是真的是在认真教学的好老师
49510,2851,周文军,2017-04-17 09:41:50,2,2,0,就是不准玩手机看电脑，可是我不想手记笔记啊哭泣
53251,2851,周文军,2017-06-26 08:55:45,1,4,3,考试极其坑
57087,2851,周文军,2017-07-05 13:33:27,2,4,2,给分无比随机，满勤，论文认认真真写了，最后给分超低，不知道怎么想的。期末考开卷拿书没用，只有他的ppt有用。
57161,2851,周文军,2017-07-06 00:34:05,1,2,1,环境学概论这课，老师给的分真的伤了我学习的心
57408,2851,周文军,2017-07-07 10:30:49,-1,2,3,环境学概论给分挺好的，就一篇论文，期末开卷考，内容全是PPT上的，书上有少量，上课会提问能加分。环境监测老师上课总是问问题，问的一般都是考试重点。展示的时候要脱稿，并用激光笔
191643,2851,周文军,2024-04-26 12:03:06,3,3,0,上课不允许看手机，不允许用电脑，可是我想做笔记
192575,2851,周文军,2024-05-24 06:14:02,8,8,0,爹味很重，让人不适，上课不允许用任何电子设备，
192579,2851,周文军,2024-05-24 08:43:36,2,2,0,额额额
195712,2851,周文军,2024-06-29 17:29:04,10,12,2,烂得要死 环境学上课不让用手机电脑任何东西 必须听课 大作业给分巨烂 讲课也没什么水平 不推荐选环境学当跨专业
195731,2851,周文军,2024-06-29 17:58:45,9,10,1,千万别选环境学你会很痛苦
195777,2851,周文军,2024-06-30 02:26:28,12,13,1,不要选！周五下午上课，不让请假。同时上课每次都签到。给分巨烂，都不需要正态，感觉没几个人的绩点是高于3.9的。这老师纯纯。。。
195786,2851,周文军,2024-06-30 02:47:34,6,7,1,爹味重，官味重，环境学给分巨烂
195806,2851,周文军,2024-06-30 03:50:01,7,8,1,给分贼差
195817,2851,周文军,2024-06-30 04:55:34,9,10,1,不要选环境学作跨专业！！这课上的巨难受，不准用电子产品还每节课都签到，上的东西也没见多少水平，纯纯坐大牢\n\n最重要的是给分很烂！课友们很多3.几，成绩构成期末才说，感觉老师期末才想起来需要有成绩构成\n\n老师一股官腔味，架子很大，消息永远已读不回，请假要走学校程序，询问课程论文给分等等直接不回，要你走正常程序，总之很难评
199493,2851,周文军,2024-09-24 12:59:46,5,5,0,烂就一个字！不解释呵呵
9727,2900,施加春,2015-11-06 03:39:27,0,5,5,蛮好，有货，作业多
13624,2900,施加春,2015-12-30 06:24:40,-3,2,5,没意思，作业多，
13701,2900,施加春,2016-11-21 12:07:47,-6,1,7,超好的老师呀，完全不点名，然后大水课
15294,2900,施加春,2016-01-13 11:30:27,19,26,7,最后一节课点名，但是老师认脸，作业多，超级多，一节课满堂灌一节课展示，不水，
19737,2900,施加春,2016-01-25 07:59:27,25,31,6,良心好老师炒鸡负责任，而且很认真，喜欢他！！！
19754,2900,施加春,2016-01-25 08:42:44,8,9,1,老师平时不点名，只是签到，最后一节课会点名。人特别温柔。是坚定的环境保护者。很关心学生。德艺双馨。隔一节课有小组展示，但能锻炼。
19839,2900,施加春,2016-01-25 11:16:18,0,6,6,任务多。给分不公平。做了这么多，分还没别人什么都不干的人分高。超级超级超级不爽
21240,2900,施加春,2016-02-27 10:10:52,10,11,1,绝对超赞，付出与收获成正比，老师是一位优秀的环境保护工作者，致敬
23035,2900,施加春,2016-03-16 10:23:45,5,5,0,老师讲解认真，展示课也能学到很多。
25141,2900,施加春,2016-05-06 06:01:51,15,20,5,老师很认真吧，虽然任务挺多但是很亲切，很难得的科学与研究类的课会分组，每两节课全小组成员只要准备一个ppt就好了，觉得是锻炼自己的好机会，而且结交了很多朋友……每节课前会放视频，学到了不少知识，对以后的生活有很大帮助，有次老师说要减少使用面巾纸，第二次课就发给我们每人一条手帕...真的很贴心的老师，给分当然有高有低，重点是能有所收获真的很难得^_^
28848,2900,施加春,2016-06-28 23:00:10,4,4,0,超超负责，讲课费
29186,2900,施加春,2016-06-29 11:01:33,3,4,1,超级好老师，认真负责体贴温柔帅气给分高。
33065,2900,施加春,2016-09-11 12:44:06,2,3,1,水水的
35046,2900,施加春,2016-10-31 10:31:11,4,4,0,老师很负责！虽然作业多了点，但小组分工就好了呀！老师讲课前也是认真准备的！你们在底下公然打开电脑，尊重老师吗！！！\n\n也是一位优秀的环境保护者，致敬！
35473,2900,施加春,2016-11-10 07:20:10,16,16,0,老师人特别好，要做ppt小组分享啥的不过也很水，上课的话反正我没看到有人抬头，他一个人心酸的在唱独角戏，心疼他一下。有天晚课班里翘课翘了一半，老师知道但都没计较，人还是不错
37862,2900,施加春,2016-11-21 12:08:03,3,7,4,很生气
38674,2900,施加春,2016-12-14 07:59:20,-1,0,1,超级体贴的老师，不点名，有小礼物
38860,2900,施加春,2016-12-19 15:15:53,-1,1,2,挺好的，非常和蔼，上课人来少了，也不发火
40293,2900,施加春,2017-01-01 13:36:50,3,3,0,超级好的老师，课水水的，小组合作完成作业其实量不多。
41192,2900,施加春,2017-01-10 02:53:28,3,3,0,老师很耐心也很细致，认真听的话会学到很多，课堂事情不是太多，小组分工合理的话会比较轻松
41280,2900,施加春,2017-01-10 11:27:50,3,3,0,老师很可爱，基本不点名，小组展示的话分工合理会很轻松。
41427,2900,施加春,2017-01-11 13:42:02,3,3,0,老师脾气很好很耐心很认真。会有小礼物。人超好～特别关心大家的健康。
45712,2900,施加春,2017-01-20 03:30:32,7,8,1,好老师，就是有时候同学不怎么积极，老师略显尴尬
45718,2900,施加春,2017-01-20 03:40:31,3,3,0,还行吧，每节课都去，收获不算太大，分给的还可以吧
45737,2900,施加春,2017-01-20 04:02:39,-2,3,5,被正态
46115,2900,施加春,2017-01-20 15:30:34,0,1,1,为什么给的你们低\n\n
46149,2900,施加春,2017-01-20 17:25:56,6,6,0,老师人很好，但是课有点水。\n\n在补充一下，人真的非常好，绝对的好老师。
51942,2900,施加春,2017-06-13 16:40:51,3,4,1,超级超级良心好老师，还送手帕，很喜欢他！！！
54566,2900,施加春,2017-06-29 15:39:32,1,2,1,中途缺课一次被点到。小组展示总体还可以吧。文科生，论文没有很数据化，比较定性的表述偏多，加了表格和图像。最后4.5。老师真的脾气好，Davis访问学者，环境一块同学提问没有什么他回答不了的。好评！
62944,2900,施加春,2017-11-27 12:00:20,3,3,0,老师好认真| ू•ૅω•́)ᵎᵎᵎ
64596,2900,施加春,2017-12-25 12:13:21,8,8,0,老师非常好，会不忍心水他的课
66197,2900,施加春,2018-01-13 02:46:37,4,4,0,老师真的太温柔啦！！！！手帕现在都还留着
66595,2900,施加春,2018-01-17 12:05:24,8,8,0,超级好的老师，最后一节课拍了小组集体照，
66596,2900,施加春,2018-01-17 12:09:16,6,6,0,老师真的太好了太温柔了 真的不忍心水他的课 最后一节课呜呜呜还让我们休息一下不要久坐 良心好老师！！！
66599,2900,施加春,2018-01-17 12:16:25,2,2,0,老师真的是超级棒了，很精神很绅士的一个人。期中期末总共有两篇论文，大概每三四周会轮到自己的小组做一次展示。很希望有环境专业的选老师的课，这么好的老师很值得有好的学生。作为一个每次都在课上补作业的学生，真的觉得有点愧疚了。
68532,2900,施加春,2018-01-23 10:16:21,1,1,0,课一点都不水\n\n但让我学到很多东西\n\n爱你   老师
71241,2900,施加春,2018-01-28 07:42:28,1,2,1,很负责很关心学生，勤恳的环境保护者！
71253,2900,施加春,2018-01-28 07:55:27,0,1,1,施老师是个很温和的人，挺为学生着想的，期末作业有同学迟交他也会等(说“要对每一位同学负责”)。课不水，每隔一周一次研讨课需要小组合作，交两篇论文。作为文科生，写论文的时候真·秃头……但还算有所收获w
71262,2900,施加春,2018-01-28 08:12:04,1,1,0,虽然绩点爆了>3< 但是老师还是很认真负责的
71265,2900,施加春,2018-01-28 08:20:03,4,4,0,课是轻松但几率死亡评分
71381,2900,施加春,2018-01-28 11:19:31,8,14,6,怎么说呢，老师人不错，但事情多，一学期付出不少努力，绩点3.3，一门通识居然绩点最低，有点忧伤
71486,2900,施加春,2018-01-28 13:50:21,0,0,0,老师是真的很认真负责，给老师点赞！
71639,2900,施加春,2018-01-28 23:22:30,0,0,0,老师人很好，小组展示内容比较多，老师隔一周讲一次ppt，期末要求是写1500字论文。
72949,2900,施加春,2018-01-31 12:04:22,1,1,0,真的良心老师，脾气真的超级好，虽然要上一个学期课，隔两周就有小组展示，但老师真的是个很优秀的环境保护者，很关心学生，给分也不错哇
74773,2900,施加春,2018-03-06 01:10:28,1,1,0,很认真负责的老师
87277,2900,施加春,2018-09-26 15:13:28,1,1,0,挺好的  支持
100156,2900,施加春,2019-01-25 16:02:07,0,2,2,老师挺不错的，但是感觉付出和收获不成比例
121457,2900,施加春,2019-12-16 03:58:40,0,0,0,亲切，敬业
128231,2900,施加春,2020-12-14 12:03:09,8,9,1,课程十分水，老师人称加州小丸子，编纂经典著作《加州的往事》，讨论课每学期一次个人展示，爱了爱了
145981,2900,施加春,2022-01-05 01:41:20,0,0,0,上的老师的通核，事情可能稍微有点点多但是真的很棒！
150517,2900,施加春,2022-01-28 08:55:08,2,4,2,老师人很好，事多，平时好好做作业，但是期末考试没打印ppt，很多题找不到答案直接爆炸，2.8绩点让我很难评到10分啊，我还是太年轻了🥺
166440,2900,施加春,2023-01-12 09:28:40,1,1,0,老师人很好，很温和，平时也不为难学生，周一听他讲课也可以干自己的事情，像是一个德高望重的学者。\n\n事情确实蛮多，2个2000左右的小论文，2个展示，期末开卷考。\n\n给分的话还行，属于是那种平时把考核要求都达到就可以有高分、没达到就分不高的课。\n\n期末考试不难，翻ppt和书就行，单元如果没找错的话还是好找的，和同一个学期的军理考试比简直就是天堂。。。。
166448,2900,施加春,2023-01-12 09:35:43,5,5,0,给分不行
166455,2900,施加春,2023-01-12 09:46:48,4,4,0,10分给老师，但是那个程助教班级有点过于严苛了，可能论文给的也不好，最后乘成绩不好。老师还是很好滴！！！！！！！！！！！！！
167226,2900,施加春,2023-01-15 06:43:07,0,2,2,老师很好，事情略多。都到课了，论文认真写了，讨论课也非常积极在发言了，期末考试大部分都找到了，还是拿到了有史以来最低的绩点。唉。
167833,2900,施加春,2023-01-19 10:19:21,10,11,1,老师人很好，课程任务稍多，2篇很短的小论文，小组每个人2次展示相当于一学期可能有10-12次小组展示，感觉相关话题资料不是非常好查，周末还是需要花些时间的\n\n小测是每次2.5分直接计入总评，题目不难，基本都是本节课一些内容条目，但是只取第一次成绩，所以一定尽量一次做满，不然巨亏( p′︵‵。)\n\n期末是开卷考试，只要对书上和PPT内容有大概印象全部找到还是比较容易的，一定一定要打印PPT上所有带字的内容（有字的配图/绪论课也别忘记）！几届同学血的教训( ‘-ωก̀ )
170041,2900,施加春,2023-03-01 06:04:43,1,1,0,一个学期忙下来，期末考开卷基本都做对了，结果绩点3都没有
185093,2900,施加春,2023-12-26 07:52:21,-3,3,6,老师改进了很多，现在给分也不错了（自然资源科学导论），考试注意订购教材+上网找辅助资料打印（仅仅PPT绝对不够）就可以，大学第一个满绩！
196123,2900,施加春,2024-07-01 17:22:27,2,4,2,绩杀，作为一门通识核心很水，但是课程给分真的很抽象，期末考试开卷但是基本上考察信息查找能力，一节课一百多页的PPT一共十五节课，考察的还很多都是细枝末节的稀碎知识点，快跑别选
196129,2900,施加春,2024-07-01 19:05:45,1,2,1,给分不行，但还是很负责很好交流的老师。课程事情不多，两次pre➕两篇论文➕开卷考，平时要多发言（虽然每节课都发言了最后还是只有3.6，并且卡绩）。总之追求高绩点别选，水水通核学分还可以吧（应该不难选上）
221899,2900,施加春,2025-06-27 08:44:30,0,0,0,赶快逃
7351,2901,沈掌泉,2015-09-14 02:51:23,0,0,0,没意思
15480,2901,沈掌泉,2016-01-14 14:56:47,4,4,0,老师挺和蔼的
41706,2901,沈掌泉,2017-01-12 11:43:21,4,4,0,老师很温柔，人很好
89310,2901,沈掌泉,2018-11-18 09:23:58,3,4,1,老师很好(●—●)是我太废
175336,2901,沈掌泉,2023-06-24 04:09:23,6,6,0,考试也太难了吧
36445,2978,林道辉,2016-11-13 16:13:08,3,3,0,负分滚粗。
38671,2978,林道辉,2016-12-14 06:34:12,1,2,1,不让玩手机，上课差不多都按照书上的上。有一次作业，一个8-10页A4的论文综述，考试内容是最后一个ppt上的，背出来就好了
50790,2978,林道辉,2017-05-05 11:21:32,5,5,0,负分\n\n
79382,2978,林道辉,2018-06-02 04:50:51,2,2,0,屎一样
89615,2978,林道辉,2018-11-20 03:36:25,-6,1,7,给分很低。考试几乎等同于默写，我背得滚瓜烂熟，卷面几乎满分，最终总成绩才4.5
89622,2978,林道辉,2018-11-20 04:28:46,-1,2,3,医学生过来修个性的，反正觉得比起我们专业不划重点！！！！这个重点复习真的好良心? 94也不亏～
106372,2978,林道辉,2019-04-26 18:58:04,4,8,4,环资最垃圾的老师之一
116702,2978,林道辉,2019-09-13 15:13:47,10,10,0,没懂他为什么要用01年的教材…真的没懂
119567,2978,林道辉,2019-11-14 00:25:50,-2,3,5,其实老师上的还挺有趣的，相对于我们自己的专业课（医学生呜呜）已经很生动了，然后期末考前背一下ppt，可惜没满，拿了94分，也还算可以了吧
119641,2978,林道辉,2019-11-14 11:47:08,-5,1,6,我来复读了：给分很低。考试几乎等同于默写，我背得滚瓜烂熟，最终总成绩才4.5
142352,2978,林道辉,2021-11-10 12:01:41,15,16,1,有就是有，没有就是没有😅
142680,2978,林道辉,2021-11-15 05:25:08,3,4,1,非常好，建议选购
142682,2978,林道辉,2021-11-15 05:28:10,5,6,1,终究是牛遇上了马
142685,2978,林道辉,2021-11-15 05:30:04,7,7,0,解释一下，流汗黄豆那个评论说的那句话是林在结课展示的时候诘问学生有没有查询过数据。
143190,2978,林道辉,2021-11-21 06:38:00,0,0,0,我不李姐，为什么这个年代了还会有这样的课存在
182307,2978,林道辉,2023-11-14 10:46:04,1,1,0,给分就是答辩
35016,3005,施积炎,2016-10-29 14:52:24,2,2,0,总共签两次到，会事先提醒～讲课内容很充实～
55376,3005,施积炎,2017-07-01 11:44:37,0,0,0,很认真的老师，但是听课有点无趣。给分一般，污染修复期末写论文，大二还是不要提前选了！论文真的不好写。
210086,3005,施积炎,2025-01-08 06:13:53,0,0,0,老师给分还可以，最后要有一次小组汇报、写一篇大论文、个人小结，很轻松的一门课
19691,3009,方萍,2016-01-25 05:48:12,0,0,0,负责任的老师
83990,3009,方萍,2018-07-11 16:05:25,0,0,0,方老师人很棒，可惜马上退休了，祝老师愉快
8735,3077,庄树林,2015-09-25 02:09:17,0,8,8,好老师不解释～
49319,3077,庄树林,2017-04-05 07:06:57,3,3,0,呵呵，评价吧
58617,3077,庄树林,2017-09-09 18:30:27,0,5,5,超级棒！！
65319,3077,庄树林,2018-01-03 03:35:08,0,5,5,好老师不解释
81143,3077,庄树林,2018-07-04 06:54:17,2,9,7,庄老师的课程给分都不错，认识实习主要看态度，环境数据分析主要看最后的展示，给分都相当不错！好老师，平易近人。
81184,3077,庄树林,2018-07-04 08:24:45,2,6,4,给分不错，环境数据分析事情非常少，就期末一个展示以及相应的word，上课很轻松
88713,3077,庄树林,2018-11-06 09:38:06,6,7,1,挺好玩的，长的有点儿像葛优
122974,3077,庄树林,2020-04-27 06:34:14,-7,2,9,非常非常非常认真负责的老师，选的环境分析，能感受到老师态度，论文+ppt都会查重，虽然分数不是很高，但是按头安利！！庄老师超棒！！
158350,3077,庄树林,2022-06-28 14:55:46,-9,0,9,上了环境科学的认知实习，同时庄老师还是很多项目的指导老师，和老师的交谈中能感觉到老师很负责任、热情并且有学识，真的很佩服老师
158872,3077,庄树林,2022-07-03 02:55:49,4,4,0,老师很好，但真的没人吐槽认识实习的考评嘛，时间真的很赶啊
178957,3077,庄树林,2023-08-05 16:22:37,12,18,6,第一次在大学里见到老师当着学生的面飚脏话，震撼。感觉不是很能控制好自己的情绪，不过态度还算负责。
180946,3077,庄树林,2023-09-28 15:04:19,3,10,7,这个老师非常的畜生，投湖事件之后他的评论是可惜了这个年轻有为的导师要受影响了
195353,3077,庄树林,2024-06-28 00:38:27,1,2,1,要求比较高，对迟到早退请假和pre超时的容忍度低，一款有点呆呆的老师，有时候有点可爱。比较不喜欢的是，一节课一个半小时，他有一半的时间在大吹马斯克和各种生成式AI大模型，每周都如此，emmmm……此外环境数据分析这门课出发点是好的，实用性是强的，而且可以看出老师每年都有对内容进行更新，紧跟时代（比如今年加了大模型相关的内容）。但老师本人非计算机或者数学专业，难以把概统和代码讲透彻。上课倾向于囫囵吞枣式教学，自己把老师给的示范代码跑一跑，期末是自己整个模型案例分析，在这门课要学到东西还得自学，反正对我来说这门课的最大收获是学会用智谱清言写各种作业（这何尝不是一种进步…）。最后说一下这门课教材是他自己编的，我觉得编挺好，在代码方面比课程有用，如果想学建议拿到电子版或购入纸质版。
215485,3077,庄树林,2025-02-27 00:16:23,7,7,0,最好不要迟到🥹迟到一分钟直接给我扣掉分了
215868,3077,庄树林,2025-03-06 06:39:35,5,5,0,你在讲啥呢，，
216024,3077,庄树林,2025-03-09 13:08:20,0,3,3,好老师，负责任，刀子嘴豆腐心，就是偶尔有点点子王，反正点赞就对了
218416,3077,庄树林,2025-04-23 09:05:05,2,2,0,下面那条好评是老师自己给自己写的吧，人工智能基础A教了个寂寞，啥不会的都让去问deepseek，每节课都说多加练习多加练习，翻来覆去就讲那么几句话，期中考也是一坨，顺便提醒一句老师很在意查老师和朵朵上的评价
39363,3149,梁璐怡,2016-12-22 07:47:28,-1,3,4,就是好，还是好
63083,3149,梁璐怡,2017-11-28 07:59:54,3,6,3,梁老师很爱笑，十分亲切，有问必答，非常棒的老师！
116753,3149,梁璐怡,2019-09-15 04:52:20,6,8,2,报告贼麻烦
127538,3149,梁璐怡,2020-11-24 06:39:38,1,3,2,老师超级棒！！！不过今年的助教感觉没有很专业
141379,3149,梁璐怡,2021-10-03 15:16:56,-2,4,6,温柔的老师
143983,3149,梁璐怡,2021-12-15 06:24:59,-1,4,5,课前讲一个多小时，不能让我们早点去做早点结束吗
197768,3149,梁璐怡,2024-08-12 00:27:21,-1,0,1,老师超好的，实验出现奇怪的现象都会超级耐心地帮你找原因，找不到菌的时候也会帮你找，超级温柔的
218570,3149,梁璐怡,2025-04-24 15:58:45,0,0,0,老师人很好
221319,3149,梁璐怡,2025-06-23 02:27:10,1,1,0,超级好老师，耐心又温柔
221356,3149,梁璐怡,2025-06-23 04:18:35,0,0,0,学弟学妹们在实验课后千万不要选晚课，拖堂到七点多吃不上晚饭是常态。一学分的课那么多事情，给分卡绩真的令人寒心。感觉对不起我写实验报告、改方案的几十个小时。
24550,3280,翟国庆,2016-05-01 13:20:47,2,3,1,先占个坑，上完课再来补充
52783,3280,翟国庆,2017-06-23 00:43:49,0,1,1,宇宙无敌究极好！！
60721,3280,翟国庆,2017-10-28 05:51:02,0,0,0,很好啊\n\n
68452,3280,翟国庆,2018-01-23 08:23:40,0,1,1,上课有点困困的，但是很良心，给分很好，考试好好准备一定会考好的！
70268,3280,翟国庆,2018-01-26 10:22:27,3,3,0,虽然上课听不懂 感到绝望，但是期末考超好的 重点很细 给分好 ??
70270,3280,翟国庆,2018-01-26 10:24:18,6,6,0,最后一节课之前简直绝望，最后一门课给的PPT简直良心，觉得翟老师宇宙无敌好，点一个赞\(≧▽≦)/
78404,3280,翟国庆,2018-05-11 10:53:20,0,0,0,上课有点无聊，给分极好，考试全部是ppt上的，环境物理学考前的ppt100多页全部背下来就能很好。噪声虽然有500多页，但是有重点的！
80464,3280,翟国庆,2018-06-27 01:22:41,2,2,0,非常好的老师！上课不死板，作业也不多，要是认真听的话能学到很多！要是上课想水水过的话考试前老师会给一个总的复习PPT的！考试内容不会超过这个PPT和平时作业，好好复习不会考差，而且老师会调平时分。吹爆国庆！
81023,3280,翟国庆,2018-07-03 10:37:33,4,5,1,老师笑起来很可爱呀hhhhhh\n\n划重点真的太棒了
108813,3280,翟国庆,2019-06-03 01:56:19,0,0,0,真是个有趣的家伙，给10分了
110422,3280,翟国庆,2019-06-26 14:07:32,0,2,2,给公式又有些“简单”的公式不给是几个意思，差评。什么叫简单，请定义清楚，或者把简单的公式全部列出。模糊不清就是全考，我哪知道你的简单是有多“简单”
112167,3280,翟国庆,2019-07-03 18:21:26,0,0,0,声音忽然变的好大
125664,3280,翟国庆,2020-09-12 17:31:32,1,2,1,不调分，由于疫情不见总复习ppt，平时作业不能错，错了就扣分，按比例算进总成绩的，考完期末感觉良好，与概统常微分无异，但是由于平时分成功下3。由于网课这门课也没有好好听，稍微听一下感觉也听不懂，over。
136931,3280,翟国庆,2021-06-28 10:18:59,19,20,1,环资学院难得的好老师。。虽然课程安排有点奇怪。
137689,3280,翟国庆,2021-07-05 15:23:01,14,15,1,这学期上了翟老师的噪声和环物。课程安排来看，这么大的知识量被塞在8周短学期课内确实不太合理，我一开始抱着对物理的热情是很想好好听的，但是后来发现 很多情况根本没有时间去好好理解公式的内涵，几乎就靠期末考前的背诵记忆。（当然这和我自己的时间安排不合理也是有关系的）成绩出来也不是特别理想，但考虑到仅仅靠最后几天硬背出来的结果，应该还算过得去了。\n\n从老师的角度来看绝对值得打10分！给人温文尔雅又很亲切的感觉，课后问问题的时候老师态度都很好。也很喜欢翟老师务实办事的风格。是一个谋求用知识和技术真正解决现实问题的学者，和那些一味追求业绩头衔的人完全不一样。总之对老师印象满分就对了！
173936,3280,翟国庆,2023-06-05 03:33:46,3,3,0,上课爱讲没用的鸡汤浪费时间
176990,3280,翟国庆,2023-07-01 03:34:27,0,0,0,好老师虽然上课总讲一些看似跟课程无关的内容，但实际上也是想让你学的好一点。
221640,3280,翟国庆,2025-06-25 04:51:42,0,0,0,环境物理学期末会直接给出重点，给分很好，比环境专业的其他课程好太多了
148059,3292,胡勤海,2022-01-11 12:16:38,1,1,0,相较而言，是个好老师。。
66335,3395,王卫军,2018-01-15 07:11:08,9,11,2,迷之优越感的老师…
85303,3395,王卫军,2018-07-17 01:36:54,3,5,2,SX东西，feiwu
92721,3395,王卫军,2019-01-04 03:26:18,3,5,2,从来不下课？魔鬼吗？
94657,3395,王卫军,2019-01-17 14:49:20,5,6,1,从来不下课
110098,3395,王卫军,2019-06-22 23:26:39,4,5,1,不喜欢下课啊
123058,3395,王卫军,2020-05-07 05:44:39,4,6,2,给分是什么垃圾
152465,3395,王卫军,2022-04-12 08:25:57,15,18,3,niuma老师 从不下课 12:15下课还拖课 明明很普通但很自信，，总是打断学生讲话，老师就可以不讲礼貌了？
153180,3395,王卫军,2022-04-26 12:23:16,-13,2,15,还可以
153182,3395,王卫军,2022-04-26 12:35:44,4,5,1,我不道啊
153187,3395,王卫军,2022-04-26 12:49:28,7,9,2,可以nm
153190,3395,王卫军,2022-04-26 13:00:07,4,6,2,快逃！
153191,3395,王卫军,2022-04-26 13:04:09,7,9,2,该老师极不负责，上课不知道在讲点什么，毫无逻辑，只会一味自我陶醉，上课质量极低，作为一个学生，真是受不了，建议大大整改，学校应极度重视
171140,3395,王卫军,2023-03-17 02:29:16,4,6,2,都什么年代了，上课还不能用电子设备，记笔记还得手写，你管的是不是太多了
184610,3395,王卫军,2023-12-22 02:51:45,0,0,0,上课吹牛 从来不下课 优越感强
188426,3395,王卫军,2024-01-19 03:33:16,0,0,0,讲的很一般，不下课，PPT乱七八糟
201192,3395,王卫军,2024-10-30 02:41:32,0,0,0,抽象派
207729,3395,王卫军,2024-12-24 04:58:48,1,1,0,从不下课……
26887,3403,张建英,2016-06-21 12:52:03,8,9,1,没意思
49681,3403,张建英,2017-04-23 13:00:35,4,7,3,。。。
50273,3403,张建英,2017-05-02 06:11:33,-19,1,20,首先在老师的课上能够学到很多东西，包括英文文献的查阅和阅读…给分也超级nice！人也超级温柔！
55619,3403,张建英,2017-07-02 05:08:34,-7,2,9,老师很建议大家查阅英文文献，上课除了课本内容还可以了解到很多别的知识，喜欢讲故事，给我们普及别的知识
55620,3403,张建英,2017-07-02 05:09:53,-13,0,13,给分不错，环境毒理学每节课都有课后作业，只要找一些文献发到群里就可以了。最后考试是论文和PPT展示，选题要好，偏题就完了。
57642,3403,张建英,2017-07-11 10:47:07,7,8,1,没选对题毁所有
76933,3403,张建英,2018-04-26 06:11:37,7,7,0,一句话毁了我一个礼拜的成果
76939,3403,张建英,2018-04-26 16:55:18,5,7,2,学了八周课，连环境毒理学是什么都不懂。
79464,3403,张建英,2018-06-06 02:10:35,0,2,2,怎么说呢，老师出发点是好的，但是依然改变不了传统评判和说教的模式
117012,3403,张建英,2019-09-18 08:24:59,2,2,0,一言堂。\n\n学弟学妹注意各种格式和参考文献，另外要注意答辩指的是:只答不辩，连连道歉。
153882,3403,张建英,2022-05-15 09:31:35,8,8,0,给分极差。上大学两年以来获得的最低分。
154092,3403,张建英,2022-05-23 05:26:28,9,9,0,表面温柔，内心呵呵。。。。tm就这？
162450,3403,张建英,2022-11-22 18:00:13,2,2,0,6 但没6分
177471,3403,张建英,2023-07-03 11:02:57,3,3,0,很难评。。。。
178586,3403,张建英,2023-07-15 14:42:13,3,3,0,首先是环境毒理学提纲完美避开考试内容，拿到试卷一看傻眼，其次是短学期学在浙大PPT提交不设置好，同学提醒第二天才看到，10点半开放12点截止，展示揪着主语不放，提醒后来者短学期展示不能说我们，是否是srtp就说不是😅
179134,3403,张建英,2023-08-28 08:49:11,3,3,0,给人一种很媚莮的感觉…恶心
180723,3403,张建英,2023-09-25 11:02:43,2,2,0,笑里藏刀的典范，不让用srtp也就是形式一下，谁用谁没用大家心里都清楚。难道别人一年做的实验你七八天就能超过？最逆天的是同一组的大家都用srtp，分差能超过10。
197559,3403,张建英,2024-07-19 03:16:46,3,3,0,诗人握持
197752,3403,张建英,2024-08-09 04:17:12,2,2,0,短学期都结束了钉钉未读。。。 短学期上了个开头第二天出国了。。。
215840,3403,张建英,2025-03-06 02:58:56,2,2,0,不好快跑
217411,3403,张建英,2025-04-10 03:10:56,0,0,0,第一次上课：怎么这老师只有三分？\n\n八周后：三分高了
127553,3457,何艳,2020-11-24 09:55:14,0,2,2,给分挺低的，而且上课学不到什么，考核也没有标准
24170,3602,沈超峰,2016-04-28 04:10:57,0,2,2,。。。
26140,3602,沈超峰,2016-08-05 09:28:39,0,2,2,。。。
48759,3602,沈超峰,2017-03-12 08:00:52,2,2,0,帅  声音好听（英语发音很nice）  知识面广  三观贼正，下课后也很乐意和同学们交流
63084,3602,沈超峰,2017-11-28 08:02:29,14,15,1,沈老师是个鸡汤哥，喜欢环工的同学可以跟他混。
79222,3602,沈超峰,2018-05-28 02:17:23,1,1,0,帅气的灵魂万里挑一?
90771,3602,沈超峰,2018-11-26 02:53:13,3,3,0,沈老师上课氛围很轻松，人很帅性格也很好，选沈老师的课准没错
200026,3602,沈超峰,2024-10-11 08:22:15,3,3,0,关心学生的好老师~
208238,3602,沈超峰,2024-12-26 09:46:47,1,1,0,关心学生的好老师
102040,3670,周炼清,2019-01-30 06:25:38,-2,0,2,上课很舒服很轻松的老师呀～对学生也超级好，会站在学生的立场上考虑问题就很暖还很幽默呀～?
18615,3685,吴祖成,2016-01-22 06:30:47,3,6,3,老师很萌人很好\n\n
22919,3685,吴祖成,2016-03-15 00:23:40,-1,0,1,萌萌哒，很亲切
36218,3685,吴祖成,2016-11-11 06:19:19,-1,0,1,666666666666
40511,3685,吴祖成,2017-01-24 14:02:25,0,1,1,给分一般，很一般
40673,3685,吴祖成,2017-01-05 02:29:31,2,3,1,适合大佬上的课，虽然我对这门课感兴趣但新生研讨课你懂的
45366,3685,吴祖成,2017-01-19 13:01:19,-2,1,3,适合大佬 可我不是 老师人很好 可文科生有点难过
46031,3685,吴祖成,2017-01-20 14:11:39,0,1,1,。。。
70319,3685,吴祖成,2018-01-26 12:32:57,0,0,0,给分一般 偏差  一节老师讲 两次讨论 不能说有很多干货 只能说 为你展现了一道科技前沿的大门 让你试着自己去想 自己去搜集 不错的体验 但是 最开始会有些不适应的
39965,3714,俞绍才,2016-12-28 10:56:47,0,1,1,环境学，每节课有一篇文章要写，1000-2000字，不考试，最后一节课展示，给分极好，其实挺水的
66766,3714,俞绍才,2018-01-19 02:52:31,0,0,0,不可多得的好老师！！
90268,3714,俞绍才,2018-11-23 02:04:28,0,0,0,给分好，课水
161743,3714,俞绍才,2022-11-12 01:43:09,1,1,0,给分好，课水
153264,3753,王福民,2022-04-27 08:13:31,9,10,1,反正比邓某好多了懂得都懂好吧
176621,3753,王福民,2023-06-29 12:48:46,0,0,0,讲课干货挺多，认真做平时作业能对遥感方向受益匪浅，但对于期末的笔记整理来说就有点量太多猪脑超载了
182418,3753,王福民,2023-11-16 02:14:48,2,2,0,老师讲课很有逻辑很清晰，课上用软件做示范跟着学习很有用
84147,3827,包永平,2018-07-12 06:35:48,4,9,5,给分不好。
138502,3827,包永平,2021-07-09 14:38:33,10,12,2,给分很低，作业很多，出分很慢，一点不捞
138516,3827,包永平,2021-07-09 15:21:27,12,16,4,给分巨差，作业是其他老师的五倍，讲的也烂，助教又凶，又要求天多。选上的赶紧换吧，不然必定后悔。。。
138517,3827,包永平,2021-07-09 15:23:34,7,9,2,倒霉至极，选了这鬼死老师，醉完
138519,3827,包永平,2021-07-09 15:27:24,8,10,2,这个老师特别特别多，每一次课后都要写作文。不过是形策课，作业贼多，出分特别慢还一点都不捞，害。绝了，别选。要不是我当时以为是个新老师，绝对不选。快逃。
138521,3827,包永平,2021-07-09 15:28:43,17,20,3,2.1分绝了好吧 分给的太低了
138545,3827,包永平,2021-07-09 16:44:19,6,13,7,很弱！快逃！真的没什么好说的，出分慢，你以为他在捞吧，结果我辛辛苦苦认认真真考的期末考，每一题都小论文一样，很认真很有思考量，出来就这？你就随随便便搞个正太，一个通识思政课至于吗，我就3？作业多，事多，给分烂，助教也不行，估计就是暗中踩我一把，真的一年极差体验，很恶心！！！！
138556,3827,包永平,2021-07-09 18:24:49,7,9,2,给分低 作业多 恶心🤢
138562,3827,包永平,2021-07-10 00:05:59,5,7,2,给分不好
138583,3827,包永平,2021-07-10 02:32:22,4,7,3,给分不好，很不好好不容易拉上去的绩点被拉下来了
138609,3827,包永平,2021-07-10 03:04:43,8,10,2,吐了，3.3\n\n作文认认真真写，期末复习认真觉得自己答得很不错
138622,3827,包永平,2021-07-10 04:14:57,4,7,3,太倒霉了\n\n辛辛苦苦拉上来的均绩\n\n一个2.4直接拉下来0.15\n\n…
138627,3827,包永平,2021-07-10 04:51:33,8,10,2,作业超级多超级多超级多，给分贼差，差到哭了都/::< /::</::</::< /::</::</::< ，快逃！！！
138928,3827,包永平,2021-07-12 00:24:26,-27,2,29,劳资形策4.8，一帮水课的，不绩杀你们绩杀谁？！
138987,3827,包永平,2021-07-12 05:55:30,6,9,3,竟然这老师和助教还有脑残粉，也是离谱，真不知道这个人是个哪个脑瘫。这就是传说中的卷狗之王吗？xswl。
139266,3827,包永平,2021-08-21 10:57:41,0,5,5,给分太拉\n\n每节课都都点名，全到了\n\n作业全交了\n\n最后2.7\n\n没脾气
139816,3827,包永平,2021-07-28 09:51:17,1,4,3,超级惨，作业超级多，给分超级差，能换则换，快逃！！！😭
139869,3827,包永平,2021-08-05 02:56:07,-23,1,24,劳资形策4.8，一帮水课的，不绩杀你们绩杀谁？？！！
140056,3827,包永平,2021-08-24 08:17:13,-25,2,27,劳资形策4.8！！！\n\n一帮水课的，不绩杀你们绩杀谁？？！！
140189,3827,包永平,2021-09-03 22:46:57,-14,4,18,非常棒，强烈建议!认真跟着包老师学，真的可以学到很多，太爱包老师了，✪ω✪，么么哒～(^з^)-☆
140470,3827,包永平,2021-09-13 01:01:27,0,5,5,脑瘫人会喜欢这垃圾
143599,3827,包永平,2021-11-28 09:58:44,-31,1,32,劳资形策4.8\n\n一帮水课的不绩杀你们绩杀谁??!!
143705,3827,包永平,2021-12-02 05:31:32,-32,1,33,劳资形策4.8！！！一帮水课的不绩杀你们绩杀谁？？！！！！
151883,3827,包永平,2022-03-19 04:39:36,-10,2,12,非常棒，强烈建议!认真跟着包老师学，真的可以学到很多，太爱包老师了，✪ω✪，么么哒～(^з^)-☆么么哒～(^з^)-☆么么哒～(^з^)-☆么么哒～(^з^)-☆么么哒～(^з^)-☆
164157,3827,包永平,2022-12-18 13:19:39,-1,1,2,回放删了让人怎么课下继续卷呢？:)
170926,3827,包永平,2023-03-12 12:57:55,0,0,0,不想评价 呵呵
171492,3827,包永平,2023-03-26 11:14:24,-2,0,2,挺好的，老师还行
174892,3827,包永平,2023-06-19 12:24:38,2,2,0,倪嫲似了
175234,3827,包永平,2023-06-22 15:05:16,1,1,0,牛马算了
175298,3827,包永平,2023-06-23 12:03:08,0,0,0,密麻麻石蜡
175299,3827,包永平,2023-06-23 12:04:22,0,0,0,密麻麻石蜡
175795,3827,包永平,2023-06-26 15:46:24,0,0,0,每节课都会有作业 不知道班怎么样
181711,3827,包永平,2023-10-29 12:36:05,2,2,0,不是东北怎么你了？？？
194476,3827,包永平,2024-06-24 05:36:42,3,3,0,史中史
194482,3827,包永平,2024-06-24 05:55:30,3,3,0,给分真的烂
194757,3827,包永平,2024-06-25 09:19:36,-2,0,2,给分似乎比以前稍微好了一点点？但是整体上确实一言难尽
200119,3827,包永平,2024-10-13 11:12:54,1,1,0,n n d
205510,3827,包永平,2024-12-08 10:56:45,0,0,0,666啊
220427,3827,包永平,2025-06-18 02:19:30,0,0,0,讲课也不会讲，上课还不给用电脑也不给玩手机写作业，最后还绩杀+卡绩，难评
76050,4157,唐先进,2018-03-26 01:17:27,0,2,2,早知道不选他的课了
120236,4157,唐先进,2019-11-24 14:01:54,0,2,2,老师人很好
202660,4157,唐先进,2024-11-13 16:06:17,2,2,0,上课不让用电子设备 展示很爱挑刺 最后给分不错 不过有可能是另一个老师给的分 讲课中规中矩吧 很爱提自己博士工作什么的
113409,4191,田生科,2019-07-06 17:09:02,9,11,2,垃圾老师，给分极差，付出得到不成正比
124633,4191,田生科,2020-07-04 11:37:31,-7,0,7,谢谢老师！
157420,4191,田生科,2022-06-23 07:38:57,1,1,0,事情有点多，给分不好
145584,4342,孙幼波,2021-12-30 10:50:07,0,0,0,水字数
74868,4388,逯慧杰,2018-03-06 07:11:58,1,2,1,讲得特别好，很亲切
124188,4388,逯慧杰,2020-06-26 16:42:14,4,9,5,漂亮的大姐姐
164762,4388,逯慧杰,2022-12-25 12:59:48,3,6,3,为什么感觉老师讲的内容好像很多时候她自己都不是很懂的样子？\n\n嘴上说讲的很细 但是实际没讲出什么东西来\n\n留的作业每次都是很重的负担...\n\n期末划的范围也不是很全 复习有很大难度\n\n怎么说呢。。有点喜欢不起来
214339,4388,逯慧杰,2025-02-01 11:54:40,2,2,0,认真亲切，为数不多希望把课讲好的老师；课后事情杂杂的，任务重；期末出卷比较为难学生、回避重点
117054,4500,罗煜,2019-09-19 01:00:47,3,5,2,我觉得挺好的
74637,4608,刘凤仪,2018-03-05 02:24:48,-13,5,18,满分哦
74638,4608,刘凤仪,2018-03-05 02:25:43,0,5,5,非常nice的老师，声音好听有磁性，给分也很好！\n\n
74911,4608,刘凤仪,2018-03-06 10:55:54,0,4,4,思修老师，很棒
74925,4608,刘凤仪,2018-03-06 12:42:59,0,4,4,nice
74926,4608,刘凤仪,2018-03-06 12:44:10,-2,4,6,人美心善，别说了，用心去感受。\n\n\n\n\n\n\n\n老师说她快32了，我是不信的。\n\n\n\n\n\n上她的课水手机有种罪恶感。
75015,4608,刘凤仪,2018-03-07 03:56:46,0,5,5,超级温柔的老师 真的！超温柔！！！
75315,4608,刘凤仪,2018-03-09 01:46:31,2,21,19,老师人又美又温柔，而且给分超好，上她的课简直不想玩手机。自身实力很强大，因为自身是国家二级心理咨询师，且对职业规划有一定研究，所以上她的课很舒服。介绍自己的名字说是有凤来仪的凤仪的时候简直被她迷到神魂颠倒(´▽｀)ノ♪
75577,4608,刘凤仪,2018-03-13 12:49:18,-2,2,4,上课很开心
75591,4608,刘凤仪,2018-03-13 23:10:54,-2,3,5,刘老师的思修课虽然事情相比较别的班有点多，但是却在刘老师的课上学到了许多。
78555,4608,刘凤仪,2018-05-13 02:43:39,0,5,5,女神老师 很漂亮很温柔 为老师打call 就是职规课程安排事很多 姑且先让备课组背锅吧 (￣∇￣)
78576,4608,刘凤仪,2018-05-13 09:55:17,13,16,3,老师人挺好，然而被正态?
79210,4608,刘凤仪,2018-05-27 05:50:33,-2,2,4,老师好漂亮，上课只想盯着她看?
80572,4608,刘凤仪,2018-06-28 03:47:06,-4,1,5,稳得一批
83977,4608,刘凤仪,2019-02-23 15:07:17,0,7,7,老师很pl！课上的也好！然后嘛，我啥也没做，小组分应该也是最低的，就期末交了篇职规书，拿了4.5！人美心善没错了！
84041,4608,刘凤仪,2018-07-12 01:52:38,1,7,6,老师真的很漂亮很温柔！职规满啦！谢谢老师！
84064,4608,刘凤仪,2018-07-12 03:09:40,-10,2,12,刘老师真的是人美心善有温柔，炒鸡有气质，给分也很好，课堂上能学到很多干货，而且最重要的是，这堂课让我找到了女朋友:)
84640,4608,刘凤仪,2018-07-13 12:15:25,-2,2,4,多举手发言成绩肯定会好啦！！！
85473,4608,刘凤仪,2018-07-18 07:38:20,-2,1,3,老师很有气质，然后本身功底也很扎实
85887,4608,刘凤仪,2018-08-25 04:39:15,-2,1,3,超级美丽
86057,4608,刘凤仪,2018-09-01 00:49:43,-2,0,2,老师上课超有趣，各种有趣的活动和小组讨论，每次课后还会推荐很多书籍，网站甚至电影，我们有问题也会非常热心地解答。
86541,4608,刘凤仪,2018-09-17 06:10:16,-2,1,3,漂亮又温柔 爱她!
86614,4608,刘凤仪,2018-09-17 12:47:03,-2,4,6,老师长得好看，顺便表白11组紫衣服的小姐姐啊啊啊啊啊啊啊
86779,4608,刘凤仪,2018-09-18 15:58:28,-3,0,3,，，，
92385,4608,刘凤仪,2018-12-28 07:37:52,-2,0,2,好！好！好！
94082,4608,刘凤仪,2019-01-15 06:45:30,-2,3,5,单方面宣布刘老师是我女神 不接受任何反驳\n\n我所有向往的样子她都有
94414,4608,刘凤仪,2019-01-16 15:04:14,6,7,1,我凉凉了大题点答错了
94419,4608,刘凤仪,2019-01-16 11:18:22,-2,2,4,前面那个单方面的我顺着网线来打你了? 有凤来仪，超级可爱，又很有气质的一个女神小姐姐，每天都会在微信群里滚雪球，不小心把读书报告发错邮箱了，她还傲娇了一下，真是可爱死了。
97050,4608,刘凤仪,2019-01-21 15:20:20,-3,1,4,职规 老师很好滴，虽然我对职规兴趣一般般来混个j类学分，但还是觉得上课内容很充实，形式很丰富，资源资料也很多，老师备课用心，讲述生动，而且给予同学们充分的鼓励。我是不太爱发言和展示的同学，但是小组作业和期末职规书都做比较认真，觉得给分还是满意滴。
97113,4608,刘凤仪,2019-01-21 16:13:36,12,20,8,老师人不错，各种女神。但个人感觉给分很一般，与其他某些老师相比甚至可以说给分偏低。作业和事比较多，每周都要进行小组讨论和上交记录。平时分中，小组成员互评占比大。本课绩点主要体现学生运气（能否被选为组长，组长是否负责）和人际交往能力。
97123,4608,刘凤仪,2019-01-21 16:36:16,1,7,6,人是好人，课是好课，给分海星，上课不积极的人会低一点。
97165,4608,刘凤仪,2019-01-24 13:38:58,12,13,1,自求多福吧
97174,4608,刘凤仪,2019-01-21 23:39:36,-4,5,9,真是受不了思修出分以后在群里阴阳怪气的。fy小姐姐很棒。
97211,4608,刘凤仪,2019-01-22 00:29:04,12,22,10,思修：老师人很不错，课事很多，给分很不好
97335,4608,刘凤仪,2019-01-22 08:15:35,12,14,2,老师人很好，给分比较低，事很多，课堂的气氛不太好
97426,4608,刘凤仪,2019-06-28 16:48:36,-15,14,29,真受不了某些在群里匿名的键盘侠，吃相难看，总想把自己的无能推别人头上去。我这种绩点只有三的人说什么了吗？世界上本来就没有绝对的公平好么？\n\n   总而言之这个班的氛围细想起来颇为可怕，组员之间、师生之间的矛盾被有心之人恶意放大，老师努力想打造的那种“有意义的思修”竟被一些“绩点奴”贬为无物，可笑可谈。
97456,4608,刘凤仪,2019-01-22 09:07:44,-9,0,9,老师上课很注重气氛培养，如果认真融入的话会发现很有意思的，平时注重小组研讨，但也是要求有质量的研讨，老师平时分都打的不错，主要是看期末闭卷考，这是靠自己的，老师也没办法，所以要想好绩点，主要还是靠自己，期末考试好好考
97533,4608,刘凤仪,2019-01-22 10:07:24,1,4,3,客观地说，刘老师是个很善良负责的老师，教学很认真，会给我们分享一些有用的知识。但或许是思修课的通病，上课从未涉及书本，所以期末考一脸懵逼；给分一般，但我觉得给分规则还是科学的（组内互评加期末考）。
97602,4608,刘凤仪,2019-01-22 11:55:18,1,6,5,没听过老师讲课\n\n给分低理所应当\n\n个人觉得大学最重要的学到自己想学的，知道自己想做什么，思修…不太有意义，拿到学分就行吧\n\n老师本身没什么问题，但我不太说的出来fy小姐姐怎样怎样这种话，毕竟对这门课没什么感情吧\n\n如果选这位老师还想拿高分的话应该挺吃力\n\n
97695,4608,刘凤仪,2019-01-22 13:41:22,9,11,2,唉╯﹏╰平时思修事比室友多，期末室友们都压根没准备过，结果室友们都上了4
97886,4608,刘凤仪,2019-01-23 00:57:06,7,18,11,别舔了 难不难看 事情么死多 分么死低 你要是女神你分数给高点啊 思修这种课一堆事情 分么又这副样子 也是没谁了
98679,4608,刘凤仪,2019-01-23 19:40:27,1,4,3,老师人很美很有气质，课堂也比较有趣，事情也不算太多，然而给分很铁面，自求多福吧
100778,4608,刘凤仪,2019-01-27 00:08:24,15,26,11,老师上课还是很温柔的，课后也有很多很有趣的分享，感觉老师也是在努力让思修这门课不这么枯燥。但是相比之下事情真的比其他班略多，每节课结束都有小组讨论，两次展示，一个短一点的专题小培训和一个研究性学习，还要写书评和志愿服务感想，而且上课按照小组坐不能翘课。给分的话没有很差但是比其他班还是要偏低一两档这样，就不和某免考班比了吧，比要考试的班还是低一些。虽然说不能唯绩点论，根据她给你几分评价一个老师，但是思修这种思政课，不在意绩点难道我还关注我真的能学到什么吗？
101009,4608,刘凤仪,2019-01-27 09:00:33,8,12,4,不就是一个思政老师吗?给自己已经认认真真做事的学生一个稍微好一点分数有这么难吗?
102817,4608,刘凤仪,2019-02-23 13:18:35,4,5,1,替隔壁康康同学表白凤仪女神！！
104728,4608,刘凤仪,2019-03-26 14:45:27,7,7,0,给分低
105420,4608,刘凤仪,2019-04-12 10:44:37,1,1,0,老师超漂亮，超给力
105611,4608,刘凤仪,2019-04-17 07:37:20,5,7,2,反正就是 我女神\n\n人巨好 巨温柔\n\n这么说吧\n\n我如果大个十岁 一定要追她
106939,4608,刘凤仪,2019-05-03 17:01:20,2,6,4,给分差
107323,4608,刘凤仪,2019-05-03 17:01:06,7,7,0,别问，问就女神
107337,4608,刘凤仪,2019-05-04 04:16:33,9,10,1,职规课的收获很大，完全不水的，只是事情可能稍微有点多，但老师从来不收课堂作业这还不好吗？而且老师会请有资历的hr或者想关人员来做专题讲座，收获真的很大。然后小组打分也不鹅颈，组内关系很好。
107413,4608,刘凤仪,2019-05-05 03:09:47,0,2,2,职规课上的很棒啊，收获很大
108930,4608,刘凤仪,2019-06-04 10:20:16,-22,6,28,反正老子4.5
118611,4608,刘凤仪,2019-10-29 11:23:04,11,11,0,令人窒息。老师有一种诡异的圣洁感，听她讲课寒毛都要竖起来了。
119002,4608,刘凤仪,2019-11-09 06:32:23,5,6,1,不太好 感觉鹅颈严重
121003,4608,刘凤仪,2020-01-19 08:27:28,1,1,0,老师很美！！气质女神
122679,4608,刘凤仪,2020-03-17 08:27:12,3,4,1,职规课如果不想人物访谈（找有三年工作经验的人访谈）和各种感觉有点麻烦的事还是别选刘凤仪老师，虽然人挺好的
162545,4608,刘凤仪,2022-11-25 03:48:26,-2,1,3,good
162551,4608,刘凤仪,2022-11-25 06:29:27,0,1,1,职规成绩刚出来，高得简直超乎想象！\n\n老师真的是讲课超好，给分很高\n\n课上满满干货，授课赏心悦目\n\n人美心善，温柔耐心
162763,4608,刘凤仪,2022-12-06 02:39:35,5,6,1,给分一般
163432,4608,刘凤仪,2022-12-14 09:31:49,5,5,0,给分差的要死
163778,4608,刘凤仪,2022-12-16 05:47:16,-4,1,5,满绩耶
164089,4608,刘凤仪,2022-12-18 02:45:18,1,1,0,美女老师！！！！！！！不知道吐槽她讲课的同学怎么想的本来就是来上课的老师也准备了很丰富的课程相关内容也在认真引导同学们，你想水课就自己在下面水也不要怪老师在上面讲课打扰你水课吧。采访+简历+小组展示+职业生涯规划书，任务量的确不算小，但每样都认真完成给分也不会很差。
166534,4608,刘凤仪,2023-01-12 16:05:30,2,2,0,事稍微有点多，不过职规事普遍较多，上课不容易水，给分可以接受
170731,4608,刘凤仪,2023-03-09 01:31:37,3,3,0,所以任务都完成了但是喜提最低分
172638,4608,刘凤仪,2023-05-03 02:47:52,0,0,0,虽然我职规课全程都在水没怎么听过课，但是刘老师真的分享了很多很有用的东西，也对我的感触很大，最后好好写大作业也可以得到很好的分，不需要卷发言什么的，就是很舒服！
192856,4608,刘凤仪,2024-05-31 05:00:40,5,5,0,人美事多给分拉
198924,4608,刘凤仪,2024-09-13 02:42:16,3,3,0,垃圾老师，事超tm多，分低的要死
201334,4608,刘凤仪,2024-11-01 01:03:49,-1,1,2,事情很多
201982,4608,刘凤仪,2024-11-08 02:46:51,-2,0,2,一堆b事，能上的下去的也是神人了
212613,4608,刘凤仪,2025-01-14 09:25:53,0,0,0,老师人挺好的！思政课卷一下给分也还不错
213120,4608,刘凤仪,2025-01-16 04:45:46,0,0,0,思政\n\n点名的话，分小组坐的，一眼就看到谁没来了。\n\n上课事挺多的，每节课每个小组都要出一个人来讲一两分钟，建议讲一次，有记录的，可能会作为加分项。\n\n其他的读书报告、小组作业基本上都是水水过去的，大头在期末。\n\n期末一定要写到最后一秒，全屋只剩一个人了也要写到最后一秒，把能抄的都抄上去！最后成绩不会很难看的。
75674,4641,彭红云,2018-03-15 04:11:23,-2,1,3,彭老师的棒棒课，快去上
99652,4641,彭红云,2019-01-25 04:31:14,-3,1,4,傻逼课 课水给分乱给 考试监考没原则
139823,4641,彭红云,2021-07-29 02:36:50,-2,1,3,老师很关心学生，很好说话
139848,4641,彭红云,2021-08-01 14:53:16,-2,1,3,傻逼课 课水给分乱给
187381,4641,彭红云,2024-01-15 19:26:09,-1,1,2,老师超级和蔼的，上课也很有意思，越活越年轻了
73507,4685,陶虹向,2018-02-02 00:00:45,35,35,0,并不想评论
75752,4685,陶虹向,2018-03-16 07:17:05,58,64,6,傻逼啊，不解释
75915,4685,陶虹向,2018-03-21 15:55:43,23,26,3,emmm
75916,4685,陶虹向,2018-03-21 15:56:02,45,50,5,渣渣渣
77292,4685,陶虹向,2018-05-04 11:36:35,79,81,2,反正是个说的比做的多的辅导员，来浙大后不想在多看一眼的人！
78696,4685,陶虹向,2018-05-14 14:06:58,64,70,6,呵呵，这样的人到底是怎样混进浙大当辅导员的。摊上这么个辅导员真的是。。反胃。。。
78955,4685,陶虹向,2018-05-17 13:32:44,161,178,17,我去，这个老师真的是垃圾好吧……怎么说呢，只知道在群里跟男生眉来眼去，说话又尖酸又刻薄。说真的，不是人身攻击，我之前觉得她只是太张扬放荡了，人应该挺好的。后来真是瞎了眼了，只知道说大话（声音又尖又大），天天说什么浙大人的素质，那么请问你的素质呢？真不明白这种人凭什么当浙大的辅导员，哪哪儿都像是个骂街泼妇……以为自己是个辅导员了不起啊，八成都是凭关系进来的……看见大家在这里的评论都这么一致我就放心了，并不是我自己脑子有问题……最后，祝愿她早日被辞退，谢谢！
79023,4685,陶虹向,2019-05-10 15:52:24,-246,27,273,评论太过了吧 其实陶姐人挺好的啊 有时候也会发福利 经常加班也很辛苦 也比较关心同学的 你们这样发她会很伤心的
79597,4685,陶虹向,2018-06-11 05:52:00,22,25,3,
80196,4685,陶虹向,2018-06-21 10:09:18,82,89,7,真的，这老师做事情不带脑子。
80542,4685,陶虹向,2018-06-27 15:20:55,91,96,5,这个老师呵呵了，搞些花的东西不做实事。和她聊一次恶心一整年！呕
85856,4685,陶虹向,2018-08-23 06:23:37,94,101,7,呵呵，赞同楼上聊一次恶心一整年的说法。今年从丹青调走了，又去huo hai云峰的小同学去了。。
86036,4685,陶虹向,2018-08-28 08:40:31,35,39,4,相由心生，一看就是傻逼
86051,4685,陶虹向,2018-09-07 14:03:05,291,324,33,给分厚道徐小洲 制度合理林建华 尊重学生孙大雁 亲切友善祝秀香 从不绩杀陈昆福 分多事少陈素珊 知识广博看沈燎 讲话生动吴朝晖 声音洪亮陶虹向
86105,4685,陶虹向,2018-09-07 10:30:25,29,32,3,呵呵呵
86106,4685,陶虹向,2018-09-07 10:33:23,23,26,3,不解释
86107,4685,陶虹向,2018-09-07 10:42:52,309,338,29,拿着接到全体育场音箱的话筒说“你们的声音还没我大”
86108,4685,陶虹向,2018-09-07 10:43:22,37,43,6,这老师是个zz
86109,4685,陶虹向,2018-09-07 10:43:30,28,33,5,智障一个
86110,4685,陶虹向,2018-09-07 10:43:42,51,52,1,声音好大（扩音器加持）
86111,4685,陶虹向,2018-09-07 10:45:00,16,17,1,emmmmmm
86112,4685,陶虹向,2018-09-07 10:45:44,84,89,5,从不爆粗口的我只想骂她傻逼，完全没有脑子，不要脸，丹青受够了，为啥来祸害我们云峰？就他妈的是个泼妇，只会骂街！人品极差，快滚走
86113,4685,陶虹向,2018-09-07 10:49:12,116,125,9,拿着超大扩音器对我们喊：我一个人都比你们声音大……无语
86115,4685,陶虹向,2018-09-07 11:33:59,27,30,3,辣鸡玩意
86119,4685,陶虹向,2018-09-07 12:40:58,21,22,1,令人窒息
86120,4685,陶虹向,2018-09-07 12:43:25,17,18,1,不解释
86121,4685,陶虹向,2018-09-07 12:44:58,27,28,1,“浙大人的素质”
86122,4685,陶虹向,2018-09-07 12:46:15,51,52,1,真的没有比1分更低的选项了吗？？？？
86123,4685,陶虹向,2018-09-07 12:48:37,18,22,4,嘴这么甜，抹了蜜吗
86124,4685,陶虹向,2018-09-07 13:05:08,20,23,3,傻逼一个
86125,4685,陶虹向,2018-09-07 12:57:20,56,59,3,尖叫的母鸡
86126,4685,陶虹向,2018-09-07 13:00:40,14,15,1,贼烦\n\n
86127,4685,陶虹向,2018-09-07 13:02:54,40,42,2,评论一点都不过，我们也很好的，但时不时要淋个憋屈雨，一直军训训练也很辛苦的！她这样站着说话不腰疼我们不伤心吗
86131,4685,陶虹向,2018-09-07 13:31:07,15,15,0,真牛逼
86132,4685,陶虹向,2019-05-31 06:37:56,61,63,2,旁边的队列都在练习，你们很牛逼吗，难道不害臊吗？这就是一个大学辅导员的说话水平，可以的。
86133,4685,陶虹向,2018-09-07 13:36:44,57,62,5,mdzz，沙雕power都要栈溢出了，素质感人不解释，我是云峰打拳被逮上去的那个，小小两个中指不成敬意，尖刺只是她掩饰内心懦弱的伪装。
86134,4685,陶虹向,2018-09-07 13:43:18,17,18,1,弱智不解释
86135,4685,陶虹向,2018-09-07 13:44:39,21,22,1,这种没人性只知道大喇叭吼的辅导员怎么待下去的
86136,4685,陶虹向,2018-09-08 05:07:16,24,27,3,恶心死了
86137,4685,陶虹向,2018-09-07 13:53:41,24,26,2,为人师表，素质何在？
86138,4685,陶虹向,2018-09-07 13:58:19,22,24,2,傻逼一个，请她永远不要理会谣言和中伤（Never Mind the Scandal and Libel）
86139,4685,陶虹向,2018-09-07 14:19:23,54,58,4,在那么多人面前把女生拽过去训话   真tm素质感人
86141,4685,陶虹向,2018-09-08 00:11:39,41,44,3,2018年9月7号及以后的评论确实是真的\n\n操场扩音器声音确实够大，再加上您那尖叫般的嗓音，当然比学生声音大\n\n
86148,4685,陶虹向,2018-09-08 06:35:45,13,14,1,没饭吃
86152,4685,陶虹向,2018-09-08 10:36:11,16,18,2,垃圾，千万别上她的课
86168,4685,陶虹向,2018-09-09 12:33:37,17,20,3,无fuck说
86169,4685,陶虹向,2018-09-09 12:46:51,17,19,2,感觉是教小学生的，完全不尊重学生
86173,4685,陶虹向,2018-09-10 01:53:36,16,17,1,废话真多，站着说话不腰疼。
86177,4685,陶虹向,2018-09-10 02:42:22,28,33,5,呵呵呵 \n\n拿着话筒比全操场的声音都响真的很辛苦\n\n下着雨叫大家好好训练\n\n感动N❤️M❤️S❤️L❤️
86191,4685,陶虹向,2018-09-10 07:03:50,29,33,4,教官很辛苦的，一直在爬    那你不能先让他们起来吗
86203,4685,陶虹向,2018-09-10 12:54:10,11,14,3,吃了屎的傻屄
86204,4685,陶虹向,2018-09-10 12:57:06,6,10,4,恶～～～
86205,4685,陶虹向,2018-09-10 13:24:20,25,26,1,这样的神仙美貌是真实的吗?到了亲眼看到也无法相信的程度！今天的智障脑袋也认真营业了呢。
86206,4685,陶虹向,2018-09-10 12:58:27,15,16,1,神经病，不配为人师表
86207,4685,陶虹向,2018-09-10 13:08:08,23,26,3,我也觉得这逼就一个沙比，不过大家还是脏话少说吧？我们浙大学子还是有素质的吧。
86208,4685,陶虹向,2018-09-10 13:11:37,91,99,8,现在骂陶虹向傻逼还有人顶吗？
86209,4685,陶虹向,2018-09-10 13:15:03,14,16,2,不多说了 和大家一样
86210,4685,陶虹向,2018-09-10 13:16:16,15,18,3,来自军体拳同学们的怨念。\n\n
86211,4685,陶虹向,2018-09-10 13:18:54,16,18,2,“打的好不好，你们没点逼数吗？”她说的。emmmm
86214,4685,陶虹向,2018-09-10 13:46:39,79,82,3,这老师纯粹一个傻逼，理由如下：\n\n1.军训期间没有做过任何有益于团的事，她做出的所有决策都是有害无益的（她几乎没出过力，还老是破坏团结，如果没有她的煽动，我们根本不会如此不满意，她身边的男指导一直在给她才屁股，安慰我们，看着很可怜\n\n2.她嗓门大，还特别傲，没本事“你们这么多人还没我一个人声音大”（拿着扩音器以为自己是什么东西啊\n\n3.不尊重教官，先不说我们一直在做，她闲的不行，对于教官她也吼，还让教官10秒内集结完毕，自己什么都不做，却对趴在地上的教官指手画脚\n\n真心希望这东西（不配称为老师）能离开浙大，不要害了下一代，她不尊重教官，对自己没有认识，老是激怒学生，给同事添麻烦\n\n就单纯觉得这种东西恶心，像疯狗一样，祝早日离开浙大\n\n
86223,4685,陶虹向,2018-09-10 22:34:05,12,15,3,你拽个ball ball？？？？？？？
86227,4685,陶虹向,2018-09-11 03:25:28,135,138,3,\n\n陶姐怎么了 陶姐人多好啊\n\n拿着喇叭比全团声音都大\n\n态度和蔼让教官趴下\n\n人不漂亮满口脏话\n\n这么优秀的辅导员 \n\n没做点孽你能得到么
86231,4685,陶虹向,2018-09-11 05:42:52,5,10,5,不好得很
86233,4685,陶虹向,2018-09-11 06:40:21,7,10,3,哈哈哈哈哈哈哈
86261,4685,陶虹向,2018-09-11 14:26:09,7,11,4,呵呵呵……
86264,4685,陶虹向,2018-09-11 14:28:26,13,14,1,什么体验？体验极差
86276,4685,陶虹向,2018-09-12 00:51:23,12,15,3,尖酸刻薄妇人心
86277,4685,陶虹向,2018-09-12 01:41:15,14,17,3,继拿着话筒说“你们声音还没我响”之后第二天，应该除了她附近的人再没听到她没拿话筒说“你们声音还没我响”
86294,4685,陶虹向,2018-09-12 11:18:30,13,17,4,从她的身上找到了和世界一流大学的差距
86493,4685,陶虹向,2018-09-17 01:28:15,36,38,2,这个老师是不是傻逼我靠，第一次见她还以为是个很好的老师。真的没想到这么倒霉碰上这种辅导员，一点情理也不讲，对女生格外的凶，类似于笑面虎吧。特别特别特别讨厌！！！！大学里最厌恶的老师没有之一！可能是意识到查老师里被骂，让我们不要相信学长组的话用什么乱七八糟的软件比如查老师。真的是呵呵了，希望更多的人给他打分，刷新老师最低分?
86825,4685,陶虹向,2018-09-19 03:02:08,8,12,4,莫名其妙自作主张.发号施令从不含糊.
87169,4685,陶虹向,2018-09-21 07:26:05,9,12,3,刻薄尖酸，垃圾老师
87173,4685,陶虹向,2018-09-21 08:03:12,7,10,3,不想多说
87176,4685,陶虹向,2018-09-21 08:15:37,7,10,3,mdzz
87179,4685,陶虹向,2018-09-21 09:36:11,20,22,2,千万别去周三的心理辅导\n\n因为周三的心理咨询员。。\n\n\n\n\n\n\n\n\n\n没错就是她
87336,4685,陶虹向,2018-09-27 06:06:57,29,30,1,非常不尊重学生，作为经困生，自尊心总是不重要的。
87370,4685,陶虹向,2018-09-27 13:30:59,18,19,1,忍住不像她一样骂人。。我只能说。。。没有比一分更低的分数吗？
89270,4685,陶虹向,2018-11-18 01:55:15,2,5,3,(;｀O´)o
90028,4685,陶虹向,2018-11-21 23:58:11,10,12,2,垃圾。
90159,4685,陶虹向,2018-11-22 09:12:17,9,12,3,mdzz
90920,4685,陶虹向,2018-11-27 12:02:42,20,23,3,带学长查女寝，还不提前通知，真是一个超棒的老师呢给1分都觉得便宜了
91168,4685,陶虹向,2018-12-02 14:08:18,4,8,4,不予评论\n\n
92230,4685,陶虹向,2018-12-27 06:59:13,12,16,4,谁接触谁知道！！！！快离开云峰吧
92436,4685,陶虹向,2018-12-28 14:39:05,3,7,4,老女人
92881,4685,陶虹向,2019-01-05 09:29:57,9,10,1,三个字
93753,4685,陶虹向,2019-01-13 06:56:48,3,8,5,mdzz
104464,4685,陶虹向,2019-03-21 03:56:28,5,7,2,………………
104512,4685,陶虹向,2019-03-22 05:56:02,0,4,4,...
104558,4685,陶虹向,2019-03-23 14:40:24,21,23,2,整个普化全挂在应农，md应生不学怎么挂啊？\n\n你怎么不说整个工图都挂在应生了？\n\n是不是该给你配个小秘书，让你说逼话之前动动脑子？
104559,4685,陶虹向,2019-03-27 12:28:23,8,10,2,jj\n\n
104772,4685,陶虹向,2019-03-27 12:37:32,8,11,3,大傻逼
104889,4685,陶虹向,2019-05-13 14:35:44,45,49,4,这种淫荡泼妇傻逼辅导员一分都不想给，在丹青活不下去，来云峰祸害小朋友，态度傲慢，丝毫没有辅导员应该有的素质。什么事情都只会推给别人去做，嘴上说的好听，实际什么事情都不干。委托学生做事情，永远都不称呼一下同学的名字，也不是请求的语气，永远是命令的口气，态度极其傲慢，打生下来没见过这么没素质的。是从小缺钙，长大缺爱，姥姥不疼，舅舅不爱。左脸欠抽，右脸欠踹。驴见驴踢，猪见猪踩么？你说话时张牙舞爪，走路时手舞足蹈，你个没人要的货，你自己什么样难道心里没个B数吗？长得挺有创意，活得挺有勇气，丑不是你的本意，是上帝在发脾气。\n\n
105312,4685,陶虹向,2019-04-10 01:48:52,11,15,4,。恶心到我了。让学生做事从来不问学生意见。责任都是学生的，你一点错也没有。见人说人话见鬼说鬼话功夫一流。
105379,4685,陶虹向,2019-04-11 04:18:41,5,8,3,呵呵呵呵呵呵呵呵
105576,4685,陶虹向,2019-04-17 01:08:30,11,13,2,尖叫鸡
106583,4685,陶虹向,2019-04-28 07:56:37,6,7,1,...\n\n\n\n
106598,4685,陶虹向,2019-04-28 09:26:53,13,18,5,鸡你太美
107280,4685,陶虹向,2019-05-03 02:46:49,16,18,2,这个辅导员是zz\n\n\n\n
107601,4685,陶虹向,2019-05-07 12:16:22,15,19,4,在丹青的时候群里好多同学觉得她很好。。。我还以为只有我一个人不喜欢她。。。
108387,4685,陶虹向,2019-05-22 12:05:37,14,17,3,这逼祸害完丹青去祸害云峰了？还记得大一行测给了所有行测班级的最低平均分
108715,4685,陶虹向,2019-05-31 16:23:20,19,21,2,我这辈子应该没有遇到过也不会再遇到这么恶心的老师了吧...为了自己的政治利益不惜牺牲学生是什么鬼啊？我问号问号。真的佛了。怎么会有这种傻逼老师？真的为了光明正大的拿我的劳动成果还带强迫我的？还有我答辩处处针对我是什么意思啊？还带人身攻击的我真的很服气。反正在云峰也就半年了，熬一熬就过去了，下一届学弟学妹加油吧...辣鸡老师！辣鸡查老师没有负分！（原谅我第一次骂查老师）
108723,4685,陶虹向,2019-06-01 00:29:03,21,27,6,这个老师是真的恶心到我了，我一篇思想汇报让我前前后后改了五六遍是什么东西?倒了八辈子大霉我的入党联系人是她。真傻逼不解释。而且军训的时候根本不把学生当人看，让学生淋雨走队列。有的同学本来就感冒了淋了雨就发烧发到39度!真的变态老师
108734,4685,陶虹向,2019-06-01 04:57:40,15,18,3,路上都不想碰见，真的恶心
109069,4685,陶虹向,2019-06-07 04:53:59,-55,9,64,好老师 受益匪浅
109958,4685,陶虹向,2019-06-20 13:30:02,8,16,8,哪位说陶傻逼好的是本人吗，还人好，发什么福利，我们一群人怎么就没享受到？她关心同学个屁，为应付工作找同学谈话，可怜同学还要听她bb自己的“光辉历史”，特别是说“去年在浙大找到了归属感，哦对了我去年在这里买了套房”，黑人问号？？？你买房关同学什么事。别的老师做不完工作也加班啊，自己工作能力不够所以花更多时间有什么好心疼了？？据说创青春的时候作为队长，啥也不干，真是好老师啊！谁跟她接触一次就能被恶心一整年
112646,4685,陶虹向,2019-07-04 23:31:33,19,22,3,卧槽，来浙大两年了，大一也是她的辅导员，真是不想多看见她一眼，今天才知道查老师上有她，这货居然也算老师？？？？
114067,4685,陶虹向,2019-07-08 16:23:22,12,16,4,业务能力极差，一问三不知，总爱站在圣母视角讲话，经常干一些形式大于内容的屁事
114697,4685,陶虹向,2019-07-11 04:11:56,12,15,3,业务能力不是一般的差好吧，自己想一套是一套结果又和上面的要求不一样，各种东西只能再改来改去，倒霉的还是学生，呵呵了
115075,4685,陶虹向,2019-07-15 07:09:25,4,9,5,臭sb
115912,4685,陶虹向,2019-08-25 15:37:53,10,11,1,军训不要！不要！不要摊上她！
117068,4685,陶虹向,2019-09-19 02:15:53,3,6,3,ljs
117103,4685,陶虹向,2019-09-19 07:13:58,5,9,4,呵呵，sb
117577,4685,陶虹向,2019-09-26 07:14:54,1,4,3,辣鸡。
117666,4685,陶虹向,2019-09-28 07:23:47,1,4,3,1分zsbd
118050,4685,陶虹向,2019-10-19 12:29:18,9,11,2,怎么没有零分？我呵呵
118193,4685,陶虹向,2019-10-22 13:39:38,18,21,3,选完专业后开会的时候说：你们没人退学吗？
122201,4685,陶虹向,2020-02-20 02:51:19,4,9,5,真的是一个非常恶心的老师了
123258,4685,陶虹向,2020-05-26 06:55:12,12,16,4,从“给分厚道徐小洲 制度合理林建华 尊重学生孙大雁 亲切友善祝秀香 从不绩杀陈昆福 分多事少陈素珊 知识广博看沈燎 讲话生动吴朝晖 声音洪亮陶虹向”前来观光
123677,4685,陶虹向,2020-06-11 10:16:05,-21,4,25,好啊，挺好的
123919,4685,陶虹向,2020-06-16 08:10:55,6,12,6,职规学在浙大原始分94.4，精准卡绩。
124522,4685,陶虹向,2020-07-02 09:21:33,-26,6,32,职规满了
124667,4685,陶虹向,2020-07-05 14:31:55,14,17,3,不知道之前在云峰怎么样，反正现在来物理系也是把事情搞的一团糟，实在受不了，无效信息各种转发，实际业务各种拖延瞎搞
124937,4685,陶虹向,2020-07-22 11:31:35,16,18,2,眼神不太好，脑子不太行
124938,4685,陶虹向,2020-07-22 11:53:40,31,34,3,见过的最差辅导员\n\n整天在群里发各种无关广告，经同学提醒死不悔改\n\n做事极其不靠谱，问她问题不懂就乱讲，各种乱通知，问通知细节一律不清楚，也不知道去查证，找她办事假装没看到消息\n\n6月中旬返校如果同学没有提问就直接没通知，导致外地学生买票困难；6月底学校没有设立返校批次她一直到26号还通知28号有返校批次，发的问卷调查还显示月底返校选项，混乱通知导致毕业生错过毕业典礼。7月初通知同学没提问就没告知外省返校需要核酸检测，还一会说校医院可以检测一会说不可以，同学去问细节就非要同学当地三甲医院检测，连校医院值班台回复都比她态度好还靠谱\n\n对学生态度极差，发十几条语音，态度还不如学工部等等校级部门；跟同学老师各种打官腔，推卸责任，拒绝做事\n\n天天催学生就业，逼迫学生签约找工作，打击考研学生自信\n\n找她办事回复莫名奇妙，牛头不对马嘴，仿佛甚至没有理解办事内容，帮忙填个表填错将近一半\n\n令人烦恼的是学校有些事情又非要通过辅导员办，不能绕过她，物理系的朋友们自求多福吧\n\n让人不禁好奇浙大是怎么招的辅导员，这个老师的素质和能力严重不匹配其职务，八成靠背景的吧
124939,4685,陶虹向,2020-07-22 13:46:28,18,20,2,我每天可是很忙的哦，只在白天回答问题，有很多同学都来问我问题，所以回复你就不错了哦，那么你有什么问题呢？\n\n噢噢，你说昨天白天有问过我呀，我昨天去出差了，老师太忙了，要管足足一届毕业生呢。\n\n什么，你竟然问我什么时候领双证，这个我怎么知道，你要去问x老师，懂吗？\n\n以后不要再来问我这种傻x问题，老师的时间很宝贵哒！
125197,4685,陶虹向,2020-09-03 11:48:57,-28,4,32,不是挺好的嘛？\n\n
125859,4685,陶虹向,2020-09-15 03:20:36,11,13,2,恶心啊
126590,4685,陶虹向,2020-10-05 03:47:39,13,19,6,问的所有事情都是随便的给出一个错误的答案，办事效率为0，其他老师一分钟做好的事情他永远都办不好，物理系想要振兴，第一步就是把这样无作为，帮倒忙的辅导员换掉
126634,4685,陶虹向,2020-10-10 00:00:24,14,18,4,物理系的败类，行政老师中的老鼠屎
126831,4685,陶虹向,2020-10-22 09:41:23,4,7,3,其实在系办算能做事的那一批，可惜是个**\n\n“当时我给师兄一直打了很多电话都没用，最后我冲进他们实验室终于把他拉走了”\n\n自她开的第一个会，我就知道这剩下几年没好日子过了
126838,4685,陶虹向,2020-10-22 14:28:24,12,15,3,这种老师 整天说自己工作忙 学生工作做得有多差劲 系里的同学都知道 你是个辅导员 扪心想一下 称职不称职
126840,4685,陶虹向,2020-10-23 00:13:00,11,16,5,对学生态度极差，提一些建议只会装可怜找借口，完全不采纳hhh学生都是她的工具人，免费劳动力
126859,4685,陶虹向,2020-10-25 08:12:16,1,6,5,无语得很
126874,4685,陶虹向,2020-10-30 00:06:26,6,11,5,浙大还有这种败类，那么浙大永远成为不了一流大学！
126947,4685,陶虹向,2020-10-29 06:48:06,4,7,3,沙比玩意
127132,4685,陶虹向,2020-11-09 13:08:40,7,11,4,自我感觉相当良好
127463,4685,陶虹向,2020-11-23 08:19:11,4,9,5,臭傻逼 卡绩点
127464,4685,陶虹向,2020-11-23 08:40:20,5,6,1,三个字？
127466,4685,陶虹向,2020-11-23 08:47:30,-16,9,25,总的来说上这门课还是能学到点东西的，老师也没有前几年所评论的那么不堪（反正至少职规课上还是挺正常的），虽然可能自身水平确实有限。\n\n绩点的话，只能说需要特别特别用心才能拿高吧，想水过去的同学（比如我）只能耗子尾汁～
127472,4685,陶虹向,2020-11-23 10:38:10,-28,5,33,上课很有收获，分数也很好
127473,4685,陶虹向,2020-11-23 10:43:09,5,11,6,给分极低，本人自认为较认真得完成了冗杂的作业，结果被绩杀了。上课也毫无收获，没有内容，实在是她水平有限了把。据说PPT也是好几年前的，懒得很，不知道怎么当上老师的。呵呵呵，傻逼老师
127474,4685,陶虹向,2020-11-23 10:48:50,3,7,4,为什么没有0分？赶紧滚出浙大吧
127477,4685,陶虹向,2020-11-23 10:57:10,-33,13,46,怎么说呢，因为没有陶老师当辅导员的经历，不知道老师当辅导员到底是怎么样的。但是上职业规划课A真的挺快乐的，感觉老师也很有亲和力也很好（感觉跟高赞评论差的蛮大的），认识了很多小伙伴，上课也快乐的跟同组的人闲聊，作业认真写，大作业展示搞得好一点，绩点应该不低，纪念一下我上大一第一门结课就满绩的课
127496,4685,陶虹向,2020-11-23 14:54:14,1,6,5,卡绩点，。。。。。。
127547,4685,陶虹向,2020-11-24 07:25:45,2,6,4,不仅卡绩 而且 给分很差 作业超多 绩杀
127583,4685,陶虹向,2020-11-25 03:01:03,6,10,4,把刚及格的同学挂掉，这种操作，她把学生当人了吗？
128047,4685,陶虹向,2020-12-04 11:08:29,2,5,3,老师绩杀
128063,4685,陶虹向,2020-12-05 11:49:24,15,17,2,千万别选她的职规课，学不到什么东西，而且给分相当差，来自认认真真写作业、辛辛苦苦一学期却还是低分的同学的忠告！！！
128741,4685,陶虹向,2020-12-25 06:24:54,3,8,5,千万别选她的思修课！水平实在太低，而且三观不正
128748,4685,陶虹向,2020-12-25 06:44:16,-1,3,4,垃圾，卡绩
129433,4685,陶虹向,2021-01-05 09:16:13,9,12,3,永不认错陶虹向
129488,4685,陶虹向,2021-01-06 07:32:17,16,20,4,物理系的老鼠屎，什么时候滚出物理系，什么时候滚出浙大？
129883,4685,陶虹向,2021-01-13 07:23:51,10,14,4,结论：男人 窗口 白纸jpg．\n\n\n\n原因：\n\n1、课水：有些内容像是在教人投机取巧，对于一些职场现状没有深刻剖析\n\n2.事多:一个小组大作业（卷翻天）、一份3000字职业生涯规划书、每周的若干小作文\n\n3.强制互评而且yygq\n\n\n\n评分现在还没出，已经做好被jisha准备
129884,4685,陶虹向,2021-01-13 07:26:19,2,6,4,鼓励鹅颈这就很离谱了吧
130068,4685,陶虹向,2021-01-16 09:08:25,10,12,2,服了 怎么能如此当不好辅导员\n\n说要大家看通知，然后自己又说得和通知不一样，搞得大家都在疑问。发言啥的说清楚呗！
130354,4685,陶虹向,2021-01-21 09:17:51,5,8,3,懂的人都懂\n\n着实ex
130928,4685,陶虹向,2021-01-25 09:06:45,13,16,3,给一分的原因是因为没有零分，快滚吧别祸害物理系
131908,4685,陶虹向,2021-01-29 09:51:39,7,11,4,爬
131930,4685,陶虹向,2021-01-29 10:23:11,-11,4,15,上课很水但是给分不错
131938,4685,陶虹向,2021-01-29 11:09:30,7,10,3,上课没有水平，偶尔会说几句三观不正的话而不自知
132962,4685,陶虹向,2021-02-05 13:36:49,-11,12,23,陶老师给了我满绩，人也蛮好的呀
133079,4685,陶虹向,2021-02-07 14:02:02,10,13,3,垃圾中的战斗机，丢物理系的脸
133272,4685,陶虹向,2021-02-23 02:35:01,14,19,5,还是想说，希望物理系能把她换掉，别祸害学生了。。。
133640,4685,陶虹向,2021-03-03 05:30:49,-20,17,37,看老师评分这么低我还挺震惊，毕竟她上课蛮好哇。不晓得陶虹向做辅导员的事，但就事论事，她上课真的蛮用心，脾气也很好啊没发过火，一直都是笑眯眯的，而且还会请学长、阿里的HR来讲话，我觉得还蛮有收获的。职规事情确实不少，每节课都要组内讨论+发言，几乎每次课都有作业，但只要认真做分数不会差的。简历、职业规划书和最后展示认真做，分数基本4+。我组内不太爱发言的，但每次作业都认真写，组内终展也花很多时间，就是满绩了。好多都不选她的课，觉得好可惜哇。上课真的不错，给分也很好啊！不要只看查老师，害。
134316,4685,陶虹向,2021-03-23 10:54:01,0,5,5,我佛了，不要选她
134432,4685,陶虹向,2021-03-28 10:03:55,3,6,3,无语子
134820,4685,陶虹向,2021-04-16 12:26:19,-16,5,21,评分方式在期末快结束的时候改动并通知？！！！这是什么奇葩老师，导致自以为能卷满绩的我最后得了3.9\n\n提前期末作业的ddl？？在最后三天的时候突然说要交？？！！！
135091,4685,陶虹向,2021-04-30 05:03:09,-8,5,13,客观评价，我选这个课就是只想上创新创业类课程，给学弟学妹分享一下我的看法吧，首先，老师会说确实成绩要按照正态分布，所以大家的竞争对手实际上也只是自己，平常作业好好完成，也不要盲目的卷，最好是形式上有新意，签到和慕课我也没啥说的，小组大作业我们组比起别的组感觉比较逊，职业生涯规划书认认真真写，最后成绩其实也没有那么差（我是做好被绩杀的准备的，毕竟小组展示的成绩真的不太好）
135585,4685,陶虹向,2021-05-15 13:55:28,17,20,3,滚出浙大
135822,4685,陶虹向,2021-05-28 00:13:38,-35,5,40,守护最好的陶老师
135864,4685,陶虹向,2021-05-30 10:18:58,15,19,4,哈哈哈哈她是我们物理系的辅导员，但在群里永远不发有用的通知，每次其他系的人都知道了的事我不知道
136176,4685,陶虹向,2021-06-12 02:14:02,-56,3,59,老师上课一般，事少分高，几乎全组满绩的选手飘过~
136442,4685,陶虹向,2021-06-18 03:02:22,12,13,1,人间败类
136867,4685,陶虹向,2021-06-26 15:33:31,3,5,2,111
136926,4685,陶虹向,2021-06-28 09:54:36,26,28,2,什么时候能把她调到别的院系啊，物理系的同学要受不了了
138201,4685,陶虹向,2021-07-08 02:08:06,20,22,2,留个校被她搞这么麻烦…还要过去给她当半天免费劳动力？\n\n是这样的，我在查老师里的发言一直都很礼貌，所以对于陶虹向这个非物质文化遗产，我没什么可以说的了。
139754,4685,陶虹向,2021-07-23 11:00:32,21,27,6,想问一下浙大的产假制度是怎么样的 她咋还没去放假 主要也不是觉得跟她讲话太累 就是怕她生孩子辛苦
139986,4685,陶虹向,2021-08-22 18:19:55,12,15,3,这个暑假是真的被这伞兵恶心坏了
140111,4685,陶虹向,2021-08-26 11:33:01,14,18,4,懂得都懂
140921,4685,陶虹向,2021-09-18 01:45:20,-32,3,35,其实挺好的
142019,4685,陶虹向,2021-11-04 04:43:51,10,15,5,干啥啥不行，甩锅第一名
150953,4685,陶虹向,2022-02-21 10:27:50,4,7,3,呵呵呵
152334,4685,陶虹向,2022-04-04 16:50:55,16,17,1,真的就是脑子有点问题的辅导员，也不听你的说法，直接拿权压人。我也不知道辅导员到底哪里来的权，不知道她哪里来的自信，呵呵。
152876,4685,陶虹向,2022-04-21 06:57:11,12,14,2,臭傻逼你妈死了
154044,4685,陶虹向,2022-05-20 06:16:20,18,21,3,希望她与这个世界和解！不知道她经历了什么，对待学生这么无礼！
154863,4685,陶虹向,2022-06-06 08:58:40,8,12,4,为什么还有1.14分
155516,4685,陶虹向,2022-06-14 01:45:03,7,11,4,扫墓来了
156036,4685,陶虹向,2022-06-17 07:44:44,7,10,3,就你这样的人也能做辅导员？
156326,4685,陶虹向,2022-06-19 05:39:01,11,13,2,人模狗样祸害众生
157188,4685,陶虹向,2022-06-23 07:04:14,9,12,3,老鼠屎，纯纯的脑残
157248,4685,陶虹向,2022-06-22 14:32:37,5,9,4,丁真珍珠先生代言，理塘特产珍珠，白皮黑心分文不值。
158945,4685,陶虹向,2022-07-03 16:43:55,9,14,5,我只能说名不虚传
159001,4685,陶虹向,2022-07-04 11:30:41,17,20,3,没法理解她这样对待学生，打击学生，评价学生一无是处，能不能有点良心！
159005,4685,陶虹向,2022-07-04 11:19:33,10,14,4,她喜欢打击学生的自信心，不知道她是不是通过这个来换取内心的快乐？希望她做个人吧，学生跟你没仇！
159161,4685,陶虹向,2022-07-07 07:40:35,7,11,4,一句呵呵
159233,4685,陶虹向,2022-07-08 19:12:20,16,21,5,表演型人格障碍、自恋型人格障碍
159604,4685,陶虹向,2022-08-22 02:33:56,4,6,2,ヘ(_ _ヘ)
171793,4685,陶虹向,2023-04-05 20:14:30,-35,4,39,天哪，看看这都是什么\n\nhttp://5156edu.com/page/20-02-21/166212.html\n\nhttp://5156edu.com/page/22-05-18/190615.html
178245,4685,陶虹向,2023-07-08 13:45:04,-27,5,32,哈哈\n\nhttps://img.xuesai.cn/uploadfile/20191125/273ab9ff02474c878660669e9c30f12d.pdf
182895,4685,陶虹向,2023-11-21 04:00:06,6,9,3,给分可，上课中规中矩
182896,4685,陶虹向,2023-11-21 04:02:06,4,8,4,老师上课其实很好的
182901,4685,陶虹向,2023-11-21 04:09:20,5,7,2,第一次给10，职规全班三分之一的人都满了，小组6个人五个人满了，陶姐你真的我哭死
182905,4685,陶虹向,2023-11-21 04:37:13,1,5,4,给分超好 前 30% 直接满
183263,4685,陶虹向,2023-11-23 08:51:54,4,7,3,给分很好，上课氛围很好
185250,4685,陶虹向,2023-12-27 09:46:35,6,13,7,如果你是想要选课的同学，请不用怀疑这位老师对学生的用心，她会尽全力让你得到你想要的分数。不要带着别人的恶意来揣测你未知的事情。
187489,4685,陶虹向,2024-01-16 10:46:39,1,8,7,事少分高
190031,4685,陶虹向,2024-02-11 04:11:46,-3,8,11,从“给分厚道徐小洲 制度合理林建华 尊重学生孙大雁 亲切友善祝秀香 从不绩杀陈昆福 分多事少陈素珊 知识广博看沈燎 讲话生动吴朝晖 声音洪亮陶虹向 十罪七策王章野”前来观光
190923,4685,陶虹向,2024-03-24 11:55:20,8,13,5,上了陶的职规，我得给她说句公道话，thx也就因为军训那次风评锐减，其实她职规课对我们挺好的，还专门请了优秀学姐来给我们讲秋招的事情。
191367,4685,陶虹向,2024-04-18 14:18:45,5,10,5,出分前评价\n\n老师上课很好，安排到位。\n\n讲解有料，且和大家说上90的比例全给95+。\n\n我觉得选课参考不止1.1分，单论课程安排8-10分是有的。
191722,4685,陶虹向,2024-04-29 04:03:11,3,9,6,职规有料，也体谅大家，有几节分享和电影之类可以在课上写作业。下课也比较早。\n\n群里公示97+一堆，89一堆，由于要适当拉开给了少数8788，给分可以说很好了。
191845,4685,陶虹向,2024-05-04 01:35:50,5,11,6,选职规的同学请看最新评论。\n\n陶姐课程安排不错，有很多干货，事情也不是太多。\n\n而且给分非常好！一片89，一片满绩！\n\n职规课值得一个十分！
191861,4685,陶虹向,2024-05-02 08:08:48,-1,6,7,老师给分真的很好，一个班基本上要么89要么97+，职规宝藏老师。\n\n人也很好，和之前评论描述的已经截然相反。
192039,4685,陶虹向,2024-05-08 05:57:22,-2,7,9,给分超级无敌爆炸好
192087,4685,陶虹向,2024-05-09 03:25:34,-6,7,13,给分无敌好！几乎人人4.5+！
193260,4685,陶虹向,2024-06-05 08:52:33,12,16,4,上了职规，还是想说就是一个比较傲慢的傻逼
196724,4685,陶虹向,2024-07-05 02:10:29,1,7,6,要选职规直接冲！给分好事少，老师人也很好很热情（评分低主要是因为军训）
197654,4685,陶虹向,2024-07-24 12:52:08,5,7,2,额，不建议参加该教师组织的实践活动，屁事很多，但是真有事情又不管
197840,4685,陶虹向,2024-08-15 14:07:34,5,6,1,0'XOR(if(now()=sysdate()，sleep(15)，0))XOR'Z
198194,4685,陶虹向,2024-09-04 09:34:39,9,9,0,社会实践看到这个老师赶紧跑！！！！！！！！！！！！！！！！！！！！！！！！！！！！！！！！！！！！！！！！！！！！！！！！！！！
199343,4685,陶虹向,2024-09-21 10:44:12,1,2,1,something 404
200519,4685,陶虹向,2024-10-18 05:40:56,-4,7,11,我不知道她曾经是个什么样的人，但是她的职规现在请放心选，事情不能说很少，但是正常，最后真的会有30%的人是满绩，性价比极高
202933,4685,陶虹向,2024-11-15 08:39:15,-6,5,11,陶老师太好了！！给分好性格好
208115,4685,陶虹向,2024-12-25 16:05:04,10,13,3,说话口无遮拦，刻板印象很重。不像个老师，说话声音太大太聒噪，听的耳朵难受。体验感很不好。
215086,4685,陶虹向,2025-02-21 00:14:10,-8,2,10,职规课很好，不要被评分吓到
216665,4685,陶虹向,2025-03-20 11:05:29,-7,2,9,老师挺可爱的
216734,4685,陶虹向,2025-03-23 11:17:00,6,9,3,逆天thx，听课就别想着学些什么了，作业是不好好看的活动是没意义的，不知所谓的东西。只能说想着实在受不了跟别人吐槽结果认识的这入的都是“交口称赞”，没赤过的可以选，一选一个不吭声。thx不是对学生变好了，只是看到评分觉得自己要炸了。那很有生活了，评分系统得了MVP，thx是躺赢狗
220520,4685,陶虹向,2025-06-23 08:34:46,3,5,2,陶老师不是个完美的老师，上课我也边干自己的事情边听听，但一学期下来从她的个人经历和生活哲学中我确实吸取到了一些值得学习的东西。作业都是课程组统一过的也不会占用太多时间，认真完成最后是可以拿个好分数的，总之推荐，可以放心选。
221395,4685,陶虹向,2025-06-23 08:01:55,1,1,0,两极分布
221440,4685,陶虹向,2025-06-23 12:56:07,2,2,0,职规期末会捞，捞到上一个分段，但是这是建立在平时作业给分差的基础上的，平时作业扣分严重；上课给人的感受并不好，需要忍受各种刻板印象各种或有争议或无意义的观点，尽管她尝试展现出“亲和”与“热情”的一面但时常让人感到违和。当初选择这门课也是冲着有人说虽然评分低但是给分好，但最终感受是给分不及预期而评分低确有其事
221457,4685,陶虹向,2025-06-24 00:26:12,0,2,2,职规全班总评菌剂4.563，作业不要全用AI总评至少能够拿到89分，老师上课还是很有热情的，单论职规这门课不敢说10分，至少9分是有的
83961,4810,朱小萤,2018-07-11 15:22:48,3,5,2,给分差，事情多的要死，每节课都有作业。而且很不体谅同学，他热了就一定要开空调，不管大家冷不冷。甚至端午节还要补课
115351,4810,朱小萤,2019-07-19 07:33:24,1,3,2,就一傻逼老师，白白让学生浪费时间，还蛮大的官架子气，有个毛用
123059,4810,朱小萤,2020-05-07 06:31:49,-4,1,5,（虽然不是本学院的学生），平心而论，感觉老师下午上课的时候有点迷糊，绿色化学讲的时候感觉化学底子一般般（个人感觉）。不必喷，提早下课还是很人性化的，作业虽然每周都有但是都很少。可能备课还有点欠缺吧……
195350,4810,朱小萤,2024-06-27 23:55:39,0,1,1,环境化学来讲座过一次，上过几节水污染，其实他讲课水平在环资这个地方也算不错了，没到怨声载道的地步……绿色化学没上过，据同学说事多分低，所以这块不评价。
217499,4810,朱小萤,2025-04-11 11:47:17,1,1,0,为什么没有0分，非常糟糕，对学生的事情非常敷衍不关心，工作安排不负责任，好大的官威
217526,4810,朱小萤,2025-04-12 09:09:30,1,1,0,差差差，很凶，做事安排很混乱，不把学生当回事
218014,4810,朱小萤,2025-04-19 07:14:41,0,0,0,大一认知实习的时候是老师在新加坡带队，印象比较模糊了。大三上环境化学的时候老师来代了一节课讲饮用水相关内容，之后也上了老师的绿色化学课程。感觉老师的讲课水平在环资学院里算是很好的了，上课节奏把握得很好，不是照本宣科一味读PPT，而是让人可以听进去知识、学到东西。而且感觉老师为人也比较有趣，比如会叫肯德基开封菜（因为课正好在周四），也会把学在浙大的期末章命名成期末大作战什么的；老师是从新加坡留学回来的平时也会分享一些留子小知识（？），比如日本米好吃但昂贵。而且上到12:25的课也会留给大家吃饭的时间。就这么几门课上下来其实对老师的观感挺好的，因为在环资会上课的老师真的很少啊，难得能听到真的能学到一些东西的课
124262,5078,官宝红,2020-06-28 06:43:30,-1,1,2,辐射防护蜜汁给分
185856,5078,官宝红,2024-01-05 03:16:22,0,0,0,辐射防护这门课极不适合非环资同学报！
216772,5078,官宝红,2025-03-24 14:49:42,4,4,0,不知道的还以为在上专业英语课🙃
218168,5078,官宝红,2025-04-22 00:52:35,1,1,0,谁选谁坐牢。会开火车叫人回答问题，问题包括不限于武侠小说，英语前缀。。。。考试有些题他发出来的ppt里没有，要去弄完整的ppt
97655,5081,卢玲丽,2019-01-22 12:45:16,2,6,4,老师简直是女神叭！！听卢老师的课超级享受内，而且是自然而然会吸引学生主动听课的那种（，平时对学生也超级超级好～很喜欢啦
101965,5081,卢玲丽,2019-01-30 01:31:22,0,2,2,上课好玩，温柔、美丽的小卢老师！！！给分也超好，大赞！！！
128859,5081,卢玲丽,2020-12-26 06:32:25,0,2,2,必须要给小卢老师刷到十分5555！老师是我在浙大遇到过最好的老师之一！讲课真的非常生动清楚，感觉即使没学过生物也能听得懂。会结合很多具体的例子以及自己身边的故事来讲课，让人不想水手机。也很为学生考虑，会照顾到我们其他课程的压力，作业等等都会商量我们的意见~这就是女神吧啊啊啊啊！选到小卢老师的课也太幸运啦！
133045,5081,卢玲丽,2021-02-07 03:56:03,0,1,1,老师太好了！水平高、讲课超有趣、布置作业会和大家商量，给分也巨好！选植物营养学！
94248,5097,杨武,2019-01-16 04:42:48,-1,8,9,老师自身水平很高，是青年千人计划的，科研大佬。教学认真负责，但是不怎么有耐心(因为这种三十出头就当了博士生导师的天才是不能明白我等凡人为什么连这种简单的问题都搞不懂的)考试方面，真的很善良，考试的时候很多很多提示，就差把答案告诉我们了…虽然颜值一般 普通话不标准，但是因为是天才所以还是很有人格魅力的！
94997,5097,杨武,2019-01-18 14:35:25,6,6,0,老师真的超级好鸭
102165,5097,杨武,2019-01-31 01:53:08,7,7,0,老师真的很好呀！无论是上课讲解知识点，还是课后回答同学的疑问，或者是考试时一次又一次耐心地给同学解释英文单词的意思（也是我们太菜许多单词都不认识哈哈）。\n\n虽然是一个短学期的课，但还是能学到不少东西的。环境经济学这门课要拿高分，课后还是要花一定时间去看课件的～
131491,5097,杨武,2021-01-27 17:06:19,1,2,1,老师很认真负责~很喜欢老师关于学习的一些观念。环经考试前会提示和讲重点，超爱这门课！
210330,5097,杨武,2025-01-09 02:31:28,2,2,0,很细心的老师，环境经济学考试客观题闭卷，主观题开卷，考的很简单，都是复习课上的内容。
143139,5203,张晶,2021-11-20 01:18:36,0,2,2,庙小阴风大，池浅王八多
220957,5684,马斌,2025-06-20 12:44:39,1,1,0,乱打分。。。
157134,5688,王娟,2022-06-22 04:19:15,6,10,4,只会念PPT，考试和上的课没半毛钱关系
175010,5688,王娟,2023-06-21 04:15:38,-1,0,1,shabichushengnimadile😅
195355,5688,王娟,2024-06-28 00:52:41,1,1,0,为人比较严肃端正，稍有点说教味。讲课会加入自己的解释，也不是仅仅念ppt。但这门课实在太容易犯困了我天，没给ppt前还能挣扎着每节课认真听记笔记，给了ppt以后上课就是犯困犯懒犯贱…最后的考试，实在没想到她会出克克方程，不是说不会和历年卷一样嘛啊啊啊啊，亏我背了那么久的大气扩散模型德意希和分级效率公式，还有那个脱硫和voc题出得我很沉默…（以上，还没出分但是先来评价）
184239,5874,王志彬,2023-12-13 17:34:46,0,0,0,就内样
195356,5874,王志彬,2024-06-28 00:56:28,1,1,0,口音和讲课风格很符合我对北京人的印象，上课废话不多说，偶尔讲个段子。以及他总是看起来比我们还不想上课😂
218592,5874,王志彬,2025-04-25 14:18:07,0,0,0,给环工环监和环科大气上课是同一份ppt。。。。。。。。
126326,6117,王宏全,2020-09-22 16:28:46,3,3,0,人超级nice！什么事情都为学生考虑！
181913,6256,罗忠奎,2023-11-05 02:51:33,1,3,2,大数据真的6
182067,6256,罗忠奎,2023-11-09 11:20:44,0,2,2,每堂课都会点名。老师本身很厉害，上的内容其实也是有意思的，可听可不听。
183084,6256,罗忠奎,2023-11-22 08:12:28,0,1,1,。。。
183112,6256,罗忠奎,2023-11-22 08:40:19,-1,0,1,罗老师讲课很有水平，实力很强，该打高分打高分，该打低分打低分，很负责的老师
183155,6256,罗忠奎,2023-11-22 12:19:45,1,3,2,还行，农生大数据就是小组展示，每节课都点名，你只要都到平时分不会少，不用上课卷着回答问题，反正也不考试（\n\n但是不好的一点就是只有最后的展示环节评分，而且对PPT评分，所以最后得分也不是很看你个人能力，一般般，不上不下
184396,6256,罗忠奎,2023-12-19 00:49:01,0,1,1,老师讲课可以，但最后检验的实际上是个人能力，如果一开始不懂大数据，到最后估计也还是不太懂大数据。pre鹅颈有点点严重，容易汗流浃背
201644,6256,罗忠奎,2024-11-05 06:08:06,-1,0,1,pre很考验能力，老师真的很好，在努力培养我们解决问题的能力
204062,6256,罗忠奎,2024-11-23 13:34:20,0,1,1,纸质点名。\n\n很真诚的老师。有点上世纪的思想。明确提倡学生阅读英文文献。\n\n上课完全可以不听。不过老师会很难过\n\n拿了4.2\n\n个人感觉给分挺好的，老师标准很明确，对着一群对大数据一无所知的人努力在捞分。\n\n有些小组会很卷。
204705,6256,罗忠奎,2024-11-27 12:03:15,1,1,0,前面的几节都是介绍，平时也没事，老师人也很好，而且经常活用大家不听课当例子，讲得挺有趣的。只有一个小组展示，老师们最后打分的时候挺犀利的，提问也很有水平。总体不错
206079,6256,罗忠奎,2024-12-13 04:57:51,1,1,0,老师人特别特别好 ，讲课很认真 要是不认真听课老师会难过，给分也很好
206456,6256,罗忠奎,2024-12-15 08:12:35,1,1,0,老师真的很好 上课是努力想让我们认真听 不听会难过的哦～～并且老师学术水平很高 三位老师都很好 第一节课还点名打招呼认识每一位同学很真诚 给分也很好 只有一个小组pre拿到啦满绩！！！
152947,6481,李保海,2022-04-22 05:53:50,0,1,1,上着上着就放视频了
209111,6796,胡凌飞,2025-01-04 13:45:42,1,1,0,虽然每节课上课都点名，但是老师上课内容丰富，考虑学生接受能力，十分送上！
217917,6796,胡凌飞,2025-04-18 02:28:09,1,1,0,神中神
146364,7213,孙成亮,2022-01-06 10:26:06,8,8,0,老师上课还是挺有意思的
166882,7213,孙成亮,2023-01-14 05:31:30,2,2,0,好爱老师啊！我是文科生，没有选考生物，但是最后几天复习了雪灾浙大的课后习题，准备好老师的讨论题，期末考就没问题啦！老师真的好好！对比其他班来看事也很少，只有一次小组展示，刚出分，居然有4.5！！文科生狂喜！！！吹爆老师！他真的在拼命捞我们！！选他！！他真的我哭死！！
166892,7213,孙成亮,2023-01-14 07:02:12,5,5,0,上课蛮有意思，会有提问大概是代替点名，事情不多一个小组展示，期末考给分也很好，挺好的老师
166893,7213,孙成亮,2023-01-14 07:02:12,1,2,1,上课蛮有意思，会有提问大概是代替点名，事情不多一个小组展示，期末考给分也很好，挺好的老师
167097,7213,孙成亮,2023-01-15 03:05:32,0,0,0,老师虽然会点名，但是人还是挺好的，期末考没怎么复习结果给分挺好的🥺
167147,7213,孙成亮,2023-01-15 04:22:17,0,0,0,老师人很好，给分比较高，高中生物的基础比较重要，但课下还要听网课，花的时间较多不过给分挺好
167201,7213,孙成亮,2023-01-15 05:25:35,0,0,0,老师超好 还给我们讲了ppt和论文网站之类的东西 有简单的小测 老师讲课也很认真～
167463,7213,孙成亮,2023-01-16 13:22:41,0,0,0,给分超级好，上课也很有意思
169149,7213,孙成亮,2023-02-24 12:48:06,1,1,0,对于我的付出来说，给分好，事贼少，爱
169557,7213,孙成亮,2023-02-27 02:05:22,1,1,0,文科生友好～不要太担心
191361,7213,孙成亮,2024-04-18 11:56:50,8,8,0,略高于胡宝兰老师
172948,7329,邬文浩,2023-05-10 09:17:01,22,23,1,作业真的多，给的时间还短，吐了
173032,7329,邬文浩,2023-05-11 13:51:15,18,18,0,一堆作业，还是上课没讲课件没有的东西，踩踩踩
173072,7329,邬文浩,2023-05-12 10:36:51,26,26,0,教的是个啥，让写的作业又是个啥。。。真的有想过一门课程该怎么去教吗，一次课后作业，比得上别人一门课程大作业。自己做的PPT也不知道是哪个寒武纪遗留下来的产物，好多都是不知道从哪里来的360P高清截图加一个纯色背景。上课就在那儿疯狂抽人回答问题，不是点名胜过点名。省流：依托答辩。
173075,7329,邬文浩,2023-05-12 11:39:33,17,17,0,作业真的太多了……学生的命也是命……
174916,7329,邬文浩,2023-06-28 09:36:32,15,15,0,讲得不明不白，作业全看国标。欲问老师是谁，就你邬哥最烧。辛辛苦苦一学期，寄点给分星号币的。
174992,7329,邬文浩,2023-06-20 15:13:50,12,12,0,kuaipao
175683,7329,邬文浩,2023-06-26 07:38:40,13,15,2,读研的快跑，别来
176848,7329,邬文浩,2023-06-30 11:25:26,14,14,0,作业多、时间短、不把我们当人看
179159,7329,邬文浩,2023-08-29 03:26:35,13,13,0,你说得对，但是《毕业实习》是由yangkun自主研发的一款全新开放世界游戏。游戏发生在一个被称作「牛马养殖场」的幻想世界，在这里被wwh选中的环境学子将被授予「第一课堂学分」，引导牛马之力。你将扮演一位名为「实习生」的神秘角色，在自由的天坑中邂逅以杨邬王为代表的性格各异、能力独特的老师们，和它们一起击败浙江大学最低时薪，找回需要倒贴的工作的同时，逐步发掘「实习生三方协议」的真相。
183666,7329,邬文浩,2023-11-28 08:57:14,5,5,0,0分无需多言~~~///(^v^)\\\~~~
193783,7329,邬文浩,2024-06-18 05:11:27,12,12,0,一般老师要求严格可以理解，但是上课和作业没有关系，作业提交方面又完全不体谅学生，是因为自己被压榨了所以要来压榨学生吗？？学生学到东西才是最重要的，跟着他全自学还要被精神折磨。最讨厌的一门课。
195343,7329,邬文浩,2024-06-28 01:28:46,8,8,0,给分机制就很有问题，表扬是几乎不表扬的，图画得好也是不加分的；有时候别人加了的东西你没加是要扣分的，别人没画但你画了的东西错了要倒扣分的。上课不知道在讲什么，总以为自己脑回路人人都能同频，抽人问问题非让人答上来不可，给一些和答案毫无关系的“提示”。wwh，ppt年纪怕是比您自己还老吧，给的参数范围没几个和国标一样的。常用的手册不能当教材发放么？标准不能基本提供么？设计步骤不能详细讲讲么？作业收得那叫一个说一不二，给分就不会给好点么？有作业的每一周都过得生不如死，期末了还得给您这门课恶心一下，从未见过如此事多还吝啬的课………
215647,7329,邬文浩,2025-03-03 08:11:46,1,1,0,邬需多言
217301,7329,邬文浩,2025-04-08 03:09:47,1,1,0,作业多的要死，难评
217661,7329,邬文浩,2025-04-15 02:21:01,0,0,0,最难评最ex的课 作业布置不把学生当人
218523,7329,邬文浩,2025-04-24 07:19:25,0,0,0,你那个史前PPT能不能教一下怎么设计啊。。。。
219838,7329,邬文浩,2025-06-08 12:04:46,1,1,0,md怎么不能打0分 这个b作业是人做的？
175351,7462,褚驰恒,2023-06-24 06:40:14,2,5,3,科环令人作呕的一面：在自己班划重点是按照页码和小标题来划的，划了10多分钟；在赵老师班划重点🟰5分钟把目录念了一遍。\n\n不知道是何居心….
176441,7462,褚驰恒,2023-06-29 02:18:47,5,6,1,楼下那位说的不完全对吧，智云我都去听了下，在周一晚上的班划重点的时候刚开始是说页码的，但是老师用的是第一版的教材，页码和第二版不一样。后来同学提出页码对不上之后，就不说页码从头来了一遍，和周二晚上的班差不多了。既然页码对不上周二晚上的班也就没有报页码的必要了，虽然这样看知识点确实很杂很多，而且如果老师换成第二版教材说一下页码会更好。但令人作呕真不至于...\n\n老师上课还是会点名的，通过叫人起来回答问题的方法，另外两位老师这个学期没有点过名。
176903,7462,褚驰恒,2023-06-30 15:42:00,1,2,1,上的是科学技术与环境健康，这个老师爱点名，上课还喜欢随机点人回答问题，画重点我个人觉得画了个寂寞，说的范围太大但是又考的太细。
182011,7694,马奇英,2023-11-08 03:54:07,1,2,1,烂课捏
182015,7694,马奇英,2023-11-08 06:33:07,3,4,1,朋友，如果你是为了某节答辩全英文课程而来，欢迎你，来了就是难友了\n\n秋学期很短，三节课很长，忍忍就好
182484,7694,马奇英,2023-11-16 11:39:48,1,2,1,一坨大便，跟那个满脸肥肉的外国助教一样\n\nfuck you！！！
182563,7694,马奇英,2023-11-17 13:44:51,4,8,4,第一次来cls上评价，也是第一次遇到这样的贵物老师和助教，我很不理解“农业与环境前沿”这门课为什么可以成为农资专业的专业必修课程，也许专业课就是这样的吧。\n\n  老师似乎更适合专心搞科研，给研究生上的课我不知道，至少我认为不适合给本科生上课，课上基本都是尬聊。肥婆助教看着就生理不适，给分很傻逼，充满随机性，你的付出可能得不到相应的分数，因为你做的展示她都不会认真听，而且完全不会中文，沟通效率低。课程上基本都是讲一些大而空的东西，你不仅学不到什么还说不定会被给分恶心到。\n\n  总结：傻逼课，别选。
184546,7694,马奇英,2023-12-21 14:06:59,2,3,1,有些攻击助教的身材的倒也大可不必，这学期助教是老师的研究生不会中文，老师也说了之后会换会中文的助教来的。课程考核比较看重展示吧，pre和课堂讨论加起来占百分之六七十了，对英文展示能力不行的人不友好。但是没考试没论文，我觉得给分不错也挺轻松的
202850,7694,马奇英,2024-11-15 01:29:47,2,3,1,这学期助教换成中国人了，上课也没有像前人说的那么不堪，老师讲课的内力其实很好
141378,7862,方雪坤,2021-10-03 15:13:22,0,1,1,新老师，上课感觉一般
163446,7862,方雪坤,2022-12-14 10:31:28,0,1,1,还行。
163539,7862,方雪坤,2022-12-15 03:29:52,1,6,5,上课会积极和学生互动，上课内容挺生动的，不会照搬书本上的内容，要学生现场查资料并回答问题，如果上课想水过去的慎选。环境管理学组织了一场辩论作为平时作业，形式挺有趣。虽然可能学不到什么东西，可能环境科学的专业课就是这样的吧。
200217,7862,方雪坤,2024-10-15 02:44:39,0,1,1,老师很好很喜欢 点名不会点 但是会叫人回答问题 上课方式很新颖很有趣很喜欢
202593,7862,方雪坤,2024-11-13 08:47:11,1,1,0,上课的课件感觉是学生临时准备的，看着和他的研究内容也并没有太大的关联
184342,7891,常锦峰,2023-12-18 05:31:09,3,3,0,超级温柔超级可爱🤩人也很有想法在学术前沿
203098,7891,常锦峰,2024-11-16 17:48:45,2,2,0,今天题量陡增
203126,7891,常锦峰,2024-11-17 05:53:02,2,3,1,今年可视化题量太多了，与以往历年卷相比，两道计算题的计算量缩到一道题里，而且考前没提醒带计算器，徒手开根，让我们带的画图工具根本来不及用上了。成绩给分一般，不知道是否有根据整体考试状况调整过，反正很难让人满意
206772,7891,常锦峰,2024-12-17 12:55:50,0,0,0,上了制图可视化，老师挺好的，讲课清晰有干货（虽然很多时间确实是读ppt），钉钉回消息及时，会认真看上交的作业并给反馈。不过这课作为一门短学期课程，确实任务量不算小，三次小作业+一次大作业+期末开卷考，个人对课程内容比较感兴趣所以学得挺开心，不喜欢地图学的慎选哇
183950,8110,管冬兴,2023-12-04 14:28:54,2,2,0,讲课比较无聊 会点名 考试比较简单 但是要背挺多且没重点
183966,8110,管冬兴,2023-12-05 04:17:25,0,0,0,给分烂捏，但反正逃不掉
183980,8110,管冬兴,2023-12-05 09:02:37,5,5,0,老师是很nice的新生之友，人很好。\n\n但听说环境生态学很求是，背多少给多少再和论文匀一下。
191132,8110,管冬兴,2024-04-07 14:21:16,3,4,1,职规课采访过老师，老师人很好，环境生态学不忍心让一些同学再上一遍，最低也给了61。和老师聊过，老师很辛苦，也想把课上好，也愿意听同学意见。预计下一年可能会划一点重点或者可能平时论文改成其他形式，老师还是希望大家分数高一点以及不要太累的，也欢迎大家和他交流，不过可能交流的人也不太多吧。老师知道环资学院本科生找导师是任务，愿意或者不愿意做科研（为了应付学院）的同学老师都收了，认真的很好！
216867,8110,管冬兴,2025-03-27 13:58:31,0,0,0,比较一般
197896,9072,徐江,2024-08-20 05:50:00,3,5,2,本科课程上上得了，千万别来读研
214336,9072,徐江,2025-02-01 11:44:26,2,2,0,诅咒每一门脱离群众的实验课，为了push而push，累了老师累了助教累了学生，回过头来忙得还挺热闹，操着一颗为了学生成长的心真是煞费苦心，原本的课程负责老师退休了，给年轻老师接手果然是要大展身手，祝老师早日改革成功，为让环资本科生早日认清专业现状提早规划跑路做出卓越贡献。（助教们非常认真负责，辛苦了）
217412,9213,杨碧君,2025-04-10 03:13:24,0,0,0,老师很好，指导很耐心，能和学生打成一片，很喜欢的老师
207144,9512,俞萍锋,2024-12-19 11:47:41,0,0,0,自己请的老师忘记上课，要大家都来周末补课，环资的学生真惨🙂🙂🙂
200700,10202,叶粟,2024-10-21 06:38:36,4,6,2,超好的老师啊，大家快冲
200701,10202,叶粟,2024-10-21 06:38:56,3,3,0,老师人很好
216040,10202,叶粟,2025-03-10 01:28:18,1,3,2,老师年轻但是科研实力非常强悍，能带发子刊，师生关系融洽，学生补贴按时发放且发的多，手把手教写代码，论文改的仔细认真
205036,10203,肖欣,2024-11-30 06:10:04,-2,0,2,肖老师特别好！
205037,10203,肖欣,2024-11-30 06:11:24,-2,0,2,Good Boy
