评论id,老师id,老师姓名,发表时间,点赞减去点踩数量,点赞量,点踩量,内容
116012,3451,蒋闰婧,2019-08-30 04:51:40,8,9,1,婧姐牛逼！！婧姐真的很棒！！人超级nice的！！！看到婧姐就和看到了妈妈一样！
116013,3451,蒋闰婧,2019-08-30 04:53:20,2,4,2,八错八错八错
164259,3451,蒋闰婧,2022-12-20 04:48:41,1,2,1,作为辅导员对于学生的问题热情细致地回答，工作认真，对学生很不错
165296,3451,蒋闰婧,2022-12-31 07:05:17,1,2,1,蒋老师yyds!
174849,3451,蒋闰婧,2023-06-19 05:06:38,0,1,1,蒋姐nb！
174850,3451,蒋闰婧,2023-06-19 05:06:37,-1,0,1,蒋姐nb！
179326,3451,蒋闰婧,2023-09-11 02:49:14,0,1,1,特别特别好滴婧姐
180366,3451,蒋闰婧,2023-09-21 08:43:52,-1,0,1,好好好
181512,3451,蒋闰婧,2023-10-20 03:19:05,-1,0,1,好好好
201394,3451,蒋闰婧,2024-11-01 15:08:35,0,0,0,特别好，很照顾我。是一个特别为学生考虑的好辅导员
203937,3451,蒋闰婧,2024-11-22 06:19:03,0,0,0,蒋老师是好老师！
16548,3486,田宇倩,2016-01-18 10:44:18,-19,6,25,田田姐人很好的！
36998,3486,田宇倩,2017-06-15 15:15:10,25,31,6,傻逼。
52846,3486,田宇倩,2017-06-26 03:52:50,-19,4,23,老师还是很温柔哒
140244,3486,田宇倩,2021-09-06 15:09:13,13,14,1,事很多
140245,3486,田宇倩,2021-09-06 15:15:52,17,18,1,《以身作则》
140246,3486,田宇倩,2021-09-08 13:47:41,18,19,1,有大病，真作
140247,3486,田宇倩,2021-09-06 15:29:16,18,19,1,茶言茶语
140257,3486,田宇倩,2021-09-07 09:56:33,15,16,1,伞兵。
140922,3486,田宇倩,2021-09-18 02:35:42,-10,0,10,人挺好
141900,3486,田宇倩,2021-10-31 01:41:34,5,5,0,不太能接受
141944,3486,田宇倩,2021-11-01 14:06:10,5,5,0,傻逼。
143658,3486,田宇倩,2021-11-30 12:06:19,3,7,4,唯一的优点就是长的好看，办什么活动都打扮的很精致，估计就是男生喜欢，女生恨死那种
145555,3486,田宇倩,2021-12-30 08:26:12,3,3,0,呵呵呵
146151,3486,田宇倩,2022-01-05 14:48:34,4,4,0,呵呵
152288,3486,田宇倩,2022-04-01 12:02:04,5,5,0,作精加傻逼，拍脑门决定事情
159840,3486,田宇倩,2022-09-05 15:29:15,3,3,0,以身 作 则
160994,3486,田宇倩,2022-10-23 14:52:26,3,3,0,为啥没有0
221355,3486,田宇倩,2025-06-23 04:16:56,0,0,0,坐标 大学生朋辈心理辅导\n\n老师还是挺好的  事情也很少说话很和善  还会提前半小时左右下课\n\n军训什么的不清楚  这条只对朋辈心理辅导作出参考
20877,3492,金虹霞,2016-02-02 19:16:44,0,1,1,太作，给分差得要命
22678,3492,金虹霞,2016-03-14 02:41:33,0,2,2,呜呼哀哉～～绩杀
22780,3492,金虹霞,2016-03-11 03:33:40,0,3,3,。。。
22871,3492,金虹霞,2016-03-14 02:30:50,0,1,1,特别不好，给分差，还会假哭的老师，呵呵呵呵哒
25478,3492,金虹霞,2016-05-22 11:30:59,0,4,4,一个SB!
26981,3492,金虹霞,2016-06-22 04:00:13,0,1,1,搞不懂浙大怎么会聘用这样的人
42888,3492,金虹霞,2017-01-15 10:57:06,0,1,1,莫名其妙？？？
87191,3492,金虹霞,2018-09-21 22:07:25,0,0,0,很温柔
17265,3498,许冰沁,2016-01-20 03:07:11,8,13,5,军训大绩杀
17283,3498,许冰沁,2016-01-20 03:39:36,4,8,4,军训GG
18322,3498,许冰沁,2016-01-21 12:43:16,9,14,5,最傻逼的老师，没有之一\n\n
18323,3498,许冰沁,2016-01-21 12:43:56,12,17,5,妈的怎么就不能给负的？
18392,3498,许冰沁,2016-01-21 14:17:58,-8,4,12,Fantastic
20521,3498,许冰沁,2016-01-28 05:25:35,7,11,4,说她傻逼都太侮辱傻逼了，军训真的坑爹！
20559,3498,许冰沁,2016-01-28 10:46:27,7,11,4,傻逼傻逼傻逼
20606,3498,许冰沁,2016-01-29 02:41:52,6,11,5,碰上这种老师我也是无言以对~你还是去读书吧！真的不适合当辅导员！！！！
21420,3498,许冰沁,2016-02-28 23:08:32,5,8,3,愚昧无知的sb
23372,3498,许冰沁,2016-03-27 15:13:30,4,7,3,有多坑这我就不多提了大家都懂。
23625,3498,许冰沁,2016-04-11 00:10:13,3,5,2,。。。。。。。
31844,3498,许冰沁,2016-07-05 04:08:58,-2,5,7,还是蛮好的
31888,3498,许冰沁,2017-01-04 13:21:18,-5,8,13,挺好哒！为什么给军训分数低一点就要这么评价她，说良心话你们自己军训花了什么力气了？？一群sb
40172,3498,许冰沁,2016-12-29 16:08:07,-4,5,9,很好的老师，军训时合唱失败还唱歌鼓励我们。抱怨绩杀的从自己身上找找原因。
58926,3498,许冰沁,2017-09-18 13:19:59,-5,1,6,挺好的，而且长得好看
58927,3498,许冰沁,2017-09-18 13:20:36,-2,2,4,长得好看
58928,3498,许冰沁,2017-09-18 13:25:38,-5,0,5,老师很好啊，很亲切，总是到寝室来跟我们增进感情，军训给分也不错。平常工作认真负责，长得也挺好看的
81046,3498,许冰沁,2018-07-03 12:11:50,4,4,0,1分，不能再多了
23583,3505,王瑞,2016-04-07 07:58:50,-1,0,1,非常坑
39895,3505,王瑞,2016-12-28 06:39:26,0,0,0,都这么漂亮了，还有什么话可说
22195,3509,夏丽霞,2016-03-03 02:03:19,0,0,0,长得还可以
17721,3519,陈泽星,2016-01-20 17:55:45,15,22,7,小黄人...
17722,3519,陈泽星,2016-01-20 17:59:02,7,11,4,小黄人
20498,3519,陈泽星,2016-01-28 01:36:52,4,8,4,小黄人
26545,3519,陈泽星,2016-06-20 05:02:39,4,8,4,小黄人。。。
27639,3519,陈泽星,2016-06-27 06:06:44,20,24,4,太爱装逼
32264,3519,陈泽星,2016-07-06 05:17:47,13,19,6,形策助教，给分慢，爱拖，给分烂，自己去玩吧。
32272,3519,陈泽星,2016-07-06 05:23:40,3,7,4,助教当的，出分慢到极点
32274,3519,陈泽星,2016-07-06 05:26:42,26,34,8,垃圾助教 没见过这么不负责的 不把学生当回事当nmb助教当nmb辅导员
32286,3519,陈泽星,2016-07-06 05:47:01,8,11,3,闭卷考可以增加别的测试项目啊，怎么非得拉低所有人分数。
32521,3519,陈泽星,2016-07-07 11:00:47,4,7,3,在形策助教这件事上，wqnmlgb
32576,3519,陈泽星,2016-07-08 01:40:29,9,14,5,为行策老师感到悲伤，因为这个助教而背黑锅，我一般都是给老师10分的，可是他给了1分，为什么没有0分！！上课展示助教上课也是一副装逼的样子，展示后评价也是一听就知道没认真听展示，小组有几个都不清楚，醉了醉了，一点不尊重学生。最后的给分真是极差极差，不知道怎么想的，这种课为什么不让我们上上开心？还要找事情。还是替不明真相的去低分评价满丰老师的同学们感到不值，老师真的背黑锅了。
34055,3519,陈泽星,2016-09-26 07:27:17,-5,2,7,
34896,3519,陈泽星,2016-10-26 09:06:41,3,7,4,装逼不打草稿
36186,3519,陈泽星,2017-05-16 14:22:49,7,10,3,遇到他这种人只能说倒霉
38339,3519,陈泽星,2016-11-30 07:22:57,11,14,3,没啥好说的 不是啥正常人
49455,3519,陈泽星,2017-04-14 05:16:29,-14,4,18,至少3
49456,3519,陈泽星,2017-04-14 05:18:03,12,15,3,陈bibi
49457,3519,陈泽星,2017-04-14 05:42:00,14,18,4,大傻逼
51265,3519,陈泽星,2017-05-26 09:16:40,31,35,4,作为一个辅导员 简直是垃圾中的垃圾
57483,3519,陈泽星,2017-07-08 14:57:45,-3,1,4,小黄人
57689,3519,陈泽星,2017-07-12 14:13:40,9,13,4,军训碰到他，晚上集合不被站10分钟就万幸了。
57691,3519,陈泽星,2017-07-12 14:26:19,11,14,3,吃翔了
57692,3519,陈泽星,2017-07-12 14:28:48,22,25,3,您pi话少点可以吗
57693,3519,陈泽星,2017-07-12 14:32:09,25,34,9,恶心到要命，效率低下，拖沓，一句话嚼五六遍，军训遇到了就别想12点前睡觉。想了很多形容词，还是傻逼最贴切。
57695,3519,陈泽星,2017-07-12 14:39:41,7,11,4,为什么没有零分这个选项?
57735,3519,陈泽星,2017-07-13 07:15:40,16,19,3,垃圾一个
57741,3519,陈泽星,2017-07-13 10:52:43,33,43,10,自以为是，练个合唱一点乐理只是都不懂，还在那里瞎逼逼。说话拖沓，有了他，别想早点回寝室了
57934,3519,陈泽星,2017-07-18 00:29:04,12,17,5,屁话少说，谢谢
58604,3519,陈泽星,2017-09-08 08:35:49,20,23,3,知道的辅导员中印象最差的，没有之一
58685,3519,陈泽星,2017-09-14 18:05:38,7,10,3,拖拖拖
59362,3519,陈泽星,2017-09-21 04:08:33,30,36,6,辅导员里面最拖沓的，说好什么时候给你办，永远都不会说到做到。说什么时候在系办，去找他的，到时候去也见不到人。素质底下，不守信，不把学生的事情当回事。发消息很少回。一大框不好，毕业回执信啥的经他手，基本上别抱希望。
59627,3519,陈泽星,2017-09-25 04:11:29,18,21,3,真的超级磨叽磨叽磨叽\n\n年级大会一共就40分钟还把全系的名字点了一遍\n\n
66308,3519,陈泽星,2018-01-15 03:52:37,3,6,3,这种傻逼是怎么当上辅导员的…败类
73778,3519,陈泽星,2018-02-03 05:26:40,-7,5,12,同一个课堂，觉得不同的人感受还是不一样的吧，我觉得讲的挺有意思的，有些人旷课不来还说啥呢？
73834,3519,陈泽星,2018-02-03 07:51:22,4,7,3,差评！！
74541,3519,陈泽星,2018-03-03 08:29:04,12,14,2,这老师屁话多打官腔，有用的啥也不懂，开会贼墨迹，傻逼一个
79952,3519,陈泽星,2018-06-16 08:11:40,5,7,2,特爱装逼，特爱在学生面前显示自己辅导员的高贵地位
85656,3519,陈泽星,2018-07-24 07:16:04,5,7,2,作为辅导员对学生的态度极差，说真的从来没见过这样的辅导员，说出来的话奇葩到让我震惊！
85926,3519,陈泽星,2018-08-25 12:01:08,7,9,2,是个jb，他教会了我怎么退课
86460,3519,陈泽星,2018-09-16 12:42:06,3,5,2,日常放学生和其他老师鸽子，没有什么问题。
87076,3519,陈泽星,2018-09-20 07:16:53,-27,5,32,评论区刷新了我对浙大学生的认知，给分分就能否定老师的一切了，找那么多破理由做什么？
87988,3519,陈泽星,2018-10-19 13:31:30,21,22,1,贼傻逼一人，我想起学生代表大会楼仁功说我们系的辅导员都是人才，工作一年就被挖走了，还夸了czx一顿，陈泽星那个时候都工作两年了，怕是别的学院嫌垃圾都懒得看吧。和这货打打交道你会刷新对辅导员的认知。
88047,3519,陈泽星,2018-10-20 15:35:53,12,13,1,永远找不到人的辅导员，大概坟头信号不好吧……，下次还是烧给他好了。
88587,3519,陈泽星,2018-11-02 06:03:42,2,3,1,做事拖沓不负责任
92470,3519,陈泽星,2018-12-29 13:25:25,2,4,2,这个辅导员，是真滴不给力。述职报告说自己啥事都管，找他办事的时候啥都不想管。能力是真的不行，还非要表现得自己很行。唉，感觉自己被坑了。
92533,3519,陈泽星,2019-01-02 07:02:18,-2,2,4,一般般
102607,3519,陈泽星,2019-10-23 12:57:16,-26,2,28,别说陈泽星老师不好了，大一接触过，没有深入，人起码还有礼貌，对比一下张小晟，丢脸都丢到知乎去了，说czx是最差的，我只想说，那是因为你没接触过张小晟?
106357,3519,陈泽星,2019-04-26 15:55:01,9,9,0,陈泽星从不理会谣言和中伤\n\nczxnmsl
108144,3519,陈泽星,2019-05-15 16:09:04,12,14,2,为什么没有0分？？？？？这种人是留在浙大恶心人的吗？正事不干 就会溜须拍马。学生微信找他基本不回复，学校花钱养你这么个孙子是干嘛吃的？辅导员不帮助学生处理事情，反倒是利用学生帮你打杂？你是狗养大的吗？
109665,3519,陈泽星,2019-06-18 08:06:11,4,4,0,woc 这个逼真的是一个垃圾
109666,3519,陈泽星,2019-06-18 08:11:10,8,9,1,为什么没有零分 狗b一个 他分内的工作什么都不做 全给学生做 一天天还巨爱装b 天天打官腔 臭傻逼 天天还好大喜功 觉得自己做了很多事情 傻逼 怎么有这种人 长得还tm黑煤球一样
114732,3519,陈泽星,2019-07-11 07:44:45,2,2,0,傻逼.
115473,3519,陈泽星,2019-07-26 10:36:37,-7,4,11,一个人面对六百号人的事务，想想也是不容易了，也不可能随传随到吧。上学期帮他做了点事，觉得还行啊，人挺好的。不做不知道其中感受啊，难
117093,3519,陈泽星,2019-09-19 06:02:01,9,9,0,Never Mind……算了，爷忘了，NMSL
118081,3519,陈泽星,2019-10-20 16:46:39,0,1,1,述职报告他自己给自己打好分然后直接拿给学生签字（看来最起码还有点自知之明，知道自己分学生评的话肯定高不了）。。。这个弄虚作假的。。。真不知道他怎么进的浙大，身为辅导员怎么宣扬“求是”校训
122142,3519,陈泽星,2020-02-17 04:20:00,0,1,1,这个人让我感到我的脏话词库是多么的匮乏
122229,3519,陈泽星,2020-02-20 06:42:52,0,1,1,职规课，眼睛瞎了？职规书好好写的给分这么差？？
123452,3519,陈泽星,2020-06-09 03:56:39,-3,0,3,不错。
26437,3544,叶晨晨,2016-06-18 12:44:07,1,2,1,化工系的认识实习快截止了强行加企业数我是服的
116276,3544,叶晨晨,2019-09-07 07:25:20,2,2,0,非常牛逼
116277,3544,叶晨晨,2019-09-07 07:25:31,4,4,0,牛逼.
24057,3625,任林涛,2016-04-26 08:25:03,1,1,0,。。。
37295,3625,任林涛,2016-11-18 08:35:59,0,0,0,帅哟\n\n
54685,3641,梁艳媚,2017-06-30 04:20:11,0,0,0,好漂亮！好可爱！！女神！！！
75989,3641,梁艳媚,2018-03-23 05:54:14,2,2,0,垃圾真的垃圾
24509,3674,傅晨柠,2016-05-01 01:50:30,-5,4,9,没什么可说的
25346,3674,傅晨柠,2016-09-28 15:04:47,6,7,1,高冷范 把妹狂
26741,3674,傅晨柠,2016-06-21 04:27:35,-6,3,9,无语的辅导员
49381,3674,傅晨柠,2017-04-09 05:28:29,8,8,0,经常开会
61292,3674,傅晨柠,2017-11-14 02:34:36,4,4,0,已经不记得我了……
93145,3674,傅晨柠,2019-07-01 16:30:02,-1,2,3,恶心 做作
116674,3674,傅晨柠,2019-09-13 01:09:57,-1,0,1,超级棒！
18303,3709,梁思姝,2016-01-21 12:00:15,-4,44,48,凶，分低，军训坑
19191,3709,梁思姝,2017-07-16 15:17:17,-5,63,68,搞不懂她天天把自己抹得跟个妖精似的有啥意思。。。
21912,3709,梁思姝,2016-03-01 15:15:32,-33,6,39,凑个整
23056,3709,梁思姝,2017-07-09 05:27:31,-59,41,100,漂亮又有气质，我的女神！！！
57126,3709,梁思姝,2017-07-05 14:57:27,43,97,54,专门负责骂人
57662,3709,梁思姝,2017-07-16 04:57:20,-16,34,50,挺好的啊
57716,3709,梁思姝,2017-07-16 10:45:42,133,191,58,讲真打一分完全是因为没有零分。骂人不分青红皂白口无择言，当着全连的面骂副连和指导员是常有的事。你骂的合理的话也就算了，拔河的队伍在绳子旁边准备好了要开始拔河的时候骂他们加油的队伍不整齐？？？自己穿着短袖晃来晃去又要求我们在晚上大热天的穿上外套坐姿端正？？？一言不合就开骂，骂的话永远特别难听。是啊我就是不服气，反正军训了这么多天我依旧想不通这位所谓“老师”的那股优越感究竟哪来的。手动微笑。
57736,3709,梁思姝,2017-07-13 07:59:20,-23,17,40,先洗洗嘴巴吧
57753,3709,梁思姝,2017-07-17 16:12:00,-38,29,67,风口浪尖上的人
57765,3709,梁思姝,2017-07-16 04:50:57,-30,13,43,很傻逼，很傻逼很傻逼，谁看谁知道
57782,3709,梁思姝,2017-07-16 04:51:36,-19,23,42,辣鸡……居然上二了，我特么不信
57790,3709,梁思姝,2017-07-16 16:18:42,-27,18,45,娘是猪\n\n
57791,3709,梁思姝,2017-07-15 23:21:39,-15,16,31,有点坑有点毒\n\n
57794,3709,梁思姝,2017-07-17 09:52:52,-32,12,44,还可以
57795,3709,梁思姝,2017-07-16 15:15:42,-16,10,26,呵呵何
57797,3709,梁思姝,2017-07-15 23:51:07,-24,6,30,呵呵呵
57799,3709,梁思姝,2017-07-16 06:53:46,-13,45,58,女神啊
57800,3709,梁思姝,2017-07-16 13:53:57,-31,15,46,不管怎么说毫无理由的骂人绝对没有道理，某些同学太偏激也是因为被压抑了太深…
57801,3709,梁思姝,2017-07-16 13:06:52,-26,79,105,15级医学生被思姝姐带了两年，人超好，军训给分也很客观很有依据。楼上某些nc，军训都没出成绩说什么分低。真不懂戾气为什么那么重？
57802,3709,梁思姝,2017-07-20 12:30:31,21,106,85,还记得那个热门的孙大雁老师\n\n说16级素质差的请手动搜索，让我看看15级的高素质学长学姐。\n\n你们当年那是争取人权，我们就叫矫情，戾气重。呵呵呵
57803,3709,梁思姝,2017-07-18 05:00:28,-44,21,65,天天把自己画成这样，可以x吗
57805,3709,梁思姝,2019-01-05 08:32:16,44,90,46,继续说说吧，大二的老生们都说大一的戾气好重啊，什么思姝姐平时对我们超级好啊，但是那是平时啊，老哥老姐们，难道军训起来就会让一个人变成了另一个人？我也没有骂过她，但是令我们不能忍受的是无缘无故的训斥我们啊，我们不听指导员的我们听谁的？听她的？   笑话   天大的笑话。说我们戾气重，说我们这届水，那么你们军训时毕竟不是三伏天吧，毕竟教官也不会晕倒两个吧，所谓15级大二老生在这种天气也恐怕会这样吧，如果你想否认，那么请在每天中午最热的时候排队等待吃饭？    还穿着超级热的军训服？   不敢的话   请你们不要瞎说，哦对了，你们也许会说我们当然愿意体验，可是没有时间体验（如果你们真的这样说，我也无话可说），说我们娇气，说我们戾气重，你们并不是在15年同一时间军训的人，有什么资格说我们（请不要倚老卖老，那样的话，和那些讹人的老人有什么区别，和那些占着篮球场跳广场舞的老人们有什么区别，呵呵）
57807,3709,梁思姝,2017-07-16 02:50:23,-19,45,64,这些骂脏话，人生攻击甚至言语性骚扰的人照照镜子看看自己丑陋的嘴脸吧，你根本不配骂思姝
57809,3709,梁思姝,2017-07-16 02:53:01,-12,18,30,不错呀
57810,3709,梁思姝,2017-07-16 02:53:47,-32,57,89,这届大一的什么情况？军训时给你们玩的？军训本来就是给你们吃苦的。自己话说的这么难听还好意思说思姝姐？你们这种思想确实应该好好教育一下。看来是思姝姐骂的还不够狠。
57811,3709,梁思姝,2017-07-16 03:02:31,-24,40,64,很好的辅导员啊，真的对学生很有帮助，那些瞎jb喷的喷子是不是太过分了点，大概就是自己犯错被思姝老师批评了很不爽来这里泄私愤吧
57812,3709,梁思姝,2017-07-16 03:11:47,-19,56,75,同15级医学生，看到这些话真的很难受。你们之间有什么矛盾具体情况不得而知，军训期间有情绪也可以理解；思姝姐严肃的时候看起来确实凶，但思姝姐带了我们两年我们都知道她平时人很亲切对我们也很好；真的是觉得这里部分言论人身攻击过于不堪入目，说出这样的话真的应该先自我反省一下。
57813,3709,梁思姝,2017-07-16 08:50:37,29,84,55,确实这是评价老师的平台，评论里用【大一】来以偏概全也有失偏颇，但是从头到尾指责的都是喷脏某些大一同学，请不要对号入座，谢谢。真的想象不到能用“SB”“biaozi”这样肮脏的词汇来形容老师的人竟然是浙大的学生。LSS是严格，她不分青红皂白骂人也确实应该指出批评，但我不认为肆意辱骂老师是所谓的正当评论。(当然，楼上有些同学的对事不对人的指责，我表示尊重)
57815,3709,梁思姝,2017-07-16 03:37:55,-23,29,52,军训没事找事太正常了，主要还是没见过很高大的阵仗，建议去问问国防生，问问你们教官，你们有新兵连十分之一的辛苦吗？
57816,3709,梁思姝,2017-08-09 11:50:01,-56,53,109,这届大一的是逛了一年微博被洗了脑了吗？军训就是磨练意志、锻炼体魄，完全不知道你们在喷什么，感觉自己无所不能很有主见就能瞎逼逼了？把慰问教官那件事扣帽子给校长，在知乎上这么诋毁学校真的好吗？在你们说话之前能不能先了解前因后果？作为一个浙大人居然像某些喷子一样容易被带节奏？lss确实很凶，可是没有无缘由地凶你们吧？没有人身攻击吧？她在做好自己负责的事，你们呢？你们的副指和妇联都是她的学生，她只是在需要严肃的场合严肃，平时都是很疼爱你们的副指和妇联。这届大一你们在急于发泄情绪的同时能不能先学会客观地看待问题？无论客观的结果是什么，我们都会尊重你们。
57817,3709,梁思姝,2017-07-16 04:28:31,-23,41,64,某些16级的戏真多？骂得还这么难听？
57818,3709,梁思姝,2017-07-16 04:46:02,-14,29,43,思姝姐挺好的。
57819,3709,梁思姝,2017-07-16 04:52:39,-13,42,55,抱怨思姝姐凶无可厚非，毕竟每个人都需要情绪的宣泄。但那些爆粗口骂脏话人生攻击的都是在干什么？？？思姝姐有这么骂你们么？？？？？
57820,3709,梁思姝,2017-07-17 00:23:15,-13,39,52,也许老师在军训这个事情上骂人骂的不妥 但是在这里用脏话发泄情绪也没有用处呀 心疼学弟学妹 但也希望学弟学妹冷静一点 如果你们觉得不满 能有一个人号召一下联名提个建议上报上去 还可以带上妇联副指 这样解决问题也会有效得多不是吗？老师私下里人很好 一定也会听你们的意见的
57821,3709,梁思姝,2017-07-16 05:12:36,-7,16,23,傻逼杀
57822,3709,梁思姝,2019-01-05 08:58:32,-131,37,168,哇，真的对你们这些16的小朋友无语。呆了一年翅膀硬了？觉得自己很牛逼了？天不怕地不怕，觉得谁都是错的了？戾气这么重也是没谁了…才大一刚结束就这么牛气哄哄，也不照照镜子自己什么样…上面评论满嘴喷粪的这种人就该好好训训，爹妈没管好？？？\n\n
57823,3709,梁思姝,2017-07-16 05:14:20,-15,14,29,好辅导员
57824,3709,梁思姝,2017-07-18 03:18:46,-42,32,74,很好的辅导员。16级军训自由散漫的样子我也不是没见过，“反骨”反的恶心。那些一上来就满嘴侮辱话语、人身攻击的16级同学，浙大竟然有你们这些人，我真是觉得寒心哦。
57827,3709,梁思姝,2017-07-16 05:27:59,-25,11,36,表白梁思姝
57828,3709,梁思姝,2017-07-16 10:27:08,63,94,31,1没有抱怨军训苦\n\n2单纯看她不爽
57829,3709,梁思姝,2017-07-16 10:59:51,-14,30,44,大二的那么多，自己吃了屎就不许别人不吃？
57833,3709,梁思姝,2017-07-16 06:15:54,-20,29,49,16级医学生。\n\n摸过来一看真的觉得丢脸，讲道理做的不好还要骂别人提醒你吗？？一点纪律不讲还有理了是吧？？军训严格一点不是超正常的吗？？而且那些骂人的说的话也太难听了吧？？\n\n真看不下去太丢脸了。\n\n
57835,3709,梁思姝,2017-07-16 06:41:41,28,51,23,一言不合就开喷
57836,3709,梁思姝,2017-07-16 06:51:52,2,9,7,呵呵哒
57837,3709,梁思姝,2017-07-16 06:53:40,19,33,14,骂人不讲道理
57839,3709,梁思姝,2017-07-16 06:55:02,41,76,35,那些说军训有意义的大概都是些被军训训成功的“优秀”学生，像我这种智商是根本看不出来军训有个毛的意义
57840,3709,梁思姝,2017-07-16 06:55:17,8,18,10,自己体会
57841,3709,梁思姝,2017-07-16 06:55:38,-13,9,22,很好呀美滋滋哦\n\n
57842,3709,梁思姝,2017-07-16 07:17:58,-38,25,63,思姝姐是当年大学我的第一个副部，人不仅超级好而且对我的帮助也挺大的…另外有句话不得不说，16级你们太矫情了，矫情过头了……哪届军训不是又苦又累，不是听辅导员训话？军训是给你过家家玩的？真是有意思……哪届军训都一样，我在学校4年了，没看到哪届像你们这样balabala成天哭天喊地的
57843,3709,梁思姝,2017-07-16 07:23:13,8,28,20,很棒棒哦，才发现这里也有刷子，给这样的老师抹白有意思吗？你们以为过来了就可以瞎逼逼了？
57845,3709,梁思姝,2017-07-16 07:52:18,-32,13,45,对16级那些满嘴喷粪的人真是没想法，浙大学生？讲出去都丢人
57846,3709,梁思姝,2017-07-16 08:08:45,-5,14,19,一句话: 你很有理 来蓝六办公区 我们坐上下来好好谈谈
57847,3709,梁思姝,2017-07-16 22:29:47,-30,22,52,不管怎么样，你们这样评价一位老师真的是丢人，把自己的情绪拿到这里来发泄，真的是有够逊的，才来一年就成这样了，你的骄傲哪来的？从骂人中得的？除了大一的学生谁赞同你的观点？
57848,3709,梁思姝,2019-01-05 07:55:04,99,166,67,第一次见到她是一次礼仪培训，觉得人很温柔，说话超斯文，军训时听到她当了某职务领导有些惊讶，觉得她这么温柔的人带的过来吗，然后第一天就见识了她是怎么训人的。。。我嘞个去简直不敢相信是一个人。。有些惊讶，只是客观觉得她的管理方式有些像初高中，也有些不给副连和指导员面子。。并没喷老师，只是对这里大二某些人表示无语。\n\n请那些大二的喷子们不要把气全撒在大一身上好吗？？你们又没和我们一起怎么就能凭在网上的主观臆断知道我们军训比你们水？你们知道三伏天军训是什么感觉吗？抱怨是正常的，你们军训的时候就没有过抱怨吗？有怨不发是要迎合谁啊。你们点的那些《晴天》，不就是如果我们这届比你们军训水心里不平衡吗。\n\n你们说我们不能吃苦，那你们未必比教官们都能吃苦吗？教官们都知道高温预警大家都不容易尽量给我们多休息，那请你们不要坐在空调房里指责三伏天里军训的我们！也不要仗着比我们高了一级就以为多长了多少见识倚老卖老！\n\n请大二的喷子们走开！这里是老师评价平台，不是大二喷大一的地方！也同时对给我们送过西瓜的大二学长组们表示感谢。
57850,3709,梁思姝,2017-07-16 10:02:58,39,57,18,听大一的骂过之后，大二的决定跟风骂，早就想骂了，接触不多，但对其印象极差，能力不强，脾气很大，没有为人师表的意思，很龌龊。
57851,3709,梁思姝,2017-07-16 10:16:55,-5,8,13,什么玩意儿
57858,3709,梁思姝,2017-07-16 10:37:55,5,20,15,为什么没有0分
57859,3709,梁思姝,2017-07-16 10:41:09,-5,4,9,呵呵哒
57860,3709,梁思姝,2017-07-16 11:04:07,57,73,16,说实在的 作为一个之前根本不认识她的人，连续多次看到她不分青红皂白骂人喷人，确实对她没有好的印象。其他方面不评论，就在这一方面差评，仅此而已。还有某些人，别一口一个大一矫情，大一咋咋的，好像你们当初没抱怨过一样，而且我们所处的天气，不一样，评论老师就好好评论老师，别人爱怎么评论她，是别人的事儿，与你无关。
57861,3709,梁思姝,2017-07-16 11:11:49,-8,6,14,其实还不错
57863,3709,梁思姝,2017-07-16 11:15:36,69,91,22,不管梁某对你们大二做了什么事情，我只讲我看到的。无故指责痛骂你认吧？随便找个没穿外套理由痛批你一顿，任谁心里会好受？梁某脸白你认吧？天生丽质？敢问谁能在大热天暴晒还能保持脸白头发黄？哦，她是管理层，不需要晒太阳，所以就能不知道任何情况来把你抓过来骂一顿。拜托学长学姐，我们基于自己的印象来评分，有问题吗？
57864,3709,梁思姝,2017-07-16 11:19:48,8,16,8,差就是差
57867,3709,梁思姝,2017-07-16 12:00:21,32,43,11,做事很情绪化，不尊重对方，考虑问题比较片面。
57868,3709,梁思姝,2017-07-17 05:27:31,-20,13,33,漂亮，女神\n\n
57869,3709,梁思姝,2017-07-16 12:02:14,87,107,20,我是大二的 我心疼被骂的学弟学妹 给她打1分
57870,3709,梁思姝,2017-07-16 12:06:35,91,116,25,“谁让你们走的”\n\n“辅导员”\n\n“辅导员让你走你就走啊”\n\n“.....”\n\n“谁让你听辅导员的！！！”
57871,3709,梁思姝,2017-07-16 12:26:54,5,10,5,呵呵呵
57872,3709,梁思姝,2017-07-16 12:54:14,-12,10,22,这老师还是挺好的！
57873,3709,梁思姝,2017-07-17 05:34:58,42,50,8,军训正式开始前一晚一个个连队骂过去，噗嗤
57875,3709,梁思姝,2017-07-16 16:16:52,1,10,9,东瀛来的吗
57877,3709,梁思姝,2017-07-16 14:12:54,-21,11,32,老师是真心好，大家因为军训烦躁就把气撒她身上真的好吗？
57878,3709,梁思姝,2017-07-16 14:18:20,-23,14,37,觉得老师挺可怜的。。虽然没有被她带过而且我们连还被痛骂了一遍。。可是老师是为了我们好啊。。你们心胸不要这么狭隘。老师跟你无冤无仇训你不就是为了纪律和威信。她自己拿到什么好处。。。虽然是被骂过。。可是我没有觉得她怎么不好了。。你们真的了解这个老师吗。你们知道她私下的作风吗就这样乱评价。真的过分的。你们的评价要对得起自己的良心。挺老师。
57880,3709,梁思姝,2017-07-16 14:30:25,-23,6,29,老师做事就是要有自己的原则，无论什么事，她都是凭着自己的良心做的，说老师不好的，只能说明你们自己没有认真对待军训，自己没有达到要求
57881,3709,梁思姝,2017-07-16 14:55:26,5,12,7,1分不能再多了…
57883,3709,梁思姝,2017-07-16 16:46:39,-11,22,33,一边骂大二的学长学姐，一边感谢给你们送瓜的学长学姐，给你们送瓜的学长学姐表示看到这些评论很心痛，希望那些骂人的话不是出在自己带的班的里面，人家怼你一句你就要以更恶毒的话怼十句回去，且不说是师生关系，且不说有没有胸怀，不是我们长期处在黑暗中习惯了黑暗而是你们太自私不管别人对你们多好只要触及一点你们的个人利益就反目成仇开骂，走到哪里就骂到哪里，他让我们不开心了我就要骂啊，希望骂人的评论都不出在我带的班
57885,3709,梁思姝,2017-07-16 17:25:48,-22,6,28,力挺我思姝姐！
57886,3709,梁思姝,2017-07-16 18:06:31,-39,7,46,军训是把自己当军人，不是学生身份，军人就是要服从命令听指挥。不想服从可以退出啊（逃兵），承担责任（不能毕业）就好，何必bb呢？就是不要惯着你们，就是要杀杀你们的戾气
57887,3709,梁思姝,2017-07-16 22:52:47,48,54,6,不是所有的老师都配尊敬。只有你尊重别人，别人才会尊重你
57888,3709,梁思姝,2017-07-20 07:03:43,4,8,4,就是傻
57889,3709,梁思姝,2017-12-13 05:12:34,13,17,4,恶狠狠，凶巴巴，不会好好讲话，不近人情，不讲道理
57890,3709,梁思姝,2017-07-17 01:26:09,-6,5,11,别喷了
57894,3709,梁思姝,2017-07-17 04:14:57,9,11,2,装，不解释
57899,3709,梁思姝,2017-07-17 05:41:03,3,6,3,懒得多说
57900,3709,梁思姝,2017-07-17 06:05:11,7,10,3,不想多说，默默1分
57901,3709,梁思姝,2017-07-17 08:58:22,-28,3,31,表白思姝姐
57920,3709,梁思姝,2017-07-17 21:23:55,23,27,4,竟然还有这么多人帮她洗白
57923,3709,梁思姝,2017-07-17 23:04:48,8,12,4,每次听到她的声音就反胃\n\n
57924,3709,梁思姝,2017-07-17 23:09:42,16,19,3,如此为人师表？反正就是不喜欢。
57925,3709,梁思姝,2017-07-17 23:09:59,0,2,2,哦哦哦
57926,3709,梁思姝,2017-07-17 23:14:12,23,26,3,不想说了
57927,3709,梁思姝,2017-07-17 23:11:00,5,8,3,有毒吧
57928,3709,梁思姝,2017-07-17 23:18:38,44,47,3,顶一头黄毛，有资格说别人军容不正？说纪律可以，但是要以身作则。而且不能忍的是训人的时候，一点都不把教官同学放在眼里。大家都要互相理解，是统一战线，而不是划清界线，阶级斗争。我们的炎炎烈日下的苦，空调房里指挥的你们未必能受得了。梁思姝老师，需要好好反省了。
57929,3709,梁思姝,2017-07-17 23:36:39,19,21,2,操场暴晒实时交流，点杀。都在无聊地看查老师吧
57932,3709,梁思姝,2017-07-18 00:18:20,33,37,4,阅兵现场:大家往我右手边来一点。。。往里靠一点。。。往那边走。。。不说别的，请问您真的会指挥吗2333
57935,3709,梁思姝,2017-07-18 00:39:24,18,21,3,军训成了她装逼和满足个人私欲的舞台
57937,3709,梁思姝,2017-07-18 01:29:53,5,7,2,瞎指挥 作威作福
57938,3709,梁思姝,2017-07-20 09:22:35,3,6,3,自以为是
57942,3709,梁思姝,2017-07-18 06:34:30,1,3,2,大不自多，心中多一点容量，对这个校园友好点！
57943,3709,梁思姝,2017-07-18 06:44:10,2,4,2,白的是她，黑了我们
57947,3709,梁思姝,2017-07-18 09:45:14,-2,3,5,纯弱智？
57949,3709,梁思姝,2017-07-18 09:49:32,0,2,2,梁老师太凶了
57950,3709,梁思姝,2017-07-18 09:52:31,26,31,5,打了中间5分。利益无关，不过光是在动员大会和总结大会上听她指挥就觉得趾高气昂，总结大会给三团整队“右手边来一点，右手边来一点……”几分钟过后“不好意思是我的右手边……”最后让领导说别整了……军训的确是磨人意志的，但是服从命令是为了提高效率，军队最讲究效率，在我看来她还没有能够带一个团的能力和魄力，一昧的骂人肯定会引起下面人的不满，逆反心理更严重，我们16级不是吃不了苦的人，但要是在我天天晒太阳跟个似的小笼包蒸的时候还要被人骂，那我不保证我能控制情绪，军训是很珍贵的体验。这位老师也许是个好老师，但不是个好领导(权威)。
57957,3709,梁思姝,2017-07-18 13:18:35,-12,10,22,参谋长今晚表扬了我们连！\n\n（不穿军装真的很漂亮hhh）\n\n回过头看参谋长确实却是挺严格的，但我眼中觉得她为了维护秩序有时候训人也是情理之中。（训人和骂人还是有很大区别的吧！
57968,3709,梁思姝,2017-07-19 00:23:33,26,32,6,我真的不知道那些大二的哪来的优越感，说我们娇气?我只知道我们天天顶着将近40度的温度，晒着太阳，没人倒下，没人无故请假，说我们散漫。。。欲加之罪何患无辞，我只知道我们每天按计划执行每一项人物，有人抱怨，没人缺席。说我们翅膀硬了，抱歉，还真就硬了，怎么了，读了一年大学了，翅膀还不硬点，一年大学白读了？梁老师人确实不错，但不管是谁，第一次见面就开骂，第一印象都不会很好，不管出于什么原因骂我们，心灵肯定不爽。没有黑老师的意思，真的很看不惯有些大二在这里怼大一的。
57970,3709,梁思姝,2017-07-19 00:43:24,0,0,0,呵呵呵
57971,3709,梁思姝,2017-07-19 01:57:40,-6,7,13,树大招风，心疼梁老师
57972,3709,梁思姝,2017-07-19 02:27:49,6,8,2,没有整队的水平就不要占着指挥的位置。
57983,3709,梁思姝,2017-07-19 23:31:16,-2,6,8,为人师婊
57995,3709,梁思姝,2017-07-21 07:58:06,8,12,4,怎么说，我是大二的。对她的印象就是，很主观的一个人。你和她关系好，刷脸多就很好。不然的话，呵呵
58034,3709,梁思姝,2017-07-25 04:22:38,2,2,0,无FA可说
58081,3709,梁思姝,2017-07-29 01:28:12,6,7,1,希望军训过后\n\n老师还是老师\n\n辅导员还是辅导员\n\n学长还是学长\n\n学姐还是学姐\n\n大家还是大家\n\n\n\n一场军训，分出了等级，将“相互尊重”变成了“无条件服从”，至少个人是感觉非常不舒服的，也正是这场军训，让大家见识了这些，接触到或许再也不会接触的“另一面”，也让很多同学们(也只能说自己周围吧)\n\n\n\n放弃了参军的念想
58097,3709,梁思姝,2017-07-30 08:42:51,18,22,4,某些15级的就会戾气戾气，依照自己的主观判断来对16级整个群体开炮。“你们16级”“这届大一”balabala这些词汇我真的看不下去，我们一年学了什么用得着你们管吗，你们学了两年是比我们高到哪里去了还是怎样，网络暴力就在身边…
58102,3709,梁思姝,2017-07-31 04:23:32,2,2,0,辣鸡老师
58126,3709,梁思姝,2017-08-04 00:31:10,3,3,0,很无语…平时是个怎么样的人我不了解，然而军训的时候确实很让人恶心
58157,3709,梁思姝,2017-08-11 05:02:39,8,8,0,一团的，看到总结大会她的瞎指挥，顿生厌恶之情
58214,3709,梁思姝,2017-08-24 08:39:31,-9,0,9,你猜 特别好的老师
58240,3709,梁思姝,2017-08-27 05:55:27,6,6,0,不管其他人怎么说，她给我没留好印象 。大二有些在说老师好，这是你们的权利 。但是我个人没有好印象，你们不能要求我们赞同你们，我们也不能要求你们。孰是孰非自会证明 。大家也没必要为她互怼，不论是好是坏都是她留给大家的印象，争吵是没有意义的。还有你们怼人不要动不动就把整个大一整个大二说进去，我们每个人只代表自己，为自己言论负责。即使整个大一或者大二只剩下一个不同声音，也不能代表整个群体 。一个群体总是有各种声音的，不要以偏概全 。对老师评价也是有各种的，也都有它的合理性，即使有情绪化掺杂
58347,3709,梁思姝,2017-08-29 05:46:30,0,0,0,太差劲
58715,3709,梁思姝,2017-09-15 11:18:14,0,0,0,2b啊
58874,3709,梁思姝,2017-09-18 07:37:12,9,10,1,看了看评论觉得挺有意思的。\n\n梁思姝给我这个16级学生的印象就是很反感，谁让她一言不合出来扮黑脸，扮的还十分不成功。训我们连的时候她自己训的话都说不利索了，有毒吗？从历届的评论看，梁思姝连续几年担任了军训期间跑来整肃纪律的黑脸，这就是一个需要在军训期间故意扮黑脸的人。我就见过她几面，但是她不是在玩手机就是训斥我们，那我怎么有什么办法对她有个好印象？和她接触时间长的当然不会对她有太多恶感。试想，难道一个人已经让周围人都觉得讨厌还能安稳地生存在这个环境里吗。而且对比军训最后她变成正常的态度和我们交流，我就更反感了。\n\n还有，比16级高年级的人可以停下你们喷的嘴吗，任何一个人都不能完全代表整个群体。愤怒更容易使一个人冲动地来到这里留下过激言论，这句话不仅适用于16级的部分学生，也适用于一些高年级的人。都是以偏概全，谁又比谁高贵？
59584,3709,梁思姝,2018-04-16 06:31:50,5,9,4,送瓜的学长组学姐看到你们这么吵感觉很心痛，希望没有自己班的孩子，，，
60140,3709,梁思姝,2017-10-11 07:53:45,7,7,0,骂人很不错
62521,3709,梁思姝,2017-11-25 16:00:31,8,9,1,中国总有这样一种人 我当年受苦了所以你们年轻人也要受苦，我年轻的时候没空调 所以你们年轻人也不应该吹空调。我年轻时挨板子所以你们年轻人也要挨板子。不是很懂这种心理
63377,3709,梁思姝,2017-12-02 03:15:47,0,1,1,提供高品质
63869,3709,梁思姝,2017-12-18 04:23:37,1,1,0,胡乱骂人
63926,3709,梁思姝,2017-12-19 13:18:31,5,5,0,个人感觉她对学生区别对待很严重，跟她熟的她可以很亲切，但对其他学生则很看心情。
64554,3709,梁思姝,2017-12-25 06:58:38,-8,1,9,老实人挺好的呀\n\n尤其是对志愿者
64619,3709,梁思姝,2017-12-25 14:38:26,0,0,0,。。不想说啥
64976,3709,梁思姝,2017-12-28 05:58:06,9,10,1,没想到有这样评价的老师竟然是浙大礼仪队的队长，简直是知人知面不知心
65063,3709,梁思姝,2017-12-28 12:18:05,0,0,0,。。。
65205,3709,梁思姝,2017-12-31 03:40:14,1,1,0,不喜欢
65486,3709,梁思姝,2018-01-04 12:10:50,7,7,0,拿跟鸡毛当令箭。智障一个
66110,3709,梁思姝,2018-01-12 01:02:39,9,10,1,一脸浓妆出卖了她的装腔作势
71895,3709,梁思姝,2018-01-29 05:13:50,11,11,0,百度百科上竟然有她的名片，这矫揉造作到了什么地步
80259,3709,梁思姝,2018-06-23 10:15:24,1,1,0,凶，难以想象
85826,3709,梁思姝,2018-08-19 10:47:13,25,25,0,时穷节乃见，一一垂丹青。平时对你们好是因为你们没有触碰她的核心利益，当你们所作所为影响她个人利益的时候，你看她们搞不搞死你。不针对她一个，我说的是学校大部分辅导员。
91278,3709,梁思姝,2018-12-05 01:05:35,11,12,1,“你在军训时，深受同学们的喜爱”
92804,3709,梁思姝,2019-01-04 13:52:16,19,19,0,这简直是给浙大礼仪队抹黑，官僚到了极致的恶心
92855,3709,梁思姝,2019-01-05 08:00:24,1,1,0,呵呵呵呵呵
92856,3709,梁思姝,2019-01-05 11:57:03,6,6,0,记得有一次指导员副联副指都在，本来大家什么事都没有，lss突然在人群前大发脾气，把指导员他们都吓蒙了。感觉她就是为了在我们面前发火而发火，莫名其妙。
92857,3709,梁思姝,2019-01-05 08:05:08,6,6,0,看到这么多人骂我就放心了
92860,3709,梁思姝,2019-01-05 08:10:49,6,6,0,再回来踩几脚，就这么简单
92863,3709,梁思姝,2019-01-05 08:20:04,1,1,0,………
92866,3709,梁思姝,2019-01-05 08:24:12,1,1,0,呵呵呵
92869,3709,梁思姝,2019-01-05 08:37:25,1,1,0,6666666
92871,3709,梁思姝,2019-01-05 08:56:45,0,0,0,暴脾气
92872,3709,梁思姝,2019-01-05 08:59:27,2,2,0,端起我的小板凳\n\n捧起我的瓜\n\n癌癌 前排挤一挤给我一个位置鸭
92874,3709,梁思姝,2019-01-05 09:07:55,0,0,0,笑里藏刀绵里藏针
92877,3709,梁思姝,2019-01-05 09:24:30,0,0,0,点点点
92882,3709,梁思姝,2019-01-05 09:42:03,7,8,1,真心劝告这位小姐姐，你颜值爆表，已迷人无数；你做事雷厉风行，有魄力，具有做大事的潜质。但是我也要奉劝你一句，没有良好的人际关系，将难以与别人有效沟通，你高挑的身材将会处处碰壁。\n\n你现在事业不错，证明你与领导关系不错。但是没有群众基础，高处的花朵，下方会是一片荆棘。\n\n你具有良好的潜质，本来我也想给你打十分；但是我还要保持和16级同学的良好关系，我只好给你打3分（不影响你的平均分）\n\n这仅代表个人之见，你可以不予理睬；正如一个人，一句话对你影响不大一样。但是久而久之，大家本来给你的10分都变成了3分，就像花瓣落在荆棘之中，个人深感可惜。\n\n也希望这位小姐姐能够重新思考一下自己。
92885,3709,梁思姝,2019-01-05 10:08:45,1,1,0,傻逼c
92887,3709,梁思姝,2019-01-05 10:36:16,0,0,0,Emmm
92893,3709,梁思姝,2019-01-05 11:25:07,1,1,0,吃瓜围观
92896,3709,梁思姝,2019-01-05 11:31:56,-6,2,8,对这位老师不太了解，但是不知道为什么会有人把焦点放在每天化妆上面，女性化妆本来就是权利，怎么还能喷到每天化浓妆上面了。可能不适合日常工作，但是这和一个人本质有什么必然关系吗？类似的难道一个女生出门穿短裙就是不自重？个人认为最好不要评价到无关的事情上去
92962,3709,梁思姝,2019-01-06 11:13:54,0,0,0,为什么要强行把16级和15级分开？如果说关于梁思姝在军训上的作为，参与军训的16级学生抱怨是个别现象，那么说个别人戾气重尚可接受。但当评论一边倒的时候，怎么可能得出是16级整体翅膀硬，戾气重的结论？\n\n      那么是不是不管他们怎么说，多少人说，总有人要建立在lss是个好老师的前提上去理解。少数人说她不好，就是少数人sb，多数人说她不好，就是集体sb。\n\n      谁sb就显而易见了。
92985,3709,梁思姝,2019-01-06 14:54:48,0,0,0,跟风打个一分
92996,3709,梁思姝,2019-01-06 17:12:04,0,0,0,踩一下
93086,3709,梁思姝,2019-01-07 08:46:22,0,0,0,。。。
102541,3709,梁思姝,2019-02-06 04:22:42,4,4,0,只有我一个人觉得她长得不好看而且看着很刻薄很可怕吗
103196,3709,梁思姝,2019-02-26 15:03:13,0,0,0,傻逼老师
107693,3709,梁思姝,2019-05-08 10:30:43,4,4,0,妈了个巴子成了我们辅导员
108543,3709,梁思姝,2019-06-19 17:00:13,0,0,0,希望把她换成蔡徐坤
117987,3709,梁思姝,2019-10-17 16:40:33,0,0,0,唉 好讨厌呢
122134,3709,梁思姝,2020-02-16 09:11:25,0,0,0,哈哈哈哈这配当我浙老师还是辅导员？趾高气昂的当自己是谁哦…
41663,3717,张云飞,2017-01-12 10:18:28,-26,12,38,叫这个名字的肯定是好老师
41666,3717,张云飞,2017-01-12 10:20:12,-33,9,42,一位很好的教官 每天进寝室和同学交流
41669,3717,张云飞,2017-01-12 10:24:36,-27,10,37,人美心善 高玩
41674,3717,张云飞,2017-01-12 10:46:22,-32,4,36,可爱的
41676,3717,张云飞,2017-01-12 10:47:56,-40,5,45,英语说的很好，经常能和我们谈笑风生
41680,3717,张云飞,2019-07-07 05:50:07,-70,5,75,人美心善，活泼，英语大神，高玩
41682,3717,张云飞,2017-01-12 10:53:39,-26,12,38,同学们亲切地称ta为飞哥
41685,3717,张云飞,2017-01-12 10:54:47,-31,5,36,但我很爱她\n\n
41703,3717,张云飞,2017-01-12 11:22:45,-35,5,40,爱你么么哒
41762,3717,张云飞,2019-07-07 05:49:44,-50,9,59,表白老师～
49671,3717,张云飞,2017-04-23 06:57:28,-31,7,38,人心善美
50014,3717,张云飞,2017-04-28 13:32:59,27,38,11,屌 丝
50807,3717,张云飞,2017-05-05 16:26:40,-34,6,40,老师能晚上陪你去喝酒
50808,3717,张云飞,2017-05-05 16:27:44,-26,1,27,?????????
50811,3717,张云飞,2017-05-05 16:31:17,-34,6,40,很关心学生 会和学生吃宵夜哦
57560,3717,张云飞,2017-07-19 23:11:24,74,81,7,你绩点低不要来找我，我们这里都是有证据的～你号码是温州的，那你就是回温州了，没有理由的～
57981,3717,张云飞,2017-07-19 10:58:41,57,62,5,拔河加方阵，最后分数很低，老师很虚伪，
58203,3717,张云飞,2017-08-22 02:07:57,-15,10,25,据说还是个90后
58668,3717,张云飞,2017-09-13 13:24:52,-30,6,36,温柔的老师
59626,3717,张云飞,2017-09-25 04:03:46,36,39,3,某省全被宰了，很棒棒哦
59907,3717,张云飞,2017-09-28 06:29:57,-30,6,36,好好好
60723,3717,张云飞,2017-11-24 12:15:50,32,37,5,则讨厌他 恨死了 超级不公平
60731,3717,张云飞,2017-11-18 10:33:57,35,39,4,好评，给一分
60946,3717,张云飞,2017-11-04 11:03:41,48,52,4,你们是忘了我的两个问题吗？一，你来浙江大学谈恋爱了吗？二，你来浙江大学戒了游戏吗？
63269,3717,张云飞,2017-11-29 16:56:19,66,69,3,虚伪，展现出了一个年轻官僚对于权力的极其强烈的欲望
64225,3717,张云飞,2017-12-21 15:52:01,36,39,3,雇人刷分有意思嘛？
64483,3717,张云飞,2017-12-24 12:11:24,40,42,2,伪君子 一心想往上爬
64948,3717,张云飞,2017-12-28 04:34:56,30,33,3,绩杀绩杀
65049,3717,张云飞,2017-12-28 10:57:33,38,40,2,找人刷分有意思吗？
65131,3717,张云飞,2017-12-29 05:28:06,22,30,8,老师超级好(评论一条，截图发送，可领五元红包)
65165,3717,张云飞,2017-12-30 00:13:24,30,33,3,自以为很懂我们的人，其实根本不懂。有点没意思的老师。
65168,3717,张云飞,2017-12-30 01:27:17,33,35,2,求求您，事少点
65169,3717,张云飞,2017-12-30 01:44:53,57,59,2,为什么没有负分？且不谈我个人被绩杀，我全省被绩杀，他吃饭的时候叫大家给他刷十分(有偿？)就足以见其人品，虚伪官僚的让我这个还在象牙塔的大一学生充分见识到了社会的复杂，我曾直接正面问他绩杀原因，他含糊其辞后说了些什么十月底或十一月专业面试他也会在场！exm？您是我终身的老师，感谢您教我做人?
65170,3717,张云飞,2017-12-30 02:02:46,27,30,3,有毒。\n\n
65172,3717,张云飞,2017-12-30 02:17:51,47,50,3,呵呵，跟他有交集你会学会很多，首先学会做人，然后学会如何拍马屁往上爬，最后学会不抱大腿最终是会绩杀的。军训不按功劳给分，看脸和关系，扯起八卦事可以扯到大半夜不让学生睡觉，一边还使个劲的给大家灌输“党性”。谢谢飞哥教我做人，感激不尽
65173,3717,张云飞,2017-12-30 02:55:27,37,41,4,是我见过的话最多的男的
65184,3717,张云飞,2017-12-30 08:41:43,40,41,1,真是让我看到了年轻官僚对权力的极大欲望，绩点不能说低，但是纯论人，他真的让我大开眼界
65679,3717,张云飞,2018-01-19 05:01:31,43,48,5,nmsl
65680,3717,张云飞,2018-01-08 08:01:11,28,30,2,太特么爽了
65681,3717,张云飞,2018-01-08 08:01:51,33,35,2,垃圾 毁我青春
65683,3717,张云飞,2018-01-08 08:10:13,44,44,0,头皮发麻
65687,3717,张云飞,2018-01-08 08:34:37,48,49,1,官僚主义的垃圾
67116,3717,张云飞,2018-01-20 09:44:13,31,32,1,无fk说
71709,3717,张云飞,2018-01-29 01:32:27,37,41,4,找人刷分的8.91终于掉下去了吧？
74459,3717,张云飞,2018-02-26 14:04:39,-32,2,34,老师人不错
74931,3717,张云飞,2018-03-06 13:19:23,49,50,1,千方百计打探别人家庭背景和恋爱状况，疑心很重，经常请学生吃饭别有用心，如果没有按照他的意愿办事，就会各种揣测扣帽子，分分钟把你逼死… 形式主义和官僚主义，会拿奖学金和助学金的名义强迫别人做事，自认为有权利且擅长各种人际利用…… 经典的官场虚伪
76418,3717,张云飞,2018-04-08 14:28:32,26,28,2,欺软怕硬 假面虚伪
78967,3717,张云飞,2018-05-18 05:46:35,27,30,3,1分，这种垃圾滚出浙大
78983,3717,张云飞,2018-06-08 17:10:33,26,29,3,我从未见过如此厚颜无耻之人
79385,3717,张云飞,2018-06-02 14:28:32,32,34,2,现在骂张云飞还有赞吗？
79505,3717,张云飞,2018-06-07 08:33:42,27,28,1,同志们，每天都可以给一次一分噢
79569,3717,张云飞,2018-06-10 03:25:45,36,36,0,喜欢上纲上线，给人扣帽子
79879,3717,张云飞,2018-06-14 20:24:45,23,26,3,虚伪愚蠢，真当官就是奸臣
80716,3717,张云飞,2018-06-29 14:50:21,23,24,1,nmsl
82226,3717,张云飞,2018-07-07 13:38:07,32,34,2,身为辅导员不想着好好为学生办事，只想着把学生当做可利用的资源???
85737,3717,张云飞,2018-07-31 15:47:25,20,21,1,这傻逼贼坑
85754,3717,张云飞,2018-08-02 08:20:42,17,20,3,就是个垃圾
85760,3717,张云飞,2018-08-03 14:47:42,38,38,0,公开的秘密：和他搞好关系给他干活保研综素可以帮你加分噢~没做过的项目搞份申请书结题表什么的完全不是问题呢~
86149,3717,张云飞,2018-09-08 07:42:20,14,15,1,nmsl
86301,3717,张云飞,2018-09-12 15:45:12,21,21,0,小人一个
88260,3717,张云飞,2018-10-25 06:54:49,18,18,0,为什么没有负分
88865,3717,张云飞,2018-11-10 19:57:22,15,17,2,nmsl
91273,3717,张云飞,2018-12-04 16:04:27,16,18,2,哈哈哈哈哈，恶心
91730,3717,张云飞,2018-12-19 03:01:42,21,32,11,给分厚道徐小洲 制度合理林建华 尊重学生孙大雁 亲切友善祝秀香 从不绩杀陈昆福 分多事少陈素珊 知识广博看沈燎 讲话生动吴朝晖 声音洪亮陶虹向 为人实在张云飞 做事靠谱是梅玫
93193,3717,张云飞,2019-01-08 05:40:34,22,24,2,老子的奖学金是从你口袋里出的吗？不过是替学校申报统计的中间办事员而已，凭什么拿奖学金和助学金的名义强迫学生参加各种需要凑人数的活动以及给你服务干活？不参加就要被扣上忘恩负义、精致的利己主义者的帽子?不知道哪里来的自信把它当权力使，溜得一匹……md尽管毕业了想起来还是一肚子火
94705,3717,张云飞,2019-01-18 02:30:29,16,18,2,老师您是脑子里有屎吗？本来微积分考试时间就紧张，您哇啦哇啦讲了十分钟？
104425,3717,张云飞,2019-03-20 05:12:29,18,18,0,看了一下评论区，感觉就是男版xy。
104443,3717,张云飞,2019-03-20 16:32:22,12,15,3,我觉得辅导员里 女的得看许怡 男的得看张云飞  都好好学学！
104456,3717,张云飞,2019-03-21 02:38:16,0,5,5,铁憨憨\n\n
104593,3717,张云飞,2019-03-24 17:46:00,17,19,2,哈哈 官微发文瞬间掉分
104705,3717,张云飞,2019-03-26 08:13:07,15,17,2,nmsl
104720,3717,张云飞,2019-03-26 11:17:37,14,17,3,垃圾东西
104945,3717,张云飞,2019-03-31 15:18:24,16,16,0,nmsl
105183,3717,张云飞,2019-04-06 14:27:55,22,23,1,飞狗和贿选北大学生会主席的戴威相比，唯一的区别就是:戴威用家里的钱，飞狗贿选用公款用的美滋滋！就这一点，飞狗比戴威不知道高到哪里去了！！
109145,3717,张云飞,2019-06-10 05:26:13,18,19,1,呵呵…见过最恶心的辅导员。官僚主义，溜须拍马，利用学生，套近乎，讲空话，弄虚作假，拿奖学金压迫，傻逼
109219,3717,张云飞,2019-06-12 03:53:48,16,17,1,就这么说吧，飞哥参加项目答辩不看项目看人的，找个脸熟的上去一答一个稳（手动狗头
109294,3717,张云飞,2019-06-24 02:53:21,29,30,1,人间sb sx sd\n\n并且提醒往来的人们学生工作啊但凡有涉及到的不要垫钱，别自己以为应付得来\n\n\n\n因为这种?不是他自己的钱哦，报销一拖再拖，据我所知关于做学生助理啊兼职辅导员啥的钱也是一拖再拖的，都不知道钱挪到哪里去了……得奖学金也会要求你参加各种事情哦，因为这个奖学金美其名曰是它给的哦\n\n\n\n关于钱的事情，大家自己注意吧，涉及钱的事情，它能让你花呗都还不起。\n\n\n\n
109299,3717,张云飞,2019-06-13 03:23:27,13,16,3,张口就来，官僚主义的嘴脸无疑。和他关系好即使表现差，专业里的lj也能拿奖入党巴拉巴拉的。优秀的辅导员。
109868,3717,张云飞,2019-06-20 02:22:14,13,14,1,风评这么差的辅导员不换是没人用了吗？
110040,3717,张云飞,2019-06-21 14:00:25,17,17,0,因为奖学金的事被举报到学校了，然而看现在的情况没啥用啊
110105,3717,张云飞,2019-06-23 03:31:31,15,17,2,hhhhh傻逼玩意儿我只说一次，这样都混的风生水起怕不是背后有人?
113274,3717,张云飞,2019-07-06 03:31:45,18,19,1,就是个?*
113798,3717,张云飞,2019-07-07 15:03:24,10,13,3,人间? 8⃣
114698,3717,张云飞,2019-07-11 04:15:30,14,15,1,一分都不想给好么呵呵傻逼
117674,3717,张云飞,2019-09-28 16:06:01,8,8,0,追名逐利
117979,3717,张云飞,2019-10-17 10:44:26,11,13,2,升官了 去校长办公室了
132061,3717,张云飞,2021-01-30 05:00:25,9,9,0,只要骂这b玩意儿，咱们就是亲兄弟亲姐妹
183204,3717,张云飞,2023-11-23 00:20:40,-2,1,3,sb一个
205068,3717,张云飞,2024-11-30 14:54:00,1,2,1,nmsl，愁煞弼
