评论id,老师id,老师姓名,发表时间,点赞减去点踩数量,点赞量,点踩量,内容
56,106,陈昆福,2018-08-26 06:11:02,295,345,50,给分坑得不行
475,106,陈昆福,2015-03-15 03:02:07,75,81,6,给分坑
508,106,陈昆福,2015-03-15 03:41:21,91,105,14,分坑 慎选
969,106,陈昆福,2015-03-19 16:24:54,67,72,5,给分坑
1453,106,陈昆福,2015-03-22 04:54:47,-136,26,162,满绩路过，难道我是那幸运的登分出错的1％？上课确实无聊，也不是很友善，给2分。
1798,106,陈昆福,2015-03-25 04:41:07,166,190,24,给分神坑，论文奇葩，孙杨的老师就是任性！\n\n
2372,106,陈昆福,2015-04-27 13:55:21,71,76,5,不负责任给分的老师
2946,106,陈昆福,2015-05-11 11:57:03,58,65,7,给分超级坑，上课也无聊
3863,106,陈昆福,2015-08-31 03:14:59,51,54,3,不负责任给分的老师，\n\n
4220,106,陈昆福,2015-06-18 06:50:07,32,37,5,坑
4424,106,陈昆福,2015-06-22 16:36:27,122,133,11,就知道吹吹牛，没什么干货，给分还低
4933,106,陈昆福,2015-07-01 07:13:31,-131,27,158,为什么大家都说坑呢？满绩飘过~
5073,106,陈昆福,2015-07-03 08:27:06,49,58,9,垃圾，装逼，给分坑
5669,106,陈昆福,2015-07-09 05:51:48,97,114,17,上课其实挺无聊的，莫名其妙一个人在那里慷慨激昂，给分再次刷新了我的课程最低分下限（不是平均）
5709,106,陈昆福,2015-07-09 07:45:18,28,33,5,从来不听
5714,106,陈昆福,2015-07-09 07:49:01,43,47,4,坑
5779,106,陈昆福,2015-07-09 10:25:26,39,44,5,大坑
6094,106,陈昆福,2015-07-11 00:43:15,29,31,2,这特么
6133,106,陈昆福,2015-07-11 05:52:21,40,47,7,不说了，不在乎绩点的可以上
6708,106,陈昆福,2015-07-19 09:02:15,34,38,4,傻逼老师
6873,106,陈昆福,2015-07-27 12:34:03,62,67,5,坑 绩杀 还登错分 给了我0分
6939,106,陈昆福,2015-08-21 16:59:18,76,85,9,怎么没有0分这个选项
7197,106,陈昆福,2015-09-10 10:24:54,52,62,10,傻逼老师 毁我青春
7236,106,陈昆福,2015-09-12 03:44:36,14,20,6,坑
7302,106,陈昆福,2015-09-13 09:06:02,230,252,22,不要相信绩杀改过自新的话
7341,106,陈昆福,2015-09-14 01:34:43,23,25,2,上不了3
7405,106,陈昆福,2015-09-14 08:18:12,-35,2,37,好
7415,106,陈昆福,2015-09-14 09:04:01,19,25,6,傻逼老师，自顾自讲话，自顾自傻笑
7439,106,陈昆福,2015-09-14 11:26:55,16,20,4,无聊！没听过！上课从来都是戴耳机写作业    耳机都挡不住他自嗨讲课的声音。。给分低
7451,106,陈昆福,2015-09-14 12:16:55,-35,5,40,很幽默，上课很有意思
7535,106,陈昆福,2015-09-15 02:47:50,12,28,16,听说姓陈的可以满绩
7595,106,陈昆福,2015-09-15 06:20:48,35,38,3,大学第一门通识，只想说SB老师
7644,106,陈昆福,2015-09-15 07:24:11,12,15,3,超坑的
7680,106,陈昆福,2015-09-15 08:35:59,22,25,3,巨坑 各种坑
7691,106,陈昆福,2015-09-15 09:13:22,-45,2,47,给力\n\n
8081,106,陈昆福,2015-09-17 02:30:45,6,11,5,就是一sb\n\n
8581,106,陈昆福,2015-09-22 17:16:09,-29,2,31,比较幽默。
8649,106,陈昆福,2015-09-23 13:33:12,15,18,3,不知道是他坑还是助教坑
8668,106,陈昆福,2015-09-24 01:10:40,39,44,5,看到这么多人骂我就果断决定退课了
9645,106,陈昆福,2015-11-03 15:46:14,11,17,6,就知道吹逼，写的书还要当作教材，没什么干货，上课时间最好还是拿来自习，但要小心突击的点名（例如国庆前最后一节课）
9672,106,陈昆福,2015-11-04 07:09:52,-37,2,39,老师讲课比较激动，虽然学生不跟他一起嗨⋯给分的话我还好吧，论文题目比较奇葩
9845,106,陈昆福,2015-11-11 03:25:20,4,10,6,绩杀啊……
10398,106,陈昆福,2015-11-18 11:51:40,15,18,3,呵呵呵
10411,106,陈昆福,2015-11-18 13:07:14,13,17,4,给分巨坑爹，sb老师
10413,106,陈昆福,2015-11-18 13:29:08,-24,4,28,老师很逗，讲的许多东西也特别有内涵。偶尔会听不清在说什么，重点是给我的分还不错
10421,106,陈昆福,2015-11-18 14:17:25,12,14,2,sbsb
10479,106,陈昆福,2015-11-19 04:47:15,13,16,3,……传说中的制作ppt的个人论文满分呢？我们几个制作ppt的人分数这么低……
10508,106,陈昆福,2015-11-19 10:07:54,-34,1,35,interesting
11030,106,陈昆福,2015-11-24 02:31:23,8,11,3,给分坑，绩杀
11204,106,陈昆福,2015-11-25 07:13:11,14,15,1,超坑！
11460,106,陈昆福,2015-12-02 04:40:54,40,46,6,国庆前，下大雪两次突击检查全到，62
12380,106,陈昆福,2015-12-24 03:53:38,5,8,3,哈哈哈
12429,106,陈昆福,2015-12-23 09:05:11,26,28,2,遇见最坑的老师，没有之一，上课吹逼，还事多，给分极低，满满的绩杀，大一终结者
12521,106,陈昆福,2015-12-23 11:58:56,-37,2,39,我不管我就是喜欢他
12563,106,陈昆福,2015-12-23 13:23:53,21,23,2,傻逼弄个粑！期末看名字给分
12696,106,陈昆福,2015-12-24 02:10:02,7,10,3,没内容，上课一半时间在看电影，讲得也不明所以，想水的别来了，不想水的也谨慎。
12878,106,陈昆福,2015-12-24 07:17:10,26,31,5,什么东西啊！给我们放了大半学期的视频，上课一个人在那里嗨，讲的什么鬼都不知道，莫名其妙来次点名，没来的统统扣5分，自己不知道缺课几次了，怎么会有这种老师
13065,106,陈昆福,2015-12-24 16:40:50,5,9,4,坑坑坑\n\n
13102,106,陈昆福,2015-12-25 01:21:18,5,8,3,垃圾坑
13434,106,陈昆福,2015-12-28 03:50:59,8,10,2,……不说了
13497,106,陈昆福,2015-12-28 12:49:12,15,16,1,无话可说
13674,106,陈昆福,2015-12-30 09:55:11,13,15,2,大学以来最想吐槽的课。简直浪费生命…
14508,106,陈昆福,2016-01-07 09:54:16,3,5,2,容我吐会儿血，此所谓sha人于无形……
14951,106,陈昆福,2016-01-21 14:19:49,-39,2,41,满绩哦！！！！
14966,106,陈昆福,2016-01-11 10:01:05,-25,1,26,还可以
14984,106,陈昆福,2016-01-11 11:44:02,0,1,1,…呵呵\n\n
14987,106,陈昆福,2016-01-11 11:58:42,1,1,0,呵呵哒
15435,106,陈昆福,2016-01-14 11:12:31,1,2,1,一般吧
15643,106,陈昆福,2016-01-16 02:51:43,14,16,2,不要相信绩杀改过自新的话
16115,106,陈昆福,2016-01-17 08:46:15,6,7,1,分还没出，只能说，上课很无聊
16772,106,陈昆福,2016-01-21 07:38:27,8,11,3,居然说给大家及格就好，最多80
17502,106,陈昆福,2016-01-20 10:12:54,-24,1,25,好好好
18038,106,陈昆福,2016-01-21 07:09:17,-28,2,30,我绩点还行吧4.1
18055,106,陈昆福,2016-01-21 07:13:23,4,4,0,呵呵哒！被杀了就知道为什么给1分！
18065,106,陈昆福,2016-01-21 07:17:46,4,4,0,吹吹吹
18069,106,陈昆福,2016-01-21 07:19:42,5,5,0,想水过的可以选，但期末分不会高啊
18071,106,陈昆福,2016-01-21 07:20:01,-31,3,34,其实陈老师还是很好的，我很尊敬他的
18072,106,陈昆福,2016-01-21 07:20:05,2,3,1,无语了
18078,106,陈昆福,2016-01-21 07:23:48,0,2,2,关键时刻点名
18087,106,陈昆福,2016-01-21 07:31:02,3,5,2,给分坑
18090,106,陈昆福,2016-01-21 07:36:10,-27,6,33,给分还行吧 没有绩杀那么严重。也许他真的“改过自新”了？！放了好几堂的电影，上课讲的还行吧不过我一般都在做作业大一最水的课。最后认真写了一篇6000+的论文
18098,106,陈昆福,2016-01-21 07:40:54,-26,2,28,论文写到8000 别被点到人不在 上课不听考前抱书 可以4.5.....上课一节课讲一节课看电影
18108,106,陈昆福,2016-01-21 07:48:08,1,3,2,最低就1分，没办法
18114,106,陈昆福,2016-01-21 07:53:30,3,4,1,反正学不到跟考试有关的东西
18122,106,陈昆福,2016-01-21 08:00:01,1,2,1,并不知道有什么好听的，不要看你最后考多少，他都会坑死你
18123,106,陈昆福,2016-01-21 08:01:17,2,2,0,无重点，给分超级坑
18126,106,陈昆福,2016-01-21 08:02:39,11,15,4,如果有零分这个选项我会给的点名都到了论文认真写 有一篇还是手写上课也不知道在干什么 经常说我还有事就先走了 大家看看军事片好了 相互体谅
18131,106,陈昆福,2016-01-21 08:03:58,3,4,1,上课挺无聊的  感觉师生都在完成任务
18192,106,陈昆福,2016-01-21 09:01:56,-20,4,24,讲的还可以，这学期说好不当绩杀，应该是真的吧？作业挺少的，期末考翻书翻书翻书翻书就可以。。
18238,106,陈昆福,2016-01-21 10:23:36,7,9,2,傻逼中的战斗机，讲课讲的烂算了，给分也这么烂，辛辛苦苦一学期，论文写得多，上课也都去，最后照样低的一逼。能选别人就别选他。
18246,106,陈昆福,2016-01-21 10:30:42,2,2,0,日了狗了才选上他的课
18295,106,陈昆福,2016-06-27 14:09:35,4,4,0,讲课无聊，什么都不懂瞎逼逼。动不动就提前离开，给分贼坑。
18306,106,陈昆福,2016-01-21 12:01:36,1,4,3,刷新最低分
18308,106,陈昆福,2016-01-21 12:15:09,-22,2,24,上课很有激情，讲得不错，貌似。。。今年改邪归正了
18315,106,陈昆福,2016-01-22 09:56:01,-44,3,47,骂老师的都不对。。。满绩飘过～\n\n老师不错的啦，很棒的一位老师，可以听听他的课。
18325,106,陈昆福,2016-01-21 12:45:36,2,3,1,怎么给分的啊！！！
18336,106,陈昆福,2016-01-21 12:53:54,-26,1,27,其实讲的挺好的....
18341,106,陈昆福,2016-01-21 12:59:35,3,5,2,上课就是各种吹自己，课讲的超级烂。我们班的课缺了三次，都是放电影糊弄过去。给分也坑。
18389,106,陈昆福,2016-01-23 05:21:48,0,3,3,给分是个大坑
18406,106,陈昆福,2016-01-21 14:38:17,1,3,2,呵呵呵呵
18412,106,陈昆福,2016-01-21 14:44:22,1,3,2,因缺斯汀  不要选就对了
18501,106,陈昆福,2016-01-22 00:28:53,2,5,3,傻b老师，给分超级坑，专业歧视，偏爱国防生。
18969,106,陈昆福,2016-01-23 01:07:35,3,4,1,不想说话。。。
19178,106,陈昆福,2016-01-23 11:46:48,2,3,1,一般般
19348,106,陈昆福,2016-01-24 02:38:49,10,12,2,老师我真心觉得你既然做不到又为什么冠冕堂皇做保证，明明知道大一同学需要绩点选专业你却又故意这样，有什么意思。我自己低就算了全班同学都低你至于吗，实在是太贱了
19997,106,陈昆福,2016-01-26 00:59:32,2,3,1,给分神坑啊！
20538,106,陈昆福,2016-01-28 08:32:50,4,4,0,给分坑，军理顺利成为我所有科绩点最低的
20712,106,陈昆福,2016-01-30 06:28:42,4,6,2,教室很暖和
20854,106,陈昆福,2016-02-02 09:46:28,4,4,0,给分你懂得
20983,106,陈昆福,2016-02-06 16:01:05,1,3,2,虽然点名其实也没什么乱卵用，恐怕他打分是摇骰子，sb老师
21211,106,陈昆福,2016-02-26 09:06:41,2,3,1,不想骂人，好自为之吧
21413,106,陈昆福,2016-02-28 15:30:32,5,8,3,没上过，但看评论那么惊天动地果断退课。。。只是来看评论的
21659,106,陈昆福,2016-02-29 12:49:13,2,4,2,真心～不想听
21707,106,陈昆福,2016-03-09 03:58:20,4,5,1,呵呵呵
21911,106,陈昆福,2016-03-01 15:10:38,6,7,1,无机的张老师都比他好多少都不知道
21914,106,陈昆福,2016-03-01 15:17:49,3,5,2,大无畏的牺牲还是别来强求我\n\n
21942,106,陈昆福,2016-03-02 01:10:11,4,5,1,垃圾垃圾
22014,106,陈昆福,2016-03-02 05:55:03,-14,7,21,爽~真心好老师
22015,106,陈昆福,2016-03-02 05:54:46,-26,6,32,楼上说的不切实际，老师还是很不错的，至少我选了老师的所有课程，讲得好，给分高，我心目中的典范
22030,106,陈昆福,2016-03-02 06:13:46,4,6,2,辛苦一个学期！分还不高！
22147,106,陈昆福,2016-03-02 14:29:29,-29,3,32,没见过比这更负责任的评分，学校最渊博的老师！
22148,106,陈昆福,2016-03-02 14:32:03,35,37,2,只要你姓陈并且体型相近就可以满绩
22244,106,陈昆福,2019-01-07 08:48:18,-55,12,67,希望你们不要因为评论对陈老师有偏见。\n\n那些说课水的，我想微积分啥的不水的课总该满绩了吧，interseting.\n\n其实认真听陈老师讲真的很好。\n\n那些说他绩杀的。我敢说是你自己没好好学。\n\n至少上个学期。陈老师平时分打的很高。我敢说绝对比大多数老师的高。
22342,106,陈昆福,2016-03-04 01:14:07,5,6,1,超级坑的人，一学期的军事理论课有三次没来上课，来上课了也就是吹自己，然而并没有多厉害，吹个毛线。论文也是奇葩，给分更不用说了。
22382,106,陈昆福,2016-03-04 04:50:09,2,4,2,傻逼老师
22486,106,陈昆福,2016-03-07 01:55:45,-24,0,24,老师挺好的啊
22752,106,陈昆福,2016-03-10 14:53:58,5,6,1,口音好重!听不懂。连他说的作业是神马都听不懂!
24069,106,陈昆福,2016-04-26 12:57:50,3,3,0,每天装逼，给分低得不行。
24278,106,陈昆福,2016-04-29 05:02:58,7,8,1,傻逼老师，老子考试明明基本都找出来了，论文他妈也写这么认真，分怎么还这么低，不会真因为我不姓陈吧。。。。真是绩杀
25259,106,陈昆福,2016-05-09 05:03:11,3,3,0,差评哦
25481,106,陈昆福,2016-05-22 12:13:09,8,9,1,煞笔煞笔煞笔，尼玛连作业是什么都说不清，还在那慷慨陈词，不想上课直接放电影，尼玛电影还特么卡的不能看，只会吹逼，动不动让写个小论文，还特么要手写，你特么告诉我手写军理是一种什么体验！
25842,106,陈昆福,2016-06-11 14:36:39,0,1,1,。。。。
26145,106,陈昆福,2016-06-16 06:04:24,-22,1,23,只有我觉得军理考得也没有很好论文貌似也写到雷区还有4+的么
26164,106,陈昆福,2016-06-20 14:53:19,4,4,0,渣渣老师
26305,106,陈昆福,2016-06-16 16:47:27,2,3,1,老师是理科生出身。老师又红又专。但老师讲话稍欠逻辑，个人主观情绪附加太多。
26882,106,陈昆福,2016-06-21 12:46:34,5,5,0,给分差
26891,106,陈昆福,2016-06-21 13:09:47,7,8,1,就知道吹牛逼，还要杀光所有日本人。\n\n傻逼一个。\n\n
27011,106,陈昆福,2016-06-22 07:04:01,5,5,0,垃圾，黑
27104,106,陈昆福,2016-06-23 02:34:38,3,4,1,给分坑啊
28259,106,陈昆福,2016-06-28 08:26:39,5,6,1,我大三结束了，路过这里忍不了要骂他，给分这么坑，垃圾老师
28424,106,陈昆福,2016-06-28 08:56:47,3,3,0,真的差，上课超级无聊，看个电影下课都没了……我只想去上个厕所
28646,106,陈昆福,2016-06-28 11:28:37,7,8,1,上课一个人自娱自乐，自己都说不讲书本知识，考试要考书本知识，莫名其妙会傻笑。。。学期初会说不再当绩杀要改过自新，绝对不要相信。还是去隔壁听吕强吧。。
29162,106,陈昆福,2016-06-29 10:13:31,6,6,0,认真完成作业准备考试，收获了该学期最低分
29779,106,陈昆福,2016-06-30 10:02:51,6,7,1,差 看似和蔼 实则敷衍
30004,106,陈昆福,2016-06-30 17:04:08,4,6,2,诶 长叹一声 别选就对
30396,106,陈昆福,2016-07-01 13:11:57,7,7,0,智障老师\n\n
31268,106,陈昆福,2016-07-03 13:51:47,3,5,2,老师讲课倒还算好（不过也没什么人听…），只是给分实在太坑…
31429,106,陈昆福,2016-07-04 02:05:44,4,6,2,不知道我是特例，还是我要求低……3.6我已经满意了……毕竟上课也没认真听过…这分数可以了……
32048,106,陈昆福,2016-07-05 13:21:57,4,4,0,呵呵呵
32427,106,陈昆福,2016-07-06 16:40:59,4,4,0,预置他的课，果断退掉重选
32432,106,陈昆福,2016-07-06 18:51:08,2,3,1,哈哈哈哈蛤蛤?
32658,106,陈昆福,2016-07-09 00:21:04,2,3,1,2次小论文，1个期末大论文，再加一次课程展示。你没听错，这是军理。\n\n能退就赶紧退，实在退不了就去当小组长，组长的分数还能看的过去，就是忙点
32980,106,陈昆福,2016-09-08 14:58:45,6,8,2,据说打分是助教打。我们这个班人少，有次他有事让助教给我们看视频然后只通知了班长后来那节课领导抽查没来的那些人期末反而比来的人分数高呵呵
33022,106,陈昆福,2016-09-10 05:31:27,3,3,0,上课听他装逼。
33087,106,陈昆福,2016-09-12 09:43:32,3,3,0,不咋地
33233,106,陈昆福,2016-09-16 04:42:26,-4,1,5,一定程度
34181,106,陈昆福,2016-09-28 03:20:57,4,5,1,超级坑
35798,106,陈昆福,2016-11-10 08:13:10,0,2,2,
38311,106,陈昆福,2016-11-30 00:15:39,5,5,0,害人不浅
38471,106,陈昆福,2017-01-17 03:38:22,25,28,3,听学长一句劝，不要选他的课，可以吗？\n\n如果你选了他的课，请不要退，好吗？
40191,106,陈昆福,2016-12-30 01:35:39,-37,4,41,老师讲课太棒了，声情并茂，堪比赵晖，给分超好的
41154,106,陈昆福,2017-01-09 14:00:16,3,5,2,当我听说他为什么是绩杀之后我觉得这种人根本不配当老师
43729,106,陈昆福,2017-01-17 01:40:16,4,4,0,明明觉得自己完成挺好，唉
43732,106,陈昆福,2017-01-17 01:46:47,2,3,1,saber
43743,106,陈昆福,2017-01-17 02:11:44,3,4,1,神老师
43784,106,陈昆福,2017-01-17 03:06:52,7,7,0,军理被陈昆福谋杀
43822,106,陈昆福,2017-01-17 04:27:26,7,7,0,别说了开卷考书上全找到了论文观后感全写了评分只有2.7我就呵呵呵呵了
43889,106,陈昆福,2017-01-17 05:40:57,1,3,2,学不到什么  建议别选
44535,106,陈昆福,2017-01-18 02:34:44,2,3,1,没听过
45241,106,陈昆福,2017-01-19 07:59:41,2,3,1,真是没见过这种老师，为什么他还在上课
45968,106,陈昆福,2017-01-20 10:05:05,3,4,1,绩杀不多说，整组被杀，一门通识课所有课里面最低，大家掂量掂量
46932,106,陈昆福,2017-01-23 03:27:14,3,4,1,二流高中感觉
47906,106,陈昆福,2017-02-27 08:17:55,4,5,1,瞎BB
48346,106,陈昆福,2017-03-02 08:22:27,-36,3,39,为啥我是4点2
48353,106,陈昆福,2017-03-02 09:12:18,3,3,0,傻逼老师，
48389,106,陈昆福,2017-03-02 16:21:57,175,192,17,我是组长，平时分满分，最后69分，问为什么这么低，说我卷面44分。我掐指一算，开卷考试+只有选择填空+全部书上找得到，这样还能卷面44的，这种人的智商应该考不上浙大吧?
51357,106,陈昆福,2017-06-01 13:08:17,1,2,1,想死掉
51415,106,陈昆福,2017-06-05 07:20:03,5,5,0,每日一分
51993,106,陈昆福,2017-06-14 04:54:38,1,2,1,不好，差评！
52193,106,陈昆福,2017-06-15 16:25:53,3,4,1,每日一分
54322,106,陈昆福,2017-06-29 05:55:21,2,2,0,大傻逼！
54854,106,陈昆福,2017-06-30 10:19:58,1,1,0,只想说没有遇到过更渣的老师
55790,106,陈昆福,2017-07-02 11:22:52,-4,0,4,还行吧\n\n考试好就行了
56430,106,陈昆福,2017-07-03 20:34:38,0,2,2,哈哈哈哈
56727,106,陈昆福,2017-07-04 12:42:17,2,2,0,给分真不想说…
56772,106,陈昆福,2017-07-04 14:56:57,59,70,11,老师会开很多讲座，如果你去了，会加分的哦~一定要去哦~不管你有没有兴趣，你不去别人去结果你懂的~\n\n小组论文大家是平均的，就算你划划水，组长在群里安排任务，装死就好，什么都不做，还能窃取别人的劳动成果，岂不美滋滋？组长能有什么办法？\n\n绩点什么的就不要想啦~你们都是大一的学生，需要绩点，老师也会给很高的！我2.7已经很高啦~毕竟老师开学承诺不绩杀，2.7真的很高啦~\n\n考试书都查的到！但是你能考几分连标准答案也不知道！\n\n
56814,106,陈昆福,2017-07-04 16:19:26,0,9,9,今年的给分还不错啊 课上的事情也少 就一个小组展示和个人小论文 绩杀改过自新了？
56876,106,陈昆福,2017-07-05 02:06:54,4,6,2,傻子老师
57437,106,陈昆福,2017-07-07 17:39:02,4,5,1,什么都学不到
58699,106,陈昆福,2017-09-15 05:43:08,2,3,1,垃圾老师毁我青春
58981,106,陈昆福,2017-09-19 03:38:10,-2,1,3,凑字数
59030,106,陈昆福,2017-09-19 07:10:08,-2,3,5,今年给分还不错？上课的确喜欢装逼，事情不多吧。
59417,106,陈昆福,2017-09-21 08:13:15,4,4,0,吹牛逼，三观……
59499,106,陈昆福,2017-09-22 02:29:45,4,4,0,无言以对
60203,106,陈昆福,2017-10-13 01:16:46,14,18,4,陈昆福:清华北大是卖国大学，清华是耻辱大学\n\n清华北大:喵喵喵?
64441,106,陈昆福,2017-12-23 16:10:42,3,3,0,啊呸呸
65035,106,陈昆福,2017-12-28 10:03:55,5,5,0,楼上说的是，听他的课会给人一种浪费生命的感觉
65092,106,陈昆福,2017-12-28 15:43:31,13,14,1,上课说着说着自己说:我讲课也没什么意思，然后给我们放了电影，他自己翘课走了，走了？
65097,106,陈昆福,2017-12-29 00:16:29,5,5,0,求求你把痰吐干净再来上课吧
65270,106,陈昆福,2018-01-02 07:50:00,0,2,2,凑热闹。
65399,106,陈昆福,2018-01-03 15:06:41,10,11,1,无故发脾气！作业要求变态！论文字数多到爆！给分超低！上课学不到东西！
66050,106,陈昆福,2018-01-11 07:37:20,-28,2,30,老师上课说的很有启发性\n\n就算给我挂掉，我还是会来上
66063,106,陈昆福,2018-01-11 08:51:07,20,20,0,我要给25分\n\n\n\n胸怀才是最重要的
66065,106,陈昆福,2018-01-11 09:04:29,5,7,2,吹牛逼一绝，装逼一绝
71783,106,陈昆福,2018-01-29 03:05:05,6,6,0,不建议选
71806,106,陈昆福,2018-01-30 01:31:30,489,522,33,大咖好，我系陈昆福。贪玩尊理，介系里没有上过的船新版本，几需体验三番种，理就会像别人一样，爆掉介门课勤。来，拉里进群，是战友，今晚就来砍我！
71815,106,陈昆福,2018-01-29 03:43:15,6,8,2,给分真服了他了，怎么能昧着良心给这么低的绩点。
71819,106,陈昆福,2018-01-29 03:56:08,5,6,1,mmp，真的别选，付出得不到回报的
71820,106,陈昆福,2018-01-29 03:56:26,6,7,1,大绩杀
71828,106,陈昆福,2018-01-29 04:02:34,12,13,1,什么老师，上课不行，给分更是坑的不行，2.1，不要心存侥幸，这老师就是个绩杀
71832,106,陈昆福,2018-01-29 04:09:43,9,10,1,给1分是不能打0分，绩杀恐怖如斯
71837,106,陈昆福,2018-01-29 04:16:46,3,5,2,建议暴毙
71839,106,陈昆福,2018-01-29 04:21:21,11,12,1,求求你们别因为周五只有一个老师就选他的课
71844,106,陈昆福,2018-01-29 04:28:02,4,6,2,看电影是拿分换来的。
71870,106,陈昆福,2018-01-29 04:56:52,8,10,2,如果你相信他不会绩杀了，那你就上当了
71872,106,陈昆福,2018-01-29 04:58:40,1,2,1,差死了
71877,106,陈昆福,2018-01-29 05:03:02,1,2,1,。。。
71882,106,陈昆福,2018-01-29 05:16:02,12,16,4,节节课坐前三排，上课认真听，小论文认真写，小组展示是全班做得做好的一个，考试开卷全都能翻得到，，，，2.7？？？黑人问号脸。。
71896,106,陈昆福,2018-04-16 09:05:00,30,32,2,每节课都去了（还是冬天第一节），论文认真写了，小组作业评分还好，期末开卷大多查到了。但实际只有68，2.4的绩点。听说姓陈的分会好一点。我还有什么好说的。不去上课的分都比我高！！！\n\n垃圾！！！！！！！！！！！！！！！！
71913,106,陈昆福,2018-03-31 11:56:20,185,202,17,垃圾中的战斗机，王八蛋中的混账王九蛋。眼睛一百度，戴个眼镜说看起来斯文；怕是后面少了败类两个字，一大把年纪，围个大红色的围巾，丑到让人一眼暴毙；肥胖的身材，一个过道感觉都要侧身过，你一天要消耗多少粮食啊；这些其实都不是事。主要是，绩点跟你有仇啊，上课不好好上课，就知道吹牛，吹你大爷，不想上就留助教小姐姐放电影，要你何用。整个班几乎全被被绩杀，你脑子是不是浆糊了啊。如果你觉得查老师你的分数太高了，想要个1分，你直说啊，非要委婉的用绩杀来提醒我们吗！你大爷的
71936,106,陈昆福,2018-01-29 06:17:53,5,6,1,……我不想说什么了，因为大家都已经说完了，感谢老师，终于让我明白了什么叫绩杀，什么叫平时白努力，给分考运气……
71952,106,陈昆福,2018-01-29 06:35:39,9,11,2,还好我没有听过课，绩点低，至少心里不怎么委屈。
72030,106,陈昆福,2018-01-29 08:36:07,23,27,4,室友勤勤恳恳一个学期被绩杀了，考试前陈老师没有给多少复习资料，全靠她一个人看书划重点努力整理，努力有目共睹，即使是这样还是被绩杀了。我没上陈老师的课或许不能切身体会被绩杀的痛，但依然很不平，这样的给分存在于教务系统中真的对上这门课的学生很不公平。
72104,106,陈昆福,2018-01-29 10:49:39,2,4,2,水水水老师，给分坑，笑声魔性
72222,106,陈昆福,2018-01-29 14:46:29,5,7,2,果断一分
72373,106,陈昆福,2018-01-30 04:09:16,18,20,2,全班都是六十分  给分应该算是很公正了  我不想骂人  毕竟  胸怀最重要
72987,106,陈昆福,2018-01-31 13:26:12,7,8,1,hhd
72988,106,陈昆福,2018-01-31 13:28:24,13,14,1,不知道均绩3.39是怎么来的...
73413,106,陈昆福,2018-02-01 14:46:36,4,5,1,MDZZLS
73424,106,陈昆福,2018-02-01 14:19:30,8,8,0,。。。
73685,106,陈昆福,2018-02-02 15:30:48,18,20,2,选课的时候 我以为 浙大的老师 都是认真负责的 直到遇见了陈昆福 我就不骂人了 选了他的课 做什么的无济于事 就安心等着被绩杀就好了 绩杀还有一个好处呢 不会挂科哟 2.4很好了呢
74016,106,陈昆福,2018-02-04 07:11:11,-42,3,45,其实老师人挺好的！
74430,106,陈昆福,2018-02-23 03:39:03,1,2,1,呵呵呵呵呵呵
74524,106,陈昆福,2018-03-03 02:18:56,7,8,1,求求你们别选他的课
74718,106,陈昆福,2018-03-05 09:01:40,3,4,1,太坑了
75294,106,陈昆福,2018-03-08 16:05:39,9,11,2,老师你的团长要造反了
75412,106,陈昆福,2018-09-20 00:56:02,-64,6,70,为了能让你们看见我的评论，我决定打十分
76383,106,陈昆福,2018-04-06 02:17:10,-1,2,3,体验极差\n\n
77145,106,陈昆福,2018-05-03 02:24:41,4,4,0,挺差劲的……
78293,106,陈昆福,2018-05-10 13:10:27,1,3,2,有毒，东西学不到，屁事一大堆。
78947,106,陈昆福,2018-05-17 09:23:00,14,15,1,辣鸡  辛辛苦苦写论文  上课从不旷课  2.7什么意思
79022,106,陈昆福,2018-05-21 02:46:42,5,6,1,这老师真的差，别选他的课了
79178,106,陈昆福,2019-07-16 03:43:54,42,56,14,抓去炼出来的猪油可以供一户三口之家吃十年
79602,106,陈昆福,2018-06-11 06:35:50,-13,1,14,好好好
85955,106,陈昆福,2018-08-26 03:07:19,2,3,1,生气，给分低
86716,106,陈昆福,2018-09-18 06:04:08,6,9,3,打一分是因为没有更低的分
87259,106,陈昆福,2018-09-26 07:12:44,5,8,3,体验极差
87961,106,陈昆福,2018-11-07 05:53:15,-22,7,29,徒弟李金正怒挺老师！
88896,106,陈昆福,2018-11-12 02:00:50,0,4,4,沙雕老师不行\n\n退课
89445,106,陈昆福,2018-11-19 07:22:41,-28,3,31,讲得好事少给分好
91398,106,陈昆福,2018-12-08 06:22:01,2,4,2,一刀999级? ? ? ? ? ?
92143,106,陈昆福,2018-12-26 15:52:21,0,1,1,真的很坑，慎重
92223,106,陈昆福,2018-12-27 06:07:13,10,11,1,沙比老师只会吹大牛，一天到晚讲什么“子弹面前人人平等”
92326,106,陈昆福,2018-12-28 00:15:52,1,2,1,无聊啊\n\n这逼上课瞎讲\n\n
93154,106,陈昆福,2019-01-07 16:57:31,11,28,17,给个均分，单纯想说一下下面很不文明的评论。我觉得能说出这种话的人不可能是浙大学子，即使名义上是，但你已经不配了。人与人之间最基本的尊重，说话最基本的尺度还是要搞清楚吧，更何况这是一位老师呢（微笑）。
93587,106,陈昆福,2019-01-10 15:56:04,4,7,3,哪位11月20多号评价的同学，你已经出成绩了，所以你给老师评价给分好事情少？\n\n还是你上学期的事情专门等到这学期快完了评价？\n\n好多洗陈昆福的，真恶心。怕不是为了骗几个人选陈昆福的课，不然他作为一个老师连课都开不了面子怎么挂得住。
93613,106,陈昆福,2019-01-11 02:46:11,12,16,4,唉……小组展示，前几个组展示完了，他突然大吼一声，嫌我们投票少，然后也不管前面的小组的票数，后面小组票数特别多，这不是变相的拉票吗？不公平......
94357,106,陈昆福,2019-01-16 07:35:28,1,3,2,烂的一逼
94671,106,陈昆福,2019-01-17 16:20:43,-4,4,8,好老师！
95754,106,陈昆福,2019-01-20 03:44:49,0,3,3,卧槽了
96405,106,陈昆福,2019-01-21 02:30:02,-1,15,16,我滿績了? ? ? ?
96436,106,陈昆福,2019-01-21 03:33:53,1,9,8,啊啊啊啊虽然没满但没绩杀！老师本身很有水平der！
96460,106,陈昆福,2019-01-21 04:24:01,2,5,3,上课挺无聊，老师有点逗，一个个人作业一个小组作业，给分海星
96475,106,陈昆福,2019-02-27 22:45:50,6,17,11,他上辈子肯定是条狗，不然怎么可能有这么像狗的样子和行为
96500,106,陈昆福,2019-01-21 05:18:13,-10,12,22,给分还是很公正，如果论文认真写，期末稍微准备一下，卷面分不低，也不会被绩杀的。所谓的绩杀，估计是老师不会调分，以及自己确实一直在水。老师上课是挺水的，也不会给你说考试的事情。考试是开卷考，全是选择题，要带机读卡铅笔全都是室友告诉我的。陈老师讲的有些东西还是有政治智慧的，个人感觉是一个挺精明的人。比起陈老师，陈老师班上的学生可能会让你更加绝望。之前说如果上了3就来给个好评，结果给了4.5，来还愿了。\n\n
96571,106,陈昆福,2019-01-21 06:41:35,-9,7,16,没绩杀，给老师拉拉分吧，分数这么低真不容易啊
96650,106,陈昆福,2019-01-21 08:34:41,2,7,5,有很多收获，老师不愧是军事理论家和思想教育大师
96653,106,陈昆福,2019-01-21 08:39:45,-27,4,31,上课不听，水水就84，嗯还不错，
96842,106,陈昆福,2019-01-21 10:27:57,6,9,3,福哥 可以的
98249,106,陈昆福,2019-01-23 08:44:34,-22,7,29,大徒弟李金正怒挺老师！！！
99443,106,陈昆福,2019-09-08 14:11:55,-38,33,71,一开始也看到大家评论，可是自己去上了第一节课觉得老师完全没有问题。说老师装逼是不知道老师在军事教育界确实很厉害，有胸怀，爱校爱国，这有错吗，一学期下来我也没感觉老师装逼啊？绩杀的同学我想说你真的只考了那么多分数，助教说大家卷面分数本来就很低，你以为开卷你就能找到答案做的题就是对的吗？自己绩点差不可怕，可怕的是因此咒骂老师，我觉得你们对老师破口大骂的人是我们学校人真的很丢人，最起码得尊师没有吗？自己没好好学总想着老师该替你买单，别以为匿名就可以随便骂老师，骂别人不觉得后背发凉吗，绩点低没啥，没了良心素质真的让人很心痛…
102627,106,陈昆福,2019-02-15 02:13:12,3,5,2,绩点杀手，上课呵呵呵
102803,106,陈昆福,2019-02-23 09:41:07,3,5,2,绩杀！！
102977,106,陈昆福,2019-02-25 07:36:42,0,4,4,绩杀\n\n
103052,106,陈昆福,2019-02-25 23:44:11,4,6,2,挺好的，18届给分不是很低的，虽然依然听不太懂他说的话
103136,106,陈昆福,2019-02-26 06:26:05,15,15,0,明白了两件事∶卧底就在我们身边和子弹面前人人平等
103874,106,陈昆福,2019-03-07 01:20:56,5,6,1,千万别去，，，，，，
104561,106,陈昆福,2019-03-23 16:36:16,-18,4,22,我是ikun，反正我满了
104565,106,陈昆福,2019-03-23 16:52:07,14,18,4,军事理论燃起了我对军事理论的期望，壮大了我对军事理论的理想。不怕大伙儿嘲笑，我高考军理才138分，仅为理综一半，但是军事理论竟然全部缺勤仍能轻松满绩。大家平心而论，这门学科是不是真呀么真神了？重温战略经典，品读先进文化，我们在路上！
104952,106,陈昆福,2019-04-01 01:11:11,5,6,1,学这位老师的课就别想高绩点了\n\n
105111,106,陈昆福,2019-04-04 01:20:02,3,6,3,不如我的幼儿园老师。。。。
105203,106,陈昆福,2019-04-07 11:53:35,33,39,6,我是ikun，考前刷蔡徐坤nmsl，结果\n\n我满了
106471,106,陈昆福,2019-04-27 15:40:10,16,16,0,上此人的课，让我一大二小女生觉得他实在没有什么心胸眼界
106797,106,陈昆福,2019-04-29 14:47:23,37,38,1,他说给现在的浙大学生30天和一座图书馆，我们每个人都能造出原子弹。我当场笑出声来
108026,106,陈昆福,2019-05-13 07:05:10,-9,1,10,还没出分，但是老师对我挺好的
108464,106,陈昆福,2019-05-25 17:26:30,1,6,5,还好我没选你的课，哈哈
108909,106,陈昆福,2019-06-04 04:25:17,-16,4,20,爽啊！大家快选！哈哈哈
109027,106,陈昆福,2019-06-06 02:12:37,-67,7,74,浙大为数不多的好老师之一o(^o^)o\n\n值得去选的，不知道你们这些喷子怎么想的，这样一个给我满绩的老师不点个赞？。。
109995,106,陈昆福,2019-06-21 03:25:47,-43,5,48,上学期逃了半个学期的课，小组论文写了一点点，结果差点满了。。。不知道绩杀从何说起
110741,106,陈昆福,2019-06-28 06:48:38,18,21,3,什么时候浙大评价老师已经开始看他给你的分数？我是17年学的陈昆福的军理，结果给分根本没有逻辑和道理，考完想要查分也不给，说是存档了。平时上课都是让助教给我们放电影，根本没有老师的一点担当，我最后想请问一句，在你的国防学会的不来上课的同学凭什么分数比我高？就凭你陈昆福是学会会长吗？
110986,106,陈昆福,2019-06-29 03:33:36,-1,0,1,。！？
114831,106,陈昆福,2019-07-12 01:33:12,-7,1,8,给分还行哎
114939,106,陈昆福,2019-07-13 00:53:25,-13,6,19,我大一上就选了他的课。只要你愿意一直坐前排，把他说的故事放的电影当要点记下来，一定能有兴趣上他的课。只要不水课必有回报。\n\n记住，第一排！
114977,106,陈昆福,2019-07-13 13:33:59,1,1,0,吹牛。
115053,106,陈昆福,2019-07-15 01:47:15,-1,1,2,哈哈哈
116085,106,陈昆福,2019-09-03 07:52:08,0,4,4,傻p老细
116998,106,陈昆福,2019-09-18 05:36:58,1,3,2,经常不在
118383,106,陈昆福,2019-10-26 06:49:16,0,0,0,吹牛王者
122043,106,陈昆福,2020-02-06 12:56:31,14,15,1,社会我福哥，人菜骚话多。
123254,106,陈昆福,2020-05-26 06:53:45,33,33,0,从“给分厚道徐小洲 制度合理林建华 尊重学生孙大雁 亲切友善祝秀香 从不绩杀陈昆福 分多事少陈素珊 知识广博看沈燎 讲话生动吴朝晖 声音洪亮陶虹向”前来观光
123504,106,陈昆福,2020-06-09 07:51:36,1,1,0,666
124010,106,陈昆福,2020-06-20 06:02:11,2,2,0,如果对绩点无所谓的话可以选他，否则就算了吧
124611,106,陈昆福,2020-07-03 16:13:58,2,3,1,观光.
124918,106,陈昆福,2020-07-19 23:18:24,0,2,2,无语啊
126635,106,陈昆福,2020-10-10 06:59:46,22,24,2,陈昆福，你他妈连个群都不给让我们创小组？我一刀给你猪头肉都剁下来，这组你妈呢，现场分配？
126825,106,陈昆福,2020-10-21 15:17:34,2,3,1,马上就弃修
127263,106,陈昆福,2020-11-18 09:33:30,6,8,2,阿福 耗子尾汁
127576,106,陈昆福,2020-11-24 14:33:34,-20,5,25,陈教授在身体状态欠佳的前提下依然接受台湾问题的采访，非常精彩，这种精神值得我们敬佩
130008,106,陈昆福,2021-01-15 01:29:03,6,6,0,真是臭不要脸，打分不公平。
130029,106,陈昆福,2021-01-15 06:58:53,13,14,1,公然干预小组打分，要求所有人必须投第六小组非常好或者很好，不投票就要强迫上去做展示，而且威胁不投票的人回去查录像。展示结束临时决定上去讲的人满分，其他人按权重给分，理由是上去做展示的同学付出的更多。\n\n这老师有多nt不用我说了吧。
131702,106,陈昆福,2021-01-28 13:26:21,20,20,0,阿福觉得满绩是4，不说了特朗福牛逼
131709,106,陈昆福,2021-01-28 13:35:45,1,2,1,lj一个，呵呵了，这种人怎么还待在这儿，浪费时间
131955,106,陈昆福,2021-01-29 14:32:34,2,2,0,前来观光
132370,106,陈昆福,2021-02-01 06:48:47,4,5,1,给分这么低，我这学期最低的居然是通识课你敢想象？
132853,106,陈昆福,2021-02-04 07:32:07,-118,8,126,劳资军理4.8\n\n一帮水课的不绩杀你们绩杀谁？
132865,106,陈昆福,2021-02-04 08:29:16,3,6,3,呵呵，麻烦大家把他打到一分，谢谢
133054,106,陈昆福,2021-02-07 08:37:11,1,2,1,态度端正……
133100,106,陈昆福,2021-02-08 06:37:50,9,10,1,辣鸡老师，当了小组长，一节课没翘，PPT、集体论文、线下讨论，的确付出了很多在这门课上，开卷考试感觉也还好，结果3.3。当初想着思修课程有学分就好，就提前选了军理。真后悔啊真后悔
133358,106,陈昆福,2021-02-26 09:34:34,1,4,3,4.2  每节课不知所云，可能是因为卷面分高  ，  提醒一句，开卷也要好好看书复习，不然真的会后悔
133468,106,陈昆福,2021-03-01 04:40:13,8,8,0,如果对绩点不感兴趣可以选他，否则还是选其他老师吧
134105,106,陈昆福,2021-03-16 05:14:48,12,12,0,陈昆福跟油子一样，活该他身体是那个样子。选老师一定要深思熟虑，否则最后真的是追悔莫及。不想品尝被绩杀的滋味就别选!
134725,106,陈昆福,2021-04-12 07:25:07,30,33,3,典型的公知，说话毫无根据，暴论频出，风格很油腻，像大排档醉酒吹牛的街溜子，内燃机专业的，有头衔的，体制内酒囊饭袋，混吃混喝的那种，要么迟到要么放电影，绩点随机分布
134865,106,陈昆福,2021-04-19 12:55:07,38,41,3,这种垃圾老师怎么会出现在浙大讲台上？宁马的天天在讲台上自嗨，最后小组展示学生评分的时候还强迫所有人给其中一组打到满分，还说啥只有上台展示的同学才有展示作业的最终分，说其他同学都不能获得这个分。上课塔玛的这老师还会睡过头迟到一个多小时的，这都不是事儿好吧，最后的考试我只有两道选择题没有在书上找到，论文我前前后后写了一个多星期自认为是所有通识课论文里写的最认真内容最出彩的论文了，最终绩点竟然不如我那个天天床上打游戏上课不去考试纯粹乱写论文两小时赶完的室友的绩点？他和我都是这个陈胖球的课，我塔玛直接原地核爆了。看到这种自嗨老师就赶紧逃！
136170,106,陈昆福,2021-06-11 16:29:04,48,51,3,鲲鲲我爱你，mua，就凭你那一肚子坏水，凭你那190斤的大肚子，凭你那猥琐的微笑，爱了爱了
136201,106,陈昆福,2021-06-12 13:20:37,-26,0,26,军事理论，还是好好复习吧，复习好了就可以，4.2，论文胡乱写的。
136467,106,陈昆福,2021-06-18 08:11:24,17,17,0,你大爷的
140205,106,陈昆福,2021-09-05 02:10:21,-44,6,50,搞不懂怎么那么多黑昆昆的，问问自己平时用心了吗，付出多少努力收获多少成绩。
144684,106,陈昆福,2021-12-23 06:33:54,3,3,0,还没出分，就是感觉应该凉了，，，
147575,106,陈昆福,2022-01-10 08:47:06,18,22,4,极品中的极品，垃圾中的战斗机，王八蛋中的王八蛋。妈的，傻逼，陈昆福这臭狗tmd我这辈子都忘不了
147701,106,陈昆福,2022-01-10 13:38:47,-43,4,47,老师真的改过了 他现在是个好老头呜呜呜
147703,106,陈昆福,2022-01-10 13:42:03,-35,8,43,军理4.2 谢谢陈昆福老师 [亲亲]\n\n查老师上一点几的评分让我一直慌得一匹\n\n最后一节课老师说“我也想我的学生成绩好看点 以前我不在乎这些 但我现在是个好老头”\n\n他真的改过了 他好好呜呜呜[伤心]
149812,106,陈昆福,2022-01-17 06:05:36,5,6,1,dlj
151921,106,陈昆福,2022-03-23 09:38:23,8,10,2,➗中➗，在楼廊吸烟，尼玛下面一层都闻得到
154473,106,陈昆福,2022-06-02 01:16:26,6,6,0,老毕登，恶心死了
155404,106,陈昆福,2022-06-12 08:15:37,6,7,1,陈老师确实很有自己的想法，但是军理课有两篇论文，加上两个小组展示，个人认为作业量有些大，并且老师上课不注重知识点的强调，特别是期末也不会给出一些关于考试的有效提示，觉得对于考试不是很友好。
156505,106,陈昆福,2022-06-20 05:18:21,13,15,2,不要存在侥幸心理，老师评分低有他的理由:上课期间在走廊抽烟，监考期间问同学借充电线在后排玩手机，平时成绩和考试成绩不公布，小组展示给分就像儿戏，想怎么操纵就怎么来，什么组长要一半的分，其他人分剩下的？！
160099,106,陈昆福,2022-09-13 07:14:45,1,3,2,呵呵呵
162127,106,陈昆福,2022-11-17 02:37:18,2,2,0,从没见过这么离谱的老师
163948,106,陈昆福,2022-12-16 23:34:54,4,5,1,垃圾辣鸡
165951,106,陈昆福,2023-01-10 13:16:09,143,148,5,实话说，昆福先生的知识相当渊博，之前的同学评分太过于无礼！毫无学生风范！上学为求知而非“绩点”，望诸位明白！先生科研实力很强，对《孙子兵法》研究可谓入木三分。但与先生的能力与视野比起来，孙子写的《孙子兵法》那还是有点不够看。陈昆福先生才是真孙子！
166238,106,陈昆福,2023-01-11 13:31:20,16,16,0,上完ckf军理上马原觉得如听仙乐耳暂明。\n\n给分着实垃圾 绩杀\n\n毫无改过自新的趋势 上课光吹牛\n\n学生小组展示带头在下面玩手机\n\n喜欢搞些不明所以的事情恶心学生（点名和展示打分要组长拉群在群里统计后报到组长的群里，纯纯官僚制度，打分我能理解，点名你整这幺蛾子干啥呢）节节组长点名，就看你和组长关系如何是吧。小组展示规则改来改去，幸好我们组都看开了，最后才动工的。\n\n军理自我感觉考得不错，被彻底绩杀，刷新本人思修类最低分。
166247,106,陈昆福,2023-01-11 14:21:37,-4,0,4,对我来说
166831,106,陈昆福,2023-01-14 00:54:07,6,10,4,刚出分，确实绩杀，慎选，大早上出分心态崩了，其他课累死被这一课拉死。除此之外一定要好好复习，不能大意。
167462,106,陈昆福,2023-01-16 12:28:46,19,19,0,孙子之风
168853,106,陈昆福,2023-02-23 03:10:10,4,6,2,给分很烂
169518,106,陈昆福,2023-02-26 15:07:55,4,4,0,非常lj
169936,106,陈昆福,2023-02-28 14:02:08,74,77,3,本来想在大一下解决一门思政课程，但是看到余量还有228/248的教室，我陷入了沉思，麻烦还在的20位同学在期末给我一个回复，如果情况还好的话，我大二再选他的课
170592,106,陈昆福,2023-03-08 12:47:20,22,23,1,大家使劲顶一下楼下那位的评论，因为我发现我想说的和他想说的是一样的。\n\n228/248的教室余量，真的6.
171666,106,陈昆福,2023-03-31 12:01:50,-15,4,19,昆昆好好，大家快选呜呜呜呜呜呜呜呜呜呜
172389,106,陈昆福,2023-04-26 03:20:36,2,2,0,那没事了
173313,106,陈昆福,2023-05-18 10:10:23,3,3,0,。。。。。。。。。。。。。。。。。。。
179178,106,陈昆福,2023-08-29 11:08:49,12,12,0,圣地巡礼
181058,106,陈昆福,2023-10-07 04:04:08,-2,0,2,。。。
183730,106,陈昆福,2023-11-29 09:31:20,38,38,0,选择了陈昆福老师的军事理论。课程名字叫军事理论，但是全程都在讲《孙子兵法》，与现代军事没有任何的关系，剩下的时间都是在夸他考入斯坦福大学的儿子。索性还好，只去了两节课，签到都没签到，考试也是随便答的居然拿了80多分。后面就发现一个规律，只要是姓陈的同学或者是加了老师微信的同学分都不会低。认真答题的同学都只能才考60多分，真不愧是孙子兵法，陈老师才是真正的孙子
190327,106,陈昆福,2024-02-28 05:22:00,4,6,2,上课第一节课，感觉老师还可以，没看出啥不好的
190523,106,陈昆福,2024-03-07 02:18:30,1,2,1,给一分
193132,106,陈昆福,2024-06-04 02:46:23,3,3,0,23秋选的 老师也有反思说自己太凶太绩杀 说要好好改观 课上是基本没什么人听甚至没什么人来的，印象里好像点名了 不过我没去好像也没啥影响 一次小组展示 顺便就可以合作把论文写了 因为主题都是一样的 最后考试开卷 资料很全 最后得分4+，总体还算满意 老师应该是真的改邪归正了 从不绩杀的传说可能要破灭了
193432,106,陈昆福,2024-06-11 00:49:35,2,2,0,非常逆天
206270,106,陈昆福,2024-12-13 12:47:19,1,2,1,大家好，我系新来的，请问是直接骂还是走流程
7186,135,盛群力,2015-09-10 05:14:29,2,3,1,挺好
11687,135,盛群力,2015-12-11 11:54:15,0,0,0,不错啊
108940,135,盛群力,2019-06-04 12:39:48,0,0,0,老师挺好的，有理念，喜欢翻译书
111145,135,盛群力,2019-06-30 05:39:17,0,0,0,专家风采
115528,135,盛群力,2019-08-01 10:01:06,0,0,0,老师很好
5883,137,叶映华,2015-07-09 20:05:30,8,13,5,还行吧，挺和蔼
17363,137,叶映华,2016-01-20 06:09:02,4,9,5,差劲……\n\n
17464,137,叶映华,2016-01-20 08:53:30,1,6,5,自顾自的
18133,137,叶映华,2016-01-21 08:04:27,1,10,9,情绪管理纯扯淡
20550,137,叶映华,2016-01-28 09:58:47,-2,6,8,前面的都在乱说，叶老师不点名的
20554,137,叶映华,2016-01-28 10:00:36,3,10,7,讲课算是有进步的，但就是自我感觉太过良好受不了。
20593,137,叶映华,2016-01-28 18:15:13,0,4,4,比较一般吧
20788,137,叶映华,2016-01-31 12:00:55,4,9,5,如果能够和学生建立真正有效的互动就好了
21002,137,叶映华,2016-02-09 10:26:54,4,9,5,就那样吧，基本靠自学。
21751,137,叶映华,2016-03-01 03:25:05,3,10,7,挺好的，有热情也很真诚，激起了我对教育学的兴趣~
22275,137,叶映华,2018-05-04 08:38:39,25,33,8,情绪管理课很和蔼!会交流很多感情故事还有幼儿园儿子的风流故事\n\n
22398,137,叶映华,2016-03-04 08:22:58,4,10,6,我觉着还行，观点很犀利。
23602,137,叶映华,2016-07-06 05:32:09,3,9,6,自己把自己都能讲糊涂
23968,137,叶映华,2016-04-23 07:38:22,4,7,3,自学……
24407,137,叶映华,2016-04-30 13:24:45,-1,4,5,还ok
24601,137,叶映华,2016-05-02 06:50:51,0,5,5,不错啊 讲课很有趣 也有学术部分 评分也还行
24711,137,叶映华,2016-05-03 07:34:29,4,9,5,促进思考，寓教于乐
24715,137,叶映华,2016-05-03 07:40:55,3,6,3,听课挺有趣的但是给分特别低
27258,137,叶映华,2016-06-24 06:24:17,0,7,7,叶老师人很好 讲专业课很清楚  也很有意思 情绪管理课有一节课关于幸福 大家听了之后都感觉幸福指数upupup   喜欢！
27413,137,叶映华,2016-06-26 02:26:10,3,6,3,感觉挺不适合我的，风格不喜欢。
31192,137,叶映华,2016-07-03 11:04:58,8,10,2,像我这样数学和统计基础不好的同学一定要看《行为统计基础》，就算上课听不懂，也不要弃疗！
33018,137,叶映华,2016-09-10 05:21:17,-2,3,5,虽然叶老师的课对于文科生而言难度略大（数学统计什么的），但是讲课真的很好啊给分也还不错，是一位个人很喜欢的老师
40890,137,叶映华,2017-01-06 06:18:18,-1,1,2,很好啊
40891,137,叶映华,2017-01-06 06:27:16,0,5,5,氛围愉快，能学习到不少应用统计的知识。\n\n建议修读教育测量与统计的同学，打好数学基础，学完会有收获的～
40898,137,叶映华,2017-01-12 09:10:53,-1,4,5,可以的
40902,137,叶映华,2017-01-06 07:19:13,-1,5,6,老师上课非常好！条理清晰，逻辑性很强，而且上完课以后对情绪管理的认知提高了很多！
40911,137,叶映华,2017-01-06 09:54:56,-3,0,3,棒棒哒
40967,137,叶映华,2017-01-07 02:20:07,2,3,1,不说了
40968,137,叶映华,2017-01-07 02:23:17,-2,0,2,和善的
41012,137,叶映华,2017-01-08 03:53:34,-2,1,3,认真的
41013,137,叶映华,2017-01-08 03:54:23,-3,1,4,上课满满的干货，教学内容应用性很强，统计方法是科研必备啊，老师人也很nice。是值得用心听的好课！！
41232,137,叶映华,2017-01-10 06:37:44,-2,0,2,挻上心
52286,137,叶映华,2017-06-17 12:20:16,1,2,1,还行吧
53603,137,叶映华,2017-06-30 00:21:11,-1,6,7,点名展示论文考试，每样都不水，明明教务网上没说有考试还一定要安排考试，开卷还有找不到的，明明很认真的完成了还要被正态
53623,137,叶映华,2017-06-27 07:45:52,-2,0,2,情绪管理很不错
53645,137,叶映华,2017-06-27 08:36:16,-1,2,3,情绪管理很棒呀，我从第一节听到最后一节，一点也没有水手机的欲望。老师给的绩点还好的。很棒。
53687,137,叶映华,2017-06-27 10:03:32,0,4,4,叶老师还不错，我上的是她的情绪管理通识课。叶老师对展示的要求比较高，我们组展示的内容还被她批评了。不过论文和考试，认真去完成，就会有不错的分数。上课的话，叶老师会讲很多小故事，很有趣，实质性的理论学到的不多。
53810,137,叶映华,2017-06-30 08:25:18,2,5,3,表白超萌的助教姐姐
53902,137,叶映华,2017-06-28 03:44:51,4,5,1,情绪管理j类课 给分还可以?4.2\n\n自我感觉水水这个分数还行 也没啥负担\n\n上课听听各种校园生活故事\n\n点3次名 然后助教姐姐好可爱\n\n认识了一堆新伙伴 考试开卷 基本能找到\n\n展示也不是很烦 一次 互评小组间打分啥的
53956,137,叶映华,2017-06-28 06:11:55,-1,1,2,唔...给分蛮好比较轻松的j类课
62181,137,叶映华,2017-11-23 04:16:10,1,1,0,上课有趣 专业知识靠自己
81780,137,叶映华,2018-07-06 07:19:31,-1,0,1,超好的老师，实践证明给分不错。。。。
81879,137,叶映华,2018-07-06 11:05:15,-1,0,1,老师人很好啊，很亲民。经常在讲课中融入一些生活上的例子，还有她可爱的儿子hh 至少她让我了解到研究真的可以为求知而做的。助教姐姐也超棒的!
86410,137,叶映华,2018-09-15 09:12:12,-1,0,1,好好赞
99792,137,叶映华,2019-01-25 07:33:04,-2,0,2,老师超可爱，老师的儿子更可爱
104913,137,叶映华,2019-03-30 16:32:58,-2,0,2,很好好棒
106127,137,叶映华,2019-04-25 05:07:04,6,8,2,虽然和蔼，但上课确实不咋地
108310,137,叶映华,2019-05-21 00:24:15,12,12,0,人挺好，但经常知识点没讲清楚就游离到了很远的地方。
108325,137,叶映华,2019-05-21 06:24:06,3,3,0,应用统计还行，就是会突然开扯
108428,137,叶映华,2019-05-24 01:53:42,9,10,1,我是真的听不懂她在讲什么。
108483,137,叶映华,2019-05-26 15:10:22,14,14,0,老师人挺好，就是教学能力还欠火候，一些难点总是无法深入浅出地讲透，而且，讲不清楚的时候经常会用这样一句话塘塞过去：这个问题很简单，我就不说了
108529,137,叶映华,2019-05-28 00:16:28,6,6,0,感觉老师讲的很乱 有些知识点前面讲了一点点就不讲了 要放在后面讲 问题是后面讲的也不详细
109107,137,叶映华,2019-06-08 13:02:20,4,6,2,这个你们都知道，我就不讲了
109449,137,叶映华,2019-06-14 12:46:22,-1,0,1,情绪管理给分好啊
110096,137,叶映华,2019-06-22 17:07:14,0,1,1,教统怕是到不了均绩了…………
110197,137,叶映华,2019-06-24 10:27:51,1,2,1,人超级好，给分也不错。划重点，人真的超级好！！
110198,137,叶映华,2019-06-24 10:52:09,0,2,2,刚出分激情给叶老师打十分!\n\n叶老师人很好超负责超nice!\n\n教育统计与测量一个pre一个期末考，pre展示一篇论文的统计方法，然后当时自己看不懂就一直vx问老师，老师超耐心回答超详细!然后展示也是老师周末抽出大半天给大家展示，还一直安慰我们注意休息别不睡觉。考试有点难度的，但是认真复习认真学考试也没那么可怕，最主要是这门课真的收获很大很大。至少不怕看有统计方法的论文了! 友情提醒:上课一定要认真听哦，老师儿子的故事也很有趣hhh
110199,137,叶映华,2019-06-24 11:14:43,-1,1,2,叶老师真的很好啊，虽然上课有时候会觉得讲得太快了，但老师每次都会让提前预习，就好很多啦。考试之前也很关心我们，最后给分也很好呢～
110226,137,叶映华,2019-06-26 18:06:21,23,25,2,（教育统计）叶老师人超好，只是这门课对于短学期来说过于硬核了，课程进度非常赶，没有统计基础的话会吃力。但是叶老师真的是非常尽力在帮助我们，不管是课堂还是答疑，虽然平时超级辛苦但在同学面前一直很贴心很热情。给老师一个十分。（顺便说一句，心理系和教育学同样的教材但是那边是上两个长学期……） \n\nbtw放上一份期末回忆卷https://www.cc98.org/topic/4853460
113568,137,叶映华,2019-07-07 00:09:50,-1,0,1,庆幸自己选了她的创启
115573,137,叶映华,2019-08-05 11:53:15,4,5,1,外表不错，看着挺顺眼的，就是教学水平偏低了点，概念讲不清楚，有时再吹嘘自己儿子时偏离主题太久
124587,137,叶映华,2020-07-03 09:11:09,-1,0,1,应统非常好！！完全不后悔选了老师的课！！给分也很好！！入股不亏的老师！！
124625,137,叶映华,2020-07-04 04:51:26,0,1,1,学生认真做作业，老师给分也很好。
134239,137,叶映华,2021-03-20 10:47:45,1,1,0,讲话很飘
174643,137,叶映华,2023-06-15 03:37:46,3,5,2,😇😇😇她在讲什么，作业什么的都好为难人。\n\n教育统计学😇以后看到她绕道走
176706,137,叶映华,2023-06-29 19:33:26,1,1,0,一门真的能学到东西的教育学专业课。老师本人特别厉害，回答问题也很负责，学习的内容确实有难度但是认真做一定能做出来，并且老师给分真的好好我哭。特别感谢老师负责的解答，好课bd
177437,137,叶映华,2023-07-03 09:07:01,0,0,0,叶老师很有学识人也很不错，问问题都会及时回答，讲课也尽力在照顾我们，但教育统计学这门课真的挺难的，最后给分还可以
181893,137,叶映华,2023-11-03 12:57:59,1,1,0,我最喜欢的一位老师（截至目前为止），最喜欢最喜欢的老师，呜呜呜，快结课了好舍不得
192056,137,叶映华,2024-05-08 09:54:04,4,4,0,讲课好混乱，好喜欢说半截话。。。“那个...那个...”
208906,137,叶映华,2025-01-03 09:34:07,0,1,1,搞双标，爱挑刺，师德师风恶劣，针对其他导师的学生很有意思？
208907,137,叶映华,2025-01-03 09:39:46,0,0,0,肚量小小的，变脸快快的
208908,137,叶映华,2025-01-03 09:40:24,0,0,0,先管理好自己的情绪吧，呵呵
219180,137,叶映华,2025-05-23 00:59:34,1,1,0,她到底在讲什么？\n\n感觉像某种规则怪谈，虽然她讲的很用力听上去头头是道，但是仔细一听发现根本听不懂。作为教育学的老师居然可以讲的这样烂。。很多知识点都默认我们已经懂了，请问如果真的如此我们还来上这门教育统计学干嘛？\n\n“都懂了吧？”“这个讲过了吧？”\n\n明明应该是最干货的一节课，讲成这样，还是自学吧。
51936,157,李萌,2017-06-13 15:52:56,0,0,0,老师挺好的。就是老师拖延症很严重。出成绩好慢。作业有点多，但是布置很早。总体觉得收获很大
53754,157,李萌,2017-06-27 13:27:10,0,0,0,李萌助教，郑丹文老师行测是绩杀
57508,157,李萌,2017-07-09 04:01:24,0,0,0,听课无聊，但是干货比较多。\n\n给分一般，老师好说话，帅气。
85726,157,李萌,2018-07-30 08:36:57,0,0,0,授课细致，乐于交流。另外，老师其实很宽容的啦，比如将ddl定在考试周最后一天，对拖延症患者而言真是小天使了！
25372,159,商丽浩,2016-05-16 06:37:46,3,4,1,上课节奏慢 仔细认真 善于启发同学思考 认真听能够获得关于近代教育的很多思考
51029,159,商丽浩,2017-05-15 01:07:24,2,3,1,事情多
61156,159,商丽浩,2017-11-09 09:00:09,-1,3,4,认真听的话还是比较有收获，任务稍微有点多，给分还可以，老师比较nice
61195,159,商丽浩,2017-11-10 15:43:43,5,10,5,老师讲课方式以及态度不做评价，但是给分真的很有失公平。班上一个韩国学生，平时作业不做，论文不写，不展示，考卷写不好，居然给及格，却给辛苦当组长的同学挂科。被质疑按英语水平给分这个理由的时候前言不搭后语，先是说英文水平对给分很重要，后来又说英语并不是关键给分因素，对于学生的质疑顾左右而言他，明显包庇韩国学生，给分实在不公，枉为师表。
113476,159,商丽浩,2019-07-06 18:06:12,1,1,0,老师上课还是不错的 生动有趣 上的教育史 但是对大家展示的要求还是比较高的 需要我们有一定的创新性 总体感受是一个很可爱的老师
117115,159,商丽浩,2019-09-19 08:46:11,1,3,2,无语 每次提出一个问题一点启发都没有强行叫同学起来回答 同学尬答后她也不讲自己的答案就跳过了 我：？？？\n\n
118728,159,商丽浩,2019-10-31 09:06:04,6,7,1,老师很温柔，而且上课节奏不会太快，问了问题之后很耐心，不会急着要我们回答，这样的课堂可以促进我思考，也不会很紧张。而且也不会只是老师一直讲，我们也很有参与感。
118789,159,商丽浩,2019-11-06 01:12:55,0,1,1,非常负责耐心的老师，会带着我们阅读许多英文的材料，但很体谅学生的难处，尊重学生的意见，上课很有启发性。
120486,159,商丽浩,2019-12-09 08:05:49,0,0,0,很有收获
127507,159,商丽浩,2020-11-23 22:50:43,1,4,3,考试保持卷面整洁\n\n字好好写吧\n\n唯一的忠告了
134172,159,商丽浩,2021-03-18 01:59:49,0,1,1,上课会举很多生动的例子，能一窥老师严谨的治学态度，非常负责认真上课的老师！很有收获！
151353,159,商丽浩,2022-03-01 06:06:21,0,0,0,不说上课什么的，消息已读不回，一个月后回复“才看到”，也没有对我的问题进行回应
165939,159,商丽浩,2023-01-10 12:42:45,-1,0,1,还可以
187801,159,商丽浩,2024-01-17 13:18:20,1,1,0,论文给分太好了给商奶奶跪了呜呜
56902,165,王莉华,2017-07-05 03:01:20,-9,4,13,老师非常温柔，上课认真能越到很多～
57019,165,王莉华,2017-07-05 07:41:03,10,11,1,呵呵呵呵
69647,165,王莉华,2019-01-09 01:11:21,27,36,9,为点名而存在的课，那个张佳也是个辣几
70014,165,王莉华,2018-01-26 03:08:31,6,8,2,真的是呵呵呵呵
92492,165,王莉华,2018-12-31 09:14:26,13,16,3,原来觉得老师上课只会照ppt讲很无聊，直到张佳来了才发现浙大居然有老师照着ppt都挤不出个p……这么一想王老师还是不错的，肚子里有货，也尊重学生
92600,165,王莉华,2019-01-03 05:42:23,7,7,0,你是魔鬼中的天使，所以让我心碎的方式，是让我笑到最后一秒为止，才发现自己胸口碎大石
94874,165,王莉华,2019-01-18 11:44:29,12,13,1,看到ls的zjxswl，自己讲得差甩锅给wlh做的ppt不好╮(￣⊿￣)╭这课都开了一百二十年了自己干啥不做啊\n\n学弟学妹慎选此课……
96422,165,王莉华,2019-01-21 03:07:08,6,6,0,事多分低
119115,165,王莉华,2019-11-10 12:49:47,2,3,1,给分真的低 请问老师是根据考试和作业公正给分的吗？ 还是说只根据印象给分呢？
119382,165,王莉华,2019-11-12 13:20:42,1,1,0,我讲的比她好
182311,165,王莉华,2023-11-14 11:51:59,11,11,0,给分有点太求事了，我的心脏受不了🤦
182325,165,王莉华,2023-11-14 14:57:20,11,11,0,给分烂透了，讲课也很难评...
182328,165,王莉华,2023-11-14 16:13:14,6,7,1,3.9，不知道怎么给的，给分真的低
182401,165,王莉华,2023-11-15 14:25:39,5,5,0,这很难评
201776,165,王莉华,2024-11-06 06:36:36,9,9,0,给分奇差
202634,165,王莉华,2024-11-13 13:16:46,0,0,0,一周两节早八……\n\n给分也不是很好
33064,354,祝怀新,2016-11-10 12:32:06,23,24,1,儒雅、睿智
36400,354,祝怀新,2016-11-13 03:06:14,20,21,1,棒啊咯哈\n\n
58806,354,祝怀新,2017-09-18 02:07:41,-22,4,26,蓝瘦！
85827,354,祝怀新,2018-08-19 11:09:07,22,24,2,上课挺风趣，视角比较独到
93976,354,祝怀新,2019-01-14 14:09:52,22,23,1,儒雅而有学识，讲课内容丰富又引人思考。
104040,354,祝怀新,2019-03-11 02:21:20,20,20,0,棒棒哒
104113,354,祝怀新,2019-03-12 08:27:14,27,29,2,老师风趣幽默，听他上课很有收获
105148,354,祝怀新,2019-04-04 14:03:36,18,19,1,儒雅、帅气、睿智
105175,354,祝怀新,2019-04-06 05:22:44,19,21,2,睿智儒雅，幽默风趣，自信大气，帅气潇洒，是我最喜欢的老师
106791,354,祝怀新,2019-04-29 14:07:41,16,20,4,听老师的国际与比较教育课是一种享受，娓娓道来，分析深入，见解独到，ppt十分漂亮大方，其中还插入一些小视频，使课更饱满生动，显然老师对教学十分投入。相比之下，与老师合上同一门课的另一个老师逊色太多了。
108039,354,祝怀新,2019-05-13 22:25:27,16,18,2,思维敏捷，循循善诱，让我们听得意犹未尽，好想有机会再听老师讲课
108482,354,祝怀新,2019-05-26 15:06:07,15,16,1,大学学习中难得一遇的高水平老师，听老师的课，不仅是一种享受，还能启迪智慧与思想
109018,354,祝怀新,2019-06-08 12:51:04,13,15,2,难得一遇的男神老师
109077,354,祝怀新,2019-06-07 11:16:48,12,14,2,帅的没天没地啊?
109558,354,祝怀新,2019-06-17 03:34:27,11,12,1,一个字：好！两个字：很好！三个字：非常好！
115290,354,祝怀新,2019-07-18 02:01:12,11,13,2,思路清晰，有激情，有深度，受益匪浅
115291,354,祝怀新,2019-07-18 02:02:01,10,12,2,博学，儒雅
115292,354,祝怀新,2019-07-18 02:03:25,8,11,3,接地气，语言犀利，幽默风趣。
115293,354,祝怀新,2019-07-18 02:06:27,9,12,3,分析透彻，有启发有收获
115294,354,祝怀新,2019-07-18 02:09:02,9,11,2,儒雅，思维敏捷，有大师风范
115295,354,祝怀新,2019-07-18 02:15:09,9,11,2,听君一席话，胜读十年书。
115330,354,祝怀新,2019-07-18 23:26:46,8,9,1,老师的国际与比较教育这门课是我听过的最棒的课！一年过去了，还意犹未尽！
115341,354,祝怀新,2019-07-19 02:34:45,8,10,2,心里开心，精神愉悦。\n\n
115442,354,祝怀新,2019-07-24 02:23:52,8,10,2,上课很有感情，言之有物
115524,354,祝怀新,2019-08-01 08:52:46,9,11,2,风趣幽默，地气与高度兼具，学者风范。
115526,354,祝怀新,2019-08-01 08:58:24,9,12,3,祝老师实例特别多，像讲故事一样把各国的教育改革讲的深入浅出，风趣幽默的儒雅学者！时间太短，要是能多上几天，相信会有更大的收获！
115527,354,祝怀新,2019-08-01 08:59:10,10,12,2,字字珠玑，句句扎心，男神老师，不虚此名
115544,354,祝怀新,2019-08-02 06:58:05,10,11,1,男神哦
115612,354,祝怀新,2019-08-08 15:02:07,8,10,2,幽默风趣，睿智
116166,354,祝怀新,2019-09-05 09:16:01,6,10,4,自信，睿智，气度非凡
117078,354,祝怀新,2019-10-07 04:59:40,-16,10,26,只会耍嘴皮子，不学无术的混子
117817,354,祝怀新,2019-10-03 01:22:32,5,9,4,学识渊博，思路清晰，见解独到，语言魅力无穷！
117871,354,祝怀新,2019-10-07 04:58:01,5,9,4,之前蹭过老师的几堂课，非常棒，这个学期马上就有祝老师的了，好期待！
118177,354,祝怀新,2019-10-22 05:00:11,5,8,3,喜欢老师潇洒自如的气质和自信满满激情四射的讲课风格
121209,354,祝怀新,2019-12-29 11:39:33,4,7,3,比较教育学界的一枚男神
124708,354,祝怀新,2020-07-06 15:16:24,4,7,3,男神老师，我的最爱😀 😀 😀
126620,354,祝怀新,2020-10-09 03:09:51,3,6,3,评价给的太高
127605,354,祝怀新,2020-11-25 03:00:41,0,1,1,Anti-PC
137108,354,祝怀新,2021-07-01 08:28:41,0,3,3,男神一样的老师！
157829,354,祝怀新,2022-06-25 04:18:44,1,1,0,非常好的老师，学识渊博同时鼓励学生表达自己的想法，给分也超nice，祝老师yyds！
162797,354,祝怀新,2022-12-06 08:32:47,2,2,0,大师风范
180190,354,祝怀新,2023-09-20 13:27:08,0,1,1,大绩杀
5323,395,苏建元,2015-07-06 15:01:11,-4,7,11,台湾老师听不懂，给分超低
5324,395,苏建元,2015-07-06 15:10:30,0,5,5,哄 哄 哄
5489,395,苏建元,2015-07-08 02:38:45,-2,5,7,听不懂哄\n\n
18227,395,苏建元,2016-01-21 10:01:54,5,11,6,我觉得老实人很好，很有趣啊
22196,395,苏建元,2016-03-03 02:22:09,-9,9,18,废话连篇，一节课45分钟只有5分钟在讲课，超级浪费时间，真的不知道怎么招进浙大的；非常自以为是，整天“内地的学生”、“内地的学校”巴拉巴拉，觉得内地人都是土鳖…
24471,395,苏建元,2016-04-30 14:52:19,-10,4,14,辣鸡老师 每次作业都做 上去讲 上课偶尔不去 尼玛给分和一次没去过的差不多
33044,395,苏建元,2016-09-11 02:34:10,1,5,4,口音太重
40903,395,苏建元,2017-01-06 07:45:43,7,10,3,苏老师上课很有意思的啊，而且我觉得很像同龄人，明明讲的很有用啊，又很有眼界，很赞，不同意那些乱说的
40904,395,苏建元,2017-01-06 07:46:19,4,10,6,讲道理，我觉得苏建元老师的课非常实用，学了一学期的多媒体制作，期末拍微电影非常有趣，此外还听苏老师介绍了文献检索的方法，很实用，开这么实用课的老师不多。\n\n希望大家不要以口音、地域等无关因素来评判老师的辛勤付出！
53177,395,苏建元,2017-06-26 06:35:26,3,5,2,现代教育技术，老师很棒呀，上课很有意思呢～让我对湾湾产生了蜜汁好感～给分也好
53191,395,苏建元,2017-06-26 07:18:28,5,10,5,我觉得老师很可爱，现代教育技术平时没什么作业，给分也好。缺点就是快考试周了才布置微视频制作和期末报告，不过难度其实也不大。
53487,395,苏建元,2017-06-27 00:21:40,3,5,2,这个老师给分超级好，大家不要放过他！！！
53622,395,苏建元,2017-06-27 07:44:51,2,3,1,现代教育技术给分很好哇，并且作业也不难
54584,395,苏建元,2017-06-29 17:49:46,3,4,1,老师上课很好玩\n\n课程也比较实用，会教录屏做视频什么的
54649,395,苏建元,2017-06-30 03:12:31,14,16,2,很不明白有些人为什么要恶意差评 苏老师又有情怀又能和学生打成一片 台湾腔也超可爱 给分也很好啊
55083,395,苏建元,2017-06-30 21:54:37,-5,3,8,平时水水的 期末作业很多 好好做给个满分很好 老师人很好
58128,395,苏建元,2017-08-04 09:20:14,3,3,0,很喜欢的萌萌哒老师
75512,395,苏建元,2018-03-13 01:32:36,1,3,2,男神！
78935,395,苏建元,2018-05-17 06:02:23,19,26,7,我对于拿出那么多时间来给一个非洲博士生乱搞非常有意见
81867,395,苏建元,2018-07-06 10:30:50,12,13,1,水是真的水，现代教育技术是我觉得最水的专业课了，感觉很浪费时间
82117,395,苏建元,2018-07-07 07:15:20,3,4,1,每次课都到，认真参与，展示评价不错，给分很差
82141,395,苏建元,2018-07-07 09:15:51,4,4,0,人很好
82158,395,苏建元,2018-07-07 09:28:07,6,8,2,最初的课程与任务设计感觉挺有想法，挺实用的，尤其是教学视频，感觉做任务的过程中还是学到了很多东西，老师的口音还是很有趣的～但是老师在教学评价这方面确实做得不够好，由于做的教学实验分去了很多课时，导致很遗憾有些最初约定的给分任务并没有进行，一些课时也没上完。学期末才对给分标准做出了比较大的改动。希望老师以后在教学规划和给分细则落实上做得更好吧
91309,395,苏建元,2018-12-05 10:45:42,1,1,0,老师很可爱啊，我上课就很认真听，学到很多实用的东西，为什么要根据老师的给分恶意差评，老师给分严格说明老师是个认真的人啊！
91311,395,苏建元,2018-12-05 11:03:16,1,2,1,特别喜欢的老师，上课能学到很多干货。
111126,395,苏建元,2019-06-30 03:35:26,1,2,1,讨论课真的浪费时间。毫无意义
113304,395,苏建元,2019-07-06 05:02:45,3,3,0,大家教技的分怎么样？
113452,395,苏建元,2019-07-06 17:30:13,0,1,1,苏老师的现代教育技术还是很不错的!老师的湾湾口音很可爱啊哈哈哈老师上课还经常跟我们唠嗑 做的微视频和动画都是涨姿势了hhh 给分也是很不错滴! 可水可有趣~
118095,395,苏建元,2019-10-21 02:17:56,1,1,0,很可爱哦
68707,451,周丽君,2018-01-23 15:51:22,-1,3,4,真的差
110424,451,周丽君,2019-06-26 14:26:36,-1,2,3,挺好的老师
110425,451,周丽君,2019-06-26 14:27:02,-2,1,3,挺喜欢
128792,451,周丽君,2020-12-25 10:40:39,-1,2,3,sb老师
144207,451,周丽君,2021-12-20 15:37:59,-1,1,2,什么垃圾老师 一点师德没有 天天恶心人 人品差 以自己利益为上 嘴脸丑恶 大型双标PUA道德模范 靠近她会变得不幸
145798,451,周丽君,2022-01-02 11:39:24,4,6,2,老师特别好 认真上课给分也好
159511,451,周丽君,2022-07-30 01:28:02,-1,0,1,官僚气息浓厚
20253,454,温煦,2016-01-26 16:14:04,4,9,5,男神。讲的好
27321,454,温煦,2016-06-24 23:53:17,0,1,1,好好好
33892,454,温煦,2016-10-07 05:24:37,2,2,0,棒的不行
36531,454,温煦,2016-11-14 15:18:18,1,2,1,好老师，够男神
37221,454,温煦,2016-11-18 02:54:53,1,1,0,不错\n\n
90822,454,温煦,2018-11-26 10:08:14,-1,0,1,干货满满
144648,454,温煦,2021-12-23 03:30:03,2,2,0,老师现在就在我背后
160171,454,温煦,2022-09-14 06:17:14,1,1,0,温煦男神！！！！
184992,454,温煦,2023-12-25 08:38:08,6,7,1,《四百块》《收费比较低》\n\n好好好，银泉足球场从此开始收费
184997,454,温煦,2023-12-25 09:12:40,3,3,0,银泉足球场要预约不😋😋😋
185010,454,温煦,2023-12-25 14:11:31,0,0,0,收费不贵，400元两小时
188784,454,温煦,2024-01-20 02:33:01,0,0,0,感谢解剖不挂之恩
193407,454,温煦,2024-06-09 16:41:22,0,0,0,老师上课还行
6884,500,肖龙海,2015-07-28 11:30:17,42,47,5,水师
7184,500,肖龙海,2015-09-10 05:13:08,38,39,1,这个老师实在不行
8317,500,肖龙海,2015-09-18 09:41:10,15,17,2,呵呵了
11601,500,肖龙海,2015-12-07 10:39:43,8,11,3,给分好，但讲课烂透了
11689,500,肖龙海,2015-12-11 11:56:20,-5,7,12,这么低分我心碎了。拉一拉
11918,500,肖龙海,2015-12-21 10:37:56,17,19,2,你就是个笑话
13248,500,肖龙海,2015-12-25 15:20:15,3,7,4,这么低分
18229,500,肖龙海,2019-01-09 09:10:49,-40,3,43,我觉得肖老师挺好的，虽然水，也算有套路有追求
20594,500,肖龙海,2016-01-28 18:17:26,9,11,2,水出套路，野路子
25453,500,肖龙海,2016-05-20 01:29:52,6,6,0,次次点名
26323,500,肖龙海,2016-06-17 01:30:30,1,2,1,呵呵呵→_→
34968,500,肖龙海,2016-10-27 08:40:39,24,28,4,第一次见到完全不备课就来上课的老师，展示的同学没来他就完全没有可讲的，尴尬癌都犯了。随堂测验一测一节课，就一个问题要写多久啊？总之就是水水水，完全没有内容。你要是不想开这门课就别开，撑不了那么久还要一次上三节，何必呢？
35316,500,肖龙海,2016-11-08 07:45:23,20,21,1,水师提督\n\n
41435,500,肖龙海,2019-01-08 14:11:15,-32,4,36,我觉得老师还好呀
41539,500,肖龙海,2019-01-08 14:11:19,-25,3,28,好~~~
47802,500,肖龙海,2017-02-25 06:25:43,15,15,0,这种废物老师，给分不公平，上课水，还他么能教书？
59013,500,肖龙海,2017-09-19 06:10:19,2,3,1,第一次课就不断暗示申请免听是几个意思啊
59439,500,肖龙海,2019-01-13 06:12:25,-35,2,37,为啥给老师这么低的分数啊
77507,500,肖龙海,2019-01-13 06:12:12,-41,2,43,其实我觉得老师人很好，注重学生主体，认真参与了收获很大。
86897,500,肖龙海,2018-09-19 09:30:29,37,38,1,面向退休的水师领军人才，堂堂教育学院课程系竟然有这种连课都不会上也不好好上的教师，还要教我们如何上课？三观不正，师德崩塌，逻辑诡辩，体系混乱，田家炳的讲台因你而跌份
88681,500,肖龙海,2018-11-05 15:36:20,23,23,0,消泷海
88724,500,肖龙海,2018-11-06 13:13:06,9,9,0,大海全是水
88798,500,肖龙海,2018-11-08 07:23:55,13,14,1,这个老师简直是在毒害学生，极差，赶紧滚蛋吧！浙大还有这样的老师，怎么能成为世界一流大学？
88801,500,肖龙海,2018-11-08 07:38:50,14,15,1,作业无穷无尽 被作业拖垮 这个课太惨了
89169,500,肖龙海,2018-11-16 09:31:26,6,6,0,海哥真是水
90086,500,肖龙海,2018-11-30 15:11:24,16,16,0,☔️???⛈????
91323,500,肖龙海,2019-01-08 10:46:41,19,19,0,不到最后一天都不知道他还能整出什么幺蛾子 呵呵 毫无章法 脸大如盆 上课基本靠同学展示水 点评还只会点评ppt 呵呵 第一个让我恶心到反胃的老师
91340,500,肖龙海,2018-12-06 06:17:02,12,12,0,从他自序可知他教小学的时候就很水了，最令我不能忍受的教育学专业课，没有之一。闲扯都没有重点，不知道教育学院为什么会有这样的老师，呵呵
91342,500,肖龙海,2018-12-06 06:23:12,15,15,0,直言不讳自己的水，水得非常真诚ಥ_ಥ
91481,500,肖龙海,2018-12-11 08:37:00,7,7,0,今天，他又为自己的水阐述了理论依据
91654,500,肖龙海,2018-12-17 09:37:13,5,6,1,还有一个月就结束了
91685,500,肖龙海,2018-12-18 02:17:01,12,13,1,太烂了，为什么没有零分？
91707,500,肖龙海,2018-12-18 06:34:18,10,11,1,上课无厘头，想讲啥就讲啥。作业多，要求多，烦琐而且毫无意义。浙大钱太多了吗，请这种毫无水平的老师？？？？？希望学院可以脑子清醒点，早点把他请出去，不要耽误我们的学弟学妹
91710,500,肖龙海,2018-12-18 08:36:50,7,8,1,煎熬，五学分的课，让我对教育学本科产生了深深的厌恶
91760,500,肖龙海,2018-12-19 13:09:33,5,5,0,真的垃圾
92243,500,肖龙海,2018-12-27 07:44:55,6,7,1,元旦后讲课程考核
92345,500,肖龙海,2018-12-28 02:26:47,8,8,0,要么上课，要么下课。小学自习第一人
92563,500,肖龙海,2019-01-03 02:52:12,14,14,0,外专业千万不要选，教育学本专业自求多福吧。一周前布置某天下午上课要展示，展示那天上午说这项作业不需要做，呵呵哒
92565,500,肖龙海,2019-01-03 02:59:51,2,3,1,? ? ?
92634,500,肖龙海,2019-01-03 07:57:32,8,8,0,请让他原地爆炸
92786,500,肖龙海,2019-01-04 12:05:12,12,12,0,一个误解了课程即过程的老师
92848,500,肖龙海,2019-01-05 07:12:46,10,11,1,教材术语完全属于译者根据英文单词自创，最后闭卷考试虽然有材料但没有除举行考试之外的任何意义
93206,500,肖龙海,2019-01-08 06:36:11,7,8,1,一个存在卷面分的神奇老师。上课已经半小时了，讲的内容毫无营养。
93501,500,肖龙海,2019-01-10 06:07:45,11,11,0,？1.8 1.9两天谁来集体洗白了？
93510,500,肖龙海,2019-01-10 06:40:03,18,18,0,乱搞，从开学到期末，天天乱搞
93518,500,肖龙海,2019-01-10 07:19:56,38,38,0,生成性教学等于不备课吗？说自己不教教材，确实一点也没讲教材，但是为什么设置的四次小测完全按照一本翻译得极烂的书出题与批改答案？一共八九次展示，其中三四次展示不算平时成绩，随意选择到这种程度吗？有一个大项目前后进行两个月，结果最后算分和一个课堂完成的十五分钟海报占比一样？期末闭卷考试自己不出题，发的提纲来自上届学生作业？每项任务选题随意，不到最后一刻不公布作业主题，展示大多点评PPT模板？附加分之后再设附加分，无穷无尽的作业，难道只有这门课吗？没有学生展示就讲不出来什么，尴尬的时候就说过往经历？上课基本没有PPT，说自己PPT做的难看，再难看你可以用word，也不至于每次上课只打开多媒体，不知道这样多浪费电吗？临近期末关于如何评分前前后后讲了四次课，是这个课课时太长了吗？自己不想开就别开，主动让学院在培养方案上剔除就行，何必坑了那么多人？表面民主实则诡辩，声称自己注重活动翻转课堂，其实都是他的奴隶。
93522,500,肖龙海,2019-01-10 07:33:16,24,25,1,民主不是不负责任也不是推卸责任，这样的民主我只能理解为懒惰和没有责任心，心疼教育学子
93546,500,肖龙海,2019-01-10 09:32:17,-1,2,3,
93725,500,肖龙海,2019-01-12 10:44:00,22,23,1,我是一个儒雅随和的人，但是上他的课我有一种欲杀之而后快的冲动，这种人侮辱了老师这两个字，侮辱了浙大的招牌，为什么可以容许这样的人存在？建议纪委查一查学院。
93848,500,肖龙海,2019-01-14 03:57:41,5,5,0,绝望。。。
93851,500,肖龙海,2019-01-14 04:04:22,15,15,0,听老师上课是一种什么体验：\n\n希望他闭嘴
93967,500,肖龙海,2019-01-14 13:32:13,1,2,1,一个在绝对应试与绝对素质的两级间摇摆不定，反反复复的“好”老师
99664,500,肖龙海,2019-01-25 04:40:40,0,1,1,虽然给分不错，但是真的不值得
104277,500,肖龙海,2019-03-15 14:37:11,-1,0,1,啊，大海，你让我说什么好？\n\n默默给个一分，啥也不说了
106130,500,肖龙海,2019-04-25 05:11:21,3,3,0,见过差的老师，没见过这么差的老师
109112,500,肖龙海,2019-06-08 13:14:38,2,3,1,水平低口才差也就罢了，可是连教学态度也糟，学校安排这种人来给本科生上课，足以说明学校对本科生何其凉薄
110257,500,肖龙海,2019-06-25 06:04:56,6,6,0,肖老师我男神，讲的好棒，真乃浙大之栋梁！（五毛一条）
115530,500,肖龙海,2019-08-01 13:33:05,3,4,1,还行，至少比徐小洲好那么一点点
115862,500,肖龙海,2019-08-22 01:31:08,5,5,0,就是因为这个老师才让我意识到这个地方配不上如此好学的我。
117836,500,肖龙海,2019-10-04 11:10:26,6,6,0,教育学院为何对学生如此薄情寡义？居然派这种不学无术、口齿不清的混混来给我们上课！要知道，这种人出场不仅是浪费我们的青春，也是给学院抹黑，别忘了，贵院的名称是教...育...学...院！
118018,500,肖龙海,2019-10-19 02:19:37,1,1,0,全校最差老师，没有之一
119108,500,肖龙海,2019-11-10 11:13:56,1,1,0,此生遇到的最差老师，以后再也没有机会遇见比他更差的老师了，也算是有意义的人生经历吧？
136590,500,肖龙海,2021-06-21 12:18:49,3,3,0,一分是有一分的道理的
136988,500,肖龙海,2021-06-29 07:56:05,5,6,1,不到最后一刻不知道会翻出什么花来🆘
139859,500,肖龙海,2021-08-03 15:41:30,4,4,0,热爱105度的小组合作，上课的每一天都像油煎。
154023,500,肖龙海,2022-05-19 13:24:46,7,7,0,作业重复布置，上课灌满水分，任务不切实际
154152,500,肖龙海,2022-05-25 00:30:19,4,5,1,上课就希望他能闭嘴。\n\n任务布置的不切实际，他觉得自己能做到吗？\n\n作业要求说了一节课都说不清\n\n浙大竟然让这样的老师来给本科生上课
154724,500,肖龙海,2022-06-04 07:47:28,4,5,1,只能说这个分数实至名归
154725,500,肖龙海,2022-06-05 04:35:52,6,7,1,很难以想象浙大教育学院会有这种老师。\n\n遇到他真的是三生不幸。\n\n6.5来修改一下，布置作业的时候说不用做pre，作业提交之后告诉我们第二天要做pre，朝令夕改，这种人怎么配当老师的？
154726,500,肖龙海,2022-06-04 07:52:15,5,5,0,他到底想干什么
154835,500,肖龙海,2022-06-06 05:49:56,6,6,0,《无语凝噎》
159096,500,肖龙海,2022-07-06 05:42:53,0,1,1,教育学院怎么会有这样的老师。。。
197844,500,肖龙海,2024-08-15 14:07:36,0,0,0,if(now()=sysdate()，sleep(15)，0)
394,504,汪辉,2015-03-15 01:52:37,17,35,18,中国好老师
27333,504,汪辉,2016-06-25 02:45:58,-8,2,10,职规不点名可以水。真棒！
31698,504,汪辉,2016-07-04 13:54:45,11,13,2,认真完成作业还是给分差
31770,504,汪辉,2016-07-05 01:39:26,-6,3,9,好老师，知识点也多。
43423,504,汪辉,2017-01-16 08:51:01,9,13,4,上课烂 给分差
51660,504,汪辉,2017-06-08 05:25:05,7,10,3,上课烂 给分差
53552,504,汪辉,2017-06-27 03:22:56,5,9,4,教育学院的呵呵老师
53559,504,汪辉,2017-06-27 03:44:10,7,9,2,很差很不好
57302,504,汪辉,2017-07-06 13:43:12,-5,2,7,老师人很好啊给分也棒
58770,504,汪辉,2017-09-17 04:18:00,5,6,1,讲得差 给分烂 事情多
93207,504,汪辉,2019-01-08 06:31:36,4,5,1,奇葩 装逼
116538,504,汪辉,2019-09-11 08:59:18,2,7,5,亲切可爱的老师，即使没有人听课也一直笑着讲课
118514,504,汪辉,2019-10-28 01:18:22,-5,1,6,不说给分，其实还行
130668,504,汪辉,2021-01-24 06:53:38,0,1,1,论文答辩催着其他同学快速讲 轮到自己辅导的学生就不说话了
181531,504,汪辉,2023-10-21 12:09:13,2,3,1,好老师！
181891,504,汪辉,2023-11-03 12:55:58,6,6,0,呜呜，似乎老师快退休了，蛮舍不得的，祝老师身体健康...
202347,504,汪辉,2024-11-12 02:20:10,1,1,0,课上人很少，一般没人听老师讲课，但是课后自己认真看书看ppt也可以取得不错的成绩
204780,504,汪辉,2024-11-28 01:42:58,0,1,1,汪老师，好
12,554,姜海,2015-03-14 01:40:15,-9,21,30,很有个性的老师，能学到不少东西。
13,554,姜海,2015-03-14 01:41:36,-8,19,27,如果作业交晚了，会被狠狠的骂一顿。。不过也算是能让我们养成一个好习惯吧
534,554,姜海,2015-03-15 04:25:12,-9,9,18,老师很严格，但是知识非常渊博。
596,554,姜海,2015-03-15 06:23:07,-8,8,16,非常好的老师 很负责
820,554,姜海,2015-03-17 12:59:06,-8,3,11,上课还好，平时群里交流的话不怎么样
825,554,姜海,2015-03-17 15:15:19,-9,9,18,眼神光!最专业的视角!
837,554,姜海,2016-09-18 00:05:24,-7,39,46,喜欢摄影的真的要上上他的课，不了解的更要上上他的课。除了对于光影的精心巧妙布局之外，姜老师更向同学展现了摄影的内涵与意义，有血有肉。
1116,554,姜海,2015-03-21 16:12:34,-7,11,18,很好玩！摄影启蒙课！
1364,554,姜海,2015-03-22 01:01:13,-8,8,16,非常棒，专业人带我们领略不只是泛滥的摄影\n\n
1624,554,姜海,2015-03-23 02:28:29,-8,7,15,老师很好的，不仅教摄影也有很多人生的道理。认真上课的话既会有收获也能拿不错的绩点。
1906,554,姜海,2015-03-26 05:34:15,23,38,15,摄影艺术是推荐上的，只是上了这个课的同学们建议你们再选选别人的摄影课，姜海老师的一家之言在很多别的老师那里是不一样的，不要盲目崇拜
3118,554,姜海,2015-05-15 02:59:03,21,28,7,还是推荐岑兆峰老师吧
4127,554,姜海,2015-06-18 01:41:58,-6,10,16,能学到很多东西\n\n但是特别主观，这点要注意
5254,554,姜海,2015-07-06 04:57:08,2,8,6,千万别翘课 尤其是在要签到的时候
5276,554,姜海,2015-07-06 08:52:29,-9,4,13,很激情
10331,554,姜海,2015-11-18 05:59:35,-7,13,20,老师摄影方面很独到，能学到很多。但是有些发表观点的地方个人认为可能有些偏颇，不太认同他的价值观。交作业很凶。
13045,554,姜海,2015-12-24 15:31:33,-7,2,9,………
14701,554,姜海,2017-08-29 03:54:28,63,103,40,姜海就是一傻逼，不学无术，用几十年前的理念招摇撞骗忽悠同学，更可悲的是被忽悠的同学还丝毫没有察觉。贵校的摄影水平就被这样一个江湖骗子带得啥都不是。
14837,554,姜海,2017-08-29 03:54:17,26,39,13,这位东海老法师，不学无术。基础知识谁都能教。课程万年不变的佳能清洗券，佳能相机好。你这不是搞笑呢？一遇到自己失误说错东西同学指正一下，就把同学朋友圈屏蔽了。
14838,554,姜海,2016-01-10 02:57:10,34,42,8,至今我也没想明白他到底是害了很多届学生造就了很多半吊子的老法师还是给浙江大学的学生摄影水平有了从0到0.2的提升。。。有些话听听就好，不必较真
14839,554,姜海,2017-08-29 03:55:12,16,26,10,守着过时的东西和自己半吊子的水平的老法师，自己不懂还要装逼，滥竽充数，欺世盗名
14841,554,姜海,2017-08-29 03:54:34,31,40,9,这老法师招摇撞骗多年，用的摄影理论都老掉牙了，还在课上推销相机，不知道学校有木有规定管一管他
15662,554,姜海,2016-01-16 05:13:17,13,19,6,交作业的最后一天FTP崩了，打电话和他沟通差点被骂哭了TAT
18797,554,姜海,2016-01-22 14:26:29,12,14,2,红雨伞
21280,554,姜海,2016-02-28 03:07:42,15,18,3,shi zai la ji
23658,554,姜海,2016-04-12 01:07:51,-6,7,13,老师上课还是不错的 确实热爱摄影 有些摄影原则会反复啰嗦就是啦 作为摄影启蒙还是不错的 \n\n偶尔签到点名
25166,554,姜海,2016-05-06 13:47:35,-7,2,9,6666666
28894,554,姜海,2016-06-29 02:58:39,-9,1,10,老师讲的很棒，学到了很多东西，但是他对摄影的看法和大多数人都不一样。给分还不错的，打算去听听另外一个老师的课。
28914,554,姜海,2017-08-29 03:55:22,17,20,3,傻逼老师 自以为是 给分差
28917,554,姜海,2016-06-29 03:26:42,-8,2,10,好老师！
28947,554,姜海,2016-06-29 04:14:23,-12,1,13,喜欢秀优越，但是眼光独到，侧重点不同，不要随便和别的老师比较，按他说的做，成绩不会差，超级轻松，还有小礼品，给分还行，和付出的努力相称。基础课，从小白到入门。不准P图！
29100,554,姜海,2016-06-29 08:38:22,14,17,3,理论并不先进，学识并不渊博，形式重于内容，不推荐
29122,554,姜海,2016-06-29 09:06:19,-6,3,9,虽然比较严厉，但暂时治愈了我的拖延症。喜欢有人文关怀的作品。
29237,554,姜海,2016-06-29 13:05:43,-9,3,12,认真听课真的会很有收获。不要觉得通识想水过去就随便搞搞最后分低了还骂老师。。。。虽然有时候是会有些啰嗦，尤其是爱的教育。。但确实是让我开始思考照片意义的重要性！有经验的好老师！
36414,554,姜海,2016-11-13 09:12:12,13,14,1,完全没听到什么有用的，ftp还会崩
38897,554,姜海,2016-12-19 16:40:46,-7,5,12,能收获很多摄影以外的东西
39146,554,姜海,2017-08-29 03:54:49,46,53,7,总是骂学生上课水手机看电脑，他的逻辑思路乱七八糟，讲到中国足球就气的好像要把教室给炸了，讲到父亲母亲这类的照片总是要说我们坐在温暖的教室不好好学习对不起变老的爸爸妈妈，我就想说，我爸妈才没那么老，我爸妈漂亮的很，我也没不好好学习
39803,554,姜海,2016-12-27 22:56:23,-6,8,14,其实认真听下去，还满有收获的～摄影技术的确可以提升，就是他平时牛吹得太过
43783,554,姜海,2017-01-17 03:06:03,-7,2,9,给分还不错的考试
43799,554,姜海,2017-01-17 03:39:04,17,18,1,给分能再烂一点吗
44043,554,姜海,2017-01-17 08:40:15,12,14,2,呵呵了喜欢摄影的人你还是自己去网上看教程吧，这老师不能给你带来任何东西。自己ftp有问题，补交还要被骂
44148,554,姜海,2017-01-17 10:47:00,12,12,0,被正态 手动再见
49608,554,姜海,2017-04-20 07:16:47,8,9,1,呵呵呵呵呵
51207,554,姜海,2017-05-24 05:24:16,17,19,2,垃圾课，懒得上他就放纪录片放水，整天大光圈小光圈，速度快速度慢，只有三板斧，开个短学期还差不多，有摄影基础的根本就听不下去，小白们还被忽悠，动不动就批判玩手机，真的想说听他的课不如玩手机，做微积分，不推荐。
51215,554,姜海,2017-05-24 09:37:28,12,14,2,请同学准备好一只单反，或者朋友有的，手机党真的快哭了
51879,554,姜海,2017-07-27 04:51:46,-6,2,8,好老师\n\n
52393,554,姜海,2017-06-19 13:24:40,7,9,2,这老师给了我他的QQ但是我加了一学期他还没同意，上课老是父母辛苦你们不好好学习要反思，口头禅是“不要牛批轰轰”，谁怎么他了就牛批轰轰，整天莫名其妙被骂，讲得也不怎么样，摄影眼光就几十年前还让我们不要学现在网上那些，作业都是玄学，全看他喜不喜欢给分的。人特别特别凶，毫无亲和力的倔老头。
52570,554,姜海,2017-06-21 06:51:59,12,13,1,不展開了
53621,554,姜海,2017-06-28 09:27:53,5,6,1,3.3……
53668,554,姜海,2017-08-29 03:56:17,15,19,4,想知道有多少人来骂的……平时凶也就算了，上课无聊重复也就算了，上了一个长学期就学到了大光圈小光圈速度快速度慢也就算了，为什么他妈给分还这么差啊！每一次课都去了，没错过任何一次点名、作业，期中期末都认真拍了，按照要求交了，有摄影基础（在学校里的比赛拿了一次一等奖两次二等奖），结果3.3？？？无fuck说？？请大家来说说?点好嘛！我想知道按照他的标准是不是都这么低！\n\n还有，强烈建议教务处安排这门课变成短学期…上课内容到后面重复太多，评讲学生作业两节课，讲课半节…长学期浪费时间
53675,554,姜海,2017-06-27 09:46:19,7,8,1,哎 真的只有一声叹息 可还是有用的 观点也有点偏激 脾气是真的不好  有次差点被骂哭 真的只是在靠近DDL的时候交的作业啊……每节课鸡汤味很浓 哎 给分很迷 当时就应该听学长学姐的话 毕竟自己对艺术真的一窍不通 还想以此来提高自己的艺术水平??? 算了 反正很失望
53701,554,姜海,2017-06-27 10:31:12,7,9,2,一幅自己摄影很厉害的样子 上课因为同学的摄影作品不符合他的要求就直接登鼻子上脸 上了一学期课基本上没收获 给分还很差 。恩反正我是没什么艺术素养的提高
54501,554,姜海,2017-06-29 12:11:07,6,8,2,期中期末作业全部准时交，上课每次都去签到都在，上交的作业在别的专业摄影课上都拿90分左右的分数，他给我3.3，发邮箱问为什么不回，QQ上问也没有回应，上大学以来就接触摄影也出了不少作品，为了凑学分选的摄影课，以为总不可能太差，结果不知道要多少成绩才能把均绩拉回来，上课天天就知道说我们不好好上课辜负父母的期望，还要上交和父母的谈话记录，我要辜负父母期望就不会来上你的课了！！整天说没相机就拍不好照片，一定要我们买相机，以相机的好坏直接断定照片的质量，牛逼轰轰毫无干货，上课就知道骂人，就知道吹嘘他的学员有多厉害，好了我知道了老师真的厉害，给分这么随便我也是第一次遇到，3.3我认了:)
55626,554,姜海,2017-07-02 05:17:53,7,8,1,上他的课我甚至连写微积分都写不下去....太吵了orz拍照什么的大概要完全看他心情吧.......其实大概一学期上下来能摸清楚他喜欢什么样的照片，就看你愿不愿意投其所好了......如果想水学分还是推荐的，毕竟就期中期末两张照片。
56952,554,姜海,2017-07-05 04:40:03,-10,1,11,老师水平极高，人品好，人称晴男。给分公平公正，善待努力的孩子。性格直爽 幽默，不会拐弯抹角，比起面子更重视里子。最喜欢的老师之一。
59470,554,姜海,2017-09-21 15:45:59,17,18,1,红衣女孩油纸伞  懂的赞我
60277,554,姜海,2017-10-16 11:18:39,7,9,2,傻逼一个
67082,554,姜海,2018-01-20 08:46:11,-7,2,9,还行吧
67088,554,姜海,2018-01-20 09:05:59,-6,10,16,我觉得凭心而论吧，我就是一个摄影小白，可能很多大神不乐意听一些基础的东西，可是我觉得老师讲的东西对我很有用。是，老师说话是有点激动，而且喜欢夸耀自己的学员啥的，但是这并不妨碍老师传授知识啊，我收获的不仅仅是摄影知识，还有摄影背后定格的是一段回不去的历史和故事。谢谢老师这一个学期的教导，虽然我绩点不是太高，但还算满意，谢谢老师o(^o^)o
67148,554,姜海,2018-01-20 10:32:20,-8,5,13,虽然说我是水课党，但是老师还是很好哒。或许他没有教那些很深奥很专业的知识点，但也有很多基本知识。摄影不仅仅是一张照片，还承载了人的情感。我没有认真去学，自己水平也不够，这点分数我觉得很合理了，毕竟上课老师给我们看过其他人的作业，那是真的好。但我觉得 ，不管怎样 ，学到了一点东西，就算跟技术无关也是好的。
67319,554,姜海,2018-01-20 18:21:38,-6,4,10,对我这种零基础，还爱水课的学生来说，的确学到了一些东西，老师给分也很好，感觉自己拍的并不怎么样也给了4.5，对我来说已经很满意了。
68029,554,姜海,2018-01-22 13:33:58,-12,2,14,老师很和蔼可亲 不仅能学到知识 老师还三观很正 作业是让我们给家里人打电话 很关注国家发展 很好的老师！
69157,554,姜海,2018-01-24 09:09:28,-11,2,13,明明很好的好吗！
71057,554,姜海,2018-01-28 02:12:18,7,7,0,要得高分，得拍老师喜欢的片子¯\_(ツ)_/¯呵
73608,554,姜海,2018-02-02 05:43:38,8,8,0,同学一学期就上了三次课，从没签过到，期中作业也没交，我认认真真学了一学期，结果分还没他高
76163,554,姜海,2018-03-28 06:01:38,9,9,0,骂人上课法的。。怕了\n\n
76991,554,姜海,2018-04-27 11:25:28,5,7,2,老师，我想交作业，明明4月30号是截止日期，为什么ftp没权限还提前三天办公室就没人了，我给你10分，你改一下ftp让我交交作业好不好，谢谢你了老师，我哭晕。
79291,554,姜海,2018-05-30 06:00:12,12,12,0,好了，不展开了啊
82440,554,姜海,2018-07-08 07:47:34,9,9,0,很凶，很看重人文的东西，但是摄影专业知识不咋地，推荐水课
86872,554,姜海,2018-09-26 15:02:05,30,30,0,打鸟 大片 吹设备 坚决不（不会）ps 吹学员\n\n讲真您老拍的照片真的一般 很多还辣眼睛\n\n真是一个标准的老法师了
88217,554,姜海,2018-10-24 05:48:44,15,15,0,看到骂声一片我就放心了 我浙的同学还是有觉悟的
88833,554,姜海,2019-09-07 16:43:20,26,27,1,我想问问 您老在课程的群里发照片没人给您点赞您就发脾气说以后不发了四怎么回四呢(￢_￢)为什么没人点心里没点B数吗
93368,554,姜海,2019-01-09 08:03:03,3,4,1,看了楼上各位的评论我突然觉得彭韧虽然没啥摄影水平，至少不骂人……
98709,554,姜海,2019-01-24 00:06:55,2,3,1,傻逼一个，自以为是，给分奇差，建议不选
102885,554,姜海,2019-02-24 16:35:36,4,6,2,一开始看查老师 感觉说的挺过分的 现在上完课 你们说的真对
103166,554,姜海,2019-02-26 10:09:02,0,3,3,江湖骗子
104557,554,姜海,2019-03-23 14:10:55,-4,3,7,老师讲的都是摄影的基础知识，我不明白那些人为什么要喷。老师讲的非常好，还结合了自己半辈子的摄影经验，非常好的课程。
106714,554,姜海,2019-04-29 05:06:59,1,2,1,讲真，客观来讲，垃圾。\n\n一个学期讲的东西，一篇推文就能明白，在课程群里发他公众号的推文，都是什么感想、感谢姜老师，还说我们都不点赞就不发了？？？真的笑死，你还有脾气了喔
107674,554,姜海,2019-05-08 06:58:06,4,5,1,讲得不咋地声音倒是能把??耳朵整烂\n\n
107678,554,姜海,2019-05-08 07:53:12,2,3,1,真的超级垃圾了，不懂为什么这种人也能当浙大老师，莫名其妙，耳朵要被吼聋了，不知道什么毛病，总扯些有的没的。
108117,554,姜海,2019-05-15 07:30:02,1,2,1,极其睿智，三节课里两节课灌鸡汤半节课骂人半节课放视频
108587,554,姜海,2019-05-29 06:09:44,1,2,1,在听这位老师讲中国女排上他的课第6遍一模一样的照片一直放，几乎每节课都讲:)\n\nfine我觉得我要吐了
112327,554,姜海,2019-07-04 01:48:09,1,1,0,你们看过我的朋友圈吗？我有一张照片收获了很多赞(◐‿◑)﻿
112416,554,姜海,2019-07-04 05:13:23,-1,0,1,\n\n最后给1分是因为最低只有1分
19943,627,高乃春,2016-01-25 15:12:38,1,3,2,咱们的女神老师
78957,627,高乃春,2018-05-17 13:41:18,0,0,0,超级女神老师呀！！人美课讲的也好，课堂氛围很好，会跟学生讨论很多问题，非常好的老师！\n\n
153453,627,高乃春,2022-04-30 07:47:14,0,0,0,体育英语出分惹！给分和老师本人一样漂亮嘿嘿
181916,627,高乃春,2023-11-05 06:08:41,0,1,1,三天补完直到期中一半内容然后直接小测的狠人。
184161,627,高乃春,2023-12-11 12:27:31,1,2,1,要求又高，教学质量也不高，老师和助教又都懒😃
6883,711,刘淑华,2015-07-28 11:29:15,-4,4,8,就就
7187,711,刘淑华,2015-09-10 05:15:00,-1,4,5,soso
8318,711,刘淑华,2015-09-18 09:42:57,0,8,8,不错耐心女神
27164,711,刘淑华,2016-06-23 09:25:01,3,7,4,一种享受
29358,711,刘淑华,2016-07-03 09:12:48,4,6,2,事多给分不太好慎重选择不是真喜欢不要选了吧俄罗斯文化
30562,711,刘淑华,2016-07-02 03:18:27,0,4,4,很棒的老师很有气质
31083,711,刘淑华,2016-07-03 08:04:11,0,4,4,老师有气质，给分公道
31916,711,刘淑华,2016-07-05 06:59:53,4,6,2,平时不好好表现绩点会炸，学弟学妹要高分的话上课记得装逼，下课做好ppt
32278,711,刘淑华,2016-07-06 05:31:20,1,4,3,口音重
36546,711,刘淑华,2016-11-15 00:22:33,0,2,2,上课还行给分不错一定要发言
41549,711,刘淑华,2017-01-16 10:43:34,0,5,5,老师很正能量，给分不错呀\n\n
51768,711,刘淑华,2019-01-22 01:24:04,4,11,7,念ppt型、、一言不合就把俄罗斯文化吹上了天就很无语、本身似乎也是俄语老师？反正能学到的不多、都是网上查得到的那种、看ppt就够了（摊手
54847,711,刘淑华,2017-06-30 10:07:45,3,5,2,还行吧，任务都是自选的，基本会有一次小组展示，两次听写，一次论文
55077,711,刘淑华,2017-06-30 18:53:18,17,22,5,老师其实很好很耐心的人啊，因为是真心喜欢俄罗斯文化选的这门课，也是有史以来通识上课听得无比认真，记了好多笔记也学到很多。感觉真的是要付出才有回报吧，做了两次小组展示，一次个人作业，两次课堂测试都写得八九不离十，最后论文的话，感觉老师比较喜欢带个人感想的吧。虽然没有课堂发言但也拿到了自己目前所有课的最好分数。但是！！！说实话这门课事挺多的，如果不是感兴趣的话不要选了，不水！不水！不水！
55082,711,刘淑华,2017-06-30 21:51:02,3,6,3,很用心上课的老师，课堂展示很有趣，付出和收获成正比
56234,711,刘淑华,2017-07-03 09:54:27,1,4,3,没有100分，想打100分啊！老师真的很用心上课，很有气质！
56238,711,刘淑华,2017-07-03 10:03:35,1,3,2,给分好   人也漂亮～很好的老师
69637,711,刘淑华,2018-01-25 06:04:57,1,2,1,国际教育改革与发展，看出来老师在很认真准备上课内容，然后每次都讲不完ahhh
77283,711,刘淑华,2018-05-04 10:21:15,1,7,6,老师挺好的，课也挺有趣的，就是内容有些太泛泛了……一共八堂课，她按时间讲下来，还有各种小组展示，唱歌念诗演剧和报告，想想时间就紧张……然后结果就是好像内容也都讲到了，但和没讲没什么区别。一点小建议就是讲课和展示分开，不一定非要讲到一个内容直接叫同学展示，单拿出一堂课展示效果可能更好。\n\n7分吧，很多通识课都安排的比她这个好。
77576,711,刘淑华,2019-02-22 14:49:55,1,1,0,对这门课很感兴趣，很高兴能选上这门课。老师讲得真的很用心，课堂活动很丰富给分也不错XD\n\n一点小建议，可能是课堂限制，整体讲得有些泛了，如果能重点讲一个时期的名人和事件感觉会更好一些？
81187,711,刘淑华,2018-07-04 08:35:45,1,4,3,老师确实温柔很气质 没有像评论说的吹捧俄罗斯文化啦 上课风格比较像高中历史老师 时间仓促所以泛泛而谈一些 \n\n不用刷发言 好好准备课堂小测 参加小组展示 认真写论文 可以上4的
94649,711,刘淑华,2019-01-17 14:15:16,2,3,1,老师好有气质!说话也好有气质鸭!\n\n上的国际教育改革，老师上了一半的课程，每节课都是干货满满，认真听会有收获而且会有启发。偶尔点名同学回答问题，也比较喜欢叫同学翻译PPT上的英文哈哈哈。总之老师敲棒，私下问问题和交流也感受到那种亲切感!
102750,711,刘淑华,2019-02-22 09:01:13,1,1,0,很充实的课！每堂课都能学到很多东西，小组的表演也挺有意思的\n\n有随堂小测，平时上课有做笔记的话有帮助
103580,711,刘淑华,2019-03-01 12:14:57,6,11,5,上课还行，但是看到俄罗斯的学生就high得不行了？没选上课还直接签字给她直接选上，这样对系统刷下来的600多个人公平吗？
104284,711,刘淑华,2019-03-16 08:54:31,0,6,6,精俄分子……
104875,711,刘淑华,2019-04-13 04:03:02,0,8,8,对俄罗斯本身没什么感觉，但是天天上课都把这个国家吹上天就很恶心了。尤其是对那句“俄罗斯不可战胜像个神话”，作为一个了解一点点历史的人，我只能表示呵呵。
105554,711,刘淑华,2019-04-16 14:11:56,3,6,3,老师上课前备课超级认真，课堂内容安排地很满很紧凑，能学到不少知识，老师也是特别有气质～
106005,711,刘淑华,2019-04-24 08:09:12,2,5,3,超有气质的女神老师，内容丰富，课堂也很有趣！
106195,711,刘淑华,2019-04-25 13:11:03,-3,8,11,老师上课确实挺像中学历史老师。会讲很多facts而不是opinions。中规中矩，能学到东西，但是要觉得大受启发学到很多东西非常棒，那是不存在的……（不过可能是因为本人之前对俄罗斯已经有一些了解吧）。前面说俄吹的同学，是你个人有偏见，老师只是单纯地喜欢俄罗斯文化，没有很大倾向。如果对俄罗斯的了解还仅限于战斗民族的话建议来听一下，因为你会了解到一个比你想象的更加广阔的俄罗斯。老师会有两次随堂小测当作点名，建议多展示多发言，期末论文好好写。事情确实不算特别少，但我觉得特别特别多也算不上，毕竟不需要读课外材料写读书笔记什么的。总之建议对俄罗斯文化和历史感兴趣的同学可以选一下。老师给分不错。
106233,711,刘淑华,2019-04-26 01:19:33,0,2,2,历史课吧
106391,711,刘淑华,2019-04-27 04:02:56,-5,4,9,事多 压力大
106517,711,刘淑华,2019-04-28 03:34:50,0,3,3,超级好的老师，努力会有回报！
108705,711,刘淑华,2019-05-31 11:11:18,0,0,0,！！！
109110,711,刘淑华,2019-06-08 13:06:48,1,5,4,颜值还行，教学不行
115531,711,刘淑华,2019-08-01 13:37:55,9,10,1,老师啊，历史知识百度上都有，能不能给我们一点耳目一新的分析和思考啊？
116693,711,刘淑华,2019-09-13 10:33:34,0,0,0,老师人挺好的吧
117360,711,刘淑华,2019-09-23 09:54:12,4,4,0,自己体验
132562,711,刘淑华,2021-02-02 09:23:55,6,6,0,内容饱满，思想贫乏
167252,711,刘淑华,2023-01-15 08:46:59,0,0,0,给分差。。。
167300,711,刘淑华,2023-01-15 12:31:35,0,0,0,挺负责的，给分还不错
187512,711,刘淑华,2024-01-16 12:14:55,6,6,0,国教改垃圾课，一些不能称之为知识的东西要求背，老师一边说激发我们自主性一边发言计分，到最后一个问题半个教室的人举手就是你想看到的吗，第一次听说有同学给老师发钉钉说“老师不要上课只看教室某边叫那边的同学发言”，无脑翻译题装作提升了国际化素养
192715,711,刘淑华,2024-05-29 07:11:58,6,6,0,鼓励恶竞
28582,782,黎禾,2016-06-28 10:36:37,1,1,0,呵呵呵
28586,782,黎禾,2016-06-28 10:39:10,1,1,0,超级恶心的老师 根本毫无原则可言
47995,795,蓝劲松,2017-02-28 02:34:20,15,17,2,我滴娘...这口音...太重了
76907,795,蓝劲松,2018-04-26 00:21:03,14,15,1,没有零分的评分，给一分都是高。既然决定了糊弄学生，就不要当老师。垃圾一般得东西
79415,795,蓝劲松,2018-06-04 03:50:51,15,15,0,有负分吗，围笑
79455,795,蓝劲松,2018-06-06 00:14:00,14,14,0,不明白这样的人为什么会当老师
82062,795,蓝劲松,2018-07-07 04:11:50,15,15,0,他上课上的都是什么东西，就这水平还从清华出来的？
82250,795,蓝劲松,2018-07-07 14:55:14,15,15,0,傻逼一个
103665,795,蓝劲松,2019-03-04 03:04:30,13,13,0,f......k
103746,795,蓝劲松,2019-03-05 03:24:47,8,8,0,population 赞！
108280,795,蓝劲松,2019-05-20 01:35:24,5,5,0,每节课都是浪费时间，浪费生命
108490,795,蓝劲松,2019-05-27 02:25:34,5,5,0,既然当了老师就不要忽悠学生
109138,795,蓝劲松,2019-06-10 01:17:13,6,7,1,真的感觉上课是随便讲点什么，八周的课布置了四次作业四次展示，期末还要交论文。上课什么干活都没有
109141,795,蓝劲松,2019-06-10 02:27:22,3,3,0,解释一下楼上同学的population，为了跟留学生说明人口，用浓厚的口音说population（应该polution...）
109204,795,蓝劲松,2019-06-12 02:28:30,4,4,0,欲仙欲死
109552,795,蓝劲松,2019-06-19 02:22:26,5,5,0,求求这个专业领域完全不对又喜欢瞎解释的辣鸡不要再来丢人现眼了。0分都嫌多
115521,795,蓝劲松,2019-08-01 05:47:45,3,3,0,我其实想打零分的。
115583,795,蓝劲松,2019-08-05 18:35:38,1,1,0,...
118020,795,蓝劲松,2019-10-19 02:24:06,4,4,0,语言表达能力也太差了吧
118706,795,蓝劲松,2019-10-31 02:18:57,4,4,0,教育学院的神仙老师 一言难尽
119356,795,蓝劲松,2019-11-12 08:27:07,0,1,1,老师辛苦了
119393,795,蓝劲松,2019-11-12 14:49:53,3,3,0,画面上只有一个孤单的同学，在讲台上做pre，那么蓝劲松老师呢？《蓝劲松老师在上课》
195938,795,蓝劲松,2024-07-01 02:07:07,-2,0,2,上课内容有点不知所云，感觉挺一般的。一共一个3000以上的论文和两次小组展示，挺水的。但是老师人还是很好的，给分的话，你认真准备，还是能够拿高分的
217819,795,蓝劲松,2025-04-17 03:15:30,0,0,0,。。。
61903,822,张文军,2017-11-21 13:20:58,0,1,1,专业英语任务不多，一次展示一个作文还有一个结课论文，但是课真的有点鸡肋，虽然老师人很nice
102358,822,张文军,2019-02-01 07:12:23,3,4,1,老师特别温和，英语很好，给分也很好。作为外专业的同学，从《国际课程流派》里学到很多教育学的知识。
188137,822,张文军,2024-01-18 09:07:08,2,3,1,老师人还挺好的，但她的课是真的水
201916,822,张文军,2024-11-07 10:46:53,1,1,0,给分挺好
39192,824,丛湖平,2016-12-21 14:02:23,0,0,0,有意思\n\n
39350,824,丛湖平,2016-12-22 07:01:07,1,1,0,虽有时候会跑题不过挺有意思的
6241,887,徐小洲,2015-07-12 09:19:45,-97,12,109,挺好的老师
9122,887,徐小洲,2015-10-13 13:40:44,-98,6,104,好………^_^
11600,887,徐小洲,2015-12-07 10:37:17,160,171,11,吹牛大王
11684,887,徐小洲,2018-01-28 07:45:32,128,134,6,吹牛大师
22400,887,徐小洲,2016-03-04 08:24:53,38,42,4,过誉了
23606,887,徐小洲,2016-04-09 02:03:28,47,50,3,一个字，吹
23747,887,徐小洲,2016-04-14 10:33:20,161,165,4,全社杀一头
24921,887,徐小洲,2016-05-04 10:35:18,81,84,3,呵呵二字
25662,887,徐小洲,2016-10-26 12:56:32,102,111,9,呵呵呵，bitch
29293,887,徐小洲,2018-09-03 12:30:30,264,276,12,不知道这种人为什么可以当院长，还是教育学院，懂什么是教育？
31188,887,徐小洲,2018-04-26 11:48:22,75,81,6,刷新了对院长的认识
49636,887,徐小洲,2017-04-21 01:05:39,625,645,20,坚决把反对创业教育作为必修课
51939,887,徐小洲,2017-06-13 16:08:49,81,88,7,坑逼老师，色胆包天
58690,887,徐小洲,2017-09-15 02:10:06,256,273,17,女大学生人生导师\n\n酒场真男人\n\n学术官僚\n\n地产巨头\n\n农场守门员\n\n乒乓球魔鬼\n\nktv老天王
58713,887,徐小洲,2017-09-15 11:02:33,9,10,1,呵呵呵
58779,887,徐小洲,2018-05-03 01:35:21,59,62,3,创业教育创nmb！
60447,887,徐小洲,2017-10-20 05:37:09,39,41,2,讲课毫无逻辑可言，观点与例子牛头不对马嘴
61354,887,徐小洲,2017-11-15 06:42:13,6,11,5,鬼神莫近的微笑......
61363,887,徐小洲,2017-11-28 16:52:59,52,55,3,什么破课程
61365,887,徐小洲,2017-11-25 09:47:23,25,26,1,辣鸡老师\n\n毁我青春
61569,887,徐小洲,2017-11-26 07:11:23,21,23,2,垃圾绩点，垃圾课程
61578,887,徐小洲,2017-11-25 14:29:20,53,58,5,垃圾课程，毁我青春
61580,887,徐小洲,2017-11-19 01:18:06,24,25,1,不想听
61590,887,徐小洲,2017-11-19 04:14:52,75,77,2,绩杀，必修，别无分号，学了这个课提高了我的创业素养吗？不敢苟同。
61593,887,徐小洲,2017-11-19 04:31:38,25,28,3,绩点杀手
61599,887,徐小洲,2018-01-24 15:27:55,436,443,7,绩杀，给分极不合理，mooc拖沓到不能再拖沓（总时长居然比数学系秋学期“数学分析”的时长还要长），还有，谁给你的权利考前不告诉我们考试内容的??书上一堆mooc里没讲到的你考是几个意思???还必修，不管是不是有创业方面想法的，怕是都不会从你拖沓而无趣的讲课中得到启发。试问:“纯粹浪费时间和拉低绩点的课，还有什么存在的价值?”
61735,887,徐小洲,2018-05-08 07:56:34,1182,1240,58,坚决禁止官僚主义，因为官僚主义是大学教育的最大的蛀虫。我想问，第一，你开这门课，是在真心为学生着想吗？第二，秋学期第一批考试的，谁会想到书上内容要考，你在网上说一句有多么麻烦吗？ 第三，你制造不公平，挫伤了第一批尝试者，你有脸面抨击我们不好好复习吗？你认为公平是吗？那么好，群众的眼睛是雪亮的。如果大家都反应给分不合理，你自己是否应该反省？要不然你就是独裁者，你想推行官僚主义吗？告诉你，绝不可能。 后面学生有了题库，有了答疑，还知道考试范围。前面的学生什么都没有！！！ 学校曾经调查过我们分数，导员也认为给分不合理，说要协商。结果呢？你动用过半点良心吗？你为了个人威严，坚决5级绩杀，让大批秋学期考生受损，牺牲大家，身为教师，你认为合适吗？尤其是竺院的学生，你知道你的强力绩杀对于他们意味着什么吗？他们退院的可能大大增加。 你为了维护你的威严，为了装一下，毁掉多少人的前程，你自己从来没想过吗？ 后人些许的4.5选手，恭喜你们逃脱了这位老师的魔爪，我不阻拦你们给老师打高分。但是，我希望你们要比这位老师更有良心，希望你们知道，我们根本不知道考试范围！！！你们不要因为知道考试范围而抨击我们不知道范围的第一批考生，你们待遇的改善是秋学期考生的鲜血换来的。后人中可能会有高分，但你们不要像忘记，曾经有这样一位老师为了个人威严毁掉大批学生的前程，他曾经做过这样见不得人的事情。 所以，和我一样，做了小白鼠的秋学期考生，跟我一起狠狠地砸；抵制官僚作风的我浙学子，有觉悟的我浙学子，跟我一起狠狠地砸。
61791,887,徐小洲,2019-06-26 16:34:38,75,78,3,不想骂人，但真的被恶心到了。
62066,887,徐小洲,2017-11-22 10:25:18,326,340,14,你的语速就是两倍放还嫌慢的那种。\n\n你的创业基础就是水成海洋的那种。\n\n你的考试却是难到爆炸的那种。\n\n听了九十多集大型泡沫连续剧，最终要考观众第几集男主念了谁的名字？受不了了，豆瓣上给恶评。
62423,887,徐小洲,2017-11-25 06:06:23,140,148,8,这老师太不行，讲的视频很烦躁，内容没重点，考试来说，每个人的试题难度很不均衡，对考生来说不公平，给分超烂，你很容易被正态。极力不推荐选这个老师，很差劲。
62425,887,徐小洲,2017-11-25 06:24:29,26,27,1,不知道这种课为什么可以作为必修课
62426,887,徐小洲,2017-11-25 06:25:26,18,20,2,不知道为什么创业基础要当必修课？
62442,887,徐小洲,2017-11-25 09:22:15,12,13,1,腊鸡水课！大鸡杀！创业创个毛！题还那么难，有病吧
62444,887,徐小洲,2017-11-25 09:26:31,28,30,2,我没有听过他的课，创业基础只开视频不放声，自己该干嘛干嘛，反正他考什么你也不知道，靠自己运气咯
62445,887,徐小洲,2017-11-25 09:27:38,67,73,6,创业基础大绩杀!mooc讲的书上没有，书上讲的mooc没有，怎么，还想让我们两个全都被下来？考试之前没有题库没有范围，瞎b复习考的全都不会几个意思？某个理论谁提出的，15年欧盟颁布哪个发令跟我有啥关系，还指望我背这个？再见吧，我要去炸学校了。
62446,887,徐小洲,2017-11-25 09:31:01,32,32,0,垃圾创业基础还五制\n\n
62447,887,徐小洲,2017-11-25 09:32:42,24,26,2,死垃圾\n\n创业基础\n\n服气\n\n绩杀\n\n滚\n\n
62449,887,徐小洲,2017-11-25 09:40:31,18,22,4,无聊，无用，难以实践。
62451,887,徐小洲,2017-11-25 09:44:50,39,40,1,创业基础MOOC视频没什么用，还不如看PPT
62453,887,徐小洲,2017-11-25 09:49:12,59,61,2,创业基础，给分巨低，明明考的不低，平时分也够了，不知道怎么算的分数，感觉被正态了。拉低了绩点，伤心
62458,887,徐小洲,2017-11-25 10:15:05,22,23,1,我可去你的吧
62462,887,徐小洲,2018-01-26 07:47:45,258,288,30,我没能进竺院都是因为你。 一节课居然可以把4.2的均绩拖到4.0。 你厉害。
62463,887,徐小洲,2017-11-25 10:55:27,19,19,0,没有体验，辣鸡绩杀
62465,887,徐小洲,2018-01-24 10:23:10,-191,7,198,一点没看有关课程方面的东西，考试之前也一点没突击，多亏了室友第一批考，我第二波考的 室友给透了很多题 绩点轻松4.5 不用听也能拿高分。给这么轻松给分还好的老师点赞！? ? ? \n\n
62466,887,徐小洲,2017-12-28 10:50:30,7,9,2,mmm
62471,887,徐小洲,2017-11-25 11:24:27,97,108,11,创业基础大绩杀，基本大家都2.5！本来四点几的均绩，创业基础一出来就下四了，再见吧
62475,887,徐小洲,2017-11-25 11:37:02,5,7,2,嘻嘻高级黑
62477,887,徐小洲,2017-11-25 11:41:35,67,69,2,他的创业概论极大地抹煞了我对创业的兴趣，本来对创业蛮感兴趣的，结果一点干货没有，啰啰嗦嗦一大堆。整整把我的绩点拉低了0.8，不知是否还有比这更烂的课！
62478,887,徐小洲,2017-11-25 11:42:05,91,93,2,我真的不知道创业基础为什么要变成一门必修课，其实很多人根本就没有创业意向，有种专制强迫的感觉。而且没有兴趣，就算认真看书看视频了也没有什么用。而且给分形式和结果真的不怎样，如果我从这节课里学到了很多那我也不会这么难受。抱着我三观正就应该没关系的想法上机，结果三观被刷新。
62480,887,徐小洲,2017-11-25 11:47:44,9,9,0,不满意
62482,887,徐小洲,2017-11-25 11:54:13,13,16,3,一分都多了
62483,887,徐小洲,2017-11-25 11:54:39,27,28,1,反对把创业基础作为必修课
62485,887,徐小洲,2017-11-25 12:03:07,52,54,2,毫无意义的必修课，还是绩杀，拖沓的mooc，内容杂并且多，最后考试却考得非常细，完全形式主义的产物。
62489,887,徐小洲,2017-11-26 04:51:11,121,122,1,垃圾，这中课除了能迎合某些领导的胃口，还能干啥，不能真正增加学生的知识。恐怕只是为了领导的升官和面子。
62491,887,徐小洲,2017-11-25 12:16:24,47,52,5,绩杀！！！创业基础真的有作为必修课的必要吗！？感觉从这节课里学不到什么，考试题也很奇葩！想建议大家不选这门课的，谁让是必修呢！另，吐槽恶心的五级制评分，硬生生拉低绩点！！！
62493,887,徐小洲,2017-11-25 23:05:53,3,5,2,不行…
62495,887,徐小洲,2017-11-25 12:41:56,22,26,4,花了很多时间在mooc上，考前也突击了书的文本内容，结果给我2.5。。。
62500,887,徐小洲,2017-11-25 13:50:28,339,365,26,题难度极不统一。室友啥都没看，考前随便看了一天，还打了半天王者荣耀，考了3.5；我从开学就在看，我还做了笔记！你告诉我最后考的什么？愣是2.5？开学军训死了一样拿高绩点，一门拉到4分以下…考什么完全不说，题库没有，mooc长到吐血…创业基础完全没有存在的必要…
62502,887,徐小洲,2018-04-17 01:11:41,103,112,9,真的不知道为什么一门这么没实质性的帮助的只上半个学期的还是由这样一个傻逼来上的网课居然有两个学分，还他妈是五级制！你的使命就是来做绩杀的吗！？我实在不觉得这门课能在创业上给我们带来什么帮助，课程质量远超你的想象，希望你还有你的教育学院不要再坑害别人了，心疼后面的同学，一大波恶竞即将来临
62503,887,徐小洲,2017-11-25 14:00:06,76,81,5,既然是必修课，那就拜托学校和老师都认真对待。课程内容没有营养，考前也不提供复习方向，考试也不够公平。\n\n创业基础也没有必要是必修课，每个人的人生选择不一样，这样子给大家洗脑真的好吗？\n\n课程不够完善却要求这么高，真没意思。
62506,887,徐小洲,2017-11-25 14:22:02,-46,12,58,室友在寝室考的居然4.5？？
62507,887,徐小洲,2017-11-25 14:29:12,14,15,1,绩杀！
62519,887,徐小洲,2017-11-25 15:25:36,12,14,2,这种课我就呵呵了，纯恶心不偿命，流于形式，纸上谈兵，说辣鸡都是抬高它了。
62525,887,徐小洲,2017-11-25 16:29:45,7,9,2,烂到爆炸，人渣。
62527,887,徐小洲,2017-11-25 23:22:45,1,3,2,巨坑，绩杀
62528,887,徐小洲,2017-11-25 23:40:01,34,37,3,想到创业基础就烦，不知道是疯了还是怎么的搞了这个一个压绩点的玩意，而且我还是第一批考的，完全不知道考什么，真不知道这种不公平的课为什么必修。
62530,887,徐小洲,2017-11-26 00:23:27,20,21,1,不想说了，视频和课本内容完全不一样，也不知道考试的时候以下哪个国家没有创业教育战略这种题是怎么出来的，难道我们要全部背完吗？不对我们连要背什么都不知道。微笑脸
62531,887,徐小洲,2017-11-26 00:35:28,48,48,0,凭什么五级制？相差一两分就相差1.0的绩点？两学分的课就相差2.0？有毒吧？
62539,887,徐小洲,2017-11-26 01:38:11,1,4,3,没听过
62541,887,徐小洲,2017-11-26 01:41:39,5,5,0,我就笑笑不说话
62571,887,徐小洲,2017-11-26 03:29:12,13,14,1,绩杀绩杀
62572,887,徐小洲,2017-11-26 03:37:49,29,32,3,真的是菜，没见过这么渣的老师，讲课毫无逻辑，跟成功学骗子一样，绩点杀手回，毫无道理可言
62573,887,徐小洲,2017-11-26 03:38:35,11,11,0,这种课，我已经找不到更差的词来形容它了！
62577,887,徐小洲,2017-11-26 04:03:50,10,13,3,制度不完善，我们小白鼠不该来承受这些后果
62580,887,徐小洲,2017-11-26 04:06:31,2,3,1,很垃圾
62589,887,徐小洲,2017-11-26 05:10:14,4,5,1,绩杀.
62594,887,徐小洲,2017-11-26 05:48:01,14,14,0,呵呵 认真看视频记笔记\n\n2.5
62595,887,徐小洲,2017-11-26 06:05:28,7,9,2,mdzz，也是呵呵了，水得要死视频没重点，考试难度乱来，哪个zz把这个列为必修的。
62596,887,徐小洲,2017-11-26 06:07:39,41,43,2,无话可说，认真复习看书看mooc，但是因为脸黑第一批考啥也不知道，看到题的那一刻懵逼。第二批后面考的被透题，网站考试靠自觉，在寝室都可以打开，甚至还有在寝室考试的……真的，这样的考法，我大概就是输在第一批考
62598,887,徐小洲,2017-11-26 06:11:03,65,67,2,为什么最低能打1分，这样对0分的课程和老师多不公平
62599,887,徐小洲,2017-11-26 06:45:46,20,24,4,辣鸡课程，毁我青春，绩点一点五。毁我热情！
62600,887,徐小洲,2017-11-26 06:23:46,91,95,4,太tm毒了吧？啊？发了好几次考试通知就tm不说考什么内容考什么范围！开学也不提醒！还tm强行二十个帖子！就为了“国内开创业基础教育的学校有浙江大学”这样的名头断送第一批考试同学的前途！我能说啥！寝室里考考也能上分！干嘛啊这是要！这么不公平！为什么一定要创业，大部分人想搞科研的都想专心搞专业知识！你们这门课就这样把这些把绩点看的很重要的同学往死路上逼！
62605,887,徐小洲,2017-11-26 06:52:16,14,17,3,创业基础网课期末考不给明范围!
62608,887,徐小洲,2017-11-26 07:04:57,10,11,1,不知道这种课程除了拉低均绩还有什么存在意义。\n\n听说还能在寝室考？？？呵呵哒。
62610,887,徐小洲,2017-11-26 07:13:47,23,24,1,辣鸡课程，绩杀zz，还非要必修，你以为我们拼死拼活挣那一点点绩点容易啊，还两个学分，你讲的课有多大用你自己心里还没点b数吗？
62611,887,徐小洲,2017-11-26 07:16:40,0,2,2,∑(O_O；)\n\n(⊙…⊙)\n\n_(:3⌒ﾞ)_\n\n(ﾉﾟ0ﾟ)ﾉ~
62612,887,徐小洲,2017-11-26 07:18:16,19,19,0,来来来，让我们把他的评分干到2.5。我就呵呵呵了，为什么创业基础是必修，一个线上必修？你总得来个缓冲吧。
62615,887,徐小洲,2017-11-26 07:38:17,14,15,1,退院了退院了
62620,887,徐小洲,2017-11-26 07:58:31,8,8,0,听说很恐怖？冬学期的瑟瑟发抖。
62621,887,徐小洲,2017-11-26 08:00:12,11,14,3,听君一席话，恨不能复读。
62622,887,徐小洲,2017-11-26 08:00:24,23,25,2,垃圾课程，第一批考试的，不知道考啥，室友第二场直接背我的题，去她妈的绩杀，大一全毁了
62628,887,徐小洲,2017-11-26 08:33:42,22,22,0,创业基础的mooc不知所云，感觉他只是简单地把自己写的书念了一遍，考试不告知形式范围，考的也不是对创业的理解而是一些毫无意义的东西，最后五级制绩杀。讲道理，这门课真的很烂
62643,887,徐小洲,2017-11-26 08:53:54,-48,3,51,课我都没听，考试随便写了点东西，绩点就3.5了哈哈哈哈哈哈哈哈
62645,887,徐小洲,2017-11-26 09:04:24,30,30,0,老师从不点名（想点也点不上），课程不知所云，没什么意思。创业基础这门课不知为何存在，所有人都要学习创业吗？可以改成选修课，有想学的自己选就是啊。看老师好像很厉害，上课却没什么用。上课都是马云，李嘉诚，所有人都要学马云，李嘉诚吗？讲创业讲的这么滔滔不绝，自己咋不去创业？不想说脏话，只是表达对这门课的不满。
62647,887,徐小洲,2017-11-26 09:14:03,9,10,1,绩杀。
62649,887,徐小洲,2017-11-26 09:16:20,6,8,2,乱来，瞎搞，绩点给分差，好水
62655,887,徐小洲,2017-11-26 09:36:48,5,7,2,辣鸡不解释
62661,887,徐小洲,2017-11-26 09:44:25,67,69,2,真是想不明白为啥要把这门课搞成必修。我不想创业不行吗？\n\n三十个视频里有二十个在讲这门课多叼，上了课的学生创业测试平分多高多高。还有两个再讲一套漏洞百出的理论，前前后后毫无关联不说，还不时自相矛盾。剩下八个视频就是在举一些不知道哪儿来的跟理论一点关系也没有的例子。\n\n这门课开在浙大，难道浙大不觉得拉低了自己的教学水平吗？\n\n最后，老师你那么激动，说创业多好多好，我想问问您，创业辣么好，您为啥来当教授了呢？您咋不去创业呢？
62664,887,徐小洲,2017-11-26 10:02:28,8,8,0,我有一句mmp不知当讲不当讲。。\n\n
62669,887,徐小洲,2017-11-26 10:23:35,8,9,1,呵呵了！mooc根本看不进去，两倍速还慢，考的都是什么鬼??！看了视频，看了PPT也记不住，就是一门毫无意义的课，浪费时间，不如让我们亲身实践来得方便。上了这个课根本没有什么收获，还拉低绩点！！
62678,887,徐小洲,2017-11-26 10:56:28,2,4,2,像听神话故事\n\n只是希望这门课可以再来一年，可以让我重修
62686,887,徐小洲,2017-11-26 11:24:51,4,5,1,一门不得不选的垃圾必修课\n\n
62690,887,徐小洲,2017-11-26 11:46:03,10,11,1,mmp这种课还是必修，五级制绩杀，明明分数不是特别低，mooc视频也都有看硬生生2.5，绩点4+被拉到3+，不想说啥了，为什么没有零分的选项(微笑)
62692,887,徐小洲,2017-11-26 12:03:43,4,6,2,sb!
62695,887,徐小洲,2017-11-26 12:12:03,9,11,2,垃圾。
62715,887,徐小洲,2017-11-26 14:19:14,8,9,1,拖慢社会发展.制约学生进步.毫无意义的课.毫无意义的老师.绝对的差评.
62716,887,徐小洲,2017-11-26 14:20:08,9,10,1,真的。受够创业基础这门课了，考试前不宣布考试形式不宣布考试内容，让我们都拿一个低绩点很开心是么。坚决反对把这门课作为必修课，毫无意义，对我们素养的提高毫无促进作用
62718,887,徐小洲,2017-11-26 14:25:59,2,3,1,mmb
62720,887,徐小洲,2017-11-26 14:28:10,0,2,2,没听过\n\n
62727,887,徐小洲,2017-11-26 15:14:23,4,5,1,垃圾课程
62735,887,徐小洲,2017-11-26 16:33:57,123,128,5,什么时候有能力在讲课的时候能记住课件，眼睛别三秒往旁边瞟一眼再来给人上课吧。\n\n恕我直言，就这讲课水平，浙大大部分学生都能把您给顶下去。\n\n咋不讲绩点，考试是个什么水平你们心里也是有点b数的。没有公平性的考试您随便出，反正我不出国，我不保研，我要考研转专业方向。我只希望，您这水平的老师，别来祸害下一代了。\n\n同学们骂你，给你低分，很多是因为绩点，但我给你低分，是因为你不能给我任何身为老师应该传授或者表现的东西。
62780,887,徐小洲,2017-11-27 03:10:20,2,3,1,mmp
62784,887,徐小洲,2017-11-27 03:15:20,2,3,1,垃圾垃圾就是垃圾
62792,887,徐小洲,2017-11-27 03:45:58,0,1,1,垃圾课程，真的辣鸡
62794,887,徐小洲,2017-11-27 03:49:27,1,2,1,刚刚好话费
62807,887,徐小洲,2017-11-27 04:33:05,1,2,1,完全不知道他在讲什么，深海巨坑
62829,887,徐小洲,2017-11-27 06:03:06,3,4,1,我以为电脑卡住了
62838,887,徐小洲,2017-11-27 06:25:31,11,11,0,绩杀，苦命的2.5
62852,887,徐小洲,2017-11-27 07:05:04,10,11,1,贵课绩点2.5是基本操作吧
62904,887,徐小洲,2017-11-27 10:09:12,1,2,1,什么东西
62909,887,徐小洲,2017-11-27 10:23:18,11,12,1,课垃圾 给分也垃圾 老师不知道想想一个2.5能把一个刚大一第一批创业基础的人心搞得碎成渣渣么 说发帖子要发满20个有深度的帖子 有深度的标准在哪里都没有说 那我们是不是可以理解为想怎么给分就怎么给分 可能确实有人做的不够好 但也不至于这么低吧 我们需要一个交代
62969,887,徐小洲,2017-11-27 13:33:24,5,11,6,你一个2.5把我所有别的辛苦都白费了你知道吗
62988,887,徐小洲,2017-11-28 00:04:01,6,9,3,高中的时候老师开玩笑说教育学就是把简单的东西讲得深奥复杂。当时还以为是因为比较科学系统。上了创业基础的慕课后，我对创业更加困扰了。（其实视频啥的根本就是静音挂着，反而是考前看书做笔记自学了一点皮毛。结果绩点就挂了
63006,887,徐小洲,2017-11-28 01:52:06,5,5,0,垃圾课垃圾给分\n\n真不应该弄成必修
63044,887,徐小洲,2017-11-28 04:07:59,21,22,1,没有习题，没有重点，没有范围，打开试卷前一秒钟我都不知道接下来会发生什么。作为第一批考的学生表示：请考虑一下我们的绩点好吗？你既然作为一门必修课作为一门要考试的课，麻烦给个重点和范围好吗？起码给我们几道题让我们看看你想怎么玩呀。你这样子搞，你的良心不会痛吗？
63059,887,徐小洲,2017-11-28 05:34:10,6,6,0,辣鸡课程，强烈建议取消该课程!
63097,887,徐小洲,2017-11-28 09:00:32,3,7,4,听老师的感觉是一种什么体验？\n\n我以为我吃的屎，到最后发现真的是屎。
63157,887,徐小洲,2017-11-28 23:59:31,6,9,3,这门课会凭借之后修的同学的高绩点而把评分刷上去。\n\n反正除了第一批，之后的都相当于还没考就知道答案
63165,887,徐小洲,2017-11-29 01:46:20,0,2,2,垃圾网课
63182,887,徐小洲,2017-11-29 03:26:59,7,9,2,创业基础真的坑！又不给范围又不给题库，浪费大量时间也得不到好的成绩，严重拉低均绩！而且不公平，之后学的同学可能会有题库！
63217,887,徐小洲,2017-11-29 08:20:29,9,10,1,没听过更差的了，课程设置出奇的诡异，给分第一批学生吃亏太大。这个老师就知道吹，感觉是做行政官员时间长了。另外说他不创业的，人家当官也是创业啊。发个善心，给他个1分
63343,887,徐小洲,2017-12-01 03:53:38,0,1,1,垃圾，课多还没用，考一堆无聊至极抠字眼的东西，这是创业？
63388,887,徐小洲,2017-12-02 08:50:26,23,24,1,和高赞的某位同学一样，本以为能拓展一下视野，结果还是栽在了一堆无聊的文字内容上。我就想问问，把“XX的意义”背得滚瓜烂熟，这对培养创业素质有帮助吗？这种彻底沦为形式主义产物的课有价值吗？另外MOOC内容真的枯燥且拖沓，就是把自己编的课本简单重复一遍，考试范围还不明不白。不过说实话，课本质量还算不错。
63406,887,徐小洲,2017-12-03 07:20:14,5,6,1,莫名其妙的网课，不知道把创业基础作为必修的意义何在。根本不知道考试的范围和知识的重点。绩点创下我的历史新低，最茫然的一门课。
63462,887,徐小洲,2017-12-04 14:59:24,2,2,0,一言难尽
63495,887,徐小洲,2017-12-05 08:16:13,0,3,3,第一次体会到绩点3分以下是什么感觉
63613,887,徐小洲,2017-12-09 12:31:32,2,2,0,无语。。。
63617,887,徐小洲,2017-12-10 01:20:19,12,14,2,老师你在橘子树下面等着，我给你把火车站搬过来
63638,887,徐小洲,2017-12-11 07:05:30,4,4,0,毁一生
63846,887,徐小洲,2017-12-17 12:16:57,3,4,1,这课有助于创业？有必要作为必修课？
63923,887,徐小洲,2017-12-19 11:28:38,41,44,3,一点用处都没有，个人认为很失败的一门水课，而且学分偏高，价格太贵，内容太少且粗糙\n\n作为必修课不合理，而且没有线下实体课程，学生难以知道自己该干什么，应当以学生团队创业实践项目的考核代替机械肤浅无用的计算机考试且将至作为通识核心课，有老师全程指导，分组为创业团队教学考核运营，而不是学生见不到老师，只是在听见老师空谈，对老师的不信任程度大大提高\n\n并不是人人都适合创业都喜欢创业，并且课程内容流于形式，陷入空谈，机械式的考试似乎只是在考验人的记忆力，强制性的任务使人厌烦\n\n本质上依旧是应试教育，将创业精神格式化，枯燥化，简单化，不但难以给学生带来创业的激情和智慧，反而挫灭了学生的创业之心，让孩子对创业感到迷茫和失望
64033,887,徐小洲,2017-12-23 02:03:46,-41,4,45,没什么好说不公平的，大家都是一样的题目，为什么不公平？
64097,887,徐小洲,2017-12-21 03:27:25,10,11,1,绩杀，秋学期没题库我就呵呵了，坚决反对作为必修课
64350,887,徐小洲,2018-01-26 16:34:03,15,20,5,哪国没有创业教育我不知道，但贵浙肯定没有
64455,887,徐小洲,2017-12-24 05:06:33,7,7,0,真心觉得这种课没有任何的意义，对于秋学期选这门课的同学一点也不公平，不知道学校和老师是怎么想的，之前说会调分后来也没了音讯……
64635,887,徐小洲,2017-12-25 23:45:29,7,10,3,查老师是不是把这个关了？前段时间就4.23现在还4.23！还有为什么最低只能打一分？还有我为什么没看到我和我同学的评论？查老师是不是受某某人摆布？我现在怀疑这个平台的透明度和公正性！
64880,887,徐小洲,2017-12-27 15:24:07,2,3,1,呵呵呵
65033,887,徐小洲,2017-12-28 09:56:19,6,7,1,你妈＊讲创业，自己怎么没成为马云爸爸，你妈＊教创业，怎么还在浙大，sbsbsbsb，我特么恶心。
65046,887,徐小洲,2017-12-28 10:54:08,4,5,1,还好没听课，这课就是在浪费时间，没重视过，完全没有收获
65078,887,徐小洲,2017-12-28 13:37:04,8,8,0,2.5不是因为分少才骂。。。
65310,887,徐小洲,2018-01-03 02:06:46,7,8,1,就这样吧，我的前途。\n\n
65345,887,徐小洲,2018-01-03 07:24:54,8,8,0,深海巨坑
65500,887,徐小洲,2018-01-04 16:42:19,35,38,3,垃圾老师，枉为人师，厚颜无耻，寡廉鲜耻，恬不知耻。此獠实乃浙江大学之耻辱，中国高等教育之墓碑，世界创业教育之贼寇，人人得而诛之，远追秦桧，近比豫章，必遗臭万年，永载耻册，以供唾弃。
65563,887,徐小洲,2018-01-06 05:05:55,2,3,1,没有什么用，考试乱七八糟
65586,887,徐小洲,2018-01-06 14:33:03,0,1,1,无聊之课
65745,887,徐小洲,2018-01-09 00:59:27,32,34,2,你给我零分我给你一分以德报怨
65747,887,徐小洲,2018-01-09 02:09:35,5,7,2,为什么这逼货还有4.2的分？？不说你分数学分设置和考核方式很扯淡，光是你上课语速慢成屎还永远摆着副臭脸就够喷了吧？人模狗样
65795,887,徐小洲,2018-01-09 07:26:48,11,12,1,个人感觉创业基础这种课的实效性很小。在实际的过程中绝大多数人是水过的，创业这种重于实际的课程不适合以这种方式来呈现。最后吐槽五级制，这种制度让79分和80分的人的差距，跟71分的人和89分的人的差距，是一样大的。
66024,887,徐小洲,2018-01-24 02:48:07,1,2,1,是不是分数打不下去
66152,887,徐小洲,2018-01-12 06:58:09,4,8,4,我就想知道创业基础均绩3.7你怎么有勇气写上去
66170,887,徐小洲,2018-01-12 08:49:57,0,0,0,
66245,887,徐小洲,2018-01-14 05:17:01,1,1,0,毫无逻辑性可言
66384,887,徐小洲,2018-01-15 14:22:56,0,2,2,不知道这种人怎么当上老师
66394,887,徐小洲,2018-01-16 02:55:02,6,7,1,为什么这样的老师还有4+，创业基础学了有毛用\n\n
66786,887,徐小洲,2018-01-19 05:04:16,1,2,1,绩杀，吹牛大王
66850,887,徐小洲,2018-01-19 07:34:58,2,2,0,emmmm绩杀\n\n能退就退了吧……
67010,887,徐小洲,2018-02-01 08:06:49,0,1,1,呵呵\n\n
67012,887,徐小洲,2018-02-01 12:57:10,4,6,2,作为秋学期2.5的，笑笑不说话了。
68125,887,徐小洲,2018-01-22 15:17:34,0,2,2,呵呵哒
68134,887,徐小洲,2018-01-22 15:37:46,2,3,1,非常坑
68537,887,徐小洲,2018-01-23 10:22:27,0,2,2,退学基础？
68717,887,徐小洲,2018-01-23 15:57:19,53,55,2,老师给分特别好，虽然绩点2.5；老师讲课特别棒，让人想把他从里面就揪出来打一顿；老师长得特别帅，看得我想吐☞
69149,887,徐小洲,2018-01-24 09:01:51,2,3,1,辣鸡老师 毁我青春
69191,887,徐小洲,2018-01-24 09:51:15,1,2,1,极其差劲
69343,887,徐小洲,2018-01-24 13:38:38,3,4,1,把创业基础作为一门必修课真的不是一个明智的决定，学完之后没有什么实质性的帮助
69408,887,徐小洲,2018-01-24 15:44:40,8,9,1,真的太无耻了。我们秋学期的学生就真得成了牺牲品。本来这是第一次，出现点差错很正常。但老师看到我们的绩点后，应该考虑给我们调分或不用五级制吧。既然就这样就不管我们了，太不负责了。你们这样是在让我们为你们的错误付出代价。
69410,887,徐小洲,2018-01-24 15:21:54,0,2,2,懒得评论，毫无意义的课，下一个
69553,887,徐小洲,2018-01-25 03:45:53,0,1,1,呵呵哒
69554,887,徐小洲,2018-01-25 03:47:12,15,15,0,我觉得这门课就是浪费时间，真正有用的内容没有多少，同时，考试没有题库没有范围，作为第一批考的人就是小白鼠一样的存在，绩点也很低，真的很拉绩点！！很容易一不小心挂了，给你四个外国人名字让人选一个，这种题也要出？？？这是存心想让我们挂科吗？这种问题知道了有什么用吗？？用来吹逼？？
69559,887,徐小洲,2018-01-25 03:52:43,2,2,0,最sb的课
69590,887,徐小洲,2018-01-25 04:38:29,1,1,0,呵呵呵
69670,887,徐小洲,2018-01-25 07:41:40,0,1,1,体验很差
69679,887,徐小洲,2018-01-25 08:01:34,12,12,0,他作为一个教师，自己都没有把课程内容摸清楚  只知道瞄着小屏念 还念的漏洞百出 实在看不下去 太恶心了
69735,887,徐小洲,2018-01-25 09:42:20,0,1,1,难受，听的想吐
69736,887,徐小洲,2018-01-25 09:42:36,3,3,0,rua
69747,887,徐小洲,2018-01-25 10:10:34,0,2,2,呵呵的体验
69799,887,徐小洲,2018-01-25 11:56:51,2,2,0,傻逼傻逼傻逼傻逼傻逼傻逼傻逼傻逼
69804,887,徐小洲,2018-01-25 12:12:52,5,5,0,呵呵，创业基础，这种没有干货，拉低绩点的垃圾课，还是赶快取消吧！
69829,887,徐小洲,2018-01-25 13:17:21,15,15,0,官僚主义形式主义的代表，大学教育失败的典例，大学生，不是某些人迎合领导口味的小白鼠！
69832,887,徐小洲,2018-01-28 02:06:19,-114,6,120,没有复习出奇意料的简单，随便就4.5了，秋学期听说停办，但是冬歇期的题太简单了，希望以后加大难度啊，要不然没有区分度，这个课就没意义了。mooc学习本来就比较水，要是考试再不严格，这个课有存在的意义吗？所以说，老师希望您能加大难度，真正地考出浙大学生的水平！
69920,887,徐小洲,2018-01-25 16:10:54,3,5,2,Fxxk
69965,887,徐小洲,2018-03-10 10:25:47,16,22,6,为什么没有0分，这对老师太不公平了。
69972,887,徐小洲,2018-01-31 10:00:23,24,25,1,我没有在大四选这门课，我没有看到徐小洲的评论，我没有测试时超高的rp，我不能耐心下来背一堆没用的垃圾，我不能在考崩以后给老师1个0分，我是傻逼
69983,887,徐小洲,2018-01-26 01:25:18,0,1,1,绩杀  课程真是太垃圾了  \n\n
69986,887,徐小洲,2018-01-26 14:56:59,-58,8,66,对不起了各位，我要给徐小洲教授打10分。我认为他是一个负责任的人。虽然我是4.5，但是这是我的客观评价。
69990,887,徐小洲,2018-01-26 11:01:39,-72,5,77,秋学期一大波恶评，怎么感觉冬学期的考试超级简单啊，只是简简单单看了一小会书，就错了不到五个。力挺徐小洲，力挺创业基础。要是学分还高一些就好了。
69991,887,徐小洲,2018-01-28 06:40:25,-102,5,107,要是学分是4分就好了，这样我的绩点就不会只被拉高0.1了，什么都没看过，4.5，开心~
70007,887,徐小洲,2018-01-26 02:57:04,0,1,1,。。。
70008,887,徐小洲,2018-01-26 02:57:01,1,3,2,这样的课存在的意义在哪里！
70009,887,徐小洲,2018-01-26 02:57:07,0,1,1,为什么要必修???
70013,887,徐小洲,2018-01-26 03:05:09,6,8,2,这门课存在的意义在哪？为了拉低绩点存在？我想说，有谁学完了所谓的创业基础后，感觉真的学到了很多东西？你设置为选修的话，我举双手赞同，你设置为必修，呵呵，目的在哪？就是一门辣鸡课。
70022,887,徐小洲,2018-01-26 03:48:15,2,2,0,烦啊啊啊啊啊啊啊啊啊，绩杀，毫无用处，
70048,887,徐小洲,2018-01-26 04:57:23,4,5,1,那些说很简单的是认真的吗
70079,887,徐小洲,2018-01-26 05:29:02,0,0,0,呵呵……
70148,887,徐小洲,2018-01-26 07:22:51,5,5,0,辣鸡，毫无用处，不想创业
70153,887,徐小洲,2018-01-26 07:31:23,0,2,2,熬夜看ppt结果考书
70157,887,徐小洲,2018-01-26 07:33:56,1,1,0,大sb
70161,887,徐小洲,2018-01-26 07:41:32,2,4,2,上完这门课我知道zju为什么这么水了
70228,887,徐小洲,2018-01-26 09:12:00,-63,3,66,我要满绩，你考诉我最高4.5？
70229,887,徐小洲,2018-01-26 09:12:14,1,2,1,什么通知也没有是最烦人的。
70506,887,徐小洲,2018-01-26 23:17:51,98,99,1,我翻开创业基础一查，这创业基础没有年代，歪歪斜斜的每页上都写着“创业”几个字。我横竖睡不着，仔细看了半夜，才从字缝里看出字来，满本都写着两个字是“绩杀”！
70523,887,徐小洲,2018-01-27 00:34:13,2,2,0,垃圾老师，渣渣玩意
70801,887,徐小洲,2018-01-27 14:10:40,6,7,1,绩杀，书本内容倒还好……实在是视频课无聊，必修太坑，考试形式太死板，五级制太不科学了吧？而且以后肯定会有题库出来哇，除非你们一年更新一次题库，这样才能保证公平吧。早知道大一不修创业基础了，气死我了
70814,887,徐小洲,2018-01-27 14:23:14,0,2,2,辣鸡 无聊 绩杀 呵呵
70852,887,徐小洲,2018-01-27 15:41:17,0,0,0,无聊，无趣，无用
70969,887,徐小洲,2018-01-28 01:59:28,9,11,2,第一，强烈要求慕课增加倍速功能，这一点wk老师的程序设计基础做得就很好；第二，如果是必修课的话请把创业基础的考试放到最后一门考试的后一天或两天好吗，如果不行的话请不要强制要求半小时内不得交卷，考场有很多十五分钟做完然后坐着干等的人，有这时间还不如提前出去复习下一门考试；第三，虽然看视频计播放次数，就计到截止日期就好，之后希望不要关闭视频，让对创业不感兴趣的同学也有时间复习；第四，有一堆同学告诉我他们考试的时候在搜百度，what？欺负我讲诚信？第五，不知道对于帖子是怎么审核的，不过就秋学期同学的体验来看，一句话水完和仔细思考分析后写下大几百字毫无区别，甚至可以复制粘贴别人的评论，（我不是说评论公开不好毕竟看评论有助于加快对一个知识点的理解。）我牺牲了两天复习几何的时间用来学视频写评论，最后几何都没有复习完，结果最后的回报是创业基础2.5。（几何也崩盘，不过这个就不让创业基础背锅了谁让我选择复习创基不复习几何呢？只是很羡慕一个小时写完评论的室友罢了。）
70978,887,徐小洲,2018-01-28 01:24:43,0,1,1,膈应\n\n
70996,887,徐小洲,2018-01-28 01:36:51,4,6,2,鼓破万人捶 这个评分您自找的
71063,887,徐小洲,2018-01-28 02:16:24,2,2,0,怎么没有0分
71089,887,徐小洲,2018-01-30 08:51:09,2,4,2,唉……
71094,887,徐小洲,2018-01-28 02:49:13,3,4,1,抱歉我不创业
71152,887,徐小洲,2018-02-02 06:02:14,-73,25,98,第一次评论，很多主观感受请见谅！！！\n\n首先，假如我是徐小洲老师的话，看到你们这些抱怨真的会觉得很难过的！我是秋学期上的创业基础，差不多每个视频都挺认真的看（偷偷讲是开的二倍速。。。）最后大概做了半本小本子的笔记。真的，虽然记着的不多，发自内心的觉得徐老师讲的内容挺系统全面，而且讲的也特别认真，个人认为认真听是可以学到好些东西的！或许我和你们大多数人不太一样？我从来不觉得绩点这种东西有什么重要的，也从来没有去奢求过。可能有一些同学拼了命去挤那些给分好的水课，到头来除了一个4点几的数字什么也没学到。我个人认为这做法挺愚蠢的。。。况且我的一位语文老师曾经告诉我，凡事因上努力，果上随缘，一切都是最好的安排！因此我个人真的觉得不能凭给分，绩点去抹杀一个老师的所有努力！我认为凭给分论老师高下的做法恐怕有些违背入学的初衷？个人觉得我们是来学习知识的，不是来刷绩点拿奖学金保研找高薪工作？和生活的满足感比起来，钱算的了什么？好吧有些讲偏了。。。不过你们真的没有觉得，每个视频最后徐老师微笑地说再见的画面特别可爱吗？。。。而且我考试前还在机房前遇到徐老师本人，激动得说哇塞终于见到真人了！然后就看到徐老师乐得不行，还拍了拍我的肩膀。。。emmmm。。。水平不行自己也不知道在讲什么东西，不过打了这些字还是希望那些对课程绩点不满意的同学可以释然一些，对老师宽容一些吧？谢谢。
71169,887,徐小洲,2018-01-28 05:30:37,0,1,1,呵呵呵
71182,887,徐小洲,2018-01-28 06:10:14,1,2,1,呵呵呵
71186,887,徐小洲,2018-01-28 06:16:28,0,1,1,差很差
71188,887,徐小洲,2018-01-28 06:17:38,5,6,1,一门必修创业基础，只能呵呵，难道浙大学子非要求创业吗？个人选择不同，你这般强行必修用意何在？既然是讲课，我真不清楚你到底在讲什么，书上内容也不提，考试一对书上概念题，我们是学的创业基础，不是创业概念，课程是为了增强创业素养的，而不是想文科生那样背书的，书上所有内容在以后想创业的时候都可以查到，这种考试有何意义？到时候浙大就多了一群创业概念讲的头头是道的人，而不是真正会创业的人。真心不懂你是如何成为院长的，呵呵。
71194,887,徐小洲,2018-01-28 06:25:22,-2,0,2,垃圾垃圾
71195,887,徐小洲,2018-01-28 06:27:29,0,1,1,辣鸡水课 毁我青春
71196,887,徐小洲,2018-02-01 08:23:47,1,2,1,因为这门课绩点掉了好多\n\n心痛\n\n这种课真的有意思吗？\n\n考试就是看运气的
71204,887,徐小洲,2018-01-28 06:35:41,0,1,1,
71215,887,徐小洲,2018-01-28 06:56:56,1,1,0,呵呵呵
71237,887,徐小洲,2018-01-28 07:40:49,6,8,2,听老师课是一种怎样的体验？\n\n谢邀。大概就是被四十岁的女的上了还给钱贼少的感觉吧。\n\n
71240,887,徐小洲,2018-01-28 07:41:47,3,4,1,你们让秋学期学生怎么办…我们的绩点怎么办？保研怎么办？退院怎么办？我们什么都没有！你有良心么？狗都嫌你恶心不愿意吃你的良心吧！
71258,887,徐小洲,2018-02-02 06:02:30,-43,2,45,老师很好
71260,887,徐小洲,2018-01-28 08:08:19,2,2,0,一分刷一波~
71275,887,徐小洲,2018-02-01 10:43:37,12,13,1,一门能把我一个学期的均绩拉低0.3的垃圾课。
71284,887,徐小洲,2018-01-28 08:45:23,0,1,1,地狱体验
71287,887,徐小洲,2018-01-28 08:49:33,4,4,0,考试分高，但绩点爆炸，这老师怎么乱给绩点？
71324,887,徐小洲,2018-01-28 09:44:00,2,2,0,真德菜
71327,887,徐小洲,2018-01-28 09:51:40,0,1,1,均?玩完
71342,887,徐小洲,2018-02-05 23:25:36,-89,3,92,个人觉得如果认真把ppt看一看，书再翻上一遍，得4.5不是一件多困难的事。毕竟是两学分的课，也要认真对待吧。也是可以学到一些知识的，在我上过的通识课里面其实算是还不错的了。我们秋学期虽然做了小白鼠，但冬学期考的晚呀? ，比较平衡。唯一不满的为什么是五级制？！比正常的绩点低好多好嘛？！
71398,887,徐小洲,2018-01-28 11:40:50,0,1,1,呵呵哒
71401,887,徐小洲,2018-01-28 11:44:58,0,1,1,题是你出的吗，那你真 的 很 棒 哦！
71458,887,徐小洲,2018-01-28 13:15:42,7,7,0,什么？均绩3.7为什么我2.5？
71488,887,徐小洲,2018-01-28 13:54:10,1,2,1,这门课我只学了一个星期
71520,887,徐小洲,2018-02-01 08:14:43,32,36,4,退学基础均绩2.96  3.5排名3％?，自行体会
71523,887,徐小洲,2018-01-28 14:39:40,2,3,1,给一分是因为最低没有零分
71560,887,徐小洲,2018-02-02 05:44:12,4,6,2,真的服，一门课直接和竺院无缘，真是谢谢你了哦！
71568,887,徐小洲,2018-01-28 15:32:34,7,7,0,刷夜复习创基 那么创基到底TM考什么东西啊 有谁能告诉我嘛 就考这种狗逼东西？？？啊？？？  还TM2学分 真TM狗拿耗子 老师么线上的 大纲么没有的 题库么不存在的 绩点么TM乱给的 真特么无语
71586,887,徐小洲,2018-01-28 15:58:29,178,179,1,"没意义。且不局限于绩点，毕竟自己非竺院的学生，也不追求保研。撇开这些，单看课程本身，觉得不合理，对自己任何素质能力没提高。\n\n首先授课方式，网络视频，然后回答问题。确实这算方式新颖。但这新方式难免有弊，比如像我会去空放视屏，然后刷贴吧一样在回复区灌水凑20贴。这样水，有失全国第三大学的体统。\n\n其次授课内容。很多内容有关于经济，管理相关。内容多但很浅，常是一些概念罗列，缺少生动的描述，内容枯燥，缺少全国第三大学的水平。\n\n再来聊人人喊打的根本原因:必修全年级。如果你觉得某课某老师的授课给分不符合期待，多少有自己做二次选择的权利。别的课都如此，但这课统一的慕课和强制必修却让人看到大学最令人憎恶的那一面:僵硬的体制，领导一言堂。要全年级这么多人洗耳恭听您精彩授课，怕是很难服众。况且精彩与否，风评和预期大相径庭。这体现我全国第三大学的专制。\n\n课程设置的初衷，其实很明白。最近几年，举国上下，无不重视双创，因此也需要高校这一层面起到引导作用。浙大这两年双创成绩斐然，想:扛起这面大旗，舍我其谁?可仔细想来，其实这课名不正言不顺。若我创业，必考虑:我要做市场调研，学习相关科学技术，寻场地做出一些产品，然后做企划书，寻找风投拉来投资。然后创业就成功一小步了。这背后用到的调查分析，科学学术能力，管理能力，如何寻找投资等等能力，他的课程都讲了但都蜻蜓点水。我如果创业根本不会看这种浅薄的垃圾。听闻前几年不少三本院校盲目跟风开很多""对外汉语""专业，结果就业遇冷原因:这既非汉语也非外语，好像也非正经翻译。到创业基础，就是既不教管理，也不教科学知识也不会教授你经济金融。与其折腾这种课，不如多点有趣的经济，管理等课程，或鼓励学生多读书增强批判性思维，都比这强。\n\n望上级能瞄一眼我胡言乱语的作文。学校莫跟真三本一样被新生事物冲昏头脑，还是鼓励勤奋踏实的良好学风为是！后生莫受害！\n\n"
71620,887,徐小洲,2018-01-28 17:24:20,5,6,1,垃圾创业基础 我们秋学期真的什么都不知道就面对那一张垃圾卷子好吗 而且五级制真的很垃圾很垃圾 你就用这样的制度来抹杀学生的努力吗 垃圾徐小洲真tm想给1分
71800,887,徐小洲,2018-01-29 03:21:51,0,1,1,绩杀一个
72180,887,徐小洲,2018-01-29 13:58:56,35,37,2,创业基础就是，授之以鱼，考之以鱽鱾鲀鱿鲃鲂鲉鲌鲄鲆鲅鲇鲏鲊鲋鲐鲈鲍鲎鲝鲘鲙鲗鲓鲖鲞鲛鲒鲚鲜鲟鲔鲕鲑鲧鲬鲪鲫鲩鲣鲨鲡鲢鲤鲠鲥鲦鲺鲯鲹鲴鲶鲳鲮鲭鲵鲲鲰鲱鲻鲷鲸鳋鳊鳁鳀鲾鲼鳈鳉鳃鳄鲿鳇鳂鳆鳅鲽鳌鳒鳎鳏鳑鳐鳍鳘鳛鳕鳓鳙鳗鳚鳔鳖鳜鳟鳞鳝鳡鳠鳢鳣鳤。背了PPT也看了书，绩点2.5不说什么了。您那么厉害，您开心就好。
72182,887,徐小洲,2018-01-29 13:59:08,15,15,0,创业未半而中道崩殂……
72227,887,徐小洲,2018-01-29 14:53:57,4,7,3,讲课内容毫无帮助可言。反正我不转专业不出国不考竺院，期末考前突击一个晚上大概有个2.5，时间损失不大。只是有点心疼被脑残的官僚们设置的垃圾课程坑惨了的有相关需求的同学们。最后，后面的几届应该会有我们用自己的绩点换来的题库了。退学基础，呵呵。
72236,887,徐小洲,2018-02-01 10:25:58,10,12,2,创业基础跻身微积分线代等重要课程行列的方式是强行把均绩拉低？傻子哦！直接喷！不走流程！
72427,887,徐小洲,2018-01-30 06:04:14,1,2,1,垃圾课程
72493,887,徐小洲,2018-01-30 08:32:50,0,1,1,垃圾垃圾\n\n
72510,887,徐小洲,2018-01-30 09:15:57,1,2,1,毁人生
72568,887,徐小洲,2018-01-30 11:37:01,8,9,1,您是真的牛，我感觉我也能当院长了。
72711,887,徐小洲,2018-01-31 02:52:12,0,1,1,拉我均绩，什么辣鸡课程毫无用处
72752,887,徐小洲,2018-01-31 04:37:30,5,6,1,退学基础，不多说了
72755,887,徐小洲,2018-01-31 04:51:08,3,5,2,为啥没有零分，为啥，
73078,887,徐小洲,2018-02-01 01:23:36,2,2,0,绩杀。
73144,887,徐小洲,2018-08-29 08:05:10,2,4,2,无意义的必修
73227,887,徐小洲,2018-02-01 08:03:34,7,9,2,冬学期考试前复习了三整天，完整的看了视频做了笔记，还翻了遍书，全考场最后一个交卷。卷面却只有60分，这让我怀疑人生。一门课将绩点拉低好多，害怕耽误下半年的竺院选拔。\n\n
73230,887,徐小洲,2018-02-01 08:14:08,2,3,1,垃圾老师垃圾课，垃圾创业基础坑死学生
73235,887,徐小洲,2018-02-01 08:24:32,0,1,1,垃圾。
73237,887,徐小洲,2018-02-01 08:25:57,2,4,2,不错，人长的能看，拖我均绩0.15
73238,887,徐小洲,2018-02-01 08:26:51,0,1,1,不说了
73242,887,徐小洲,2018-02-01 08:30:58,4,5,1,绩点被拉0.2…
73244,887,徐小洲,2018-02-01 08:31:21,24,27,3,创业基础已经被同学们戏称为退学基础了，我想学校和开设这门课程的老师需要反思了，首先并不是所有人都想创业，你把它设为必修课程就很不实际，其次，既然已经是必须课程了，为什么不好好地准备课程，20个视频、20个帖子水水就过，视频内容毫无意义，帖子也基本千篇一律，这些指标有什么意义？如果只是为了那个创业率最高的头衔，那么我只能说我浙这样下去永远都不会是一流大学，考试也什么意义都没有，请问哪些关于创业的概念、定义有什么意义？考几个人名、多大比例、什么作用，就算不了解这些对创业有什么影响呢？下一届可能会有题库了，他们基本上都会考得比我们好，但我希望我浙能改改这华而不实的学风了，多作实事，少一些面子工程。
73245,887,徐小洲,2018-02-01 08:31:48,1,2,1,垃圾垃圾，拉低我绩点，真是垃圾垃圾
73247,887,徐小洲,2018-02-01 08:32:40,1,2,1,很不好，拉绩点，什么破创业基础\n\n
73248,887,徐小洲,2018-02-01 08:33:27,2,2,0,垃圾创业基础毁我绩点
73251,887,徐小洲,2018-02-01 15:31:34,5,8,3,有太多时间无谓的被浪费了，而且从课程形式到课后反馈到考察方式到绩点给分没有一个是优解；平心而论，老师水平可能不至于1.13，但是整个课程真的让人不爽。
73252,887,徐小洲,2018-02-01 08:41:08,3,4,1,毫无意义的课程 而且没有公平性
73253,887,徐小洲,2018-02-01 08:41:14,2,3,1,俏丽吗？？？
73255,887,徐小洲,2018-02-01 08:42:25,17,20,3,我真他妈不知道这门课开出来有什么用处。虽然都说秋学期的是小白鼠，可是我也忍不住说一句这题库的难度是极其不统一的。我考前认认真真地看了pdf还有书本，也自己整理了。可是呢？？？考了一堆乱七八糟的东西，书上和pdf上的内容可能只占到了考题的百分之六七十？？？我都不知道该说什么了？？？特别是五级制，太拉绩点了，在有20+学分的情况下2.5的绩点硬生生拉了我均绩0.18我都不想说什么了只想骂人啊。这老师为了自己的尊严和荣誉极力简直五级制不改变，这样下去整个浙大的新生都会恨你入骨。你有没有想过你自己这种不公平的教育方式给多少人带来了痛苦？自己是教育学院的？？经历过一个秋学期的学习之后难道你还不懂得反思一下吗？辣鸡老师
73259,887,徐小洲,2018-02-01 08:49:37,12,14,2,我真的无语了。。。说实话冬学期考生几乎没有什么受益，我真的强忍着爆粗口的冲动，告诉我这门课的意义在哪里，毁掉新生的信心吗？背了一堆毫无用处的东西，帖子视频都是走形式，有什么用？！
73266,887,徐小洲,2018-02-01 09:00:21,0,1,1,难受 呕吐
73269,887,徐小洲,2018-02-01 09:02:01,0,0,0,如果可以我想打0分
73273,887,徐小洲,2018-02-01 09:05:15,1,2,1,好生气！！那么认真！！均绩下4了！！烂课！！
73274,887,徐小洲,2018-02-01 09:08:42,18,21,3,努力学习了，却被一门莫名其妙的垃圾课程拉了均绩，这什么脑残的教育，对得起认真学习的学生吗，大雪天等在寝室就为了这么个玩意儿，想想都恶心
73275,887,徐小洲,2018-02-01 09:08:42,2,3,1,哇，真的太生气了，忍不住来打分！
73278,887,徐小洲,2018-02-01 09:14:03,-23,4,27,课被骂的体无完肤大家也都有目共睹了，我想说的是 既然事实体制无法改变，而为了公平起见我们这一届创业基础必须作为全体必修的话 ，那我们应该要想的是对策。至少在考试前你需要做的是把它当作一门2学分的课来认真复习，而不是人云亦云，认为体制不够完善就不好好学那结果想好看都难吧。还有就是复习时找前人咨询经验应该怎么复习，我虽然对这节课没有任何好感甚至觉得很浪费时间但我认为至少这是一节考试内容能够被复习到的课，你所需要的仅是正确的方法以及端正的态度，有了这些你的绩点并不会难看到哪里去。然而很多人方法不对态度不端正导致绩点不好看这才是谩骂声如此之高的重要原因吧。
73280,887,徐小洲,2018-02-01 09:16:26,3,3,0,垃圾课程，毁人青春
73281,887,徐小洲,2018-02-01 09:18:19,9,11,2,我不懂这种赋分制，你怎么不就5.0和1.5呢。88拉成80。感觉真的是垃圾。三分一档我也就忍了
73282,887,徐小洲,2018-02-01 09:18:57,17,19,2,看评论都这么说了，我说不上什么。\n\n希望浙大得老师们能够重视学生们得意见，好好反思一下。浙大得创业氛围的确很浓厚，很多方面是一流高校像清北和复交都比不上的，但是这门课程还是要好好反思，是什么做的不对，哪里还应该改正。\n\n浙大有很多出名的搞创业教育的老师，像浙大勤创的指导老师高峰老师，他们都创业教育经验往往更加贴近我们大学生生活，而不是像这样说的滔滔不绝却遥遥无期。浙大创业教育应该用心做，而不是这样随便交付任务！\n\n还有就是，我身边很多最终绩点2.5或是1.5的同学，并不是没有好好复习，更多的人，为了这门课，认认真真看了书和ppt。我们大家都希望能从浙大创业教育中获得更多干货的东西而不是水水就好，也希望我们每一次的认真都能得到应该得到的成绩而不是开了一堂课却遭来一顿臭骂！\n\n希望老师们能够认真吸取同学们反馈的意见！！也希望浙大创业教育发展的越来越好！！
73284,887,徐小洲,2018-02-01 09:20:50,5,7,2,2倍速都嫌慢，网课没什么重点，有种很散的感觉。考试看直觉。好好复习不一定能拿高分。过来人的经验。
73286,887,徐小洲,2018-02-01 09:24:08,13,13,0,五级制评分太不公平，考试内容也有很多的随机性，最重要的是不是每个学生都对创业有兴趣，把它定为必修课完全只是为了学校的名声，完全不是一个为学生考虑的行为。
73290,887,徐小洲,2018-02-01 09:29:26,0,1,1,辣鸡老师
73293,887,徐小洲,2018-02-03 13:37:06,18,21,3,楼下那个，怕不是**。你以为就你认真学了？！第一，认真学的肯定不止你一个，考试靠的是运气，运气好些是认真学的结果？逗。第二，在普遍骂声的情况下，这门课真的有你口中那么好？！第三，客观来讲，这门课不说你的绩点，看平均绩点以及老师时不时卡壳的讲课和瞄ppt，怕不是在抹杀学生的创业热情？另外呵呵一句？我严重怀疑你看过整个视频？怕每个视频就看了开头结尾。第四，课不行不算什么，但你自己讲课水平不行，玄学的考核制度，为什么要我们的绩点来承受？你怕不是**
73304,887,徐小洲,2018-02-01 09:51:58,-2,1,3,tql
73305,887,徐小洲,2018-02-01 09:52:04,25,27,2,我是新来的，请问直接喷还是走流程
73306,887,徐小洲,2018-02-01 09:52:18,10,12,2,这门课千万不要复习，千万不要复习，不要复习，那只会浪费时间
73307,887,徐小洲,2018-02-01 09:55:24,6,6,0,不想说话
73308,887,徐小洲,2018-02-01 09:56:55,7,11,4,拉了我均?，直接和竺院工高拜拜?
73310,887,徐小洲,2018-02-01 09:59:08,0,1,1,坑！太坑了！
73311,887,徐小洲,2018-02-01 09:59:30,4,5,1,秋学期2.5的再来骂一遍\n\n拜拜吧您
73316,887,徐小洲,2018-02-01 10:12:08,2,3,1,呵呵呵呵呵呵
73320,887,徐小洲,2018-02-01 10:19:54,4,7,3,创业教育有用，但正如第十章PDF里面说的那样创业课程还欠完善。
73321,887,徐小洲,2018-02-01 10:26:27,1,2,1,像狗屎一般恶心
73322,887,徐小洲,2018-02-01 10:26:28,2,2,0,哼！！
73323,887,徐小洲,2018-02-01 10:27:21,8,8,0,出成绩了来打个1分
73325,887,徐小洲,2018-02-01 10:40:43,2,5,3,出成绩了，难受的要死，垃圾课
73327,887,徐小洲,2018-02-01 10:42:26,5,5,0,呵呵，呵呵，呵呵，nmb！
73330,887,徐小洲,2018-02-01 10:47:05,0,1,1,糟蹋心情
73333,887,徐小洲,2018-02-01 10:48:25,1,2,1,大烂人
73336,887,徐小洲,2018-02-01 10:53:08,6,7,1,考试前已经喷了一遍，当时评分还有三点多，考试后一看，果然拉到一点多了，好，大快人心。有空再来喷一喷，不喷就对不起我这不忍直视的绩点。
73343,887,徐小洲,2018-02-01 11:19:20,2,6,4,冯唐易老，李广难封。\n\n\n\n竹园再见
73345,887,徐小洲,2018-02-01 11:24:51,8,8,0,辣鸡老师，我感觉都做对了，绩点2.5，亏我还认真听和复习
73346,887,徐小洲,2018-02-10 13:00:59,25,25,0,希望徐老师以后能对学生负责，不要随意打分，不是大家讨厌你，是你真的很讨厌，不能算一位合格的老师，你的院长职务不知道怎么拿到我们不追究，但愿像你这样的老师少一些，不祝你新年快乐了，不值得。
73347,887,徐小洲,2018-02-01 11:52:07,9,10,1,无任何实际意义，恳请校方就“创业基础”课程作慎重考虑。考试命题及给分，运气成分过大；教师水平不敢恭维，极大打消学生创业积极性。
73348,887,徐小洲,2018-02-02 02:59:53,9,9,0,就不能打0分吗
73355,887,徐小洲,2018-02-01 12:06:30,3,4,1,傻逼老师傻逼课程
73362,887,徐小洲,2018-02-01 12:23:56,10,10,0,呵呵，求求你，考什么讲清楚行吗？看一群学生提心吊胆不知道怎么准备你是满足了还是高潮了？PPT关闭时间你给个通知不行吗？什么不说突然不让看了感觉自己很牛逼当个老师真好玩真舒服爽歪歪是吗？能感受一下其他课出来均绩挺好看的结果来了个goupi创业基础均绩脸一黑的学生的心情吗？这种必修？呵呵，是想把我这种垃圾学生笑死，然后显得NB是吧？就是为了这种优秀老师，查老师舍不得设0分对吧，不然票投出来，多难看呀您说对吗？
73371,887,徐小洲,2018-02-01 12:33:49,0,0,0,呵呵呵
73381,887,徐小洲,2018-02-01 12:52:39,3,6,3,觉得老师不行大家都有同感 但是有个热评你能别攻击教育学院吗
73382,887,徐小洲,2018-02-01 12:53:35,1,3,2,秋学期的我再来骂一遍，真的垃圾，不光没用，浪费时间，还绩杀，强行拉低绩点，好好学了一波考的什么乱七八糟的，真的垃圾。
73384,887,徐小洲,2018-02-01 12:57:40,0,1,1,mooc太长了
73390,887,徐小洲,2018-02-01 13:13:36,0,2,2,我竟无言以对
73394,887,徐小洲,2018-02-01 13:21:36,1,1,0,
73397,887,徐小洲,2018-02-01 13:38:21,-15,4,19,秋学期的同学是应该吐槽 ，冬学期学的同学就省省吧 毕竟都有前车之鉴，可以问之前考的同学了
73402,887,徐小洲,2018-02-01 13:44:12,6,8,2,爽啊  视频直接静音打王者    差评  没有自动播放下集   考试嘛   重在参与   看到那些认真复习考试跟我一样的也是蛮惨的
73403,887,徐小洲,2018-02-01 13:44:27,11,12,1,竺老校长在，会让这种课出现吗？开这种课，只会抹黑我们浙大求是创新的校训。
73411,887,徐小洲,2018-02-01 14:01:47,3,3,0,退学基础，毁我均绩
73417,887,徐小洲,2018-02-01 14:14:09,2,3,1,创业基础，浪费时间，对很多学生来说没什么意义...不应该作为必修。两学分..认真复习了然并卵，拖均绩
73430,887,徐小洲,2018-02-01 14:26:33,4,4,0,无fuck说
73492,887,徐小洲,2018-02-01 16:41:33,16,18,2,他终于，要追上孙大雁和林建华了，加油。
73506,887,徐小洲,2018-02-01 23:58:43,4,7,3,我就想知道你创过业么\n\n滚
73515,887,徐小洲,2018-02-02 01:01:31,0,2,2,均绩是怎么来的？
73526,887,徐小洲,2018-02-02 01:41:44,0,1,1,辣鸡课程，毁我均绩
73540,887,徐小洲,2018-02-02 02:30:54,19,21,2,绩杀，不解释。我生平最厌恶的就是形式主义，相信大多数同学的想法和我一样。我知道，我校作为全国创业率最高的高校，当然希望推广普及创业基础教育，可以说出发点是很好的，但我认为不应采取这种授课方式。且不说网课效率本就比较低下，这种考核方式也是极其令人不爽。试问，我是否有必要具体地知道某组织是哪一年哪个月在哪里建立的？这对创业有何意义？我是否又要精确地记住某些生搬硬套的英文字母缩写？我不敢说自己清楚什么样的教育方式才是正确和有效的，但我知道这种方式一定是不合理的。所谓创业教育，不应该只停留在理论层面，更应该在实践中进行。希望学校慎重考虑该课的存在与否，让我们这一届成为唯一的牺牲品，也希望我校今后的创业教育以正确的方式蓬勃发展！
73560,887,徐小洲,2018-02-02 03:29:08,2,2,0,不懂上了什么
73581,887,徐小洲,2018-02-02 04:13:50,1,1,0,存在的意义是拉低绩点
73616,887,徐小洲,2018-02-02 06:26:37,2,3,1,秋学期2.5路过 不想多说。
73618,887,徐小洲,2018-02-02 06:38:41,0,1,1,垃圾到爆炸，还必修，严重拖累GPA
73636,887,徐小洲,2018-02-02 07:36:39,2,2,0,呵呵 呵呵
73664,887,徐小洲,2018-02-02 11:16:43,4,4,0,这门课下一届可以取消了
73715,887,徐小洲,2018-02-03 01:46:14,0,2,2,这样的课根本没有意义
73790,887,徐小洲,2018-02-03 05:48:07,1,2,1,不说了……退学基础……
73793,887,徐小洲,2018-02-03 05:55:54,11,13,2,楼下那个，居然支持徐小洲老师的，大家给我狠狠的踩！你怕不是得了3.5或者4.5的便宜就卖乖吧！你以为全校就你记了笔记?就你努力了?不还是2.5???\n\n真是呵呵了，垃圾老师，傻逼课程！
73795,887,徐小洲,2018-02-03 05:59:55,7,7,0,作为秋学期的考生，这门课讲真什么都没学到，还得了特别低的绩点，官僚主义的做法能到这个程度也是很不容易了不想说什么，它的评分怎么会比1高，你们摸着良心好好打分好吗
73796,887,徐小洲,2018-02-03 06:06:22,16,23,7,lxydl：辣鸡创业基础把我绩点拉下4.7
73822,887,徐小洲,2018-02-03 07:22:08,28,28,0,极其不公平的评价和给分机制，10分一档，每档1绩点，期末考试80分，得59分和60分直接相差1绩点，谁给你的勇气和资格去拉低我们的GPA？努力复习只有2.5，随便乱蒙3.5，这种考核方式有什么意义？4.2竺院梦已破碎，没有零分评价真是天理不容。
73830,887,徐小洲,2018-02-03 07:45:13,2,4,2,为什么不能给0分
73916,887,徐小洲,2018-02-03 14:13:47,0,1,1,呵呵呵
73979,887,徐小洲,2018-02-04 02:56:49,1,1,0,各位好好学习吧 吧退学基础拉掉的绩点拉回来
73980,887,徐小洲,2018-02-04 03:03:00,1,3,2,这老师不点名啊，多好（手动滑稽）
74093,887,徐小洲,2018-02-05 05:07:51,11,11,0,浙大真的应该少一些这种形式主义，毫无意义的面子工程，就算将来有题库，这门课仍然不应该作为必修，我看不到学这个的价值
74102,887,徐小洲,2018-02-05 06:30:14,6,8,2,2.5的魔咒，绩杀
74127,887,徐小洲,2018-02-05 13:18:03,2,3,1,呵呵呵呵呵呵呵呵\n\n不想多说
74129,887,徐小洲,2018-02-05 13:30:07,0,1,1,。。。\n\n
74142,887,徐小洲,2018-02-05 15:38:01,12,12,0,他妈的1分都给多了 垃圾老师 上你妈的创业基础 也没见您创业成功啊 毁我青春 垃圾
74220,887,徐小洲,2018-02-07 03:32:56,2,2,0,退学基础\n\n
74235,887,徐小洲,2018-02-07 11:23:20,0,1,1,呵呵呵
74245,887,徐小洲,2018-02-27 10:34:10,-56,2,58,其实自己拿不到高分还能怪老师，也不知道上面热评的逻辑，4.5不是很轻松就拿到了么？拿到4.5的人就我所知，就有20个以上
74249,887,徐小洲,2018-02-08 02:27:44,59,63,4,这个老师在我手中，赞我一下，打这个老师一下。
74268,887,徐小洲,2018-02-08 13:36:38,0,1,1,垃圾课程
74326,887,徐小洲,2018-02-11 03:27:30,0,1,1,put your md fxxk hands up
74338,887,徐小洲,2018-05-04 08:58:59,36,38,2,感谢老师让我少走创业的弯路——我TM这辈子都不想创业了。
74421,887,徐小洲,2018-02-21 01:50:35,13,13,0,wok，我认真复习了ppt，视频，书也看了几遍，你考的到底是什么！有种你每个人都出这么坑啊，随机出题而且有些人还在寝室里考。GPA活生生给你拉低了0.2，我真是醉了，被这么一门垃圾课拉低真是恶心，不管是谁导致这门课这样，你绝对有无法推卸的责任。看到下面那些拿4.5的吗，都是没复习的。你良心不会痛吗。有种你以后每次都给这么低！！！就不该这么早选这种课
74451,887,徐小洲,2018-02-25 04:49:14,2,3,1,呵呵呵呵
74456,887,徐小洲,2018-02-25 14:38:24,28,29,1,这是人性的扭曲还是道德的沦丧？月黑风高的夜里，有多少电脑播放着mooc视频，有多少电力流失，有多少浙大学子失眠头疼。这是地下的py，还是利益的勾结，让我们敬请收看，徐小洲的故事......
74532,887,徐小洲,2018-03-03 04:55:01,4,6,2,真棒 给老师一分
74547,887,徐小洲,2018-03-03 10:50:01,0,2,2,无语\n\n
74566,887,徐小洲,2018-03-03 15:23:43,0,2,2,辣鸡辣鸡
74581,887,徐小洲,2018-03-04 03:11:59,5,10,5,选上课之后微积分，线代什么的都白学了。\n\n
74595,887,徐小洲,2018-03-04 11:55:16,3,5,2,垃圾哦
74606,887,徐小洲,2018-03-04 14:36:30,1,3,2,大家好
74873,887,徐小洲,2018-05-06 15:34:41,13,15,2,徐小洲啊徐小洲，你千不该万不该跑来大学教创业基础呀。浙大每年创业的毕业生最多也就在百分之几那里徘徊，结果一门课愣是要给另外百分之九十几的人上，先不说单单这种废话连篇的没有实践经验就能学到东西的所谓创业慕课有多么沽名钓誉，实打实地谈及大多数人实际利益，这门通过水评论和看视频的伪课程，能够给一群连职业规划都没做好还愁着毕业能找到好工作的人，搞到什么创业教育的实际效用？人人都是创业者谁还来守业？设置成必修课这不纯粹扯淡么？课程测试没有预习考试，题型又不透露？你让那些打算刷高绩点的怎么活哦！唯绩点论功利不是，却不改进病态的正态分布还变本加厉搞了个五级制？评论里有多少骂你的就是因为你乱给绩点破坏了他们的竺院英才梦呵。自作孽，不可活，你喜欢正态，我只求绩点，死循环了咯，都一心奔着自个的绩点去，建设个鬼世界一流大学。
74918,887,徐小洲,2018-03-06 11:50:03,-3,0,3,
75170,887,徐小洲,2018-03-08 01:19:44,-15,2,17,老师做视频编书应该很累吧，老师辛苦了！\n\n但是 这个分 我真的很难以理解！真的很难理解！！！！
75179,887,徐小洲,2018-03-11 04:33:00,8,9,1,秋学期的同学别哭，冬学期依然啥都没有，依然被杀掉一片。
75200,887,徐小洲,2018-03-08 02:52:42,1,2,1,不作评论
75209,887,徐小洲,2018-03-08 04:11:14,3,3,0,无力吐槽
75217,887,徐小洲,2018-03-08 05:11:47,-22,1,23,来来来，我们把这个老师的评分弄到2.5?
75373,887,徐小洲,2018-03-09 12:01:49,1,1,0,没用，无聊，失望
75386,887,徐小洲,2018-03-10 02:54:04,2,3,1,小学生都觉得你的mooc简单，废话多没什么重点。
75406,887,徐小洲,2018-03-11 04:03:21,0,1,1,全是废话啊
75423,887,徐小洲,2018-03-11 14:18:22,0,1,1,退学基础
75441,887,徐小洲,2018-07-08 05:23:20,233,251,18,给分厚道徐小洲 制度合理林建华 尊重学生孙大雁 亲切友善祝秀香 从不绩杀陈昆福 分多事少陈素珊 知识广博看沈燎 讲话生动吴朝晖
75507,887,徐小洲,2018-03-13 00:49:14,4,8,4,出分前均绩近4.5 出分后报不了竺院 NMB书全白看
75786,887,徐小洲,2018-05-06 05:02:06,5,5,0,辛辛苦苦一学期拿个2.5也是可以的
75834,887,徐小洲,2018-03-19 11:50:38,0,1,1,。。。
75890,887,徐小洲,2018-04-29 01:49:37,1,1,0,我就呵呵
76006,887,徐小洲,2019-04-01 15:57:53,48,52,4,这老师也就比101多一点，1.01\n\n
76182,887,徐小洲,2018-03-28 10:10:47,-1,1,2,。。。。。
76305,887,徐小洲,2018-04-02 10:22:29,26,29,3,竺老校长啊！您开开眼吧！浙大都成什么样了？您在天有灵就把这些官僚、蛀虫都带走！
76354,887,徐小洲,2018-04-04 05:37:25,1,2,1,hhh\n\n
76374,887,徐小洲,2018-04-05 04:59:53,16,20,4,给大家讲个笑话，徐小洲；给大家讲个冷笑话，长江学者徐小洲；给大家讲个令人捧腹大笑的笑话，教科文创业教育教席教授徐小洲。给大家来个实话实说，徐小洲就是个道貌岸然的伪君子、学术骗子、人渣！
76658,887,徐小洲,2018-04-17 10:04:24,2,3,1,这老师的嘴脸，怎么可以这么恶心？？？？
76831,887,徐小洲,2018-05-13 06:14:44,-41,11,52,保护我方徐小洲
77010,887,徐小洲,2018-05-04 04:44:37,-81,2,83,垃圾，把我绩点拉成4.7
77029,887,徐小洲,2018-04-28 15:39:08,0,2,2,垃圾！
77066,887,徐小洲,2018-05-01 04:27:09,-15,15,30,看到评论很多辱骂字眼真的心寒。浙大同学能不能有素质点
77076,887,徐小洲,2018-05-01 11:56:50,1,2,1,别的不说，PPT做的毫无逻辑，找不到任何有用的信息
77080,887,徐小洲,2018-05-01 12:46:44,0,1,1,很不好
77081,887,徐小洲,2018-05-01 12:48:04,7,8,1,有的时候觉得一个人是个垃圾，有很多原因。不谈了，垃圾玩意儿
77115,887,徐小洲,2018-05-04 12:53:21,3,6,3,可以查考试分了大家，虽然绩点还没出
77117,887,徐小洲,2018-05-02 11:00:18,2,2,0,………
77136,887,徐小洲,2018-05-02 15:07:42,0,0,0,呵呵呵\n\n
77151,887,徐小洲,2018-05-03 03:10:14,7,11,4,秋冬学期的同学别哭，春学期的同学还是…………(跪)
77179,887,徐小洲,2018-05-03 10:53:00,0,0,0,呵呵呵
77189,887,徐小洲,2018-05-03 13:30:52,1,1,0,....\n\n
77192,887,徐小洲,2018-05-03 13:39:26,-7,2,9,听说有题库了
77196,887,徐小洲,2018-05-03 14:06:22,-7,2,9,求题库，明天要考试了
77201,887,徐小洲,2018-05-03 14:45:25,39,43,4,现在骂徐小洲还有赞吗？
77212,887,徐小洲,2018-05-04 00:34:40,14,16,2,强烈要求学校取消创业基础，这种课程让我体验到了三本的教育水平。
77215,887,徐小洲,2018-05-06 06:52:30,5,9,4,我劝开这门课的老师反省一下，你们有考虑过那些考试刚好差一两分绩点掉1的同学的感受吗?卡绩也不是你们这样卡的好吧。
77225,887,徐小洲,2018-05-04 03:38:01,0,2,2,不说了
77226,887,徐小洲,2018-05-04 03:52:44,9,10,1,没听过老师的课 放视频的时候都是无声的
77240,887,徐小洲,2018-05-04 05:59:11,-2,5,7,幽默，印象深刻
77287,887,徐小洲,2018-05-04 10:57:49,5,6,1,我多希望评分界面有个0可以选啊！
77323,887,徐小洲,2018-05-04 15:51:57,1,2,1,问:听老师的课是一种什么样的体验？\n\n答:问君能有几多愁?恰似一江春水向东流。? ? ?
77347,887,徐小洲,2018-05-05 01:22:01,10,11,1,垃圾垃圾垃圾！\n\n浙大居然有这种课，意义何在？意义何在？？意义何在？？？\n\n是为了通过2.5的绩点说服学生创业很难所以大家不要去创业吗？？？如果真是这样的话那。。呵呵，这门课的目的还真是达到了哈～我这辈子都不想再碰与创业有关的任何东西了哈哈哈\n\n还有那本书。。。贵我就先不吐槽了，假大空假大空假大空。。。还“发挥优势克服势。。。”废话呀还用你说？！那些创业的人要是知道怎么克服劣势还要你干嘛？！\n\n
77350,887,徐小洲,2018-05-05 02:18:32,0,1,1,不太懂
77351,887,徐小洲,2018-05-05 02:30:30,-8,4,12,这门课太水了，而且最后大家基本3.5，拉均绩。我不反对创业基础作为全校通识，但全校必修就有点过了。而且采用五级制评分就更是吐槽点满满的。
77357,887,徐小洲,2018-05-05 04:42:26,2,4,2,不懂这门课必修的意义在哪里，又不是每个人都想着创业。而且课也没意思，看视频从来都静音，评论复制粘贴，除了浪费时间浪费电脑电量找不到任何别的作用了。而且最后考试的内容和培养我们创业能力毫无关系。所以……（微笑
77360,887,徐小洲,2018-05-05 05:25:18,8,10,2,别的不说了，就这个mooc水平，你能不能背背稿子再上去录视频啊？讲得天马行空天花乱坠，真正有用的又有几个？其他必修课好歹还给学生面对面授课，你告诉我你这门必修课一学期学生见不到老师然后你给我个1.5？我招你惹你了？浙江大学天天喊着世一大世一大，有你这种老师学生学术水平上的去才怪！
77390,887,徐小洲,2018-05-05 09:08:07,0,1,1,特意来刷低评分，创业教育莫非就是教我知道创业素质是什么？
77398,887,徐小洲,2018-05-05 10:42:01,0,3,3,与其在这说不如去校信，在这有何用
77399,887,徐小洲,2018-05-05 10:50:15,1,2,1,呵呵呵
77400,887,徐小洲,2018-05-05 10:59:21,42,46,4,高校之上，朽木为官。\n\n象牙塔内，禽兽食禄。\n\n\n\n狼心狗行之辈汹汹当朝，\n\n奴颜婢膝之徒纷纷秉政。\n\n\n\n皓首匹夫，苍髯老贼，岂不知浙大人皆愿生啖你肉。
77402,887,徐小洲,2018-05-05 11:06:44,-21,14,35,浙大人的素质不过如此 \n\n因为成绩就能说出这样的字眼......\n\n
77405,887,徐小洲,2018-05-05 11:13:26,17,22,5,请大家不要骂人 你要是骂人的话和徐老师有什么区别
77406,887,徐小洲,2018-05-05 11:25:14,2,5,3,庆幸这是门网课，要是让我去教室听他讲一学期再来个小组展示什么的我就可以****了。
77413,887,徐小洲,2018-05-05 12:24:48,1,4,3,为什么不能打0分
77414,887,徐小洲,2018-05-05 12:30:08,1,2,1,呵呵呵
77417,887,徐小洲,2018-05-05 12:45:19,8,12,4,我她妈真想日了他\n\n
77418,887,徐小洲,2018-05-05 12:45:02,9,11,2,只想把这老师的脑子锤爆\n\n
77439,887,徐小洲,2018-05-05 14:33:46,0,2,2,创业基础这门课从头到底恶心到我们了
77468,887,徐小洲,2018-05-06 01:40:12,2,3,1,什么东西都学不到，书里视频里都是一堆废话，三本学校三本老师三本课程。
77469,887,徐小洲,2018-05-06 01:43:33,0,0,0,毫无用处还没法复习
77473,887,徐小洲,2018-05-06 02:34:40,0,0,0,呵呵呵
77479,887,徐小洲,2018-05-06 03:16:23,1,1,0,
77480,887,徐小洲,2018-05-06 03:28:27,7,12,5,mmp，神经病，智障，弱智，傻逼，我擦，b卷传出来那么多，a卷一道知道的也没有，公平在哪里啊，有毒吧，a卷考的都是小白鼠...什么壁垒，什么风险投资，不仅是一两句话，考的那么细，考完了翻遍课本ppt都找不到，神经病啊，公平呢？mmp啊！！！顶不顶我！！！
77482,887,徐小洲,2018-05-13 00:15:37,60,68,8,第 … 第 一次当喷子….有点紧 张 我…我开始了啊…你…你算哪块小饼干……对不起，我是不是有点过分，对…对不起
77487,887,徐小洲,2018-05-30 01:48:06,0,2,2,呵呵呵呵呵呵
77493,887,徐小洲,2018-05-06 04:15:52,0,1,1,简直傻逼一样
77497,887,徐小洲,2018-05-07 01:30:24,-4,2,6,老师好啊！
77502,887,徐小洲,2018-05-06 06:33:15,4,6,2,绩点评分标准为什么不能改一改，动不动就1.5 2.5的故意拉低我们学生的绩点，嫌我们压力还不够大吗？
77503,887,徐小洲,2018-05-06 06:49:37,3,8,5,老师0分不能更多\n\n考试意义0分不能更多\n\n不过平心而论C卷90%内容PPT都出现过\n\n为了绩点还是好好看看PPT吧\n\n当然 最好是这种毫无意义的辣鸡课就不要有
77504,887,徐小洲,2018-05-06 12:32:25,6,11,5,不予置评
77508,887,徐小洲,2018-05-06 07:05:38,0,2,2,垃圾课程，为什么还要必修，感觉完全在浪费大家的时间。
77512,887,徐小洲,2018-05-15 00:56:59,25,37,12,在乎绩点的应该好好复习啊！春学期考试已经有秋冬两学期人的经验了，谁都知道ppt和书本都是要全看的。在没法改变这门课的情况下想要保住绩点，就应该多花点时间去复习啊。我也是认认真真看了一天，还熬了个夜，书本看了两遍，ppt一遍，最后机考73，4.5。虽然很没意思，但想保住绩点的同学，扪心自问下有没有好好复习，毕竟总是有那么多人拿了4.5最后，他们也都得靠自学啊！！但是，这门课是真的垃圾我不反对！！
77528,887,徐小洲,2018-05-06 09:18:30,6,8,2,退学基础……呵呵
77531,887,徐小洲,2018-05-06 09:38:08,4,17,13,没必要因为绩点和课程设置的原因而迁怒于老师，
77552,887,徐小洲,2018-05-06 12:05:32,11,14,3,一直以为浙大应该还算得上全国高校，但一看强制性的创业基础以及这门课的给分，浙大和其它大学差远了，试问浙大那么多学生，有多少会选择创业，这么课应该精心准备给那些想要创业的同学，而不是这样随意强制，一直以为浙大还算得上民主，结果却是社会主义羊皮下专制主义的狼，教育并不是只是为了分数为了有这样一门课，而是应该真正教给学生一些有实质性内涵的东西，这门课强制，无非是国家的政策，这样附和，仿佛是当年奴隶制下的奴隶，咧着嘴迎合主人，而没有自己任何的思考。浙大一直想做到全国数一数二的大学，就这样的水平，不落后已经不错了，还眼巴巴地渴望世界性大学么
77562,887,徐小洲,2018-05-06 13:44:21,1,2,1,傻逼吧
77571,887,徐小洲,2018-05-07 02:46:45,9,12,3,相对冷静地说，开设创业教育课程我很支持，即使要求必修我虽不支持但也勉强可以理解。然而诸位好学者来到浙大，都渴慕优质的教学资源和课程水平，课程的诚意得有吧？网课拖沓，编书冗长，不能说一点没有干货，但是干货和又大又空的废话可谓平分秋色，甚至废话更胜一筹。要不是我没有骨气贪恋绩点，怎么会浪费这种时间！“学”完创业基础，不仅没激发创业热情，反而是凉凉了。取得这样卓越的效果，创业基础的开设真是令人遗憾。当然课程最值得吐槽的还是给分机制。考察并不能检验学生的学习质量，五级制更是丧尽天良。差1分绩点少1的同学，唯有泪千行。虽然我真想以后更多的兄弟陪我一起绩点跳水，但善意一点我还是非常希望这门课能好好改良。友情提示，考完去了解了一下，目前市面上所见的创基题库与考试的完全不同。以及，如果你跟我一样没骨气的话，多花点时间复习这门课还是能多点希望的。(对，是多点希望)
77580,887,徐小洲,2018-05-06 15:34:49,18,18,0,我们伟大的联合国教科文组织创业教育教席主持人 联合国教科文组织中国创业教育连席主席 浙大社科研究院院长 教育部长江学者特聘教授 求是特聘教授 ，他的课怎么会差呢？!如此好的课程，不给0分简直对不起老师的身份!
77593,887,徐小洲,2018-05-07 00:53:54,0,2,2,呵呵，lese
77622,887,徐小洲,2018-05-07 03:04:57,3,3,0,垃圾。
77625,887,徐小洲,2018-07-04 07:01:04,6,8,2,额…感觉没有什么体验…
77630,887,徐小洲,2018-05-14 16:11:50,9,11,2,? ? ?
77650,887,徐小洲,2018-05-07 06:02:37,8,9,1,不知道有多少像我一样差一分就差一档绩点的人 暂且不说这门课有多么没有意义 光是五级制评分就足够恶心了
77694,887,徐小洲,2018-05-07 09:49:40,6,7,1,太过形式主义，别说能激发学生创业热情了，不浇灭就不错了，一个2.5让其他的辛苦都白白浪费了
77738,887,徐小洲,2018-09-17 02:03:06,-51,10,61,创业基础这么好的课不开了真是可惜了
77749,887,徐小洲,2018-05-09 09:07:49,18,19,1,我们上也就算了 我就不明白为啥留学生也要上? 春学期一个柬埔寨妹子问我 刚才又有一个留学生汉子问我 迷啊迷啊 退学基础一生黑
77799,887,徐小洲,2018-05-08 01:49:29,7,7,0,辣鸡坑课还必修，哎呦喂。
77879,887,徐小洲,2018-05-08 10:27:31,-3,1,4,？？？
77891,887,徐小洲,2018-05-08 11:03:09,1,6,5,不好意思又想来骂你了 恶心坯子
77928,887,徐小洲,2018-05-08 15:27:18,10,14,4,好老师就是我，我就是徐小洲
78061,887,徐小洲,2018-05-09 07:46:12,1,2,1,我还有什么要说的呢
78126,887,徐小洲,2018-05-09 12:16:58,1,2,1,呵呵呵
78148,887,徐小洲,2018-05-09 13:42:54,8,10,2,呵呵呵，一点五，我可xxxx
78262,887,徐小洲,2018-05-10 08:43:23,0,3,3,形式主义
78417,887,徐小洲,2018-05-13 06:04:37,4,5,1,出分慢，给分差，不能更差
78470,887,徐小洲,2018-07-02 09:02:13,-74,6,80,老师牛逼啊
78515,887,徐小洲,2018-05-12 12:22:20,2,2,0,极其差劲无聊没干货，什么卵用都没有，和真正素质教育的创业没什么关系，不过是生硬的概念罢了
78546,887,徐小洲,2018-05-13 01:18:17,0,0,0,不想多说什么了
78575,887,徐小洲,2018-05-13 09:36:47,9,22,13,如果这门课的均绩有4.5的话，即使课再水，相比也不会有这么多人在这喷。为了所谓的绩点，有这么多人在这冒出一些不堪入眼的话，还问候老师的家人，这就是浙大学生的素质吗？
78580,887,徐小洲,2018-05-13 10:32:32,10,22,12,无论怎样，还请保持浙大学子基本的素质，那些骂脏话的同学，请扪心自问是不是认真看了ppt，是不是好好地看过了一遍书，并且把自己觉得重要的知识记住了。批评可以，但请别暴露您那低下的素质，真的让人恶心
78631,887,徐小洲,2018-07-07 10:43:33,0,3,3,………………
78705,887,徐小洲,2018-05-14 16:09:11,-14,4,18,其实考前复习还是比较有用的，多看看书考试拿满还是可以的吧
78706,887,徐小洲,2018-05-14 15:14:47,-3,1,4,? ? ?
78708,887,徐小洲,2018-05-14 15:15:34,4,5,1,能骂人吗？不能的话就没什么说的了。
78713,887,徐小洲,2018-05-14 16:41:12,2,12,10,请那些素质论的同学们省省吧，什么叫为了绩点骂人至于吗，我问问你你作为一个学生你难道不关心绩点?去你的吧。
78717,887,徐小洲,2018-05-14 23:42:47,1,1,0,无话可说
78719,887,徐小洲,2018-05-15 00:18:22,0,1,1,现在觉得很累
78720,887,徐小洲,2018-05-15 00:19:18,5,10,5,59分上机考，2.5，虽然我觉得真正的创业基础很重要，确实很有用，但是这种课程这种考核方式我不能接受。\n\n我成绩不太好，均绩也就三出头，但是我没有挂科，基本上所有的科目成绩都在平均70到80的水平，这一门课出来，直接拉低了不少。\n\n我不会怨恨老师，毕竟网课的讲解难度很大，理解和尊重是做人的基本道德，辱骂他人更是要不得，但是这门课的考核方式就存在着极大的问题。对于创业者而言，根本没必要了解谁谁谁在啥时候干了啥。。。对于真正要创业的同学，更多的应该是把握时代大潮的能力以及广阔的社交人脉，这都不是这堂课能给我们的。
78725,887,徐小洲,2018-05-15 00:50:57,33,37,4,评论区的老哥都是人才…\n\n除了那个用生殖器骂人的\n\n对不起 你是傻逼
78728,887,徐小洲,2018-05-15 01:28:46,-28,0,28,复习了半天不到，优秀了，感谢老师
78730,887,徐小洲,2018-05-15 01:52:44,5,6,1,刚出分，均绩拉低0.1，看到大家都在喷我就放心了。
78731,887,徐小洲,2018-05-15 01:58:57,19,19,0,57分上机考，2.5，拉低0.2均绩。我成绩不太好，均绩也就三出头，但是我没有挂科，基本上所有的科目成绩都在平均70到80的水平，这一门课出来，直接拉低了不少。 这门课的考核方式就存在着极大的问题。对于创业者而言，根本没必要了解谁谁谁在啥时候干了啥。对于真正要创业的同学，更多的应该是把握时代大潮的能力以及广阔的社交人脉，这都不是这堂课能给我们的。
78749,887,徐小洲,2018-05-15 03:40:30,3,6,3,秋学期第一批小白鼠现在无话可说了\n\n能不能重修？
78750,887,徐小洲,2018-05-15 04:05:36,0,1,1,形式主义
78752,887,徐小洲,2018-05-15 04:27:05,0,2,2,真的是无语
78755,887,徐小洲,2018-05-21 04:05:57,10,14,4,79分，2.5，呵呵
78767,887,徐小洲,2018-05-15 06:11:21,1,2,1,坑\n\n坑\n\n\n\n坑\n\n\n\n
78785,887,徐小洲,2018-05-15 07:06:10,1,3,2,首先  为什么没有0分\n\n\n\n其次    关于必修的问题，可能是如果不必修它就没人选了吧   \n\n然后 我想说   对于冬学期的同学来说也是很坑的，哈哈哈  也不知道考什么   ！！！  \n\n\n\n总结一下   对于这节课   我是不太懂它存在的意义的   \n\n摊手
78789,887,徐小洲,2018-05-15 07:24:53,-2,2,4,创业基础 考试技巧就是看书+PPT，就能获得好的分数。但要说开这门课的意义，不敢苟同。
78800,887,徐小洲,2018-05-15 07:52:20,0,0,0,。。。
78804,887,徐小洲,2018-05-15 09:47:25,5,15,10,你们说的都很对 但热评第一的我怎么看起来就这么别扭啊 对竺院的影响大难道还要事先知道你是竺院的然后给你调分吗（非竺的强烈不服 最后说句实话 这门课着实恶心 但知道要考试你他妈看视频稍微认真点 考前花几个小时看会儿书3.5总没问题吧
78805,887,徐小洲,2018-05-15 08:24:51,2,3,1,呵呵呵
78816,887,徐小洲,2018-06-19 13:58:10,20,24,4,评论里有条真是恶心，就算课再不好，给分再不好，也不应该用这么污秽的语言吧？不好意思举报了。
78824,887,徐小洲,2018-05-15 11:03:02,7,8,1,幸亏是16级的，教学改革就改成这样？\n\n
78825,887,徐小洲,2018-05-20 14:44:35,12,16,4,对不起，看到了成绩又忍不住来骂你，69+20是89啊!给3.5啊，徐小洲教授，你的良心不会痛吗？lagay
78889,887,徐小洲,2018-05-16 08:09:32,1,2,1,无fuck可说
78912,887,徐小洲,2018-05-16 17:06:52,10,10,0,思维碎纸机 时间焚尸炉
79185,887,徐小洲,2018-05-26 05:10:16,8,10,2,开网课就是一种不认真的表现，自己不认真如何让学生认真对待，自己说着重理论轻实践，却全部是理论，这是唯一一门什么都学不到的课程！
79255,887,徐小洲,2018-05-29 03:15:37,1,2,1,垃圾得不能再垃圾了
79262,887,徐小洲,2018-05-29 07:52:43,1,1,0,ktv老天王
79312,887,徐小洲,2018-05-31 00:50:07,0,1,1,?
79402,887,徐小洲,2018-06-03 12:06:19,2,3,1,只能说打一分以上的做事不经大脑思考或者走了运蒙对了题
79428,887,徐小洲,2018-06-04 10:39:30,2,2,0,。。。
79487,887,徐小洲,2018-06-06 17:16:31,5,6,1,我从未见过如此厚颜无耻之人，失去同步
79557,887,徐小洲,2018-06-09 06:44:53,3,3,0,辣鸡辣鸡您真辣鸡
79607,887,徐小洲,2018-07-02 09:08:33,25,32,7,对于前面某4.81的大神，我只想说，你很强，连这种课都还要全背一遍，你的大学真是白上了，连大学里应该学习什么都不清楚你还上什么学？
79648,887,徐小洲,2018-12-13 12:52:38,-103,15,118,1.考前认真看了书和PPT考了4.5。嫌弃给分低能不能反思一下自己有没有好好学。\n\n2.热评说后面上的学生有题库，显然就是不知道实际情况就乱说。\n\n3.我认为这门课主要的问题不是老师的问题，而是上课形式的问题。满嘴喷粪的可以反思一下自己的素质吗？
79703,887,徐小洲,2018-06-13 02:28:27,3,5,2,不评论，我是再次过来打1分的
79767,887,徐小洲,2018-06-13 11:33:14,1,2,1,课太长，而且给分极其不合理！
79807,887,徐小洲,2018-06-14 02:11:47,4,6,2,真搞不懂查老师里面3.72的平均绩点是怎么来的
79900,887,徐小洲,2018-06-15 03:29:39,0,2,2,难受，秋学期的炮灰
80069,887,徐小洲,2018-06-26 02:33:47,0,1,1,狗屎体验\n\n
80799,887,徐小洲,2018-07-01 08:27:30,0,1,1,垃圾 真实垃圾 不能更垃圾
80800,887,徐小洲,2018-07-01 08:27:57,1,3,2,我感觉给他这一分会让他骄傲????
80828,887,徐小洲,2018-07-01 13:23:44,-2,1,3,。。。。妙不可言
80837,887,徐小洲,2018-07-02 00:09:57,6,11,5,这门课垃圾就是垃圾，楼下那个秀均? 的优越? 秀你? 啊，考的不好就没权利在这发表言论了
80894,887,徐小洲,2018-07-02 12:21:19,4,5,1,蛀虫您好，老师再见。\n\n
80947,887,徐小洲,2018-07-03 03:24:17,1,1,0,呵呵呵
80970,887,徐小洲,2018-07-10 11:37:30,11,12,1,关于刷网课的事情，大家可以同时开几个视频，刷几个课，然后就特别快了。考试基本书上，网课就瞎bb，没用
81145,887,徐小洲,2018-08-04 05:55:51,42,43,1,评论里某些既得利益者的嘴脸真是令人悲哀。我是秋学期第一批小白鼠，看了书和ppt拿了3.5，当时还算是比较高的分数。但是后来随着题库的出现，4.5已经屡见不鲜了。看了题库拿4.5的同学们当然行为正当，但请某些拿了题目考高分的不要在这说什么很简单很水的言论，你真的不知道第一批同学看到你的评论心里是什么滋味。说不定有人因此失去进竺院，出国或者保研资格，求你们不要吃相太难看。
81151,887,徐小洲,2018-07-04 07:18:31,0,0,0,除了辣鸡还有别的可说的吗？
81163,887,徐小洲,2018-07-04 07:47:28,-2,1,3,考完了～11111111
81170,887,徐小洲,2018-07-04 08:01:58,0,1,1,呵呵呵
81181,887,徐小洲,2018-07-04 08:22:29,1,1,0,五级制真的。内容是真的没用。
81900,887,徐小洲,2018-07-06 12:49:58,4,4,0,。。。
82539,887,徐小洲,2018-07-08 12:24:21,7,9,2,学校不看查老师的嘛……虽然不清楚这个老师对女学生做了什么，看起来可以调查一下阿...长江学者，呵呵
83089,887,徐小洲,2018-07-09 15:53:23,2,3,1,辣椒酱
83278,887,徐小洲,2018-07-10 04:02:44,7,10,3,上创业基础的同学们看pdf就行，别的不用管，视频讲课如同便秘，看了也是浪费时间
83548,887,徐小洲,2018-07-10 14:46:48,8,9,1,讲道理考试内容都能找到的，努力还是有用的。但是这个制度太奇怪了：老师撒手不管，导致学生重点无法掌握；课程意义不大，只靠死记硬背；五级评分制度，简直是运气差的学生的噩梦。这样的课和思政课一样，价值不大。
84326,887,徐小洲,2018-07-12 14:48:48,12,13,1,这种无意义的课 浙江大学第一年开估计也是最后一年开 可怜17级学生成为了实验田的小白鼠
84370,887,徐小洲,2018-07-12 16:03:26,8,10,2,五级就五级吧，我就是好奇我是怎样被和平时分为零考前没复习过的同学划到一档的
84375,887,徐小洲,2018-07-12 16:08:55,2,3,1,没有体验
84398,887,徐小洲,2018-07-12 17:19:48,4,6,2,辣鸡辣鸡辣鸡
84451,887,徐小洲,2018-07-13 01:41:55,9,10,1,垃圾课，有点靠运气成分，可怜呜呜
84986,887,徐小洲,2018-07-29 06:01:01,21,24,3,每日一骂
85634,887,徐小洲,2018-07-23 07:56:46,2,4,2,。。。
85645,887,徐小洲,2018-07-24 01:02:49,11,12,1,辣鸡老师！退学基础一生黑！日常来拉低老师的评分
86081,887,徐小洲,2018-12-13 12:54:16,6,6,0,给一分是因为没有零分
86222,887,徐小洲,2018-09-10 19:22:30,8,9,1,听说这门课不开了，然而我还没修过这门培养方案上的必修课。我是不是可以躺在家里坐等肄业了?喜闻乐见大快人心。
86274,887,徐小洲,2019-11-08 09:54:33,-83,8,91,创业基础这么好的课不开了真是可惜了，唯一不满的是最高只有4.5，要是5.0就好了
86430,887,徐小洲,2018-09-16 02:48:31,6,8,2,请不要拿“大众创业”来误人子弟
87112,887,徐小洲,2018-09-20 11:40:33,0,2,2,呵呵呵
88072,887,徐小洲,2018-10-31 04:52:25,9,14,5,你? 死了\n\n
89288,887,徐小洲,2018-11-18 05:33:27,6,8,2,第一批考试，啥都没有，最后2.5，心态崩了。
89628,887,徐小洲,2018-11-20 04:46:12,1,1,0,不谈了
89663,887,徐小洲,2018-11-20 07:22:49,-5,2,7,创业基础这么好的课不开了真是可惜了
89777,887,徐小洲,2018-11-20 18:49:48,12,14,2,人人每天评一次，帮助徐小洲这个死妈的玩意接近1，人人有责
89819,887,徐小洲,2018-11-21 02:29:05,0,1,1,呵呵呵呵呵
90006,887,徐小洲,2018-11-21 14:14:04,0,2,2,太差了
91142,887,徐小洲,2018-12-02 01:21:56,1,3,2,辣鸡课
91543,887,徐小洲,2018-12-13 02:32:39,2,3,1,辣鸡辣鸡?
91971,887,徐小洲,2018-12-25 06:47:43,10,11,1,好奇你到底对女大学生做了什么，你就是官僚主义，布尔乔亚
92417,887,徐小洲,2018-12-28 12:26:02,0,1,1,垃圾，浪费生命。
92926,887,徐小洲,2019-01-05 18:14:17,22,24,2,新时代中国文科学界学术手淫的典型代表，逼走党委书记独霸学院，拉帮结派一堆徒子徒孙，骚扰女大学生不止一次两次，学术一堆论文假到不行，巴结领导继续步步高升，创业基础去你妈十八代祖宗
93167,887,徐小洲,2019-01-30 01:49:27,9,10,1,nmsl
93168,887,徐小洲,2019-01-08 02:31:59,3,3,0,助攻1分
93205,887,徐小洲,2019-01-08 06:24:15,-8,3,11,老师还是不错的，和教育学院的邵兴江比一下 还是强不少
93628,887,徐小洲,2019-01-11 03:50:51,6,7,1,水货教授 我不是针对谁 我是针对这个学科
93655,887,徐小洲,2019-01-11 07:25:45,3,5,2,看到差竺院一点点就因为这门只给17级的课，不知道是什么运气和体验，希望这课对自己以后不要再有影响了
94111,887,徐小洲,2019-01-15 07:56:59,3,4,1,bbbbb\n\n
95375,887,徐小洲,2019-01-19 09:32:47,31,32,1,一个说过他不缺女学生送上门的男人，上起课来却像太监指导性生活一样阴阳怪气
98331,887,徐小洲,2019-01-23 10:29:40,6,8,2,掉我均绩的sb课
98712,887,徐小洲,2019-01-24 00:11:11,13,17,4,浙大的哪个老师没有经历过大学时代呢？他们谁不是知道努力了想要的是高分呢？一些老师的经历让他们懂得了授人以渔并且公正赋分，一些老师却依旧口上冠冕堂皇地给出可能会影响学生一辈子的分数。真的很悲哀，他们哪懂什么分数对学生的影响，的确大多数对待创业基础都不认真，那你徐教授有没有考虑一下，我浙的创业之风真的和你有关吗？我浙未来创业成功的人士真的会在酒后笑谈间想起你这门课么？
99856,887,徐小洲,2019-01-25 08:43:19,17,17,0,看了看现在均绩，又看了看去掉创业基础之后的均绩。只能说一句:  nmsl.
102370,887,徐小洲,2019-02-01 09:24:34,3,5,2,浪费生命。
102721,887,徐小洲,2019-02-22 03:41:43,4,6,2,回来差评
102917,887,徐小洲,2019-02-25 03:25:48,1,1,0,什么都学不到
104146,887,徐小洲,2019-03-13 03:15:26,10,15,5,只要你用心学习创业基础这门课程，就会觉得吃屎都不是一件难事
104401,887,徐小洲,2019-03-19 16:28:13,-20,6,26,打出某些评论的人，自己不对自己感到失望吗？
104494,887,徐小洲,2019-03-21 14:45:05,14,17,3,你们敬爱的徐小洲交兽已经在浙传美滋滋当副校长了，congrats！真是如鱼得水～～～
104681,887,徐小洲,2019-03-26 03:13:52,4,5,1,除了傻逼我真的找不到什么词能更好地形容这门课，至于老师，讲课水平不行，录个视频讲课都那么差，要是现实生活中讲岂不是辣鸡到极点？
104773,887,徐小洲,2019-03-27 12:39:03,0,1,1,垃圾啊
104927,887,徐小洲,2019-03-31 10:12:22,0,1,1,没水平，乱给分
105176,887,徐小洲,2019-04-06 05:30:10,8,9,1,如果评选全球最差教师，这个徐小洲必定高居榜首。如果评选浙大最无聊课程，非此创业基础莫属
105206,887,徐小洲,2019-04-07 11:59:26,1,6,5,我是ikun，考前刷蔡徐坤nmsl，看蔡徐坤打篮球，结果我满了
106467,887,徐小洲,2019-04-27 15:37:47,5,5,0,出国党真不想让梦校看见自己成绩单上有这种课
106758,887,徐小洲,2019-04-29 09:58:16,1,1,0,。。。
107428,887,徐小洲,2019-05-05 06:38:54,2,5,3,哎又是帮助大家给他一分 加油各位 别因为别人影响自己
109106,887,徐小洲,2019-06-08 12:55:54,5,7,2,就这么一个连话也说不清却又面目狰狞的家伙居然还成了长江学者，还当上了大学校长，唉，无语啊无语
109327,887,徐小洲,2019-06-13 06:36:29,0,1,1,...
109841,887,徐小洲,2019-06-19 15:30:24,1,1,0,辣鸡哦
109893,887,徐小洲,2019-06-20 05:11:26,2,3,1,wtf
111146,887,徐小洲,2019-06-30 05:45:09,5,6,1,扫墓。
112534,887,徐小洲,2019-07-04 17:09:10,2,4,2,不能打0分很心疼，创业基础什么辣鸡
113298,887,徐小洲,2019-07-06 04:51:24,3,6,3,wdnmd砸种\n\n来扫个墓
113361,887,徐小洲,2019-07-06 09:53:27,2,3,1,哟~可算到一分啦
115568,887,徐小洲,2019-08-05 10:35:19,7,7,0,此生难得一遇的差老师！人品学品教品皆差到极点了。堂堂浙江大学怎么会有这种老师呢？据说还不断得道发迹！唉……
115581,887,徐小洲,2019-08-05 18:32:37,0,0,0,垃圾的一批
115798,887,徐小洲,2019-08-20 10:44:34,0,1,1,帮你保位
115820,887,徐小洲,2019-08-20 12:30:25,0,4,4,一碗泡面还可以这样吃？不同年龄吃法大不同，大学生吃法最惨？\n\n\n\n泡面的发明可谓是极大的方便了人们的生活，在没有时间做饭又想吃的稍微美味一点话，泡面定首当其冲，各种口味任君挑选，总有一款你喜欢！\n\n\n\n
116087,887,徐小洲,2019-09-03 07:59:17,3,4,1,毒瘤...
116298,887,徐小洲,2019-09-07 11:46:54,1,2,1,算了吧
117163,887,徐小洲,2019-09-20 02:59:34,1,2,1,是傻逼
117231,887,徐小洲,2019-09-20 16:31:55,1,1,0,
118528,887,徐小洲,2019-10-28 06:29:18,0,1,1,垃圾垃圾
119845,887,徐小洲,2019-11-16 04:35:27,5,5,0,sbsb
123251,887,徐小洲,2020-05-26 06:50:38,31,33,2,从“给分厚道徐小洲 制度合理林建华 尊重学生孙大雁 亲切友善祝秀香 从不绩杀陈昆福 分多事少陈素珊 知识广博看沈燎 讲话生动吴朝晖 声音洪亮陶虹向”前来观光
123286,887,徐小洲,2020-05-29 11:06:27,-2,1,3,；gg
124724,887,徐小洲,2020-07-07 06:31:56,0,0,0,呵呵呵
126962,887,徐小洲,2020-10-30 10:37:58,4,4,0,，，，
128440,887,徐小洲,2020-12-23 05:30:25,13,15,2,你就是个🐔⑧
128621,887,徐小洲,2020-12-25 00:31:34,0,1,1,辣鸡老师
130226,887,徐小洲,2021-01-19 11:23:25,1,2,1,慕名而来
130358,887,徐小洲,2021-01-21 10:01:47,1,2,1,真的垃圾
133265,887,徐小洲,2021-02-22 03:59:47,14,15,1,作为导师，定方向混乱，理不清头绪，给不了指导，没时间科研，身居高位而不思学术进取，真的是无语。
133511,887,徐小洲,2021-03-01 11:54:41,0,1,1,666
134546,887,徐小洲,2021-04-01 06:01:16,6,7,1,辣🐔玩意儿
139990,887,徐小洲,2021-08-22 23:58:21,0,0,0,呵呵呵
140648,887,徐小洲,2021-09-14 22:13:59,3,7,4,干净又卫生嗷兄弟们
142452,887,徐小洲,2021-11-11 14:50:59,22,23,1,气的我拉稀，徐小洲你个鸡
159928,887,徐小洲,2022-09-09 04:54:23,1,3,2,。。。
160038,887,徐小洲,2022-09-12 06:55:37,4,6,2,只因只因
160672,887,徐小洲,2022-09-30 03:25:25,7,9,2,户口本只有一页了
171530,887,徐小洲,2023-03-27 13:08:03,2,4,2,收敛于1
171855,887,徐小洲,2023-04-08 05:04:54,0,2,2,创业必修？你尼玛知道创业有多少成功率吗？没创死都难得，还好有职规课能替代
172493,887,徐小洲,2023-04-28 02:19:02,1,2,1,没全家的东西，虎扣笨玩没了是吧？
172994,887,徐小洲,2023-05-11 03:11:46,4,4,0,你在狗叫什么？
178193,887,徐小洲,2023-07-08 00:49:26,11,12,1,给分厚道徐小洲 制度合理林建华 尊重学生孙大雁 亲切友善祝秀香 从不绩杀陈昆福 分多事少陈素珊 知识广博看沈燎 讲话生动吴朝晖
179235,887,徐小洲,2023-08-31 13:57:52,2,4,2,怎么说呢，官官捏
214000,887,徐小洲,2025-01-22 15:47:30,2,2,0,https://henan.163.com/25/0118/10/JM69IQ4D04398SNL.html\n\nxxz这个出生还活得好好的，真tm晦气
214229,887,徐小洲,2025-01-30 01:27:22,1,2,1,牢徐还在教院活的风生水起，某些重要活动里还能看到它那副嘴脸，真tm晦气，妖魔鬼怪快离开
78307,903,王素文,2018-05-10 16:07:58,0,0,0,这个老师是我见过浙大最sb的老师，临毕业想砍死她那种
63322,909,沈国平,2017-11-30 14:15:42,0,0,0,无聊死了
75482,909,沈国平,2018-03-12 10:19:21,0,0,0,很轻松
49859,910,刘文明,2017-04-26 15:02:37,0,3,3,上网球课第一节课，老师直接开骂，各种脏话真的服气。
49861,910,刘文明,2017-04-26 15:04:10,4,6,2,见过最没素质的老师，也不知道他会什么，不懂这种人怎么还能当老师，还是在浙大
87578,910,刘文明,2018-10-07 14:25:03,4,6,2,除了给分其他都不行
134782,910,刘文明,2021-04-15 01:31:25,2,3,1,无能老色批
172734,910,刘文明,2023-05-05 16:18:02,2,4,2,给分很随意，没有依据，男生比女生分高的多，上课不讲内容，全靠学生讲，很少点评
218438,910,刘文明,2025-04-23 13:01:17,0,0,0,纯路边
25886,1013,赵康,2016-06-13 09:32:50,10,11,1,这位老师知识丰富
40990,1013,赵康,2017-01-07 09:06:30,-1,2,3,不怎么样\n\n
46891,1013,赵康,2017-01-22 18:02:57,2,2,0,很不错
49431,1013,赵康,2017-04-12 06:32:09,5,7,2,老师您的声音能大点吗
56101,1013,赵康,2017-07-03 05:17:00,1,1,0,很好，有学识
56118,1013,赵康,2017-07-03 06:02:32,7,7,0,赵老师绝对好老师\n\n
63948,1013,赵康,2018-05-06 13:54:52,3,3,0,老师看起来很年轻哇，也很温柔，还是清华大学霸
72960,1013,赵康,2018-01-31 12:25:19,0,1,1,清华学霸呀，又好看又温柔声音好听还有学识~
74557,1013,赵康,2018-03-03 13:11:08,4,5,1,朋友们，这是教育学院的赵康老师，在北大做过博士后，清华赵康老师在楼下的建工学院。
82577,1013,赵康,2018-07-08 14:33:33,1,1,0,老师很温柔！
85588,1013,赵康,2018-07-20 02:34:43,1,2,1,教育思潮，主要是教育哲学内容，可以看出老师的情怀，事情真的少就一篇课程论文，给分很好
105180,1013,赵康,2019-04-06 06:04:24,2,6,4,怎么那么多人把建工学院的清华学霸与教育学院的钻石王老五混为一谈啊
113205,1013,赵康,2019-07-06 01:35:16,4,5,1,可能是因为受限于内容是教育哲学，所以老师上课显得有些枯燥，但是老师真的非常儒雅温柔，还会发邮件反馈你的论文情况！
113282,1013,赵康,2019-07-06 03:47:47,0,1,1,老师真的非常儒雅温柔！课程事真的很少就一篇限制了字数上限的论文～（虽然不知道为什么没有收到老师的论文反馈qwq不过老师给分真的好
113473,1013,赵康,2019-07-06 17:54:07,1,1,0,老师上课每节课都点名 讲课语气较为平淡\n\n讲的主要是教育哲学和西方教育历史 喜欢的人可能会比较听得进去 不喜欢的人可以水水~给分尚可
124059,1013,赵康,2020-06-23 03:34:32,4,4,0,事非常少，给分非常好，老师很和善，外专业来修学分的爱了
131002,1013,赵康,2021-01-25 13:59:54,5,5,0,康康男神！！！
133437,1013,赵康,2021-02-28 15:57:42,4,4,0,赵老师讲课非常有深度，温文尔雅，非常耐心！！！
135299,1013,赵康,2021-05-07 17:17:57,0,0,0,mmmmmmmm
149396,1013,赵康,2022-01-15 08:34:17,0,2,2,外国教育史，原来考前补天是真的有用的，即使只剩最后一天，也不要放弃，考前尽量背，考试时多写，最后得分我自己很满意，感谢老师
153193,1013,赵康,2022-04-26 13:38:34,2,2,0,1. 关心学生，疫情时期每节课提醒我们尽可能戴口罩，注意健康。2. 对学生很仁慈，我自己没看字数要求，论文不合规，学在浙大提交机会用完了，向老师道歉求情，老师马上同意给补交机会。3. 群里说话和作业评语都很诚恳，真正愿意跟学生交流。4. 上课有意思，哪怕对哲学没兴趣都会觉得听着有趣。5. 会点名和随机点人回答问题。6. 给分非常好。
153194,1013,赵康,2022-04-26 13:38:47,3,3,0,不知道为什么大家说他给分好，我觉得给分真的差……而且喜欢点名……
166424,1013,赵康,2023-01-12 08:36:29,-4,1,5,外国教育史，会随机点名，上课比较平淡但能看出里很有涵养，可以在课上做些别的事情也可以回神听老师上课，对本摸鱼选手很友好，课程考核也比较容易，考前突击一天最后4.8
192251,1013,赵康,2024-05-13 03:27:52,2,2,0,【西方教育思潮】不点名，一篇期末课程反思+一篇3k字论文（自己选一个教育思潮），压力小，给分好
218324,1013,赵康,2025-04-22 14:37:59,2,2,0,虽然说赵老师永远用一个语调讲课有点无聊，但还是有深度的。特别是西教思，比较适合做跨专业 此外，老师比较喜欢点名，但点名是跳着点的，这次点你没到，下次还会点你。
218545,1013,赵康,2025-04-24 11:33:57,2,2,0,所有他的课都可以闭眼选，外专业也一样，事少分高，点名频率高但我觉得到课已经是最基本的要求了，为人谈吐儒雅有风度，强推！
21,1021,吕强,2017-06-07 07:06:44,262,293,31,可水可听，知识点解释得挺清楚，也有不少私货。
138,1021,吕强,2015-03-14 16:06:46,207,230,23,其实我对这方面不是特别感兴趣..可是就是觉得老师特别棒..讲的课能够吸引人.不是完全的照搬书上而是真的有很多知识要告诉我们一样.特别喜欢！而且很帅！！！
148,1021,吕强,2018-09-18 01:26:38,1357,1469,112,都长得这么帅了，还有什么好计较的呢。
161,1021,吕强,2015-03-14 16:17:30,-18,46,64,我觉得没大家说的那么好，慎重
187,1021,吕强,2019-06-12 05:45:09,602,655,53,颜好有原则顺带磁性声线 大叔控根本无力招架好嘛！！
218,1021,吕强,2015-03-14 16:58:47,20,27,7,很好的
231,1021,吕强,2015-03-14 17:14:00,71,78,7,帅而有气质的大叔～
238,1021,吕强,2019-02-26 10:44:37,344,370,26,上课非常幽默风趣～！内容也很充实！难得把思政课讲的这么好
313,1021,吕强,2015-03-15 00:43:09,-5,6,11,还可以，我不是很喜欢，但是蛮敬业\n\n
412,1021,吕强,2018-01-11 06:31:42,162,170,8,喜欢他的港台腔哈哈哈，很多人都是被他划重点划的最多而吸引。。但是请不要忽略了他上课真的很有趣！
437,1021,吕强,2018-06-13 16:43:31,29,32,3,挺好的
466,1021,吕强,2015-03-15 02:51:34,-1,9,10,主要是对这门课实在不感兴趣
469,1021,吕强,2015-03-15 02:52:39,-28,28,56,上课炒鸡有趣，但是绩点……呵呵……表示从头到尾认真听课认真码论文不如别人从来不听课论文复制粘贴来得成绩好………………
484,1021,吕强,2015-03-15 03:08:58,29,31,2,虽然没有之前学长学姐说得那么好，但是上课幽默有趣又深刻，摄影超级棒！大叔控擦掉口水！
547,1021,吕强,2015-03-15 04:43:49,8,10,2,不错的 不乏味的课~
716,1021,吕强,2015-03-16 02:16:27,101,112,11,上课挺有趣的，个人觉得是一个好老师，从几乎每次下课时都有掌声就可以看出
743,1021,吕强,2015-03-16 06:53:56,13,16,3,很有意思。讲课吸引人哦
809,1021,吕强,2015-03-17 10:54:02,19,19,0,会惨杂一点课外的，而且还会有许多好棒的资料
832,1021,吕强,2015-03-17 15:55:30,399,484,85,对军事感兴趣的男生不可错过！重点是这门课教会了我如何写一篇符合规范的论文，自此以后我全部的论文模板基本都是套用这门课的~
881,1021,吕强,2015-03-21 18:05:13,11,12,1,风趣幽默有干货！难得的思政课老师！
938,1021,吕强,2015-03-19 10:41:21,72,78,6,让我一个对军理毫无概念的人都能整堂课不溜号的好老师！
999,1021,吕强,2015-03-26 01:51:16,172,188,16,他长得很像元芳有木有呀～
1057,1021,吕强,2015-03-21 16:03:12,1,19,18,唯一缺陷是最后一节课给划的重点。。只是他认为的重点
1094,1021,吕强,2015-03-21 16:08:49,-1,1,2,太舒爽了～
1137,1021,吕强,2015-03-21 16:16:13,24,28,4,老师挺萌的
1306,1021,吕强,2015-03-21 18:48:59,7,9,2,严谨负责的好老师，也是军事科技历史迷。
1375,1021,吕强,2015-03-22 01:20:25,26,30,4,讲得真的挺好，上课认真听能学到很多东西，给分也棒棒哒。
1384,1021,吕强,2015-03-22 01:27:03,32,39,7,男神
1454,1021,吕强,2015-03-22 04:58:04,130,139,9,隔壁陈坤福班上的帮顶
1500,1021,吕强,2015-03-22 08:20:24,9,11,2,挺好的一个军理老师
1582,1021,吕强,2015-03-22 16:27:35,26,29,3,又帅声音又棒讲课也很有条理的好老师啊！期末还会划重点太良心了！
1653,1021,吕强,2015-03-23 06:10:40,0,1,1,"exit;"";exit"
1853,1021,吕强,2015-03-26 02:10:41,20,23,3,上课有内容，讲课风趣幽默 ，思路很清晰，讲的特别棒！~而且长的帅~人好~总之就是男神~
2026,1021,吕强,2019-01-16 05:55:11,7,8,1,很有趣最喜欢的课了
2122,1021,吕强,2015-04-01 14:51:52,67,70,3,虽然军理分数不高，但是老师的水平毋庸置疑
2174,1021,吕强,2016-06-21 03:27:51,86,90,4,超棒的英语口语！又帅！讲得也清楚！
2448,1021,吕强,2015-05-03 02:29:43,21,22,1,原谅我是大叔控~很有意思的老师
2741,1021,吕强,2015-05-06 14:34:12,4,10,6,感觉萌萌大……认真听肯定收获很大，但是很多人都往后坐水手机，鄙视……
2783,1021,吕强,2015-05-07 08:25:27,8,9,1,很负责
3436,1021,吕强,2015-06-12 10:44:25,27,29,2,什么都不说了，就是男神！
3641,1021,吕强,2015-06-17 01:57:58,14,15,1,男神！
3705,1021,吕强,2015-06-17 02:40:47,4,7,3,东西丰富
3869,1021,吕强,2015-06-17 07:06:26,6,6,0,讲得挺好的。而且帅
3908,1021,吕强,2015-06-17 08:03:50,12,14,2,吕男神
3960,1021,吕强,2015-06-17 11:15:38,5,5,0,好
4119,1021,吕强,2015-06-18 00:20:19,8,11,3,身为一个大叔控无力抵抗
4158,1021,吕强,2015-06-18 02:35:49,7,8,1,上课认真幽默风趣～男神范儿啊～人超好～
4215,1021,吕强,2015-06-18 06:31:21,2,4,2,挺好的“”帅，讲的好。
4349,1021,吕强,2015-06-19 08:34:43,3,4,1,给分不错+上课内容丰富
4398,1021,吕强,2015-06-21 08:16:05,67,71,4,吕强是个非常平易近人的老师。上节课开始五分钟因为近来拍毕业照的很多，就给我们讲述了他大学毕业的事，还放出了照片～专业知识也很过硬，是真的热爱军事知识
4716,1021,吕强,2015-06-26 12:09:09,12,13,1,实在是太棒了！第一节课就完全被吸引了，以前从来都对军事没什么兴趣，而且老师很好说话，很棒！
4846,1021,吕强,2015-06-29 14:33:17,1,3,2,棒
4946,1021,吕强,2015-07-01 08:46:11,5,7,2,港台腔
5133,1021,吕强,2015-07-04 13:33:42,16,17,1,帅
5241,1021,吕强,2015-07-06 03:28:27,41,43,2,老师讲课很好，内容充实，也会把自己的一些资料给我们看，而且超级温柔，他的笑简直可以把人融化。考试前也能在答疑群里为我们及时解答问题，真的很棒！
5517,1021,吕强,2015-07-08 04:27:12,209,216,7,期末建答疑群，考前答疑到深夜！！无比感动！！特别关心学生，会卖萌得跟你讲晚安。男神啊！！而且，告诉你们一个秘密，我不是男神班的。很想为了男神再修他别的课！！
5573,1021,吕强,2015-07-08 10:54:44,8,11,3,渊博 帅气
5574,1021,吕强,2015-07-08 11:00:21,0,2,2,赞
5579,1021,吕强,2015-07-08 12:21:37,2,4,2,水课还是想听一听，很有趣，有时候都忘记写作业了\n\n
5723,1021,吕强,2015-07-09 07:56:38,9,11,2,虽然对军理不敢兴趣，但是他的课完全不想翘
5875,1021,吕强,2015-07-09 17:30:44,29,35,6,也许没有哪个老师\n\n能再让我如此崇拜了。
5884,1021,吕强,2015-07-09 23:19:38,55,57,2,明明都这么帅了，还如此渊博如此和善如此认真负责，必须强势支持男神！
5931,1021,吕强,2015-07-10 03:04:33,1,3,2,男神！
5956,1021,吕强,2015-07-10 04:08:47,20,24,4,\n\n老师超级好，认真负责，而且特别善解人意，办事靠谱，上课不点名，虽然我没听课不过感觉很有趣，简直简直超级男神
5991,1021,吕强,2015-07-10 07:09:42,3,3,0,就是棒！！！！
6140,1021,吕强,2015-07-11 07:22:16,5,6,1,很棒啊，和和善，讲课也超级棒
6191,1021,吕强,2015-07-11 23:01:24,17,22,5,老师真的很负责啊，最喜欢这样的老师了\n\n考前建群答疑到最后一刻，感动到落泪ToT\n\n真真不愧男神老师啊！！！\n\n\n\n
6197,1021,吕强,2015-07-12 02:23:36,3,4,1,人超好
6249,1021,吕强,2015-07-12 10:08:46,5,6,1,男神强\n\n
6276,1021,吕强,2015-07-12 14:28:26,-16,23,39,老师姿势丰富，颜值高，解答耐心，最重要的是给了满绩，男神无误！
6875,1021,吕强,2015-07-27 17:50:32,2,3,1,绝对的男神！上完他的军理以后果断又选了一门他的通识！
7275,1021,吕强,2015-09-12 14:31:03,4,6,2,绝对好老师，讲课一点也不枯燥，对学生很耐心
7746,1021,吕强,2015-09-15 11:31:23,2,5,3,帅的不行，声音好听，特别有时事评论员的范儿！
7820,1021,吕强,2015-09-15 14:08:05,3,3,0,老师对很多自干五有启蒙的作用
7948,1021,吕强,2015-09-16 07:39:07,4,5,1,悔生晚矣
7971,1021,吕强,2015-09-25 13:36:03,6,7,1,老师好萌，语速好快，上课不笑下课会笑(=￣ω￣=)
8349,1021,吕强,2015-09-19 01:14:15,4,4,0,厉害嗒\n\n
8584,1021,吕强,2015-09-23 00:05:08,1,3,2,人太好了 哎 不知道怎么说了
8609,1021,吕强,2015-09-23 05:56:56,3,4,1,男神一枚
8774,1021,吕强,2015-09-26 09:34:30,21,26,5,太赞 作为一个姑娘认认真真听完每一堂课
9646,1021,吕强,2015-11-03 15:48:53,6,6,0,炒鸡棒！
10050,1021,吕强,2019-02-25 05:50:41,557,577,20,老师私藏的资料够把全校的水表都炸了
10203,1021,吕强,2015-11-17 10:59:08,18,20,2,会说这部分可水可听 那部分要好好听呀期末考形式很灵活的 总之 帅又机智
10273,1021,吕强,2015-11-18 01:12:21,-5,14,19,从不点名 但是给分不好
10852,1021,吕强,2015-11-23 07:15:18,32,35,3,讲的真是不错，军事知识极为渊博，而且不拘泥于所谓历史和政治，有自己的见解。口头禅是“就是这样子”——笑～
11339,1021,吕强,2015-11-27 16:27:25,3,4,1,上课很认真的
11695,1021,吕强,2015-12-11 15:00:35,4,4,0,个人魅力爆棚！
11778,1021,吕强,2015-12-15 07:13:30,2,3,1,老师知识很丰富，认真听能学到很多。
12121,1021,吕强,2015-12-22 02:27:02,7,7,0,很有趣，很舒服。
12375,1021,吕强,2015-12-23 07:22:34,5,5,0,真的是好老师 良心课
12673,1021,吕强,2015-12-24 00:57:54,1,3,2,有意思的老师，语速小快但是跟上了就停不下来
12751,1021,吕强,2015-12-24 03:13:49,3,5,2,炒鸡好\n\n
12852,1021,吕强,2015-12-24 06:35:02,4,5,1,帅帅帅
13204,1021,吕强,2015-12-25 07:17:49,9,11,2,真的挺有趣，不经意就卖萌了~讲的都是自己整理的内容，扩充看视频也很棒！
13625,1021,吕强,2015-12-30 06:34:33,17,18,1,绝对好老师，长得很帅，英语很6，私藏很多
13737,1021,吕强,2015-12-30 13:04:28,2,4,2,每节必去
14311,1021,吕强,2016-01-06 07:51:02,22,24,2,老师真的是很棒，上课讲得很好，期末还给划重点，态度非常认真，就连嗓子不舒服咳嗽了几下都要给同学道歉，能上过这么好的老师的课真的足够幸运了给多少分我都不介意XD
14366,1021,吕强,2016-01-06 13:50:59,9,9,0,简直太爽了~~好崇拜他~~不仅考试可以拿高分还可以学到真的知识，对同学非常关心，选上他的课简直太幸运了！！
14616,1021,吕强,2016-01-08 03:14:46,4,4,0,超赞！干货满满
14875,1021,吕强,2016-01-10 13:33:04,0,2,2,出类拔萃
16108,1021,吕强,2016-01-17 08:23:57,2,3,1,思政课老师，长得帅，声音有磁性，有耐心，事少，上课全干货，语言风趣幽默，你还想要什么？
16113,1021,吕强,2016-01-17 08:36:23,1,1,0,男神老师
16121,1021,吕强,2016-01-17 08:52:33,17,17,0,男神！！老师又帅又复责！结束的时候真的很舍不得！考试前会划重点，考试时还会到考场纠错。上课很有趣！良心老师！
16174,1021,吕强,2016-01-17 11:44:51,5,5,0,萌到酥
17052,1021,吕强,2016-01-19 13:55:33,1,1,0,知识渊博
17204,1021,吕强,2016-01-20 01:07:58,5,7,2,老师真的很良心上课真的很好！
17501,1021,吕强,2016-01-20 10:12:27,-15,7,22,差差差
17891,1021,吕强,2016-01-21 03:29:15,2,3,1,很有吸引力
18205,1021,吕强,2016-01-21 09:24:36,17,17,0,世界上最好的军理老师！
18379,1021,吕强,2016-01-21 13:54:15,-5,13,18,给分是真的差
18380,1021,吕强,2016-01-21 13:54:27,-1,2,3,老师真的男神！！虽然我军理课都是水水过
18381,1021,吕强,2016-01-21 14:01:43,3,4,1,吕强老师，谢谢您！
18384,1021,吕强,2016-01-21 14:04:02,2,5,3,讲真，老师讲课很有意思，重要知识点会很仔细的讲，而且有各种自己的私货，而且给分很有原则，关键最后一节课还会给大家讲答题技巧！大赞！
18385,1021,吕强,2016-01-21 14:06:28,-1,2,3,军理男神！讲课也讲得好，最后还会复习，特别细致，人还特别帅！绝对男神\n\n
18387,1021,吕强,2016-01-21 14:09:53,0,1,1,很好啊
18405,1021,吕强,2016-01-21 14:25:31,0,1,1,
18411,1021,吕强,2016-01-21 14:44:18,0,2,2,男神不解释
18417,1021,吕强,2016-01-21 14:47:25,3,5,2,超级有魅力的一个老师 人帅声音好听讲课很有内容也很有趣！作为一个对军事没有兴趣的人也没有办法拒绝 平时水考试照样帮你梳理得上天 就是这么666
18430,1021,吕强,2016-01-21 15:18:10,16,19,3,男神 永远你的学生------纪念2015.2016秋冬军理课
18433,1021,吕强,2016-01-21 15:22:16,13,14,1,男神男神男神 感觉是个老婆傻瓜（课上有提到过老婆 一种很棒的感觉）期中一篇论文 期末给划“我觉得的重点” 真的超赞 群内答疑到最后一刻 互动也超蠢萌的
18457,1021,吕强,2016-01-21 16:09:21,1,4,3,为什么老师不是满分？？？
18474,1021,吕强,2016-01-21 16:58:25,-1,1,2,男神，不需要理由
18855,1021,吕强,2016-01-22 15:45:49,1,3,2,男神男神男神！重要的事情说三遍！
19007,1021,吕强,2016-01-23 03:29:27,3,4,1,男神真帅而且好厉害 很认真很负责 越来越喜欢他 中期论文好好写 期末多看书 给分也不坑啊
19033,1021,吕强,2016-01-23 05:50:21,-1,2,3,超棒的男神!
19055,1021,吕强,2017-05-15 05:45:08,4,5,1,有趣充实，绩点有点低怪自己了……
19174,1021,吕强,2016-01-23 11:41:37,1,3,2,长得帅，上得好，性格ok。虽然天资愚钝感觉不到男神在军理学识上的魅力，但外在的还是感受了。
19837,1021,吕强,2016-01-25 11:14:22,2,4,2,男神！有颜有才还关爱学生！哪怕我啥都听不懂考得稀巴烂一学期都没去上过几次课那又怎样！这老师必须给满分！
19874,1021,吕强,2016-01-26 02:14:15,2,5,3,颜值爆表，男同学要认真上课学习男神的气质，女生吗……还要多说什么？
19876,1021,吕强,2016-01-25 12:59:45,0,2,2,不会水手机
20137,1021,吕强,2016-01-26 08:00:38,1,4,3,好、豪
21112,1021,吕强,2016-02-17 16:08:10,4,5,1,超喜欢吕强男神！作为一个喜欢军事的女生，听男神讲课好幸福~\(≧▽≦)/~
21132,1021,吕强,2016-02-20 12:16:54,3,5,2,男神 给分好 为学生着想
21297,1021,吕强,2016-02-28 03:21:27,1,3,2,爽！！！！！！！！
21347,1021,吕强,2016-02-28 06:32:55,0,2,2,这样的
21368,1021,吕强,2016-02-28 09:38:12,1,2,1,男神!会提醒同学一些贴心的事。暖男啊
21569,1021,吕强,2016-02-29 08:21:19,-7,9,16,其实也并没有那么帅
21644,1021,吕强,2016-02-29 11:49:33,-1,2,3,养眼啊～～～
21774,1021,吕强,2016-03-01 05:28:26,2,5,3,字写得漂亮
21840,1021,吕强,2016-03-01 08:05:47,3,5,2,老师上课会提醒你重点 在考试的时候也是 能给你的分数都会尽量给你 标准都很明确 真的非常喜欢吕强老师 人特别好！很有知识和气质的一个老师！
22111,1021,吕强,2016-03-02 11:15:53,2,2,0,真心不错
22122,1021,吕强,2016-03-02 11:44:22,2,3,1,蛮爽的！很棒！
22142,1021,吕强,2016-03-02 13:39:42,0,1,1,很好啊！
22434,1021,吕强,2016-03-05 11:07:50,0,1,1,男神！
22630,1021,吕强,2016-03-09 02:37:08,3,3,0,。。。
23191,1021,吕强,2016-03-21 09:11:01,1,3,2,讲得好，掌声雷动
23226,1021,吕强,2016-03-22 06:14:37,6,6,0,这是男神啊同学们！！
23309,1021,吕强,2016-03-24 04:12:20,6,6,0,男神！！
23528,1021,吕强,2016-04-05 03:26:14,4,4,0,简直男神啊...虽然对军事不太感兴趣...但是上课还是很认真的在听...很有趣
24241,1021,吕强,2016-04-28 17:02:38,1,3,2,老师简直太棒！给分也好！开心！\n\n
24536,1021,吕强,2016-05-01 08:01:46,2,3,1,上课可水可听 有干货 期中论文要求有点高
25526,1021,吕强,2016-05-24 11:51:48,-1,1,2,真心好老师
25728,1021,吕强,2016-06-05 15:24:24,1,1,0,男神。上课超级认真，魅力太强挡都挡不住。
25826,1021,吕强,2016-06-10 08:38:10,1,1,0,很好⋯⋯
25895,1021,吕强,2017-01-13 02:44:50,2,3,1,这可是我大爱的吕男神啊！！！\n\n水了一个学期的军事理论课是我这学期最最后悔的一件事。每次看到答疑群里男神带着一众大佬一顿high的场面都会让我重新燃起好好学习的激情。作为我这个考试周复（yu ）习的最认真的一门课，军理一考完我突然有了一种考试周已经结束的奇妙错觉。
25929,1021,吕强,2016-06-14 12:01:14,5,7,2,为了走私老师私藏的资料，我拿过去一个1T运动硬盘，从头到尾拷了我一节课⊙▽⊙
25961,1021,吕强,2016-06-14 15:10:58,0,2,2,长得帅气 待人接物又十分和善(///w///)\n\n上课内容丰富【也可选择不听】讲得也很好\n\n简直是最喜欢的老师啊ww
26118,1021,吕强,2016-06-16 02:32:07,2,2,0,老师重点划的多，讲课也有自己独到的见解，人也很好，还会在群里发红包，强推！！！
26180,1021,吕强,2016-06-16 07:17:32,3,3,0,男神，最后qq群里大家都在刷不管绩点多少都要谢谢老师！
26497,1021,吕强,2017-01-16 17:05:39,14,17,3,真的是好老师 上课节奏 内容都很用心 给分也好
26574,1021,吕强,2016-06-20 07:17:52,2,3,1,很帅 虽然上课没听懂过 但是看得出来老师人很好 很有修养 很温柔”
26793,1021,吕强,2016-06-21 06:27:21,3,3,0,男神啊
26928,1021,吕强,2016-06-21 16:05:12,-1,1,2,吕强男神超赞！
27002,1021,吕强,2016-09-10 04:43:35,7,8,1,选的现代战争与国防技术，干货不少，课堂讨论环节也很有意思，适合对军事感兴趣并且有一定基础的同学；当然哪怕基础不是很好，小组讨论抱个大腿、论文认真点写，给分也不会差……
27133,1021,吕强,2016-06-23 06:50:04,0,0,0,吕强超帅！
27151,1021,吕强,2016-06-23 08:17:36,0,1,1,炒鸡帅！！！炒鸡关心学生的！！！讲的也清楚，论文模版超严谨的～
27152,1021,吕强,2016-06-23 08:22:35,1,1,0,感觉长得很像一个老戏骨，但是不记得那个演员叫什么了。真的很喜欢他~
27317,1021,吕强,2016-06-24 15:36:48,1,1,0,特别棒，真性情
27337,1021,吕强,2016-06-25 02:54:24,3,4,1,第一节课吓唬我们会点名。然而最终并没有点名。我后悔没翘更多的课。
27394,1021,吕强,2017-01-25 07:25:23,1,2,1,好老师啊，真是负责任的好老师，如今不多见了。
27566,1021,吕强,2016-06-27 03:41:20,2,2,0,为了他 我去选了一门通识课
27568,1021,吕强,2016-06-27 03:54:01,-1,0,1,真心是好。上课风趣幽默
27853,1021,吕强,2016-06-27 23:29:00,-1,0,1,声音嗯好听
27925,1021,吕强,2016-06-28 05:38:24,0,0,0,老师帅  讲得好
27954,1021,吕强,2016-06-28 07:15:52,0,6,6,我同意那两个被喷得最厉害的两个观点。另外，老师讲课好，给分看不懂。人格魅力有的，为什么给分这样？\n\n\n\n每节课都认真听了，看了无数文献新闻码了七千字论文，最后考试几乎所有题目都在书上确认了，然后3.4。微笑。
28026,1021,吕强,2016-06-28 08:00:18,-1,0,1,又帅又好
28090,1021,吕强,2016-06-28 08:05:48,0,0,0,666666\n\n
28164,1021,吕强,2016-06-28 08:11:22,3,5,2,终于有个老师教论文的格式了
28416,1021,吕强,2016-06-28 08:54:41,1,1,0,吕强老师很能为学生着想。个人对军事不感冒，上课努力去跟依旧无法感兴趣，有愧。老师经常分享资源，记得一次课看广岛原子弹的纪录片，很受感染。
28485,1021,吕强,2016-06-28 09:20:51,1,1,0,人都这么帅了，一切都不是问题
28520,1021,吕强,2016-06-28 09:46:46,4,4,0,两堂课可以讲得满满当当，每次下课必有掌声。老师真的是非常为我们考虑的，更重要的是～有万军(/ω＼)
28562,1021,吕强,2016-06-28 10:19:37,1,2,1,长得帅
28565,1021,吕强,2016-06-28 10:21:23,2,5,3,8年上过吕老师的课，不得不说时间过得真快！给分高，长得帅，讲得好！
28569,1021,吕强,2016-06-28 10:27:57,1,1,0,Perfect
28626,1021,吕强,2016-06-28 11:14:01,-1,0,1,
28728,1021,吕强,2016-06-28 13:21:38,4,4,0,男神！能够从老师的话里感受到他的热情哈哈哈还有强大的知识储备，最重要的还是万能的军理群还有男神个人魅力。
28762,1021,吕强,2016-06-28 14:09:26,2,2,0,舍友想嫁给他！
28949,1021,吕强,2016-06-29 04:16:31,6,6,0,超级男神！！！！最后散群前还会发红包给我们～～大爱男神
29125,1021,吕强,2016-06-29 09:11:29,4,5,1,没听过男神的课，就不算来过浙大
29270,1021,吕强,2016-07-05 03:44:27,5,5,0,超级棒的男神
29693,1021,吕强,2016-06-30 07:59:33,3,3,0,讲课精彩，关心学生，喜欢！
29997,1021,吕强,2016-06-30 16:28:42,148,154,6,请记住，你的军理老师叫“吕强”，不叫“李强”，也不叫“褚良才”???
30263,1021,吕强,2016-07-01 06:59:46,7,7,0,所有教军理的老师中最好！没有之一！六一儿童节在群里发了200的红包，期末考试完又发了100的红包！考前会给复习资料，讲的也非常好！男神！
30854,1021,吕强,2016-07-02 16:19:20,-1,1,2,啊啊啊啊！！！男神超好！群里总是发红包！给分也不错，然后人超级好啊！很负责！上课也会讲很多很有趣的东西！军理课都变成沃听的最认真的课啦！！！
30957,1021,吕强,2016-07-03 04:31:58,0,0,0,男神啊！！！
30976,1021,吕强,2016-07-03 05:15:28,-7,5,12,真不知道成绩怎么搞得，只能呵呵了
30977,1021,吕强,2016-07-03 05:31:05,0,1,1,超级棒！上课超级好！爱万能的军理群
30986,1021,吕强,2016-07-03 05:46:32,2,2,0,非常赞！男神老师！
30987,1021,吕强,2016-07-03 05:46:49,0,1,1,幽默风趣讲的好给分也好⊙▽⊙
30988,1021,吕强,2016-07-03 05:47:45,4,4,0,老师超级好，给分也好，最后一节课还给我们复习，还发目录表(*^ω^*)
30989,1021,吕强,2016-07-03 05:48:37,-1,1,2,女生节发红包 六一儿童节也发红包～
30991,1021,吕强,2016-07-03 05:49:57,-1,1,2,被正态
30996,1021,吕强,2016-07-03 05:53:13,1,1,0,棒！！！
31000,1021,吕强,2016-07-03 05:55:44,-1,0,1,绝对男神\n\n
31003,1021,吕强,2016-07-03 05:57:18,1,1,0,3个字
31012,1021,吕强,2016-07-03 06:19:22,-9,2,11,不说了，就看了一遍书就满了。我感动得要哭l了?
31013,1021,吕强,2016-07-03 06:14:57,10,10,0,万军出征寸草不生
31023,1021,吕强,2016-07-03 06:25:14,1,1,0,虽然平时也不怎么认真听，但是最让我感动的是每节课下课的掌声和论文上交出了问题一个个来核实并且手动回复邮件
31026,1021,吕强,2016-07-03 06:27:58,1,2,1,我不管我就要给男神满分
31042,1021,吕强,2016-07-03 06:53:57,-1,0,1,男神不解释！真心为学生着想！
31050,1021,吕强,2016-07-03 07:09:26,0,0,0,满分男神
31053,1021,吕强,2016-07-03 07:15:48,0,4,4,还行吧，给分一般
31074,1021,吕强,2016-07-03 07:47:19,2,2,0,不爱绩点爱男神
31091,1021,吕强,2016-07-03 08:11:21,-1,0,1,男神！！！
31207,1021,吕强,2017-03-02 08:05:09,8,10,2,君生我未生，我生君已老，恨不生同时，日日与君好！
31255,1021,吕强,2016-07-03 13:18:02,2,3,1,虽然自己的成绩不是很好\n\n但是老师超级好！！ 讲的很有趣 会放影片 关注时事 过节还会发红包 虽然我从来没抢到过 把军事也讲得很有趣噢 每次抢占第一排? 甚至想再上一次课
31284,1021,吕强,2016-07-03 14:08:39,1,1,0,非常好
31397,1021,吕强,2016-07-04 00:28:11,-1,2,3,为什么非要写评价。楼上的把我想说的优点都说了
31548,1021,吕强,2016-07-04 06:05:08,0,2,2,气质好，知识渊博，讲课不无聊，不点名，发红包大方，给分高
31757,1021,吕强,2016-07-05 01:21:25,0,2,2,男神呀！讲课讲的超级好！只可惜我都没怎么听。。现在想想都有点后悔。上课玩什么手机啊！男神的课也就听一个学期啊。给我们模版，教我们写论文；创建1000人的万军大群，都有感情了呢～是不是男神还会发几个红包，虽然我从来没有抢到过。论文和考试好好考就行了～最后，赞～
31863,1021,吕强,2016-07-05 04:32:53,1,2,1,老师上课很认真！感觉每次一个半小时就没停下来过? 赞！
32130,1021,吕强,2016-07-05 16:33:47,-1,2,3,强哥真男神！课上的真心好，最后还提供考试复习资料，不给满分不行啊！！大学第一门满绩！
32324,1021,吕强,2016-07-06 07:11:28,0,1,1,男神男神
32376,1021,吕强,2016-07-06 10:19:45,2,2,0,实实在在地想给当代大学生带来些东西的老师
32421,1021,吕强,2016-07-06 15:44:30,1,2,1,好评都这么多了我只是来给个10分的
32725,1021,吕强,2016-07-11 15:44:04,1,2,1,好好好
32815,1021,吕强,2016-07-15 05:40:49,-1,1,2,满分！男神！
32945,1021,吕强,2016-08-14 10:13:54,-1,1,2,告诉你不会点名，真的不会点名
33679,1021,吕强,2016-09-21 03:34:17,0,0,0,男神啊紫薯
33754,1021,吕强,2016-09-21 10:43:41,2,3,1,男神。磁性男腔。人好。千年一遇。选上就是幸运
35414,1021,吕强,2016-11-10 07:14:28,-1,0,1,完美，没作业就一个论文，课堂讨论写个名字就可以了
35464,1021,吕强,2016-11-10 07:18:59,0,0,0,不能更棒
35757,1021,吕强,2016-11-10 08:03:50,1,1,0,应该很好吧
35875,1021,吕强,2016-11-10 08:38:13,0,1,1,爱上了通识课
35955,1021,吕强,2016-11-10 09:09:06,-1,0,1,还不错
36086,1021,吕强,2016-11-10 11:57:09,-1,0,1,超级超级好
36139,1021,吕强,2016-11-10 14:19:07,0,0,0,他的课很有帮助
36155,1021,吕强,2016-11-10 15:23:33,1,1,0,非常好\n\n
36845,1021,吕强,2016-11-16 08:35:46,-1,0,1,像我这样完全懵逼的人都能听懂
36865,1021,吕强,2016-11-16 09:56:01,0,1,1,上他的课很有趣，像听故事一样，其次如果你有思想也可以在讨论课时上台展示，如果不想太麻烦也可以直接抱大腿，真是一门有趣的课。
37586,1021,吕强,2016-11-19 14:19:03,2,2,0,男神 冷空气之前还在群里发红包关心同学
40253,1021,吕强,2016-12-30 15:34:21,1,1,0,保佑我选上男神的课吧！！！
40332,1021,吕强,2017-01-03 03:02:08,1,1,0,帅！生猴子吧！
40497,1021,吕强,2017-01-04 01:21:33,2,3,1,虽然我还没选上他的课 但不妨碍他是一个好老师（｡ò ∀ ó｡）
40568,1021,吕强,2017-01-04 06:07:31,-1,0,1,老师很好~不过我想说，军事理论不是思政课!!是军体类的课!!你们有没有好好看培养方案。。
41140,1021,吕强,2017-01-09 12:20:38,-1,0,1,如沐春风……
41422,1021,吕强,2017-01-11 13:03:12,0,0,0,发好大的红包哦，来浙大不听男神老师的课就可惜了！
41546,1021,吕强,2017-01-12 07:19:25,0,1,1,好好好
41556,1021,吕强,2017-01-12 07:42:53,-1,0,1,围观男神
41599,1021,吕强,2017-01-12 08:41:57,0,0,0,超级棒！12点还在答疑 特别好！长得特别像以前的化学老师 很亲切
41606,1021,吕强,2017-01-12 08:51:32,1,1,0,男神知识储备超丰富，课也讲得很有意思(⁎⁍̴̛ᴗ⁍̴̛⁎)然后结课还请吃散伙饭⁄(⁄ ⁄ ⁄ω⁄ ⁄ ⁄)⁄
41615,1021,吕强,2017-01-12 09:07:42,1,1,0,棒！棒棒
41645,1021,吕强,2017-01-12 09:42:07,3,3,0,男神会考完军理后请课吃饭诶～
41648,1021,吕强,2017-01-12 09:45:04,1,1,0,很好很暖心
41834,1021,吕强,2017-01-13 03:44:05,3,6,3,男神不是虚的，超级帅，私藏的资源会给我们分享，口头禅“是不是”“这样子”，港台腔萌，PS.长得明明像马英九好吗!!!
41852,1021,吕强,2017-01-13 04:54:08,-1,1,2,送手机
41888,1021,吕强,2018-11-26 14:52:39,126,137,11,期末考上98 有Mate9 Pro拿！
42126,1021,吕强,2017-01-13 15:30:10,2,4,2,超好哦！男神
42560,1021,吕强,2017-01-14 12:58:54,4,4,0,吕男神！
42563,1021,吕强,2017-01-14 13:01:59,3,4,1,吕男神可帅可帅！而且关心同学，讲的非常好，期末复习很负责呢
42569,1021,吕强,2017-01-14 13:13:45,1,2,1,帅，有魅力，声音好听，很认真负责的老师，对同学很亲切，总是发红包，考试结束还请了有的同学吃饭，超棒！
43603,1021,吕强,2017-01-16 15:10:51,-1,1,2,谢谢老师
43606,1021,吕强,2017-01-16 15:21:01,0,1,1,好老师，真的\n\n
43607,1021,吕强,2017-01-16 15:22:50,-1,2,3,咸鱼4.8，你说好不好
43611,1021,吕强,2017-01-16 15:29:21,0,1,1,男神太好了 给了我满绩ww
43651,1021,吕强,2017-01-16 16:41:51,2,2,0,男神不解释
43673,1021,吕强,2017-01-16 21:12:05,2,3,1,简直男神！那么帅了还能说什么..还会发红包..期末考解答到最后...就两个字：完美！
43692,1021,吕强,2017-01-16 23:37:59,0,1,1,10分不解释\n\n
43696,1021,吕强,2017-01-16 23:46:11,52,56,4,“给大家正在放的这个影片是关于××很难得的××类影像资料，（略去100字）这个影片全套有××个G（总之巨大就对了），有兴趣的同学可以课下拿移动硬盘找我拷贝一下”\n\n吕老师的每次的开场白，感觉萌萌哒，希望老师以后也能工作顺利啊。
43766,1021,吕强,2017-01-17 02:44:25,5,5,0,简直男神
43916,1021,吕强,2017-01-17 06:21:40,5,6,1,万能的军理群。老师很好就是我从来没抢到过万军的红包……
44171,1021,吕强,2017-01-17 11:17:46,0,1,1,老师讲课有水平，私藏很多干货，会在群里卖萌答疑到深夜！
44251,1021,吕强,2017-01-17 13:13:46,2,3,1,非常关心同学们，经常在群里跟大家交流答疑，还是十分幽默hhh 当然还有名不虚传的万军 总之男神的军理绝对不能错过~有男神这么棒的老师真是浙大的幸事哇
44466,1021,吕强,2017-01-18 00:48:33,3,3,0,真的超级棒超级棒，虽然红包我一个没抢到过hhh真男神
44598,1021,吕强,2017-01-18 03:56:57,1,2,1,春风化雨啊！！男神！\n\n
44982,1021,吕强,2017-01-18 16:47:56,2,3,1,超赞的
45172,1021,吕强,2017-01-19 05:38:30,1,3,2,男生不解释，绝壁男神，另外还有万军加成作用，是一个解决所有问题的万年有用群
45190,1021,吕强,2017-01-19 06:25:50,0,1,1,男神男神男神！
45792,1021,吕强,2017-01-20 06:02:53,1,2,1,男神老师，我是铝丝
46194,1021,吕强,2017-01-21 01:49:51,-1,1,2,长得帅，讲得好，还有红包，给分又高，真的是好老师
46354,1021,吕强,2017-01-21 10:18:56,1,1,0,老师绝对男神不解释，你能想到的关于老师的优点几乎全都有！
46395,1021,吕强,2017-01-21 12:56:28,-1,1,2,虽然被正态了，但是老师人炒鸡好的
47230,1021,吕强,2017-01-24 20:36:09,0,1,1,思政课已经做得很好了
47367,1021,吕强,2017-01-25 12:58:01,1,1,0,给分好
48007,1021,吕强,2017-02-28 03:51:33,2,2,0,很好的
48163,1021,吕强,2017-03-01 04:42:04,3,4,1,同学，你还记得当年启真湖畔的万军群么？
48214,1021,吕强,2017-03-01 08:55:40,-1,1,2,同学们能不能分享一下军理群群号呀
48222,1021,吕强,2017-03-01 09:38:42,2,2,0,为啥没有一百分？负责，超好！
48425,1021,吕强,2017-03-03 05:29:28,0,1,1,老师人太好，感激！
48455,1021,吕强,2017-03-05 03:29:17,3,4,1,老师的万军!万军!铝粉。
48487,1021,吕强,2017-03-06 04:32:11,3,5,2,男神给我朋友圈点赞了   幸福的晕倒
48511,1021,吕强,2017-03-06 10:06:21,2,3,1,那么帅气的老师～还需要说什么呢
48710,1021,吕强,2017-03-10 02:05:52,4,4,0,有时候打算不听课然后干一些别的事情，比如说写写作业什么的，结果老师一开口，我就不想写了，水手机的时候也都是在查有关老师讲的东西。总之很有意思，绝对不是水课
49127,1021,吕强,2017-06-30 12:41:34,4,4,0,吕老师男神，长得帅，讲课棒，给分好，最重要的还是万军群啦啦啦~笔芯
51439,1021,吕强,2017-06-05 12:26:54,15,24,9,就没人说一下平时授课内容，授课方式，成绩组成，考试经验之类的吗?全是一些分高人好的空话。
51577,1021,吕强,2017-06-07 09:01:32,1,1,0,哇首先老师贼帅哈哈这是重点其次吕强老师讲的真心很好是很有料的那种
52075,1021,吕强,2017-06-30 12:46:44,-1,1,2,太好了，真的太好了，绝对男神啊
52251,1021,吕强,2017-06-16 11:11:23,-18,4,22,教室里人太多了，写作业都不舒服，上课一直昏昏欲睡，我觉得老师声音有点刺耳
52254,1021,吕强,2017-06-16 11:59:44,0,1,1,nice
52681,1021,吕强,2017-06-22 06:35:53,1,1,0,特别体谅学生，有原则
53099,1021,吕强,2017-06-30 12:48:00,-1,0,1,完美的老师啊    选上了他的课感觉用了我这学期所有的运气  啊啊啊啊啊啊啊  笔芯老师，
53229,1021,吕强,2017-06-26 08:29:52,3,3,0,老师很帅，不仅颜值
53491,1021,吕强,2017-06-27 00:50:40,0,2,2,很奇怪竟然有人没有给男神十分！！！
54562,1021,吕强,2017-06-29 16:00:38,29,31,2,竟然没有100分？？对于这个软件的好用度我是“江信江疑”的。划几个关键词：帅，声线醉人，英文十八级，硬笔书法一百级。学富五车，授课有方，可水可听（水得了的心智一定已经坚如磐石了我猜嗯）。有原则，体谅学生，考评要求合理。红包大户，重点巨户（最后一节考试说明课全班坐满，各大文印店复习资料驰名品牌“这是吕强的资料”）。个人魅力组织起浙大第一部落“万军”，久负盛名，名副其实。总之“你喜欢的样子全都有”。
54911,1021,吕强,2017-06-30 12:46:12,1,2,1,老师超级无敌负责，给分也超好，不会给我们卡档！！！！！！！！从来没碰到这么贴心的老师！！！浙大男神啊啊啊
54912,1021,吕强,2017-06-30 12:46:17,1,2,1,可水可听，干货很多，反正我是一节课都没听过；最后一节课划重点超爽！考前看了一天的PpT和提纲，忽然觉得军理好有意思，后悔之前没听hhh……最后4.5
54913,1021,吕强,2017-06-30 12:46:22,0,0,0,我的男神啊啊啊啊啊！一个字！选！！！表白！比心！
54914,1021,吕强,2017-06-30 12:46:30,1,1,0,很棒的
54915,1021,吕强,2017-06-30 12:47:39,2,2,0,老师上课超级好呀，声音很温柔，温文儒雅的，最后一课会划重点教考试技巧，还会在群里和同学互动，发红包，绝对好评！
54916,1021,吕强,2017-06-30 12:47:40,2,2,0,人长的帅讲课又有意思给分又nice这不是完美是什么嘛！！！超爱老师！
54917,1021,吕强,2017-06-30 16:06:53,4,4,0,老师人很好，大二了很多课都水水过了
54920,1021,吕强,2017-06-30 12:53:17,-1,0,1,老师超好的，主要是帅
54927,1021,吕强,2017-06-30 12:58:39,-1,0,1,男神！！！
54928,1021,吕强,2017-06-30 12:59:23,0,0,0,超棒啊老师
54929,1021,吕强,2017-06-30 12:59:46,0,3,3,老师很好很贴心 这次考的不好但是还是帮我们努力调分了 ppt和划重点都很有用 是一个细致体贴的男神！
54932,1021,吕强,2017-06-30 13:03:18,0,2,2,刚刚出分让我来给老师100分！都不嫌多！又帅人又好，给我的分真的超出预期啊超感动！又给我们发了好几个红包！感谢老师一学期以来的辛苦授课～表白男神！
54933,1021,吕强,2017-06-30 13:03:42,-1,0,1,老师真男神，特有人格魅力
54934,1021,吕强,2017-06-30 13:04:28,10,11,1,老师很有内涵，水平很高，分享自己的看法又不强加于人，同时鼓励学生有自己的思考。每到节假日就在群里发红包，对学生超级好。上课从不点名，因为到课率从不用担心，而且下课都有掌声。老师英语水平很高，是我遇到口语最好听的老师（比英语老师好）。而且老师感情细腻，有一次上课看二战纪录片，看到日本被原子弹轰炸后灾难场面，看到老师眼眶湿湿的。上到他的课真的超级幸运！男神老师！最后给分也好，太喜欢了！
54935,1021,吕强,2017-06-30 13:04:31,1,3,2,分不高，我太垃圾了
54941,1021,吕强,2017-06-30 13:06:51,1,1,0,男神，有啥好说的
54944,1021,吕强,2017-06-30 13:08:06,1,2,1,大爱老师的军理，上课经常给我们放军事视频~\(≧▽≦)/~特别关心我们的学习生活，军理群真的是一个答疑解惑的好去处。最后复习认真看一遍书就好了的，老师给分也超级好的。
54946,1021,吕强,2017-06-30 13:09:19,2,3,1,男神！这绝对是我思政课目前为止的最高分！
54948,1021,吕强,2017-06-30 13:12:41,5,5,0,3.9有一丢丢难过不过还是要给老师满分~\n\n
54950,1021,吕强,2017-06-30 13:14:24,2,3,1,哇居然有人不打十分吗？？男神啊，超有魅力超爱学生
54952,1021,吕强,2017-06-30 13:16:43,-1,1,2,真正的好老师
54955,1021,吕强,2017-06-30 13:18:58,3,5,2,老师很帅，总是用慈父的眼光看着我们，实在太亲切了，关键是军理群很强大啊
54969,1021,吕强,2017-06-30 13:43:33,2,3,1,非常非常好的一位老师！上课生动不死板，课下活波又可爱～珍惜相遇的缘分，好好听课吧(๑•̀ㅂ•́)و✧
54991,1021,吕强,2017-06-30 14:45:00,3,18,15,刚出了成绩，反正没那么男神的，可能是因为我不敢兴趣所以也没怎么听过课。最后拿了很低的绩点我也很绝望。也不能怪老师是我太菜，但我想说的是，不要只看见光鲜的一面，有人在黑暗里伤心了很久。
54993,1021,吕强,2017-06-30 14:54:03,0,1,1,ggg
55019,1021,吕强,2017-06-30 16:08:48,5,6,1,老师上课很认真，讲的都是军事方面的，对军事感兴趣的一定要去选老师的课。但我因为不敢兴趣所以没听，考试时候因为复习其他科目也没来得及复习军理，所以成绩比较惨。但这是我自己的原因。总之，老师非常好，而绩点当然要看自己啦
55026,1021,吕强,2017-06-30 16:13:16,10,10,0,军理群的这万军绝对是浙大生活必备之宝，男神老师节假日发红包很阔气的，绩点吧毕竟正太无法照顾到所有人，但大部分人都是照顾到了呀
55086,1021,吕强,2017-06-30 22:56:34,1,2,1,男神！感觉男神也有一颗童心，所以和学生们都特别亲，爱老师！
55157,1021,吕强,2017-07-01 02:18:52,0,3,3,男神评论了我空间，哇好开心
55234,1021,吕强,2017-07-01 05:14:09,1,1,0,一个字 棒！
55236,1021,吕强,2017-07-01 05:16:19,6,6,0,超棒的军理老师，虽然我成绩不好，但是老师真的是没话说，还有军理群，老师前前后后加起来一个学期都发了近一千的红包了，虽然只抢到一次，但是感觉老师对学生真的很用心
55240,1021,吕强,2017-07-01 05:18:17,2,3,1,记得涂卡下笔要重点 还会经常发红包的老师 （6s就会被抢光）抢了两次不抄过¥1。\n\n还会在群里和我们互动的老师 超棒的 还会特地问我们绩点成绩分布不让我们卡档 \n\n有100分吗？！
55257,1021,吕强,2017-07-01 06:23:10,1,2,1,竟然有人没给老师打10分…
55262,1021,吕强,2017-07-01 06:41:17,2,2,0,男神！！！
55316,1021,吕强,2017-07-01 08:54:05,3,3,0,帅！！！人超好！！！万军超棒！！！喜欢！！！给分也高！！！
55479,1021,吕强,2017-07-01 14:59:17,-1,0,1,啦啦啦
55514,1021,吕强,2017-07-01 21:46:54,0,0,0,棒棒哒男神
55784,1021,吕强,2017-07-02 11:21:17,1,2,1,老师说\n\n不可以打高分\n\n老师们评分要平均
55785,1021,吕强,2017-07-02 11:21:19,2,2,0,老师每节课都点
55786,1021,吕强,2017-07-02 11:21:34,8,9,1,老师最大的缺点：无法正视自己的优点。
55787,1021,吕强,2017-07-02 11:21:55,-1,1,2,orz
55788,1021,吕强,2017-07-02 11:22:06,-15,4,19,每次必点名。。。
55789,1021,吕强,2017-07-02 11:22:51,-1,1,2,男神!!!
55802,1021,吕强,2017-07-02 11:47:03,0,1,1,老师上课非常好！考前还有专门的课为我们讲解考试要求。
55842,1021,吕强,2017-07-02 12:43:53,0,1,1,唉，自己没好好努力，老师讲的很好
57702,1021,吕强,2017-07-12 15:41:49,0,1,1,良心极了
58011,1021,吕强,2017-07-23 01:55:42,1,2,1,emmmm……\n\n优点前面的人都说了\n\n我就是来给老师打个满分的
58018,1021,吕强,2017-07-23 03:30:21,0,1,1,哈哈哈哈哈?
58119,1021,吕强,2017-08-02 04:58:20,-1,0,1,欣赏，美的享受（论讲课与颜值ʘᴗʘ）
58618,1021,吕强,2017-09-10 00:27:42,1,1,0,非常棒啦！！！！
58828,1021,吕强,2017-09-18 04:23:23,-1,0,1,真的好老师啊
58854,1021,吕强,2017-09-18 05:36:16,2,3,1,吕老师军理课非常有趣
59070,1021,吕强,2017-09-19 10:12:27,-1,0,1,！！！
60152,1021,吕强,2017-10-12 00:16:38,0,0,0,英语确实有点提高了?
60372,1021,吕强,2017-10-18 07:41:31,0,1,1,很不错的老师，讲课挺有趣味的
60583,1021,吕强,2017-10-24 11:02:24,0,3,3,“大概这样子”
61360,1021,吕强,2017-11-15 08:12:53,-1,1,2,还没出分数。攒一波人品。英语口语真的好。课程一点都不水。上课太有趣了。喜欢军事的可以来选～～～\n\n希望拿一个好分数
61929,1021,吕强,2017-11-22 00:06:13,1,2,1,老师的现代战争与国防技术，课有点小累，论文要求高于军理，讨论课需要花点时间准备一下，组要选好，不能忍的队友就是全程低头玩手机，完全不参与讨论的！但就课堂而言，依然干货满满！
62256,1021,吕强,2017-11-23 15:08:52,-1,1,2,老师帅，课讲的好
62549,1021,吕强,2017-11-26 02:09:02,23,35,12,也就这样吧，不要太相信查老师上面的评分，高分不一定适合你，低分不一定不适合你。
63104,1021,吕强,2017-11-28 09:39:06,2,3,1,讲得很棒    关键人超好啊！！～\n\n
64207,1021,吕强,2017-12-21 12:56:50,1,2,1,真的非常好，老师有很多干货，记点不低，可水可听。
64209,1021,吕强,2017-12-21 13:14:58,-2,2,4,铝丝路过
64275,1021,吕强,2017-12-22 07:35:52,-1,2,3,超棒！可惜没有拷到男神的硬盘资源哈哈哈
65329,1021,吕强,2018-01-03 05:12:01,51,56,5,吕强的分数快超过我了，是不是和我竺可桢过不去
65484,1021,吕强,2018-01-04 12:00:35,-1,1,2,开心?
65914,1021,吕强,2018-01-10 07:43:39,0,0,0,幸运死了，虽然体育课没选上，但是选上吕老师的课，高兴
67927,1021,吕强,2018-01-22 10:25:10,-6,3,9,要点名
68708,1021,吕强,2018-01-23 15:50:05,4,5,1,老师给的资料特别充实，课也很棒，那些选上了吕强老师的课还翘课的同学良心不会痛吗？总之给10分！！！
68944,1021,吕强,2018-01-24 06:52:43,3,3,0,和老师合影的愿望看来下个学期才能实现了
70474,1021,吕强,2018-01-26 16:27:34,2,3,1,出分之前膜一下
70842,1021,吕强,2018-01-27 15:24:42,1,3,2,真的好
70844,1021,吕强,2018-01-27 15:28:15,2,2,0,认真教学而不失幽默，无论是抱以水课的心态还是认真学习的目的，都能有很大的收获
70849,1021,吕强,2018-01-27 15:40:03,3,4,1,听说老师给分很好 然而分并没有预想的好哈哈 怕是期末考爆了 老师讲课很好 虽然讲道理军事并不感兴趣但还是会听 最后红包虽然没抢到过但很够意思
70857,1021,吕强,2018-01-27 15:50:41,0,3,3,还可以吧
70859,1021,吕强,2018-01-27 15:51:36,3,4,1,长得帅，有气质，军事知识渊博，上课幽默风趣有魅力，论文模板超高端，最后一节课会讲复习答题技巧，经常在群里发红包，给分也好，完美男神没错了！
70864,1021,吕强,2018-01-27 15:59:11,4,6,2,老师人超级好，课上的也棒，军理书上的内容又老旧又死板，但男神能上得干货满满，本来是抱着赶作业的心态上的军理，但是总“忍不住”听男神上课23333，考试给的提纲极好，但是可能是专业课扎堆，对军理不重视吧，考试考得不太好，最后意外地收获了很好的成绩，给男神打十分！！！
70877,1021,吕强,2018-01-27 16:15:41,11,11,0,算是明白为什么是这么多人的男神了！期末被圈粉！虽然自己考的不大行(还不是因为自己)，但是就在群里跟风问了句好奇卷面成绩，男神就真的来私戳我?  感动的要哭出来！
70878,1021,吕强,2018-01-27 16:16:57,2,5,3,老师真的是男神无误了！感动！虽然绩点不是特别好但也是很满足了！老师人实在是太nice了！上课很有风度又超级关心学生！为吕强男神打烂电话！
70895,1021,吕强,2018-01-27 21:44:08,2,4,2,嘻嘻，男神
71123,1021,吕强,2018-01-28 03:43:28,4,4,0,最后一节课突然很伤感听不到老师的课了，老师真的是很有人格魅力的人，男神\n\n
72107,1021,吕强,2018-01-29 11:00:19,0,1,1,不管最后几分，永远的男神
72286,1021,吕强,2018-01-29 21:19:31,1,3,2,老师很博学很谦虚，上课也很有趣，我一个对军事不怎么感兴趣的人从头到尾认真听讲。老师人很好，给复习资料讲考试注意事项。
74015,1021,吕强,2018-02-04 07:10:15,-3,0,3,。。。
74252,1021,吕强,2018-02-08 03:45:14,-1,1,2,很棒！
74708,1021,吕强,2018-03-05 08:34:19,3,3,0,刚刚上完一节课，老师声音好好听啊，而且老师本人超有见解，听课真的好享受。另外，我觉得我要花一天的时间把老师收藏的资料搬进我的U盘(´▽｀)ノ♪
75483,1021,吕强,2018-03-12 10:29:51,-1,0,1,男神哇
75500,1021,吕强,2018-03-12 13:12:38,0,0,0,爽就一个字
76366,1021,吕强,2018-04-04 14:18:32,1,1,0,还不错
76818,1021,吕强,2018-07-10 13:32:29,18,21,3,桃李不言，下自成蹊。
77374,1021,吕强,2018-05-05 06:35:28,-1,0,1,通识课4.2
77968,1021,吕强,2018-05-09 04:10:38,0,2,2,一般般
79190,1021,吕强,2018-05-26 13:11:29,1,2,1,我！永远！爱！吕老师！！！
79776,1021,吕强,2018-06-13 12:30:19,1,2,1,男神！男神！
80403,1021,吕强,2018-07-26 07:04:09,4,6,2,长得好好看！（bushi）课讲得不错，做事给分都有规矩条理，总之值得一选！
80692,1021,吕强,2018-09-16 23:45:20,3,5,2,终于选上了qwq
80853,1021,吕强,2018-07-02 04:56:27,-1,0,1,男神！！男神！！
81001,1021,吕强,2018-07-03 09:04:22,1,2,1,婉君求问
81536,1021,吕强,2018-07-10 16:10:35,5,5,0,绝对男神，平易近人，爱发红包，万军威武
81758,1021,吕强,2018-07-06 05:56:06,4,5,1,考完试立刻给老师十分！老师认真的很帅而且很好啊，来了我们考场好几次，考前也各种叮嘱，是真的好老师啊?讲课也特别生动，期末什么也不用买，打印老师的资料就特别足够了！总之老师真的让我钦佩和感谢~\n\nps.qq群里红包一次也没抢到...求绩点?
81938,1021,吕强,2018-07-06 13:56:34,-1,1,2,宝贝宝贝
83092,1021,吕强,2018-07-09 15:57:02,0,0,0,10分不多说
83348,1021,吕强,2018-07-10 07:15:59,2,3,1,男神男神！(只能跑到这里来放肆了\n\n吕老师超好的~讲课有条理有内容有趣！资料特别有用！还有就是真的很暖^O^关心学生！反正就…各方面都好 选到赚到~选不到补选赚到
83349,1021,吕强,2018-07-10 07:16:12,-1,0,1,老师真的很好很好很好！砸锅卖铁地推荐！
83352,1021,吕强,2018-07-10 07:21:26,0,0,0,真的很不错 绩点也太好了
83353,1021,吕强,2018-07-10 07:21:29,1,1,0,男神！人帅给分还好！
83358,1021,吕强,2018-07-10 07:25:38,0,2,2,军理课上得很有趣虽然我都水过去了。期末重点划得超级好资料超级全！！出分前评价的不知道给分怎么样~！
83374,1021,吕强,2018-07-10 07:38:00,2,4,2,老师真的真的太可爱了还不让我们叫男神但是真的好可爱啊表白老师
83384,1021,吕强,2018-07-10 07:47:15,5,6,1,老师人很好的，非常为同学考虑。像会为了统一因为考试难度不同的不同课程时间的同学们的成绩（秋冬，春夏），会调整平时分，让成绩合理波动。上课也很有意思的，虽然自己有时候因为不了解会听不懂。而且当时是补选选上的，只是发了个邮件给老师。因为自己一开始不懂补选流程，后来知道了才发现老师帮我省去了好多好多麻烦的流程！无论成绩都要谢谢老师的！
83386,1021,吕强,2018-07-10 07:50:48,6,6,0,老师上课内容很充实，干货很多，看得出来老师博学又认真。整个学期要求交一篇期中小论文，期末考试开卷客观题，有一定难度。最后给分不错，感到很惊喜，总体体验很好，感谢老师！
83391,1021,吕强,2018-07-10 07:56:20,5,6,1,嗯，很好的老师，很有学生缘，没有代沟，真的是很好了(●°u°●)​ 」  男神
83418,1021,吕强,2018-07-10 08:47:43,1,2,1,我爱男神！太好啦！！！
83458,1021,吕强,2018-07-10 10:14:51,-1,2,3,男神，我只说一遍，不容置疑！
83566,1021,吕强,2018-07-10 15:17:26,1,2,1,上男神的课是一种怎么样的体验？当然是婉君群，干货多和绩点++啊～
83583,1021,吕强,2018-07-10 15:56:10,2,3,1,不仅是帅，是人格魅力！不仅是发红包，是群里活跃的身影！为学生考虑的同时，给分公正！
83595,1021,吕强,2018-07-10 17:50:03,2,3,1,我带了微积分，大物作业去上军理，然后两节课下来，基本没进度。。老师和我们分享很多，感觉课上收获很大。考前万军群里有问必答，很负责的一位老师！给我们的军理提纲，让我考试翻书速度倍增，最后也得到了满意的绩点！
83720,1021,吕强,2018-07-11 05:34:11,2,2,0,男神！！！
83839,1021,吕强,2018-07-11 09:48:13,3,5,2,男神啊啊啊啊啊，但是强烈建议军理考试之前至少把书大致翻一遍，翻书比赛名不虚传
83887,1021,吕强,2018-07-11 12:30:13,7,8,1,超级帅超级好！老师在群里发红包至少发了一千吧，每次节日都会发 考前加油 考后也发 超级无敌好了 虽然我一次都没抢到 很令人心痛 但是真的很好！我爱男神！
84507,1021,吕强,2018-07-13 04:22:21,1,2,1,虽然没考好 但还是要给10分
85344,1021,吕强,2018-07-17 06:33:00,14,15,1,qq群里水群还卖萌，不允许叫他男神，叫一次平时分ー1，我笑死
86250,1021,吕强,2018-09-11 13:35:54,-1,0,1,非常好
86348,1021,吕强,2018-09-13 23:33:49,0,0,0,老师真的炒鸡棒了！
86677,1021,吕强,2018-09-18 02:27:55,0,1,1,好！很好！
86863,1021,吕强,2018-09-19 06:19:43,2,2,0,是不是！（si不si！）
86870,1021,吕强,2018-09-19 06:34:19,-1,2,3,听了一个多小时，好！
86927,1021,吕强,2018-09-19 11:47:20,0,0,0,听着很吓人
87237,1021,吕强,2018-09-26 03:25:05,1,1,0,讲的好
87392,1021,吕强,2018-09-28 03:18:13,1,1,0,挺不错的了
87838,1021,吕强,2018-10-15 10:05:05,3,3,0,会帮没选上课的同学去找选课老师帮选上，节日在群里发红包！真男神！
89009,1021,吕强,2018-11-13 23:40:59,-1,1,2,老师太棒了
89194,1021,吕强,2018-11-16 14:41:07,0,1,1,大爱吕老师o(^o^)o
89780,1021,吕强,2018-11-20 22:50:41,3,5,2,其实老师很好...只是要求好高 给分真的....好低啊……
89782,1021,吕强,2018-11-20 23:34:29,1,1,0,学到很多东西（老师手头东西真的多…）最后课程论文写得确实不行，老师给的分数感觉非常合理，符合自己的水平吧。非常感谢老师，甚至还想上他的军理课?
89784,1021,吕强,2018-11-20 23:55:24,0,1,1,完美！
89785,1021,吕强,2018-11-21 00:01:51,2,3,1,超级超级好的老师……\n\n好到上完他的课 觉得其他很多通识课的老师都远远比不上他……
89787,1021,吕强,2018-11-21 00:18:04,4,6,2,老师讲的都很有用。而且老师很亲民，很和蔼，在群里也很俏皮。而且他的课不是水课，老师要求很高的，很棒的老师
89841,1021,吕强,2018-11-21 03:48:38,6,8,2,超级棒！虽然没有军理基础但是老师还是很认真的和大一同学分享了很多资料，上课也很认真（虽然有时候会放一些不知道哪里弄到的很鬼畜的图片完全不敢看quq），第一次写论文，给分超乎我的预料了.....给男神比心。平时还会经常在群里和大家一起皮(๑>؂<๑）  还有不得不提的超大红包！！！（总是错亿orz）   现在就希望能选上男神的军理！！！
89855,1021,吕强,2018-11-21 04:44:32,0,2,2,太舒服了
89879,1021,吕强,2018-11-21 06:31:33,3,5,2,啊啊啊，我男神啊~会在收获史高绩点后突然散群(ㄒoㄒ) 留下你独自想念老师\n\n总之与老师同姓真的超幸运，会继续选军理课的~\n\n
89960,1021,吕强,2018-11-21 11:35:53,8,9,1,老师经常会在群里发红包哈哈 给的论文模板很实用
89973,1021,吕强,2018-11-21 12:08:11,0,2,2,老师给分可太好了\n\n老师人超好
90477,1021,吕强,2018-11-23 15:30:23,4,8,4,男神讲课特别有趣，每节课课前都会给我们看真实的史料（开门，查水表）。虽然对这门课不是特别感兴趣但是确实学到了很多。然后男神对我们特别关心，也非常好相处，可惜错过了跟男神毅行的机会（毅行也太难报到名了吧）
90851,1021,吕强,2018-11-26 14:49:29,-14,8,22,不怎样
91392,1021,吕强,2018-12-08 00:54:27,4,4,0,海星，人很帅
91538,1021,吕强,2018-12-13 01:37:41,1,1,0,男神！
91698,1021,吕强,2018-12-18 04:31:06,2,2,0,虽然我基本不听? 但老师讲的还是很好的
93292,1021,吕强,2019-01-09 01:17:13,3,3,0,10分
93529,1021,吕强,2019-01-10 07:47:47,6,6,0,老师太棒了！！！期末考试还会给资料（学姐总结的目录，精简ppt等等），对军事非常热爱，而且“这样子”的口头禅很有趣～
93610,1021,吕强,2019-01-11 02:31:12,-1,3,4,战技课是我这学期来上过的最有趣的通识课，可惜只有短学期啊啊啊。虽然是第一次写论文，连引用标记都没做，但老师还是给了4.8。超怀念那段天天盼望上男神课的时光！
95949,1021,吕强,2019-01-20 09:10:46,0,0,0,就很有意思啊！！！
96164,1021,吕强,2019-01-20 13:48:15,0,0,0,小测没去但是拿到了比预期高上不少的分数，感谢老师
96230,1021,吕强,2019-01-20 14:44:41,1,1,0,老师真的完美！！
96268,1021,吕强,2019-01-20 15:44:48,-1,0,1,老师男神！
96277,1021,吕强,2019-01-20 16:02:11,0,0,0,出分了 来给老师打个满分?
96291,1021,吕强,2019-01-20 16:32:38,0,0,0,老师人超好！讲课干货很多！考前会带着划重点！给分也超好！
96295,1021,吕强,2019-01-20 16:50:47,2,2,0,很棒了，给分也超好，不管是真正想学习军事理论只是还是水一水（x）都是极好的
96322,1021,吕强,2019-01-21 00:00:36,-1,0,1,对不起男神 成绩出来完全是我自己的错?
96352,1021,吕强,2019-01-21 01:03:32,-1,0,1,男神！讲课超棒，给分也超好！心目中的满分老师！
96362,1021,吕强,2019-01-21 01:13:21,0,0,0,非常赞
97033,1021,吕强,2019-01-21 15:06:48,0,0,0,妙啊啊
97122,1021,吕强,2019-01-21 16:35:12,7,9,2,听老师的课真的有种凤凰卫视评论员讲话的感觉哈哈哈哈
97315,1021,吕强,2019-01-22 08:03:48,5,6,1,吕老师的存在让我对浙大充满希望
97440,1021,吕强,2019-01-22 09:00:42,0,2,2,?男神，英语口语也超级棒的
98592,1021,吕强,2019-01-23 15:26:57,-1,2,3,老师很好，给分也好\n\n平时在群里还有期末划重点的时候都是稳中带皮hhhhh
98887,1021,吕强,2019-01-24 04:33:24,0,0,0,老师人超好
99828,1021,吕强,2019-01-25 08:08:22,0,5,5,老师讲的自然是很好的。。但给分还是成迷吧，大家都是翻书找答案结果还是截然不同的。。。还是强推！
100251,1021,吕强,2019-01-26 00:55:18,1,1,0,男神老师\n\n
102201,1021,吕强,2019-01-31 10:43:10,-1,1,2,人好啊啊啊啊啊啊，写论文格式不确定可以问，期末例题不会做可以问，给的资料爆炸全，虽然上课没有好好听，但是我有认真舔老师的颜hhhhhhh
102856,1021,吕强,2019-02-24 08:43:52,0,2,2,平时可以不上课 要点到会事先提醒 最后通览全书分数不会差的（关键是吕强老师人真的很nice 在群里也蛮活跃的哈哈哈
102867,1021,吕强,2019-02-24 12:40:23,0,1,1,老师超帅，知识渊博，必须10分
103137,1021,吕强,2019-02-26 06:29:18,1,2,1,好老师。
103177,1021,吕强,2019-02-26 11:43:34,-1,0,1,很牛逼
103229,1021,吕强,2019-02-27 02:27:43,0,2,2,男神！男神！男神！\n\n外加死肥军宅很能体会到自己存在感的地方(逃
103386,1021,吕强,2019-02-28 01:07:32,0,2,2,老师讲的特别好 对学生特别好 QQ上会及时回复 给的材料特别好用 最后给分也特别好！
103706,1021,吕强,2019-03-04 10:49:46,2,2,0,nice
103837,1021,吕强,2019-03-06 07:35:10,-1,1,2,干货满满，感觉老师对时事的点评很精彩，也特别喜欢听，牛！！
103893,1021,吕强,2019-03-07 04:17:17,1,3,2,选到老师的课是我进入zju第一件幸事。
104458,1021,吕强,2019-03-21 02:57:37,0,0,0,不催啊
105163,1021,吕强,2019-04-05 12:20:50,0,1,1,帅\n\n给分好\n\n10分送上
105194,1021,吕强,2019-04-07 10:00:24,0,1,1,人真好
105549,1021,吕强,2019-04-16 12:45:09,6,6,0,真的收获很大，虽然战技课的事情还是比较多的，但是最后结课的时候相当舍不得
105551,1021,吕强,2019-04-16 13:31:42,33,33,0,战技最后一堂课，时值巴黎圣母院被烧。\n\n一句“我们不能忘记历史，但不能永远活在历史中。”成为对该事件最好的回答，鄙人也将永远铭记在心。
105588,1021,吕强,2019-04-17 02:30:41,5,5,0,很好，优秀
105616,1021,吕强,2019-04-17 09:50:17,0,2,2,完美的老师
106007,1021,吕强,2019-04-24 08:19:12,7,8,1,就冲敢讲一些敏感的东西这股勇气就要给十分
106036,1021,吕强,2019-05-04 23:05:16,15,17,2,对军理课感兴趣的同学一定要选，不感兴趣的同学慎重，你会正太到哭泣，呜呜
107014,1021,吕强,2019-04-30 20:37:06,4,5,1,给分好
107015,1021,吕强,2019-04-30 23:31:43,2,10,8,大爱男神吕强老师，已经经历了被一大堆通识课正态的我，一大早看到4.8的绩点，重拾了我对通识课的信心，老师上课干货满满，循循善诱，特别是他那充满磁性的声音，爱了爱了，这样的好老师，怎一个10分了得
107402,1021,吕强,2019-05-05 01:53:12,13,15,2,军迷速选，对军事不感兴趣的慎选
109371,1021,吕强,2019-06-13 11:48:44,1,2,1,爽就完事了！
111172,1021,吕强,2019-06-30 08:49:08,2,3,1,哈哈哈哈
111982,1021,吕强,2019-07-03 05:47:14,1,1,0,cool
112149,1021,吕强,2019-07-03 17:38:38,2,2,0,感谢男神！！！
112162,1021,吕强,2019-07-03 18:06:41,3,4,1,男神不解释
112331,1021,吕强,2019-07-04 01:52:57,1,2,1,真的很棒
113422,1021,吕强,2019-07-06 17:14:12,0,2,2,吕老师的课我都是补选上的，感觉自己非常幸运。吕老师的课上不论是知识点还是观点都能给人很大的启发，能让我们了解军事同时正视战争。老师的视频资源简直宝藏，在军理群里和同学们的互动也很有趣，永远的男神！
113989,1021,吕强,2019-07-08 06:22:55,3,3,0,男神！
114560,1021,吕强,2019-07-10 16:53:24,3,4,1,个人魅力十足，上课内容讲的清楚明白有幽默感，之外还启发自由思想，最后满绩完美。
114773,1021,吕强,2019-07-11 13:24:56,2,4,2,对学生是真的好哇，我交错迟交了论文，老师就一句没事，让我不要担心，面对着几百位学生还能处事如此细致，实在佩服
114986,1021,吕强,2019-07-13 18:26:25,0,2,2,男神，好老师，打10分
115285,1021,吕强,2019-07-17 20:22:45,-1,1,2,我永远喜欢吕强老师
115901,1021,吕强,2019-08-25 04:13:39,0,1,1,颜值还是很重要的哈
116193,1021,吕强,2019-09-06 02:29:01,-2,0,2,舒服了
116442,1021,吕强,2019-09-10 13:30:08,1,2,1,最神奇的课程群
116761,1021,吕强,2019-09-15 08:34:42,1,2,1,老师讲的太好了 中秋节还会在群里发红包！！
116899,1021,吕强,2019-09-17 06:03:54,0,1,1,嗯？  牛逼
116925,1021,吕强,2019-09-17 10:24:47,-1,0,1,很好很好
116930,1021,吕强,2019-09-17 10:55:48,-1,0,1,反对鹅颈 良心老师
116932,1021,吕强,2019-09-17 11:17:38,4,5,1,要求写论文\n\n不喜欢军事还是有点无聊\n\n然后 老师为啥讲这么多“这样子” 让人有点听到绝望\n\n还是给十分
117857,1021,吕强,2019-10-06 06:28:58,2,4,2,万能军理群，老师还发红包，呜呜\n\n
118190,1021,吕强,2019-10-22 11:15:07,0,1,1,好喔喔
118385,1021,吕强,2019-10-26 06:54:07,-2,0,2,好好好好好
118765,1021,吕强,2019-10-31 14:40:06,0,1,1,老师的课真的超级好！老师也很好啊，跟学生打成一片
118889,1021,吕强,2019-11-07 11:31:48,3,5,2,尽管每次讨论题我都查不到，上课也有点陌生，毕竟我对这方面不了解，但！！老师真的超好！！！！！
119240,1021,吕强,2019-11-11 15:01:27,0,2,2,真男人！行走于远方山河的好老师！
119381,1021,吕强,2019-11-12 12:46:21,-1,0,1,非常崇拜
119713,1021,吕强,2019-11-15 23:33:18,-1,2,3,我靠我过4了！！！爸爸！吕爸爸！！
119777,1021,吕强,2019-11-15 22:35:17,2,4,2,感谢吕爸爸！最后给了划水的我4.5！
119781,1021,吕强,2019-11-15 23:38:17,-1,1,2,还有什么好说的，给分这么好，上课也非常好
119787,1021,吕强,2019-11-16 00:09:55,0,2,2,老师超棒！！！
119788,1021,吕强,2019-11-16 00:15:07,1,2,1,上课有趣，人长得帅，给分不错，强力推荐
119790,1021,吕强,2019-11-16 00:21:50,0,1,1,挺好的，是我对这方面不够了解
119851,1021,吕强,2019-11-16 06:56:35,0,1,1,老师讲得很开心，可以看出来老师是真的很喜欢相关领域，于是我们听的也很愉悦哈哈哈哈哈
120079,1021,吕强,2019-11-17 10:43:22,0,1,1,好！\n\n
120306,1021,吕强,2019-11-28 01:53:30,-2,2,4,干货满满！（虽然我很多都懂）
120395,1021,吕强,2019-12-03 06:39:43,2,4,2,每次上课都像是在推销武器哈哈哈哈 老师讲得很好
120500,1021,吕强,2019-12-09 09:53:21,-2,1,3,每节课的讨论题*0.5+论文*0.5=最终分数。只要稍稍认真完成那绩点就很高了。老师讲课真的很好，爱了爱了。
120997,1021,吕强,2020-01-19 08:19:52,1,2,1,老师超帅！
121192,1021,吕强,2020-01-20 09:35:03,-2,1,3,非常标准的英语
121246,1021,吕强,2019-12-25 15:25:17,-1,1,2,真的好！
121384,1021,吕强,2019-12-16 12:31:31,-1,1,2,怎么会有这么好的老师啊呜呜呜我疯了我可以谁不可以大家都可以没有人不可以
121388,1021,吕强,2019-12-16 11:53:56,0,2,2,第一节课就让我感觉到，瞎摸摸了节好课
121578,1021,吕强,2019-12-12 11:01:06,-3,0,3,炒鸡棒
121665,1021,吕强,2019-12-09 09:53:21,-1,2,3,每节课的讨论题*0.5+论文*0.5=最终分数。只要稍稍认真完成那绩点就很高了。老师讲课真的很好，爱了爱了。
121797,1021,吕强,2020-01-22 02:45:23,0,3,3,没啥好说的，吕强当然10分
122767,1021,吕强,2020-04-01 13:27:47,8,15,7,可惜和老师政治观点不合，太遗憾了
123196,1021,吕强,2020-05-19 01:08:07,2,4,2,怪我咯
123827,1021,吕强,2020-06-15 00:50:52,3,5,2,老师是挺认真负责的，但是如果对战争和武器不感兴趣的话不建议选现代战争与国防技术
124011,1021,吕强,2020-06-20 06:03:45,1,3,2,军事领域专家，好老师，声音也很好听，认真的话绩点不会很差
125503,1021,吕强,2020-09-10 15:02:35,3,4,1,。。。
126488,1021,吕强,2020-09-28 07:48:20,0,2,2,一般般
129783,1021,吕强,2021-01-12 09:37:49,2,3,1,事少分高 老师水平还高 i了i了
130460,1021,吕强,2021-01-22 14:46:21,0,3,3,真的很不错
131200,1021,吕强,2021-01-26 13:23:33,-1,2,3,好极了！
131258,1021,吕强,2021-01-27 00:52:02,-90,5,95,就冲我一学期没听课，期中两天写论文，最后4.5，给你10分
131360,1021,吕强,2021-01-27 07:48:43,2,3,1,很不错～
132581,1021,吕强,2021-02-02 12:18:54,-57,5,62,吕老师，永远滴神，军理满绩选手在此
133407,1021,吕强,2021-02-27 10:06:14,1,2,1,男神！！！
133639,1021,吕强,2021-03-03 05:29:19,0,2,2,好呀的
133740,1021,吕强,2021-03-04 10:37:12,-2,1,3,好老师啊
134002,1021,吕强,2021-03-11 14:35:08,0,2,2,好老师，给分好，而且平时讲课内容很好，认真听收获很多
135285,1021,吕强,2021-05-07 14:13:19,-1,2,3,别的不多说，选！
135748,1021,吕强,2021-05-23 07:27:18,-1,3,4,真的很棒
138751,1021,吕强,2021-07-10 16:13:20,2,6,4,没什么……是我太菜了吧，2天复习付诸东流。\n\n10分
138754,1021,吕强,2021-07-10 16:31:19,1,3,2,还不错
138788,1021,吕强,2021-07-11 00:50:53,-5,4,9,lq is my father!
138793,1021,吕强,2021-07-11 01:06:38,-1,2,3,10分
138819,1021,吕强,2021-07-11 04:40:07,0,3,3,强哥课很好！给分也不错！
139142,1021,吕强,2021-07-13 03:56:20,-2,1,3,啊啊啊！
139978,1021,吕强,2021-08-22 16:43:31,2,9,7,很认真在听课，重点都有勾画。期末考也尽全力了，4.8很满意也很感谢老师。
141115,1021,吕强,2021-09-24 01:47:40,9,11,2,并不认同老师的政治观点，但是可以看出老师确实很博学，阅历丰富，我选择批判接收，冲这一点我给老师打十分。
142830,1021,吕强,2021-11-16 15:56:57,0,1,1,给分很好！
142911,1021,吕强,2021-11-17 09:59:55,-1,1,2,长得帅
143661,1021,吕强,2021-11-30 15:02:02,-2,14,16,别的不说，论文真的不好写而且要求非常非常非常非常多！！另外，阿富汗战争的由来、阿富汗战争的特点这种题目是一篇几千字的论文能写的出来的吗...
143753,1021,吕强,2021-12-04 13:00:42,18,24,6,直率敢言，追崇真理。在当前政治形势日趋保守的社会环境下能遇到这样依然敢说敢做的老师实在是太可贵了…
143899,1021,吕强,2021-12-11 09:48:46,3,6,3,好老师，（づ￣3￣）づ╭❤～
144264,1021,吕强,2021-12-21 03:37:13,0,2,2,军理讲课有趣，值得一听
145634,1021,吕强,2021-12-31 01:09:28,-1,2,3,好有意思的老师
145675,1021,吕强,2021-12-31 05:27:14,0,3,3,授课有趣有见解，对学生很好，温柔亲和。考试前对大家的复习嘱咐也很多，必选！！！！
147856,1021,吕强,2022-01-11 04:16:53,-2,3,5,好老师！
147864,1021,吕强,2022-01-11 04:34:17,5,8,3,我爱吕强老师，他真的好好！中秋和元旦都在群里发红包，考试前有复习课还给重点。考试那天早上打电话问问题怕打扰到他，他很耐心地给我讲解，最后还说“没事的”~\n\n大学以来最有内容的思政课了。大家不要犹豫，选他！！！
147874,1021,吕强,2022-01-11 06:11:09,-4,10,14,老师很帅，论文查重，给分杀人，如果追求水+高分，就算了
147927,1021,吕强,2022-01-11 07:19:49,-1,1,2,好老师！上课有意思，解答巨耐心，对人很友善，给分超级赞！
147931,1021,吕强,2022-01-11 07:32:11,-1,1,2,不说了，10分，吕强老师就是强
148004,1021,吕强,2022-01-11 09:52:16,3,6,3,军理挂科，但是老师讲得太好了，还是心甘情愿地给个满分
148347,1021,吕强,2022-01-12 07:55:19,-3,1,4,我超\n\n給分超好
149063,1021,吕强,2022-01-14 09:27:37,-2,1,3,超棒的老师！
149148,1021,吕强,2022-01-14 14:09:51,0,2,2,～～～
149239,1021,吕强,2022-01-15 00:43:57,-2,2,4,我爱吕强！！！
149950,1021,吕强,2022-01-18 03:23:51,4,7,3,有思想的老师，课下碰到会笑着和你打招呼，给分很好
150024,1021,吕强,2022-01-18 11:01:05,1,3,2,3个字喔~
151412,1021,吕强,2022-03-03 01:05:00,0,2,2,好好好
151897,1021,吕强,2022-03-19 16:35:17,9,14,5,①老师喜欢百事可乐\n\n②老师硬盘里大约1.6T的资料，从下午三点开始传到自己的硬盘上，在熄灯之前可以传完。DVD文件用老师硬盘里的software
152065,1021,吕强,2022-03-25 00:58:07,25,45,20,不是很认同老师的一些历史和政治观点
152376,1021,吕强,2022-04-07 06:05:42,19,39,20,感觉老师对俄罗斯有点偏见...
152384,1021,吕强,2022-04-07 11:30:34,16,35,19,通识课，感觉没有评论的那么好\n\n讲课不那么客观，比较亲西方
152385,1021,吕强,2022-04-07 12:01:39,-13,30,43,三观极正\n\n用事实说话 用证据说话\n\n不囿于意识形态设定的条条框框\n\n屹立于混沌的时代中\n\n不被浊流席卷\n\n一个大写的人\n\n浙大教师学子当如此。\n\n有此般良师，恐怕竺老若泉下有知也会倍感欣慰。
152397,1021,吕强,2022-04-08 00:19:54,9,48,39,极端亲美亲西方，有些政治历史观点令人震惊甚至震怒，完全站在西方立场和视角考虑问题，参考资料大都来自西方网站，并奉为圭臬，认为经济利益大于国家安全，认为中国应当弃俄亲美，否认中华文明5000年历史…真不知道为什么思政老师会有这种思想和说辞？
152499,1021,吕强,2022-04-13 08:34:24,-19,16,35,讲求事实，爱国情怀浓厚感人肺腑，很踏实的一位老师。
152566,1021,吕强,2022-04-14 17:15:52,15,43,28,对中国上百架四代机和两百万陆军完全没有信心，对单兵云爆弹和高超音速弹道导弹闭口不提，对发展了几十年的雷达部队和电子战部队完全不造，我相信吕老师非常适合在30年前南联盟大使馆被炸的时候给国内的学生上军理课\n\n关于立场问题，有些时候我不是无底线亲俄，而是在当今世界，别无选择
152647,1021,吕强,2022-04-17 10:13:34,-18,20,38,楼上你就是个懂王，你说别无选择就是别无选择吧，大学就是大家畅所欲言，你这种人适合到六七十年代当红卫兵
152683,1021,吕强,2022-04-18 08:34:22,22,37,15,楼上那两个我都看不懂\n\n一边说是分享观点一边又给人扣帽子，这不就是比烂吗\n\n除了吕老师观点比较诡异之外，总的来说人还是很好的
152822,1021,吕强,2022-04-20 07:30:17,6,44,38,吕强老师是一名不错的老师，但是在课堂上表达的很多观点令人极其失望。\n\n每个人都有每个人的观点，这是合理的。但是作为老师，他在课堂上的每一句话都具有了教育的含义，都在无形之中灌输着他的个人观点，这是必然的，也是他必须认识到的。因此，在课堂上，他的言论极为不合时宜。\n\n\n\n在课上声称“同学们也可以有自己的想法”，一边诱导学生接受、认同自己的观点。\n\n公然对我国严肃的外交态度立场进行荒谬的指责，甚至辅以“北约批评我们”“我们要有道德”等可笑言论予以佐证。我不知道他这些话是否对得起受到西方制裁的维吾尔同胞——基于谎言的制裁。\n\n歪曲我国外交立场，甚至有些自以为是地从西方的道德方面提出“合理”的外交态度，而非基于我国利益来考虑。他可能把自己当成了乌克兰人吧。\n\n\n\n他可以有这些看法。但是他是老师，他就不能像这样不负责任地肆意发泄。如果一个老师在公开场合对学生屡次发表这样言论，那么他就不再适合走上讲台，就是一个不合格的老师
152931,1021,吕强,2022-04-22 02:19:11,11,28,17,个人觉得老师是军事专家 从军事角度论述一些东西可能无可厚非 但一些政治观点只能说有待商榷吧。。
152973,1021,吕强,2022-04-23 00:38:58,182,219,37,"大四老学长看了评论深感震惊，深感墙内自媒体和俄新社洗脑之深。这次俄乌联大投票141国反对俄罗斯，4国支持，35国弃权。中国弃权，足以说明问题。各国主权领土完整都应该得到维护，联合国宪章宗旨和原则都应该得到遵循，各国合理关切都应该得到重视，当务之急是劝和促谈。\n\n粉红乌拉们口口声声""国家利益""，殊不知""以经济建设为中心""才是最大的利益。你不能否认的是，经济发展和民生改善是执政党最重要的合法性来源。如果哪一天我们放弃了这一点，随时可能会面临灾难，这绝不是危言耸听。如果这次我们也和叙利亚朝鲜厄立特里亚白俄这4国一样和俄捆绑，你们可知道今年本来就因疫情和周期性冲击下极为困难的经济会有多惨？现在的稳就业，稳民生，市场化改革和稳外资稳外贸有多难？""需求收缩，供给冲击，预期转弱""三重压力叠加，我们应该怎么做？我们应该变成领导层无法依法有序更替，普京一个人执政23年，日益变成个人独裁，一片吹吹拍拍之风，民族主义和对外军事优先于经济，十年大停滞的第二个俄罗斯吗？改革开放何去何从？建议去读读刘鹤总理的《两次全球大危机的比较研究》。\n\n我希望大一的学弟学妹多看不同来源的新闻，保持独立思考。另外，你可以认为普京发动战争有合理性，有北约拱火的因素。但请包容老师的不同观点。在墙内喊打喊杀的乌拉不会被屏蔽，反倒是反战的频频被封杀。现在的舆论环境已经导致深层次的经济改革越来越难，越来越一元思维和一刀切，思想越来越僵化，这是我多次社会实践和接触不同部门以后的真实感受。这两年举报老师的事情已经够多了，不赞同普京的方式就是不爱国，这种帽子谁也受不了。如果你以这样的方式斗别人，迟早有一天你也会被更极端的方式斗倒，最终社会越来越撕裂。不希望这种悲剧越来越多。\n\n这次俄乌战争最终历史怎么定论，我觉得2036/2037年左右的时候，大家可能会有更清晰的认识\n\n肺腑之言，不妥之处请谅解。"
152977,1021,吕强,2022-05-17 05:01:42,-11,50,61,支持楼上观点，一个经济、民生、创新、社会、科教、抗疫都毫无建树，躺在石油上面吃老本，靠对外扩张转移国内经济社会矛盾，几乎把邻国入侵个遍的政权能有什么好下场？这次瑞士、新加坡都旗帜鲜明制裁俄罗斯，140多国支持乌克兰，4个独裁、终身制国家支持俄罗斯。现在哈萨克斯坦都开启民主化、市场化转型了。世界已变，自由开放、公平竞争的浪潮是任何人都挡不住的，看错大趋势要倒大霉！何况普和他的同僚们已经70岁了，俄罗斯终将重回欧洲。\n\n附本次国际社会193国仅有的“挺俄4国”背景：\n\n叙利亚：阿萨德家族父子相传，执政时间累计已达52年，按现有制度总共预计达60年以上（到2035年）\n\n白俄罗斯：卢卡申科本人执政已达28年，按现有规定可执政到2035年，被称为“欧洲最后的独裁者”\n\n朝鲜：金家祖孙三代执政累计已达74年，按现有规定父子相传，“白头山纯血统”终身执政\n\n厄立特里亚：自独立以来只有一个总统，阿费沃基已经执政29年，计划终身执政，被称为“非洲小朝鲜”\n\n你支持独裁，你怎么不移民这4个国家？
152989,1021,吕强,2022-04-23 08:36:28,12,26,14,那位说我的，建议去查查91年前后苏联国有资产流失情况
152992,1021,吕强,2022-04-24 09:39:02,0,30,30,那位说putin有能力的，自己去查俄罗斯过去十年人均GDP的变化\n\n不相信独裁和个人崇拜是未来的潮流\n\n普最大的敌人是他的年龄。讲的难听一点，他能有勃列日涅夫的下场都是走运，弄不好变成萨达姆卡扎菲齐奥塞斯库
152995,1021,吕强,2022-04-23 09:15:49,7,25,18,楼上定义普京是所谓的独裁还是所谓的个人崇拜，跟我一点关系都没有。每个人都有自己的立场的自由，不管是支持普京还是反对普京，都有自己的一套理论与社会观作为出发点，这一套体系一旦建立，除非是遇到了实践上重大的挫折，否则是不会改变的，因此我也不会寻求在网络上隔着个匿名的屏障说服异见者。\n\n\n\n\n\n我只说说我的观点，现在战争的结果是美国准备取消对中国进口税，欧洲大陆各种奇奇怪怪的言论满天飞（ps:洗澡只洗四个地方？WTF？pps:这不是主流，但是有很多德国人批评朔尔茨没能阻止能源危机是真的）以及全球范围内的通货膨胀，不管这些消息真假与夸张程度，这一轮能源危机和粮食危机在这里叠buff的初期结果已经显现出来了。中国是不缺粮食的，但是相对缺能源（人均层面），如果非得划线站队，大概率去俄罗斯那边。而且联合国那个决议，有用吗，无非是跟俄罗斯划清界限而已，要是真的都反对俄罗斯，你信不信开会的就不是联合国大会而是联合国安理会了，安理会是可以授权出兵的，哪怕是走个过场，安理会也更能说明立场，更别提布恰事件之后的人权理事会投票了，中国可是直接反对了的\n\n\n\n(过了800字，NMD）
152996,1021,吕强,2022-04-23 09:17:51,8,26,18,（接上，头次打那么多字）\n\n而且就实际作为来说，中国可以说是比中立国还中立国的存在，这样子可以两头赚好处为什么非得划线？就像你要跟别人谈，本来还想理解一下你的逻辑，来补全自己思维的漏洞；但是一谈战争就给支持俄罗斯的人扣fascism的屎盆子，这怎么谈？真当大学里面人均孔老三啊，没给你以怨报怨就算不错了。\n\n\n\n\n\n说回独裁和个人崇拜，可以去英推和繁推上看看，对某人的批评可比普京常见的多了，言辞还更剧烈，我第一次看的也是难受的不行。但是后来我想通了，因为专制还是民主都只是用来协调的手段，区别就是决策变量收到谁的影响更多，谁的影响更少，以及结果是最大化了社会利益还是最大化了某些人的利益；那些把独裁和民主当宗教来崇拜的人，不是傻就是傻。\n\n有空可以从反对者的角度出发，理解自己的短板，可以一声不吭地改掉。但是如果做出了一些让人惊世骇俗的操作，也要有做好收到激烈批评的准备\n\n一字不讲老师，字字都讲老师
152997,1021,吕强,2022-04-23 09:30:22,4,24,20,我真是服了，美国不让中国人市场竞争买到先进技术，不卖7nm光刻机，不让台积电给我们做先进芯片，有些人讲都不讲突然上海疫情来了，他不光不关心上海的人权，还一边关心维吾尔族的人衩，一边把两千多的神药连美国人都不卖光卖给中国人（想反驳的可以去找个得过新冠的美国朋友问问），怎么可能让我们放心跟美国经济对接.\n\n换句话说，如果俄罗斯明天支持某岛独立并且把皓石导弹卖给tw当局，声称维吾尔族遭受种族灭绝，还让中国边境陈兵百万，试射导弹的时候还不忘修几个雷达布两个核弹，你信不信明天该死的putin和他的独裁政府都得下地狱？非得把普京和法西斯联系在一起？不说叶利钦干了啥，反倒跑来批评普京政府没能力还真是少见\n\n关于某些人，中国目前之所以没有民粹化，那是因为中国民众的右派有着对美国的不信任、左派对帝国主义的反对情绪使这两个派系能做到协调，所以能产生统一战线和政治协商会议；但是，我是说但是，如果有那些极右，罔顾政治利益与长期的经济主动权，将高端制造业转型的机会拱手送给别人的同时还在宣传所谓的自由主义，你说这些人到底是为中国好还是为了别人好呢\n\n当然 我说的是上海政府掌权的那一批共存派 请勿联想
153062,1021,吕强,2022-04-27 03:08:46,6,36,30,党章禁止任何形式的个人崇拜！\n\n对领导人的宣传要实事求是，禁止吹捧。——————十八届六中全会
153201,1021,吕强,2022-04-26 14:57:40,-17,30,47,完全亲西方，政治观念感觉很神奇，并且一个教军理的，张口闭口都是外交和政治，并且观点极具误导性，说是同学们也可以有自己的观点，但话里话外都是自己看法的正确与高傲，个人受不了
153203,1021,吕强,2022-04-26 15:08:11,22,24,2,给了9分，不是因为老师不好，而是因为评分标准\n\n课非常好 有很多私货 很多值得思考的想法\n\n人也很好 很关心学生\n\n课也可以水 几乎没有课下作业，除了讨论\n\n美中不足是评分：5*10的讨论，50分论文\n\n讨论大约不是参与就满。而是小组形式的，小组形式的话那你的命运就不取决于你自己了对吧（所以很可能会在这里掉不少分\n\n论文老师对格式的要求非常高，但这是好事，真的能学会一篇论文的写作规范。不过你满足了那写了5页的ppt的要求躲开扣分项之后你只有基础分80分\n\n加分项只有：引用充分+5，观点新颖且论述详实+20。很难拿。\n\n不知道在哪里什么时候为什么分就扣的差不多了\n\n如果你是一个军事知识充分且很感兴趣的同学，那选这个对你非常好（也就是为什么这门课均绩挺高的）。剩下的同学，emmm，你能学到很多，但是绩点大概要受委屈了。\n\n不调分。卡绩了。呜呜
153377,1021,吕强,2022-04-28 23:51:46,19,20,1,观点有争议性，但是鼓励探讨
153461,1021,吕强,2022-04-30 11:50:21,18,24,6,老师人很不错，真的，尽管他向我们“夹带私货”的讲课，但是他也不是会完全否定不同观点，他愿意和我们心平气和的讨论。所以，就算是我和老师一些政治观点相背，我还是很喜欢他。
153768,1021,吕强,2022-05-10 12:24:56,10,21,11,是位好老师，亲切讲课好。\n\n不打10分扣两分，原因是虽然是老师人很好但对于国际外交方面观点感觉有点”幼稚”？大国外交没有永远的礼仪只有永远的利益，这句话我初中的老师就和我说过老师却拿什么仁义啊道德啊看待俄乌争端中的中俄关系。\n\n抛开观点不谈老师真的是好老师，课讲得好，就是某些课程之外的观点我真的非常不认同
153813,1021,吕强,2022-05-12 01:22:13,11,34,23,#FFC0CB依旧稳定发挥\n\n老师表达自己主观观点再正常不过，顺我者“思想深刻” ，逆我者即“夹带私货”。所谓私货为何，反对俄罗斯发动战争也能成为什么见不得人的观点了？\n\n联大141票反对票，到你这反俄成了“倒向西方”，我都不知道什么时候西方的定义都这么宽泛了。\n\n且不论观点对错或者阅历多少，觉得老师观点“幼稚”的想想自己就这场冲突而言信息来源都是些什么，我想老师所吸收的资讯与观点的全面性会比大部分人整天盯着的能把Ruassian artillery翻译成乌克兰炮击的国内媒体好得多
153893,1021,吕强,2022-05-16 02:41:49,5,26,21,有哪一个西方不喜欢的领导人不被西方说成是独裁者？西方为什么希望每个人都去讨厌独裁者？例如萨达姆，为什么他做的好事少有人知道，做的坏事却人尽皆知？资本家为什么要给安人钱？反正我就是支持独裁，没有强有力的领导人，无产阶级就是无法团结，无法团结就会搞内斗，永远会被资本家分而治之。
153894,1021,吕强,2022-05-16 02:54:09,9,24,15,一开始有人说爱国情怀感人肺腑，现在又开始说支持俄罗斯的人没有独立思考能力。我总觉得有人在洗地，因为这些手法跟推特上的机器人评论太像了
153900,1021,吕强,2022-05-16 08:20:34,10,16,6,在俄乌冲突很早之前，普京曾经说过：“美国现在已经不需要领袖了，而俄罗斯还不是一个不需要领袖的国家。”
153954,1021,吕强,2022-05-18 03:09:49,5,31,26,我现在就生活在西方说的所谓的独裁国家里，自己去看看美国国防部的报告里是怎么评价中国的，“对全球民主的严重挑战”；而且说到独裁，中东那一堆油老板哪个不是父传子子传孙，到你口里又是所谓的民主了是吗，看来你也只是嫌贫爱富嘛\n\n但是你又不说中国到底是不是个du cai国家，这让我很难说服你啊，不妨把话说明白点.jpg
153967,1021,吕强,2022-05-18 07:00:34,12,30,18,乐了，美国人支持的独裁政府还少吗，皮诺切特，蒙博托，还有沙特这个君主国，拿什么民主独裁来打标签，有意思吗
154002,1021,吕强,2022-05-18 18:16:28,1,15,14,楼下那位支持独裁老哥，封建君主制，官僚垄断资本主义和社会主义你是真的理不清还是故意说反话yygq？
154291,1021,吕强,2022-05-29 08:15:31,-1,10,11,强烈支持自由发表观点！！
154332,1021,吕强,2022-05-30 10:52:21,1,6,5,作业要求高，但课堂有干货，10分bd
154644,1021,吕强,2022-06-02 16:17:00,-1,2,3,老师真的很好
154904,1021,吕强,2022-06-06 15:40:48,6,10,4,帅老头(^з^)-☆
155261,1021,吕强,2022-06-10 02:17:59,2,6,4,点名一定要去QAQ
155866,1021,吕强,2022-06-16 10:35:03,2,7,5,老师讲课确实很好，但是平时分...是不是太低了，虽说没有花特别多时间在这上面，但每次点名都到了，论文也有尽力认真写，最后平时分按百分制才八十多分...期末考得不错结果因为平时分绩点上不了4...
156112,1021,吕强,2022-06-17 14:51:35,7,11,4,写论文可以学到一些规范之处，但给分一般
156931,1021,吕强,2022-06-21 10:55:51,-2,1,3,好老师！！！虽然课程内容听不懂 但是老师就是很有魅力
157241,1021,吕强,2022-06-22 13:27:40,4,7,3,军理 一生之痛....
157251,1021,吕强,2022-06-22 15:06:47,3,10,7,他像一个战士。十分bd
157254,1021,吕强,2022-06-22 15:13:15,-50,4,54,虽然91分卡绩，但还是要给10分呢
157467,1021,吕强,2022-06-23 10:38:50,6,10,4,早八点名全到，论文按时交，期末考也都翻到了，3.3.。。。。果然是我太菜了
157504,1021,吕强,2022-06-23 12:54:05,0,5,5,又帅又有气质捏
158130,1021,吕强,2022-06-27 06:15:19,10,14,4,课程：军事理论\n\n 打分：9/10 \n\n优点：讲课确实不错，认真听确实能收获军事知识，军迷会听得很开心吧www；老师确实长得不错（划去；期末是最后出分的老师，大概也许maybe是在努力捞人（怀抱美好希望，但个人体感没被捞起来多少。\n\n 缺点：也不能算缺点，就是老师特别喜欢美国，同时特别讨厌俄罗斯。个人推测是以前受的教育影响？（他自述大学时听VOA，中文版被禁了之后就听VOA英文）嗯……然后今年论文题二选一（俄乌战争or伊拉克战争海湾战争后军事发展）的时候说同学们如果写俄乌战争有倾向/立场也不要紧，他会公正客观地评判……就挺微妙的（bu\n\nP.S.别来锤我，我既不好感俄也不好感美，我是两个拳头打人那派（咦？
158947,1021,吕强,2022-07-03 18:20:51,25,44,19,-你这人屁股怎么歪成这样了？\n\n-他干了什么？\n\n-把俄罗斯做的事情说了出来[飙泪笑]
158967,1021,吕强,2022-07-04 04:34:24,42,52,10,针对有关老师的评论，我想说这么两点。\n\n首先是老师的观点和立场问题。老师是经历过那个时代的人，有倾向西方的观点不足为奇，但老师本人在上课时也曾说过，他支持同学们有独立思考的自由和自己的立场，老师有表达自己观点的自由，而我们也有听或不听、接受或不接受的自由，老师并没有强迫每个人接受他的观点（虽然他的观点是带一定倾向性和引导性的）。因此没必要苛责老师。兼听则明，偏信则暗，有时听一听不一样的声音也有助于我们形成更加全面客观的认识（当然还是要建立在明辨是非和独立思考的基础上的）。\n\n其次就是有关俄罗斯的问题。首先我国并未明确声明支持俄罗斯，不发声不代表默许。当然可能有同学会说当前我国的实际行动不就是对其支持吗？我认为这只是两国间的友好往来，是我国出于有利于我国国家利益的目的进行的暂时的行动，并不代表对其侵略的支持。其次我们现在的所作所为也并不意味着我们认同俄罗斯的侵略行径，而只是因为其有利于我国的国家利益。众所周知，主权国家一切对外活动的出发点和落脚点都是国家利益，我相信一旦俄罗斯做出不利于我国的国家利益的行为，我国一定会果断与其划清界限的。国家利益是超越意识形态的，上个世纪苏联不也曾是我国的老大哥吗？我们不也拥有一样的意识形态吗？但当其逐渐导向现代修正主义，大行沙文主义之事时，我们不也将其与美帝一般同等对待吗？国家交往不过都是相互利用罢了。
159356,1021,吕强,2022-07-14 10:47:10,-13,6,19,真的万分感谢，感谢吕强老师海底捞(〃'▽'〃)
159395,1021,吕强,2022-07-15 21:37:45,19,40,21,沙皇时代多少烂事就不说了。就提近点的，1939年入侵芬兰，1956年入侵匈牙利，1968年入侵捷克斯洛伐克，1969年入侵我国珍宝岛，1979年入侵阿富汗，2008年北京奥运会开幕当天入侵格鲁吉亚，2014年吞并乌克兰克里米亚，2022年全面攻打乌克兰
160132,1021,吕强,2022-09-13 15:08:32,21,32,11,从目前乌克兰的反攻来看，老师半年前判断挺准的，和复旦唐世平教授有的一拼。是我盲目崇拜普京的力量误会老师了。
160643,1021,吕强,2022-09-29 04:19:35,0,3,3,很不错
160756,1021,吕强,2022-10-09 15:47:37,14,23,9,不是特别懂为什么评分这么高…感觉也没有太多干货吧？
160895,1021,吕强,2022-10-18 16:49:20,44,57,13,半年过去，回看前面评论区，多少人被俄国宣传战蒙骗了。网上多少军事自媒体被啪啪打脸，观察者网军事组没有一条预测准确的\n\n反倒是老师对于俄军外强中干的估计更符合实际情况。俄国确实也在乌克兰固有领土上发起独立公投，东乌也成了“依附境外大国谋求地区非法独立”\n\n究竟谁更实事求是呢？
161543,1021,吕强,2022-11-08 12:44:53,0,2,2,好好好
163138,1021,吕强,2022-12-08 02:58:59,0,3,3,老师帅的没话说
164314,1021,吕强,2022-12-20 08:41:19,-1,4,5,论文一直拖到期末才交，结果绩点意外的不那么差，感谢老师！
164360,1021,吕强,2022-12-20 11:26:04,2,6,4,老师很温柔，去问问题他会先说你好（当时就把我整不会了）。可以学到写论文的模板，很有用的。
165242,1021,吕强,2022-12-30 12:59:21,59,87,28,逛查老师，看到这位老师是10分，就点进来看看。虽没听过他的课，但看了大家的评论，很震惊在现在这个全程录像的教学环境下，居然还有这样的老师存在！！\n很想说一句：大家无论有多么不同意吕老师的观点，也请你一定要珍惜并呵护这样的老师，因为他真是在赌出整个职业生涯在给你这样上课！只是为了让你听到一点点与墙内主流媒体所不同的声音，这在今天的国内实在是太珍贵了！\n自从2022年开始，老师们上课的每一分每一秒都会被录下来，后台会有督导组盯着，一旦出现政治观点问题，立刻就会给学院甚至更高级学校机构反映，然后相关人士立刻就会找老师本人来谈话。任何老师说一点点出格的话，都有可能被当时或者未来所清算。\n同学们如果觉得吕老师的观点和三观与你严重不符，那么就毕业后出国吧！去欧美澳日韩台学习生活几年，深入了解公民意识与普世价值，观察公民社会，侧面参与公民活动，耐心倾听各种与从小就接受的观点都不同的声音，让自己越来越宽容和丰富。多年后再来想想吕老师和他说的话，说不定你会更加珍惜他！
165518,1021,吕强,2023-01-07 17:33:16,1,4,3,好老师！很负责！
165669,1021,吕强,2023-01-09 08:01:49,-1,3,4,认真负责
165785,1021,吕强,2023-01-09 17:26:50,1,3,2,听了一学期的军理，没有期待中的那么好，比较吸引我的是每节课前放的纪录片，有些在快被遗忘的片单里，还挺有意思的
165852,1021,吕强,2023-01-10 06:12:13,-3,1,4,很好交流的一位老师，有点后悔后面没好好听他的课哈哈哈。
166180,1021,吕强,2023-01-12 01:31:13,-16,4,20,好老师，又帅讲的又好，给分也好！
166213,1021,吕强,2023-01-11 12:27:09,35,37,2,给分求是，绩点压力大的同学慎选
166228,1021,吕强,2023-01-11 13:04:03,16,19,3,老师的资料真的很好 对同学也很好\n\n但给分实在求是 喜提大学思政课最低绩点
166235,1021,吕强,2023-01-11 13:28:25,7,7,0,非常好的课，非常好的老师。但客观上来说，比起其他老师的平行班，给分会逊色一些，但我已没有遗憾。\n\n如果对军事理论感兴趣/绩点压力没有那么大，非常推荐选吕老师的军理课。
166364,1021,吕强,2023-01-12 05:36:06,-1,5,6,好好好
169144,1021,吕强,2023-02-24 12:21:55,8,8,0,很求是 想要高绩点还是选cc slp吧
170282,1021,吕强,2023-03-02 12:16:05,17,39,22,我很好奇为什么这么多人为俄罗斯的侵略战争辩护。俄罗斯入侵乌克兰难道不是侵犯了乌克兰的领土主权，违反了联合国宪章？难道不是违反了俄罗斯自己签署的《布达佩斯备忘录》？希望乌克兰人不管在什么时候，不管面对打着红旗、铁十字旗还是白蓝红旗的的侵略者，都能把他们赶出家园。
170332,1021,吕强,2023-03-03 02:18:00,1,21,20,不是很行，纯纯倾向性诱导回答，屁股不评价，亲美亲西是肯定的，话说一半，欺负人不会上网？当思政老师不太行，怀疑没学过马哲，唯物史观是一点没有啊，哈人
170361,1021,吕强,2023-03-03 06:54:01,-2,16,18,还拿抗日战争和俄乌战争比，说是让人自己判断美国是不是拱火，实际故意诱导你，让你认为美国很正义，自己又不敢直说。
170486,1021,吕强,2023-03-05 17:04:07,3,45,42,不评价别的，就为老师敢在课堂上支持乌克兰，我就敬老师是个真男人！我不想去说nato做了什么美国做了什么，但是俄无疑就是赤裸裸的侵略，把自己的坦克和炮弹打到别国的领土上，强行吞并他国领土，公开违背《布达佩斯备忘录》，上一个敢这么做的已经在柏林的地堡里自杀了。无论如何乌克兰人民保家卫国永远是不会错的，无论这个敌人来自何方。谢谢老师，敢于做舆论的逆行者，勇气可嘉！
170845,1021,吕强,2023-03-10 09:48:18,19,38,19,支持乌克兰政府的支持台独港独疆独藏独行为捏，你乌克兰政府都骑脸了还要给我上眼药，那这很难办啊\n\n同情乌克兰人民的八年内战带来的痛苦，反战永远是广大无产阶级的立场，但这并不意味着我需要支持乌克兰的买办政府或者是俄罗斯帝国主义的任意一方。真以为俄罗斯是狗咬狗就可以说明NATO的正义了？乌克兰让NATO打赢了，下一秒就拉上日右来台湾捅你菊花\n\n另外单独谈谈吕强老师的立场，其实吕强老师不是真正的亲美；就我的交流而言，感觉吕强老师对国内军事上的弱点是有点恨铁不成钢的情绪在的，当然他不带立场地讲出来，也可以被解释成亲美，我还是相信吕强老师的立场，因为自己的独立思考再做出选择永远是第一位的，而不是上来就扣鹅毛乌贼的帽子为了反主流而反主流
170982,1021,吕强,2023-03-13 17:11:48,5,14,9,抛  开  事  实  不  谈  ，  我  不  想  谈  nato\n\n就突出个乐，诶，很乐
171050,1021,吕强,2023-03-15 04:46:20,0,2,2,很认真负责的老师，值得选择。
171205,1021,吕强,2023-03-18 13:11:55,-12,28,40,之前上过老师的课。绩点是真的很求是，看中gpa的建议慎选。\n\n但是看这评论。。。\n\n俄罗斯作为侵略者的事实摆在那里，支持俄罗斯的是真的屁股大于理性？
171377,1021,吕强,2023-03-23 00:24:10,-25,19,44,有点罕见的精美老师
171488,1021,吕强,2023-03-26 05:46:42,-9,21,30,说俄罗斯侵略乌克兰的，怎么不说北约东扩呢，把我整笑了。你美国不允许苏联在古巴安核武，俄罗斯就能容忍北约把前线推到俄边界？
171569,1021,吕强,2023-03-29 03:51:36,0,5,5,很不错很不错，干货挺多，也有考试题的小练习
171795,1021,吕强,2023-04-06 01:29:51,-12,26,38,通过有倾向性的诱导来鼓励学生进行所谓“独立思考”，通过所谓“反侵略”来为北约和纳粹洗白。宣扬所谓“普世价值”，却闭口不提所谓“自由民主”之下的舆论封锁和思想控制，不提西方国家底层民众的生活。纯纯反动派。
172595,1021,吕强,2023-05-01 09:47:31,2,5,3,我很喜欢的是老师不会灌输他的想法给你。我了解到了很多闻所未闻的史料，也算有了一条新的学习历史的思路。老师也是非常温柔的。
172721,1021,吕强,2023-05-05 05:28:09,28,33,5,《现代战争与国防技术》来的，我建议辩证地看待吕强老师：\n\n一方面，业务水平在线，讲课条理明晰，对论文要求高，实事求是；课后可以与他聊聊天，你不用认同他的观点，但往往会有所收获。\n\n另一方面，鉴于授课存在一定的诱导性和倾向性，有时会选择性地阐述事实，不建议对军事/政治/历史知之甚少的同学选他的课；比如，提及乌克兰历史却闭口不谈波立联邦、赫梅利尼茨基和伊万·马泽帕，这实在很难绷。\n\n\n\n最后我想说：\n\n人不是只有小粉红和公知两种。\n\n这里是评价老师的地方，不是用浅薄而贫瘠的知识储备来相互对喷的地方。
173321,1021,吕强,2023-05-19 01:54:38,0,17,17,其他思政老师要是像他一样要求严给分一般估计早就被喷烂了吧，只不过因为他的自由派言论满足了一些人的心，所以有着名不符实的分罢了。\n\n用的话术也是经典话术了。论侵略，全世界估计谁都比不上美国了，这他是绝对不会提的。话里话外传达着对西方思想的向往，又不敢直接说出来，只能暗戳戳的点一下，阴暗鼠辈罢了
173323,1021,吕强,2023-05-19 04:13:58,4,7,3,我不知道为什么这个老师分这么高，workload很大
173576,1021,吕强,2023-05-29 08:20:57,1,3,2,夫阉尹之祸，如毒药猛兽，未有不裂肝碎胆者也。自书契以来，唯东汉吕强，后唐张承业二人号称善良。——苏轼
173724,1021,吕强,2023-06-02 04:10:17,23,23,0,本人军理战技双修选手，吕老师在做论文指导的工作，所以在第一节课就会语重心长提醒大家要把论文规范做好，还发了一套几年前的祖传word论文模板，用来写通识课论文相当好用，大一的同学可以找学长要一份；给分特别求是，而且对想要分高的人有点push，有嗯卷论文展示喜提满绩的，也有论文胡编乱凑绩点爆炸的；这个春学期上完国防技术这门通识课之后，吕老师说以后不开了，我还挺希望只是暂时休课调整，这套课程其实开课挺久了的，如果是真的不开了有点遗憾\n\n俄乌战争以来上课会经常性地搬运外媒报导，而且也会带着对美式民主的推崇讲事，这也是查老师上吵得厉害的原因；吕老师也说过几次自己的大学同学都在国外发展，联系他从中科大浙大毕业那几年的滑梯，其实吕老师在国内已经非常难能可贵了；有个同学一直在问一些国内主流观点（这里说的很保守了）跟他的观点对冲，我在后面看哭笑不得，但是还是很耐心地一条条回答批驳，换成网友可能直接拉帮结伙开始骂战了，这方面足够说明吕老师是有真知灼见的，即使当下互联网左神兔观点撕裂到如此抽象的地步，吕老师实在是令我非常尊重的自由派；更何况一个奔六十的人到现在还在想办法了解年轻人的热点，完全对得起这十分评分，正所谓君子和而不同小人同而不和\n\n总之，有干货、人品好、有待交流、快退休的好老师，我认为足够概括了
173756,1021,吕强,2023-06-02 09:43:50,2,8,6,先说优点：\n\n1.能帮你规范论文写作，他真的会抽时间给你看论文，我跑到问过（注：需预约）\n\n2.给分不低，只要按要求来\n\n3.长得帅（实事求是），确实能接受一些异议\n\n缺点也有：爆论多，对美国的一些霸权做法轻放而揪着俄罗斯的问题不放，\n\n认为大毛在鹅乌战争中倒了兔子可以痛打落水狗\n\n认为现在像鹰酱俄亥俄州这些事件根本没有想象中严重\n\nemmmm，现在想来，只能说这类观点与我的思路三观难合。\n\n但是在课上这些内容表达的还是比较少的，只能说求同存异吧，举报啥的过分了，有不同意见直接课上表达出来，我觉得还行
174306,1021,吕强,2023-06-09 06:50:05,3,9,6,一位讲课逻辑条理非常清晰的思政老师，\n\n非常有自己的想法与主见，\n\n本人也是军理和战技双休选手，\n\n战技论文没有好好写结果绩点刚4\n\n军理论文卷了卷60分拿满了，\n\n给分真的非常非常求是
174690,1021,吕强,2023-06-15 15:59:40,20,23,3,yysy，抛开军事不讲，因为真的有很多军事小白，单纯的给分很求是，讲课很生动体验效果强对于小白来说，跟别的老师没什么区别，所以对军事不了解的，还是slp和cc把
176549,1021,吕强,2023-06-29 08:47:38,22,23,1,别的不说，吕老师是真喜欢喝可乐啊，还是一大早上喝
176736,1021,吕强,2023-06-30 03:00:56,-29,30,59,支持俄罗斯的那些人纯纯贱种
177939,1021,吕强,2023-07-05 15:43:03,21,22,1,虽然我并不认同他的些许观点，但我将毫无疑问捍卫他的课程。
177983,1021,吕强,2023-07-06 02:56:04,13,13,0,上课军事方面讲的还是很不错的，今年给分也很好！
177985,1021,吕强,2023-07-06 02:59:53,4,6,2,讲课讲得不错给分还是挺求是的
178065,1021,吕强,2023-07-06 13:55:27,2,2,0,吕老师我想得分
178207,1021,吕强,2023-07-08 03:10:53,43,45,2,同时上了吕强老师的战技和军理，绩点自己还是比较满意的\n\n吕强老师是军事工程师，对新型武器装备和作战理论有很深刻的了解，因为水平高，所以要求也会严格，不过老师是乐意帮助同学指导论文的，无论从师风师德还是学术能力，毫无疑问是位好老师。\n\n至于很多同学上升到所谓民族问题攻击吕强老师的立场，其实大可不必。我国的国防水平突飞猛进不过是近十来年的事情，距离美国也确实仍有不小差距，吕强老师只是一个比较清醒的爱国者，你从他的言行可以看出来，他是真心实意希望民族进步的，而不是放空头炮。无论是神还是兔都不会看得惯吕强老师，导致吕强老师上课有时候经常受到奇奇怪怪的为难。\n\n吕强老师自己说他下学期不会再开战技了，感觉有些遗憾。其实，无论是极端民族主义者，还是极端亲外仇内者，都是右翼保守思想，兔和神只是看似对立却又有相似精神内核的一类人，他们都不是社会的主流，大可不必受这些人的影响，踏踏实实走自己的路。浙大精神以“求是”为先，吕强老师是践行了这一点的，所以我敬佩他。
179164,1021,吕强,2023-08-29 05:04:04,7,8,1,老师本身是负责导弹相关研发的工程师，军事素养很高，对待学生十分亲切友善，可以和他讨论各种问题，课堂也比较有意思。不过他很讨厌俄罗斯，偏向欧美。老师对于论文的要求较高，不过最后总体给分好像还行。对军事感兴趣的同学们还是可以考虑一下的。
179327,1021,吕强,2023-09-11 04:12:24,-1,2,3,老师很好，非常求是，点名会提前说，总之是非常nice的老师
179328,1021,吕强,2023-09-11 08:57:58,0,1,1,老师很不错
179532,1021,吕强,2023-09-18 04:14:45,4,5,1,老师今年给分变好了，还是挺推荐选的
180569,1021,吕强,2023-09-23 02:34:36,0,5,5,好幸运能在吕老师退休前听到他的军理课！小测就小测吧，我愿意！！！
181072,1021,吕强,2023-10-07 09:46:19,5,7,2,吕老师有点帅，有点像……燕双鹰
181522,1021,吕强,2023-10-21 04:12:29,3,6,3,吕强老师的论文要求实在严格，对于学业繁重的同学属实比较痛苦。军理课并非影响未来发展道路的一门课，为何需要如此严格的论文要求，且给分确实一般，事多分少。若对军事理论不感兴趣，慎选！！
181740,1021,吕强,2023-10-30 11:31:06,8,14,6,一些关于以色列的言论实在不敢苟同（没有不尊敬老师的意思，只是单纯观点不同）
181815,1021,吕强,2023-11-01 11:59:10,8,19,11,立场有问题，夹带私货。提日本军费增长就说日本军费始终占GDP1%很稳定，中国新闻报道这个是引导宣传。然后后面用中国军费增长图宣传中国威胁论的时候完全不考虑中国1.7%的占比。日本还是二战战败国原则上不能有进攻性军事力量的。\n\n真的无语，类似事情不胜枚举，给分也不高，不知道怎么那么高分
181919,1021,吕强,2023-11-05 10:35:15,9,22,13,这些去年讨论俄乌的美吹们今年看到以色列痛击巴勒斯坦平民什么想法？前排有人大谈特谈什么反战言论，美国现在在安理会巴以停战投反对票打你脸疼不疼。\n\n啊对对对，不一样的，以色列这可是反恐战争，你美爹可是给世界带来和平了啊。我炸个医院，炸个难民营又怎么了在人家隔离墙边上开纪念反阿拉伯战争胜利的音乐会，被抓了之后再道德绑架中国网民怎么了？巴勒斯坦人只是失去了他们的生命，鱿鱼们可是真实的被巴勒斯坦恐怖主义者砸了车车了啊。\n\n那日本侵华战争的时候，它们是不是也可以说自己是受到了中国人的恐怖主义威胁（如卢沟桥事变），它们也可以在东京审判的时候说一句：日本入侵中国只是哥哥在教训弟弟。它们也可以像以色列不承认轰炸加沙医院一样不承认南京大屠杀，它们也可以像现在美国人谈论哈马斯一样谈论我们的党，把反对侵略者的游击武装组织视为恐怖主义袭击，把我们的革命先烈视为恐怖主义者。那些狂吹外国怎么怎么民主，怎么怎么先进的，怕是GPA太低了，只能去国外只能申社区大学吧，为啥还在中国跟我们争保研名额啊。美国人自己对自己国家不做人的地方它们自己都看不下去了，你们这些外国友人还在这给他们洗地。快滚去你的精神故乡去吧，即使你是浙大人，中国也不需要你们这些慕洋犬，就怕是你们又没钱又没能力，去了你美爹还不待见你。至于这个老师，他确实有发表他言论的自由，但是我要说的是，作为一个军理老师，有着大量的信息来源，但是他却选择处心积虑地去筛选和粉饰，然后告诉你的学生一个他想看到的真相。他去狂吹以色列轰炸之前给难民撤离时间，却不说它们就给加沙北部人两个小时撤离，不说它们行为就是事实上的侵略行为。他去吹以色列允许人道主义物资进入加沙，但是你却不说以色列和美国在联合国“人都拥有获得食物的权利”的提议中公然投的反对票。\n\n我想说，如果你不是像上面哪些美吹一样，被美国的言论霸权欺骗了，或者是看了太多美吹言论，跟外国人共情了，那我想说你是真的坏。
181961,1021,吕强,2023-11-06 13:29:43,-23,16,39,楼上是什么逆天，学了一点贴吧用语拿着键盘就冲出来装了是吧，真的笑死了\n\n\n\n如果乌克兰也是空降莫斯科突袭音乐节把德国女孩杀了扒光了游行，我也支持俄罗斯平推基辅啊，这不是很正常吗？张口闭口一个牧羊犬，保不了研卷不过别人就劝别人滚，很符合我对这个群体的想象\n\n\n\n只可惜乌克兰没有恐袭莫斯科，你的鹅爹不仅没有平推基辅，连克里米亚都快没了，是不是被老师预判了失败后只能咬牙切齿无能狂怒在这人身攻击了？\n\n\n\n啊别说我双标，是你先攻击支持乌克兰的人的，我攻击你很正常，就像你的动物朋友先开炮然后快被杀完了一样
183318,1021,吕强,2023-11-23 15:52:30,20,24,4,王伟都能黑我是没想到的
183808,1021,吕强,2023-11-30 08:40:04,10,24,14,私活真的多，那些说他独立思考的自己是不是犯了“顺我者独立思考，逆我者已被洗脑”的错误？他那么指向性的信息能被人说成给出各方观点我只能说是不是你信息获取渠道太少了？还说自由观点讨论的，老师和学生本身就有身份地位的不对等，这叫“授课”不是“讨论”，老师授课时的小心思没被注意，对学生影响就是很大的\n\n我不扣帽子，举例子。2023秋季学期第四课，新华社提日本军费增长8%达新高。他说这是新华社引导人们警惕日本军国主义，虽是事实但是也不能信，然后说日本军费就占1%。\n\n同一节课，放了一张中国军费增长图，这下不看占GDP比例了，说中国军费增长造成威胁什么的，中国威胁论常见论调这种。然后放美国军费图，不看绝对值，不看占GDP比例，直接说军费增长不大，暗示美国才是全球稳定维护者。\n\n可谓是双重标准，自己熟练掌握引导暗示发还给别人泼脏水\n\n\n\n中国军费占GDP约1.7%，美国4%到5%，中国军费仅是美国四分之一到三分之一，更不提军事力量在海外的干预。这些数据一笔带过，反而是职责中国军费报的太低有造价可能说了半天也没给出依据，说是有国外机构怀疑，结果连个名字都不提\n\n\n\n然后到了美国说美国打仗都是爱其民的表现，说是打伊拉克说解救人民于萨达姆的残暴统治下，是爱其民表现。伊拉克战争我不做评价，这是联合国授权的，萨达姆确实活该。但是这个“爱其民”敢问吕强说的不肉麻吗？死亡公路、对平民的暴力行径以及后续治安站的信息一点不提啊。到头来无论是萨达姆还是美军，一个爱伊拉克人民的都没有\n\n\n\n美国做的事大夸特夸，中国有点成就就暗暗阴阳，隐藏信息式夹带私货等等，这怎么敢玷污独立思考四个字的？
183860,1021,吕强,2023-12-01 09:49:10,3,13,10,教学能力不错，但是在巴以冲突问题上有严重错误
184131,1021,吕强,2023-12-11 04:19:48,4,7,3,个人感觉老师已经挺中立了，是老师在别的时间课上有偏颇发言还是楼上是对zz太敏感我不知道。\n\n1.老师未否定日本军费确实增长，只是日本疫情后gdp上升使军费增长率很高，这个被新华社做文章了\n\n2.老师也说过人民币贬值使得实际上中国军费与几十年前差不多\n\n3.印象中没听到过不严谨的言论，开战与作战正义是两回事，科技战的平民伤亡就是减少了
185208,1021,吕强,2023-12-27 05:23:37,1,5,4,不理解为什么老师这么双标
185303,1021,吕强,2023-12-27 16:07:51,1,3,2,真的是虚高
185714,1021,吕强,2024-01-04 00:12:56,6,9,3,回答 2023.11.30同学的回复\n\n请问伊拉克战争哪里有联合国通过的决议了？联合国通过的难道不是海湾战争？死亡公路老师上课也提了吧？黑也要有点水平，至少听一听课再黑吧
185783,1021,吕强,2024-01-04 09:52:18,5,7,2,对1.4同学的回复：讲事实就叫黑是吧？那位同学说的难道不是事实？要不要我告诉你对应的智云是几月几号啊？再说伊拉克战争美国未经授权就发动难道不是更加可耻吗？
186025,1021,吕强,2024-01-08 00:14:55,16,17,1,吕老师讲课还不错，但是给分特别差，\n\n平时分不调分，考试考多少算多少，别的沈老师，陈老师基本平时分给满的。去年选手，平时分只有51（满分60），绩点3.9。
189059,1021,吕强,2024-01-21 13:55:19,23,35,12,客观一点说：\n\n1.早八雷达点名\n\n2.给分没其他老师高\n\n3.没有小测\n\n通识课不调平时分？你指望我论文能发表什么高见吗？我又不是相关专业的你给分这么苛刻是想干嘛？？？sb
189063,1021,吕强,2024-01-21 14:11:58,3,6,3,讲课先不说，但是给分是真的很求是
189076,1021,吕强,2024-01-21 15:21:03,0,0,0,人还好
189101,1021,吕强,2024-01-22 02:01:22,1,9,8,老师确实亲美亲日，有些过分看轻中俄了，不过我虽然对美西方国家没什么好感但也不算是俄粉，所以勉强还能接受。抛开私货不谈讲的课还是有水平的。给分比较求是，有点名，5k字论文要求也挺高的，总体上就是求是吧xs也是很符合zju校训
189103,1021,吕强,2024-01-22 02:09:30,-15,10,25,sb老师
189104,1021,吕强,2024-01-22 02:13:03,3,5,2,之前看评论说给分很苛刻，自己论文分数不怎么高还从来没在课上发言加过平时分，害怕拉下一堆绩点。结果等出来后其实还可以，主要还是看期末考吧，翻书的速度和运气可能更决定最后的分数。
189176,1021,吕强,2024-01-22 09:09:30,9,10,1,lq老师一学期大概点四五次名，而且有规律（开学三四周后隔一周点一次，差不多点到期末考前三周），给分肯定不如cc和slp，但是我觉得不是因为老师给分差，是因为那两位老师给分太好了。论文没调分之前55，期末判断单选大概十个没翻到，多选有两三个不确定，最后92，供下一届选课的uu参考一下
189348,1021,吕强,2024-01-23 10:25:31,12,13,1,给分给的挺好的，可惜给的不太好
190123,1021,吕强,2024-02-23 03:44:15,8,11,3,给分不行，就这一句话，快润
190138,1021,吕强,2024-02-23 14:13:36,9,11,2,如果对于军理这门课只想高一点分数的话最好别选
191760,1021,吕强,2024-04-30 01:11:39,5,6,1,比其他老师给分低两个档
192013,1021,吕强,2024-05-07 16:42:48,3,6,3,卧槽你大爷的吕强，军理的分瞎瘠薄给啊
192378,1021,吕强,2024-05-17 03:05:37,6,7,1,😅😅😅
193334,1021,吕强,2024-06-06 13:11:23,4,5,1,评分还没出，但是客观来说，吕强老师讲课还是挺厉害的，推荐！
193680,1021,吕强,2024-06-15 08:12:09,-8,6,14,观点非常逆天。
195304,1021,吕强,2024-06-27 17:06:43,2,4,2,一个学期点名了六次，一篇论文，一次考试。老师讲的还是很好的，上课有种听评书的感觉，老师有些观点比较新颖
195305,1021,吕强,2024-06-27 17:06:47,7,9,2,人还不错，但给分很不好，跟别的老师差距很大，直接绩杀。老师本人知道自己给分不好，并且不打算改。在意绩点的慎选。
195319,1021,吕强,2024-06-27 17:31:23,2,3,1,求是
195339,1021,吕强,2024-06-27 22:34:01,4,5,1,给分真的超级不好，被绩杀了。军理想要高分就选其他两个老师。
195342,1021,吕强,2024-06-27 23:18:35,10,12,2,吕老师是我上大学以来见过的难得的学识和良知兼具的老师。不过，他今年底就要退休了，为浙江大学略感遗憾。
195360,1021,吕强,2024-06-28 00:58:33,6,8,2,也许课程不错，但是我上大学以来最低绩点（同寝室的室友同样如此）
195378,1021,吕强,2024-06-28 02:09:26,5,8,3,老师非常有思想，虽然我是俄粉但经过与老师私下的交流后发现老师的思想其实是站在世界角度的，对局势的分析也很正确。老师给分确实偏低，但讲的真的很好，是我为数不多的（或许是唯一）早八也会认真听课的通识课，建议是追求成绩的不要选，追求知识的或者真正的军迷一定要冲。
195440,1021,吕强,2024-06-28 05:07:48,-5,6,11,老师上课真的很好，期末成绩主要靠自己翻书速度。那些说平时分不高的不妨反思一下自己有没有发言，有没有认真写论文，有没有认真对待这一门课程。
195446,1021,吕强,2024-06-28 05:36:27,2,3,1,老师真的太好了
195478,1021,吕强,2024-06-28 08:08:35,3,4,1,一名真正的好老师！
195489,1021,吕强,2024-06-28 10:00:04,-3,3,6,给分真的很一般，不要选不要选不要选，如果不是军理爱好者，选了会得到超低的菌剂。。。
195610,1021,吕强,2024-06-29 04:03:22,4,6,2,这个学期给分变好了，但是和隔壁的几位老师相比还是有些差距。老师讲课讲得极好，推荐时间相对比较充裕的同学选吕老师的课。
195767,1021,吕强,2024-06-30 02:04:18,-76,15,91,军事理论，整个学期点名了6-8次，特别在意点名情况；老师上课水平很高，给分上跟cc和slp还是有差距的；lz喜提四年来最低绩点3.9
195935,1021,吕强,2024-07-01 02:01:22,-2,2,4,男神老师
195979,1021,吕强,2024-07-01 03:41:18,0,2,2,有观点，讲真话。
196376,1021,吕强,2024-07-03 07:10:24,9,10,1,想水不建议选\n\n签到很规律 这周签到下周一定不签\n\n给分的话主要看期末考试卷面成绩\n\n本人期末卷面61www
196460,1021,吕强,2024-07-03 13:48:50,5,22,17,吕强老师必须满分～不过很抱歉我家狗跑到评论区在那里用狗叫来支持乌克兰
196564,1021,吕强,2024-07-04 05:42:11,4,8,4,老师讲课很好，给分确实求是。本人对军理毫无兴趣，上课偶尔听听，论文超认真地写，期末考没怎么准备。最后3.9，符合我的水平。
197924,1021,吕强,2024-08-21 05:09:19,10,10,0,分低了
199615,1021,吕强,2024-09-26 08:54:24,0,0,0,讲课非常好
204175,1021,吕强,2024-11-25 02:29:39,5,7,2,如果你认为分数不是一切，请选择吕强。\n\n没上过他的课会后悔的
205382,1021,吕强,2024-12-05 08:34:18,0,2,2,挺好的，很真实
205725,1021,吕强,2024-12-11 12:39:52,2,6,4,吕强老师讲课真的好，每次早八都能认真听下来，还会分享自己去中印边界的自驾经历，很有趣。但是给分很求是，如果想要高分的话还是选其他老师！
207496,1021,吕强,2024-12-22 11:56:28,-15,12,27,虽然上课说提倡不同观点，但上课带有很强的煽动性和引导性，就知识讲解来说并没有特别深刻或者吸引人，但是因为喜欢讲对抗主流的言论容易吸引很多同学兴趣，这很正常。但不可否认的是，吕老师很多观点给出得证据显得比较片面主观。我看到评论区有很多同学说老师愿意包容反对意见，但在我这届可能是讲课年数太久失去耐心，老师在课上会对反对其观点的意见与同学（当然老师不会说具体是谁）带有极强的反讽与排斥（单纯的批评，并非理性辩驳），至少在我的印象里这位老师是一位很少愿意接纳对立观点的人。当然，这也可能是老师经历过那个年代导致对zf产生的偏见，但就是论事，这位老师的个性绝非客观理性的学者，但你可以从中吸取一些少见有趣的观点。最后，他的课给分很低。综上所述，我只能给五分。
208123,1021,吕强,2024-12-26 00:20:04,25,30,5,从这一届的学生评价来看，就知道我们的教育真的出现了很大的问题，完全不接受任何新观点，盲目追随主流舆论，对于老师提出的新观点与新史料始终抱有偏见与怀疑，这种教育如何培养出真正的人才呢，只不过是没有思想的工具罢了。老师在课堂上始终保持自己的主观独立性与批判性，这种珍贵的思想才是对自己，也是对国家最好最有利的，一味服从主流舆论，如何能够对这个世界有着清晰的认知？当主流舆论已经置常识于不顾的时候，仍然得到广大学生的支持与认可，这不才是教育的悲哀吗？
208241,1021,吕强,2024-12-26 10:18:27,4,4,0,老师讲课很有思想
209955,1021,吕强,2025-01-07 14:36:06,0,2,2,好好好
212554,1021,吕强,2025-01-14 07:40:18,19,23,4,不敢恭维 讲课确实可以 但是给分太低了 别的老师平时分都拉满 lq给我扣了12（没有旷课 论文认真写）
212560,1021,吕强,2025-01-14 07:54:19,18,20,2,讲课只有最后几节在讲课本，其他时间在讲世界战史，很有思想，对军事迷很友好，水平大概是军理老师里面最高的，但是给分确实不行，平时分比别的老师低很多
212577,1021,吕强,2025-01-14 08:30:43,7,15,8,给分特别特别差！避雷
212580,1021,吕强,2025-01-14 08:38:14,8,10,2,一开始我选军理的志愿其实是按照查老师上的评分来排序的，于是选上了lq老师的班，后来发现他分高的原因是因为上课水平高，但给分相对求是。在出分前看到有人在吐槽slp的时候我甚至以为我军理要完蛋了，毕竟lq好像会认真看论文的，也会扣平时分，就非常慌。今天早上通过奇奇怪怪的方式看到了军理论文的得分，然后下午就出最后的得分了，居然到4.5了（不过可能在slp或cc的班里有4.8）。\n\n\n\n总的来说，他讲课的水平确实很高，我如果能在第一排找到位置的话都会去坐第一排的，在给分方面可能确实不太行，但就我而言，差距有但不多，还是值得给上10分的。如果你对军事方面的知识感兴趣的话，欢迎选他的班；而如果你只是想混掉军理的学分同时又重视绩点的话，他可能就不是最优选择了。
212589,1021,吕强,2025-01-14 08:51:29,1,2,1,老师雷达点名，讲的好不好不知道（作为一个对军事不感兴趣的孩子，听这种课哪个老师来了可能都不感兴趣），但学识十分渊博。给分真的不好，如果你对军事完全不感兴趣，并且追求学分，那么尽量不要选他。如果你是军迷，觉得分数不是一切，那么请选择吕强！
212621,1021,吕强,2025-01-14 09:45:33,0,3,3,挺好的吧，老师上课很认真，论文认真写了应该是给的90以上，期末自己提前翻翻书拿了80多，最后总评分也很高🥳🥳🥳
212640,1021,吕强,2025-01-14 10:28:09,-4,2,6,上课讲的很好，听说给分比较求是但是给我分还挺好的有4.5
212659,1021,吕强,2025-01-14 11:42:39,7,7,0,老师学识渊博，上课也讲得很好，然后关于给分问题我来说一下我这边的情况：\n\n本人全勤无发言，论文分有55.8（甚至晚交了三天大概是扣了2*0.6左右的分）最后得到的成绩是89，我一开始以为老师平时分没调是自己期末考了83，但是找了老师问了详细情况以后发现其实自己期末只有73，老师给我平时分调满了🥲（60+73*0.4）所以有没有一种可能这学期他确实调过分了呢（毕竟cc和slp班刚出分也有很多人觉得没调分最后明细发出来发现其实是期末分数太低了…）毕竟今年军理平均分就低，翻到了也不一定就是对的（我出考场感觉90+实际就70多…）当然这只是个例，不排除只调了部分人，主要给下学期同学做一个参考，也给lq不调分做一个小小的正名
212667,1021,吕强,2025-01-14 11:34:59,0,2,2,老师讲课挺有意思的，在讲中印边境问题时还会给我们看他自驾时的照片。不过论文小登真的不太会写，缝缝补补55分。要是别的班可能高一个档？（当时选的时候只看了评分）最后4.5还算满意吧，至少比德法史纲高🃏
212720,1021,吕强,2025-01-14 14:49:27,0,1,1,老师很博学，观点很新颖值得深思，不理解楼里什么样的人会说老师“立场有问题”？最后给分也很求是（军理期末考不认真复习准备的话会很低）
213243,1021,吕强,2025-01-16 12:49:19,-17,8,25,给分太差，md，均绩直接拉了0.1
214151,1021,吕强,2025-01-25 17:38:01,-19,6,25,给分差，sb老师
214375,1021,吕强,2025-02-02 15:00:57,0,0,0,555
214629,1021,吕强,2025-02-15 07:41:02,3,3,0,当你认为没有点名的时候，一定跟旁边的同学确认一下。我差点因为这个错过两三回QAQ当然老师讲课很棒，大家似乎都同意这一点
214846,1021,吕强,2025-02-18 08:27:35,5,8,3,致敬思政课传奇绩杀王
215002,1021,吕强,2025-02-20 03:26:15,0,7,7,需要卷一些，因为看了之前的评论所以决定稍微卷一下。确实没听课但是论文写了一万字左右磨了一段时间，然后期末复习的时候过了一遍书，准备了很多资料都过了一遍，最后4.8，老师确实很认真很负责，但可能不太适合想完全躺平的同学
215207,1021,吕强,2025-02-24 08:31:14,-8,3,11,老师人好给分好
215532,1021,吕强,2025-02-27 15:42:56,-32,7,39,泥浙学生对自由思考的要求真低，且不说他天天擦边球阴阳怪气尚且是自由言论的范畴，但是拿着不知道从哪里搞来漏洞百出的营销号史料硬黑，属实是过于难绷，他发表这些观点的时候有没有考察过事实与历史证据？张口对着学生胡说，我也会，那我也是独立思考咯？我不希望拿屁股压人，也不希望扣帽子，但是他在那里胡扯，完完全全就是背离求是精神。
218461,1021,吕强,2025-04-24 00:32:56,1,2,1,老师讲课很有深度
218524,1021,吕强,2025-04-24 07:23:09,9,10,1,特别好的老师。有节课我忘记签到了，下课后一堆同学围着老师要补签，老师都很好脾气地一一记上。因为我是超绝社恐i人，在一堆人挤着报名字的时候完全插不上嘴，就默默在旁边站了很久，然后老师就说看到我站很久了，让我先来。好温暖啊
218877,1021,吕强,2025-05-10 08:56:11,-8,4,12,特别难评，论文事多，要求多。天天在课上点名，高高在上，不知道说他好的人安的什么心。
219260,1021,吕强,2025-05-23 14:15:11,2,2,0,老师很有魅力，对于军事上的东西侃侃而谈，哪一年哪一天哪一场战争什么武器都如数家珍。对论文要求高，认真负责。不过给分据说很差。
219279,1021,吕强,2025-05-24 05:52:14,3,5,2,讲的确实好，但是是绩杀王
219586,1021,吕强,2025-05-30 09:53:25,-10,4,14,不理解他的假ddl有什么意义，被坑惨了。
219992,1021,吕强,2025-06-13 09:36:25,4,4,0,什么叫假ddl有什么意义，老师课上重点强调了学在浙大上的时间不是ddl的时间，让大家不要忘了，就算平时课不怎么听，第一节课讲要求总得听一下吧
220390,1021,吕强,2025-06-17 14:44:40,1,1,0,吕老师的论文不敢不好好写啊，但是老师人真的很好！
220583,1021,吕强,2025-06-18 15:23:14,-4,2,6,给分这么低显得自己水平高吗
220599,1021,吕强,2025-06-19 00:49:23,-4,2,6,六百六十六，传奇绩杀王
220600,1021,吕强,2025-06-19 00:50:57,2,3,1,老师yyds，退休了替我幸福🌪️😭
221094,1021,吕强,2025-06-21 08:21:29,0,0,0,作为一个对军事理论感兴趣的同学，上吕老师的课还是非常有意思的\n\n课前会讲一些军事新闻，配以分析，真的很好\n\n\n\n吕老师的一些观点可能比较不合大流，但是我觉得还是要认清差距，不能盲目自信，在没有论据的情况下，抵触这些观点\n\n论文认真写了，改了好久，最后给分也满意
79803,1043,阎亚军,2018-06-14 01:30:44,0,1,1,哇怎么这里显示的他的均绩这么低……
124709,1043,阎亚军,2020-07-06 15:26:26,1,1,0,阎老师去哪了？
120547,1056,周清志,2020-01-12 10:49:06,2,9,7,是个好老师！！！
153799,1056,周清志,2022-05-11 12:32:14,-43,9,52,离谱他妈给他开门，离谱到家了
153859,1056,周清志,2022-05-13 11:48:17,4,9,5,老师挺好的，游泳教的挺耐心，学会了就很爽了
163201,1056,周清志,2022-12-09 14:16:07,-13,4,17,每次都已读不回，怀疑人品问题
163723,1056,周清志,2022-12-16 04:20:16,14,16,2,真的是个好老师，非常耐心温柔，对我这种旱鸭子友好！
163772,1056,周清志,2022-12-16 05:41:36,10,12,2,首先，老师每节课都点名，这个不要有侥幸心理，每节课都会点！网课也一样！迟到了也会扣平时分的！各位自己注意点吧。\n\n除此之外我觉得老师还是很不错的。是那种比较和蔼可亲的老人，我上的他的游泳课，每节课教点基本动作之后就让我们自己在泳池里随便干什么，而他待在一边看，如果有问题随时找他，会手把手教，非常耐心。\n\n捞不捞是另一回事，没出分我也不知道，至少在12分钟跑他没有捞，但是引体向上确实有捞（虽然就一点点吧）。估计绩点差不到哪里去，他自己也承认了，这门课真的很简单。\n\n综合一下给9分。
163788,1056,周清志,2022-12-16 06:04:57,1,3,2,挺好的老师
163832,1056,周清志,2022-12-16 07:55:02,1,1,0,挺不错的老师，就是为啥点进来之前是na
163940,1056,周清志,2022-12-16 15:45:49,9,9,0,6分我觉得真不至于，这个老师的游泳课是我上过最轻松的游泳课，十二分钟跑我本人没啥太高要求，跑到五圈老师让我拿剩下时间再跑半圈我就直接走回来了，最后给我记了五圈半。别的不说，作为一门体育课来说起码是很轻松的，楼上说网课会点名，但是亲测挂在那不听也给签上了，个人感觉还不错，网课开了以后就去睡觉了，没出过问题。\n\n\n\n给分不知道怎么样，反正8分应该是有的。
168896,1056,周清志,2023-02-23 09:04:37,1,1,0,66666666
172345,1056,周清志,2023-04-25 08:07:44,1,1,0,老师很和蔼～
174228,1056,周清志,2023-06-08 03:28:19,4,4,0,老师是个很有耐心的小老头哈哈哈，很和蔼，我这种没下过水的旱鸭子最后都会游泳了。
181580,1056,周清志,2023-10-23 09:28:40,1,2,1,老师教得很好
184691,1056,周清志,2023-12-22 07:57:05,2,2,0,老师很和蔼！
184769,1056,周清志,2023-12-22 14:41:16,0,1,1,老师用一节课教会了我游泳，人真的好好
184834,1056,周清志,2023-12-23 08:48:43,3,3,0,轻松好玩
186750,1056,周清志,2024-01-13 02:38:57,5,5,0,很和蔼的老师！进度有一点点快，但是对于旱鸭子会特别注意与指导，我是有游泳基础的，上老师的课比较轻松。请了一次病假，也没有扣分。冲！
193167,1056,周清志,2024-06-04 06:30:14,5,5,0,超级可爱温柔的小老头，我每次上课都会迟到也从来不会说啥，有一次在东操十二分钟跑我跑到西操去了，迟到了将近二十分钟，结果老师一边慈祥的笑一边打趣说我东西都分不清了，真的人很好很温柔！只下过几次水，最后游泳也喜提满绩了～
193847,1056,周清志,2024-06-20 07:19:30,6,7,1,老师人很好，非常和善，我是个旱鸭子，不会游泳，上了老师的初级班成功学会了蛙泳，因为自己比较笨，上课学的很慢，老师从来没生过气，非常耐心，跟我说就是有点紧张没事的，考试时候第一次因为紧张技术分不太好，老师认真帮我纠正了问题，还让我下节课可以重考一次，第二次老师说很有进步，综上真的很推荐选老师的课！
195060,1056,周清志,2024-06-26 14:22:35,3,3,0,啊啊啊啊啊啊啊啊周老师您大好人啊啊啊啊啊啊啊啊啊浙大的光浙大的神浙大的第一人！
195697,1056,周清志,2024-06-29 16:05:04,4,4,0,老师是一个非常可爱非常慈祥的小老头～（没有贬义）上了老师的游泳中级班，自由泳完全一点不会，学的也比别人慢，但老师特别关照，会单独很耐心地教～最后给分也很好，挺捞的。
197345,1056,周清志,2024-07-11 05:56:48,3,3,0,本来是卡绩的，还好最后一节课可以通过50米自由泳计时的bonus加了一分，感恩！
200844,1056,周清志,2024-10-23 09:37:51,-9,2,11,桨板贾老师出差让他代授心肺复苏，心肺复苏只讲了二十分钟，其余时间全在做原地运动动作 谁懂啊连上两节身体素质课，史
209431,1056,周清志,2025-01-06 02:48:20,5,5,0,游泳初级\n\n会蛙泳的老师直接让自由活动了，每节课都玩得很开心，甚至呆不住了还能悄悄溜走（doge），不会的老师会认真指导一整节课。老师人很和蔼，每节课都会点名，最后期末考的专项技能分给的很高（蛙泳25米就行，我拿了95），后面还有一次蛙泳50米竞速，可以加一到两分。我12分钟跑2500，没参加三好杯之类的加分项目，每节课都到，引体向上、48次打卡和智慧树拉满，最后喜提96，很满意了。周老师的游泳初级可以直接冲。
209591,1056,周清志,2025-01-06 10:15:04,2,2,0,10分！！！本学期为一个满绩，谢谢周老师大好人
212474,1056,周清志,2025-01-14 05:06:40,1,1,0,讲解认真细致，收获很大
212495,1056,周清志,2025-01-14 05:46:46,2,2,0,游泳（中级） 2024秋冬 除了消息已读可能不回，其他都很好
213973,1056,周清志,2025-01-22 08:31:24,-3,0,3,虽然学会游泳了，但是给分是真的不行，有其他选择还是不要选周老师的课
215945,1056,周清志,2025-03-08 02:00:06,4,4,0,没有人说老师的颜值嘛！！感觉年轻的时候绝对是超级大帅哥啊
221345,1056,周清志,2025-06-23 04:11:07,0,0,0,老师年轻的时候肯定很帅\n\n上课的时候会放养本来就会游泳的同学 可以提前溜走(划掉)\n\n最后专项给分也不错  最后一节课还会有竞速游的加分
51584,1089,郭怡,2017-07-03 03:40:25,0,0,0,激情！！浙大人文学院的老师都是很好的老师！！
51924,1089,郭怡,2017-06-13 15:05:59,0,0,0,第一节课就被圈粉！
52608,1089,郭怡,2018-08-26 05:08:32,0,3,3,大学以来最棒的一次通识！老师讲课很棒，很好玩，听他的课是一种享受，真正的会了解知识。老师还会带学生出去参观！事少有趣！
73175,1089,郭怡,2018-02-01 05:47:01,0,1,1,很棒的老师呀
23380,1120,陈胜,2016-03-28 05:37:41,-4,3,7,讲课很有气质
23605,1120,陈胜,2018-09-14 02:08:40,2,7,5,还行 分数给的高
29103,1120,陈胜,2016-06-29 08:40:18,-5,3,8,第一次选跨校区的课哈哈哈感觉很值。老师讲课慢条斯理的很有文人的感觉(˶‾᷄ ⁻̫ ‾᷅˵)
36720,1120,陈胜,2016-11-15 13:46:40,5,7,2,老师讲得挺仔细的，留学生可以学到很多，但是对于中国学生来说有些简单了，我个人给分还是不错的
49927,1120,陈胜,2017-04-27 08:50:02,0,5,5,老师的课很好，但是给分很坑。我上课点名都到了，论文也认真写了，最后给80分？？？一门通识课啊，老师到底要多高的论文要求？！
77813,1120,陈胜,2018-05-08 02:44:14,1,2,1,虽然有些观点我不太认同，但是老师讲的真的很有水平
81863,1120,陈胜,2018-07-06 10:27:07,2,3,1,老师人很好，可惜给分略低，上课内容过于简单
81979,1120,陈胜,2018-07-06 16:43:35,10,14,4,每节课签到点名，论文写得那么认真，听学姐说最高就给4.2还不信，现在真的信了?
86174,1120,陈胜,2018-09-10 01:58:07,94,98,4,我就想问吴广在哪里
93969,1120,陈胜,2019-01-14 13:38:26,1,1,0,很有收获的一门课\n\n老师讲的很好很有趣
96566,1120,陈胜,2019-01-21 06:36:53,0,1,1,课程内容中规中矩 老师讲得挺有意思 给分还行 平时签到 没有考试 期末一篇论文 认真写的 内容一般 最后3.6 已经很满意了
96568,1120,陈胜,2019-01-21 06:37:58,1,2,1,课很水很水。不过老师是真的挺好的，温文尔雅~文人的气质~一些观念我还是很赞同的。。。至于给分，不知道4.2是不是最高了？\n\n
96583,1120,陈胜,2019-01-21 06:58:01,2,2,0,绩点偏低啊……
97599,1120,陈胜,2019-01-22 11:49:44,5,5,0,讲的不错很有收获。。。\n\n就是给分。。。。\n\n我之前还不信这个邪。。。没想到真的给分很低emm
105178,1120,陈胜,2019-04-06 05:54:25,21,22,1,吴广老师今何在？
110441,1120,陈胜,2019-06-26 16:13:53,1,2,1,给分低的朋友们是不是……漏了一个作业啊？老师并没有最高只给到4.2啊？毕竟是通识课程大家主要就当普及知识吧，老师讲课听着挺舒服，有一些有趣的可以记下来～
110604,1120,陈胜,2019-06-27 15:07:41,2,4,2,没啥意思，很多观点都有些浮浅，感觉老师的知识东拼西凑，不成体系。\n\n给分差。
137866,1120,陈胜,2021-07-06 12:39:13,-4,1,5,垃圾，绩杀，每节课都签到了，实践也认真实践了，最后3.3，无语
138468,1120,陈胜,2021-07-09 10:48:01,1,3,2,u1s1 老师是真的好老师。上个学期每节课都有签到，都有去上课，但是可水，本人上个学期上课没听过，作业有一次去万松书院和一篇论文（我是百度百科自己家乡的文化）论文水过去的，最后给了4.5。推荐这门课。
155733,1120,陈胜,2022-06-15 11:54:26,-10,0,10,听说最高4.2？我4.2是该高兴吗哈哈
173267,1120,陈胜,2023-05-17 08:15:48,-1,0,1,在上老师的教育名著导读！\n\n讲的好棒！学到了很多！
175522,1120,陈胜,2023-06-25 10:30:43,1,1,0,教育名著导读，把古代学者细碎的教育观念讲的很有体系，上课的时候旁征博引，看得出来老师真的学富五车而且对中国传统教育有着很大的热情，特别吸引人的课
184777,1120,陈胜,2023-12-22 15:31:15,0,2,2,传统文化教育｜老师很儒雅，讲课很有趣。一个实践一篇论文，最后轻松满绩
187519,1120,陈胜,2024-01-16 12:26:24,2,2,0,老师很儒雅很有学问的感觉
194631,1120,陈胜,2024-06-24 17:15:22,4,4,0,今天出分4.8，感谢老师。作为一门通识课我觉得它既做到了传授知识，又做到了不难为学生。上课可听可不听，到了就行，作业一篇实践报告(春游体悟加百度百科)和一篇论文(回忆了自己家乡独特的风俗和小吃加百度百科介绍)。整体来说很轻松。老师是个好好先生的感觉，很温和健谈(虽然有些观点让人不是很赞同哈)
194646,1120,陈胜,2024-06-25 00:38:56,14,14,0,2024了，评价也该更新更新了。\n\n首先作为一门通识课，一篇纸质论文（50%）和一篇纸质报告（20%-30%）负担极小。论文写与本课程有关的，字数不少于3k。考察报告只需要去某个带“文化”的地方拍几张照片写几句话即可，不需要写得太复杂。以我个人经历，由于补选进来没补第一节课，写了论文没写考察报告，在最后一节课得知还需要写一篇考察报告，立马动用了压箱底的滕王阁参观照片再配合上几句话，用一节课时间做完去打印，甚至还能在课上完之前交，最后分数也不低（4.8以供参考）。\n\n其次作为一门通识课程，纸质点名的次数十分频繁，本学期就一两次没点名，有一次还是口头点名。所以建议选这门课的同学尽量去现场听课，哪怕不听老师讲，自己做自己的事还是可以的，就是别坐前排就对了，因为老师还是会和同学有些小互动的。\n\n最后，这门课作为一门通识课其实并不足以承载十分庞大的知识量，只能作为粗浅的了解，如果只是想简单了解的话，大可以去听听老师讲的汉唐盛像等等，但如果是真的想深入学习的，那我想作为一门通识课它不一定会满足你的预期。\n\n总结：上课点名，一篇3k字论文和一篇实地考察报告，给分好，课程轻松，适合想水过去的人。
194909,1120,陈胜,2024-06-26 02:01:38,2,2,0,老师真的很儒雅，他不在意你是否会一直认真听课，只要能够吸引你片刻就足够了。很有古代文人的气息。作业认真写，上课要纸质点名，绩点4.5。\n\n4
220262,1120,陈胜,2025-06-17 03:44:24,2,2,0,事不多，给分好，推荐
222075,1120,陈胜,2025-06-29 12:05:33,0,0,0,中国传统文化与教育，事情少，给分高。讲课很有意思，可惜没人听
24951,1151,郑芳,2016-05-04 12:01:02,-2,3,5,老师喜欢读政府文件，人很好
30204,1151,郑芳,2016-07-01 05:17:06,0,4,4,上课学不到什么东西，给分还很差！
30277,1151,郑芳,2016-07-01 07:21:38,-2,3,5,什么渣渣老师？我想问她怎么给分的？
31063,1151,郑芳,2016-07-03 07:35:51,0,3,3,没有平时作业，不点名。老师也不爱和同学们交流，随随便便打成绩。遇到这样的老师简直了。
32121,1151,郑芳,2016-07-05 16:05:00,0,5,5,从来不点名，讲课会引导大家思考，还挺有想法的
38045,1151,郑芳,2016-11-23 13:34:18,-1,1,2,老师人很好 课堂参与多了给分就高
50836,1151,郑芳,2017-05-06 08:22:35,0,1,1,挺水的，上课没什么内容
55228,1151,郑芳,2017-07-01 04:45:19,1,1,0,上的社会调查研究 老师很负责 虽然平时事情多得要死 但是收获也不少 而且给分超好啊！
103652,1151,郑芳,2019-03-03 19:08:40,0,1,1,还行吧
135085,1151,郑芳,2021-04-29 14:23:34,7,12,5,评论下面说老师不愿意和学生交流的 我想问问是否是自己的原因 说老师给分差的 也应该好好反省自己 郑老师和我说过：“学会和老师沟通，也是个体社会化的过程”。 老师课程评价中的“不只是体育概论老师 更是体育人的引路人”是本人留下的 跟着郑老师学的的确不只是体育知识 十分我打在这了 再次感谢郑老师 与课程分数无关。 铭记您的话：“一旦选择便义无反顾往前走”
153300,1151,郑芳,2022-04-28 00:10:49,2,2,0,好老师，会启发和引导你思考，而不是一味地把知识点塞给你。
155385,1151,郑芳,2022-06-12 03:40:42,0,0,0,无语了
159512,1151,郑芳,2022-07-30 01:29:06,1,1,0,讲东西有水平，但是给分不靠谱，乱给
174426,1151,郑芳,2023-06-12 06:09:25,0,0,0,好老师 引发我很多思考 对体育的认识不止是体育 超喜欢她 以后还选您的课
197010,1151,郑芳,2024-07-06 15:23:41,0,0,0,666
184236,1159,单亚萍,2023-12-13 14:08:24,-1,0,1,人挺好的，有时候会比较凶，给分还行
29847,1172,吴华,2016-06-30 11:43:31,3,3,0,老师很有自己的立场，很强调逻辑。民办教育领域的权威
29879,1172,吴华,2016-06-30 12:48:21,1,1,0,学到很多
2082,1203,肖朗,2015-04-01 08:48:25,5,6,1,很棒很可爱
10022,1203,肖朗,2015-11-14 11:19:10,10,11,1,旁征博引，还很可爱\n\n
31204,1203,肖朗,2016-07-03 11:14:33,4,5,1,老师人挺好的，只是…我真的不喜欢教育史啊
48134,1203,肖朗,2017-03-13 01:41:11,3,4,1,上课娓娓道来，有板书，很不错，但是下课会在走廊抽烟，这有点不太好。等互相之间脸熟了，他在路上见到同学会主动说“你好”
61744,1203,肖朗,2017-11-20 13:33:36,16,16,0,教育名著导读课程打卡。虽然是短学期的课，仍然是由两个老师来上。\n\n肖朗老师上中国的教育名著，是一个很可爱的老头，非常和蔼，上课氛围轻松，不过听说在正经学术上很严。XD \n\n王慧敏老师是一个较年轻的老师，讲课语速快，思路清晰，幽默风趣，PPT上的内容都是自己思想的概括(和肖老师的PPT内容不是一个风格～) 王老师很有自己的想法，也愿意和同学交流，他回复你的邮件都是满满一大框噢。\n\n总之强推教育名著导读这门课，一片有自己思想融入其中的读书报告就可以啦。毕竟读了名著，总会有感悟的对吧? \n\n〈( ^.^)ノ\n\n
61746,1203,肖朗,2017-11-20 13:36:57,10,10,0,老爷子学识超渊博，成天乐呵呵，深入浅出，一点不无聊。
77819,1203,肖朗,2018-05-08 03:32:59,0,1,1,上完了肖爷爷的最后一门课，还是蛮喜欢肖老师的，上课内容很丰富，只是内容较为枯燥。
89768,1203,肖朗,2018-11-20 16:35:11,1,2,1,肖老师是很可爱的老爷爷\n\n上课可能会枯燥一些，但是人还是很可爱的，因为是研究中国教育史的，所以上的教育名著导读会有点像历史课，但老师还是会补充很多历史上的知识点，让我们更好地去理解古代教育家的教育思想
93971,1203,肖朗,2019-01-14 13:50:17,5,5,0,肖爷爷人很好的，据说肖爷爷不用手机，只用邮件，也算是某种大隐隐于市了
113480,1203,肖朗,2019-07-06 18:10:43,4,4,0,肖爷爷有种真才实学老教授学者的气质 上课爱用板书  说话娓娓道来 仿佛一个沉迷历史的倔强小老头
115525,1203,肖朗,2019-08-01 08:54:38,5,6,1,专业，旁征博引，引经据典，大家风范。肃然起敬的老师。
129512,1203,肖朗,2021-01-06 12:16:04,6,6,0,学者之风 娓娓道来
136098,1203,肖朗,2021-06-11 02:38:27,3,3,0,像个学者，上专业课很舒服，会科普一些知识
162429,1203,肖朗,2022-11-22 07:40:12,0,0,0,肖老头超可爱的，讲课也超有趣。
53974,1222,王健,2017-06-28 06:39:17,0,0,0,儒雅的系主任!\n\n
116322,1222,王健,2019-09-08 09:48:45,0,0,0,很好的老师
127100,1222,王健,2020-11-07 10:35:56,0,0,0,博文笃学之典范
137818,1222,王健,2021-07-06 08:40:18,0,0,0,非常好
181,1248,吴剑,2015-03-14 16:27:35,1,12,11,太极拳挺好玩的
4088,1248,吴剑,2015-06-17 16:38:52,4,10,6,挺认真的
13635,1248,吴剑,2015-12-30 07:24:46,5,10,5,拳击散打课很耐心。人特别好 最后一节课才开玩笑的点名～
16689,1248,吴剑,2016-01-18 19:22:58,19,21,2,认真参与收获不少
17004,1248,吴剑,2016-01-19 12:18:44,-3,1,4,心好塞\n\n
26691,1248,吴剑,2016-06-21 02:19:59,25,35,10,保健科为什么不可以给高一点i
27744,1248,吴剑,2016-06-27 10:39:40,0,6,6,拳击与散打课比较注重训练，上课讲解的很清楚，课上完会有一些体能训练，给分不错的～
28891,1248,吴剑,2016-06-29 02:47:49,1,3,2,超喜欢老师的拳击与散打
37789,1248,吴剑,2016-11-21 05:18:59,4,6,2,特别和蔼的老师\n\n
38210,1248,吴剑,2016-11-27 03:54:45,1,2,1,太极，还挺好玩
39337,1248,吴剑,2016-12-22 06:20:49,3,5,2,很好啊，人也挺好的上课也很好。
41871,1248,吴剑,2017-01-13 06:09:30,1,2,1,太极拳课好累噢。。（（老师很和蔼
45019,1248,吴剑,2017-01-19 00:00:14,3,9,6,太极拳要稍微用点心学，平衡性和柔韧性好一点的人比较容易。要参加比赛有点烦，还得买鞋买服装。不参加的人不买也行，不过据说要另外考试。专项分在75-92之间浮动，想挂不容易，想满也不容易
46393,1248,吴剑,2017-01-21 12:53:15,3,4,1,老师挺好的
54859,1248,吴剑,2017-06-30 10:33:14,1,3,2,好老师。
58621,1248,吴剑,2017-09-10 08:18:23,7,10,3,欢迎加入浙江大学普通生武术队。
64528,1248,吴剑,2017-12-25 02:56:46,2,3,1,老师超级好呀(๑• . •๑)
64908,1248,吴剑,2017-12-28 02:15:49,3,4,1,老师人超级好的，很温柔，有时候还会跟你开玩笑
66772,1248,吴剑,2018-01-19 03:24:19,4,5,1,认真负责，和蔼可亲，教的不错。太极拳专项成绩是比赛的时候评委评的成绩，老师也会有适当加分，所以给分公平合理，挺好的。
66903,1248,吴剑,2018-01-19 08:44:49,9,14,5,老师很亲切很细心很认真，是个好老师。ps：对这门课程的建议：最后的专项考试为什么最低89最高91呢？为什么不能最高99最低96呢？
66950,1248,吴剑,2018-01-19 12:11:23,0,1,1,太极拳成绩引体向上十分很重要，男同学们注意了。然后老师在前面打太极拳我是很难看到的，还不如网上学。
74874,1248,吴剑,2018-03-06 07:36:54,10,13,3,竟然是女老师……不过看上去好和蔼
79915,1248,吴剑,2018-06-15 07:00:41,15,17,2,浙大经典:吴老师的微笑\n\n
79918,1248,吴剑,2018-06-15 07:44:27,5,8,3,老师很温柔！！！上课也很好，就不知道给分怎么样啦 \n\n
81226,1248,吴剑,2018-07-04 10:48:47,7,11,4,老师很温柔，给分公正，考试就是打一套拳，专项分差距不大。推荐怕热的同学春夏学期选太极拳，教室凉快～
92460,1248,吴剑,2018-12-29 07:42:28,7,10,3,上的是太极拳初级班，老师真的超级超级好呀！非常非常温柔der~而且秋冬学期可以报集体比赛算作专项分，又可以拿二课，福利实在太好了，强推！！！
95801,1248,吴剑,2019-01-20 05:26:36,4,4,0,拳击与散打的老师，人特别负责任，脾气也很好。而且偶尔还会讲笑话嘻嘻
95910,1248,吴剑,2019-01-20 08:10:00,9,14,5,引体向上不好的男同学千万别选这门课，不然你的满分就只有90分，在东扣西扣未必能到八十分。同学们慎重。
104186,1248,吴剑,2019-03-13 15:04:46,-6,1,7,给分迷
108805,1248,吴剑,2019-06-03 00:25:08,20,20,0,温润儒雅的老师，有货而低调。
110770,1248,吴剑,2019-07-03 01:27:01,4,4,0,很轻松
120260,1248,吴剑,2019-11-26 10:48:22,5,5,0,老师同我们非常好，上课方式也很好，教的很耐心，很喜欢太极拳课
120952,1248,吴剑,2020-01-19 01:29:01,15,18,3,温柔与严谨并存。
124194,1248,吴剑,2020-06-28 05:51:04,0,3,3,双标。
129199,1248,吴剑,2020-12-31 06:06:25,10,10,0,我好喜欢吴剑老师 想每个学期都上太极拳初级hh但是这学期没选上（落泪了
130717,1248,吴剑,2021-01-24 11:09:41,8,8,0,不错不错  下学期还是她
132790,1248,吴剑,2021-02-03 15:14:57,6,7,1,吴老师超级温柔！每星期课前会跟同学们讲学期里关于体育的重要事项，主动帮没选上体育课的同学补选中级班，最后一堂课除了太极拳外还教了我们健身气功～\n\n后个学期想来上您的太极拳中级班(´-ω-`)
139591,1248,吴剑,2021-07-18 00:30:13,11,13,2,超级温柔超有气质的好老师！此生无悔太极拳*v*！yyds！
145441,1248,吴剑,2021-12-29 14:28:27,11,11,0,好喜欢吴老师，真的很和蔼而且教动作也很认真，网课期间特意为了照顾我们活动空间小，自己也找了个小房间说这样才能和我们活动空间一样。课上事情稍微有点多但不过都是听讲座之类的都很水的
147407,1248,吴剑,2022-01-10 02:50:52,13,14,1,上的是吴老师的身体素质课，不得不说，很硬核，但是对学生很好！人也和蔼可亲
149897,1248,吴剑,2022-01-17 15:31:29,16,16,0,比较严格
152688,1248,吴剑,2022-04-18 10:50:20,-17,2,19,千万别来\n\n体素\n\n太脑瘫了\n\n课后签到\n\n不给打卡\n\n做一些很奇怪的身体素质
153529,1248,吴剑,2022-05-04 00:16:06,14,15,1,人温柔，讲课又认真
154015,1248,吴剑,2022-05-19 06:26:51,7,18,11,太极拳事情真的太多太多太多了。\n\n慎选！！
154078,1248,吴剑,2022-05-22 15:17:41,0,5,5,太极拳破事太多，消息已读不回
161016,1248,吴剑,2022-10-23 16:33:44,8,11,3,老师很认真负责，身体素质课很充实
164499,1248,吴剑,2022-12-21 09:29:40,-13,3,16,体素课没得选了才选了吴老师。上了课发现，其实老师人挺好，但是要求多，认真做有点累的。不过课后签到很好，后来就直接上课打卡或者不来，下课时间混进去签个到就走
167018,1248,吴剑,2023-01-14 15:36:46,-35,3,38,垃圾大学写作，给分超低，而且不说明白。
171273,1248,吴剑,2023-03-20 10:15:51,-10,3,13,无语了体素
172439,1248,吴剑,2023-04-27 02:36:56,39,40,1,吴剑老师性格温和，上课的时候总是给我们看一些演讲视频并在观看视频的过程中给我们讲解视频里的甲骨文。休息时间，老师也会跟我们聊天，融入学生的生活日常。在吴剑老师的课，我们从来不会感到尴尬，更不会感到疲惫。每天每天，我们都很期待上吴剑老师的课！
185788,1248,吴剑,2024-01-04 11:43:10,17,18,1,给吴老师发邮件，她给我回邮件竟然还祝我学业进步。非常好的老师，一定要给10分
193257,1248,吴剑,2024-06-05 08:39:27,-27,4,31,大学写作丶人，根本和对于人的写作一点关系没有！讲的是如何写文献综述和读书报告，对于学生的文学素养和写作素养一定帮助也没有，只觉得浪费时间。。
194225,1248,吴剑,2024-06-22 15:45:45,22,32,10,好像两个有吴剑老师混在一起了…这个应该是上大学写作的吴剑老师。老师人挺儒雅温和，交流体验良好，也算有一定收获。一篇读后感+一篇文献综述的内容量尚可，但文献综述的小组合作挺容易遇雷的，一旦组内有人摆了就任务就很难进行下去
194292,1248,吴剑,2024-06-23 06:54:53,35,37,2,老师完全称得上良师益友，但大学写作课程确实就是史，实在屈才
198027,1248,吴剑,2024-08-25 14:32:50,22,22,0,很有人文情怀的一位老师，交流体验感非常好。
201072,1248,吴剑,2024-10-28 06:56:25,-11,1,12,慎选，上课超级超级累，一分钟都休息不了
207199,1248,吴剑,2024-12-19 17:03:40,10,10,0,【身体素质】身体素质课很好。基本上是上课先快走再小跑两个小圈（加起来400m不到），然后做从头到脚拉伸的热身运动，最后做一些简单的训练（跳远训练，跳绳梯，跳绳等）。内容很丰富但是简单，比较轻松，身体不舒服在旁边见习就好好像没有区别打分。没有签到只有签退（每次，现场），课比较水，还是很推荐的
207430,1248,吴剑,2024-12-21 14:19:55,11,11,0,——爱——
207790,1248,吴剑,2024-12-24 09:25:38,11,11,0,吴老师人很好，很真诚，但是小组合作就是难评，遇到蠢货就完蛋了
209296,1248,吴剑,2025-01-05 10:58:02,9,9,0,吴老师人特别好。真的超级好超级温和的一位老师为吴老师打Call
213432,1248,吴剑,2025-01-17 10:14:13,9,9,0,每节课都是干货，但对我这种小白来说有点亚历山大……小组作业有点坑，遇到不负责的组员直接两眼一黑\n\n吴老师人非常和善，说话很温柔儒雅，也会在课间和我们闲聊关心同学们，最后给分也很好，10分送上！
213967,1248,吴剑,2025-01-22 07:39:45,9,9,0,大学写作课\n\n吴剑老师本人是非常儒雅的，语气态度都很温和，上课内容主要是学习和写作读书报告、文献综述，会给出规范的格式。老师给分也很高\n\n但是不得不说，大学写作课的名字取得就有问题。大学写作 人 中的“人”指的是人文文化而非描写人物，很容易误导同学们（比如我）
214083,1248,吴剑,2025-01-23 14:14:04,9,9,0,9分好老师
215334,1248,吴剑,2025-02-25 07:42:25,9,9,0,很好很温柔
221363,1248,吴剑,2025-06-23 05:13:45,1,1,0,太极拳 课好 老师好 我在浙大体艺上的跑步次数遇到问题去询问老师，老师非常热心的帮我问了办公室😃
221429,1248,吴剑,2025-06-23 11:15:17,1,1,0,老师和蔼可亲，认真细致
23608,1274,王珏,2016-04-09 06:02:31,-28,3,31,好开心！！
36281,1274,王珏,2016-11-11 13:14:40,21,22,1,不好啊
49867,1274,王珏,2017-04-26 15:09:55,21,23,2,不好听   婆婆妈妈的  太能扯了
49868,1274,王珏,2017-04-26 15:10:03,33,37,4,听说是老处女....很拉闸
49869,1274,王珏,2017-04-26 15:10:20,22,22,0,脾气暴躁 莫名自信
51424,1274,王珏,2017-06-05 09:16:18,31,35,4,讲个鬼故事，看这个老师的给分...
55309,1274,王珏,2017-07-01 08:47:09,30,30,0,非常杂耍的老师
60962,1274,王珏,2017-11-05 13:21:30,21,22,1,脾气太暴躁
66100,1274,王珏,2018-01-11 15:19:46,23,23,0,滔滔不绝 信口开河
78051,1274,王珏,2018-09-06 09:01:00,20,33,13,作业被助教搞丢，我重新交算我迟交。我从哪里给他找邮件记录？不是孤例，班里一半人的作业都没了。
79219,1274,王珏,2018-05-27 12:57:02,30,30,0,每次上课永远是“浙江我TM吹爆”“杭州我TM吹爆”“有没有浙江的同学”“有没有杭州的同学”四个内容
80797,1274,王珏,2018-07-01 07:23:11,13,18,5,666
80823,1274,王珏,2018-09-06 09:00:11,-27,7,34,给五分是因为这个世界需要善意。这助教水平能够在浙大？盲目自我，对群众意见充耳不闻，自我错误也完全没有认知，还以此惩罚受其影响的学生。以及老师在考试的时候还叽叽喳喳的真是太烦了。
80834,1274,王珏,2018-07-01 16:04:03,26,27,1,老师您好，老师再见
83022,1274,王珏,2018-07-09 13:32:18,22,23,1,看这个老师的给分心里应该有点13数了呀！！！
83023,1274,王珏,2018-07-09 13:33:33,20,20,0,看均绩
83230,1274,王珏,2018-07-10 03:05:35,20,21,1,愚蠢至极。分真低
85061,1274,王珏,2018-07-15 07:49:49,20,20,0,打一分一点也不多
102632,1274,王珏,2019-02-15 07:52:21,-21,0,21,感觉挺好的呀
110087,1274,王珏,2019-06-22 12:05:36,-18,0,18,没体验
112159,1274,王珏,2019-07-03 17:56:12,18,18,0,。能退就退。
115603,1274,王珏,2019-08-07 15:15:09,-18,0,18,ббб
118388,1274,王珏,2019-10-26 06:58:11,14,14,0,...
120764,1274,王珏,2020-01-16 19:49:50,-12,2,14,组长貌似分会高一点？我绩点3.9，没有缺勤迟到。就感觉，马马虎虎吧。讲课（当然这课本来也没什么好讲的）不算差，但也没什么特别好的地方。上课不让做别的事情，有条件的同学还是选一个更轻松一点的老师吧 。
122987,1274,王珏,2020-04-27 18:37:45,16,16,0,有点意思
164541,1274,王珏,2022-12-21 14:16:24,0,0,0,王珏王珏真tm绝绝
574,1293,沈莉萍,2019-01-23 07:29:58,14,214,200,绩杀 不解释
607,1293,沈莉萍,2015-03-15 06:50:59,9,34,25,有两个沈莉萍啊，一个教大化实验的，一个教军理的，可悲的是这俩人课我都上过。。。大化的比较普通，给分也挺合理，军理的是个话唠，给分。。。。
1562,1293,沈莉萍,2015-03-22 14:25:20,3,5,2,讲课还行\n\n
1593,1293,沈莉萍,2015-03-23 00:50:14,7,13,6,两个沈莉萍……该改改了
1703,1293,沈莉萍,2015-03-23 10:30:29,10,53,43,绩杀不解释！
1715,1293,沈莉萍,2015-03-28 14:00:14,0,3,3,讲得还不错的
2843,1293,沈莉萍,2015-05-08 13:42:55,8,56,48,绩杀妥妥的！！军理一定别选她嗷嗷嗷
3331,1293,沈莉萍,2015-06-02 11:04:52,6,9,3,大化实验的沈莉萍不错，稍微有点严。
3765,1293,沈莉萍,2015-06-17 03:42:48,11,61,50,绩杀
3891,1293,沈莉萍,2015-06-17 07:35:32,3,33,30,军理：沈丽萍一生黑
3950,1293,沈莉萍,2015-06-17 10:59:38,5,28,23,绝对大绩杀
4289,1293,沈莉萍,2015-06-18 15:03:45,-4,3,7,千万千万不用上化学的沈丽萍的课，太TM坑！
4369,1293,沈莉萍,2015-06-19 14:47:40,13,43,30,化学的还好吧，反正实验是跟助教接触比较多，助教人很好，老师一般般；\n\n军理沈莉萍，据说专业绩杀好多年，这学期在修求保佑〒_〒
5330,1293,沈莉萍,2015-07-06 16:52:22,23,125,102,俩沈丽萍，一个绩杀，一个老骂人…妈妈问我问什么跪着哭系列QAQ
5636,1293,沈莉萍,2015-07-09 01:21:19,0,6,6,军理的沈莉萍上课其实还行…这学期求保佑。。刚巧大化G也是slp只想说…上课这么凶干什么啊摔！班里有个女助教也超凶！都说G给分比O好…可是我的G比O低了6分
6206,1293,沈莉萍,2018-03-07 02:37:15,20,162,142,军理的简直大绩杀，本来我不信的，作死选了她结果…
6209,1293,沈莉萍,2015-07-12 04:34:17,11,51,40,超级绩杀，嘴上一套，行动一套。
6210,1293,沈莉萍,2015-07-12 04:58:21,12,45,33,绩杀啊。简直了。军理一出均绩被拉了接近0.2
6215,1293,沈莉萍,2015-09-15 09:45:10,15,87,72,没缺过课，论文认真写，绩点仍然惨不忍睹，绩杀不解释，我说军理
6239,1293,沈莉萍,2015-07-12 09:07:05,7,34,27,绝对的绩杀！！！考试感觉都找到了书上原话，分还是那么低！！！\n\n
6377,1293,沈莉萍,2015-07-13 10:49:10,14,93,79,绩杀。论文要手写。你说你给分低就直接说你标准比较高呗或者别说话，非要说会尽力给大家高分，结果……呵呵……简直满嘴跑火车即视感。
6398,1293,沈莉萍,2015-07-13 14:46:04,4,22,18,大绩杀啊啊啊啊啊啊啊！！！！慎选！！！！
6493,1293,沈莉萍,2015-08-15 07:55:15,2,4,2,绩杀
6836,1293,沈莉萍,2015-07-24 01:30:41,0,22,22,老师课讲的还不错，只是我没有认真听过，至于绩杀不绩杀我觉得还是要靠自己不要抱怨老师
6900,1293,沈莉萍,2015-08-05 05:05:42,1,7,6,还好
7198,1293,沈莉萍,2015-09-10 10:38:48,5,14,9,傻逼老师 毁我青春
7318,1293,沈莉萍,2015-09-13 11:40:59,1,13,12,？。。。。真心坑
7518,1293,沈莉萍,2018-06-20 18:41:39,2,19,17,大绩杀，不解释
7658,1293,沈莉萍,2015-09-15 07:41:45,-2,0,2,呃呃呃呃
7676,1293,沈莉萍,2015-09-15 08:29:04,1,13,12,选课后才知道寄杀。。。但最后分数还不错。认真做的话成绩也会好。估计水的人比较惨
8239,1293,沈莉萍,2015-09-17 16:02:13,-2,5,7,讲道理的话还阔以
8550,1293,沈莉萍,2015-09-22 08:27:31,3,14,11,绝对绩杀
8551,1293,沈莉萍,2015-09-22 08:27:45,2,25,23,绩杀绩杀绩杀绩杀绩杀绩杀绩杀绩杀绩杀绩杀绩杀
8782,1293,沈莉萍,2015-09-27 02:39:07,-1,5,6,感觉还好吧......给分也还好啊.....
9070,1293,沈莉萍,2015-10-12 06:03:10,3,11,8,真坑，讲的也不好，别选
9843,1293,沈莉萍,2015-11-11 03:23:07,0,7,7,大绩杀
10005,1293,沈莉萍,2015-11-14 07:25:05,1,3,2,还可以吧
10599,1293,沈莉萍,2015-11-20 12:48:49,2,5,3,还不错，比较水
11213,1293,沈莉萍,2015-11-25 08:15:49,11,53,42,现在听到这个名字我的心还会颤抖一下
11351,1293,沈莉萍,2015-11-28 07:33:03,-1,0,1,。。。。。。
11597,1293,沈莉萍,2015-12-07 08:32:52,3,11,8,绩杀不解释
12938,1293,沈莉萍,2015-12-24 11:02:23,-1,8,9,骗子绩杀我军理
14028,1293,沈莉萍,2016-01-04 01:20:59,0,3,3,没听过
14589,1293,沈莉萍,2016-01-08 01:24:00,-35,6,41,军理点名才会去，论文在课上写的，期末就刷了一下题，最后还是上4了，你们是有多弱鸡。
14785,1293,沈莉萍,2016-01-09 06:15:14,0,6,6,个人观点，绩点杀手可能绩点评估在3.5以下甚至。。。军理2015年春为手写论文加考试，手写摆明字首先要好看(因为我们是知网搬运工)，很多人死在这里了吧？
15232,1293,沈莉萍,2016-01-13 02:19:06,1,2,1,大化G的沈莉萍还可以的，反正和助教接触较多，助教好玩，哈哈
15259,1293,沈莉萍,2016-09-18 01:53:34,-51,11,62,平时就刷了一下题。期末就上4了 你们是有多弱鸡
15554,1293,沈莉萍,2016-01-15 10:17:49,1,11,10,军理深莉萍绝对绩杀不解释，反正她的课从没听过。
15769,1293,沈莉萍,2016-01-16 08:46:01,-2,3,5,我说的是军理的，课没意思，给的成绩还特别烂，一副假惺惺为同学们的样子，现在回想起来还恶心想吐
15996,1293,沈莉萍,2016-01-17 02:21:41,1,11,10,绩杀绩杀绩杀 到现在最低分的一门课仍然是她的军理 从未被超越
16091,1293,沈莉萍,2016-01-17 07:39:57,-3,8,11,不知道为什么说绩杀。。。我和室友都上4了
16428,1293,沈莉萍,2016-01-21 09:51:39,3,9,6,哎，千古绩杀，唯此人是也，如果选上了，赶紧退吧
16789,1293,沈莉萍,2016-01-19 03:24:36,7,9,2,大化实验 人蛮好的 喜欢跟她搭话 还有李强助教李博士人无敌棒 找他聊天问问题都超好
16800,1293,沈莉萍,2016-01-19 03:57:45,2,7,5,是年少无知的我心里最大的痛……
17468,1293,沈莉萍,2016-01-20 09:02:00,-1,1,2,绩杀啊
17681,1293,沈莉萍,2016-01-20 15:40:16,0,1,1,我觉得很好啊
17847,1293,沈莉萍,2016-01-21 02:35:02,-15,7,22,军理哪里绩杀了，老师给的分很高好不好。
17901,1293,沈莉萍,2016-01-21 03:40:18,0,18,18,大绩杀啊大绩杀，军理上课认真听，论文好好写，考试时答案都找到了，本来以为满绩了，结果呢？？只有70多分！！大绩杀，太绩杀了
17902,1293,沈莉萍,2016-01-21 03:40:51,4,16,12,军理绩杀不解释。一直说给高分给高分然后都认真做了绩点还是惨不忍睹……没错军理是我最低的绩点……谢老师不挂之恩！哭
17918,1293,沈莉萍,2016-01-21 03:59:42,1,2,1,感觉就这样..反正军理一点五无关大局
17926,1293,沈莉萍,2016-01-21 04:09:10,4,23,19,绩杀无力吐槽，论文B+，考试答案基本找到了，结果77分，那些说刷题了分数就很高的，你为了一门通识课刷题有意思？还有平时说的给分会高不能信
17932,1293,沈莉萍,2016-01-21 04:18:38,2,17,15,想打0分的。
17946,1293,沈莉萍,2016-01-21 04:37:58,-4,1,5,军理沈丽萍，真不愧是绩杀，这种人的课，慎选。选了一定后悔
17953,1293,沈莉萍,2016-01-21 04:43:34,-3,2,5,军理沈丽萍\n\n看到我的成绩跟吃了屎一样 呵呵
17968,1293,沈莉萍,2016-01-21 04:57:02,-2,4,6,本学期最差的一门课 考试自己认为起码可以拿85 结果成绩出来惨不忍睹
17969,1293,沈莉萍,2016-01-21 04:58:59,-2,2,4,我本来也是相信自己的主观能动性的，却还是败在了大绩杀手上。。。
17986,1293,沈莉萍,2016-01-21 05:30:20,4,6,2,大大大大大大大绩杀
18024,1293,沈莉萍,2016-01-21 06:17:46,-1,4,5,上课还是挺不错的听起来很有趣然而!!!大绩杀
18068,1293,沈莉萍,2016-01-21 07:18:51,0,12,12,论文a＋ 考试全翻到了提前交卷 得分81 绩点3.6 搞不清楚怎么回事……
18100,1293,沈莉萍,2016-01-21 07:42:46,2,9,7,年轻不信别人说的绩杀，以为能破掉这个魔咒，结果光荣牺牲～每次准时到教室，看了一个月的各频道军事节目，认真考试感觉都找到了原话，然而最后3.6，均绩直接拉下去
18148,1293,沈莉萍,2016-01-21 08:22:30,1,5,4,给分呵呵了。。军理
18195,1293,沈莉萍,2016-01-21 09:09:05,-1,3,4,果然绩杀，非作死不要选
18222,1293,沈莉萍,2016-01-21 09:49:55,-1,2,3,大大大大击杀
18261,1293,沈莉萍,2016-01-21 10:41:33,1,4,3,上课很水，但考试什么的……是绩杀，千万小心
18264,1293,沈莉萍,2016-01-21 10:43:26,-6,2,8,满足于3.6就选选，基本认识的都这个数，勤奋没什么大回报。
18265,1293,沈莉萍,2016-01-21 10:43:58,2,11,9,军理沈讲课还好吧，挺激情有趣的。问她问题都回我了。期末做了一套题，然而基本没考到，最后给了90，4.5绩点，感觉没那么可怕。
18443,1293,沈莉萍,2016-01-21 15:51:05,3,8,5,和其他军理老师相比来说沈老师绝对不算绩杀啊，而且老师讲课还是不错的也挺为学生着想的
18492,1293,沈莉萍,2016-01-21 23:34:18,-3,1,4,讲课还过得去，就是成绩惨不忍睹。只有3.5，考试基本上都找到了原话，本来还以为能拿高分呢。
18656,1293,沈莉萍,2016-01-22 08:41:14,3,5,2,我给大家讲个笑话，军理沈丽萍给我3.6何善蒙给我3.3
18700,1293,沈莉萍,2016-01-22 11:03:59,0,3,3,真心绩杀，活活一门1.5分的课直接让绩点点差不多0.2
18881,1293,沈莉萍,2016-01-22 16:26:42,-2,3,5,她在很久以前的一段时间一直是大绩杀，后来前两年有一次，钻着教务网的空子给学生高分，从那以后，她就按照学期，随机绩杀，有时候给分超好，有时候继续杀！
19546,1293,沈莉萍,2016-01-24 15:27:01,-6,5,11,很nice，不知道为啥这么多人说她军理绩杀，当初考了4.8，觉得这老师实在太好了……
20038,1293,沈莉萍,2016-01-26 02:53:10,0,4,4,大 绩  杀
20580,1293,沈莉萍,2016-01-28 15:11:30,0,1,1,大化的感觉不错就是稍严，给分尚可
20586,1293,沈莉萍,2016-01-28 16:02:51,-2,9,11,军理沈丽萍，讲课好，作业少，给分棒，说她绩杀的人是什么心态，平时论文只占30分，多半是你们自己考不好，还怪人家老师
20772,1293,沈莉萍,2016-01-31 09:48:38,-1,5,6,军理4...但是我大一上的时候只花了半天时间翻了下书准备的，考试来不及也蒙了很多。。所以我觉得老师还是给分裤的
21241,1293,沈莉萍,2016-02-27 10:16:35,1,4,3,超级好的老师，满绩呀
21246,1293,沈莉萍,2016-02-27 12:02:54,-1,7,8,开卷考试至少80，点名全到，最后72，也是没谁了
21273,1293,沈莉萍,2016-02-28 02:23:16,-5,2,7,虽然绩杀，但讲的还不错，绩杀。。。
21324,1293,沈莉萍,2016-02-28 04:26:55,2,6,4,挺好的老师，反正我很喜欢，绩点也还好的
21375,1293,沈莉萍,2016-02-28 10:42:07,-2,3,5,上课语速是有点快的，有些童鞋表示听不懂，其实认真听还是不错的，特别讲朝鲜时讲的很引人入胜啊，说是大绩杀我不太知道别人是怎么样的，但是我的论文写得不好，期末把书认真看一遍做好标签还是上了80的。希望老师以后语速放慢一点吧～
21960,1293,沈莉萍,2016-03-02 02:23:40,-1,1,2,大化o骂声不断
21991,1293,沈莉萍,2016-03-02 04:48:56,-4,0,4,有点无聊，给分一般
22271,1293,沈莉萍,2016-03-03 06:54:55,0,3,3,选她的军理都不要奢望绩点了
22410,1293,沈莉萍,2016-03-04 15:01:02,-1,2,3,挺好的，不是击杀
22461,1293,沈莉萍,2016-03-06 11:45:09,1,2,1,我觉得讲课还是可以的，成绩更多看自己\n\n
22588,1293,沈莉萍,2016-03-08 08:20:00,5,17,12,"超悲催。。这个老师的每句话后面都是""的哇！哈！啊！""说话声音很冲，耳边都是音响快爆炸的声音，半小时以后你就会有想死的冲动。。"
23216,1293,沈莉萍,2016-06-29 11:24:06,5,20,15,老师上课讲的还可以╮(￣▽￣)╭，\n\n可是分数就是硬伤啊，听说是绩点杀手，听课时都没有感觉，觉得挺慈祥的一位老师，，到了考试结果出来之后，傻掉了，传说中的绩点杀手。。。。。\n\n说军理的
23229,1293,沈莉萍,2016-03-22 07:35:46,0,1,1,…………
23321,1293,沈莉萍,2016-03-24 08:10:26,1,4,3,讲的还好，然并卵，成绩是硬伤，她给的绩点绝对会成为阴影，作死选她军理，就做好心理准备。
26091,1293,沈莉萍,2016-06-15 15:28:57,1,2,1,上课总是看一些视频…\n\n讲三十六计…
26510,1293,沈莉萍,2016-06-19 10:55:38,-10,1,11,老师挺好的，我4.8怎么做到的？卷面之前保证95以上
26549,1293,沈莉萍,2016-06-20 05:33:44,-3,1,4,绩杀，不解释
26798,1293,沈莉萍,2019-07-05 04:39:29,-148,13,161,CAONIMEI，YOU ARE MORE THAN A KENGBI!
26835,1293,沈莉萍,2016-06-21 08:52:37,0,3,3,绩杀 无话可说
27224,1293,沈莉萍,2016-06-23 15:43:11,0,10,10,难道我军理上90是意外？…= =为什么大家都说是绩杀…我论文也是一般啊…
29191,1293,沈莉萍,2016-06-29 11:11:07,12,42,30,同时选上胜利瓶，沈燎，孙大演是一种什么体验，……
30159,1293,沈莉萍,2016-07-01 04:11:24,-2,3,5,大四狗12年上的他的军理，没点名，手写论文乱写的，看了半个下午去考最后88。不知道今年咋了，这么惨
30956,1293,沈莉萍,2016-07-03 04:27:41,-3,2,5,感觉老师军理课上的还是蛮好的，就是给分一般般吧~虽然差点刷新本学期新低，但是还好啦。但是给个5结尾我不开心了，再给一分又不会。。。。怎么样
31049,1293,沈莉萍,2016-07-03 07:08:41,1,6,5,学生我们首先应该端正一下态度，真的是付出了多少收获多少
31347,1293,沈莉萍,2016-07-03 16:58:08,2,13,11,那些说绩点低的绝逼都是考场上面现翻书之前不看书的 考场上找不到答案就说老师给分查 考试前看了5个小时的书 重点是第二编 最后90
33149,1293,沈莉萍,2016-09-14 06:28:31,-1,3,4,巨型击杀
33349,1293,沈莉萍,2016-09-18 15:34:53,-3,1,4,军理沈老师的课不先后悔！
33350,1293,沈莉萍,2016-09-18 15:34:22,-6,2,8,相当负责的老师，给分超级好，从不点名，可惜没选她的课
33614,1293,沈莉萍,2016-09-20 09:30:08,-2,0,2,军理不感兴趣 但是讲得挺可以的
33875,1293,沈莉萍,2016-09-22 07:54:12,2,9,7,老师毁我青春啊！大击杀！
33916,1293,沈莉萍,2016-09-23 00:12:52,2,3,1,废话多→_→
34568,1293,沈莉萍,2017-01-16 15:01:03,-1,6,7,没有很杀 至少这学期我和我的两个课友没有一个人下4的 老师也会变的 交代的事情认真做好 考试考高点 总不会故意搞你\n\n信不信当然是你们的自由了 不放心就不要选 免得最后分数不好说是上了评论的当。
35070,1293,沈莉萍,2016-11-01 08:50:57,0,2,2,其实老师上课还挺有趣的啊！听着听着就不想写作业要好好听她讲东西了！也看得出来她备课什么的都挺认真的嘛！这些好的地方还是值得好评的嘛！
38602,1293,沈莉萍,2016-12-11 23:17:18,3,3,0,好老师，rz
39126,1293,沈莉萍,2016-12-21 09:28:27,-3,1,4,不解释
41092,1293,沈莉萍,2017-01-09 06:55:36,-2,3,5,真的绩点杀手
41512,1293,沈莉萍,2017-01-12 05:40:06,-1,2,3,化学实验的沈莉萍老师给分很好，人也很棒！！
43272,1293,沈莉萍,2017-01-16 05:09:33,3,5,2,大绩杀
43446,1293,沈莉萍,2017-01-16 09:42:21,-1,3,4,军理老师人很好，给分也不是太可怕
43451,1293,沈莉萍,2017-01-16 09:46:32,0,4,4,给分不好请不要说自己给分很好可以吗谢谢
43464,1293,沈莉萍,2017-01-16 10:00:46,0,3,3,给分差，上课水
43468,1293,沈莉萍,2017-01-16 10:10:11,6,12,6,来给老师正名，个人觉得上课讲的还是很精彩的，给分也不是过不去，这种课老师点名没到的话影响还是挺大的，期中论文也别水水过，会有收获的。
43470,1293,沈莉萍,2017-01-16 10:11:52,1,7,6,我上的是军理，上课比较水，感觉她讲的有点片面……作业超少，要绩点的就算了不要来了，轻松还是非常轻松的，我3.0
43474,1293,沈莉萍,2017-03-12 16:51:02,1,11,10,还好了，以前不知道，现在不是绩杀了，比较水还拿了4.2，老师还是不错的
43477,1293,沈莉萍,2017-01-17 03:43:53,1,8,7,老师讲课是真的很烂，感觉每节课讲的内容都差不多。给分一般吧，没有期望的高，但还可以接受。
43478,1293,沈莉萍,2017-01-16 10:22:23,4,10,6,不知道为什么那么多人说军理绩杀  选课时没看评价  之后看到吓我一跳  成绩刚刚出来  3.9不高  但是我觉得就我的付出而言  这个分数很厚道了  手写论文写的一般  考试也只是考前看了两个小时的书  所以大家别听那些绩
43481,1293,沈莉萍,2017-01-16 10:31:29,-2,6,8,给分呵呵哒。。。辣鸡老师
43483,1293,沈莉萍,2017-01-16 10:37:11,5,9,4,老师讲的很有激情，虽然听课的人不多。
43491,1293,沈莉萍,2017-01-16 10:53:08,1,5,4,老师其实还是很好的 就点一次名 而且给分其实还好啊
43518,1293,沈莉萍,2017-01-16 15:06:30,-7,4,11,说沈老师是绩杀的要么是论文没有好好写要么就是考试没考好。我上课一节没听过，考试提前半小时交卷，论文自己写的流水账，最后给了我4.2，谁说他是绩杀的？
43525,1293,沈莉萍,2017-01-16 12:28:19,-3,2,5,多看长江新闻号，4.2的绩点，也满意了
43533,1293,沈莉萍,2017-01-16 13:34:16,0,8,8,听课认真，论文4000字，考试翻书原话找齐了，以为满绩，最后76，绩杀，勿选
43535,1293,沈莉萍,2017-01-16 13:36:24,-1,8,9,据说沈丽萍是绩杀，然后吓懵了一帮人，我也吓个半死，于是毅然决然地选择不听课，考前写了个提纲，没想到拿了4.2，不得不说，上四还是很轻松的。
43538,1293,沈莉萍,2017-01-16 13:38:38,-5,5,10,上课全程玩手机，最后4点多绩点，感觉靠人品，而且你们考试有认真翻书么（手动滑稽）
43543,1293,沈莉萍,2017-01-16 14:37:15,-9,4,13,大绩杀，不解释。手写论文5000字，考前认真复习，才86？？？
43546,1293,沈莉萍,2017-01-16 13:46:48,-2,3,5,课堂还好 说话比较快 比较像在吐泡沫...
43548,1293,沈莉萍,2017-01-16 13:50:59,-2,7,9,军理大绩杀，傻子，考试都翻到了尼玛最后成绩笑了，说好平时分会给很高真是放屁！
43549,1293,沈莉萍,2017-01-16 13:54:16,2,8,6,啊啊啊啊太开心了，居然上四了，是什么改变了她？！！
43558,1293,沈莉萍,2017-01-16 14:15:13,0,6,6,说绩杀的都是自己考前不看书 考的时候狂翻吧 其实很多你认为是对的答案都是错的 虽然存在正态 但也不排除自己的原因
43563,1293,沈莉萍,2017-01-18 01:29:47,-2,2,4,真正的听课不如水手机，绩杀
43573,1293,沈莉萍,2017-01-18 05:41:57,7,22,15,勤勤恳恳论文手写6000字 厚厚十面纸从搜集资料 文字成型到手抄花了我三天多的时间 考试周专门抽出一整天时间认认真真看课本 结果只有3.6 我只是想拿一个高一点的绩点 你还能让我怎么做? 真的不懂 求求你告诉我好不好沈老师?\n\n\n\n//你可以绩杀  你可以给分低  但你也不能乱给分啊  评论里1400字论文加考试不复习都能4.2  真的好气啊。
43590,1293,沈莉萍,2017-01-16 14:54:54,-1,5,6,老师根本没有评论里说的那么不好啊…
43613,1293,沈莉萍,2017-04-13 10:32:11,-4,3,7,老师挺好的
43621,1293,沈莉萍,2017-01-16 15:45:14,-1,6,7,这个老师是闭着眼睛打分的，一个巨大无比的坑。妈的智障。
43803,1293,沈莉萍,2017-01-17 03:45:18,2,6,4,感觉还可以吧，上课没听过，期中论文也就写了两千字，考试前一天开始看书翻了一遍基本上书上都找到了，最后?点4.2，没有想象中那么差，难道老师给我分数打错了？上课确实语调不是很能让人有兴趣听的那种，不过如果认真听的话应该还是有收获的。期中论文好好写，，交之前给老师看一遍老师还会给修改意见，不会太差
43804,1293,沈莉萍,2017-01-17 03:46:37,0,5,5,军理上课上成这样还绩杀。是在不太懂这种老师是怎样被招进来的。
43857,1293,沈莉萍,2017-01-17 05:10:03,-1,1,2,没听过，不知道讲得怎么样，但给分还可以
43858,1293,沈莉萍,2017-01-17 05:11:30,0,6,6,军理这位上课其实一般，没有那么差。以为是绩杀所以选上了很恐慌，但是其实给分很不错！！主要看你自己复习如何。不过手写3000字论文_(:з」∠)_
44048,1293,沈莉萍,2017-01-17 08:44:21,1,4,3,老师还是蛮不错的，会讲一些生动的故事，就是语速比较快，一直听下来会有点累，唯一一次点名是在交论文的那节课，就是为了更多的人拿到平时分。成绩也给的不错。
44178,1293,沈莉萍,2017-01-17 11:30:08,-4,2,6,今天看到分数的那一刻我哭了出来，只怪当年作死选了她
44259,1293,沈莉萍,2017-01-17 13:20:23,9,18,9,上课没怎么听因为不太感兴趣 但是论文查了很多资料也认真写了 考试前也花了时间把框架大致理了一遍 标好页码方便找 没有用网上的别人整理的所以印象会深刻点 考试基本上题目找到了 最后绩点4.2 绩杀不绩杀应该不能随便下定论吧
44362,1293,沈莉萍,2017-01-17 16:06:12,3,15,12,不知道上面说绩杀的是不是和我一个老师，大二读的军理，上课没听过，全写实验报告了，讲到感兴趣的会听一会，老师也不点名，很好。其中论文给的时间很足，我写了4000多点字，分数不知。考试开卷，考前复习了半天这样，刷题，看提纲，最后考试大概10分的题不确定。最后总成绩91，4.5。从头到尾我都觉得这个老师很合理，一个老师吃饱了饭一定要把你从90拉到80分？她有好处？\n\n希望喷人的朋友讲道理写评论，军理确实是刷题刷出来的，可是你刷了吗？你有别人刷的多熟练吗？\n\n大一史纲郭汾阳的，3.3，也没这么好说的\n\n技不如人，甘拜下风
44614,1293,沈莉萍,2017-01-18 04:28:14,-12,4,16,不说多，从没听课，唯一的作业只写了1400字，只有考前半小时和考试中翻了书和资料，最终绩点4.2。麻烦各位看老师评价不光看热度，也看看时间。我不知道沈老师过去如何，但现在她绝对不是绩杀。
44752,1293,沈莉萍,2017-01-18 08:06:58,-3,9,12,不要再说老师绩杀了！这学期我觉得她都受伤害了，这学期她只有一篇期中论文，点名也只是在交论文的那节课点了一次。考前还给我们划重点，论文也教我们怎么写。最后给分超级超级好！其实翘课的人超级多，但老师也有点心累了不管了。总之，不要再说她绩杀了好不好。
45292,1293,沈莉萍,2017-01-19 09:21:04,2,2,0,化学：什么都不知道但又喜欢瞎指挥。真是懒的给她解释。然后给分超级随意，常常鸡蛋里挑骨头，她想怎么样就这样的傻老师。
46937,1293,沈莉萍,2017-01-23 03:49:42,-13,2,15,上课还不错，我论文写得很认真，老师也说不错，考试绝大部分都从书上找到了，最后4.2，觉得略低
47696,1293,沈莉萍,2017-02-18 14:28:05,-10,3,13,大一的，当时选了这个课心里还有点怕，毕竟绩杀，后来又听社团前辈说被她坑惨了，于是很害怕。论文是发她邮箱给改了一遍的(大改，不问都不知道有那么多问题)，开卷考试，考前看书一天，最后4.5? 。上课时就感觉人越来越少，自己其实也经常没听，很感谢有这样的分。
48371,1293,沈莉萍,2017-03-02 11:26:14,1,5,4,上课不讲考试内容，给分还低
48828,1293,沈莉萍,2017-03-14 06:50:42,0,4,4,差评，退货
51211,1293,沈莉萍,2017-05-24 07:28:08,1,3,2,中规中矩，军理课重点不突出，听了课也印象不深
51643,1293,沈莉萍,2017-06-08 01:13:25,-1,4,5,上课一般，但负担少啊，就一篇1000+小论文，只点了一次名。
51714,1293,沈莉萍,2017-06-28 10:30:43,-5,4,9,上课挺有趣的，手写论文，认真一点就好，没有被杀
51956,1293,沈莉萍,2017-06-14 02:23:39,-2,5,7,满嘴跑火车
52731,1293,沈莉萍,2017-06-22 10:32:47,-4,1,5,大化沈丽萍人挺好哒，讲的挺认真，人也蛮好的呀，（并且长的好看声音好听呀嘻嘻）我们组做实验数据有问题，老师也很耐心的。不是我们的预置老师，但是给我们上了一节课，感觉不错。
54605,1293,沈莉萍,2017-06-30 01:18:49,2,5,3,军理，又绩杀
54608,1293,沈莉萍,2017-06-30 02:00:29,2,5,3,原来还报有希望不绩杀，结果还是一样。课没必要听，太水
54618,1293,沈莉萍,2017-06-30 02:35:45,-2,7,9,辣鸡老师，军理论文要求1000字，我认真写了4000字，考前认真复习了一遍，最后绩点3.9，你逗我啊，绩杀慎选！
54621,1293,沈莉萍,2017-06-30 02:40:43,0,12,12,上课听到最多的一句话就是我一定努力给高分\n\n考完查成绩真心累，绝对绩杀。平时论文认真写（她还要求手写）考试题目基本书上都找到，最后给分和我预期完全不符。本来还不信老师真的有这么大的影响，这次我信了。要是能选别的老师就千万别选她。课讲的一般，给分又差，不值得。
54635,1293,沈莉萍,2017-06-30 03:00:43,-1,5,6,绝对急杀，我都怀疑说她改过自心的是她自己刷的！有史以来最低分！
54655,1293,沈莉萍,2017-06-30 03:24:46,3,7,4,绩杀 超级无语 明明做的很用心了绩点仍然超低 。天天说会给你好分数，结果呢
54673,1293,沈莉萍,2017-06-30 03:57:48,-3,4,7,真的是绩杀
54728,1293,沈莉萍,2019-01-04 03:15:06,49,62,13,情况可能有变，2017年春夏的上课体验仅供参考：不点名（但一整个学期学期翘了2次课，翘课的2次是否点名则不详）；只有几个或十几个学生到教室上课；个人听不进去上课内容，语速、语调特别（！无贬义），孙子兵法貌似讲了很久；要求一篇手写1000+手写稿论文，未给上限，早于DDL很久便告知、布置，给足准备时间；课上专门指导“怎样写学术论文”，质量判别因人而异；“个案”：主体3300左右论文+期末绝大部分（除几道题外）翻书找到依据=4.2 切记：仅供参考！！！
54794,1293,沈莉萍,2017-06-30 08:37:25,0,6,6,一分不能再多了
54850,1293,沈莉萍,2017-06-30 10:16:32,-1,10,11,可能是我论文多出来的3000字错了，我应该只写1000字的，是我的错，呵呵???
54860,1293,沈莉萍,2017-06-30 10:33:16,3,16,13,绩杀不解释 军理论文5000+ 并且发给她改过 考题大都翻到了 只有3.6 作死
54887,1293,沈莉萍,2017-06-30 11:25:54,0,17,17,绩杀，5000字手写论文，感觉考试大部分也找到了，但是最后3.6。真的心痛。或许有人上4了，现在我开始怀疑给分是单纯看名字的？？？？？
54926,1293,沈莉萍,2017-06-30 12:58:38,1,13,12,为什么没有零分！！直到出分前一秒我都还相信她已经不绩杀了，结果呵呵。认认真真手写了3000+的论文，考试也基本都翻到了，每次课都坐前面听，口口声声说给大家加分，结果3.0......千万别选她的军理呀！！
54947,1293,沈莉萍,2017-06-30 13:10:34,1,7,6,真绩杀了很后悔真的
54961,1293,沈莉萍,2017-09-21 09:14:22,1,15,14,伪善 表面说一套背后做一套 绩杀慎选 别信会把分打高的鬼话 每学期都这样 最终都是绩杀 开学太天真 期末后悔死\n\n我周围都是3.3 3.6\n\n4以上是有但是很少很少(千万不要以为自己人品好到我就是那4+的均绩会后悔的概率小的可怜)\n\n一句话别抱希望 认真你就输了\n\n课水不点名作业少但是真大绩杀
55056,1293,沈莉萍,2017-06-30 16:38:27,-5,5,10,军理果然只看最后考试谢谢老师
55071,1293,沈莉萍,2017-06-30 18:07:11,-17,6,23,讲的一般，语速飞快，让人听了有点不舒服哈哈。绩杀，我也不太清楚，我4.2，个人觉得老师又不会平白无故把你分数拉下几个档，考试有些题你以为找到了，但是并不一定就找对了啊，而且，谁也没说过论文成绩和字数挂钩。1.5分，看淡些，说绩杀的肯定是没上过工训这门神课。
55103,1293,沈莉萍,2017-07-01 00:16:54,-14,7,21,老师人很不错，根本不是和评论里一样什么老是骂人，也没有点过名，至于给分，鉴于自己水了一学期，给个这个分数也算是满意了。平时作业也很宽松，有极其充裕的时间写。
55239,1293,沈莉萍,2017-07-01 05:18:01,-1,5,6,。？。
55579,1293,沈莉萍,2017-07-02 13:52:08,3,11,8,如果可以的话，我想天天上来给一分：）
55581,1293,沈莉萍,2017-08-31 09:46:38,-2,5,7,绩杀不解释
58156,1293,沈莉萍,2017-08-10 08:06:33,0,6,6,课堂内容充实，但是纯种绩杀。
58529,1293,沈莉萍,2017-08-31 09:44:09,-1,3,4,HK哦KKK
59221,1293,沈莉萍,2017-09-20 08:48:02,-4,1,5,好听，就是不下课而且绩杀\n\n
59543,1293,沈莉萍,2017-09-22 11:07:37,-3,2,5,。。。
59591,1293,沈莉萍,2017-09-24 08:22:43,-3,3,6,心痛的无语凝噎
64769,1293,沈莉萍,2018-01-28 17:42:41,16,21,5,挺好的。
66536,1293,沈莉萍,2018-01-17 07:56:10,-9,1,10,垃圾，绩杀
68343,1293,沈莉萍,2018-01-23 04:16:43,-3,1,4,没听过
68345,1293,沈莉萍,2018-01-23 04:30:08,-6,6,12,说了多少次了，不要选她的军理！怎么还有人不要命呢？
68493,1293,沈莉萍,2018-01-23 09:19:28,1,5,4,语速飞快，第一节课认真跟着听了还挺有趣但很累。事情少，论文手写的可以控制字数，只有一次点名是在交论文那天，只看了遍书，老师给分还不错呀
68536,1293,沈莉萍,2018-01-23 10:22:09,-2,7,9,先给10分等成绩出来再看看。
70885,1293,沈莉萍,2018-02-01 09:28:51,0,6,6,10分。
71271,1293,沈莉萍,2018-01-28 08:26:48,30,35,5,老师很负责很和蔼，没别的事的话上课可以听听，讲的还算比较有意思也能拓展一定的知识面。论文好好写，期末考好好考，不会太低的。考前把书通读一遍，做题时一定要仔细看题。别以为开卷就容易，题干到处是陷阱，一定要仔细对照课本！！给分还是公道的。
71337,1293,沈莉萍,2018-01-28 10:10:12,4,10,6,老师挺好的，平时分满分50，给48-50之间..算差吗？
71356,1293,沈莉萍,2018-01-28 10:46:07,10,16,6,讲道理，这次给分还算公道吧
71361,1293,沈莉萍,2018-01-28 15:41:13,8,15,7,老师人还是很好的......4.5，感动，谢谢老师!
71538,1293,沈莉萍,2018-01-28 14:57:21,-8,2,10,一学期基本没按时来过（都怪前一节的模电实验。。。），据说老师之前一直以为满绩是4.0????
71588,1293,沈莉萍,2018-01-28 16:01:11,68,77,9,挺好的 群里也常出现 也没有很绩杀吧～给分确实还算客观...主要是期末考试...虽然感觉都翻到书了但是陷阱比较多吧……所以标准还是客观的没故意打低分什么的......论文要手写抄了很久但是老师说最后平时分都给48-50好像论文就显得没有那么大区分度了，主要还是看考试。基本没怎么看书～考前翻了几小时～最后上4了很开心了～
71590,1293,沈莉萍,2018-01-28 16:07:06,169,190,21,浙大水课都这个样子吧，在她的课上论收获论情怀自然比不上吕强李心北，但是老师人还真的可以。\n\n一学期就传过一次点名纸，点完名的一周后群里反映补签也完全没问题（虽然这里面有多少人是根本没来上课的我也没这个本事去深究了）\n\n论文允许拖到最后一周上交，考前划重点，平时会在群里和同学们互动交流一些学习经验，最让我觉得老师还真的不错是因为今天快出分的时候，同学们催着有点急，老师就把刚登完的分拿出来给同学们看一眼。因为不符合正态分布而必须调低几个同学的分的时候，老师还做了公示，还一再道歉。两年来第一次了解正态分布的真正弊端。\n\n总之我觉得，如果这样一个诚恳的老师因为给分给得不高就要被骂，我觉得不太公平。沈老师平时分尽量给满，考试没找到是自己的事，且问诸君是否来上课了呢？
71598,1293,沈莉萍,2018-01-28 16:24:51,52,65,13,emmmmmm怎么说呢\n\n看到评论区很多说老师绩杀的，其实军理的沈老师其实也没有那么绩杀\n\n期末论文8000+    然而期末考试爆炸…只有48\n\n（被老师硬深深从3.0拉到3.9）\n\n上课挺水的，人真的挺不错，平时分差不多都给满了，主要还是看个人的期末考试\n\n强推沈老师的军理课   挺好的一个老师??
71606,1293,沈莉萍,2018-01-28 16:35:06,27,32,5,老师人特别好真的，消息单独发群里发都很热心地回，然后平时分几乎给满，所以其实不用花多大力气写，然后最重要的还是考试，这就不能说老师坑了，看自己看书的情况，我就考试之前看了半天差不多吧，先前也只看过三四章，虽然导弹的都不怎么会做但是成绩好像也还不错，还是比较推荐的^_^
71635,1293,沈莉萍,2018-02-07 02:49:24,2,10,8,重修通识课而不是专业课难道不是投机取巧了?自己菜怪老师还有b脸来评论区说!
71656,1293,沈莉萍,2018-01-29 00:08:55,82,93,11,自己菜怪老师系列
71668,1293,沈莉萍,2018-01-29 00:22:24,40,47,7,不知道为什么军理沈老师的评分这么差。虽然上课有点水，自己也敲过一次课，但老师的论文给分很好，都是接近满分的。那些说书上都找到原话，分却很低，说沈老师绩杀的人都是自己没仔细看题干。本人上课基本没听，也没有复习，但考试的时候认真翻书答题，最后绩点4.2\n\n
71674,1293,沈莉萍,2018-01-29 00:29:28,27,35,8,之前说绩杀什么的很担心，但是上了课加了群就知道老师人真的非常好！平时分基本给满，所以最重要的就是考试。考前复习一天左右熟悉下课本，然后考时要细心寻找，耐心分析，这样的成绩不会差。给分有理有据，很公正。90，4.5很满意的成绩了！
71678,1293,沈莉萍,2018-01-29 00:33:42,10,17,7,沈老师真的已经不像以前的评论里说的那样绩杀了，只点过一次名还允许补签，论文可以最后一周交，考前画重点，在群里耐心解答问题。最后录入分时，发现自己录的良好以下比例只有17%，远远不到学校要求的30%，之后跟同学们道歉，才改了几个分把成绩录进去了。本人论文1500，考试当天上午才翻书看过内容，最后4.2，班里同学也都反应老师给分挺好的。
71686,1293,沈莉萍,2018-01-29 00:42:03,-8,5,13,永远不要相信?杀会改过自新，有些老师的嘴巴就是用来跑火车的，比如，我们尊敬的沈老师
71697,1293,沈莉萍,2018-01-29 01:16:05,8,16,8,其实虽然说老师是绩杀，确实，对比隔壁的一些军理老师可能给分不是很好。但是从课堂角度看还是很有趣的，老师这个人也是挺好的。论文认真写了。期末因为没时间复习，就分了一下书的区块。认真对待考试，最后也上4了，感觉挺好的，不推荐选但是（被迫）选了的也不用很担心！\n\n
71717,1293,沈莉萍,2018-01-29 01:40:51,399,428,29,为什么那么多说军理沈丽萍绩杀的？平时分50给48-50，算低？考试分靠自己拿，军理开卷考试，老师说陷阱多，那些说自己全都找到了但是分低估计就是没找对吧。而且老师在最后录入成绩前先把成绩公布出来，后来才发现不符合正态分布，不得不把一些分数降低一些，但是在做这些时都在群里说了，并一再道歉（也让我知道了浙大的正态分布有多不合理）而且老师平时在群里也经常解答问题，还和我们谈浙大的生活以及我们现在学的东西对未来的作用，感觉是个很好的老师啊，并没有评论中的那么可怕啊，论文字数要求1000+，提前两三个月就布置下去了，留了充分时间，平时有一次点名，但就算没去之后也可以补签，总之我感觉沈老师是很负责的好老师
71824,1293,沈莉萍,2018-01-29 03:59:21,8,13,5,我觉得真心没有大家说的那么差，老师不怪，没有架子，群里课上感觉也挺随和。平时分48-50基本给满，卷面考试分是看你自己的，今年题很难，很多人以为自己找到答案了其实是坑。
71853,1293,沈莉萍,2018-01-29 04:35:18,6,11,5,说老师是绩杀的不知道是不是没上过沈老师的课就无脑跟风，至少我这一学期之内是“改过自新”的。老师人很好，很关心同学，平时没什么人来上课也不会介意，在群里经常跟同学互动，有问必答，超好的老师，最后的得分基本看考试，书要熟悉。
72616,1293,沈莉萍,2018-01-30 13:38:28,4,8,4,尚可。
72739,1293,沈莉萍,2018-01-31 04:08:52,5,8,3,我说过 如果绩点3.9我就给她十分。其实讲课很不错，对学生也很认真负责。不存在什么绩杀，考试成绩决定一切。
73268,1293,沈莉萍,2018-02-01 09:01:36,19,23,4,来这里打个10分就为了帮沈老师把分拉上去。
73668,1293,沈莉萍,2018-02-02 12:56:14,2,3,1,我觉得挺好的
74090,1293,沈莉萍,2018-02-07 06:34:55,-14,5,19,评论区里面学弟学妹说，这个老师现在不是绩杀了，但是这也改变不了她曾经是绩杀的事实。作为老师，在2017-2018秋冬学期才知道正态分布的意思，才知道70分和80分的区别，这是一个负责任的老师该做的事情?上个学期遇见多少的学长学姐辛辛苦苦从玉泉跑回紫金港来重修军理。你们总说成绩差是因为不认真，对，没错，肯定有这么一部分人是因为不认真，没有认真听课，但是那么多人都说她绩杀，寥寥无几的人维护她，你难道就是说这么多人都是不认真?你不知道别人付出了多少，就别轻易下判断。有人说考前看了几小时书就4+，而别人可能看了几天。她到底怎么样，上过的人心理还没点数?
74531,1293,沈莉萍,2018-03-03 04:00:18,0,3,3,可以不用听课\n\n老师人好
74996,1293,沈莉萍,2018-03-07 02:36:55,13,15,2,自己菜怪老师系列，不解释\n\n
75293,1293,沈莉萍,2018-03-08 16:03:31,4,6,2,我感觉老师真的不算绩杀，我们班好多上四了，我一陈昆福的室友说没比3.6高的(据他了解，即使有也极少)。而且沈老师上课也挺水的，没别的事情，你做作业开电脑都不要紧，整个学期只有一次签到(说不定还能补签)。整个学期所有的事情只有一篇论文和期末考，而且论文很早就叫我们写，ddl很长，不急交。还有期末划重点。总之，我觉得还不错
75405,1293,沈莉萍,2018-03-11 03:47:49,4,4,0,挺好的吧这老师，蛮水的，平时分差一分满，考试真的靠自己…
75446,1293,沈莉萍,2018-03-12 03:17:22,0,3,3,比以前好多了，没有那么绩杀，论文4000+，期末好好打题，最后也4.2，感觉可以选。
76525,1293,沈莉萍,2018-04-12 08:02:39,10,11,1,点名就一次，还可能可以补签。上课干自己的事也行，平时一篇论文，期末考试前还会划重点，最后绩点也能4.2，感觉还OK，算不上绩杀吧\n\n
76598,1293,沈莉萍,2018-04-16 06:18:07,25,26,1,沈老师其实人超好啊，我觉得与其在那里骂老师绩杀不如反思下自己上课都在干什么，甚至有没有去上课才比较重要。正态分布是学校的要求，沈老师作为一个讲师也不能改变学校的规定。考试这种东西，就不要拿着“很多我都找到原话了分数为什么还这么低”这种话来diss老师了吧，所有东西都在书上，别的人全部都找到了分数比你高有什么问题么
76609,1293,沈莉萍,2018-04-16 06:55:09,13,15,2,军理讲的挺好的，给分也没以前听说的那么绩杀了，军理课期末考试都比较难，平时分这老师给的真的不错了。
79848,1293,沈莉萍,2018-06-14 09:32:58,5,6,1,真的是很温柔的老师！给分好！
79921,1293,沈莉萍,2018-07-07 17:40:52,-12,4,16,我只想说自己菜别说了，根据分布情况，你就算吕强的课拿3.6也很正常啊，不要因为人云亦云，一门同时课3.6够了，物化，概率论这种随便拿个4.8均绩不就上去了\n\n
80608,1293,沈莉萍,2018-06-28 08:37:33,-2,3,5,这是两个老师，但都是大坑，军理的不多说。教化学实验的沈莉萍是真的给分不客观，自以为是。
81564,1293,沈莉萍,2018-07-05 11:54:27,1,4,3,化学slp，给分巨差，自己水平不高，探究事情还多，最后给分很差。\n\n
82645,1293,沈莉萍,2018-07-09 01:58:41,7,7,0,一学期点三次名，错过了也可以补签。论文手写一千字即可。个人感觉给分不错。
82657,1293,沈莉萍,2018-07-09 02:28:54,9,10,1,老师还是很好的～不像以前那样绩杀啦，军理点名尽量到，论文好好写考试好好翻书（hhh裸考路过……）给分基本不会太差了～
82792,1293,沈莉萍,2018-07-09 06:47:48,2,5,3,老师感觉已经不是很绩杀了，平时课很水，点名可补签，论文手写稿1000字以上，事情是真的很少很少的。期末就打印一下吕强的ppt再带上书和目录就差不多了。这学期没有给满绩，最高4.8也就一两个，4.5、4.2、3.9比较多。
82855,1293,沈莉萍,2018-07-09 08:29:13,24,27,3,老师军理课不是绩杀，这学期点了三次名，平时50分给了49。期末才考了七十多分，最后4.2。平时作业就是1000字以上的论文。主要是自己学的好坏啦。看期末。
83046,1293,沈莉萍,2018-07-09 14:16:19,20,21,1,老师现在真的不绩杀了!出分前会把成绩表发到群里，我看了看，都挺高的，老师很好!
83177,1293,沈莉萍,2018-07-10 01:18:52,6,8,2,军理的考试一学期点三次名，最后给分很好，超棒！
83555,1293,沈莉萍,2018-07-10 14:59:50,39,40,1,沈老师人超好啊！很耐心解答同学的问题！！平常分基本都会给48-50。总分低可能就是期末没考好，是自己的问题了…不绩杀✔
83559,1293,沈莉萍,2018-07-10 15:09:47,42,49,7,缺过一两次课，认真写了1500字论文，最后花了一天复习，最后给了4.5，室友4.2，觉得可以接受，沈老师不是绩杀。
83560,1293,沈莉萍,2018-07-10 15:10:29,127,134,7,事少分高，我来负责捍卫老师的评分
83573,1293,沈莉萍,2018-07-10 15:34:08,5,7,2,真的很不错啦? 给分很认真的，认真听课还是有收获的
83575,1293,沈莉萍,2018-07-10 15:39:46,12,13,1,老师人超级好的，给分也不错，尽量给大家分了。虽然要手写论文，但写论文前老师有给讲思路。本来还担心绩杀，但最后还是得到了比较好的结果，给老师正名！
83698,1293,沈莉萍,2019-05-31 04:53:38,143,147,4,我上的军理。首先说绩杀的自重。沈的军理均绩不算很低。为什么会有人说绩杀，因为在谈到考试时，她说论文占50分尽量给高，有些人当真了，最后分数不遂意就开喷。很多人觉得自己考试全写对为什么分不高，那是因为有些题有陷阱，有些题只是你以为你写的是对的，请先把书翻透再说自己写对了。上课点三次到，可以在当节课课后补签，有时还会QQ提前通知。论文写好可以QQ发她寻求意见，会给出详细的修改方案。上课内容丰富，经常讲些军事的故事，绝对不会无聊。有些人平时坐在后排水手机甚至从来不上课，论文随便应付，还指望绩点高，可能吗？
84501,1293,沈莉萍,2018-07-13 04:08:33,17,18,1,用心良苦
85429,1293,沈莉萍,2018-07-17 20:07:59,3,5,2,除了手写论文没什么可说的
85520,1293,沈莉萍,2018-07-19 01:46:58,1,3,2,课堂内容还是挺丰富的
86050,1293,沈莉萍,2019-06-28 22:29:21,-39,12,51,不是沈丽萍班的，但是有一次心血来潮去听她讲课，我说句实话，作为一名军迷并不觉得她的水平有多高，她经常会刻意夸大老毛的军事思想的价值。诚然老毛的军事思想在如今仍然发挥着作用，技术不断发展，老毛的一些思想已然过时，我们需要客观去评价。另外她连八月风暴行动的指挥官华西列夫斯基都不认识。。。也是醉了
86954,1293,沈莉萍,2018-09-19 14:05:33,-1,5,6,军理课，4.5绩点。刚刚记错了，论文是要手写稿的。在此更正。
91573,1293,沈莉萍,2018-12-13 15:49:41,18,18,0,军理课，从来没遇到过点名未到还可以补签的老师，天气转凉还会提醒同学们注意身体，老师很贴心，感动(இωஇ )
92529,1293,沈莉萍,2019-01-02 04:20:24,-6,1,7,4.5。付出和收获成正比
92747,1293,沈莉萍,2019-01-04 06:38:34,3,5,2,好，认真负责
92847,1293,沈莉萍,2019-01-05 06:55:53,158,163,5,这么好的老师还去哪里找？？？点名还可以补签，请假也是会关心学生的身体，讲话也很有趣的呀，hhh说我们期末考忘了她名字可以在试卷上写女老师，因为军理就她一个女老师，论文也会讲思路，还会专门花一节课给我们讲论文怎么写，甚至可以拖到最后一节课交，除了手写搞限制了恶竞的欲望hhh，也会划重点，反正我要把老师的评分拉回上来！
94524,1293,沈莉萍,2019-01-17 05:15:16,3,5,2,很轻松，一个学期三次签到，上课认真听是能够学到知识的，还有课前会放军事相关的纪录片☺️
96552,1293,沈莉萍,2019-01-21 06:21:44,4,4,0,老师真的很好，成绩还没出，所以不知道是不是绩杀
96825,1293,沈莉萍,2019-01-21 10:17:07,7,7,0,老师人非常好！
97057,1293,沈莉萍,2019-01-21 15:25:05,6,7,1,三次点名 一篇论文\n\n分数没出\n\n老师说话给我感觉就很好 很诚恳
97332,1293,沈莉萍,2019-01-22 08:12:48,16,18,2,老师巨好！！！没有85！！绝不卡绩，都是86  92这种，觉得分低的还让你问！！我TM吹爆！！
97340,1293,沈莉萍,2019-01-22 08:17:16,9,10,1,这不应该是给10分的老师吗！这也太好了。喜欢这样的老师，事少给分好。
97341,1293,沈莉萍,2019-01-22 08:17:30,4,6,2,给分不错
97343,1293,沈莉萍,2019-01-22 08:18:35,3,4,1,海星，给分还好的
97344,1293,沈莉萍,2019-01-22 08:18:51,1,3,2,老师的课很水，给分很好
97345,1293,沈莉萍,2019-01-22 08:18:54,5,6,1,吹爆这个老师！没有卡绩！为什么这个老师评分会这么低？？理应上9的啊！
97347,1293,沈莉萍,2019-01-22 08:18:56,4,6,2,沈老师上课挺不错的，有时候也会讲一些小幽默*^_^*，给分也挺好，会提醒考试要求和复习方法，认真准备考试的话不会失望的，还是一个非常好的老师٩( 'ω' )و
97350,1293,沈莉萍,2019-01-22 08:19:20,8,10,2,所以说查老师个人成分太多了……老师绝对不是绩杀。而且会抵制恶竞什么的……肯定是好老师呀~
97353,1293,沈莉萍,2019-01-22 08:20:21,16,16,0,沈老师现在不绩杀了，还会调分哦！平时上课过去自习就好了，考前看看书也行了，优秀的！
97354,1293,沈莉萍,2019-01-22 08:20:34,2,4,2,只有偶尔点名也会提前说，要是人挺好，也很尽力了，真的不是绩杀，努不努力看自己了，上课虽然不怎么好玩，但都是有知识的。
97356,1293,沈莉萍,2019-01-22 08:21:02,6,7,1,给分很好！
97357,1293,沈莉萍,2019-01-22 08:21:17,14,16,2,军理不绩杀！
97358,1293,沈莉萍,2019-01-22 08:21:40,9,9,0,首先老师给分客观公正，总之自己写的怎么样考得怎么样肯定都是在分数上有体现的，然后老师上课也很轻松，事情也少，一个学期有三次点名，可以补签，平时在群里也很热情很贴心，我觉得挺好哒
97360,1293,沈莉萍,2019-01-22 08:22:01,11,12,1,虽然被卡绩了，但是不怪老师！是正态分布的错！期末成绩出来了，整体看了一下，大家都很不错！不绩杀，相信我！老师非常和蔼，很关心同学！
97361,1293,沈莉萍,2019-01-22 08:22:02,4,7,3,1819秋冬\n\n点三次还是四次名 允许下课时补签\n\n论文手写感觉有点妖\n\n期末会讲重点但是没啥用 主要自己做套卷子熟悉一下书\n\n\n\n可能绩杀 虽然我没吃到但是可以看到成绩\n\n\n\n最高只有很少的92
97362,1293,沈莉萍,2019-01-22 08:37:59,25,26,1,此处是军理的沈老师，老师特别亲切，讲课有很多例子，还能联系生活。而且我考试前半夜问她问题，她很认真地打了几大段文字给我！真的是好老师，给分也很好，全班没有卡绩的。我觉得老师的分绝对不该那么低，吹爆沈老师！！！
97363,1293,沈莉萍,2019-01-22 08:22:41,5,6,1,老师很好！成绩跟老师有关，并没有刻意绩杀！
97364,1293,沈莉萍,2019-01-22 08:22:55,7,8,1,老师人很好，给分也不错，
97365,1293,沈莉萍,2019-01-22 08:23:01,16,16,0,谁说沈老师绩杀的
97366,1293,沈莉萍,2019-01-22 08:24:09,12,14,2,老师挺好的，也没用绩杀叭，平时不迟到，考试没有很认真复习最后84。。也还好，老师讲课挺不错的。
97367,1293,沈莉萍,2019-01-22 08:24:31,10,11,1,老师讲得挺好啊而且很认真\n\n不是大家说的那么可怕\n\n给分真的很好了，因为毕竟考试的分数只能自己拿
97369,1293,沈莉萍,2019-01-22 08:25:20,18,18,0,全员为老师平反\n\n认真写论文3300+\n\n考试全部找到\n\n最后4.5 不亏
97374,1293,沈莉萍,2019-01-22 08:26:15,6,8,2,一学期点三次名。事少给分好，老师还超级温柔。超级喜欢！真心觉得查老师上各种言论都不那么可信
97379,1293,沈莉萍,2019-01-22 08:27:34,31,34,3,我们的分数是95.92.89.86.83.80.77等等
97383,1293,沈莉萍,2019-01-22 08:28:33,9,10,1,谁说老师是绩杀的…
97385,1293,沈莉萍,2019-01-23 13:19:50,31,32,1,其实看一下评论，说绩杀的都是很早以前的评论，大家放心选沈老师的课没问题
97389,1293,沈莉萍,2019-01-22 08:31:52,26,27,1,绩杀的我不做评价，我知道你们那时候可能是老师不太懂学校的评分系统，但是现在沈老师确实不是绩杀了好吧……平时分基本满的，只有三次点名，点名之前甚至会说今天要不要签到，我记得有一次群里有人问今天要不要点名感冒了来不了，沈老师直接说今天不点名你好好休息。而且一次不到完全没问题，这个平时分很好拿啊……最后考试本来就看你翻书的水平，反正我自己找的差不多，最后成绩很OK，总之请大家更新对沈老师的看法，她人真的很好，上课也很随和，你想水也能水，睡觉老师都不会叫你……为沈老师平反
97394,1293,沈莉萍,2019-01-22 08:34:25,11,11,0,(*˘︶˘*).｡.:*♡
97399,1293,沈莉萍,2019-01-22 08:37:35,23,26,3,不绩杀，真的真的不绩杀。\n\n从不看书，亲测绩点4.2ʅ(´◔౪◔)ʃ
97401,1293,沈莉萍,2019-01-22 08:39:20,5,7,2,不绩杀！老师超级好！
97404,1293,沈莉萍,2019-01-22 08:40:07,13,14,1,从冬日里的嘘寒问暖，到离别时的勉励期望，都是其人格与品行的写照。素日里，和蔼善良，春风化雨;讲台上，传承师道，不负初心——她，就是可敬可爱的沈莉萍老师!
97412,1293,沈莉萍,2019-01-22 08:43:35,1,4,3,这个老师还可以啊，对学生挺好的，绩点只要期末认真考就行了
97430,1293,沈莉萍,2019-01-22 08:52:41,7,8,1,老师上课就是在讲一个又一个故事，听课不会觉得无聊，全学期点3次名，交一篇论文，特别轻松的课。考试前还会划重点，对学生也是很情切，你去上她的课就能感觉的到。至于说沈老师绩杀的，不知道正态吗，你没别人学的好还能怪老师的？反正我是挺好的
97433,1293,沈莉萍,2019-01-22 08:56:14,103,107,4,老师出分前会把全班成绩发到群里让大家核对 官方数据:某班7个4.8 71个4.5 57个4.2 30个3.9 1个3.6 27个3.3 12个3.0 1个2.1 除去缺考的 均绩4.08 老师的其他优点不用我多说 但她真的不是绩杀 选她的军理真的不亏
97437,1293,沈莉萍,2019-01-22 09:00:17,5,6,1,老师人真的超级好，也不绩杀，大家军理选她没问题的ｸﾞｯ!(๑•̀ㅂ•́)و✧
97444,1293,沈莉萍,2019-01-22 09:01:36,2,4,2,开卷考之前一定要看遍书
97446,1293,沈莉萍,2019-01-22 09:04:31,3,6,3,作为一个军事白痴 觉得老师上课还是比较有意思 而且沈老师现在不是绩杀了 平时就一篇1500的论文
97452,1293,沈莉萍,2019-01-22 09:06:07,11,12,1,超级好，不解释
97464,1293,沈莉萍,2019-01-22 09:11:19,6,6,0,好！\n\n
97473,1293,沈莉萍,2019-01-22 09:14:17,4,6,2,老师布置的作业只有一篇小论文，1000字以上，不用太注重字数，主要还是看自己的论述过程和逻辑，我就才写了3500多字（手写太累了），最后平时分也不少48左右，主要还是看期末考，虽然开卷，但考的很细，有时候一个知识点往往是在另一个地方，一个概念包含在另一个大概念里，结果很多人只有看小分支，没看大标题，就少选了一些，考试前要仔细看书，争取判断题能凭直觉，最后还有时间再去慢慢找。老师很注重军事思想这一块，武器装备确实对文科生有点不友好，所以这还是看自己吧！
97489,1293,沈莉萍,2019-01-22 09:19:42,12,13,1,老师会点名，3次。应该比重很大的我成绩89分，一般。所以，谁说老师绩杀的?人很好的，上课如果听的话也很有意思，（不过我没怎么听(ﾟoﾟ;）看到之前绩杀的评价可能老师以前这样吧，现在不是了呀。大家可以放心选了(❁´ω`❁)
97528,1293,沈莉萍,2019-01-22 09:59:03,6,7,1,不绩杀啦！老师人超好
97529,1293,沈莉萍,2019-01-22 10:02:04,8,11,3,老师真的人很好，也许以前绩杀，但是现在真的没有，一片没上90的基本都是89。整个学期只需要写一篇1000字以上的小论文，点3次名。考试之前还是要看一遍书的......我很后悔没有看过。总之要给老师正名。
97531,1293,沈莉萍,2019-01-22 10:04:34,20,22,2,我敢保证，说沈老师好的绝对不是水军，就手写1500字论文，考前一定要过书，绩点真的低不了，经常关心学生身体健康，甚至还能补签，虽然我不知道被绩杀的那些学长学姐是什么情况，在这里同情他们一下，但这么体贴的老师实在是太温暖了，我来拯救她的评分，这么好的老师，评分是9.多，请之后选课的小可爱放心食用(❁´ω`❁)
97532,1293,沈莉萍,2019-01-22 10:04:49,12,12,0,给分超好 不解释
97534,1293,沈莉萍,2019-01-22 10:10:31,7,7,0,我觉得挺好的 这次全班没有一个卡ji 水了一学期 作业考试过得去 最后4.2\n\n
97553,1293,沈莉萍,2019-01-22 10:35:15,5,7,2,绝对绝对不是绩杀\n\n老师真的超好超好
97564,1293,沈莉萍,2019-01-22 10:54:32,8,10,2,给沈老师正名！！老师人超好绝对不绩杀！！
97591,1293,沈莉萍,2019-01-22 11:44:23,18,21,3,沈老师真的很好就点三次名还会给你补点\n\n论文开学就布置了给你一个学期去写，最后一堂课没有交你甚至可以考试的时候交给老师\n\n老师还专门一节课来讲怎么写论文\n\n你把论文写好给老师看老师会给你很认真的提意见\n\n平时上课也很有意思 早8也不会感到困\n\n给分真的好\n\n老师很用心的调分\n\n老师最后把每个人的成绩excel放到群里（只有学号和成绩）没有一个人是卡绩的，超级多的89\n\n这一学期也没怎么用心，最后两天肝了一篇论文看了半天的书最后4.5\n\n真的很感谢老师\n\n10分必须的\n\n老师的评分由我来守护\n\n
97612,1293,沈莉萍,2019-01-22 12:03:27,7,8,1,比较轻松 绩点高
97652,1293,沈莉萍,2019-01-22 12:43:53,4,6,2,论文虽然要手写 但是给分好  也很宽松 爱老师
97867,1293,沈莉萍,2019-01-23 00:33:41,8,9,1,沈老师的课很好，讲课很认真，课前会放军事的视频。作业只有一篇论文。会尽可能把正太的上限用完，全班无人卡绩。想学想水都很合适。
97876,1293,沈莉萍,2019-01-23 00:40:02,10,13,3,期末90，成绩出了之后为老师平反。扫了眼班里的成绩单，感觉很少卡绩，给分真的不错了。老师很温柔耐心，整门课就一篇小论文的作业，可以最后一节课交，期末一直在提醒同学不要忘记。上课也蛮有趣的，会介绍历史故事，也不是照本宣科。很好的老师！
97880,1293,沈莉萍,2019-01-23 00:43:17,3,5,2,现在说绩杀的是自己没好好学还是家中有人暴毙？？
97940,1293,沈莉萍,2019-01-23 02:20:48,3,6,3,军理这种课如果不是很有兴趣，怎么上都是无聊。沈老师人真的很好，很开明，请假只要群里说一声，一学期点三次名，一次没来完全没关系，还可以补签，论文也不要求有多大的思想性，只要把前因后果说清楚就好。群里也会发期末习题和详细解答。私戳问问题也很耐心地回复。必须给沈老师平反啊，一些人自己菜，就不要怪老师了。
97957,1293,沈莉萍,2019-01-23 02:43:23,5,5,0,沈老师的军理课真的不错，绩点给的好，很轻松绩点上4。
97981,1293,沈莉萍,2019-01-23 03:19:54,4,5,1,我觉得还不错啦～平时蛮轻松的，不过考前书还是要看看的。不算绩杀啦。
98053,1293,沈莉萍,2019-01-23 04:29:44,6,8,2,我觉得军理的沈老师超好啊，讲课也并不无聊，就好多我原来不知道的东西听老师讲了觉得还挺有意思的，而且我甚至觉得老师的标准有点点松啊…有些同学讲早上起不来想请假还是qq上，老师都批准了…话说上课不去去了不听真的是一个浙大学生应该有的行为莫？
98065,1293,沈莉萍,2019-01-23 04:43:54,5,7,2,老师超好的哇
98143,1293,沈莉萍,2019-01-23 06:16:16,27,29,2,开学选军理 只有沈老师 一看查老师 评分4.7 脸上笑嘻嘻 心里哭唧唧 为啥还选她 最新评论说不再是绩杀 沈老还可以 心中存疑虑 试探半学期 上课有内容 作业较轻松 一学期下来 4.2到来 如此好老师 汝等当何求？
98216,1293,沈莉萍,2019-01-23 07:58:03,8,8,0,本来看到查老师说军理绩杀还慌慌的，后来发现老师人真的超好！上课稍微听下不翘课，考前过遍书最后4.5? 而且基本没有卡绩的情况，爱了
98354,1293,沈莉萍,2019-01-23 11:00:18,9,10,1,最开始选课的时候看到4分，又听说是绩杀，心里挺没底的，上课比较催眠……其实是我每次都做后排……总的来说，一学期大概三次点名，点名前老师会告知本节课或下节课点名让大家做好准备，迟到了也可以补签，作业的话要有1000+的手写论文，我写了4000左右，室友恶竟天王写了7000+……结果是室友4.5我4.2……期末考试开卷还是比较水的，考前突击一下大概掌握一下内容就可以。老师人还是很好的，也很为学生着想，一直说要尽量帮我们提分。
98357,1293,沈莉萍,2019-01-23 11:14:48,2,4,2,很温柔善解人意的沈老师。。不知道之前的人怎么想的，全班几乎没人卡绩。我来为老师正名！
98358,1293,沈莉萍,2019-01-23 11:15:06,5,5,0,签到会提前说，老师很和蔼，绩点也不差，平时分会尽力给，我只能说现在cls的分数很不ok
98360,1293,沈莉萍,2019-01-23 11:16:09,6,7,1,老师上课很随和，点名点三次，可以缺一次没影响   给绩点很好   不像以前说的那样\n\n水了4.5  就点名没缺  上课水过  交篇手写论文  期末靠文印店资料翻
98363,1293,沈莉萍,2019-01-23 11:20:26,14,15,1,不是几乎没人卡绩 就是真的没有任何人卡绩
98364,1293,沈莉萍,2019-01-23 11:20:39,13,16,3,超级棒！！真的！不懂那些喷子是抱着什么样的心态！！？？？？老师上课超认真，讲的还生动，点名就点了三次，有的或许根本都没有去上课课后知道点名了在群里说老师也都很实在的没有算缺课，考试重点全都给你画出来，作业提前布置两个月，而且只要求一千字！群里答疑，私下找老师从来都是很认真很认真的解答，考试成绩出来第一时间发成绩让同学们确认然后才上传，班里没有一个卡绩！凭什么说老师给分不好！自己不认真还想要高分，傻了吧怕是。看看军理课本上小标题排版都不严谨的那几个章节都是谁的再吹好不？
98365,1293,沈莉萍,2019-01-23 11:20:53,1,4,3,老师讲课很好啊，除了论文手写有点。。。
98367,1293,沈莉萍,2019-01-23 11:22:23,6,8,2,老师现在真的不绩杀了，超良心（哭惹
98368,1293,沈莉萍,2019-01-23 11:22:44,9,10,1,绝对不是绩杀。缺点名不会有太大影响，事情也很少，天气凉了老师还会提醒同学们注意身体。超级贴心～
98369,1293,沈莉萍,2019-01-23 11:22:48,3,6,3,很温柔
98372,1293,沈莉萍,2019-01-23 15:26:14,7,9,2,点名可补到，论文可补交，其他的还需要说嘛
98373,1293,沈莉萍,2019-01-23 11:28:53,9,10,1,反正我觉得沈老师很不错
98382,1293,沈莉萍,2019-01-23 11:39:16,6,7,1,非常负责，能理解学生
98387,1293,沈莉萍,2019-01-23 11:45:41,4,6,2,老师真的很好！！！！！打分很好什么都好！！
98389,1293,沈莉萍,2019-01-23 11:47:16,7,7,0,正名走一波
98396,1293,沈莉萍,2019-01-23 11:53:54,5,7,2,沈老师真的一级棒！上课讲得很有趣，会讲很多历史故事和一些时政，有时候讲得很戳笑点，三次点名，老师人很随和也很好讲话，特别温柔，一学期的作业就是一篇论文，而且如果你让她帮你看看自己的论文的时候也会给出它的建议！关于绩点，老师超努力的让每个同学尽量拿高成绩！真的很棒！考试之前会讲怎么复习，然后就是看一遍书，刷刷题库，分数就不错。最后想说不知道为啥很多评论说她是绩杀，但根据自身经历感受，我真的觉得是很好的老师！赞[ps:本人平时就是默默无闻的同学，所以以上评论十分真实了
98400,1293,沈莉萍,2019-01-23 12:04:01,3,7,4,军事理论课 上课讲的一般 但是课前有新闻视频看有复习课和论文教你写课 期末会给ppt和一些复习题 比较开明
98406,1293,沈莉萍,2019-01-23 12:12:01,4,5,1,军理老师是真的很好，至于化学我没有上过不知道啦(^o^)
98411,1293,沈莉萍,2019-01-23 12:21:57,4,4,0,为老师正名，不是绩杀
98412,1293,沈莉萍,2019-01-23 12:22:17,2,2,0,感觉老师讲课海星 没有那么可怕 军理主要靠自己
98414,1293,沈莉萍,2019-01-23 12:24:34,0,2,2,老师人很好！事少分高！为什么查老师的评分还不给我涨上去！
98418,1293,沈莉萍,2019-01-23 12:29:13,1,2,1,老师超棒！不要轻信前面的！\n\n会关心同学天气转凉小心生病，点名可以补签，一学期三次。本来之前有点担心，但每节课都去，论文认真写，考试也仔细准备了，最后绩点拿了4.8，超级开心。\n\n在此给沈老师正名！\n\n
98420,1293,沈莉萍,2019-01-23 12:30:44,-1,1,2,对军事方面很不感兴趣，所以上课基本上在干其他课的事。虽然不会写但是对论文我还是十分认真，期末考试开卷考也还行。最后绩点上4了，很开心。老师最好的是上课签到没在下课还可以补签，而且期末论文（长学期唯一的作业）上交期限很长，甚至到期末考试当天老师还特意到教室去收。老师真的很好了！
98424,1293,沈莉萍,2019-01-23 12:33:45,2,3,1,为沈老师正名！
98428,1293,沈莉萍,2019-01-23 12:36:57,3,4,1,挺好的。
98429,1293,沈莉萍,2019-01-23 12:38:31,3,4,1,爱她不解释
98435,1293,沈莉萍,2019-01-23 12:41:30,-1,1,2,good\n\n
98441,1293,沈莉萍,2019-01-23 12:48:31,1,3,2,还行吧
98445,1293,沈莉萍,2019-01-23 13:05:41,10,11,1,手写论文要求1000+，我就写了1500。考前突击了一晚上军理，其实就是把书看了一遍，最后绩点4.8。事少分高又宽松，老师人也非常好。说实话论文写得多也没啥用，主要看质量
98451,1293,沈莉萍,2019-01-23 12:55:08,1,3,2,事少分高又温柔 绝对10分
98452,1293,沈莉萍,2019-01-23 12:58:44,7,7,0,我是来为军理沈老师正名的，客观来说，一学期就点三次到加一篇1000字的论文，作为平时分占50分，点到还提前告诉你，迟到了还可以下课补签，论文要求低字数少，基本平时分都尽量给满了好吧。至于期末考试当然要靠你自己了，开卷考都是书上原话，还都是选择判断题，背好目录快点翻书找是基本都能找到的。\n\n最后我本人是三次点到都到了，论文要求手写稿好好写了3500字左右，期末除了两道题书上没找到地方剩下都找到了，得了4.5。也看了老师的成绩公示，并没有之前看查老师评价想象中那样绩杀，天冷了还会暖心的嘱咐同学天冷加衣，上课负责认真，个人觉得沈老师是个好老师！
98454,1293,沈莉萍,2019-01-23 12:59:51,4,5,1,上课有趣，老师温柔 为沈老师正名
98457,1293,沈莉萍,2019-01-23 13:03:51,0,2,2,好老师！考试前多看文印店资料
98459,1293,沈莉萍,2019-01-23 13:07:08,5,6,1,？？？为什么沈老师评分这么低？？？\n\n一学期三次点名只要两次到了就一点问题都没有了\n\n没有小测 只有一次手写论文\n\n军理课也不是特别无聊啊（虽然我都在打游戏）\n\n平时没听过课 考前翻一遍书考试都找到了\n\n论文稍微上点心\n\n绩点很高啊\n\n沈老师赛高！！！
98462,1293,沈莉萍,2019-01-23 13:08:47,5,5,0,挺好哒！
98466,1293,沈莉萍,2019-01-23 13:11:52,7,7,0,军理的沈老师人是非常好了，看得出来老师是真的在好好讲，点名一学期也就3次，还可以补签，一篇论文虽然手写但是也才1500吧，这有什么好说的。老师平时分应该都给的挺高的，最后总分总体给的很温柔了，说老师绩杀的不想想是不是因为自己菜？？？自己有上过课有认真考试吗？沈老师是个挺好的老师，那种因为自己原因得到低绩点跑来这里报复老师给低分的，啧啧啧
98475,1293,沈莉萍,2019-01-23 13:18:13,3,5,2,我。。。特地问了自己的各项成绩，平时成绩真的不是绩杀，而是期末自己菜，虽然我也全都找到（emmm真菜系列）
98476,1293,沈莉萍,2019-01-23 13:18:16,2,5,3,沈莉萍8分还是可以有的
98477,1293,沈莉萍,2019-01-23 13:18:18,8,9,1,不知道为什么那么多说绩杀的，一个班均绩4以上怎么可能是绩杀，自己差怪老师系列的就不要说了，老师超级好，10分不接受反驳\n\n
98480,1293,沈莉萍,2019-01-23 13:20:45,4,6,2,爽就完事了
98486,1293,沈莉萍,2019-01-23 13:29:23,5,6,1,很棒的老师
98487,1293,沈莉萍,2019-01-23 13:30:35,2,4,2,事少，给分好，关心体贴。这还不够打十分吗
98519,1293,沈莉萍,2019-01-23 14:12:02,6,7,1,挺不错的，也不是绩杀
98529,1293,沈莉萍,2019-01-23 14:30:22,4,5,1,老师上课很棒，如果上课认真听的话能有很多收获。课前老师会放相关军事新闻报道视频，多多少少能了解些全球军事消息。考前老师专门会有复习课，交论文ddl一拖再拖她也没说什么。最最关键的是，老师真•不•绩•杀
98562,1293,沈莉萍,2019-01-23 14:59:34,6,7,1,老师的军理课虽然不能说引人入胜，但也算不错，而且老师人非常好的，平时分基本满上，考试靠自己的，给分相当不错，大家是不是把化学那个沈老师把军理沈老师混在一起了？
98563,1293,沈莉萍,2019-01-23 14:57:21,2,3,1,事少给分好，不解释！
98682,1293,沈莉萍,2019-01-23 20:09:46,2,3,1,很好的老师。平时一直水课没想到绩点不低 谢谢老师
98689,1293,沈莉萍,2019-01-23 22:44:51,3,4,1,很可爱的老师\n\n会耐心解答你的问题\n\n不是绩杀（但我很好奇为什么没有满绩的而4.5、4.2一堆）\n\n老师辛苦啦
98852,1293,沈莉萍,2019-01-24 04:07:28,0,2,2,老师的课讲的很生动
98990,1293,沈莉萍,2019-01-24 06:30:51,0,2,2,给分不像之前的风评，上课讲的还是有内容的
99188,1293,沈莉萍,2019-01-24 11:26:47,3,4,1,给分很好
99263,1293,沈莉萍,2019-01-24 13:59:19,1,4,3,老师超级棒的好吗？为什么会有人说绩杀？？\n\n\n\n我课没怎么听，基本都睡觉去了，但是三次点名到了（一学期只点三次名，还能补签，一次没到还没事，这么好的老师）期中论文也认真写了，考试就前一天和当天上午看了看，最后4.5，很满意
99362,1293,沈莉萍,2019-01-24 15:31:09,3,4,1,可以一起探讨问题的老师
99481,1293,沈莉萍,2019-01-25 00:40:52,4,5,1,老师上课也是很投入的，论文也课可以迟交，平时分基本给满了，期末自己都觉得考得不好，被正态掉也是正常，想来这为老师正个名，她不是绩杀，讲课虽然和吕强相比讲课无聊一下，但真的是一个挺好的老师
100022,1293,沈莉萍,2019-01-25 12:51:42,2,3,1,觉得给分确实不如我预期中的高，但是也没有大家说的那么不好...而且老师本人是个很细心很温柔的人啊！
100087,1293,沈莉萍,2019-01-25 14:23:45,8,10,2,本学期最水的一门课了，就和不存在一样……上课几乎从来没听过，拖延症晚期愣是把唯一一篇手写论文拖到考试才交，也只写了2000多，考前大概看了看书(看不下去)，找到大部分吧，但因为完全没看过也就没有坑不坑的判别了……然后得了4.2。老师人真的是温柔亲切，一直说会尽量给高分，点名可补签，很早布置作业ddl无限后延。不想水的话，可能上课体验不如别的分数高的老师，但也能学到一些东西。
100259,1293,沈莉萍,2019-01-26 01:18:02,5,7,2,老师人不错啦
101105,1293,沈莉萍,2019-01-27 13:46:44,1,3,2,好老师啊
102047,1293,沈莉萍,2019-01-30 06:56:23,1,5,4,拯救老师的评分
102931,1293,沈莉萍,2019-02-25 04:31:46,-1,2,3,没什么感觉，但给分不错
103033,1293,沈莉萍,2019-02-25 13:46:13,4,6,2,我觉得老师挺好，分这么低可能前几年有些奇怪的事情。但是就我上的学期来看，平时就点两次名，上课很多人不来，老师也照样很有热情地讲课。听她讲故事蛮有意思的，就是孙子兵法讲得有点多我不太喜欢听。论文手写一份，字数要求不高，平时分都不低，考试考不好我觉得也不是老师的责任。
103202,1293,沈莉萍,2019-02-26 23:53:01,2,2,0,老师人挺可爱啊
103237,1293,沈莉萍,2019-02-27 02:41:06,4,4,0,好！\n\n
104455,1293,沈莉萍,2019-03-21 02:35:03,-2,0,2,挺好的呀
104636,1293,沈莉萍,2019-03-25 15:39:21,2,4,2,给分很好的\n\n
108648,1293,沈莉萍,2019-05-30 10:10:03,1,2,1,来补分 上学期的  老师很棒哦 以前可能不会调分 现在已经很好啦   讲的其实也很有意思(试图认真听了两节课emmm)  论文写的好像是中日  最后花了几个小时看ppt拿了90分  总评也是90
108670,1293,沈莉萍,2019-05-31 00:12:36,0,2,2,老师人很好啊…
108921,1293,沈莉萍,2019-06-04 07:27:38,0,3,3,骂人的自重 大家都知道你是孤儿了 不要出来送妈
109318,1293,沈莉萍,2019-06-13 05:47:43,0,4,4,手写论文，匪夷所思。
109472,1293,沈莉萍,2019-06-15 13:09:59,2,2,0,老师事真的少，想水就选她，而且人也和蔼，就是讲课不太爱听
109902,1293,沈莉萍,2019-06-20 05:33:46,0,1,1,挺好的老师o(^o^)o
110828,1293,沈莉萍,2019-06-28 09:48:10,3,5,2,大化A，是一个实验一个老师，沈老师算是我的班主任那样的感觉，只接触了一个实验，感觉挺好的。最后绩点不错，不知道有没有老师的帮助
111014,1293,沈莉萍,2019-06-29 06:38:35,3,6,3,现在还没有出成绩，暂不以成绩来论，老师本人真的很好很温柔也很负责，上课也很有趣，一学期点三次名，没来也没有关系，她会期末补签!!!果断9分!!
111893,1293,沈莉萍,2019-07-03 02:17:09,1,4,3,努力了一定有回报
111916,1293,沈莉萍,2019-07-03 02:38:04,5,6,1,听说出分前评论会理性一些，然而出分后想都不想10分走起
111920,1293,沈莉萍,2019-07-03 02:46:13,1,3,2,老师性格超级超级好，事少得好像没有这门课一样。花一个下午好好写写论文，一个下午好好复习，期末轻松满绩
111922,1293,沈莉萍,2019-07-03 02:53:21,-2,2,4,老师人很温柔，想水课的可选，点名三次，基本会提前通知，还可补签。期末考试自我感觉不是很好，好多题来不及翻书乱猜的，最后成绩下来还可以，应该是老师平时分打得高。总之，沈老师很不错啦~
111923,1293,沈莉萍,2019-07-03 02:56:07,-4,2,6,我来夸沈老师了！！提前告知最后一节课签到还可以补签真的是神仙老师啊！！然后军理导弹那里有点难，其它裸考，4.8欸嘿嘿
111926,1293,沈莉萍,2019-07-03 03:07:45,5,5,0,太棒了
111938,1293,沈莉萍,2019-07-03 03:41:44,3,5,2,基本都给提档了吧，好像就没多少卡绩的，给分没得说，好
111945,1293,沈莉萍,2019-07-03 04:01:26,1,4,3,沈老师真的好好，每学期点三次名，课后也可以迟到了补签，老师完全会包容。老师真的很好，我一次没到，真的没起来，但是论文有好好写，最后考试根本就没复习，坐在考场里了才翻了翻目录，不过题读的很仔细，考试做的很认真，很多东西书上还是没找到就随便懵了，最后绩点还有4.2！！！沈老师真的超好哇哇哇！而且而且，老师回答问题特别有耐心！！真的好好，老师好温暖，好喜欢～
111947,1293,沈莉萍,2019-07-03 04:06:59,1,3,2,给分吹爆
111953,1293,沈莉萍,2019-07-03 04:17:54,4,4,0,给分好！
111972,1293,沈莉萍,2019-07-03 05:08:11,6,8,2,拉高老师的评分！沈老师人真的很好了，生病请假会关心身体并告诉上课内容，问成绩组成会说“已经很棒了，祝学业有成”，论文手写防止恶竞还可以延迟到最后一节课交，老师人真的很好！
111979,1293,沈莉萍,2019-07-03 05:33:11,17,17,0,军理沈老师真的真的超级好，平时有三次点到但是可以补签，然后只有一篇手写论文2000字，讲课的话虽然中规中矩 但对学生的疑问都能耐心解答。还有，我不知道以前老师怎么样，但是真的不是绩杀！不是绩杀！不是绩杀！给分超级好，能给高尽量给高，还在录成绩前给大家核查的机会！！！强推！
112017,1293,沈莉萍,2019-07-03 07:34:54,10,12,2,老师好没的说！！大家努力把老师评分刷到9+冲鸭
112414,1293,沈莉萍,2019-07-04 05:02:33,2,3,1,老师给分真的很棒了，很少有卡绩的，平时只要手写一篇论文就行。还会事先把成绩公示，这种做法让人很舒服～爱了！
112491,1293,沈莉萍,2019-07-04 12:12:51,2,3,1,是一个私戳她问问题会很认真回答的老师！赞！
112650,1293,沈莉萍,2019-07-04 23:40:23,0,2,2,给分很好的军理老师了
112780,1293,沈莉萍,2019-07-05 02:57:20,3,4,1,给分超好的
112794,1293,沈莉萍,2019-07-05 03:22:00,7,7,0,老师真的很棒，耐心负责，经常在群里回答问题，对我们的成绩很重视，会尽力拔高我们的分数，还会因为没法拔了而道歉。同志们，放心选！
112824,1293,沈莉萍,2019-07-05 04:37:11,2,3,1,神仙老师！！！！
112869,1293,沈莉萍,2019-07-05 07:23:15,3,3,0,老师人很好啦
112933,1293,沈莉萍,2019-07-05 13:05:42,-7,8,15,沈老师的军理。一开始选课的时候还特别不情愿，即使知道她现在给分很好了，也还是想选lq的军理，总之没选上。然后沈老师的军理。就听了前两周和最后一周的课和复习课。其他时间虽然到了但是不是睡觉就是玩手机。而且基本上踩着点到或者迟到五分钟以内，感觉有点愧疚。沈老师考核形式是点三次名，交一篇手写的1000字以上的论文，再加统一的开卷考试，并且平时分会尽力给满。我三次点名都去了，论文水了3000字左右，期末考前做了标签，带着目录和书去考，看了看老师说会重点考察的那几章，最后满了，很感谢沈老师。
113210,1293,沈莉萍,2019-07-06 01:40:20,-1,2,3,真的是个很良心的老师
113288,1293,沈莉萍,2019-07-06 04:01:45,-12,2,14,老师讲的课可能很有意思，但是包括我在内没有人会听。
113291,1293,沈莉萍,2019-07-06 04:04:41,4,5,1,守护沈老师的评分❤ ❤ ❤\n\n
113345,1293,沈莉萍,2019-07-06 09:03:06,1,2,1,挺好的啊
113498,1293,沈莉萍,2019-07-06 19:16:26,-1,2,3,不错哦很不错
113885,1293,沈莉萍,2019-07-07 23:14:16,4,4,0,沈老师是真的给分好！事情也很少！
114653,1293,沈莉萍,2019-07-11 02:49:56,2,3,1,老师课讲得6考试前会划重点教怎么应对考试而且几乎是有问必答。论文可以找她修改，一学期点三次名到两次考勤分就满了。\n\n反正，选她就完事了
114976,1293,沈莉萍,2019-07-13 13:12:52,3,4,1,事情少，给分好
116214,1293,沈莉萍,2019-09-06 09:19:06,-26,7,33,借这里求问程春的军理事情多么给分如何 事情少给分好的话帮我点个赞
116258,1293,沈莉萍,2019-09-06 17:09:20,14,15,1,点三次名，可以有一次不到不会有惩罚。\n\n为人非常好，待学生没得说。\n\n而且，我这么说吧，不算军理，我均绩铁退院，沈爸爸的课硬是把我这个菜鸡奶了回来。\n\n沈老师今后就是我爸爸，我就是铁粉，谁黑她，我第一个不服。友军挺我上去
116356,1293,沈莉萍,2019-09-09 06:17:23,-1,2,3,只交一篇论文+点一次名
116469,1293,沈莉萍,2019-09-11 01:04:42,0,0,0,老师人真的很好!!!一点都不好绩杀，说绩杀的好好反思一下自己吧
116961,1293,沈莉萍,2019-09-18 00:16:41,1,5,4,讲课喜欢两脚分开，耸着右肩，腰部左右摆动
116970,1293,沈莉萍,2019-09-18 01:24:52,1,6,5,如果从拿绩点水水课的角度，沈老师的课很好，但是讲真的，在她课上学不到什么东西，虽然知识广播，但是对问题分析的见解有一种微博的既视感
117677,1293,沈莉萍,2019-09-29 00:09:26,0,0,0,超棒，超好玩\n\n我为老师正名
117935,1293,沈莉萍,2019-10-16 01:44:51,5,8,3,不好意思借楼，预置程春的建议退掉，大不了下次去再学，恶心到自己就不值得了。
118215,1293,沈莉萍,2019-10-23 06:08:57,2,4,2,一节课没听，认真写论文，考试疯狂翻书到最后一刻，4.5也满足了。
119305,1293,沈莉萍,2019-11-12 03:56:51,0,2,2,点名三次可以不到一次太好了
120377,1293,沈莉萍,2019-12-01 10:16:52,0,2,2,1000论文写了1200，最后4.8
120590,1293,沈莉萍,2020-01-13 13:18:13,1,3,2,老师给分超好！！！！
120591,1293,沈莉萍,2020-01-13 13:35:56,5,7,2,太棒了吧！！！沈老师真是每一档都给满人数的！反正我没听过课，考前看了一遍书，最后4.8。
120594,1293,沈莉萍,2020-01-13 13:49:45,2,3,1,期末考的不太行 最后搞了个3.9
120595,1293,沈莉萍,2020-01-13 14:20:37,2,4,2,对比其它思政课，沈老师的军理给分真的是浓浓师生情！必须吹爆老师！
120600,1293,沈莉萍,2020-01-13 16:17:44,-2,2,4,吹爆沈老师！！
121030,1293,沈莉萍,2020-01-19 09:41:03,3,5,2,我要吹爆沈老师！！！太太太太太好了！真的不绩杀！
121108,1293,沈莉萍,2020-01-19 15:23:10,3,5,2,沈老师真的很好，不知道绩杀的话从何而来
121115,1293,沈莉萍,2020-01-19 15:58:17,-7,1,8,老师给分真的变好了！ 虽然上课从没听过 但是认真写了论文认真复习了最后竟然满绩了！
121129,1293,沈莉萍,2020-01-19 19:45:43,-1,1,2,三次点名给分很好，可能上课无聊点，
121485,1293,沈莉萍,2019-12-15 11:01:35,4,5,1,别的不说，万能的群真的是万能：）
121535,1293,沈莉萍,2019-12-12 17:10:32,-2,0,2,真的很好很好很好，选她选她！！！
121595,1293,沈莉萍,2019-12-12 09:38:31,6,8,2,最佩服老师能在一堆复读里找到和课程相关的问题
121844,1293,沈莉萍,2020-01-22 11:25:02,3,4,1,老师人很好
121854,1293,沈莉萍,2020-01-22 15:41:58,0,3,3,平时点三次名，还会提前告知你，作业只有一篇手写论文，期末给分挺好的
122005,1293,沈莉萍,2020-01-30 12:44:51,-8,7,15,建议不要去听课，作业交上去就好了，是绩杀
122009,1293,沈莉萍,2020-01-31 01:40:24,1,6,5,给分虽只有3.3（被正态了)但是平时分很好，基本满了.还是自己个人原因导致的，因为一学期只去过四次课，考前没复习考场直接现翻书\n\n但是老师人真的很好，关心同学身体，没去还可以补签到，终成绩还会征求意见。\n\n以后我再也不这么水的对待一门课程了555
122123,1293,沈莉萍,2020-02-15 06:56:30,1,3,2,超级超级nice！！！！\n\n非常非常体贴！！！！\n\n正态的课尽量给高，会公布分数
122192,1293,沈莉萍,2020-02-20 01:27:39,-17,6,23,军理满绩了 谢谢老师
123097,1293,沈莉萍,2020-05-09 07:45:54,-8,4,12,被绩杀了
123551,1293,沈莉萍,2020-06-10 00:59:03,-1,1,2,我爱老师
125478,1293,沈莉萍,2020-09-10 03:37:01,4,5,1,认真负责
128580,1293,沈莉萍,2020-12-24 05:56:04,0,1,1,老师简直太好啦
129111,1293,沈莉萍,2020-12-30 07:33:48,1,1,0,赞一个
130561,1293,沈莉萍,2021-01-23 15:48:19,2,3,1,老师给分真的很好！大爱！
130567,1293,沈莉萍,2021-01-23 16:19:46,0,2,2,老师超好，提前了复习周，也很照顾学生！事情极少，性格开朗～唯一的女军理老师，爱了
130571,1293,沈莉萍,2021-01-23 16:55:10,-1,2,3,不错的老师
130581,1293,沈莉萍,2021-01-24 00:54:30,1,3,2,给分没有说的很绩杀
130588,1293,沈莉萍,2021-01-24 01:26:05,2,3,1,老师给分会拉到能拉的最高，不会绩杀
130595,1293,沈莉萍,2021-01-24 01:42:46,-1,2,3,真不戳，写论文不看字数的老师
130601,1293,沈莉萍,2021-01-24 02:09:28,11,13,2,nice老师，某些人请自重，zju的学生起码尊重自己的课，绩点不低的。老师考前会画重点，甚至把每个章节出题比例都告诉你。4.8飘过，真正的事少分多！论文不用手写
130623,1293,沈莉萍,2021-01-24 04:09:26,3,3,0,老师好
130625,1293,沈莉萍,2021-01-24 04:30:49,0,1,1,老师真的超级好！
130934,1293,沈莉萍,2021-01-25 09:21:05,-3,0,3,成绩尽力不卡绩，上课事少，论文不看字数
131095,1293,沈莉萍,2021-01-26 02:38:50,0,5,5,上课没认真听，就在书上记了记几节课的笔记，复习半天满绩。群里成绩一大半都是老师捞上一个台阶的，95呀92呀89呀啥的，老师给分真的真的很好
131155,1293,沈莉萍,2021-01-26 08:35:21,1,1,0,不错的老师
131307,1293,沈莉萍,2021-01-27 04:41:03,13,17,4,首先说一下给分吧，老师给分真的很好，平时分尽量给高，期末全是客观题，做的不好老师也没办法。讲课方面，一点也不无聊，除了课本上的知识，老师还会讲一些相关的军事故事。平时也很关心同学，论文提交也会在群里反复强调，我们的论文写好也可以发给老师提出修改意见。在考试之前，还会告诉我们每一章的题型，题目数量。\n\n我在期末考试之前的准备自认为比较认真，期末85，平时分49，总评4.8（仅供参考）。\n\n总的来说，沈老师是不可多得的好老师！十分走起！
134170,1293,沈莉萍,2021-03-18 00:56:56,1,3,2,今天听了第一节课，感觉很不错！
136246,1293,沈莉萍,2021-06-13 15:07:25,0,4,4,沈老师真的很好！选她不亏！
137802,1293,沈莉萍,2021-07-06 07:41:28,-2,2,4,yyds
138135,1293,沈莉萍,2021-07-07 12:55:36,2,6,4,给分也太好了吧？今年难但是捞得太明显了，我都不好意思了
138222,1293,沈莉萍,2021-07-08 04:06:01,2,3,1,给分很好
138604,1293,沈莉萍,2021-07-10 02:57:36,1,3,2,期末考炸了，但是老师还是把我捞上来了。
138801,1293,沈莉萍,2021-07-11 02:15:35,3,4,1,给分相当好，期末考自己努力
140675,1293,沈莉萍,2021-09-15 04:41:46,6,10,4,期末60，绩点3.9，谁不爱呢
144122,1293,沈莉萍,2021-12-18 15:18:46,4,6,2,老师很和蔼亲切，考试前会详细讲解划重点。
144229,1293,沈莉萍,2021-12-21 00:35:37,-1,3,4,123
144315,1293,沈莉萍,2021-12-21 05:43:10,1,4,3,非常好的一个老师
145841,1293,沈莉萍,2022-01-03 08:22:30,1,5,4,三次点名，签到码会写在黑板上。讲的挺好，只是听的不多。\n\n快考试了，救命~
146442,1293,沈莉萍,2022-01-06 14:56:25,-1,2,3,老师很好，是我太菜
146604,1293,沈莉萍,2022-01-07 04:58:43,6,10,4,军理来的，老师人太好了，事少还给分超级好！论文认真写不用卷字数，考前把书看一遍，标记一些交叉的东西，总评就会很高噢
146608,1293,沈莉萍,2022-01-07 05:09:46,-9,6,15,说平时分好的只是你们那届考试太拉了，平时分才给的高，我们这届平时分扣了很多的不在少数；室友三次点名没去，要么请假要么事后点名接龙直接全点名点上了，可以说点名有没有都差不多了
146609,1293,沈莉萍,2022-01-07 05:09:41,-6,4,10,说平时分好的只是你们那届考试太拉了，平时分才给的高，我们这届平时分扣了很多的不在少数；室友三次点名没去，要么请假要么事后点名接龙直接全点名点上了，可以说点名有没有都差不多了
146611,1293,沈莉萍,2022-01-07 05:13:48,1,4,3,点三次名但是会尽量让你点到，事少不卷字数，总评会尽量提档。虽然我没听讲但感觉到老师经历丰富讲的也比较有趣。主要给分好体贴学生，大爱，必给10分！
146613,1293,沈莉萍,2022-01-07 05:14:07,-1,1,2,真的很好！
146615,1293,沈莉萍,2022-01-07 05:19:52,0,2,2,必须给10分的好老师！
146619,1293,沈莉萍,2022-01-07 05:36:40,0,5,5,呜呜呜呜呜女神啊啊啊啊啊好能捞啊啊啊啊啊啊啊都给我选沈老师啊啊啊啊啊😍😍😍😍😍😍从海底捞到海面!!大家一看成绩一片89.92呜呜呜呜老师真的太牛了!
146621,1293,沈莉萍,2022-01-07 05:37:57,1,2,1,给分很好
146622,1293,沈莉萍,2022-01-07 05:39:18,1,2,1,大爱！我的女神！
146626,1293,沈莉萍,2022-01-07 05:46:47,-1,2,3,老师太好了呜呜呜呜
146627,1293,沈莉萍,2022-01-07 05:46:51,4,6,2,老师人很好，可以说很为同学着想了\n\n考前会梳理一下目录章节，小论文不卷但要认真写。讲课也挺有意思的~
146629,1293,沈莉萍,2022-01-07 05:50:04,2,3,1,分多事少，非常棒
146632,1293,沈莉萍,2022-01-07 06:13:09,0,2,2,谢谢老师
146662,1293,沈莉萍,2022-01-07 07:22:38,3,4,1,太好咧
146752,1293,沈莉萍,2022-01-07 10:29:06,-3,0,3,沈老师真的很温柔的\n\n个人认为网课活跃度比线下活跃度高
146972,1293,沈莉萍,2022-01-08 08:35:45,0,1,1,好好好
147001,1293,沈莉萍,2022-01-08 11:13:38,1,1,0,好老师，冲！
147298,1293,沈莉萍,2022-01-09 12:25:53,2,3,1,好好好
147490,1293,沈莉萍,2022-01-10 05:29:34,0,2,2,slp我滴超人！
147503,1293,沈莉萍,2022-01-10 05:56:46,5,6,1,给分之神，想要事少分高的选就完事了
147509,1293,沈莉萍,2022-01-10 06:17:02,-1,1,2,沈老师的点名如果没到的话可以在课后补签，真的是事少分高，爱了爱了
147533,1293,沈莉萍,2022-01-17 14:18:44,13,13,0,单论给分，是军理老师里最好的
147563,1293,沈莉萍,2022-01-10 08:29:58,1,1,0,沈老师，你冲就完事
147598,1293,沈莉萍,2022-01-10 09:27:40,1,1,0,绝世好老师
147702,1293,沈莉萍,2022-01-10 13:39:37,2,3,1,给分之神
147779,1293,沈莉萍,2022-01-10 23:50:21,4,4,0,给分很好
148094,1293,沈莉萍,2022-01-11 13:17:58,0,1,1,快来选沈老师！！
148146,1293,沈莉萍,2022-01-11 15:29:24,-2,0,2,军理真的超好，给分其实很可以的
148193,1293,沈莉萍,2022-01-12 00:26:07,-2,1,3,谢谢老师
148231,1293,沈莉萍,2022-01-12 02:16:00,0,0,0,老师给分很好哒
148294,1293,沈莉萍,2022-01-12 05:40:16,1,2,1,沈老师给分贼好天使一般的存在呜哇呜哇
148295,1293,沈莉萍,2022-01-12 05:40:01,-1,0,1,沈老师给分贼好天使一般的存在呜哇呜哇
148440,1293,沈莉萍,2022-01-12 12:51:23,3,3,0,很好！
148620,1293,沈莉萍,2022-01-13 04:35:09,-1,2,3,我爱slp，军理讲课内容很充分，给分超级好，让我重拾思政课的信心☺️
149233,1293,沈莉萍,2022-01-15 00:37:16,0,1,1,给分很好
149468,1293,沈莉萍,2022-01-15 12:51:10,-1,0,1,给分很高。
150583,1293,沈莉萍,2022-01-31 05:05:28,17,19,2,军理课。不咋点名，即使点名也提供补签到的机会；课堂内容比较有趣和通俗，十分适合我这种军事小白；想听就听，不想听还可以干别的，期末是开卷选择，只要把课本通读一遍问题不大；论文给足够长的期限。最后成绩能捞就捞，能高分就高分。本人不了解军事，但是按老师的要求做了，最后绩点4.5，班里4.5+的一大把一大把。很感谢沈老师。
151070,1293,沈莉萍,2022-02-22 15:36:44,5,7,2,沈老师真的永远的神好吧！！！\n\n真的选她真的！！！\n\n她真的很能捞捞！！！\n\n孩子感动哭了！！！
151187,1293,沈莉萍,2022-02-24 06:07:02,5,6,1,沈老师真的很好好好！
151394,1293,沈莉萍,2022-03-02 06:08:21,39,47,8,乌克兰事件讲的很好。建议圣母们都听一听。
152186,1293,沈莉萍,2022-03-30 00:09:51,-40,7,47,讲课结结巴巴，听不下去，内容不怎么样，没有新意\n\n这个这个呃呃
154445,1293,沈莉萍,2022-06-01 13:16:22,2,5,3,看最新评论，只能说dddd\n\n指事少分高
154479,1293,沈莉萍,2022-06-02 01:24:48,1,2,1,好的好的
154480,1293,沈莉萍,2022-06-02 01:24:00,1,3,2,好的好的
155276,1293,沈莉萍,2022-06-10 05:32:11,3,4,1,军理事少分高对学生好\n\n你漏了签到下节课去找她补就行
155474,1293,沈莉萍,2022-06-13 09:16:56,6,7,1,是时候给老师一个10分了，请老师救救我一塌糊涂的考试555
155497,1293,沈莉萍,2022-06-13 14:25:20,3,3,0,求求slp老师捞捞～🙏军理太难了
155854,1293,沈莉萍,2022-06-16 09:59:42,7,15,8,军理 一节课没听 基本没去上课 签到智云数字签到 论文注水 4.5 slp我的超人
155859,1293,沈莉萍,2022-06-16 10:09:39,3,4,1,给分的神
155860,1293,沈莉萍,2022-06-16 10:17:17,0,2,2,老师特别好
155861,1293,沈莉萍,2022-06-16 10:19:13,2,3,1,事少分高，slp老师永远的神
155862,1293,沈莉萍,2022-06-16 10:24:33,4,4,0,你是我的神 给分真的好 一学期都没咋去过
155864,1293,沈莉萍,2022-06-16 10:29:10,1,2,1,事少分高yyds
155867,1293,沈莉萍,2022-06-16 10:44:19,2,2,0,事少分好
155870,1293,沈莉萍,2022-06-16 10:48:12,0,2,2,给分很好！
155871,1293,沈莉萍,2022-06-16 10:50:33,0,1,1,slp我的超人！
155895,1293,沈莉萍,2022-06-16 13:17:26,1,2,1,事少给分好 女神！
155909,1293,沈莉萍,2022-06-16 13:39:09,10,14,4,上过沈老师的军理课，真的很感谢她没有因为国籍问题对我有芥蒂，在我完成论文作业最无助的时候给了我一次机会，谢谢老师能理解我的情况
155934,1293,沈莉萍,2022-06-16 15:23:48,0,1,1,我的超人！
155939,1293,沈莉萍,2022-06-16 15:34:11,2,2,0,老师给分太好了，很负责认真。
155941,1293,沈莉萍,2022-06-16 15:50:20,1,2,1,slp老师我的超人！！
156065,1293,沈莉萍,2022-06-17 10:05:03,8,9,1,壹佰昏！
156119,1293,沈莉萍,2022-06-17 15:29:55,11,11,0,菩萨心肠
156127,1293,沈莉萍,2022-06-17 16:38:30,11,15,4,就 之前，可能还有人，对slp的给分好，没有什么概念，那我再给大伙儿讲一遍，按时提交论文（我也就写了2k字）+签到都到了（你用什么方法我就不说了）+期末带着本书和知识点目录去裸考=4.8，这就是slp给分好的含！金！量！我不知道你们是不是有认真学军理的，如果是想水一水，那必须得选slp
156202,1293,沈莉萍,2022-06-18 07:37:08,6,8,2,沈老师上课讲的内容对我这种军事小白还是很有帮助的，最后给分也超级超级好~
156260,1293,沈莉萍,2022-06-18 13:58:38,9,11,2,神莉萍
156432,1293,沈莉萍,2022-06-19 15:13:35,4,7,3,给分很好
156444,1293,沈莉萍,2022-06-19 17:26:03,18,21,3,为什么大家都只关注老师给分很好呢？明明讲课也讲的很好啊！学期初两次上课乌克兰问题分析的很到位
156975,1293,沈莉萍,2022-06-21 13:04:17,1,3,2,老师好人！！！讲得很有意思，呜呜呜，感谢老师。
156995,1293,沈莉萍,2022-06-21 13:22:00,2,5,3,给分很好
157209,1293,沈莉萍,2022-06-22 09:56:06,-1,2,3,超人！
157225,1293,沈莉萍,2022-06-22 12:23:15,3,7,4,我的成绩全靠老师捞上来的
157726,1293,沈莉萍,2022-06-24 12:55:13,28,33,5,点名数字签到，不去也可以，数字在黑板大大地写着，智云可以看到，朵朵上也可以问\n\n讲课不错，认真听过几节\n\n事情少，就一个论文，平时分几乎都给大家给满\n\n一个班200来人，100个4.5及以上，不用多说了吧
158832,1293,沈莉萍,2022-07-02 13:33:11,4,5,1,好老师！
159079,1293,沈莉萍,2022-07-05 18:09:04,2,5,3,超级棒的老师！！军理
160036,1293,沈莉萍,2022-09-12 06:24:22,1,4,3,不说了 耶
161319,1293,沈莉萍,2022-11-04 05:32:17,7,9,2,22春夏上的，给分还行，但是上课真不怎么样，可能是语言表达不够好吧。想水的推荐slp，想听听真的军理还得是lq、cc这些
164470,1293,沈莉萍,2022-12-21 06:57:21,5,8,3,slp yyds
164790,1293,沈莉萍,2022-12-26 07:03:30,-132,1,133,给分不好，只有4.8
165122,1293,沈莉萍,2022-12-29 08:31:41,4,5,1,水。但分还行
165628,1293,沈莉萍,2023-01-09 05:07:24,9,13,4,沈老师我的神，线上考试剩十分钟还有十道多选没做，本以为最多只有3.几，没想到最后总评还有86，感谢老师
165646,1293,沈莉萍,2023-01-09 05:59:05,2,3,1,老师不错
165647,1293,沈莉萍,2023-01-09 06:00:21,0,2,2,老师超好，我反正觉得自己被狠狠捞了
165652,1293,沈莉萍,2023-01-09 06:26:08,3,5,2,最好的老师，一学期一个论文一个期末考试，点名会写在黑板上，期末轻松4.5，感谢老师海底捞。
165837,1293,沈莉萍,2023-01-10 05:13:07,14,15,1,期末难没办法，可以私戳助教，平时分基本58-60分，老师仁至义尽，很负责任
165868,1293,沈莉萍,2023-01-20 07:06:53,5,6,1,老师认真的好好!一定要选她!
166239,1293,沈莉萍,2023-01-11 13:34:32,2,3,1,沈妈妈你是我的神！！！
166449,1293,沈莉萍,2023-01-12 09:36:15,24,24,0,平时分很高，都是58-60，平时上课也没有提问，签到持续一整节课，我睡过头了也能找她补签。\n\n说个题外话，这个学期的期末考试是真的阴间。。。
166566,1293,沈莉萍,2023-01-13 00:30:32,7,8,1,老师太好！如果对军事理论不算很感兴趣平时想摸鱼划水，一定要来！
166992,1293,沈莉萍,2023-01-14 13:35:31,-33,6,39,这老师还行，不过不会给满绩，今年我们班3个4.8，没满绩
167718,1293,沈莉萍,2023-01-18 14:37:51,3,4,1,平时分给满了，谢谢老师捞捞，是我期末考得太差了呜呜呜
167814,1293,沈莉萍,2023-01-19 08:06:22,19,20,1,平时分拉满，老师特别好，最后绩点4.5，也满意了\n\n但军理这门课本身期末考是客观题，所以期末考多少就是多少，但期末毕竟只占40%，而总评有保底的60分还怕啥呢\n\n老师不是不给满绩，而是确实考的不够满绩的线，所以能看到有的班有人满绩，但有的班却一个满绩也没有，这不是老师的问题
170466,1293,沈莉萍,2023-03-05 08:50:18,3,4,1,沈老师真的很棒，一定要选她，很适合划水。
170698,1293,沈莉萍,2023-03-08 07:44:07,5,6,1,给分好事情少
170720,1293,沈莉萍,2023-03-08 12:48:27,15,17,2,老师第一节课说巴不得每个同学成绩都是优秀，懂了吧
170986,1293,沈莉萍,2023-03-14 00:22:46,5,8,3,老师真的是女菩萨，点名只会数字点名，平时分直接拉满，一学期一次教室都没去过最后4.5，感谢老师
171418,1293,沈莉萍,2023-03-23 23:36:26,31,34,3,老师你怎么突然雷达点名了呀
173649,1293,沈莉萍,2023-05-31 05:44:53,4,5,1,好老师不多说
175459,1293,沈莉萍,2023-06-25 04:32:28,-2,1,3,很好的老师
176280,1293,沈莉萍,2023-06-28 08:32:13,7,9,2,期末考翻不到😭😭老师很好
176702,1293,沈莉萍,2023-06-29 18:10:33,8,10,2,《军事理论》无脑选slp老师就完了，签到都是课前签，不会不定时签，没有小测
176836,1293,沈莉萍,2023-07-03 00:51:04,8,11,3,还没出分，先来给老师打10分。\n\n老师真的很好，个人觉得上课讲得挺不错的，而且签到什么的都很松。\n\n出分了回来补充：全班两百多个人没有看到卡绩的，老师很捞放心选！
177075,1293,沈莉萍,2023-07-01 14:25:07,4,6,2,沈老师的军理你不选就亏了
177170,1293,沈莉萍,2023-07-02 03:34:25,4,6,2,沈丽萍老师太好了，快给我冲冲冲！！！不卡绩，我一个小笨蛋也能拿到4.5。好老师，快冲！
177172,1293,沈莉萍,2023-07-02 03:39:05,0,3,3,巨捞，人好
177174,1293,沈莉萍,2023-07-27 10:46:31,48,51,3,期末50，最后3.6\n\n别的不说，我就问什么课期末50能拿到这样的绩点，这还不爱吗
177178,1293,沈莉萍,2023-07-02 04:04:37,0,1,1,沈老师yyds！😍😍
177186,1293,沈莉萍,2023-07-02 04:39:29,2,4,2,水了一学期，除了点名就没到过，论文一天写完，考试当天复习两小时，最后4.2。大家懂了吧
177189,1293,沈莉萍,2023-07-02 04:51:38,2,4,2,老师真的特别特别好!期末很多没翻到以为要寄了 硬是被捞到89!
177199,1293,沈莉萍,2023-07-02 06:01:12,1,3,2,非常温柔，为学生着想的好老师，平时分基本都给很高很高，就是期末开卷真的太难翻了😭😭😭
177203,1293,沈莉萍,2023-07-02 07:13:12,1,5,4,军事理论。一学期签五次到，之前是数字点名现在是雷达点名，会在上课和下课的时候开两次雷达，两次只要签上一次就行，而且一次没签上平时分也只扣一分左右。平时分给分真的很好。
177501,1293,沈莉萍,2023-07-03 13:21:49,6,8,2,沈老师超级好，秋冬的时候都是数字点名，而且没点到还可以补，平时分基本都是拉满，就看最后翻书快不快
177651,1293,沈莉萍,2023-07-06 08:43:52,47,48,1,如果你不是军事迷，只想想水一水军理的话选slp等于选择成功\n\n事少到上了好像没上一样\n\n（论文不查重的，大家能粘尽粘，最后平时分都给满）
177668,1293,沈莉萍,2023-07-05 01:01:32,11,15,4,群里成绩公示有一堆89，确实尽力给大家好分数了，谢谢老师！
177809,1293,沈莉萍,2023-07-05 02:35:20,9,10,1,军理在考场上第一次打开书，翻得手忙脚乱，lp姐姐还是捞我了！签到是根据学校要求，一学期就几次，还会开补签！选她！超级好超级好
177861,1293,沈莉萍,2023-07-05 06:23:42,6,7,1,签到超级无敌松，快选！
177897,1293,沈莉萍,2023-07-05 09:39:24,6,8,2,老师人很好
177932,1293,沈莉萍,2023-07-05 14:05:46,15,16,1,这学期雷达点五次名，每次半小时，下课开放补签。\n\n要求一篇论文。\n\n给分非常好！\n\n沈老师一般平时分拉满，不出意外只有两种情况会扣你的平时分：一种是不扣会卡绩，另一种是不扣成绩太好无法上传。
178828,1293,沈莉萍,2023-07-24 16:20:37,7,10,3,不说了，军理选到就是赚到
178849,1293,沈莉萍,2023-07-25 18:15:11,-49,3,52,捞人纯扯淡。。。
178894,1293,沈莉萍,2023-07-29 06:01:55,25,28,3,给分好的老师我见过不少，但沈老师是我见过的唯一一个真正想拼尽全力极限给到每个同学最高分的老师。
179483,1293,沈莉萍,2023-09-17 07:16:56,5,6,1,天……这么几年slp老师涨了好多分，还有什么可犹豫的
179509,1293,沈莉萍,2023-09-18 00:39:20,3,4,1,好好好
179704,1293,沈莉萍,2023-09-19 12:02:25,3,4,1,人很和善，上课的话挺无聊的，课程内容本身也无聊。不过老师还是很认真细致地在授课，考试前范围划得十分清楚。平时就交一篇论文，最后给分也不错。
181947,1293,沈莉萍,2023-11-06 07:23:14,12,12,0,军理不冲slp会变得不幸
184500,1293,沈莉萍,2023-12-21 04:22:15,-9,5,14,讲课不太行，比较无聊，明明这些内容能讲得挺生动的，有点失望。
184527,1293,沈莉萍,2023-12-21 12:05:06,9,10,1,绝对的好老师，对同学们很宽容，上课也很有趣，会跟同学们互动，但是大家好像都比较摆，所以回应的同学也很少，说实话挺心酸的，老师真的是在三尺讲台默默付出了
184830,1293,沈莉萍,2023-12-23 07:39:46,4,5,1,老师签到超友好，数字大大的写黑板，给分也好。
185202,1293,沈莉萍,2023-12-27 05:07:12,17,18,1,任何人不给slp10分我都要和你同归于尽
187062,1293,沈莉萍,2024-01-14 09:39:14,4,4,0,允许补签的老师，不布置小测的老师，是我考试时候翻书没翻到。老师人好
187967,1293,沈莉萍,2024-01-18 02:13:40,3,4,1,老师给分真的好
188004,1293,沈莉萍,2024-01-18 03:22:58,15,17,2,预置了slp老师军理的同学把嘴角收一收谢谢
188187,1293,沈莉萍,2024-01-18 11:13:48,1,3,2,非常好的老师，大赞！！！
188230,1293,沈莉萍,2024-01-18 12:51:03,2,3,1,事少分高
188312,1293,沈莉萍,2024-01-18 15:18:23,2,2,0,非常棒的老师，人很和蔼，给分也不错
188760,1293,沈莉萍,2024-01-20 01:03:04,17,24,7,想水军理！必须slp！\n\n其他老师会有雷达点名+课堂小测。但是，slp老师绝对没有小测，点名都是数字点名，还把数字写的特别特别特别大！方便智云的人签到，我哭死！\n\n教室里人肉眼可见的少，她也不雷达点名，只数字点名！！！\n\n成绩:给分上面，180个的班，刚好50个4.8+，刚好100个4.5+，绝对是把成绩捞到最满了
191776,1293,沈莉萍,2024-04-30 05:54:57,-22,4,26,错误百出，可以休矣
192241,1293,沈莉萍,2024-05-13 01:18:28,-26,5,31,本来对军理挺期待的，但这讲得是否有点太无聊了些，不知道别的老师是不是这样。\n\n半个学期了，每次课我都到，但是真的好失望......
193930,1293,沈莉萍,2024-06-21 01:57:12,10,10,0,老师人真的很好，平时签到在黑板上大大地写上数字，还念好几遍，然后论文要求也只是1000+，复习课也一再给我们强调......感觉老师真的非常真诚。但是实事求是地说，老师讲课确实是比较无聊的，而且稍微有一点口音，不明白为什么大家都要踩那条评论，如果真的有很喜欢军事，想在这门课上学到更多东西，而对绩点不太关注的话，可能确实lq、cc老师讲的更好一些，会更合适一些。
194015,1293,沈莉萍,2024-06-21 11:38:12,4,4,0,事少放心水，签到数字点
194549,1293,沈莉萍,2024-06-24 10:08:34,-10,3,13,军理满了，从来没听课，老师的含金量不多说了
194550,1293,沈莉萍,2024-06-24 10:17:18,5,8,3,真得叫声妈！一学期没去还给捞到93！你是我的神！
194552,1293,沈莉萍,2024-06-24 10:28:59,4,6,2,妈妈你是我第二个妈妈，每次数字点名写满一整面黑板（上下翻的那种）暖我一辈子，开卷好好翻（估分90左右）+论文3000字+没缺勤最后93，妈妈我爱你🥹
194557,1293,沈莉萍,2024-06-24 10:44:45,6,6,0,军理满了，老师真的捞疯了，军理想要高分请认准沈老师！！
194601,1293,沈莉萍,2024-06-24 13:57:38,2,3,1,不多说了，只能说感恩
194754,1293,沈莉萍,2024-06-25 09:13:44,5,5,0,很适合不太喜欢听这门课的同学
194797,1293,沈莉萍,2024-06-25 12:20:42,0,3,3,沈老师很好很温柔www，不过平时不了解军事的同学考试之前一定要好好好认认真真的翻一下教材！军理考试强度还蛮大的~
194860,1293,沈莉萍,2024-06-25 17:46:47,0,2,2,事少分高的典范
194933,1293,沈莉萍,2024-06-26 03:24:34,0,2,2,捞捞界的女王！😭老师太好了，其实讲得也很不错啊
194973,1293,沈莉萍,2024-06-26 06:53:19,3,4,1,首先老师人很好，签到都会数字写在黑板上，整节课都开放签到，即使有什么问题也可以下课的时候过去找她补签\n\n然后就是军理这个课很多内容来不及讲需要自己看，但是老师基本把重点内容都在考试前过了一遍\n\n我自己论文认真写，考试考的应该还算可以，最后拿了93 4.8，只要认真上，写好论文，考试尽力而为分数肯定不会太差
194987,1293,沈莉萍,2024-06-26 07:35:08,8,10,2,一个出分能让大多数学生为之欢呼的老师\n\n已经胜过了这个学校的绝大多数\n\n\n\nps：老师上课讲话杭州腔很像我妈妈在唠叨，大脑比较容易过滤hhh
195019,1293,沈莉萍,2024-06-26 10:27:38,1,2,1,其实军理的得分还是看期末吧，平时分也差不多给满了。除开给分这一说法，老师确实是关心学生的，不应该受到某些差评。
195225,1293,沈莉萍,2024-06-27 09:34:03,7,9,2,88以为被卡绩？\n\n实际平时分满了\n\n课上的内容其他评论应该差不多了
195227,1293,沈莉萍,2024-06-27 09:38:20,-2,1,3,基本看期末，平常分的神！！
195255,1293,沈莉萍,2024-06-27 12:56:29,8,9,1,"""选上slp老师的军理就偷着乐吧""——摘自朵朵\n\nslp老师真的是给分很好很好的老师了，平时数字点名不说，特意写在黑板上\n\n然后有一次缺勤，但最后总评也是给到了93，真的超级捞了，大部分平时分应该都是满的\n\n\n\n关于有人说老师讲课无聊的，可能老师讲的确实没有cc和lq老师讲得生动，但是slp老师在最后期末划重点的时候是比较到位的，lq老师还是要求比较严格的，如果很在意绩点的话那就没办法了\n\n——————但是，其实大部分同学真正了解军理的时候其实是期末考试翻过的资料吧，如果真的对这方面感兴趣，那智云也未尝不可呀\n\n\n\n\n\n再次感谢老师（鞠躬）"
195597,1293,沈莉萍,2024-06-29 03:12:51,1,3,2,非常好
195917,1293,沈莉萍,2024-07-01 00:50:38,11,14,3,平时分捞满！！上课可能比较一般但是很负责的老师 数字签到也会反复提醒 主要还是看期末 期末一定要提前看一下军理资料呀不然考场上根本翻不完5555 以及早点涂卡！！考场上有同学铃声响了之后还在疯狂涂卡老师制止了也不停下……
196037,1293,沈莉萍,2024-07-01 08:35:32,-21,7,28,好老师，无需多言。从来没有上过一节课最后也可以满绩
196785,1293,沈莉萍,2024-07-05 06:20:37,1,4,3,特别好的老师，数字签到，期末划重点。复习得比较认真，满了
197480,1293,沈莉萍,2024-07-16 11:35:35,2,7,5,真神\n\n数字点名+签到码大大地写在黑板\n\n备课也很认真
197493,1293,沈莉萍,2024-07-17 08:39:37,-1,9,10,9分，老师人很好，给分很公允
201651,1293,沈莉萍,2024-11-05 06:31:05,0,0,0,非常好
205449,1293,沈莉萍,2024-12-06 11:45:35,2,2,0,神中神，给10分
205805,1293,沈莉萍,2024-12-12 05:33:29,2,2,0,超级好
208583,1293,沈莉萍,2024-12-29 16:18:30,0,1,1,爱你爱你，负责的老师
208668,1293,沈莉萍,2025-01-07 17:02:59,0,1,1,老师很好，给10分
208951,1293,沈莉萍,2025-01-03 14:08:20,1,1,0,人不错，作业只有论文，拖到最后交，平常不怎么点名
209576,1293,沈莉萍,2025-01-06 09:30:58,-16,11,27,沈老师真的特别好啊，论文用ai写的，期末也有一大堆没找到的，还给了我人生中第一个满绩。这么好的老师哪里找。上课很负责，事少分高。期末还会给我们划重点，甚至花一节课的时间给你讲答题卡的格式和要注意的地方，这么负责认真的老师，10分奉上好吧。
209580,1293,沈莉萍,2025-01-06 09:48:30,5,6,1,还是挺好的吧，个人感觉捞还是捞了点的，期末太难了
209581,1293,沈莉萍,2025-01-06 09:35:28,2,2,0,沈老师人真的很好哇！！！问问题也会很快回复我（虽然有好几个问题都是上课讲过我没认真听的……）给分也很好！把我捞上去了捏！！大爱沈老师！
209613,1293,沈莉萍,2025-01-06 10:59:55,1,3,2,老师人超级好啊，妈妈的感觉🥹平时点名会提前说，也会划重点讲注意事项，上课暖暖的（虽然基本没听过imsorry）论文的框架仔细思考并和老师交流了但内容有部分ai的+考前花了一个下午加把课本过了一下，最后满了。是花点功夫可以拿高分的课，上课体验感也很舒服，放心冲冲冲！
209697,1293,沈莉萍,2025-01-06 15:25:52,3,3,0,上课基本没听，干自己的事，交了一篇小论文大概2000字，最后绩点4.2，平时分60老师给了59感觉真的很不错了，但是因为可能考的不好吧，不算低的绩点了，但是还是有点小遗憾，slp老师很好！
209725,1293,沈莉萍,2025-01-07 01:26:23,0,1,1,好老师，讲课很细心，考前划重点，数字点名（有几次雷达点名也是整节课都开着），不卡绩，10分。
210631,1293,沈莉萍,2025-01-09 13:23:28,3,3,0,捞王 伟大无需多言
210906,1293,沈莉萍,2025-01-10 06:25:07,-1,1,2,谢谢沈老师呜呜呜，平时分的神。就是这一届的期末考试好难呜呜呜。
211042,1293,沈莉萍,2025-01-10 11:42:08,2,3,1,十分好老师，开卷考试还带着你复习
211174,1293,沈莉萍,2025-01-11 03:19:11,4,4,0,这学期有雷达点名了，但平时分给满，伟大无需多言
211622,1293,沈莉萍,2025-01-12 04:50:02,3,3,0,特别好的老师，数字点名是会大大地写在黑板上的，雷达点名是会提前告知的，课后是可以补签的，平时分是可以给满的，只要开卷考试找的够多总评是差不了的
212672,1293,沈莉萍,2025-01-14 12:13:15,1,2,1,她真的很适合对军理本身不感兴趣的同学。给分好，平时事少，考试翻翻书，分数就乐意给的不错
212716,1293,沈莉萍,2025-01-14 14:28:51,0,1,1,平时分都给满了
213710,1293,沈莉萍,2025-01-19 08:35:31,4,4,0,传奇耐捞王，给分一流！平时分基本全给满（甚至交上去的论文其实基本是不怎么看的，就是用来调平时分的），点名也会开很长时间，很适合想水军理这门课的人。
213831,1293,沈莉萍,2025-01-20 07:54:16,3,4,1,老师很好，数字点名是会大大的写咋黑板上\n\n这学期加了几次雷达\n\n但是时间都是从八点到九点三十五一直开着的\n\n作业只有一篇论文，基本上是给满的\n\n老师平时分会给满，尽可能的不让大家卡绩的！\n\n可能是我自己考的不怎么样\n\n这学期试卷有点难、、时间来不及，很多没翻到
214075,1293,沈莉萍,2025-01-23 12:07:04,14,15,1,老师很好！分享一个很萌的记忆，老师说有些同学可能期末考试的时候忘记她叫什么名字了，在卷子上写个女老师也行，因为教军事理论课的只有她一个女老师，谁懂啊感觉好萌好好笑hhh
215333,1293,沈莉萍,2025-02-25 07:37:35,0,0,0,是个好老师
217023,1293,沈莉萍,2025-03-31 11:29:55,4,4,0,很适合对这门课不感兴趣的同学
217423,1293,沈莉萍,2025-04-10 06:26:09,2,3,1,思政课老师都向这位看齐可以吗
219134,1293,沈莉萍,2025-05-22 05:34:21,0,0,0,好老师，不让我们内卷
219865,1293,沈莉萍,2025-06-09 07:35:14,0,2,2,拿了5.0的同学来补充一下，slp老师提前一个月会有一节复习课，一定要认真听，按照她说的做你也能拿5.0！
220191,1293,沈莉萍,2025-06-16 06:42:11,1,1,0,很好很和蔼的老师，期末太难了都没翻到，老师真的很好！
220198,1293,沈莉萍,2025-06-16 14:17:28,2,3,1,军事理论 2024~2025春夏 周二早上班均绩4.1整（除去弃修未考的）
220225,1293,沈莉萍,2025-06-16 13:31:44,-5,1,6,给绩没有以前好
220289,1293,沈莉萍,2025-06-17 06:59:17,0,0,0,真的好老师 人很和蔼 点名会在黑板上大大地写着 讲课不是无聊念书念ppt 就是语速有点快 最后一节课还叮嘱我们期末周不要过度劳累了 还是要好好休息 然后说谢谢同学们一学期的支持 很真心了 平时分也是基本给满 有此老师夫复何求
220317,1293,沈莉萍,2025-06-17 08:32:56,2,2,0,沈老师人真的很好，点名也会开一节课，没签上的同学下课也可以补签。但这学期期末出的难确实是客观原因，老师也捞不了，平时分基本上给满已经是老师努力过后的结果，甚至老师明确说会特意捞卡绩的同学。我绩点不够高只能是我自己的问题，绝对不会是沈老师的问题。
220573,1293,沈莉萍,2025-06-18 14:31:31,2,2,0,有此老师夫复何求
221219,1293,沈莉萍,2025-06-22 04:56:28,0,0,0,军理真神！
221358,1293,沈莉萍,2025-06-23 04:21:49,1,1,0,事少分高。雷达点名会开一节课的，且不会突击点名。给分方面只能保证平时分捞到你所能到的绩点的最低分（也就是按照你期末考试的成绩平时分选择性的给58/59/60），如果学院保研是百分制算分的建议去选cc，如果是按5分制的slp就是你最好的选择
221553,1293,沈莉萍,2025-06-24 12:07:45,0,0,0,军理非常捞非常好，最后公示成绩的时候我们班好像都没有卡绩的
221715,1293,沈莉萍,2025-06-25 11:40:25,0,0,0,给分好，点名宽松\n\n但我觉得课讲成这样。。。只能靠以上几点获得学生是一种悲哀
221777,1293,沈莉萍,2025-06-26 07:46:53,0,0,0,沈老师真的很好，讲课认真，事少给分还高，强烈推荐
49298,1354,郑元男,2019-05-19 00:21:49,11,13,2,上课态度差 考评标准完全不合理 给分也差 为什么不能给0分呢
60800,1354,郑元男,2019-05-19 00:21:57,8,9,1,真的烂
61674,1354,郑元男,2019-05-19 00:20:04,8,9,1,太差了
74643,1354,郑元男,2019-05-19 00:22:03,8,9,1,什么玩意儿！！！
74644,1354,郑元男,2018-03-05 02:49:09,9,10,1,那些受过的伤提醒着
74676,1354,郑元男,2018-03-05 06:59:13,0,4,4,其他也都蛮好的
75838,1354,郑元男,2018-03-19 15:07:49,5,7,2,迷之老师...上课迟到扣2分，旷课扣5分...然后上课基本只关注基础好的同学，基础差的都不怎么管只让他们自己学，最后要是没考好还是自己背低绩点的锅...上课总是否定学生....还会说学生不尊重老师...
79880,1354,郑元男,2018-06-15 00:43:52,5,7,2,怎么现在打不了0分了……上这个真的要小心，不是只管基础好的而是只管他觉得喜欢他的和他喜欢的，而且第一节课就给你打好标签了，而且一定会正态分布，回答问题答的太对不高兴不答也不高兴，问了他答不上来的就不理你了，个人感觉大概是因为没有非常渊博所以自信不足，十分需要找存在感了。学长已经做好被绩杀的准备了，谁让我被讨厌了。要是你第一节课被他觉得不错，那以后就做第一排，然后在他想互动的时候及时互动，做东西做的快，那成绩应该不错。
125894,1354,郑元男,2020-09-15 10:54:43,-1,2,3,老师很认真
5416,1482,翟俊卿,2015-07-07 08:42:43,1,22,21,很有趣 很有个性 给分还超好
8360,1482,翟俊卿,2015-09-19 09:31:38,-7,11,18,有趣有魅力
11447,1482,翟俊卿,2015-12-01 11:38:21,6,14,8,点名有点可怕
11602,1482,翟俊卿,2015-12-07 10:40:35,-1,12,13,不错！
11685,1482,翟俊卿,2015-12-11 11:52:42,6,13,7,哎…………
11706,1482,翟俊卿,2015-12-12 02:25:21,-9,14,23,不愧是名校海归，科研实力雄厚，上课讲的都是他最新研究成果，非常赞
12583,1482,翟俊卿,2015-12-23 14:10:12,9,15,6,几乎每次点名，而且还会抽查课后翻译作业。
22406,1482,翟俊卿,2016-04-09 01:50:20,-3,12,15,教学内容深入简出，照顾到了非教育专业的同学
23604,1482,翟俊卿,2016-04-09 01:58:23,-7,9,16,上课内容丰富多采，风趣幽默，启发性强，还有在校友林和情人坡进行户外学习体验及户外教学设计，赞
24064,1482,翟俊卿,2016-04-26 10:17:41,-6,10,16,很好的一位老师，上课氛围很轻松，老师也能积极调动学生独立思考
33035,1482,翟俊卿,2016-09-10 09:59:51,-4,11,15,上了翟老师的课才发现社科是如此有意思，他的研究也非常有创新意义，总之一个字「赞」
33036,1482,翟俊卿,2016-09-10 10:03:25,-6,11,17,风趣幽默，和蔼可亲。\n\n学识渊博，治学严谨。\n\n关键是能拿到推荐信，而且是他亲爱写的
36294,1482,翟俊卿,2016-11-11 14:12:03,-6,10,16,思想的火花\n\n
38427,1482,翟俊卿,2017-01-12 14:00:16,7,24,17,不负责
38490,1482,翟俊卿,2016-12-21 10:40:18,0,13,13,崇洋媚外
39388,1482,翟俊卿,2018-03-07 06:18:47,11,27,16,评分标准都不清楚，很随意，明明说过不交也可以的作业最后莫名其妙变成评分项目。对女生有点存在大英Gender difference里说的现象，特别喜欢心理学教育学的学生，略看不起人文。可以看出备课不认真，上这种课对他来说应该很轻松吧。请病假的时候看起来会原谅你，后来分数扣得很厉害搞得你是故意不来上课一样。学得很认真，最后才3.3，一句期末作业差，课堂作业没交（就是之前说的不交也可以然而交了没收到，文档修改日期等都可以证明给他看就是不给你改分数），缺课。还以缺课本来可以取消期末考试资格来威胁。没有那种儒雅气质，略社会。
41495,1482,翟俊卿,2017-01-12 04:21:40,12,16,4,一定要发言，讨论。
41763,1482,翟俊卿,2017-01-13 09:30:10,1,14,13,自以为是，歧视女生，给分超级坑，付出和回报不成正比。
43445,1482,翟俊卿,2017-04-06 01:29:08,9,14,5,还是有科研实力的…
43940,1482,翟俊卿,2017-01-17 06:49:07,5,14,9,非常不负责任，完全乱给分
48291,1482,翟俊卿,2017-03-02 02:44:22,1,12,11,并不觉得是个好老师要不是因为专业课必上的话才不会选
48817,1482,翟俊卿,2017-08-16 08:23:31,1,13,12,凭良心说，这是在浙大最不喜欢的老师，没有之一。明明可以中文讲的课偏要用蹩脚的英语来说，外国好的东西固然可以学习，但也没必要连语言都要用他们的来讲吧，中文讲不清楚吗？教育教育，我们做的是中国的教育，不是让你照搬外国！明明说过不想来他可以不点名，又每次课点名什么意思？经常威胁学生迟到算旷课，旷课可以取消考试资格，即便是病假也不会原谅你，总是小人之心度君子之腹一样。上课极其无聊给分又差，呵呵
49224,1482,翟俊卿,2017-03-30 02:52:07,1,13,12,真的是我这两年来最最讨厌的老师了。上课很喜欢怼学生啊！有人提问还让他下节课给出解答展示。每次上课都威胁我们上课不认真不要怪给分。首先想想你讲得怎么样吧。对不同专业的学生态度明显差异，非常喜欢教育学的学生，不用你喜欢别的专业的学生，起码公平对待不要怼啊！虽然还没到期末，但是我还是非常愤慨地来评价了。
49305,1482,翟俊卿,2017-04-06 01:16:53,1,10,9,非主修教育学的我觉得上他的教育科学研究还是很不错的啊。。从他讲的东西以及他请教育学的学生讲的东西当中还是可以收获很多，从一些讨论当中也能思考一些东西。。确实是像有些人说的比较重视学生的课堂表现，但是这也是应该的啊。就是不知道给分如何，有点小期待哩
49307,1482,翟俊卿,2017-04-04 14:21:20,5,17,12,其实老师也没你们说的这么差。我是一个非教育学的学生，老师上课的干货还是蛮多的，而且深入浅出，让我这个本来想要水个学分的人都受益匪浅。翟老师，我顶你！
49316,1482,翟俊卿,2017-04-05 03:44:53,-4,9,13,听完他的课，严重怀疑教育学存在的意义了……讲道理，哪来的对人文的莫名优越？
49578,1482,翟俊卿,2017-04-19 05:48:25,22,37,15,想认认真真地写一次教师评价：\n\n首先，老师本身是教育学方向的，他开的课程也都是与教育、社科相关，大家在选课的时候如果不是因为兴趣或者是需要只是想来水水的话，那就不要说一些不好的话，是不是应该反思一下自己有没有做好学科交叉的准备或者是在上课的时候是不是足够认真。老师上课的氛围很轻松，鼓励课堂发言，有什么问题会当即解决，为同学们提供讨论、观点碰撞的机会。在阅读文献的时候能够和学生们一起阅读，提供他作为一个师长的科研思路，只要自己用心，在课上学习到的一些东西，是很受益的。不同的同学会有不同的观点，可能这条也会有很多人点倒赞，但我觉得 任何问题 你是不是应该反省一下自己，老师的点名不仅仅是点到，也可以记好每一位同学的名字，你上课认真与否，参与与否，老师都看在眼里。\n\n一份付出，一分收获。总体上而言，老师还是上课观察比较细致的老师，很亲和，很接地气，不喜勿喷，做好自己就好。
49637,1482,翟俊卿,2017-04-21 01:34:40,8,16,8,翟老师超级好呀 ！给分很良心，我还是非教育学专业的。社会与教育课堂讨论的话题都很有意思，老师也很有想法，课堂很有收获，还有教室外的课堂活动。赞赞赞！
49640,1482,翟俊卿,2017-04-21 03:07:27,-1,6,7,给分很好啊，全班给分都不错。。上课比较随和，课堂氛围很轻松
49674,1482,翟俊卿,2017-04-23 08:26:28,0,6,6,老师很好啊！课堂氛围超级棒！给分也很赞！有争议的课堂才能够真正唤醒学生的批判性思维！顶老师！
52913,1482,翟俊卿,2017-06-23 13:05:43,5,9,4,我觉得老师挺好的啊，给分也很好，只要你上课认真然后回答问题分都不错啊，而且也蛮有趣的，有些人觉得不好的何必选教育类的课
76135,1482,翟俊卿,2018-03-27 12:56:57,0,0,0,还可以
76918,1482,翟俊卿,2018-04-26 02:41:44,1,1,0,评分标准不清楚，课程内容略赶，没有很好的规划，感觉要被莫名其妙地正态了
77286,1482,翟俊卿,2018-05-04 10:57:00,0,0,0,......
77330,1482,翟俊卿,2018-05-04 16:25:49,0,0,0,课堂讨论比较重要，主观性比较强，会偷偷到你背后看你电脑屏幕，超惊悚
77627,1482,翟俊卿,2018-05-07 03:37:15,-1,1,2,无条件地为我天津人打个call，氛围还是很轻松的
79281,1482,翟俊卿,2018-05-30 03:17:08,2,2,0,18年3月那条评论过分了噢，我至少一年之前就看到了这条评论了，更新一下就当成最新评论有点不负责任吧？
89489,1482,翟俊卿,2018-11-19 10:07:11,2,3,1,拜读了《教育研究 定量定性和混合研究方法》一书后，惊觉书中内容与半年前所上的教育科学研究方法这门课的PPT相似度99％。所以为什么上课时不推荐这本书呢？
105446,1482,翟俊卿,2019-04-14 06:54:12,3,5,2,感觉老师搞学术挺牛逼的，但是讲课只能说一般，课上是可以学到东西，但最不喜欢老师总是以绩点要挟学生，动不动就正态，以为查老师上所有给他差评的都是绩点给低了的，考核上也确实有点不负责任，只能说想刷高分很容易，看你怎么表现了。
105737,1482,翟俊卿,2019-05-17 02:13:22,0,2,2,给分真的莫名其妙，做了那么多分数不如报告写的厚的，我服了
105751,1482,翟俊卿,2019-04-19 17:35:16,3,6,3,上的教育科学研究方法：客观评价一下，1.老师很可爱，上课巨多互动，有时候更像师生之间的讨论，这种形式我喜欢，老师会喜欢大家多给一些response 2.老师的确挺随意的，上课内容说改就改，考核内容也是临时通知 3.老师有时候挺可爱，喜欢怼人，能记住每个人的名字，有时候巨凶，会说你们被正太了别怪我2333 4.上课内容挺有趣实用的，个人感觉这门课实用性强，收获大，认真上课会有好的回报的! 5.给分见仁见智，但是教育学的课感觉给分都不差，今年均绩3.8几，仅供参考。
105781,1482,翟俊卿,2019-04-20 11:26:07,4,8,4,老师很可爱，关于研究方法真的有学到东西，不管是理论层面还是实际操作上…看到评论里说拿绩点要挟23333，那完全是开玩笑的语气啊…最后大家一起用学术海报交流还是有收获的，觉得值得推荐~
106194,1482,翟俊卿,2019-04-25 13:05:27,2,4,2,在成绩之外（给分真的不差）想说 我真的学到了东西 这节课让我深刻意识到以前我产出的到底是什么学术垃圾 上完真的有感受：原来研究是这样搞的啊！
109078,1482,翟俊卿,2019-06-07 11:18:41,-3,1,4,翟老师，资深教育专家，帅哥一枚啊? ? ? ?
123002,1482,翟俊卿,2020-04-29 08:13:10,5,5,0,客观来说，老师上课还是挺多干货的。\n\n但是！！！\n\n前一天晚上18:00的ddl第二天下午三点多就能出分，是真的感觉自己付出的努力没有被好好对待。\n\n还有，一定要多多多多多水发言
123003,1482,翟俊卿,2020-04-29 09:12:28,3,3,0,我觉得最伤心的一点就是，为什么成绩可以给的那么快，明明有很多临近ddl交的6000字计划，真的可以这么快就批完吗？我熬了好几个夜看了好多好多文献的唉\n\n给分这个虽然也有点难过但是毕竟上课老师提到过以前给分最高92，而且我确实也觉得自己挺菜的吧
187507,1482,翟俊卿,2024-01-16 11:58:16,-4,0,4,老师好像还挺有水平的，也比较幽默风趣，有一次几乎讲不出话了还自己讲了一整节课印象很深
203909,1482,翟俊卿,2024-11-22 02:11:16,3,3,0,阿美身份buff研究者，炸裂歧视言论奇多。不欢迎讨论，用他个人观点压人。
21499,1593,叶志坚,2016-02-29 05:08:52,0,0,0,叶老师很好！
79856,1593,叶志坚,2018-06-14 10:59:33,0,0,0,呵呵哒
33348,1619,王爱国,2016-09-18 15:20:58,-3,0,3,认真给分不错\n\n
39071,1619,王爱国,2016-12-21 03:34:42,7,7,0,上课讲的东西作为法学生是有很多意见的，课程论文题目起的也感觉水平不够，个人不太认可老师的专业水平
61767,1619,王爱国,2017-11-20 23:18:14,3,3,0,就知道点名
89178,1619,王爱国,2018-11-16 11:04:47,-2,2,4,老师人很好，教育学院不错的老师了
92406,1619,王爱国,2018-12-28 09:39:31,3,7,4,老师虽然看着凶但是对学生很负责很好哦，心胸很开阔
93208,1619,王爱国,2019-01-08 06:33:18,-3,0,3,赞一个
94725,1619,王爱国,2019-01-18 03:19:38,3,4,1,仗着自己年龄大，把自己当大爷了。师德何在?
116460,1619,王爱国,2019-09-11 00:25:02,1,2,1,根本不懂法，就知道法条粗浅的含义\n\n垃圾老师
135841,1619,王爱国,2021-05-29 02:08:24,0,0,0,无语无语
801,1810,李心北,2017-01-16 06:41:00,2,18,16,讲了很多东西，给分也好
1904,1810,李心北,2015-03-26 05:29:12,97,136,39,上课很有意思，百家讲坛式老师，就是考试前给的资料不怎么有用，没有吕强的资料好用。
3721,1810,李心北,2015-06-17 02:40:07,10,17,7,挺好的
4819,1810,李心北,2015-06-29 08:37:34,4,15,11,最后两节课听了下发现讲得很好，后悔前几节课都在刷作业水手机小考试也是乱写的了……
4994,1810,李心北,2015-07-02 02:35:01,1,7,6,讲的很好的老师！
5518,1810,李心北,2018-08-24 11:05:26,33,53,20,军事知识渊博，深入浅出，很适合对军事感兴趣的同学。。然而书上地内容讲得太少，完全自学。但对军事入门级同学上课不困有难度。
5896,1810,李心北,2015-07-10 00:44:13,2,16,14,老师给的分数挺好…虽然我个人一直没听课上课玩手机（但我确实是听不懂可能换老师也一样…）点名是课堂写题的形式，来了就满分…论文分数不知道…但目测态度到了就宽松的
6164,1810,李心北,2015-07-11 13:38:08,6,11,5,每次听都感觉很有意思
6461,1810,李心北,2015-07-14 06:04:04,1,4,3,很好的老师
7164,1810,李心北,2015-09-09 08:41:47,1,9,8,挺好的老师，给分良心，讲课讲的也挺好【没有带作业于是听了三四次课感觉还是很有趣的】，平时不点名课堂测验类似签到，只要人到了交了东西就给分
7331,1810,李心北,2015-09-13 14:58:13,-37,10,47,平时水也没关系，讲得真的很值得听，一次小考试翘了考前没看过书还给了4.5
8151,1810,李心北,2015-09-17 06:50:08,4,7,3,讲的特别棒
8157,1810,李心北,2015-09-17 07:23:20,1,7,6,永不点名。。。大爱\n\n
8158,1810,李心北,2016-06-08 11:24:19,3,5,2,很好的课，刺激。
8216,1810,李心北,2015-09-17 14:06:59,2,4,2,很棒的老师
8258,1810,李心北,2015-09-18 01:24:31,54,61,7,老师承诺不点名，而且可以做其他专业作业，人很好，讲的深入浅出
8704,1810,李心北,2015-09-24 07:42:08,74,89,15,带了数分的书想来写点作业，然后90分钟后猛然发现自己认真的听了两节课。真的很有趣
12194,1810,李心北,2015-12-22 09:12:09,4,6,2,\(≧▽≦)/赞
13939,1810,李心北,2016-01-02 14:56:01,36,39,3,虽然给我的分是不高的，但是不妨碍他成为一个好老师！上课很激动
14580,1810,李心北,2016-02-23 09:53:46,3,5,2,上得好
15785,1810,李心北,2016-01-21 12:53:54,32,54,22,分数是随机给的好像，明明考的蛮好，绩点低，绩杀
18196,1810,李心北,2016-01-21 09:10:12,3,3,0,好老师，上课有趣
18198,1810,李心北,2016-01-21 09:14:44,6,8,2,点名只有一次，就是课堂小作业
18200,1810,李心北,2016-01-21 09:17:54,2,3,1,老师很好啊。据说给分很好虽然我很低应该是我自己的问题反正挺好的
18207,1810,李心北,2016-01-21 09:29:20,-21,3,24,爽，给分挺高的
18209,1810,李心北,2016-01-21 09:31:21,2,2,0,很好的老师。讲课深入浅出，知识丰富，结合最新的军事信息讲解。
18226,1810,李心北,2016-01-21 09:59:08,0,9,9,很好的老师，只要在认真听，绩点上4很简单的。
18297,1810,李心北,2016-01-21 11:51:08,2,2,0,。。。\n\n
18301,1810,李心北,2016-01-21 11:59:25,9,18,9,一般般，军理给分不给力啊
18311,1810,李心北,2016-01-21 12:21:42,5,11,6,虽然我得分不好，但是是我自己的问题，老师真的很良心，讲得很好，对学生也很体贴
18330,1810,李心北,2016-01-21 12:49:11,54,81,27,老师是好老师，可是我作业全都到，论文写好久，考试也全都书上有找到，为什么绩点如此之低！！成绩是随机给的吗！
18522,1810,李心北,2016-01-22 01:48:54,-7,4,11,平时没听过课，论文随便写的，最后分数还不错……老师其实讲课水平也挺高的，我自己不感兴趣而已……
19426,1810,李心北,2016-01-24 07:52:16,21,34,13,不点名的坏处就是给分没依据随机给
19928,1810,李心北,2016-01-25 14:34:40,32,41,9,人好绩点低\n\n
20408,1810,李心北,2016-01-27 13:33:55,0,2,2,真心体贴
20562,1810,李心北,2016-01-28 11:07:03,-11,4,15,很好啊 ，绩点给力
20610,1810,李心北,2018-05-24 06:59:05,6,7,1,就是听课吧，除了几节课比较重要其他不听也没关系，考试比较重要，用的是吕强的资料。
20921,1810,李心北,2016-02-04 05:27:53,1,13,12,莫名其妙给个2.7  我能说脏话么
21130,1810,李心北,2016-02-20 09:53:33,-21,6,27,论文不要全部照抄 写点自己的话说的东西。最后开卷考都差不多。第一门满绩
21370,1810,李心北,2016-02-28 10:17:09,-1,2,3,很棒的老师，学到很多
21625,1810,李心北,2016-02-29 10:56:11,5,7,2,很好的老师，不过他重点讲军事科技、军事思想几乎不讲，靠自己
22451,1810,李心北,2016-03-06 06:41:47,1,3,2,上学期上了李老师军理，这个学期继续来蹭课听他的精道分析
22718,1810,李心北,2016-03-10 06:46:32,25,30,5,有磁性的低音炮，耳朵会怀孕
26057,1810,李心北,2016-06-15 09:14:05,1,2,1,只能说现在很后悔错过了这么好的老师的许多节课
26282,1810,李心北,2016-06-16 13:42:10,14,16,2,很和蔼的老爷爷～人好精神也好～
26339,1810,李心北,2016-06-17 03:30:30,3,4,1,对喜欢军事的人来说简直就是享受\n\n
26411,1810,李心北,2016-06-18 05:27:06,-1,2,3,不点名，课上会偶尔有小测验，不管做的对不对只要交上去了十分就到手了，专业知识非常好，强烈建议选
26708,1810,李心北,2016-06-21 03:02:25,-1,5,6,成绩就是随便给的，怎么这么不负责任
27311,1810,李心北,2016-06-24 15:05:56,1,3,2,人很好，课程内容个人不喜欢军事不评价，不过感觉还是挺好的。另外记住的就是他说的说给分差的无非就是考得烂还自我感觉良好……
28083,1810,李心北,2016-06-28 08:05:20,3,5,2,老师人很棒的 讲军事理论讲的很生动的 他第一节课就说我知道你们后来会翘课的 就不点名了吧 老师人挺实在的 不知道给分好不好 明天就要考试了orz
28087,1810,李心北,2016-06-28 08:05:44,0,3,3,老师讲课很好，给分也很好
29299,1810,李心北,2016-06-29 14:42:22,2,3,1,超级棒
29590,1810,李心北,2016-06-30 04:27:31,5,6,1,不点名，可以写其他专业作业。然而感触最深的是昨天考试一个一个找没交论文的的同学。
30512,1810,李心北,2016-07-01 23:18:53,0,2,2,棒，虽然自己从来没有认真听过
30566,1810,李心北,2016-07-02 03:36:04,0,2,2,waiting
31002,1810,李心北,2016-07-03 05:57:16,19,25,6,给分很迷啊最后考试每道题基本都找出来了，就算是论文差也不会这么低吧，失望
31010,1810,李心北,2016-07-03 06:11:19,0,2,2,老师超级好，讲课很有意思的，我对军事不是太感兴趣都挺有感触的。论文字数不太够，考试很多没翻到，给分还是很好，感恩
31020,1810,李心北,2016-07-03 06:21:11,3,5,2,给分迷
31030,1810,李心北,2016-07-03 06:32:02,1,2,1,老师声音真好听啊～～讲的蛮有意思的。小测认真对待，对错不太重要，但一定要交！
31033,1810,李心北,2016-07-03 06:34:25,2,5,3,给分有点失望，但是上课还是挺好的，老师很认真，然后就是2次小测试一定要做，因为交了就是10分
31036,1810,李心北,2016-07-03 07:12:56,18,30,12,给分他妈的太低了吧   论文写了六千多  翻书翻文献写了那么久     考试基本每道题都找到了     最后只有3.3？    卧槽了   服气哦
31038,1810,李心北,2016-07-03 06:45:46,1,3,2,用作业当点名，又一次迟交了还没扣我分。给分很好，谢谢老师～虽然水过了你的课但真的好喜欢你
31051,1810,李心北,2016-07-03 07:10:26,3,7,4,反正我觉得给分不错，上课也不错，其实打印店资料没用，你只需要考前看一遍书就够了
31052,1810,李心北,2016-07-03 07:12:33,0,2,2,老师真的很好，本来打算上课水一下的，后面竟然认认真真听了一节课，后面的每节课都挺有意思，能学到不少东西。话说老师的声音好有磁性～其实老师平时分给的差不多的，最后一节课他也说了，主要是考试的分数会有差异。感觉还是看自己吧，最后的成绩还是不错滴～
31072,1810,李心北,2016-07-03 07:45:54,-8,6,14,百家讲坛浙大版，考试基本都找得到，给分居然上90了。。。
31079,1810,李心北,2016-07-03 07:56:42,1,6,5,上课很好，老师知识面广，讲的也好，也很幽默，给分已报警…论文一万二考试基本都找到了平时上课每次都去作业按时交考试基本都找到了有6、7个不确定吧3.6，均绩降了好多。不想说啥
31089,1810,李心北,2016-07-03 08:11:15,-1,7,8,讲的好，但是给分真的不好，考试内容都有在书上找到，作业论文全交，给分太差了，对不起学生的努力，很失望，尤其是看到一个你很欣赏的老师和你认真对待的课最后没有一个好结果的时候。
31148,1810,李心北,2016-07-03 09:33:24,0,0,0,还可以吧
31237,1810,李心北,2016-07-03 12:30:13,0,0,0,不错，真百家讲坛，可惜是第一节课，老是想翘
31258,1810,李心北,2016-07-03 13:20:26,0,2,2,讲的好，人也实在，点赞！！
31322,1810,李心北,2016-07-03 15:57:41,1,3,2,老师上课真的比一般的军事评论节目还有意思
31531,1810,李心北,2016-07-04 05:23:44,6,10,4,不知别人是怎样的，虽然老师说过给分基本完全是看自己的考试，但是结合其他人的评价和我自己的体会来看，给分可能确实和其他通识课一样，会有误差的存在。
31980,1810,李心北,2016-07-05 10:19:53,0,2,2,基本没怎么听-_-  最后3.6我也认了。。老师还是讲得不错的。是期末变难了？有些题没在书上找到。
32031,1810,李心北,2016-07-05 12:21:36,0,3,3,不错呢，给分可能试还是要考好吧
32146,1810,李心北,2016-07-05 22:07:40,0,2,2,同楼上，百家讲坛式的老师，还经常在课上给我们看纪录片之类。最后给分还不错～
32388,1810,李心北,2016-07-06 11:41:58,0,4,4,听不下去，给分低
32489,1810,李心北,2016-07-07 05:34:38,0,1,1,军理讲得很好，很值得听
32621,1810,李心北,2016-07-08 07:16:47,0,4,4,用两次小测试代替点名，没来的还能补交。老师人很好，但是给分确实有问题。平时不点名，一个教室人数比通识还多，考试开卷也没啥区分度。于是很多人都觉得自己很努力但没得到好结果。当然有些自我感觉太良好，论文写上万字就一定能拿高分？！感觉给分应该再透明一点吧。还是很喜欢这个老师的，上课认真，有学识。
32771,1810,李心北,2016-07-13 00:35:37,-1,1,2,老师人很好，给分很好，很满意
33287,1810,李心北,2016-09-18 01:14:00,4,7,3,今天第一节课，虽然大二忙的要死但以后这课我绝对不翘。太棒，都是我想听的东西，武器发展历史，军备竞赛，各国军事实力评估等等。比自己看那些过期的书有用多了，知道了很多从未想到的对抗技术……视野变宽了，兴奋。\n\n然而讲课有点慢……而且，恕我直言个人对浙大做了什么贡献不是很有兴趣……
35632,1810,李心北,2016-11-10 07:36:11,0,1,1,很生动不想睡觉\n\n
41491,1810,李心北,2017-01-12 03:46:30,0,1,1,军事科技大佬，而且貌似他去过的地方很多
43245,1810,李心北,2017-01-16 04:38:09,1,2,1,知识和阅历都非常丰富的一个老师，认真学绩点不会差
43248,1810,李心北,2017-01-16 04:43:47,0,2,2,老师上课不点名，有两次小作业，一篇论文！讲这一类的课也能讲的很生动～考题最后基本都能翻到，所以给分也不错！老师真的是好老师～
43254,1810,李心北,2017-01-16 04:53:36,1,3,2,不说了，感恩李心北霸霸，本来还有点担心自己论文水水的，没什么专业知识......
43259,1810,李心北,2017-01-16 04:58:09,0,2,2,只想说。。。明明都找到了，为什么绩点那么低啊。。。感觉这种课给分真的很没有依据
43268,1810,李心北,2017-01-16 05:08:05,-1,1,2,好气啊
43275,1810,李心北,2017-01-16 05:11:44,-5,1,6,感谢老师，绩点好高啊
43302,1810,李心北,2017-01-16 06:07:39,0,1,1,给分有毒
43335,1810,李心北,2017-01-17 15:49:18,0,3,3,自己绩点低就说老师乱给分的简直了吧。。跟老师交流过就知道论文评分不是说写得多就高分，开卷考找到了也未必选对（尤其是不定项）。不要乱喷老师
43340,1810,李心北,2017-01-16 07:12:34,-3,4,7,给学弟学妹一些经验吧，两次课堂小测和课程论文一定要记得按时上传(我不会告诉你每次全班至少有四分之一的人没有按时交qwq)，一次课堂小测5分呐，你迟交一次你基本就要被正态了。期末考不用慌也不用买题库，题目基本都在书上，我就是用了一本学长学姐留下来的书orz，最后4.5，谢谢心北老师。
43618,1810,李心北,2017-01-16 15:38:31,0,1,1,老师不点名，有两次课堂小测验，讲课内容深入浅出。
43711,1810,李心北,2017-01-17 00:52:42,1,1,0,绝逼好老师，丰富的人生阅历。\n\n
43719,1810,李心北,2017-01-17 01:14:28,-2,3,5,虽然给分很差不过上课还算有意思。\n\n很难受，这种给分
44277,1810,李心北,2017-01-17 13:57:43,2,2,0,一种娓娓道来的积淀
44507,1810,李心北,2017-01-18 01:59:45,1,1,0,成绩虽然不好，但是不妨碍好老师！这学期上了马原，可以强行把你入睡的那种，而军理是能把你唤醒的那种，好几节课本来水手机准备，但是听着听着就听进去了。真的很不错！老先生很有水准，说话声音也好听，浙大良心，成绩真的不要在意太多～能碰到一个好老师也值得。
45114,1810,李心北,2017-01-19 03:55:55,1,1,0,讲课很有趣，听课跟听故事一样，老师还会和我们分享他游历大江南北的故事，对于军理知识感兴趣的推荐。不过期末不会划重点，所以复习相对麻烦，想水水过的不推荐，给分倒是不错
45225,1810,李心北,2017-01-19 07:39:11,0,4,4,老师上课基本只讲重点，像导弹、卫星等等，对于军事思想和军事史不大提但偶尔也会融合在上课内容里。一个学期还有好几次视频课，对写论文有帮助。总的来说，上课还是有意思的，老师知识面挺广的！考试的话，考前看了一整天的书，把军事科技部分理解清楚了，最后也满了！当然论文很重要，占30％，一定要有自己的想法！
45945,1810,李心北,2017-01-20 09:37:31,4,6,2,老师知识很渊博，上课不无聊的，其实给分挺好的，挺合理的
46328,1810,李心北,2017-01-21 08:38:23,4,10,6,老师给分挺客观的啊，楼上那么多考试找到考试那么大比重确定自己找的全是对的？老师自己都说过这个问题
47012,1810,李心北,2017-01-23 09:28:59,-1,0,1,老师讲课很有趣，虽然很困但依然不想睡。老师也很宽容，不点名，两次课堂作业当天晚上交也行。反正最后考试准备好资料就能翻到了。
47270,1810,李心北,2017-01-25 04:38:55,-1,0,1,讲课内容很有意思，有科普也有实践体验，虽然考试内容还是要自己准备不少
48397,1810,李心北,2017-03-03 01:21:27,0,1,1,太可爱了这老师！！！我连手机都不玩了
48683,1810,李心北,2017-06-29 08:07:49,4,6,2,诶，陈建斌？
51710,1810,李心北,2017-06-08 12:27:44,0,1,1,给分不错?
51940,1810,李心北,2017-06-13 16:20:18,0,1,1,李心北老师超级棒！大四了决定再回到大一上过的军理课堂，重温老师精彩的讲述！
54356,1810,李心北,2017-06-29 07:16:41,0,1,1,人很和蔼。上课幽默风趣，能学到东西，事情少，给分也好
54357,1810,李心北,2017-06-29 07:16:58,-5,1,6,给分垃圾 ?杀无疑
54367,1810,李心北,2017-06-29 07:53:26,4,7,3,只有春学期去上过，夏学期再也没去过了……还记得李心北上的第一堂课就直接讲可以在课上做任何其他课的作业，能让你们六级过了也是一种功德。考试前一定认认真真看一下书，理清框架，考试内容书上都有。但是不看书根本来不及找，考的内容很多。好好复习了，绩点4.2
54383,1810,李心北,2017-06-29 08:32:48,-1,0,1,感觉个人论文写得不好，考试也没怎么翻到，但是给分好，我已经满足了
54399,1810,李心北,2017-06-29 09:06:05,-1,1,2,讲得确实很好。。。。不过其实不提前看书现翻是来得及的。。。\n\n论文水水过去作业也水水过去最后拿了一个4.5，还被卡了1分不然就4.8了
54451,1810,李心北,2017-06-29 10:27:30,-13,0,13,听他上课真jb无聊，就喜欢讲什么他去西藏，没有中美军事对比之类的有趣的，很菜
54454,1810,李心北,2017-06-29 10:28:59,-1,2,3,我觉得考试挺难的 最后3.6 就酱
54460,1810,李心北,2018-05-07 10:33:56,8,22,14,老师很好，讲的有趣。个人感觉分数和老师关系不大，考试比较主要。我4.8
54490,1810,李心北,2017-06-29 11:38:12,-5,1,6,有什么办法可以联系到老师，觉得给分很奇怪，请给个理由！拉均绩！不能接受！
54503,1810,李心北,2017-06-29 12:39:56,1,2,1,平时分给的真不低，期末百分之六十就看个人手速了。
54539,1810,李心北,2017-06-29 14:23:05,0,2,2,特别喜欢听老师讲课，我觉得绩点还ok啦，开心最重要ヽ(○^㉨^)ﾉ♪
54555,1810,李心北,2017-06-30 18:25:27,3,4,1,考前对着提纲看一遍书，考试的时候翻的快才是硬道理。上课有意思就听一下，不听也没事，主要看最后的考试吧，和老师给分没什么关系。基本翻到了，最后4.2
54626,1810,李心北,2017-06-30 02:44:16,3,11,8,4.8，考试很简单，没学好别怪老师
54674,1810,李心北,2017-06-30 04:01:29,0,1,1,老师从不点名，对于喜欢军事的同学来说应该是挺喜欢的，论文好好写，考试之前翻下书，绩点不会太差的！！
54696,1810,李心北,2017-06-30 04:57:33,-1,0,1,老师讲的挺好的，可惜听不懂。老师很和蔼，两次小作业是课上布置当天上传就好，估计是点名用的。一次期中论文。给分挺好的，期末卷子小半空着最后有这个分挺满意了。（吕强老师的提纲据说很好用，建议考前看吕强老师的重点）
54838,1810,李心北,2017-06-30 09:46:49,-1,2,3,讲的还行\n\n给分太迷了\n\n真的迷\n\n垃圾绩点
54890,1810,李心北,2017-06-30 18:24:21,-2,4,6,军理一出，血都凉了。两次点名按时交，论文认真写，考试翻到85%，绩点只有3，均绩拉下0.06。3分的军理，特地买了吕强的资料还有题库，认真复习了，承认只认真听了两节课不过每次都到了。很无力，老师人很好，但不清楚给分标准，欲哭无泪。
55075,1810,李心北,2017-06-30 18:41:36,0,1,1,觉得老师人很好啊，因为是早课所以很多次都没去但两次课堂作业都到了，论文迟了十天才交本来以为要被正态了结果绩点上四了。考试基本还是用的书。
55410,1810,李心北,2017-07-01 12:41:02,1,2,1,老师超放松…虽然有时候讲的非军理的内容会有点小错…但是给分好啊～渣渣理科女能给我的论文这么高分超级感动…
55796,1810,李心北,2017-07-02 11:34:39,-3,1,4,军事知识很丰富的一个老师，课也可以不怎么听，最后4.2，感觉一般吧，给分比吕强差
56487,1810,李心北,2017-07-04 01:40:27,0,0,0,听说讲的很棒但我一学期没去过几次。。关键靠考试翻书快不快吧。。。
56552,1810,李心北,2017-07-04 03:27:11,2,5,3,3.0，别问我怎么知道。
56670,1810,李心北,2017-07-04 08:22:37,0,0,0,还好吧 虽然讲课书上的讲的不多但重点还是讲了的 听他讲自己的见闻和军事相关的也蛮有趣的啊 考试本来就看自己 吕强的提纲确实蛮好用的记得考试前去打一份 虽然有小测但基本只要当天交就满分 论文基本分数也还是蛮高的只要不乱写不乱抄 十分
57101,1810,李心北,2017-07-05 14:11:17,0,0,0,好！没什么要说的，军理还是有点看翻书能力的。
57732,1810,李心北,2017-07-25 13:45:01,-7,2,9,反正我是没看出下面的学生有兴趣听课。不信的自己看咯，手机电脑水水过呗。
58023,1810,李心北,2017-07-24 03:52:19,1,2,1,3.0，好老师可惜我没学好，吧
59566,1810,李心北,2018-01-28 23:17:08,0,3,3,?⚾⚾⚾⚾⚾??????⚾???????????????????????\n\n
60040,1810,李心北,2017-10-08 01:33:42,0,1,1,很好，多少还是可以有所获得的。
60788,1810,李心北,2017-10-30 06:44:01,0,1,1,值得尊敬的老师，有知识有气度
64626,1810,李心北,2017-12-25 15:37:39,-34,2,36,天天不去上课，然后4.5，老师给分真心好
68430,1810,李心北,2018-01-23 07:54:17,-15,2,17,课有意思，考试巨简单。
71443,1810,李心北,2018-01-28 12:57:07,26,33,7,论文查了很多文献，自认很认真，开卷考试预估90，从没缺过课。总评三点几，比史纲等花了同等心思的课分低不少。思政课中的最低分，很郁闷。
71454,1810,李心北,2018-01-28 13:06:46,0,3,3,小测全到 论文基本认真 考试感觉也还不错 4.2很满足了和预期差不多，上课可能没有吕强老师那么有趣但是感觉老师人也不错？
71462,1810,李心北,2018-01-28 13:20:36,1,3,2,谁选谁知道
71465,1810,李心北,2018-01-28 13:24:10,-1,3,4,上课真的很有意思，最后考试基本都能找到，给分还是不错的，推荐一波~
71475,1810,李心北,2018-01-28 13:38:41,7,9,2,感觉老师给分标准有点奇怪，和自己的预期有差距。
71485,1810,李心北,2018-01-28 13:49:12,-3,4,7,军理 作为一个从没接触过军事知识的女生听老师课觉得很有意思很不错！而且给分也很好！而且老师很帅气很有风度！（不过考试还是得用吕强老师的PPT……）
71490,1810,李心北,2018-01-29 07:34:31,-24,3,27,哈哈，没搞到吕强的ppt，考前看了5遍书，书上有的全找到，精确制导的题目书上没有，几乎都瞎蒙，结果竟然有4.8。前来感恩。前面几位3点几的，问下老师小分不就知道了？期末翻到的不一定能做对
71497,1810,李心北,2018-01-28 14:05:41,-7,5,12,sb老师
71500,1810,李心北,2018-01-28 14:08:04,4,6,2,有点迷
71512,1810,李心北,2018-01-28 14:20:48,19,22,3,评分三点几，和预期差太多，自认为绝对不是期末考的原因，论文也很认真写，实在不知道为什么
71526,1810,李心北,2018-01-28 14:41:15,14,17,3,“往前面坐，没关系，你们听不听课，做什么事情我都不管的。”听了他的课以后领会了他是以怎么样的自信讲出这话的，他有办法让你听课。
71550,1810,李心北,2018-01-28 15:14:27,6,7,1,绩点没预期高，但老师是真的好老师\n\n
71621,1810,李心北,2018-01-28 17:30:39,-7,1,8,考试挺简单的。一学期没听过课，最后4.2，挺满足的。
71748,1810,李心北,2018-01-29 02:27:59,-6,4,10,我基本没怎么听过课，都在写微积分作业，期末论文感觉写的一般吧，期末考基本每道题都找到了，绩点4.5
71787,1810,李心北,2018-01-29 03:06:45,-1,0,1,没啥好说的...上课挺水的，动不动看视频...但老师知识还是挺丰富的，喜欢军事的听听也没毛病。
71812,1810,李心北,2018-01-29 03:40:59,2,3,1,感觉给分随机的啊！！！！生气！！！！
71843,1810,李心北,2018-01-29 04:25:12,0,2,2,好老师！！老师讲课很好，人也很好。感觉自己的论文写的一点也不具有专业性（毕竟作为女生对军理不感兴趣），但是到最后绩点上四了，很满意了
71893,1810,李心北,2018-01-29 05:11:44,2,3,1,除了小测论文考试其余确实没什么付出 绩点也确实低的可以
71931,1810,李心北,2018-01-29 06:09:04,0,3,3,给分神tm低，乱给的吗？明明考试很多我都找到了
71951,1810,李心北,2018-01-29 06:31:40,1,1,0,讲课很有意思，声音也好听。考试靠自己
72127,1810,李心北,2018-07-05 14:07:59,2,4,2,不点名平时分看两次课堂作业 论文和考试都很重要 给分应该都是正态的吧 反正我论文写得一般般 考试都找到了 拿了个均绩 \n\n老师很好！人格魅力?
72255,1810,李心北,2018-01-29 15:59:54,1,1,0,老师人真心挺好的，最后成绩不好也是我自己水的原因。毕竟什么课都是要看态度的，自己努力了才有资格期待好的分数。
72315,1810,李心北,2018-01-30 01:45:11,1,2,1,因为自己成绩太低怕说出的评价是不客观的。。。其实老师人很好一学期很认真的讲解最后也热心帮我查分，但如果是我这种对军事一无所知考试完全没谱的人还是慎选
73039,1810,李心北,2018-01-31 17:05:32,0,3,3,给分跟预期落差大大大
73983,1810,李心北,2018-02-04 03:13:42,-14,5,19,每次课都去 所有的都很认真的完成 考前还通宵复习 结果拉低均? 0.03 不懂老师为什么这样给分
74870,1810,李心北,2018-03-06 07:13:29,0,0,0,可以坐第一排唐而皇之地写作业。吼啊
76996,1810,李心北,2018-04-27 23:45:21,0,0,0,没听过，我看挺好
78814,1810,李心北,2018-05-15 09:28:49,-3,3,6,想水课 听李心北 想学知识 听吕强
79124,1810,李心北,2018-07-12 12:50:01,-1,2,3,老师讲课很有趣！！
84156,1810,李心北,2018-07-12 07:01:35,1,3,2,事情很少 但是的确不如其他老师！ 个人认为给分不是很好！慎选！
84163,1810,李心北,2018-07-12 07:09:08,4,8,4,目测又是一波自己菜怪老师系列。考试实打实的分数还怪老师给分随机?题目陷阱很多，书上有时翻到的并不是直接的答案，考前不把书和资料过一遍不可能考好的。4.8感恩老师。
84166,1810,李心北,2018-07-12 07:16:59,1,2,1,不点名很自由\n\n百家讲坛式老师\n\n给分是比较客观的，对得起你付出的努力。\n\n如果考前没过书本资料当然会觉得给分不好，虽然我也就堪堪拿了个均绩，但我还是觉得，老师真的不错。
84167,1810,李心北,2018-07-12 07:17:03,1,2,1,好的一批
84179,1810,李心北,2018-07-12 07:33:42,1,2,1,给分好的呀！可能因为自己也比较感兴趣所以平常上课都有认真听，考试前没复习直接带书进去大概都知道考的东西在哪找所以考得也挺不错的，努力了就会有回报的吧！老师人格魅力满分！男神本人了！
84183,1810,李心北,2018-07-12 07:39:07,-7,2,9,正如老师所说他改论文主要看个人见解，我的论文不到两千字，个人见解大概八百不到，说实话我之前没看过军理的书，全靠考试的时候翻，你翻的慢怪谁呢？感谢老师给的4.5
84189,1810,李心北,2018-07-12 07:51:40,2,3,1,大家都考得好高\n\n
84196,1810,李心北,2018-07-12 08:04:39,1,3,2,虽然最后的绩点一般，这也只能说我的学习态度配不上高分，但是这不能阻止我夸李老师，修养很高，博闻广识，会分享自己的实践经验。现在真的后悔自己没好好听课(╥_╥)
84198,1810,李心北,2018-07-12 08:13:24,2,4,2,希望老师认真一点，负责一点，就算讲的有意思但是给分的时候不要这么随意
84204,1810,李心北,2018-07-12 08:23:00,0,4,4,论文基本没有什么个人见解，上课一直是在写微积分，偶尔会听一点，考试的时候是第一次翻书，这种情况下4.2还是很不错了
84208,1810,李心北,2018-07-12 08:33:13,1,4,3,为什么我分数这么低...
84230,1810,李心北,2018-07-12 09:47:34,-1,0,1,老师上课讲得很好，平时事情也不多，想了解一下军理的强烈推荐，想水课的话也行。考试前认真看一遍书基本就没问题了。
84246,1810,李心北,2018-07-12 10:30:36,7,11,4,"老师人真的很好，不点名，但分数真的是随便给的吗？每节课都到，做笔记，每次作业按时交，花费好久写论文，考试也准备了很久，最后七十几分，绩点迷之低，拉低好多均绩，真的很无语O__O""…"
84250,1810,李心北,2018-07-12 10:43:31,1,4,3,听老师讲课还是比较有意思的 （虽然我和大部分时间没有好好听..）老师不点名 两次小作业 一篇论文 （论文我迟了一天才交的 老师说迟交没有大关系 只会扣点小分...） 但是最后好好复习了 考试的时候也基本翻到了 最后4.8～
84256,1810,李心北,2018-07-12 11:03:53,7,8,1,每节课都到，作业论文都很认真完成，绩杀。。。
84300,1810,李心北,2018-07-12 13:10:56,-10,1,11,人生第一门满绩，出分的时候有点被吓到hhh  作业按时交，论文好好写，选题跟知网最好不要重合吧，我有努力往降低查重率方向走，也许这也是论文得高分的原因？？  期末考的话有文印店的资料，是吕强的ppt以及一份详细目录（超好用，很好翻），书上基本上都能找到。试卷陷阱真的是很多……   97分满的，再一次感谢李心北老师！
84390,1810,李心北,2018-07-12 16:48:37,-1,1,2,给分很随缘，论文考试我觉得自己都不算特别认真，最后也还行吧。老师人挺好的
85330,1810,李心北,2018-07-17 04:53:02,-1,1,2,好老师\n\n
86494,1810,李心北,2018-09-17 01:41:26,2,4,2,第一节课老师腰痛，于是走了
86496,1810,李心北,2018-09-17 01:56:39,-1,2,3,结石警告\n\n
88250,1810,李心北,2018-10-25 02:54:41,-1,0,1,很好的
89223,1810,李心北,2018-11-17 04:31:39,-1,0,1,超级棒！文科生的我每次都认真听 就想一直听下去！
91501,1810,李心北,2019-01-20 12:33:03,-43,3,46,作业好好做 论文写了很久 最后出来2.4...\n\n问他为什么 说我一次作业都没交 扣我十分呵呵cnm
93020,1810,李心北,2019-01-07 03:14:45,2,3,1,老师超级棒！啊啊啊啊啊！迷妹呐喊！
93023,1810,李心北,2019-01-07 03:17:09,3,4,1,老师超级棒！啊啊啊啊啊！二号迷妹呐喊！
94532,1810,李心北,2019-01-17 05:45:27,1,2,1,言而有信，说了不点名就是不点名。很有趣的一个人，善良和蔼，很负责任，对学生很宽容，而且会提前结课，真的很完美了
95698,1810,李心北,2019-01-20 02:06:40,0,1,1,百家讲坛
98117,1810,李心北,2019-01-23 05:39:27,4,5,1,客观的说，如果之前思政类课程绩点一直还行的话，李老师军理这一般也不会碰壁
98119,1810,李心北,2019-01-23 05:43:08,3,4,1,老师人很好呀，讲的东西我也都听得懂，很有趣的。给分的话，其实我思政课一直不好，但是这次军理竟然有4.5，！论文好好写，两次小测都对，期末大部分都找到答案了。反正我很喜欢李老师！
98160,1810,李心北,2019-01-23 06:34:22,8,9,1,讲的很好，旷课可以，但两次小测当天要交上，旷课还没队友就凉凉。论文好好写，期末基本找到，给分4.8。
98212,1810,李心北,2019-01-23 07:51:54,5,6,1,老师人很好啊，经常给我们讲他在世界各地的经历，感觉是一个很有经历的男人。一学期的军理课几乎一节不落地听了，每次都听得入神。唯一不好的就是书上的内容很多不讲，但实际上不影响考试，考前花一天看了吕强老师的ppt，就4.8了。
98295,1810,李心北,2019-01-23 09:30:14,2,4,2,老师人不错，不过我考前看了一天的吕强的PPT还打印了下来，论文写了两天，全勤，最后3.9，还是有点难受的
98464,1810,李心北,2019-01-23 13:10:11,3,4,1,是我的错。没有好好复习。论文4500＋。考试很多都是自己编的 结果3.3呜呜呜呜呜
98489,1810,李心北,2019-01-23 13:35:32,0,1,1,老师真的超棒了，讲什么都可以信手拈来那种。特别喜欢听他讲自己去某某地方的见闻感受，特别涨知识了。关于给分反正我是很满意的了，而且老师的论文要求挺低的，不要求原创，只需要凑的合理就行，小测做点名要求也不高，最后考试靠自己。所以真的不亏的！！！！
98498,1810,李心北,2019-01-23 13:42:21,0,5,5,给分差
98499,1810,李心北,2019-01-26 03:14:03,-21,4,25,讲课归讲课 你有什么用
98524,1810,李心北,2019-01-23 15:00:45,19,24,5,"看到楼上有些喷老师给分坑的，没有装13的意思。。就想给后来人排一下雷。。。每次课都到了，小测课上提交可以加一分(相当于点名吧)，回答问题好像也可以加分(长期后排写实验报告这个与我无关hhh)，论文老师允许""借鉴""只要不全抄就好了，我就是知网上找了五六篇论文花了一下午拼起来大概就三四千字吧，自己写的内容其实几乎没有。。最后考试前一天看了三个小时书大概把各个章节大致内容在哪熟悉一下方便翻书 考试的时候用了文印店的提纲，开卷考大概就两三道题没找到原话，最后4.8，估计是靠考试拉了些分上来 平时真的很佛系。。希望码了点字有点用，后面学的同学都拿高分~"
98537,1810,李心北,2019-01-23 14:35:55,0,0,0,老师讲课会让你情不自禁放下作业开始听，给分也好。
98557,1810,李心北,2019-01-23 14:52:50,8,9,1,老师和吕强老师都是难得不绩杀的军理老师啊，老师最后一节课说过平时分都会给90分，除非你小测和论文没写没交，最后还是看考试的成绩吧，考前翻了吕强PPT带了提纲进考场，就妥了，给后来的学弟学妹参考一下
98568,1810,李心北,2019-01-23 15:03:53,0,1,1,我觉得自己论文写得挺糟糕的，可能考试考得还不错，最后有4.8 太感谢老师了！给分太好惹！
98588,1810,李心北,2019-01-26 03:13:05,-16,6,22,垃圾老师，乱打分
98659,1810,李心北,2019-01-23 16:53:32,-1,3,4,水，给分好，男神
98671,1810,李心北,2019-01-23 17:50:17,-2,2,4,给分好
98703,1810,李心北,2019-01-23 23:48:33,1,3,2,给分好迷啊\n\n
99040,1810,李心北,2019-01-24 07:35:01,11,13,2,还是评论一下吧，两次小测当堂交了，课堂还有一次参与加分，论文花了时间按时交了，考试用的吕强的资料，可能是最后考试莫名错的多的问题（我以为自己后面多选都找到了的），最后仍然被正态3.3，有史以来最低的思政类课程还要算主修...发邮件问老师分数情况，老师把我所有错题题号列出来了，承认平常分被正态拉低了5分，因为学校要求79分及以下必须要超过30%...\n\n最后，老师是好老师，阅历丰富，上课会让你忍不住想听听，课堂比较有趣。\n\n以上。
99060,1810,李心北,2019-01-24 08:14:30,0,4,4,绩杀，这个学期简直是低谷期，他妈连军理都那么差，思政绩点最低
99154,1810,李心北,2019-01-24 10:39:25,-4,1,5,不点名，两次课堂小测，课后也可以提交但是课上完成的加分。讲课讲的很好，有兴趣的同学应该很有收获。就是期末给分随缘，题都找到了论文也很认真在写，只有3.3真的很难受。
99623,1810,李心北,2019-01-25 04:14:06,3,8,5,不知道楼上好几个说是绩杀的是为什么…小测和论文的平时分心北基本给满了 最多不会扣5分 所以绩点基本直接由考试决定 考试前认真翻一遍书 带上吕强中篇ppt 虽然细节坑多 但整张卷子不超过5道题找不到  \n\n利益相关：5.0
99752,1810,李心北,2019-01-25 06:26:36,6,7,1,ezezez，平时事少，一论文两次课堂作业，期末裸考轻松上四，说绩杀的dd们请先找找自己原因?
99920,1810,李心北,2019-01-25 09:50:37,1,4,3,老师讲课真的太棒了 每次拿出作业 唔 老师在讲啥 én 好有意思 就这样听了一节课 啥也没写 成绩的话最重要的还是期末考试 需要把书和资料都过一遍 老师最后的习题讲解也很有用 觉得很多人说给分不好的应该都是以为自己期末都翻到了 我是看了很久的书 但是考试还是有很多不确定的 不过还是有4.8  老师很好啦 但是成绩真的看自己
100227,1810,李心北,2019-06-02 03:21:45,-36,2,38,轻松满绩，开心?
101802,1810,李心北,2019-01-29 06:32:21,-14,4,18,老师上课是真的好 但是我平时quiz全对，论文8000+，期末考差不多都找到始终原文，最后3.3是咋回事，除非我论文写的真的差，考试涂错，不然我不信 :-(老师是真的好，我只能这么说，预制这么好的老师都救不了我吗，直接把满绩的拉高的均绩拉回远点，我枯了
102387,1810,李心北,2019-02-01 10:52:55,3,3,0,老师是挺好的，我被绩杀了，也许涂卡涂错了？
102795,1810,李心北,2019-02-23 06:32:44,-15,1,16,轻松满绩
104121,1810,李心北,2019-03-12 12:02:58,13,13,0,两次题目永恒不变的小测当点名，当堂到+1分，课后补也不倒扣。平时也没什么事情，只需要一篇论文。上课嘛我个人听卫星和印度那两块比较入神，讲得真挺好的。至于给分嘛，老师都明说“我能给89就绝不给88”之类的了...最后成绩果然是卡下限的，很满足了。
104969,1810,李心北,2019-04-01 07:24:32,2,2,0,很不错
105214,1810,李心北,2019-07-05 15:33:21,-51,8,59,我是ikun，考前刷蔡徐坤nmsl，看蔡徐坤打篮球，结果我满了
108516,1810,李心北,2019-05-27 13:52:36,0,0,0,对不起
109625,1810,李心北,2019-06-18 04:01:04,0,0,0,周一一早上课好困 肯能我真的没有学军理的兴趣吧 老师人挺好
110708,1810,李心北,2019-07-07 05:25:23,8,10,2,对军事不感兴趣的不要选了，老师讲课真的很好，可是他会区别对待，喜欢本身就有军事知识的学生，仅代表个人观点，军理这种课是要让所有学生都能对这方面有所了解，而不是让本就喜欢的同学更加专业，在这一点上您真的做的不好
110800,1810,李心北,2019-06-28 09:00:28,10,11,1,再补充一下，评论区里有很多说自己应该分不低但只有3.3的，这真的不是李老师的锅，因为正态分布要求80分以下的比例至少百分之三十，而军理的考试难度不会有这个比例的，所以如果你在全班后30%，就算你95满了，也得3.3，李老师给的都是79，也是无奈之举。请大家一起抵制正态分布制度，而不是抨击老师绩杀
110888,1810,李心北,2019-06-28 13:00:27,3,4,1,北叔人真的很好，给分也好。\n\n\n\n可能是我真的太菜了，期末按正态要80以下的才会给79分。\n\n抵制正态分布和吴朝吹校长\n\n\n\n
113110,1810,李心北,2019-07-05 23:36:33,-3,3,6,是很棒的军理老师！虽然自己被卡绩（不是说不会卡绩的吗55555
113112,1810,李心北,2019-07-05 23:38:44,0,2,2,李老师是我男神！
113191,1810,李心北,2019-07-06 01:24:14,1,2,1,虽然一个学期没怎么听，但是给分和我的努力程度相符了 谢谢老师！
113204,1810,李心北,2019-07-06 01:35:04,2,4,2,超级有趣的军理课！我本来想去课上写微积分，结果听入迷了听了整整一节课，最后老师给分也超级好哦
113222,1810,李心北,2019-07-06 02:08:14,-6,6,12,划了一个学期水，最后绩点还可以，虽然没有复习但是有4.5，满意了。\n\n属实给劲嗷。
113301,1810,李心北,2019-07-06 04:57:48,2,3,1,事少给分高，李老师男神！
115415,1810,李心北,2019-07-22 09:44:38,-27,3,30,事少给分好，平时没听课，可能期末分比较高还是满了
120829,1810,李心北,2020-01-17 17:09:44,-3,1,4,吹爆老师了！！两次作业都延迟交了以为自己凉了，期末可能考的还行，最后4.2！呜呜呜呜呜呜呜呜呜知足了感恩老师！！！
121100,1810,李心北,2020-01-19 14:49:26,0,0,0,老师讲国际形势的那一段是真的很透彻
121370,1810,李心北,2019-12-17 11:14:34,0,0,0,呵呵呵
121926,1810,李心北,2020-01-24 06:52:29,21,23,2,万年不变的两次作业题+论文题目（论文提前1~2个月就会告知）+上课回答问题有加分。总的来说老师上课讲解很清楚，对军事学的理解也很透彻！期末考试打印吕强的目录+直接翻书，4.8/94到手（也许是上课摸鱼没回答问题被卡了？）。
122991,1810,李心北,2020-04-28 03:23:45,7,7,0,落了两次小测还有3.3，谢谢老师
126261,1810,李心北,2020-09-21 06:15:47,1,1,0,李老师说他花十年走了哈萨克斯坦部分的边界线，肃然起敬！！！
133241,1810,李心北,2021-02-20 11:00:28,1,1,0,两次小测（作业题？）+一篇论文，没有点名。阅读速度较快的同学完全不需要听课，打印吕强课件+翻书就可以应付考试了。
134071,1810,李心北,2021-03-15 04:40:16,2,2,0,老师上课很有意思，看得出来对军事和国际形势有非常细致的了解。而且老师上周做了心脏手术，这周就来上课了。极其负责的好老师，肃然起敬！
138294,1810,李心北,2021-07-08 11:13:03,5,6,1,给分太不好了 论文有好好写，从来不缺勤，考试的时候准备了很多资料，也在努力地查找，基本上都找到了，最后的绩点却很低
139684,1810,李心北,2021-07-20 02:09:18,0,1,1,上了老师的军理课\n\n老师讲课很有趣，会分享很多故事\n\n今年题好像变难了，我有几个没找到，其他还好。两次小测+论文+考试，感觉任务不太重\n\n给分我感觉挺好的，当然如果没有4.5就是给分不好的话当我没说
58317,1859,张辉,2017-08-28 13:10:48,0,2,2,好好好
85418,1859,张辉,2018-07-17 14:38:23,-1,1,2,无语。。。。你知道这是什么感受吗！！！
86654,1859,张辉,2018-09-18 00:56:43,-1,0,1,乱挂课
107425,1859,张辉,2019-05-05 06:11:47,-1,2,3,凉的啊
108777,1859,张辉,2019-06-02 03:24:04,0,2,2,傻逼玩意
113848,1859,张辉,2019-07-07 18:13:45,0,0,0,有点难
213131,1900,方正,2025-01-16 05:21:41,8,12,4,上了老师的习概，点名会提前通知，平时上课会有讨论，感觉老师挺平易近人的，虽然说被卡绩了（悲），但感觉老师有捞过，总体来说好老师可选~
214954,1900,方正,2025-02-19 09:35:12,0,1,1,老师的习概课很好很好，点名会提前通知，不鼓励内卷发言，按组轮流发言，除此之外就一个小组的大作业(调研报告)，期末也很捞，总之可冲~
215791,1900,方正,2025-03-05 14:09:13,0,0,0,上课才发讨论题不鼓励鹅颈，老师也很会鼓励人，特别好的老师
216463,1900,方正,2025-03-17 02:23:46,1,1,0,屈平疾王听之不聪也，谗谄之蔽明也，邪曲之害公也，方正之不容也
217428,1900,方正,2025-04-10 07:53:40,0,1,1,老师很好，特别为学生考虑！！我因故未参加期末考试，老师特来提醒我，了解到我的情况后还帮我问研究生科的老师这个事情是否有回旋余地，是特别有同理心对学生很好的老师！！！虽然最终没能解决，但是老师的善意我感念万分！！！
217587,1900,方正,2025-04-14 02:18:25,1,1,0,正在上课，先给个10分~
218583,1900,方正,2025-06-18 10:39:39,2,3,1,习概满绩了，谢谢方老师
221775,1900,方正,2025-06-26 07:33:22,0,0,0,好好好
18225,1915,阚阅,2016-01-21 09:58:32,2,5,3,一丝不苟\n\n
34146,1915,阚阅,2016-09-27 13:50:04,5,8,3,很糟糕\n\n
63937,1915,阚阅,2017-12-20 02:17:04,2,5,3,带着严重的有色眼镜，看不起高水平运动员\n\n
65433,1915,阚阅,2018-01-04 02:09:01,3,4,1,事多展示三四次
67886,1915,阚阅,2018-01-22 08:48:15,13,17,4,为什么你说创业基础算主修？
72370,1915,阚阅,2018-01-30 03:46:08,3,4,1,老师的评分方式很不公平，容易出现小组成员搭便车得情况
77735,1915,阚阅,2018-05-07 12:25:32,22,27,5,你应该别让徐小洲那么猖狂
109556,1915,阚阅,2019-06-17 03:30:15,4,6,2,口齿不请，口才很差，课上不知所云
116075,1915,阚阅,2019-09-02 23:44:28,3,4,1,很好呀 老师很幽默
117357,1915,阚阅,2019-09-23 09:26:18,0,3,3,老师和助教都很好啊
120449,1915,阚阅,2019-12-08 11:54:48,0,4,4,md 我认真学创业启程考试也没怎么错 3.3\n\n对面在另一个班兄弟一直水 考试也只会一点 4.8
121435,1915,阚阅,2019-12-16 06:43:12,1,1,0,瞎打分
127987,1915,阚阅,2020-12-02 08:48:50,3,3,0,虽然上课真的没啥互动（我也真的没怎么听），但是给分还是不错的……
128000,1915,阚阅,2020-12-03 00:42:40,3,4,1,老师上课是真的无聊，但是可以水，给分也不错
131660,1915,阚阅,2021-01-28 10:28:30,1,1,0,上理论课无聊，一节手工课倒是不错，给分很好，很轻松
13785,1954,徐曼,2015-12-31 02:53:17,-4,13,17,一个字，哭
20252,1954,徐曼,2016-01-26 16:12:28,-6,13,19,一般般
25389,1954,徐曼,2018-09-18 02:11:23,3,18,15,老师超级好，还萌萌的，女神
25767,1954,徐曼,2016-06-08 03:45:13,2,13,11,老师习百家功夫，有技术，也有情怀。\n\n希望还能上她的课～
25960,1954,徐曼,2016-06-14 15:04:50,-2,9,11,老师人超级好，会带我们玩游戏
28229,1954,徐曼,2016-06-28 08:18:25,-2,10,12,很好的老师
28333,1954,徐曼,2016-06-28 08:34:53,6,19,13,老师很温和负责，给分厚道，上课氛围很好，也能学到不少东西
29595,1954,徐曼,2016-07-02 06:49:52,-6,14,20,没缺过课绩点没上3，大家看着选
30278,1954,徐曼,2016-07-01 07:29:05,-6,14,20,上课事情蛮多的。只请过一次假，还当了组长，结果连平均分都没有，差评
32523,1954,徐曼,2016-07-07 11:06:04,2,18,16,老师功夫深厚，就是课太不水。
32981,1954,徐曼,2017-01-15 10:40:24,69,122,53,徐曼的专业请自行搜索，嫌不水的请知道你们的老师是专业老师，和你们上课的是全国冠军世界冠军，不是所有课都是来给你水的，走好不送mdzz
34129,1954,徐曼,2017-01-04 00:00:13,4,10,6,唉
34704,1954,徐曼,2016-10-19 01:30:42,-11,11,22,太极拳这门课 是真的无聊 别选
35603,1954,徐曼,2016-11-10 07:31:08,2,13,11,挺好的啊
36011,1954,徐曼,2016-11-10 10:02:23,12,22,10,老师人超级好，感觉萌萌哒(∩_∩)
37788,1954,徐曼,2016-11-21 05:17:30,9,19,10,老师好厉害！
38815,1954,徐曼,2017-01-15 10:40:33,-14,16,30,辣鸡老师，给分超烂，千万别选\n\n
39419,1954,徐曼,2016-12-22 14:15:39,1,9,8,老师人很好啊，上课很认真，想学东西的话当然选徐老师了，太极拳一定徐老师，如果想水水过的话就不要选了
39430,1954,徐曼,2016-12-22 15:40:57,0,8,8,想水的请绕道
41858,1954,徐曼,2017-01-13 05:27:45,0,6,6,超负责又温柔的老师～太极拳给分很好，而且可以学一个技能，炒鸡棒！
41903,1954,徐曼,2017-01-13 07:52:45,0,9,9,老师真的超级有知识，有情怀，如果想真的有所收获就来吧，如果你想水课请走开
42015,1954,徐曼,2017-01-13 12:16:47,-2,9,11,老师人很好\n\n还会往上调分
42157,1954,徐曼,2017-01-13 16:26:17,0,9,9,虽然分不高，但老师是真牛
42338,1954,徐曼,2017-01-14 04:55:46,-8,11,19,不负责任
42469,1954,徐曼,2017-01-15 03:09:53,-2,6,8,很好啦
44069,1954,徐曼,2017-01-17 08:59:24,-2,4,6,上课很好，能学到真东西，这样才有意义，只要好好学，好好复习，一般不会差
44351,1954,徐曼,2017-01-17 15:56:17,0,6,6,老师讲课认真，干货很多!
47844,1954,徐曼,2017-02-26 08:09:28,-1,6,7,老师人很好啊，专业水平也很过硬。12分钟跑也是差100米就给满分了，感恩。
48200,1954,徐曼,2017-03-01 07:41:22,-2,6,8,老师很好，一点不水，给分超高！！最好的体育老师，没有之一！！！\n\n
48682,1954,徐曼,2017-03-09 08:09:43,-1,4,5,还可以吧！
51559,1954,徐曼,2017-06-07 06:01:54,-2,6,8,老师挺好的，给分不错。老师很讲气息，不止关注动作
52269,1954,徐曼,2017-06-17 02:58:03,-2,2,4,老师真的好，而且学到很多东西
54320,1954,徐曼,2017-06-29 05:54:01,1,9,8,老师上课很认真 就是武术类课感觉学不到什么东西?
54362,1954,徐曼,2017-06-29 07:41:12,-6,2,8,老师很认真，武术类的体育课都还挺轻松的，给分也不错~
54532,1954,徐曼,2017-06-29 13:57:21,-4,4,8,选课时知道不水且低分还是为了充实的大学选了，以为3左右稳了…最后居然和正常体育课差不多分，那我就强推吧?认识有趣的老师和同学
64303,1954,徐曼,2017-12-22 09:53:17,0,6,6,很好的老师，很和蔼啊。
64409,1954,徐曼,2017-12-23 09:55:58,-6,2,8,老师还是很不错的， 上课也轻松
64529,1954,徐曼,2017-12-25 02:57:45,-4,4,8,老师超级好呀(๑• . •๑)萌萌的
64631,1954,徐曼,2017-12-25 16:33:26,-6,3,9,武术绩点没出之前，完全凭平时个人感觉来一发评论。\n\n老师非常好，武术课上课不水，如果感觉没学到什么东西太正常了，就练一个学期十几节课加起来不超过一个星期的时间能有什么大成果？会结合自己曾经的经历跟同学们交流谈心。有情怀，负责且和蔼的老师。
64803,1954,徐曼,2017-12-27 07:36:53,10,20,10,徐老师上课喜欢笑，给人一种很亲和的感觉，还会在休息时跟大家聊会天。在练习时不会因为大家忘记之前教过的东西而生气，会开玩笑说“学过的又还给老师了”，然后耐心地再教一遍。总之，徐老师是很好的老师。
64849,1954,徐曼,2017-12-27 11:54:18,-4,3,7,很和蔼的老师，和我们是朋友
64909,1954,徐曼,2017-12-28 02:16:35,-4,3,7,老师炒鸡厉害，什么都会，懂得很多，人生导师！
65361,1954,徐曼,2018-01-03 10:20:33,-4,3,7,挺好的，武术课挺水的，期末的专业考是别的老师来给分，分挺高，我们班是90-93分。
65726,1954,徐曼,2018-12-27 14:28:37,-15,14,29,mmp，傻逼老师，傻逼老师，给分极差
67956,1954,徐曼,2018-01-22 11:29:58,-4,2,6,老师上课很专业，人也不严肃，认真上能学很多东西~
67993,1954,徐曼,2018-01-22 12:40:36,-6,2,8,很好啊
68017,1954,徐曼,2018-01-22 13:19:47,-4,3,7,老师真的超好！要不是课表冲突我还想选她的剑术。武术专项考试的话期末给分都超好的。一开始学累了点，但能了解下中华文化很棒
68240,1954,徐曼,2018-01-23 01:29:39,-2,4,6,很好，第一节武术课就让我决定大学四节体育课争取都选民传了。原来是教体育专业的，专业素质很过硬，但也理解我们这些体质。。。的高考学子。考试把拳法练熟就好，理考有点迷，看运气。
71721,1954,徐曼,2018-01-29 01:50:37,-6,3,9,超级棒！！
73195,1954,徐曼,2018-02-01 06:47:47,-4,6,10,老师很棒很认真！绩点4.8，啥也不说了
75587,1954,徐曼,2018-03-13 14:47:11,-2,3,5,徐老师超级可爱，还会和我们聊天，关心我们的身体健康，给分也很好\n\n
79743,1954,徐曼,2018-06-13 08:00:12,16,25,9,普通生武术队过来帮顶
81291,1954,徐曼,2018-07-04 14:46:37,6,9,3,是个很nice的老师，上课很认真也很和蔼，而且会真正地教给学生很多东西，不过上课真的不水，还是有点累的，而且给分严格按照标准，有点难受
81357,1954,徐曼,2018-07-05 02:03:53,-2,4,6,体育渣渣，每门课的确不水挺累，但是每星期有那么一段时间锻炼身体也不错，也有趣味性。尽全力认真学了，课外锻炼满了，按老师要求写了额外的论文，本来希望能保住3.9，没想到上四了，感谢老师。
88052,1954,徐曼,2018-10-21 03:46:20,-2,5,7,非常可爱的老师?‍?
89503,1954,徐曼,2018-11-19 10:34:42,13,22,9,别的真的都很好\n\n但是这老师一涉及到请假就让人难以理喻\n\n
91824,1954,徐曼,2018-12-21 09:18:20,1,13,12,这老师分那么高是谁刷上去的呢？\n\n一点都不理解学生，喜欢谁就给谁特权，不喜欢谁就让谁好看。如果徐老师您能看到，我想说，您是一个老师，也只是一个老师！
91965,1954,徐曼,2018-12-25 06:28:54,1,7,6,今天结课了，老师喊下课的时候鼻子一酸。老师真的是个很好的人，上课很认真，上课练累了会让我们休息，一边休息还一边跟我们讲故事，很贴心。虽然上课真的很累，记得有一次上完课骑车回宿舍气都喘不过来了，想水的人不要来。毕竟老师是专业的教练。还有一个就是老师比较有原则，你请假什么的，就会被扣分，但是这也不能怪老师，毕竟学校就是这样规定的，你也确实请了假，被扣分也无可厚非，我只想说，老师，我下个学期还要选你的课！哪怕选不上我也要选！！
92226,1954,徐曼,2018-12-27 06:26:43,1,5,4,学的武术拳术，上完最后一节课，都说要选徐曼老师的剑术，老师真的很好，很可爱，教的很耐心不凶，专项课本来在风雨操场，然后不下雨都是去西操跑一次app，拳术考试挺轻松的，分数也可以，其他部分体育成绩毕竟看个人。给十分！
92235,1954,徐曼,2018-12-27 07:12:39,-1,4,5,非常看态度的老师，你打得不好但是有态度也是可以的。十二分钟跑最后实在跑不动了老师也给算了满分
92281,1954,徐曼,2018-12-27 11:44:50,-1,3,4,感觉来查老师给评个分，希望下学期还能选上她的课
92295,1954,徐曼,2019-01-22 08:08:54,-2,2,4,老师太好了哇哇哇 专业水平高给分好吹爆qwqqwq
92296,1954,徐曼,2018-12-27 13:47:48,-1,3,4,非常好，温柔，老师的优秀已经让我觉得上课是开心的呀呀
92364,1954,徐曼,2018-12-28 04:36:41,0,4,4,徐老师很可爱啊！虽然有时候第一二节会睡着啥的，但是真的非常nice～
92438,1954,徐曼,2018-12-28 15:39:02,-1,4,5,超级好的老师
93222,1954,徐曼,2019-01-22 07:32:21,-2,2,4,老师很好，学拳很有意思，可惜我下学期选不上老师的课...
93757,1954,徐曼,2019-01-14 13:17:45,4,11,7,mdzz
93917,1954,徐曼,2019-01-14 08:37:45,5,17,12,她的课我不会再上第二次
95653,1954,徐曼,2019-01-19 22:58:45,1,4,3,老师很负责，给分求是，这一点尤其表现在请假问题上。老师水平很高，专业素养极好，大家综合考虑选不选吧。
97251,1954,徐曼,2019-01-22 07:27:24,-3,1,4,上课很有料，不上会后悔的
97342,1954,徐曼,2019-01-22 08:18:22,-3,1,4,老师很温柔人很好，说话也很有味道，还经常和我们开玩笑。一般好好学好好考都不会很低吧。目前为止唯一一门满绩，真的很感谢老师哇。
97450,1954,徐曼,2019-02-28 05:30:59,0,4,4,老师很好，上课时和学生的交流也比较多，武术考试相对还是很简单的，竞赛，课外锻炼都认真完成的话，得分应该还是不错的。当然能够不缺勤的话就会更好了。
97461,1954,徐曼,2019-01-22 09:11:16,0,4,4,老师超级可爱，讲课会讲一些她自己的经历，很有趣，给分也很好，喜欢老师！！！！
97513,1954,徐曼,2019-01-22 09:39:35,-1,2,3,老师巨好，上课有趣，为人亲切和善
97516,1954,徐曼,2019-01-22 09:44:51,-1,3,4,老师超级专业，教太极教得很棒，不仅限于动作怎么做，还很有太极文化。
97557,1954,徐曼,2019-01-22 10:39:23,-2,2,4,开心～出分了！前来评一波！学的是太极拳徐老师很 nice很有文化底蕴！会教的比较快，也挺难记住步子但是多多练习，收获也会很多～给分也很好！记得体能一定要锻炼上去！专项课也要去上哈～
97622,1954,徐曼,2019-01-22 12:13:59,0,3,3,非常专业的老师，在浙大担任教师前是专业的武术教练，现在也经常带队参加各种比赛。老师挺好的，一个学期下来会记得我们每一个学生的名字。
97637,1954,徐曼,2019-01-22 12:27:44,0,3,3,老师认真负责会点名，但不苛刻，二十四式不容易，运动量着实小，大家上课也尽量认真叭，老师会关注每个人的情况的，不要想水水过。\n\n这是努力和回报成正比的课程，不要太恐慌，但也请珍惜哦！
97893,1954,徐曼,2019-01-23 01:13:55,-1,3,4,老师超级好，上课没什么压力，但能学到很多东西，不是搞笑型的老师，蛮朴素自然的，但课堂气氛就是很好。而且，给分是真的很好！
100307,1954,徐曼,2019-01-26 02:42:59,1,4,3,老师很好(●'◡'●)ﾉ❤
101054,1954,徐曼,2019-01-27 10:52:13,0,3,3,认真负责
101239,1954,徐曼,2019-01-28 02:36:45,1,4,3,老师超级关心学生超级用心 给分也超好！！强烈推荐太极拳！
101832,1954,徐曼,2019-01-29 08:38:11,-1,3,4,不说了，能继续选上曼曼的课开心到飞起！
103316,1954,徐曼,2019-02-27 08:53:18,-1,2,3,负责，专业，nice
109005,1954,徐曼,2019-06-05 09:39:39,-1,2,3,老师很负责 但也经常出差 相当于也选上朱莉老师的课∠( ᐛ 」∠)＿两个老师都很棒
109199,1954,徐曼,2019-06-11 16:01:16,11,14,3,我就是想水个体辅，唉，老师真的很严格。
111304,1954,徐曼,2019-07-01 01:50:13,0,4,4,为徐曼老师疯狂打call！上了老师两学期的武术课了，老师人真的很好很好！
113832,1954,徐曼,2019-07-07 17:19:54,-1,3,4,老师真的非常认真负责 我这种从小到大的体育废物都能拿一个算好的绩点 我觉得那些说老师不好的人真的应该反省一下自己
115185,1954,徐曼,2019-07-16 23:06:41,0,4,4,对学生超级好！！特别关心学生！
116386,1954,徐曼,2019-09-10 01:03:23,-1,2,3,萌萌哒
117434,1954,徐曼,2019-09-24 08:48:37,5,11,6,有理无情，严格冷漠
117436,1954,徐曼,2019-09-24 09:18:26,5,10,5,话不多说，不管武术教的怎么样，体辅课事情是真的多。没必要
117437,1954,徐曼,2019-09-24 09:42:39,10,17,7,体育辅导课先来75个深蹲/深蹲跳，然后下课15分钟前开始2.5/3.5公里打卡，这不爽吗？
117586,1954,徐曼,2019-09-26 09:30:42,2,11,9,体育辅导课做60个深蹲加30个深蹲跳，做完以后两个腿一点力气都没有了，距离下课还有十五分钟竟然让我们去打卡？？？ 十五分钟的时间加上已经没力气的双腿，跑个鬼的3.5km，距离晚上第一节课就一个小时，这中间要回宿舍洗个澡加吃晚饭不拖堂时间都很紧，什么也不教，就让运动加打卡，也不知道这样的辅导课上的有什么意义！
117608,1954,徐曼,2019-09-26 15:15:56,1,5,4,。。。
117664,1954,徐曼,2019-09-28 06:19:16,4,7,3,徐曼老师现在的专项课运动量这么大了吗？一年前我记得还只是打一次卡的量，这中间发生了什么？
117778,1954,徐曼,2019-10-01 10:04:50,1,4,3,老师真的真的超级好。不水，但是都是我们能做到的啊
120255,1954,徐曼,2019-11-26 08:19:58,2,6,4,体育辅导课太难了吧
122289,1954,徐曼,2020-02-22 10:59:44,1,4,3,这个十分是给王地老师的
122862,1954,徐曼,2020-04-15 12:40:58,10,14,4,特别认真负责的老师！听说别人班的体辅就是打个卡就水过了，徐老师会和你连麦然后纠正你的错误！五六个群的太极拳考前辅导站也是活久见~徐老师超级好！
122865,1954,徐曼,2020-04-15 14:19:55,13,17,4,3000人同时练习太极拳，老师耐心地一遍遍、多角度示范，真的好老师！
122866,1954,徐曼,2020-04-15 14:21:24,4,8,4,好老师，义务教大家太极拳，3000人围观确实壮观
122867,1954,徐曼,2020-04-15 14:21:59,5,10,5,打个十分，感谢太极拳捞我
122868,1954,徐曼,2020-04-15 14:27:18,13,19,6,刚刚上完徐曼老师的太极拳考前辅导班！老师人超好超耐心，会反复抠动作示范，带大家练习，认真回答大家的问题。成功帮助太极拳小白速成了！必须给十分！！
122869,1954,徐曼,2020-04-15 14:42:03,1,5,4,两小时速成，妈妈再也不用担心我的太极拳\n\n徐老师教的太好啦！
122870,1954,徐曼,2020-04-15 14:52:19,0,3,3,徐老师实在是太好了啊啊啊啊啊啊啊啊
122881,1954,徐曼,2020-04-16 11:56:29,-1,4,5,没什么，真的觉得评论第一那位说的很对，徐曼老师上课真的很负责，一点都不水，专业水平很高，想上很水的体育课的同学请绕道。
122925,1954,徐曼,2020-04-21 04:23:41,-2,3,5,🐂🍺
122938,1954,徐曼,2020-04-23 01:07:15,4,8,4,老师是很负责的，太极拳教的很好。但是整个线上体育课程期间，感觉就她班级事情最多，线上课程比线下还麻烦还累，其实整个夏学期体育考核方式就及其不合理......再次肯定热评第一的评价：老师过于专业，让我体验到从小学到大学最硬核的体育课
123608,1954,徐曼,2020-06-10 13:00:13,5,14,9,打1分是因为没有0分
123654,1954,徐曼,2020-06-11 07:24:14,4,9,5,网课杀手
123749,1954,徐曼,2020-06-13 11:40:23,5,10,5,真的麻烦
123755,1954,徐曼,2020-06-13 14:23:11,-4,3,7,上课认真学，太极拳还是不难的。我的满绩之一。
123805,1954,徐曼,2020-06-14 11:00:04,7,14,7,体辅课真的不推荐，事多还累死个人。钉钉回话极其冷漠，或者干脆不鸟你。线下可能好一点。体育课的话应该还不错，体辅是真的算了，没必要。
124477,1954,徐曼,2020-07-01 19:25:12,-2,3,5,非常好
128655,1954,徐曼,2020-12-25 02:36:47,-1,5,6,老师上课很认真，也很有责任心，而且最贴心的是老师怕我们身体素质课缺得太多导致成绩不及格，提醒我们可以去补课。真心的好老师。
130277,1954,徐曼,2021-01-20 12:11:45,-3,6,9,武术课。老师超可爱，很爱笑，而且是那种，笑起来，能让你一整天都开心的笑容。武术课给分很高的，大家专项(少林连环拳)基本都是91/92/93左右。另外，老师挺负责的，体测/理论考试，都会提前好久就提醒，很贴心。希望以后还能选上徐老师的课~(强推)
131122,1954,徐曼,2021-01-26 05:01:42,2,9,7,学业忙的训练课建议劝退，2.4？！她给分手下可真不留情
131802,1954,徐曼,2021-01-29 03:58:51,1,6,5,老师人很好，但是事情特别多，对学生要求很严格，如果只是想水一水体育学分的话慎选
134119,1954,徐曼,2021-03-16 09:40:18,7,14,7,sb，选到快逃
135638,1954,徐曼,2021-05-18 01:37:34,3,17,14,徐冠病毒\n\n浙大学子没人水，有些学生课真的很多，别的老师都理解，可她偏偏不。而且入坑她的武术队后并没有看到她有多耐心负责，全让老生教新生，自己基本坐一边玩手机，新生动作做得是否对她也基本不看，有些错误三个月后她才发现。训练课从不在学期初告知评分标准，放纵学生不来，直到期末才说有考勤然后疯狂绩杀。不能说你有多严格，只能说你有多刻薄
135640,1954,徐曼,2021-05-18 01:38:44,0,10,10,徐冠病毒\n\n浙大学子没人水，有些学生课真的很多，别的老师都理解，可她偏偏不。而且入坑她的武术队后并没有看到她有多耐心负责，全让老生教新生，自己基本坐一边玩手机，新生动作做得是否对她也基本不看，有些错误三个月后她才发现。训练课从不在学期初告知评分标准，放纵学生不来，直到期末才说有考勤然后疯狂绩杀。不能说你有多严格，只能说你有多刻薄
135643,1954,徐曼,2021-05-18 02:19:21,1,5,4,兄弟姐妹们快逃啊！！！想学民传强烈推荐吴剑老师！
141096,1954,徐曼,2021-09-23 10:23:42,7,10,3,如果体育课想要划水摸鱼的，逃就完事了；如果真的对武术感兴趣，而且不想水体育课的，徐老师会很对你胃口，她是那种很较真的老师！大家选课要慎重。
142226,1954,徐曼,2021-11-09 02:15:06,2,7,5,语气非常yygq呵呵呵
142227,1954,徐曼,2021-11-09 02:06:28,1,6,5,语气非常yygq呵呵呵
143860,1954,徐曼,2021-12-09 06:15:24,2,7,5,为什么有两个徐曼放在这里。\n\n要是早点看到另一个评价我不会选她的课的。
144011,1954,徐曼,2021-12-16 01:41:08,3,7,4,选了她的武术课。很负责的老师！每节课都干货满满，老师教导很耐心认真，一学期下来学了两套拳。最喜欢的是她用武术的方式来锻炼，课前基本没有跑步环节，而是练一些武术动作，对于我这种跑步渣来说太友好了（虽然最后总分里扣分最多的还是12分钟跑，这就不友好了呜呜呜）。一开始练完两节课，几天内都浑身酸痛，不过练到学期末就没有这种情况了，感觉自己身体素质确实得到了提高，还增加了对我国传统之一的了解。就是喜欢这种不水的课！
144667,1954,徐曼,2021-12-23 04:48:38,-2,4,6,是很负责的老师！！！好负责好负责，重要事项也会反复强调，真的很不错！体育专项分都给得很高！
145020,1954,徐曼,2021-12-26 14:25:28,0,6,6,普通生武术队来咯！超好的徐曼老师！！！超级喜欢她！！！
145723,1954,徐曼,2022-01-01 02:20:22,-2,3,5,第一学期就非常幸运地选上了武术课，然后就爱上了老师，也爱上了课。徐老师要求很严格，但是如果真的愿意去学习而且肯吃苦的话，非常推荐，而且分数一定不会低。但是如果不喜欢运动的话，慎选!否则分数真的会很难看。
146409,1954,徐曼,2022-01-10 15:28:08,3,7,4,呵呵，我真的谢。。。
147068,1954,徐曼,2022-01-08 14:37:21,-4,5,9,啊啊啊出分了！我吹爆徐曼老师！（武术满绩95.2飘过）徐老师上课确实很严格，但是也很耐心，我们忘记动作的时候也只会特别无奈地说“哎呀又忘啦，那我再带一遍吧。”十二分钟跑会放一百米的水，仰卧起坐很严格不让谎报成绩的。专项成绩只有92（也有可能是因为我一个不小心忘了一点点动作...）总而言之，人很nice 不想划水的可选！
150918,1954,徐曼,2022-02-21 05:16:39,1,4,3,很好的老师！教动作很耐心也会带着学生一起做。能学到一些东西。虽然有点累但是给分很不错！
151835,1954,徐曼,2022-06-06 12:27:30,9,12,3,1分，太严格了
153657,1954,徐曼,2022-05-07 06:08:55,0,3,3,1.每节课必点名，旷课扣2分 请假扣1分\n\n2.老师专业水平很高，喜欢武术的同学会觉得老师很厉害。\n\n3.老师人品还凑合，但是请假非常难。必须要纸质假条和多方签名。因个人住院和辅导员怀孕不在学校，向老师提供病假证明和病历，不给算请假。以前上过五个其他老师的体育课，没有见过如此。\n\n3.课程标准高，课程项目多，但是学生课上身体难受会关心，还不错\n\n4.还有12分钟跑非常严苛(如跑了2150米还照5圈算)，其他项目自不必说\n\n5.如果是个人体质不算很好的同学或者平衡性不佳的同学一定慎选武术课，非常累且难\n\n6.这位老师的武术课个人感觉基本相当于广播操的超级加强版，比较枯燥，不太有意思。如果想体验有意思的课程慎选武术
154166,1954,徐曼,2022-05-25 03:07:49,1,2,1,挺好的，就是武术课强度也不低🤪
154951,1954,徐曼,2022-06-07 04:14:12,0,3,3,小白认真学，最后考试能上90（我们那次是完整打下来少林连环拳就行，一般的考试前两三周就可以了，老师还会带着练习两次课吧）。老师水平很高，上的是真正的课，能学到很多。注意认真听课，尤其是第一节老师讲注意事项，不要就请假事项在后面的课程再去反复提问（老师比较喜欢一次讲清楚，有疑问要当时提出）。对于请假很严格，但是上课很和蔼，很关心同学，很耐心。综上，强烈推荐！
159985,1954,徐曼,2022-09-11 03:03:46,0,4,4,徐老师就是我的神
160113,1954,徐曼,2022-09-13 10:43:07,8,14,6,可以严格，但不能没有人情味。这是一个完全不为学生着想的老师。建议还是找年轻一点的老师比较好，建议这位老师尽早退休，千万不要返聘
168324,1954,徐曼,2023-02-11 12:16:38,0,0,0,老师上课很认真，自身能力水平也是在线的。不过确实考核比较严格，选课的话要慎重。
169327,1954,徐曼,2023-02-25 12:13:02,-3,0,3,好老师！！！
171701,1954,徐曼,2023-04-02 12:47:36,-1,2,3,烂人！！！说话不算话，恶心
175432,1954,徐曼,2023-06-25 01:38:15,2,2,0,真恶心，给分差的要死\n\n一整个班满绩的就那一个\n\n我体测分比我其他班的室友高十几分总评比人家低，6
175437,1954,徐曼,2023-06-25 02:01:09,0,1,1,老师很好，上课很耐心
177020,1954,徐曼,2023-07-01 06:16:40,0,0,0,武术课很累，体能差的别选。老师比较严格。
178538,1954,徐曼,2023-07-14 02:18:05,1,1,0,过于严格，对于大多数同学而言，体育课不应该是压力这么大的课程
180796,1954,徐曼,2023-09-26 09:59:45,3,3,0,乐了，习题课在5点结束，身体素质课在5分开始，告诉我不能迟到，迟到多了直接没分，不能通融一下？点名也是整得稀烂，快跑，别选!
194324,1954,徐曼,2024-06-23 08:45:13,0,0,0,我觉得很好的老师啊，可能因为我没请过假（？\n\n武术很水的，每节课教五六个动作，期末考试就考教的内容，挺轻松的（PS我是无任何基础的小白），最后考试不是老师给分是另一个武术老师，拿了91我觉得很好哩！\n\n最主要的是武术房开空调真的很凉快，不过冬天有一点冷（打几个动作就不冷了哈哈\n\n总之好课，水水的很安心，来选
737,1962,褚良才,2015-03-16 06:24:17,73,83,10,上课喜欢放片
907,1962,褚良才,2015-03-18 15:40:50,-9,9,18,上课就会放片
1600,1962,褚良才,2015-03-23 01:14:11,7,13,6,很赞的一个老师
1700,1962,褚良才,2015-07-10 01:31:49,8,9,1,看片
2155,1962,褚良才,2015-04-03 04:00:07,48,54,6,孙子兵法脑残粉
2344,1962,褚良才,2015-04-24 10:26:46,31,34,3,喜欢放片
3097,1962,褚良才,2015-05-14 05:26:33,11,14,3,只会放片
3421,1962,褚良才,2015-06-12 02:14:52,43,61,18,从不点名，没有课堂测验，论文给分超好，满分40的论文，最低只打35
3603,1962,褚良才,2015-06-17 01:48:00,42,45,3,最省事的老师
4254,1962,褚良才,2015-06-18 10:51:27,54,56,2,张菊座即视感
4403,1962,褚良才,2015-06-21 13:41:17,-17,8,25,五毛狗
4859,1962,褚良才,2015-06-30 01:43:58,0,4,4,很好的老师和我志同道合
4896,1962,褚良才,2015-06-30 06:53:21,41,44,3,从不点名，前两节课讲得不错，但是之后开始各种放片，建议翘课
5291,1962,褚良才,2015-07-06 09:57:12,3,4,1,上课很轻松
6362,1962,褚良才,2015-07-13 08:34:17,26,29,3,事情最少，讲课和得分其实不如吕强。上课喜欢放片教学，交完论文就没有来的必要了。然后有些军理老师考试的时候会“给予帮助”，褚老先生一般是不管事的。
6812,1962,褚良才,2015-07-23 06:14:37,3,4,1,比较水
6889,1962,褚良才,2015-07-30 02:15:02,-2,2,4,挺好论文分给的很高
7618,1962,褚良才,2015-09-15 06:37:26,-3,2,5,完美，特别有趣，建议选几次，千万别退。
7625,1962,褚良才,2015-09-15 06:45:30,-1,1,2,好可爱的老师，挺有人格魅力
7634,1962,褚良才,2015-09-15 06:57:11,-2,0,2,还不错\n\n
8108,1962,褚良才,2015-09-17 04:58:54,-2,1,3,老师偶尔装逼挺萌的。
8334,1962,褚良才,2015-09-18 12:24:04,0,2,2,唯一一门不想睡觉的课。
9340,1962,褚良才,2015-10-22 09:10:17,-2,0,2,超级好
9723,1962,褚良才,2015-11-06 01:58:04,5,5,0,各种放片……
9778,1962,褚良才,2015-11-09 01:45:03,10,10,0,给分不好
9816,1962,褚良才,2015-11-10 07:20:48,3,5,2,从来没有听过这么好的军理，特意来评价。老师风格非常幽默，至于经常放片，想水的人可以水过去，想听的人就觉得怎么不能多讲点啊！！！
10007,1962,褚良才,2015-11-14 07:45:56,16,18,2,如果真想听什么军事学的理论…还是另请高明吧。不过上他的课，你总能得到一些人生的哲理，老先生自身专业水平是过硬的，但上这门课一直不太上心，当作大讲堂来着。
10073,1962,褚良才,2015-11-15 11:18:37,0,2,2,虽然喜欢放视频，但都是很有价值、看了很有收获的视频。老师很爱国，很喜欢老师讲话的风范和用词。
10218,1962,褚良才,2015-11-17 12:55:36,14,15,1,褚良片老师把军事课上成了佳片有约节目
11164,1962,褚良才,2015-11-25 02:02:16,4,4,0,………
12757,1962,褚良才,2015-12-24 03:20:02,0,2,2,军理课上成了电影课\n\n不过老师很幽默\n\n孙子兵法脑残粉
13155,1962,褚良才,2015-12-25 03:40:05,6,7,1,老先生专业水平过硬，可能对这门课确实不是很上心，一直放片...
13654,1962,褚良才,2015-12-30 08:45:56,-2,2,4,论文35分起（满40
14649,1962,褚良才,2016-01-08 05:32:38,0,2,2,非常省事的老先生。
16547,1962,褚良才,2016-01-21 07:49:15,23,23,0,为什么我绩点这么低不开心T_T
18049,1962,褚良才,2016-01-21 07:11:28,24,24,0,给分不好啊……完全不懂怎么给的……考试时我明明几乎都找到了啊……
18053,1962,褚良才,2016-01-25 09:54:02,7,7,0,上课很水 给分很随意
18081,1962,褚良才,2016-01-21 07:25:33,11,11,0,上课水什么都学不到\n\n给分一般说最低给35的论文实际不知道\n\n放片\n\n不建议选 还是吕强好（毕竟用过他的复习资料）
18086,1962,褚良才,2016-01-21 07:30:58,5,8,3,垃圾-
18089,1962,褚良才,2016-01-21 07:34:43,5,5,0,呵呵呵
18193,1962,褚良才,2016-01-21 09:02:10,18,18,0,就想问你怎么给的分……(･ิϖ･ิ)っ
18223,1962,褚良才,2016-01-21 09:55:23,11,11,0,都不知道怎么给的分啊啊啊啊啊啊啊！
18719,1962,褚良才,2016-01-22 11:55:07,14,14,0,省事……\n\n分低！！！
18912,1962,褚良才,2016-01-22 18:39:31,12,14,2,老师人很好，就是给分我真的不懂啊！考试的题我几乎都在书上找到了，最后的分，哎...
20321,1962,褚良才,2016-09-18 13:13:17,0,1,1,喜欢褚老的课。老师水平很高，会给你讲很有用的哲理、道理，而不仅仅讲军理。认真听会很有收获
21880,1962,褚良才,2016-03-01 11:32:42,0,2,2,很棒很渊博，第一节课就被迷住了，很真实很自然，观点还挺理智客观的
22583,1962,褚良才,2016-03-08 07:09:29,1,3,2,不知道你们怎么想的 反正我觉得就是老人家在前面说着一些谎话 反正就是挺反感的 学不到东西
22705,1962,褚良才,2016-03-10 04:55:22,0,2,2,很有趣，学识渊博
22865,1962,褚良才,2016-03-14 00:52:24,15,16,1,差评，什么论文最低35，完全是骗人！
23746,1962,褚良才,2016-04-14 09:32:59,0,1,1,老师超有趣，专业课有时候不想听，军理每次听的津津有味！！！棒哒哒！！！满满爱意
24694,1962,褚良才,2016-05-03 06:35:51,0,0,0,很和蔼
25659,1962,褚良才,2016-05-31 08:06:42,3,4,1,不说课讲的怎么样，褚老师为师为人是我在浙大所遇到过的老师里，最讲究的。
25761,1962,褚良才,2016-06-07 08:24:24,1,2,1,很和蔼，讲起课来讲的也很好，但是上课的大多数，绝大多数的时候都是在放片放片放片放片放片放片。。。。。
25905,1962,褚良才,2016-06-14 07:07:00,2,4,2,不点名，全程放片，孙子兵法和毛泽东脑残粉，但是你向他提过问题就会发现他对军事方面问题的理解真的有深度（虽然我保留和老师在武器发展方面的分歧），总体而言是个好老师，多问问题，会有收获的。
25963,1962,褚良才,2016-06-14 15:28:49,1,1,0,放片，放片
26257,1962,褚良才,2016-06-16 12:14:21,0,0,0,遇到的最好的老师！听他的课，非常振奋。老师有种魔力，平常不喜欢的东西，听他讲却听的津津有味，对人生价值观的建立有很大影响。很好的老师！
26752,1962,褚良才,2016-06-21 04:48:09,4,4,0,课很水，听听也不错，就是给分太坑了！期末开卷明明都找到了！不是说论文最低35嘛→_→到底怎么算的
28815,1962,褚良才,2016-06-28 16:17:55,0,0,0,一直在放片
28934,1962,褚良才,2016-06-29 03:50:44,0,0,0,超级水的老师，放片狂魔，期末考试基本只能看造化，靠自己看书，
31778,1962,褚良才,2016-07-05 02:02:09,0,0,0,很水，很轻松，期末靠自己。
31826,1962,褚良才,2016-07-05 03:20:23,1,1,0,还好吧，特喜欢放片，很水，期末要好好看书，否则找不到
31829,1962,褚良才,2016-07-05 03:29:06,4,4,0,期末给分太坑.....要绩点高的千万别选，明明就只有几个不确定的空，还有之前说好的论文大于35分，怎么会这种成绩.....希望褚老师能解释下。给分是不是按正态比例所需给的而不是按考试所得给的啊！！！差评
32237,1962,褚良才,2016-07-06 04:19:42,1,1,0,那个…褚老先生的课…交过论文以后…建议翘吧…老先生人好三观正水平高没说的…就是这课太无聊了…然后吧…期末开卷虽然，但书还是要看一遍的，不然真的真的找不到啊科科，然后给分也就那样吧，凑合看，反正学分也才一点五
32293,1962,褚良才,2016-07-06 05:58:12,0,0,0,还不错
33045,1962,褚良才,2016-09-11 03:16:45,-4,1,5,上课放视频从来只去一一节课听下有没有任务布置，写了篇论文马马虎虎，最后考试很简单，轻松4.5
33311,1962,褚良才,2016-09-18 04:23:20,-3,1,4,水过去的，最后4.5，考试考得好，论文写得好就没问题了
35739,1962,褚良才,2016-11-10 07:57:51,0,0,0,讲的还可以 喜欢说孙子兵法 给分最后拿了85 怎么说呢 自己真没付出什么 拿了这个分数也算可以认同 老师算是很不错了
40831,1962,褚良才,2017-01-06 01:21:44,0,0,0,今年就退休了，赶紧来占坑
47488,1962,褚良才,2017-01-28 01:17:05,0,0,0,分真的低，给的承诺完全是骗人的
105210,1962,褚良才,2019-04-07 12:03:57,-1,0,1,我是ikun，考前刷蔡徐坤nmsl，看蔡徐坤打篮球，结果我满了
52170,1968,喻永祥,2017-06-15 10:18:15,0,1,1,体操太主观，简直无语
64766,1968,喻永祥,2017-12-27 05:30:35,0,0,0,讲的好的~
91886,1968,喻永祥,2018-12-24 10:11:07,0,0,0,调皮的学生会骂，但是不会记在心上。对事不对人。
93390,1968,喻永祥,2019-01-09 10:49:45,0,0,0,没学分的我（：
111829,2019,薛奎,2019-07-03 00:32:55,18,19,1,完全就是一傻逼玩意儿 上课睡长板凳 乱鸡巴给分 真实服了 还水得一批
120841,2019,薛奎,2020-01-17 18:09:24,5,5,0,nmsl
135049,2019,薛奎,2021-04-28 07:21:49,-7,0,7,还不错
144630,2019,薛奎,2021-12-23 02:09:58,8,8,0,rnmlgb，wsnd，dddd！！！
187115,2019,薛奎,2024-01-14 13:55:11,3,3,0,一言难尽…
187147,2019,薛奎,2024-01-14 18:10:03,6,6,0,很难想象这是个人
190844,2019,薛奎,2024-03-21 09:31:01,2,2,0,唐氏！
201431,2019,薛奎,2024-11-02 13:45:47,0,0,0,good
24947,2036,邵兴江,2016-05-04 11:59:01,-82,8,90,讲的还可以，老师挺严谨的，给分不高
27773,2036,邵兴江,2016-06-27 13:01:16,61,66,5,度日如年
31203,2036,邵兴江,2016-07-03 11:13:20,47,53,6,呵呵哒，要不是专业课，谁要上啊
32696,2036,邵兴江,2017-01-06 06:09:47,48,52,4,ppt上还有错别字，真心看不下去\n\n
48858,2036,邵兴江,2017-03-15 03:20:06,53,58,5,老师挺能扯 但又臭又长 最重要的是没有重点 没有逻辑 隔靴搔痒
49739,2036,邵兴江,2017-04-25 06:00:08,28,33,5,有点直男癌……
49862,2036,邵兴江,2017-04-26 15:05:55,74,78,4,今天我们 在座的各位
49863,2036,邵兴江,2017-04-26 15:06:22,73,77,4,今天 我们 在座各位 我在美国的时候?
49864,2036,邵兴江,2018-09-17 08:42:16,118,127,9,今天 ...我们在座各位都很吃力...我在美国...浙江大学是一所很好的大学，我的责任是贱伟大学校！脑残的不行，不如去跳舞。
52612,2036,邵兴江,2017-06-21 11:56:56,44,49,5,真的不好
54680,2036,邵兴江,2017-06-30 04:08:38,54,60,6,教育学院的老师 一言难尽
56923,2036,邵兴江,2017-07-05 03:29:04,38,45,7,贼难受…ppt之丑，还有错别字。开学说不喜欢死记硬背，期末可以把每道题都出成死记硬背题。一周五节课课两节讲课，三节课展示，各种展示，还要期中考期末考。而且评价光讲人家展示技巧，讲人家ppt做得好不好，内容知识什么的请问你是自己也不懂吗？？？
57566,2036,邵兴江,2017-07-10 00:06:40,-67,15,82,说句良心话，上老师课，和老师讨论问题真的收获很多啊……给分也是很好，考试给范围你们还求什么
62697,2036,邵兴江,2017-11-26 12:38:05,-74,5,79,课堂深入浅出，故事很多，有启发，我觉得还不错
63107,2036,邵兴江,2017-11-28 10:05:58,61,62,1,神奇的老师
63723,2036,邵兴江,2017-12-23 08:00:57,-68,7,75,我觉得不错，个别同学差评肯定是被老师批评上课不认真了
64636,2036,邵兴江,2017-12-26 00:07:21,52,54,2,垃圾。
66000,2036,邵兴江,2018-01-11 01:51:55,31,33,2,煎熬，没啥主题。最后随堂考试发现理解完全没用，全是死记硬背。那有啥意义，垃圾
74596,2036,邵兴江,2018-03-04 12:14:33,116,121,5,给你一分都怕你骄傲
76565,2036,邵兴江,2018-04-15 08:34:24,109,111,2,奇葩老师 骚的不行
77932,2036,邵兴江,2018-05-08 15:43:50,46,46,0,老师你是真的厉害 佩服佩服
80253,2036,邵兴江,2018-06-23 06:26:12,61,62,1,老师太优秀 浙大真的配不上你
84963,2036,邵兴江,2018-07-14 15:35:00,-69,2,71,我觉得老师还是挺好的…考前会给复习提纲，认真看能考好
86571,2036,邵兴江,2018-09-17 08:43:39,81,81,0,神奇的动物
91148,2036,邵兴江,2018-12-02 02:55:28,-53,3,56,还不错了
92952,2036,邵兴江,2019-01-06 08:03:14,55,55,0,昏天黑地背到吐
96551,2036,邵兴江,2019-01-21 06:18:16,41,41,0,死记硬背有的，理解也是有的，可以说闭卷考出了开卷的难度……
98238,2036,邵兴江,2019-01-24 10:15:57,42,42,0,老师你居然还能打3.4分，请问你是自己刷了吗？？？
103261,2036,邵兴江,2019-02-27 05:06:01,28,28,0,事多分也不高，主要是废话多
104316,2036,邵兴江,2019-03-18 00:21:41,19,19,0,王侯将相有种子么?
104340,2036,邵兴江,2019-03-19 04:48:23,3,5,2,...
108778,2036,邵兴江,2019-06-02 03:26:17,0,2,2,。。。
108978,2036,邵兴江,2019-06-05 03:16:36,27,28,1,葛朗台爱好者，又红又专是他的底色
109266,2036,邵兴江,2019-06-12 12:55:04,94,95,1,你知道，我知道，大家知不知道，今天，未来，在座的各位都是，我曾经，在美国，在宁波，有这样一个学校，是非常特别的，也许你会想，但是我要说，浙江大学是要成为双一流的大学！
110185,2036,邵兴江,2019-06-25 06:01:12,-46,7,53,迷死绍老师了，我男神，摸摸哒（五毛一条）
114369,2036,邵兴江,2019-07-10 00:02:48,16,16,0,出分了觉得很迷。同学在考前一天才开始复习，背了我整理的提纲4.8，但是自己提前五天复习只有4.2。。。或许是平时分的差距?留下了平时不学无术的泪水。。。
115601,2036,邵兴江,2019-08-07 15:10:18,0,2,2,...
118386,2036,邵兴江,2019-10-26 06:55:10,68,68,0,你知道 我知道 今天 未来 在座各位 我想说 浙大牛批
120127,2036,邵兴江,2019-11-17 15:44:08,46,46,0,牛批哦
122709,2036,邵兴江,2020-03-23 08:52:43,46,46,0,没话说了 看到大家把我想说的都说了
122986,2036,邵兴江,2020-04-27 18:53:06,87,87,0,老师 你还没有上低分榜，还没有上热门老师，说明你在建设双一流的道路上还是不够秀啊！
123044,2036,邵兴江,2020-05-04 17:49:20,0,3,3,...
123112,2036,邵兴江,2020-05-10 11:38:29,33,33,0,没话说了，看到大家把我想说的都说了
124916,2036,邵兴江,2020-07-19 16:56:49,8,8,0,相同课程里给分最低的老师，事多 水平低，给分吝啬
126327,2036,邵兴江,2020-09-22 17:53:38,0,0,0,...
126886,2036,邵兴江,2020-10-26 18:52:27,3,3,0,真的像评论里的那样，今天 我们在座各位...哈哈哈，讲课一套一套的，都是花里胡哨没有意义的东西，仿佛在听传销...重要的知识请问老师你是自己也不懂吗？
128569,2036,邵兴江,2020-12-24 04:10:36,3,3,0,专业素养真不高。。
130221,2036,邵兴江,2021-01-19 09:57:50,0,0,0,这老师的课...
133174,2036,邵兴江,2021-02-13 09:11:17,0,0,0,奇人额
133185,2036,邵兴江,2021-02-15 05:10:55,2,2,0,很跳啊
133811,2036,邵兴江,2021-03-06 07:39:37,-6,2,8,课上确实挺能吹但是人挺好的
133820,2036,邵兴江,2021-03-06 15:52:32,1,2,1,课上确实挺能吹但是人也很傻逼
133874,2036,邵兴江,2021-03-08 13:24:10,3,3,0,课上不要太能吹
134177,2036,邵兴江,2021-03-18 02:56:14,4,4,0,红灯疼绿灯肘
134226,2036,邵兴江,2021-03-19 17:53:30,2,2,0,滥竽充数的划水混子
134526,2036,邵兴江,2021-03-31 10:58:15,2,2,0,听到我脑壳疼
135300,2036,邵兴江,2021-05-07 21:03:26,0,0,0,天黑请闭眼\n\n请睁眼\n\n昨晚被毒了。请问有什么要说的吗？\n\n大家相信我 邵兴江是个狼人
135751,2036,邵兴江,2021-05-23 19:21:35,1,1,0,每个学院可能都会有几个奇葩老师\n\n在教育学院，你最nb
137246,2036,邵兴江,2021-07-02 13:38:23,5,5,0,可惜期末再好的给分也不会消减平时上这门课的痛苦555😭😭
145895,2036,邵兴江,2022-01-04 01:41:34,0,0,0,上课内容很多启发 虽然还没出分吧 不影响
148960,2036,邵兴江,2022-01-14 04:33:30,-1,0,1,吹归吹，但是不听就好了。事多也是真的，给分还可以接受
154598,2036,邵兴江,2022-06-02 10:51:35,-2,0,2,其实人挺好，给分估计是为了正态分布
163240,2036,邵兴江,2022-12-10 15:25:04,0,0,0,终于结束了
164538,2036,邵兴江,2022-12-21 14:11:53,0,0,0,什么东西
187907,2036,邵兴江,2024-01-17 17:53:11,1,1,0,教育建筑学：上课还是很不错的，但是作业ddl变来变去，原本说最后一节课结束后一周内提交，结果倒数第二节课就要交...另外期末作业写的是真的痛苦，有点为难我们了
188125,2036,邵兴江,2024-01-18 08:43:39,1,1,0,事多分特别少，占了两节早八，还经常要点名。教育建筑学作为选修课还是慎选，除非对此非常感兴趣
7651,2039,张剑平,2015-09-15 08:58:13,1,1,0,很好啊
31430,2039,张剑平,2016-07-04 02:06:12,1,1,0,在咪咕数媒实习时遇到他了⋯⋯做了个虚拟现实下的非正式学习的报告，闲着无聊就发了这条评论，给了10分而且不点名⋯⋯
24553,2065,邱亚君,2016-05-01 13:57:55,-25,0,25,还不错
36278,2065,邱亚君,2016-11-11 12:58:26,28,28,0,笑里藏刀，猴塞雷拉
50939,2065,邱亚君,2017-05-09 12:20:32,34,34,0,傻逼老师 真的傻逼 服气服气服气！
55307,2065,邱亚君,2019-10-28 08:32:20,22,22,0,没意思
118539,2065,邱亚君,2019-10-28 08:39:42,27,28,1,看到了评价篮里的文字“听老师上课有什么体验”.......我瞬间感觉自己身处天台并且在往下掉落的过程中了。自以为是的讲ppt哈哈哈哈真的气笑了。不怀疑老师的学术水平。但是做人做老师还是跟别的优秀的老师学学吧。还看不起学生？要是真的有水平我们也怕是真的见不到您
119493,2065,邱亚君,2019-11-13 05:32:19,25,25,0,这老师也是相当杂耍了 还看不起学生
126409,2065,邱亚君,2020-09-25 05:57:41,4,4,0,杂耍啊
126479,2065,邱亚君,2020-09-28 04:02:30,0,0,0,猴塞雷
144274,2065,邱亚君,2021-12-21 03:48:41,2,2,0,好家伙，课上有打游戏的，逛淘宝的，看视频的，谈恋爱的，不到课的。\n\n我自己窝角落里听教资的网课你管，一张死ma脸给谁看，一教室妖魔鬼怪不管，管一个自己学习的人？57分美名其曰拉不动了？你课上哪怕有一点有用的东西我也不至于这样。\n\n顶着考教资的压力给你做课堂展示，sb组员啥都没做都能合格，我出全组50%的力不合格。。\n\n给一定要上这fw老师的学弟学妹们一个建议：多讨好她假装很认真很崇拜的样子就有高分！\n\n呵，这大学算是被这些老师搞臭了，大家自己学东西拼自己的前程吧。
159513,2065,邱亚君,2022-07-30 01:30:43,0,0,0,笑面虎，打哈哈\n\n讲课还行
204391,2065,邱亚君,2024-11-25 14:58:48,0,0,0,好好好
6882,2067,梅伟惠,2015-07-28 11:28:41,14,18,4,挺好的老师
7183,2067,梅伟惠,2015-09-10 05:12:39,2,8,6,很好的老师，人很nice
11603,2067,梅伟惠,2015-12-07 10:41:17,9,12,3,超好超好的老师！！！
33043,2067,梅伟惠,2016-09-11 02:32:43,-3,2,5,人不错，但是课讲的没水平
67888,2067,梅伟惠,2018-01-22 08:50:29,21,36,15,建议你把创业基础的制度改一改，你别让徐小洲老师那么猖狂。
69632,2067,梅伟惠,2018-01-25 06:03:05,11,13,2,老师人超好，发邮件会很耐心回复，讲课也内容丰富有干货，国际教育改革与发展不难的，听课是享受
94648,2067,梅伟惠,2019-01-17 14:12:02,0,5,5,老师真的上课很多干货，认真听会有很大的收获!平时对同学们也很好，会认真回复邮件和课后问题。虽然有时候上课会有一些平，但是如果感兴趣，并且认真听会有收获!
94664,2067,梅伟惠,2019-01-17 15:25:15,1,4,3,差，上课没重点。
107606,2067,梅伟惠,2019-05-07 13:22:16,1,3,2,出分太慢了诶
107815,2067,梅伟惠,2019-05-10 02:42:04,6,11,5,说一下创业启程，梅老师出分是慢了点，因为我们班人最多啊，将近200个人。但是梅老师和助教都非常nice，会及时回答群里的问题，通知很及时，解答很耐心。创业基础这么改确实好多了，随机性没那么大，仔细复习都可以拿好成绩，但是五级制给分真的坑，最高也才4.5，唉?
109113,2067,梅伟惠,2019-06-08 13:20:02,-2,1,3,人很好，就是课不好
117356,2067,梅伟惠,2019-09-23 09:24:06,1,2,1,老师和助教小姐姐都很好，推荐
118914,2067,梅伟惠,2019-11-07 15:25:14,1,3,2,这老师怕不是神龙
118921,2067,梅伟惠,2019-11-08 00:12:52,0,9,9,我还能说什么？今年创业启程连人都见不到，群里助教消息不回，期末丢给你一本教材自己背书，什么东西都没有。平时上课就是去听别人教授的视频，期末考试让我们自生自灭？交完观后感群里助教和老师一句话不说，问题也不解答？我考nm呢。
118991,2067,梅伟惠,2019-11-09 04:06:41,1,2,1,老师和助教小姐姐很耐心
120406,2067,梅伟惠,2019-12-04 00:28:00,1,2,1,好好学，绩点是有的
120407,2067,梅伟惠,2019-12-04 00:28:00,0,1,1,好好学，绩点是有的
120408,2067,梅伟惠,2019-12-04 00:43:57,3,7,4,创业启程 虽然不正态 但是这门课根本学不到有用的东西 临考半个月才发给厚厚一本书考200页复习压力很大 不勾重点不答疑 上课就看根本看不清听不见的视频 网课也很弱智 谁选谁后悔
121434,2067,梅伟惠,2019-12-16 06:43:55,0,0,0,这课学不到啥
121840,2067,梅伟惠,2020-01-22 09:17:55,0,3,3,创业启程，纯网课，老师完全不管，不答疑也不划重点，感觉我们跟孤儿一样。自学量很大，不过总归比职规事情少一点点，一定认真自学，不然分很低
125400,2067,梅伟惠,2020-09-08 06:28:00,1,1,0,别选创业启程
145506,2067,梅伟惠,2021-12-30 04:49:02,9,10,1,不知道有没有小组作业抬了一手\n\n只在创业计划书里负责了一部分最后喜提4.8\n\n除了mooc和这1k字就没事了\n\n老师我爱你！！\n\n组长组员我爱你们！！
145538,2067,梅伟惠,2021-12-30 07:48:19,8,8,0,创业基础压力不大，有些课程内容也很有趣，老师讲解也很认真，给分也不错，最推荐的创新创业课程没有之一！
150086,2067,梅伟惠,2022-01-19 02:20:27,4,6,2,老师讲的很好的，听课听得很舒服。课上有些小游戏还蛮有意思的\n\n感谢我的小组，轻松地就可以完成学期的任务。\n\nmooc也比较轻松就可以完成，这学期没有期末考
151153,2067,梅伟惠,2022-02-23 12:53:58,10,10,0,创业基础，老师上课内容稍微老套枯燥了（虽然偶尔有有趣的地方），但是作业很少，没有期末考，给分很好
162010,2067,梅伟惠,2022-11-16 03:06:44,2,3,1,莫名低分
162018,2067,梅伟惠,2022-11-16 04:08:58,4,4,0,创业基础 刚出分4.5不知道算怎样\n\n不点名线下从来不听线上网课刷视频刷互动分\n\n但是期末作业是个人的大学生创业意愿访谈分析2000字再加小组创业计划书6000字\n\n小组作业真的是…负责其中分part撰写再加上最后的pre和整合真的是…我以为我能更高一点的/笑哭\n\n但可能是那个访谈分析我写得比较水吧\n\n老师人还是很nice的毕竟我从不听课
162191,2067,梅伟惠,2022-11-17 12:42:47,3,4,1,事少分多，没有期末考试，只有一个个人作业和小组作业还有智慧树课程，老师人很好
167249,2067,梅伟惠,2023-01-15 08:28:39,0,1,1,国际教育改革与发展，事少分高
167254,2067,梅伟惠,2023-01-15 08:51:15,0,1,1,国际教育改革与发展，点名全到，一次小组展示和一篇论文，上课没有发言，最后给分3.6，真的不是事少分高好吧。。。
169645,2067,梅伟惠,2023-02-27 08:54:29,1,2,1,可冲创业基础，给分好，事少
169986,2067,梅伟惠,2023-03-01 02:01:14,2,4,2,想学到东西的建议不要来，想要卷的也不要来，课上基本没有人听，完全是照本宣科，任务也不讲，完全是自学，不如去隔壁职规
183485,2067,梅伟惠,2023-11-26 15:33:27,2,2,0,很好的老师，事少分高，助教姐姐也超级好
187513,2067,梅伟惠,2024-01-16 12:18:51,0,0,0,至少讲课还算让人舒服
202781,2067,梅伟惠,2024-11-14 10:13:09,1,1,0,事少分高超级好的老师，快冲
202796,2067,梅伟惠,2024-11-14 12:08:00,0,0,0,很好的老师 冲冲冲
81,2200,何珊云,2015-03-14 15:42:39,30,36,6,且听且珍惜
7610,2200,何珊云,2015-09-15 06:32:24,2,4,2,拉拉拉拉啦
9124,2200,何珊云,2015-10-13 13:45:48,15,17,2,不错的老师！
9881,2200,何珊云,2015-11-11 16:51:32,7,9,2,老师今天发烧了，带着病来上课真的很不容易，希望大家都更用功一点吧，青椒不容易。
11686,2200,何珊云,2015-12-11 11:53:25,6,6,0,不错的老师
12882,2200,何珊云,2015-12-24 07:19:10,6,6,0,好老师，不死板
13078,2200,何珊云,2015-12-24 19:14:57,11,13,2,非常非常棒 上过最有意义的一门通识 改变了我对教育的看法 而且给分很高
16100,2200,何珊云,2016-01-17 07:54:15,3,3,0,推荐她哦
17493,2200,何珊云,2016-01-20 09:57:57,6,6,0,超爱老师很温柔又美腻～
18017,2200,何珊云,2016-01-21 06:09:52,5,5,0,很温柔 循循善诱 讲课很舒服
23603,2200,何珊云,2018-05-16 03:30:47,-30,6,36,没新意
24008,2200,何珊云,2016-04-25 06:41:22,3,4,1,老师人超好年轻又漂亮   上课很有趣
25263,2200,何珊云,2016-05-09 05:35:47,1,2,1,棒棒棒
29906,2200,何珊云,2016-06-30 13:25:20,4,6,2,给分挺好的，上课也比较轻松，做个性还挺适合~
31186,2200,何珊云,2016-07-03 11:01:26,4,7,3,很有魅力的老师啊，超有气质，看着就觉得赏心悦目。课程内容蛮有趣的，两次小作业，一次课堂展示，期末开卷，题目比较灵活。对学生基本持鼓励态度，有不足也会指出，处着很舒心。
34398,2200,何珊云,2018-01-25 00:11:02,6,6,0,温柔美腻啊
36394,2200,何珊云,2016-11-13 01:20:36,9,9,0,珊云女神！特别有情怀特别温柔的老师 喜欢她 笔芯！
39832,2200,何珊云,2016-12-28 02:39:09,0,3,3,很棒的老师～
40736,2200,何珊云,2017-01-05 07:38:32,3,4,1,很温柔～
43629,2200,何珊云,2017-01-16 15:56:40,6,6,0,不水，展示很有价值
43633,2200,何珊云,2017-01-16 16:08:17,4,4,0,选选选。相信我，平常再怎么善良幽默博学负责的老师能给予你的温暖，都不及你在饱受创伤的期末看到这个绩点的一瞬间感受到的大爱。（来自热泪盈眶的我
43683,2200,何珊云,2017-01-16 23:09:01,6,6,0,课堂氛围很好
43762,2200,何珊云,2017-01-17 02:37:55,5,6,1,事少课好给分特别高！老师非常渊博，又美又有气质，三观也正，很有收获\n\n
44579,2200,何珊云,2017-01-18 03:30:00,1,3,2,女神啊！
45990,2200,何珊云,2017-01-20 10:47:55,7,7,0,何老师是一个很有思想的老师，比较注重过程表现，喜欢请同学发表自己的看法，无关对错，而是要有自己的思想，给分也蛮好的，出分好快~推荐~（不过老师接下来要去哥伦比亚大学了2333）
65195,2200,何珊云,2017-12-30 13:42:21,3,3,0,女神就两个字，我只说一次
77052,2200,何珊云,2018-05-01 06:43:22,3,4,1,老师女神!第一节课我还以为那是助教哈哈哈!\n\n老师上课会一直点名回答问题，但是经过讨论真的会对每个问题有深刻的思考的。然后就是考试超简单，就是上课讨论的题目（所以不用怎么复习哈哈哈）\n\n最后就是每个人都要做pre，但是老师要求有点高，所以要好好准备!但是做pre真的收获很大!\n\n最后给分真的hin好啊
77069,2200,何珊云,2018-05-01 06:02:14,1,2,1,老师很女神，并且注重学生的思维框架，因为期末考主要是自己发表评论，所以平时上课会很轻松，不用背概念这些，绩点也很不错哦
78625,2200,何珊云,2018-05-14 03:13:36,3,3,0,女神老师！！
93974,2200,何珊云,2019-01-14 14:06:25,3,3,0,何老师真的超棒，温柔美腻，只是对作业要求会有点高。
101651,2200,何珊云,2019-01-28 20:47:50,3,3,0,非常赞的老师，对学生特别认真负责！
103141,2200,何珊云,2019-02-26 06:46:19,0,2,2,发挥好的时候使劲表扬，发挥不好的时候也会鼓励，期末论文还会给出修改意见。老师本人也很有气质。
105721,2200,何珊云,2019-04-19 01:52:08,1,2,1,不太需要点名因为老师记得住每个人hhhh，人超好超美丽的！
106272,2200,何珊云,2019-04-26 04:59:08,4,4,0,老师也太温柔了吧！虽然不点名，但是老师记性很好，谁哪次没去老师一眼就知道。一次展示一次期末考，期末考不用怎么复习，答题时注意表现思考的框架哦。pre老师特别重视，要认真对待！总之，要让老师看到你的态度，你对话题的认真思考！成绩绝对不会差
106304,2200,何珊云,2019-04-27 11:30:06,7,11,4,从不点名，但记得住每个人。还不错的老师，讲课还可以，不过个人觉得不如孙元涛老师，说女神有点夸张。pre很重要！
106490,2200,何珊云,2019-04-28 01:43:45,8,8,0,老师很知性很温柔，课堂是思辩的样子啊~\n\n\n\n手动分割线~19.4.28\n\n前几天出绩点了，老师的给分还是不错的，只是我略菜也不喜欢刷脸吧，毕竟这是一节讨论占比很大的课~? \n\n还是要说几句，教育学专业，尤其是大一的同学这堂课一定要堂堂去而且认真听，虽然老师不会怎么点你回答问题...\n\n这堂课虽然没有很多原理性的教育知识，但是老师普及了很多教育在各个领域的前沿结合和应用，有意无意地引导很多磕盐的原则。对就业和磕盐的帮助都很大~\n\n
107783,2200,何珊云,2019-05-09 14:15:42,3,5,2,创业启程，老师全程就第一节课和考试见到过，但是人很温柔善良，给分巨好
107785,2200,何珊云,2019-05-09 14:19:42,7,8,1,告诉这个pljj我爱她，人超超超温柔，群里说话也很可爱，创业启程，只见了一次，印象深刻，一直在微笑，真的让人很舒服的一个老师！
107811,2200,何珊云,2019-05-10 02:29:12,8,8,0,虽然创业启程低的离谱(主要还是没有好好背教材)，但好喜欢老师的笑脸啊(/ω＼)
107875,2200,何珊云,2019-05-11 00:17:49,4,4,0,老师人很好！
108069,2200,何珊云,2019-05-14 03:27:21,2,3,1,就见了一面的老师，笑起来很温柔，可恶的创业启程就让我只能见一面。（偷偷说创业启程只要背背书就能上4哟）。点赞老师！hhh
111114,2200,何珊云,2019-06-30 01:06:10,4,4,0,善解人意，温柔美丽。
119496,2200,何珊云,2019-11-13 05:40:03,2,3,1,赞赞赞?
120663,2200,何珊云,2020-01-14 22:33:22,7,7,0,节节课点名 但是事儿少，老师长得漂亮 给分还挺不错
120675,2200,何珊云,2020-01-15 02:39:46,2,3,1,上了一学期的通识课 基本都会点名，抽人回答问题，但是老师真的很温柔，课堂上能学到很多的，最后就一篇论文。
120823,2200,何珊云,2020-01-17 17:05:04,7,7,0,听老师的课太美好了吧
130500,2200,何珊云,2021-01-23 05:53:07,2,4,2,不点名，有时签到。人好，讲课有意思，给分也好，强推
132563,2200,何珊云,2021-02-02 09:26:28,5,5,0,老师的气质太美了！课也超赞！超喜欢女神何老师！
141927,2200,何珊云,2021-11-01 05:13:15,10,10,0,老师真的是又美又漂亮又可爱又和蔼可亲，很尊重学生，永远微笑待人！有这样的导师真的超级幸福啊啊啊啊！
145632,2200,何珊云,2021-12-31 00:49:25,-16,11,27,快跑\n\n从来没有这么讨厌一个老师\n\n感觉课上很多时候是提出问题，不断提出问题，却没有什么解决的方法，一开始感觉有意思，但听久了就会感到一种无力感。在课上感受到社会科学的无用。\n\n老师每节课都点名，甚至课上不断抽人提问，气氛比较压抑\n\n感觉说什么都会被批评
146066,2200,何珊云,2022-01-05 10:08:04,14,16,2,给老师十分吧。老师很好，对这门课态度非常认真，感觉上课有在努力引导同学们的思考。没有考试，一篇论文一个小组pre再回复两个教育主题的帖子就是全部任务，pre被大佬带飞了，帖子和论文有认真写，最后绩点也还不错。不过老师对这门通识课的态度真的非常认真，水课是不太行的，每节课必签到必叫人回答问题，而且很重视回答的质量～
146147,2200,何珊云,2022-01-05 14:47:29,8,12,4,看起来，温柔却无情
146820,2200,何珊云,2022-01-07 13:52:49,-2,8,10,必签到+抽人回答问题，写着作业被叫起来回答就会很尴尬。课程的趣味程度一般，一节课会有一两个点很有价值但多数时候还是没有写普物作业吸引我（个人观点），想了解教育学的同学可能找个相关通核体验会更好吧。因为事情少+自己认真完成后绩点蛮高所以还是来给了高分
150672,2200,何珊云,2022-02-11 10:39:23,9,14,5,救命啊老师会捆绑式给分，最后被绩杀的不要不要的真的........这门课给我留下了深深的阴影，让我都不敢随便选通识课了，老师评分高真的不意味着给分好，总有被正态的可怜虫。
186272,2200,何珊云,2024-01-10 09:43:19,4,5,1,老师人很好\n\n但是给分其实没有那么高，可能是我不努力，也可能只是幸存者偏差\n\n不过还是要给老师打10分
186280,2200,何珊云,2024-01-10 10:09:09,-3,3,6,大赞何珊云老师和她的当代社会中的教育课！一学期只有一篇个人论文和一个小组展示，老师的声音特别温柔，专业知识过硬，对当代社会中的教育问题分析的十分透彻，上课喜欢让同学分享观点，你答不出来她也会温柔地让你坐下。课堂轻松，任务轻松，最后拿到4.5，给分也很好，快冲！
186375,2200,何珊云,2024-01-10 16:30:54,3,3,0,老师还不错，但给分好像也不是像说的那么好（也可能是我太菜了），每节课都会点名，感觉展示占比还是挺大的，如果展示卷起来应该会好很多
186386,2200,何珊云,2024-01-11 01:56:37,5,7,2,小组捆绑式给分。上课内容有点点浅显，毕竟是通识课。老师是很好的老师。只能说上课的内容和最后分数和我的预期有差距吧。
186410,2200,何珊云,2024-01-11 03:47:20,0,3,3,卡绩！！事多
186453,2200,何珊云,2024-01-11 07:18:45,0,0,0,好老师，很温柔。
186846,2200,何珊云,2024-01-13 08:49:44,7,8,1,老师对教育教学很有个人的见解，课堂上也经常会叫同学起来回答问题，引导同学理清思路。很用心在准备每一节课，也很温柔地对待同学。喜欢老师！
187521,2200,何珊云,2024-01-16 12:27:47,0,1,1,平心而论老师上课很认真，人也很温柔，是很优秀的老师。只不过这个给分有点求是
189845,2200,何珊云,2024-01-31 01:05:38,1,2,1,i人地狱，给分也没有那么好
201843,2200,何珊云,2024-11-07 01:55:43,2,2,0,老师会点名 整个短学期课程比较轻松，事也不多，给分也还可以，不后悔选你
201852,2200,何珊云,2024-11-07 02:50:34,1,1,0,老师超温柔，超级好，超级美，不想听课也不会强迫，人到就行，回答问题也很尊重你的想法，事情也不多，是真的在引导同学去思考，给分也超好，呜呜爱死了
202001,2200,何珊云,2024-11-08 04:25:38,0,1,1,。。。
202064,2200,何珊云,2024-11-09 02:11:20,1,1,0,很好的一个老师，课程内容其实比想象的有意思，给分给的很好
202192,2200,何珊云,2024-11-10 15:08:12,0,0,0,给分可以！老师人也挺不错的很有耐心
203181,2200,何珊云,2024-11-17 16:32:57,0,0,0,老师非常和蔼可亲！有什么问题都会回复你还会主动帮你找问题，我是通识课的，然后绩点也还不错 我水水的拿了4.2。上课内容仔细听的话实际会有很大的收获，特别是思考问题的角度
203720,2200,何珊云,2024-11-20 23:11:22,2,2,0,老师超级好的（・∀・）
714,2296,司琦,2019-01-24 16:43:32,2,15,13,司老师超级好老师！虽然课不是我感兴趣的，但是人很好，有耐心，热心！感恩。
5676,2296,司琦,2015-07-09 06:22:28,-2,5,7,亲切\n\n
5800,2296,司琦,2015-07-09 12:02:53,-4,4,8,司老师是一个很棒的老师
7824,2296,司琦,2015-09-15 14:10:16,-5,6,11,老师超级好 拿到了第一个满绩
10034,2296,司琦,2015-11-14 14:25:23,6,11,5,没意思
11784,2296,司琦,2015-12-15 08:43:43,-5,4,9,司老师人非常棒
22073,2296,司琦,2017-12-08 16:45:33,10,17,7,无聊啰嗦，特别把自己当回事。
23636,2296,司琦,2016-04-11 08:47:01,12,16,4,三个字“不科学”:\n\n似乎不太了解一些事情，经常会讲出有悖底下学生认知的事。\n\n讲数据也不太顾单位，ppt漏洞比较多。
24366,2296,司琦,2016-04-30 02:45:49,-5,3,8,感觉没学到什么干货，但是老师人挺好的，和蔼可亲。平时会有三到四次英文材料阅读，然后有quiz，期末是一篇论文。
24939,2296,司琦,2016-05-04 11:18:10,6,14,8,上课废话贼多，学了不知道讲什么东西，妈的，作业这么多，给分还低，我每节课坐前排认真听，就是不发言但是估计在老师眼里和坐后面水手机的差不多，真心不知道为什么要开这棵。。。
27365,2296,司琦,2016-06-25 08:22:56,-3,1,4,给分挺好的 按照她的要求做分就不会低
28483,2296,司琦,2016-06-28 09:19:21,-2,0,2,事情有点多，身为通识居然每周还有小测，但是给分不错
32123,2296,司琦,2016-07-05 16:09:49,-2,2,4,课后跟老师交流一些想法老师都会耐心思考并回答，蛮和蔼的，需要读英文文献，隔周会有小测，按要求做了给分就不错。
63608,2296,司琦,2017-12-08 16:47:57,-4,2,6,非常好的一个老师 特别有耐心 平时有什么问题也会耐心的讲解
75867,2296,司琦,2018-03-20 08:26:37,15,17,2,事情可能比专业课还多，喜欢用绩点威胁学生
75955,2296,司琦,2018-03-22 23:59:17,7,7,0,小测真可怕……
76690,2296,司琦,2018-04-18 10:29:00,20,22,2,评价她的专业课——非常地以自我为中心……作为学生必须服从她认可她，不服从的话有可能当场跟你怼起来......上课总爱说自己什么论文发表了什么论文发表了之类的....显示自己的学术成就……曾经拿得不到学位威胁过学生......就整天嫌弃我们体育系的同学不知道在干嘛.....如果想要在她课上安全地活下去，就只要乖一点服从她就行....
78483,2296,司琦,2018-05-12 09:09:38,-5,0,5,老师人很好 给分也很棒 认真按老师说得学绝对能有所收获
78545,2296,司琦,2019-06-02 12:56:29,23,27,4,我非常非常非常认真地写了论文，然而最后绩点奇低。可能是老师看我不顺眼吧。
78554,2296,司琦,2018-05-13 02:32:54,6,6,0,有点无聊。
78556,2296,司琦,2018-05-13 03:00:07,7,7,0,事情多，给分低，当然我比较菜?
78602,2296,司琦,2018-05-13 16:33:32,4,8,4,健康行为与健康心理。老师人挺好，课也很有用，学到了挺多。事情很多，quiz，海报，论文认真做了但最后79卡绩3.3很绝望，可能还是我太垃圾了吧，反正k类通识修满了，我再也不要修了，真的是伤到了【手黄再】
78778,2296,司琦,2018-05-15 06:56:52,-2,2,4,老师很热心的人。这门课不水啦～参考呀 有测验（应该读英语的材料）还有期末论文写3000字 这要求比较困难。。。
79870,2296,司琦,2018-06-14 14:22:33,18,19,1,每节课必花七八分钟点名，而且会选择课前课中课后三个时段来进行点名，真是厉害啊。特别喜欢那种活泼开朗积极的学生，所以喜欢和老师互动就选吧，比较容易拿高绩点。作业有英语文献阅读加小测，画一张海报，外加一篇论文。本人每节课必到，没回答问题，个人觉得小测、海报加论文都还不错。结果却不尽如意，可能她就喜欢积极的学生吧。说真的，性格腼腆或天生反骨的同学还是别选了，相看两相厌。走在路上喊老师好也不会理你的。
81733,2296,司琦,2018-07-06 04:24:26,7,8,1,emmm坐后排的同学会常常被diss\n\n
91680,2296,司琦,2018-12-18 01:30:21,8,10,2,自我表达欲很强的老师，上过两门课，发现事例列举有很多重复，同一门课也常有重复的内容， 有点迷。事情多，作业有，每节课点名，给分一般般。但是态度很认真的老师。
99401,2296,司琦,2019-01-24 16:44:21,10,12,2,后悔\n\n师德欠缺
102985,2296,司琦,2019-02-25 08:05:37,12,12,0,每节课都要点名，第一映像超级差\n\n要是没有对这门课很感兴趣，那就不要选吧
104622,2296,司琦,2019-04-29 01:58:49,11,12,1,论文写的超级多，但连80都不给上，很不好的老师，看不惯，对不起
104644,2296,司琦,2019-03-26 01:13:54,30,30,0,没出分，客观讲讲锻炼心理学这门课。\n\n号称是交叉学科，给我的感觉就是体育心理四不像。本人上课认真做笔记，感觉还是学不到任何东西。\n\n司琦说：我那么认真，不想让这节课被评为水课。于是课后P事特多（相比于其他通识）。\n\n但我觉得这就是节水课。因为哪怕P事特多，我也学不到东西。感觉整节课都在被灌鸡汤，锻炼对身体好，对心理好云云，然后纠结一些无关紧要的概念。\n\n综上，学不到东西，P事还多，唯一可能的收获估计就是学分而已了。
105221,2296,司琦,2019-06-08 06:31:36,-22,3,25,人好，事少，给分高
106669,2296,司琦,2019-04-29 03:48:09,5,6,1,着实被出分伤到了...
106670,2296,司琦,2019-04-29 01:51:58,4,5,1,好难受啊，认真做作业了，最后只有2.7。哭了\n\n
106675,2296,司琦,2019-04-29 02:18:15,12,14,2,我真的不知道为什么，我每节课都坐在第一排，论文写了6000字（超过规定3000），最后绩点却只有3.6，严重卡绩，我真的气死了。
106678,2296,司琦,2019-04-29 02:30:31,1,4,3,满足了……虽然拉低了均?
106680,2296,司琦,2019-04-29 02:38:00,5,6,1,真的伤到我了，有史以来最低的一门通识课，每次都到，小测基本都对，论文写得也挺认真的居然就这么点分，以后也不会推荐别人选这门课了，唉。
106683,2296,司琦,2019-04-29 02:42:06,-3,6,9,群里说着谢谢老师，查老师里骂人？世一大的同学们啊……
107904,2296,司琦,2019-05-11 04:45:50,10,11,1,哎喜欢吹牛，没重点，啥也没学会。关键是喜欢吹一些自己不懂的东西，显得自己很牛逼
112940,2296,司琦,2019-07-05 13:42:55,1,2,1,令人叹气
115590,2296,司琦,2019-08-06 04:56:27,1,1,0,。。。。
119386,2296,司琦,2019-11-12 13:48:32,-5,2,7,人超好
144518,2296,司琦,2021-12-22 04:34:25,3,3,0,很傲，自以为是，莫名其妙的优越感
202389,2296,司琦,2024-11-12 09:25:36,6,6,0,怎么感觉说话阴阳怪气的…
205764,2296,司琦,2024-12-12 03:09:39,1,1,0,特别爱cue上课玩手机看电脑的
211789,2296,司琦,2025-01-12 12:25:33,0,1,1,傻逼老师
211790,2296,司琦,2025-01-12 12:26:01,0,0,0,实在学到0，全是pua
215616,2296,司琦,2025-03-03 02:50:13,3,3,0,事儿多爱点名讲的内容没什么意义还要求我们不能看电脑要听她讲时不时阴阳怪气，无语了……给分也很差，感觉我们组做得已经很好了。只能说，去讨好她可能会分高
215745,2296,司琦,2025-03-05 05:04:37,5,6,1,堂堂点名，压力助教并且卡绩🙄🙄🙄上课就喜欢唧唧歪歪酸玩手机和看电脑的人
62680,2363,李艳,2017-11-26 11:01:35,1,1,0,让我过得舒坦一点吧~
66647,2363,李艳,2018-01-18 03:01:54,0,1,1,老师很负责很认真 就是语速有点快 但是在反应之后明显有改进了 考试重点也很直接告诉我们 复习起来比较轻松
97280,2363,李艳,2019-01-22 07:46:25,0,0,0,是个很温柔很有责任心的老师
118236,2363,李艳,2019-10-23 11:58:56,0,1,1,温柔的老师！厉害的女教授！！本硕博背景三跨，真的厉害?
191884,2363,李艳,2024-05-03 12:12:05,0,0,0,很难平ex
192438,2363,李艳,2024-05-20 02:51:14,1,1,0,不明白为什么最后绩点那么低……
7998,2512,刘徽,2015-09-16 12:03:04,2,3,1,还好吧
9121,2512,刘徽,2015-10-13 13:37:41,1,2,1,有点跳
11688,2512,刘徽,2015-12-11 11:55:34,4,5,1,对学生好
76631,2512,刘徽,2018-04-17 00:42:55,2,2,0,理论实践相结合。人也好。
90285,2512,刘徽,2018-11-23 03:10:25,0,1,1,可以说是很想念刘老师的课了
102705,2512,刘徽,2019-02-21 14:11:37,0,1,1,解决非良构问题
102796,2512,刘徽,2019-02-23 06:50:56,1,1,0,立足实际，时常有一些“小段子”可以引发学生思考
110075,2512,刘徽,2019-06-22 07:26:16,0,0,0,很喜欢的老师
114967,2512,刘徽,2019-07-13 07:12:04,0,0,0,非常好 人美心善
116279,2512,刘徽,2019-09-07 09:01:19,0,0,0,如沐春风
118096,2512,刘徽,2019-10-21 02:18:35,1,1,0,很高了
129015,2512,刘徽,2020-12-28 12:25:53,3,5,2,讲课讲得一般，听着有点犯困
136674,2512,刘徽,2021-06-23 01:22:26,4,4,0,在本学期本专业其他几名有开课任务的老师衬托下，我觉得刘老师是天使...无论给分如何
216541,2512,刘徽,2025-03-18 06:39:19,0,0,0,好好好
79454,2581,黎学平,2018-06-06 00:13:23,5,5,0,呵呵哒
79855,2581,黎学平,2018-06-14 10:54:33,3,4,1,很不好
90663,2581,黎学平,2018-11-25 03:26:19,-4,2,6,事少，不点名。
105463,2581,黎学平,2019-04-15 01:22:46,3,3,0,不知道说什么
126311,2581,黎学平,2020-09-22 07:06:03,0,0,0,读书讲课.......
142607,2581,黎学平,2021-11-14 11:50:00,1,1,0,我觉得老师讲的蛮好的，很多知识点都帮我们扩充了，主要还是看个人感觉吧
161210,2581,黎学平,2022-10-31 23:58:23,0,0,0,老师很善良，人很好，课比较水，喜欢水课的话强烈推荐，很舒服。不过每节课必点名
174322,2581,黎学平,2023-06-09 11:27:44,0,0,0,还行但是我不喜欢
177434,2581,黎学平,2023-07-03 09:05:18,2,2,0,每节课都纸质点名，讲课确实一般但人挺好的。最后考试是判断单选多选填空和几道主观题，客观闭卷，主观开卷，客观题目考的很细很难，但就给分来看老师真的大大地捞了。
187906,2581,黎学平,2024-01-17 17:50:51,2,2,0,是个很认真很善良的老师
23997,2608,林楠,2016-04-25 01:16:51,1,1,0,挺好的啊～
33266,2608,林楠,2016-09-17 07:39:41,1,1,0,带我们上短学期课程，老师温柔美丽善良，人很好，给分也很好?
43776,2608,林楠,2017-01-17 02:58:14,1,1,0,这个老师不要太优秀  人漂亮又可爱  上课很亲近  听她课都会很认真\n\n
50060,2608,林楠,2017-04-29 04:31:58,1,1,0,老师超可爱 给分也超好
78956,2608,林楠,2018-05-17 13:39:35,1,1,0,非常好的女神老师！超级耐心，很为学生着想，上课会用很多方式教给学生知识！
79100,2608,林楠,2018-05-23 02:39:03,0,1,1,会签到，但是老师人特别好！又美又温柔！日本那边留学回来，在课堂上会介绍日本比较好的教育方式方法，上课很有条理，理论化得很好！给分也贼棒！喜欢！
29189,2638,刘华,2016-06-29 11:06:29,3,3,0,英文差 还喜欢读英语 自创单词 呵呵
31201,2638,刘华,2016-07-03 11:12:20,2,2,0,上课不能认真听，听了会很生气
32384,2638,刘华,2016-07-06 11:25:25,2,2,0,分分钟听不下去
32472,2638,刘华,2016-07-07 04:18:51,1,1,0,不能听，有毒
12699,2729,屠莉娅,2015-12-24 02:11:16,-1,5,6,讲的不是特别好，水平比较有限。
14313,2729,屠莉娅,2016-01-06 07:52:21,11,15,4,人挺好，教育经济学讲课算不上特别出色吧，研究和情怀满满，适应老师的腔调要这段时间
14876,2729,屠莉娅,2016-01-10 13:35:24,1,5,4,教经，认真听，会有很多收获。
21723,2729,屠莉娅,2016-03-01 01:52:10,7,9,2,老师上课很年轻很有活力，亲和力十足，心态也很接近我们 嘻嘻，乐于分享自己的经历，比如和课程相关的书本电影论文等等，认真听可以学到很多东西
55527,2729,屠莉娅,2017-07-01 23:30:14,3,5,2,给你宽松自由的氛围和不错的绩点，飞吧，
69485,2729,屠莉娅,2018-01-25 00:37:31,1,3,2,教育经济学事多分好
69648,2729,屠莉娅,2018-01-25 06:36:26,1,3,2,教育经济学事多给分真的好
70115,2729,屠莉娅,2018-01-26 06:33:21,2,4,2,老师任务是比较多，但只要完成了，给分真的相当好啊!因为她的分数都是按块给的，所以失分在哪里都知道，而且一般都满昏!
71363,2729,屠莉娅,2018-01-28 10:55:17,9,11,2,给分太好了吧
79324,2729,屠莉娅,2018-05-31 03:28:07,7,8,1,莉娅hhhh请问老师会唱Oasis的歌吗
89875,2729,屠莉娅,2018-11-28 07:09:26,-10,3,13,这个屌丝，上课声音敢不敢再大一点，内容一般，照读ppt，你说能学到什么？
91215,2729,屠莉娅,2018-12-03 12:04:06,1,2,1,可能比较注重学生的观点交流吧...但无论是讲课还是同学展示的进度都应该好好把控下吧 感觉有些给分制度设置也不太合理
99172,2729,屠莉娅,2019-01-24 11:05:39,6,11,5,事情真的多，给分配不上付出的精力：)
99204,2729,屠莉娅,2019-01-24 11:47:11,-2,3,5,上的屠老师的教育经济学，事情的确有点多。但是给分真的不错的!上课内容很充实，老师也很喜欢发散性思维地讲解，认真听收获很大，写的论文和期末做的调研自己收获也是很大的!虽然最后被卡绩点，但是还是给屠老师打call!如果想选择个性的比较有空可以考虑，否则可能有点小忙嘻嘻。
99220,2729,屠莉娅,2019-01-24 12:32:55,3,7,4,请问这个绩点是真实的么………………外专业来选，短学期事多到爆炸，文科思维努力去适应社科思维，都很努力做了……结果……不过老师很不错……只是我以为会调分的，没想到是一项一项完全死扣……上面写的4.38哪来的……？
99448,2729,屠莉娅,2019-01-24 23:49:08,2,6,4,这个老师是认真的吗？事多到不行而且最后小组研讨成绩明明已经打过分了过了两天还手动降低两分？？我真的无语 事情这么多给分这么差合理吗？？
100999,2729,屠莉娅,2019-01-27 08:53:54,0,3,3,认真做了所有的作业 对事情比较多的专业课来说真的感觉给分一般啊 以前那么多说给分好的 打扰了 是我太菜
109320,2729,屠莉娅,2019-06-21 13:59:12,0,0,0,
119347,2729,屠莉娅,2019-11-12 07:49:45,0,2,2,事情太多 上课迷惑 我佛了
119390,2729,屠莉娅,2019-11-12 14:23:56,5,9,4,主持人：下面请支持给学生减轻负担的站在我左手边，请反对给学生减轻负担的站在我右手边。一半的人站到了左边，一半的人站到了右边，只有一个人还留在中间。“我反对给同学增加负担，但是我会在课上给同学布置很多很多的任务。”“啊，屠莉亚老师，请你站到讲台上来！”
119827,2729,屠莉娅,2019-11-16 03:19:51,6,6,0,前面的苏联笑话，会说话就多说点\n\n挂个? \n\n顺便五年粥粉第一次看到老师名字的时候也有点激动，略略略
120201,2729,屠莉娅,2019-11-23 14:57:15,5,5,0,天啊屠老师讲真，有点点可爱，上她的课真的干货很多
142312,2729,屠莉娅,2021-11-10 05:39:36,2,2,0,老师超级好的，很有实力
143811,2729,屠莉娅,2021-12-07 09:01:41,0,2,2,事情真的有亿点点多...能不能学到干货也算见仁见智，但是比起这个专业别的大多数专业课程确实比较“充实”，以及，老师现在已经不开教育经济学了
154160,2729,屠莉娅,2022-05-25 02:20:36,5,5,0,屠老师人挺亲切的，从她的讲课方面能感受到确实专业，我们不知不解的老师都能一针见血的给予解答
157895,2729,屠莉娅,2022-06-25 10:46:10,3,3,0,老师的课程内容很新，看得出来不是年年重复着讲的内容，有更新有深度。给分也很好呀！
170776,2729,屠莉娅,2023-03-09 11:52:33,1,1,0,能感受到屠老师的教育情怀
201080,2729,屠莉娅,2024-10-28 08:17:41,0,0,0,屠老师人很nice
64192,2759,王进,2017-12-21 09:24:14,0,0,0,哈哈哈
86669,2759,王进,2018-09-18 02:17:41,0,0,0,。。。
124775,2902,杨丹,2020-07-09 02:21:10,5,11,6,能不远就别选。。两个课 全班同学都无语他
144634,2902,杨丹,2021-12-23 03:06:11,0,2,2,世界上最好的体操老师
172510,2902,杨丹,2023-04-28 06:31:00,0,2,2,这个课你需要做好当舔狗的准备，每天要追着屁股后面舔，要舔到自己都恶心的那种，在注重个人印象来给分的前提下稍稍加上了自己的个人感情，在看别人舔他深度的情况下选择舔的最舒服的那位给予最高学分，在为难学生的同时会向你提供一份卡绩的低学分，想要获得杨老师的课的高分并不难，你只要做到会舔，会舔，会舔就够了。当然你也可以选择与他共同抽一支烟来聊一聊他对教学的理解
175207,2902,杨丹,2023-06-22 09:50:31,0,0,0,无语了
185196,2902,杨丹,2023-12-27 04:30:29,-1,0,1,欢迎各位窈窕淑女曼妙美女来体验美好的体       \n\n操课，513老师会好好地爱你们
186206,2902,杨丹,2024-01-09 11:44:24,4,4,0,无语了，啥老师啊，说好捞一下的，就真是说啊 ，天天上课自己心里有点数吧
186211,2902,杨丹,2024-01-09 12:32:03,0,1,1,好好好
186215,2902,杨丹,2024-01-09 13:03:16,1,1,0,无语子。。。
186291,2902,杨丹,2024-01-10 10:57:57,-1,1,2,老师真的很负责！
22189,2940,顾建民,2016-03-03 02:00:39,-1,1,2,这节课不水
106689,2940,顾建民,2019-04-29 02:57:06,2,3,1,基本讲不出什么
108556,2940,顾建民,2019-05-28 11:31:39,0,2,2,无话可说
109789,2940,顾建民,2019-06-19 08:09:09,1,2,1,哎无语了
172114,2940,顾建民,2023-04-20 02:00:59,0,1,1,太水了
182537,2940,顾建民,2023-11-17 08:43:48,3,3,0,很好的老师
7993,2958,吴雪萍,2015-09-16 11:59:52,-5,2,7,好
9318,2958,吴雪萍,2015-10-21 07:14:58,8,11,3,还行，有点自顾自的。
11644,2958,吴雪萍,2015-12-09 06:55:57,-8,2,10,收获很大，促进你思考
11917,2958,吴雪萍,2015-12-21 10:37:09,0,2,2,三个老师上感觉真不一样
69550,2958,吴雪萍,2018-01-25 03:40:31,-8,2,10,老师懂的确实很多，如果认真听的话会有收获
93975,2958,吴雪萍,2019-01-14 14:08:40,-10,1,11,老师很好，关心学生。点评展示一针见血。
105177,2958,吴雪萍,2019-04-25 05:04:16,9,12,3,上课枯燥乏味，内容空洞，思想极左，然而自我感觉还很好，建议学校尽量不要让这样的老师来浪费我们的时间了
109111,2958,吴雪萍,2019-06-08 13:10:14,8,13,5,比较教育的课也能上成政治课，高，实在是高!灭绝师太的形象真的好吗？
115331,2958,吴雪萍,2019-07-18 23:31:28,5,8,3,好好的一门课，怎么会上的这门枯燥呢？还用大量时间来小组讨论，是不是老师实在没货了，只能这样来消磨时光呢？
117818,2958,吴雪萍,2019-10-03 01:30:15,5,7,2,水平非常一般，讲课内容太过陈旧老套，却自信满满，自以为是
118021,2958,吴雪萍,2019-10-19 02:27:35,3,5,2,看似不错，却水平太一般，还有点自以为是
119107,2958,吴雪萍,2019-11-10 11:07:29,5,5,0,老是让大家讨论、交读书报告，老师啊，你是真的想培养学生思维能力呢，还是自己肚里无货？
125853,2958,吴雪萍,2020-09-15 02:46:20,0,2,2,深入浅出
126807,2958,吴雪萍,2020-10-21 02:34:21,4,6,2,讲的一般般吧，一上来就问候你哪个高中的
134891,2958,吴雪萍,2021-04-21 04:01:16,0,0,0,……？
171502,2958,吴雪萍,2023-03-27 03:38:26,0,1,1,感觉老师是很博学的，在比较教育课程里涉及很多制度和文化上的因素，一些政治课因素确实也有，但是个人感觉瑕不掩瑜
90,3016,郑其适,2015-03-14 15:47:31,3,14,11,给份一般，脾气么。。
60901,3016,郑其适,2017-11-02 03:39:31,0,1,1,hhh
35410,3026,刘正伟,2016-11-10 07:13:56,0,2,2,太高大上
41010,3026,刘正伟,2017-01-08 03:43:55,-1,0,1,挺偏激的
205129,3026,刘正伟,2024-12-02 03:41:06,0,0,0,拖堂颇有高中老师的风范啊啊啊啊啊啊，其他不予置评，都还可以
47744,3123,过平江,2017-02-23 04:15:15,0,0,0,差\n\n很差
697,3174,程宏宇,2015-03-15 15:47:48,1,9,8,比较照本宣科吧，给分比较厚道。
8249,3174,程宏宇,2015-09-18 00:36:51,8,19,11,太烂，自己上心理咨询课，却完全不具备当心理咨询师的素质。结巴、声音难听、眼神躲闪、一点也不自信，无聊透了。
10023,3174,程宏宇,2015-11-14 11:31:03,-1,2,3,老师的经历还是挺丰富滴
10102,3174,程宏宇,2015-11-16 07:04:32,0,3,3,老师很温柔，讲课挺好的呀～
10462,3174,程宏宇,2015-11-19 03:20:37,0,2,2,只能说我他妈为什么3
12715,3174,程宏宇,2015-12-24 02:24:36,-1,2,3,讲的不错，不过的确很难直接用于实践啦
26022,3174,程宏宇,2016-06-15 06:00:09,-1,2,3,只要按课堂要求做，给分就会不错，不过老师要是再自信一些就好了
26561,3174,程宏宇,2016-06-20 06:18:41,-1,3,4,真的是很可爱的一位老师 他得套路莫名戳我萌点有毒
36991,3174,程宏宇,2016-11-17 03:41:45,-4,1,5,还可以啊，给份比较好
37495,3174,程宏宇,2016-11-19 06:32:27,3,6,3,上课听不听是不会管的，其实回想起来老师会把比较难的理论形象化，举例说明。心理咨询这门课收获很大，写的报告也没有想象中那么困难。考试内容几乎都是教材和课件上有的，考试前一定好好读教材！最后两节复习课一定要去！老师说的重点一定要看！给分还不错吧，上课基本没听但是作业和考试认真做下来4.5
37771,3174,程宏宇,2016-11-21 02:49:54,-1,2,3,老师很可爱
38858,3174,程宏宇,2016-12-19 15:09:44,-1,0,1,\n\n\n\n\n\n
48986,3174,程宏宇,2017-03-20 13:17:09,1,1,0,不怎么样
53290,3174,程宏宇,2017-06-26 10:00:39,6,6,0,心理学基础给分挺低的，虽然老师好说话也没作业，但还是有点后悔……
53325,3174,程宏宇,2017-06-26 11:10:33,-1,0,1,事情很少，很水，考试准备好就可以，就是不知道怎么满级
89031,3174,程宏宇,2018-11-16 03:00:56,5,5,0,水 考试标准不明确
135154,3174,程宏宇,2021-05-04 18:56:08,2,2,0,不喜欢这个老师 给分差 而且上课毫无内容
135161,3174,程宏宇,2021-05-05 07:10:29,2,2,0,基本上每节课都要签到，上课没什么水平，就照PPT念
135216,3174,程宏宇,2021-05-06 05:40:44,0,0,0,呜呜呜呜呜呜呜
154959,3174,程宏宇,2022-06-07 06:12:12,3,4,1,教育心理学大水
155510,3174,程宏宇,2022-06-14 00:26:25,7,7,0,……很难评价 只能说这门课本来可以学到很多东西的…………
176985,3174,程宏宇,2023-07-01 03:14:12,1,2,1,期末考试好像和之前都是一样的，98上有（）
177421,3174,程宏宇,2023-07-03 08:33:36,5,5,0,教育心理学给分好迷……专业课最低绩点……
177439,3174,程宏宇,2023-07-03 09:10:25,3,3,0,教育心理学很多是98历年卷原题（特别是主观题一模一样），老师PPT有些是网上。。。这很难评。人还不错啦，就这样
177481,3174,程宏宇,2023-07-03 11:36:58,2,2,0,给分好差
220138,3174,程宏宇,2025-06-15 11:18:28,0,0,0,给分很迷，上课很水，考试题目不换，感觉努力也没有价值
220408,3174,程宏宇,2025-06-17 22:58:12,0,0,0,课讲得略枯燥，给分有点低😭不知道是不是开卷考得太差了的缘故
7671,3208,孙元涛,2015-09-15 08:18:31,21,25,4,老师很帅
12784,3208,孙元涛,2015-12-24 04:17:45,55,64,9,老师讲的教育学基础让我跳进了这个大坑里 经历丰富 上课我从来不水手机认真听
14731,3208,孙元涛,2016-01-08 14:06:18,14,16,2,太帅了
14941,3208,孙元涛,2016-01-11 06:53:27,15,16,1,老师帅，内容有价值
15784,3208,孙元涛,2016-01-16 09:08:13,10,11,1,享受！
17103,3208,孙元涛,2016-01-19 14:56:44,7,8,1,从来认真听课\n\n老师真男神
24467,3208,孙元涛,2016-04-30 14:46:18,22,22,0,从此我相信了真有气质这一回事！！
25530,3208,孙元涛,2017-01-15 14:38:05,5,6,1,很好啊！
26314,3208,孙元涛,2016-06-17 00:42:44,15,15,0,甘做迷妹
27880,3208,孙元涛,2016-06-28 02:45:48,12,13,1,老师好甜……讲课水平高，都不想水手机了。任务不多，给分也好。
28005,3208,孙元涛,2016-06-28 07:58:49,10,10,0,讲课好，有魅力，事情少，给分高
28611,3208,孙元涛,2016-06-28 10:59:39,5,7,2,孙老师的案例讲课结合十分有趣生动引人思考，每节课都坐前排认真听讲，简直是享受。教育学院的男神，超有人格魅力。?
28630,3208,孙元涛,2016-06-28 11:15:12,5,5,0,讲课循循善诱很吸引人，老师也很风趣，很推荐的一门课，给分更是不错。
31126,3208,孙元涛,2016-07-03 08:53:03,5,5,0,真男神
31196,3208,孙元涛,2016-07-07 05:45:42,27,30,3,院里一枝花，咳，我是说，男神。
33019,3208,孙元涛,2016-09-10 05:22:29,11,11,0,我的妈孙男神评分第一了，简直想再修一遍他的课，孙男神得人格魅力真的是up up up
34756,3208,孙元涛,2016-10-20 07:26:39,4,4,0,超级超级棒的好嘛\n\n
36396,3208,孙元涛,2016-11-13 01:21:55,11,11,0,第一节专业课 听完感觉精神得到了升华 真 好老师
37220,3208,孙元涛,2016-11-18 02:48:05,1,2,1,非常好
37851,3208,孙元涛,2016-11-21 11:19:12,2,3,1,好好好
39186,3208,孙元涛,2016-12-21 13:44:12,3,3,0,真的很享受 上课不水手机\n\n
41551,3208,孙元涛,2017-01-12 07:31:42,3,4,1,啥都不说了，妥妥的男神，课好事少，考试还给重点。而且很有人格魅力，是有真本事，能学到东西的老师
42809,3208,孙元涛,2017-01-15 07:56:57,3,3,0,超赞！很有学识的老师
42810,3208,孙元涛,2017-01-15 08:06:22,2,3,1,超级好，有魅力，了解很多知识，考试划重点，喜欢和学生交流，最喜欢的老师之一男神
42824,3208,孙元涛,2017-01-15 08:43:13,3,3,0,老师真的太好啦，课讲得好，人也好。
42892,3208,孙元涛,2017-01-15 11:13:13,4,6,2,虽然我的绩点只有3.0，但是不得不说，老师的课很生动，很容易接受，不愧是研究教育的人。作业不多，给分也是实打实的。但是可能实在课时少，一本课本的很多内容都没讲。
44584,3208,孙元涛,2017-01-18 03:39:17,3,3,0,上课很生动 有干货 男神很有气质
45982,3208,孙元涛,2017-01-20 10:41:11,14,17,3,教院男神，是一门听课都不舍得水手机的课，讲课风格趣味性很强，会有很多例子，把教育学基础的知识点讲的很好，两次过程作业，不难，表达自己的想法即可，期末考也会划重点，要记的知识也不多，轻松又能学到很多~听他讲完，不学教育学的会喜欢上教育，学习教育学的对教育会更有一份情怀，老师人很好的，给分也非常不错，强推~
48059,3208,孙元涛,2017-02-28 07:55:28,2,4,2,好老师。给分也很好。考前会给资料。
50993,3208,孙元涛,2017-05-11 07:56:13,3,3,0,非常帅，讲课真心好
51382,3208,孙元涛,2017-06-03 13:05:19,4,4,0,如果能再选一次孙老师的课，我真的还想再上一次老师的课~
51512,3208,孙元涛,2017-06-07 02:14:51,5,5,0,简直男神 真的非常享受 给分也还可以吧
52677,3208,孙元涛,2017-06-22 06:09:51,4,4,0,超级赞！！
58266,3208,孙元涛,2019-01-25 01:54:08,-47,18,65,一直跟我们说浙大学生是顶尖水平，一直批判正态分布不合理，一直说自己给分不会按照正态调分，结果呢？给的分数挺低的，还有人不合格的
62161,3208,孙元涛,2017-11-23 02:30:51,4,4,0,幽默，有深度！
69935,3208,孙元涛,2018-01-25 16:45:32,1,2,1,绝好！
71980,3208,孙元涛,2018-01-29 07:19:07,1,3,2,满分满分!教育学基础4.8!\n\n老师简直就是男神!上课有趣考试也不是很难，是一门可以引起我们思考的课? \n\n真的是很男神啊!
72013,3208,孙元涛,2018-01-29 08:09:15,3,3,0,金牌课。宽和，暖暖的。
72074,3208,孙元涛,2018-01-29 09:53:47,4,4,0,不说了，男神！！！！上课完全不水，而且紧跟时代潮流，会有很多当下的热词！！！！太喜欢了！！强烈建议辅修教育学！！！！
72309,3208,孙元涛,2018-01-30 01:31:34,8,8,0,建国君民，教学为先，老师是一个有思想、有情怀的人，有这样的人引我们进教育学的门，种下对教育学的启迪和感悟，是教院之幸。
73097,3208,孙元涛,2018-02-01 02:01:27,5,5,0,为什么老师只开一门课啊o(╯□╰)o
74746,3208,孙元涛,2018-03-05 11:39:09,3,3,0,棒！男神！\n\n
75525,3208,孙元涛,2018-03-13 02:32:50,6,6,0,每次下课都有自发的热烈的掌声！\n\n
76931,3208,孙元涛,2018-04-26 05:54:49,2,2,0,教育学院男神
87858,3208,孙元涛,2018-10-16 04:52:17,3,4,1,期待中，多次请教，耐心回复。
89843,3208,孙元涛,2018-11-21 03:55:24,2,2,0,不点名也不会逃课，太有趣了
90030,3208,孙元涛,2018-11-22 00:31:27,3,3,0,名不虚传
91343,3208,孙元涛,2018-12-06 06:31:13,10,11,1,男神，羡慕他女儿? \n\n听课后，越发现自己对现实的无力，唉╯﹏╰
91666,3208,孙元涛,2018-12-17 12:44:00,2,2,0,妙喵喵
91689,3208,孙元涛,2018-12-18 02:41:00,16,16,0,温和的外表，藏不住犀利的思想，释放出人性的光辉。
92465,3208,孙元涛,2018-12-29 10:17:16,5,5,0,舒服，幽默不枯燥，特别谦逊也特别认真，偶尔点名，但是无数次强调是为了公平性，上课根本不想看手机，给分也公平，只要出勤好，作业好好写不可能挂科的
92852,3208,孙元涛,2019-01-05 07:36:24,2,2,0,没得说 真的不想玩手机
92924,3208,孙元涛,2019-01-05 17:29:23,2,2,0,老师的课很深刻，能学到内容 大一第一个学期最不水的课
99691,3208,孙元涛,2019-01-25 05:09:33,2,2,0,老师和蔼可亲
101924,3208,孙元涛,2019-01-29 16:45:21,2,2,0,真男神！！！我真的太幸运了！！！
101926,3208,孙元涛,2019-01-29 18:19:30,4,4,0,虽然我被绩杀了，只有3.3，但这门课挺有意义的，老师人也很好
101950,3208,孙元涛,2019-01-30 00:58:44,1,1,0,老师人很好，学识渊博，通情达理，每节课都讲了很多有趣的案例
101988,3208,孙元涛,2019-01-30 02:26:44,1,1,0,非常棒的老师
102061,3208,孙元涛,2019-01-30 08:42:54,1,1,0,满分满分!!!
102197,3208,孙元涛,2019-01-31 10:12:01,11,11,0,前面某个说老师给分很不公正的怕不是脑子有问题，1.30才出的成绩你1.25就知道了吗？恶意中伤要点脸吧。老师真是教育学院男神，上他的课是荣幸。
102426,3208,孙元涛,2019-02-01 19:37:32,1,2,1,回一下楼上的话 查老师好像是有人对评论点赞或者点踩日期就会更新 那个说老师给分乱给的我很早以前就看到了 我看着那个踩的数量从20到了24 是以前的人评的 应该是在他出成绩之后评的 来自某位用了两年半查老师的学长0 0
105597,3208,孙元涛,2019-04-17 03:57:18,1,3,2,孙老师的课和管院鲁柏祥的课是我大一唯二没水手机的课~(后面那门为什么没水手机就不解释了，毕竟自己怂人一个T﹏T)不过老师的给分很求是，想事少分高拉均绩的同学慎选
107820,3208,孙元涛,2019-05-10 04:18:40,2,2,0,金课。
114248,3208,孙元涛,2019-07-09 09:54:34,2,2,0,good!!
115533,3208,孙元涛,2019-08-01 15:00:33,4,4,0,满分满分
116563,3208,孙元涛,2019-10-24 02:41:15,3,3,0,狂赞一下。跨专业选
117120,3208,孙元涛,2019-09-19 12:05:03,1,2,1,真男神♪～(´ε｀　)
119283,3208,孙元涛,2019-11-12 02:32:05,4,4,0,有段子，有干货！
119303,3208,孙元涛,2019-11-12 12:11:31,3,4,1,十个传言九个虚，\n\n这一个是真滴?
120456,3208,孙元涛,2019-12-09 03:03:07,1,1,0,讲课生动，深入浅出
121997,3208,孙元涛,2020-01-29 15:01:03,1,1,0,孙老师的课非常值得一上，如果你对教育真的感兴趣的话。想拿高分的同学调研好好做哦，老师很鼓励认真的同学的。
125687,3208,孙元涛,2020-09-13 05:10:15,1,1,0,好好好
130881,3208,孙元涛,2021-01-25 05:40:07,1,1,0,孙老师上课真的非常吸引人，完全不舍得玩手机
130887,3208,孙元涛,2021-01-25 06:18:54,5,5,0,呜呜老师真的是教院男神，上课和答疑都非常用心，课堂也特别精彩，完全不想玩手机。出分很快，给分超级好，还会反馈大家的卷面情况。都去选！
131089,3208,孙元涛,2021-01-26 02:06:41,5,5,0,好课，内容生动有趣，老师认真负责而且温润儒雅，有一种如沐春风的感觉。上课写作业认真一点，绩点不会差
142420,3208,孙元涛,2021-11-11 07:37:05,5,5,0,本来考试成绩不太好心情很差，想来早点占座位学习，但是很幸运遇到老师的课堂，真的让人放松了很多，好好思考了一下自己这段时间的忙碌。真的很羡慕人文学子吧。
145534,3208,孙元涛,2021-12-30 07:35:55,15,15,0,可以把人无条件骗进教育学院的帅哥
148693,3208,孙元涛,2022-01-13 08:37:37,1,1,0,超级好的老师！上课也很有意思给分也好好老师真的超级棒
148735,3208,孙元涛,2022-01-13 10:35:41,4,4,0,老师很好！上课也很有趣，虽然我给分不是很高QAQ但是我自己也知道报告写得不是很好，所有也不能怪老师啦！建议就是报告一定要认真对待，期末考前一定要好好背书！
148940,3208,孙元涛,2022-01-14 04:00:04,2,2,0,老师挺好哒，我以为就我这种思想水平3.3差不多了，结果老师给了4.2，感激不尽感激不尽！
149908,3208,孙元涛,2022-01-17 16:59:33,6,6,0,因为一些以前的经历一直很矛盾，老师的课让我义无反顾进入教育了。教院男神yyds！可惜本科阶段就这么一次课程了。
164758,3208,孙元涛,2022-12-25 12:25:37,4,4,0,卷帙浩繁的世界，最初都有良师开卷。感谢孙老师带我走进教育学！
165921,3208,孙元涛,2023-01-10 15:18:49,-6,2,8,教育学基础，虽然已经打磨了十年，但课程本身可能没有传说中那么好，老师的课件略有些劣质，有些页上面的内容大篇大篇来源于百度百科。孙老师很有风度，讲授得很用心，声情并茂，引入的课堂教学案例都是他亲身经历过的，但是可能会觉得其中部分扯得有点远了。这学期情况特殊，考核方式是一篇观影报告或读书报告+三道开卷论述题，作为专业课来说负担不是很重，如果是常规的闭卷考试难度可能会更大一些。
166389,3208,孙元涛,2023-01-12 06:50:18,1,1,0,很有人格魅力的老师！！！大一选修上的教育学基础，课程内容本身不出彩，但是老师有很多引例挺给人启发，线上考试也是充分考虑同学建议改成了开卷（类似论文）。读书报告选题的时候跟老师交流了，开卷问题也认真结合ppt、课本和论文答了，4.5很满意！！
166399,3208,孙元涛,2023-01-12 07:12:47,2,2,0,感谢老师给我学业生涯第一个满绩！
166521,3208,孙元涛,2023-01-12 15:08:22,2,2,0,享受课程
167845,3208,孙元涛,2023-01-19 12:06:29,2,2,0,孙老师yyds！！儒雅温柔，上课内容丰富有深度，对待学生也很耐心和善，给分也很好！！真的很爱
170010,3208,孙元涛,2023-03-01 03:31:25,3,3,0,外专业来听教育学，完全不会觉得艰涩，线上考试专门询问参考所有同学的意见。老师人很谦逊，所有消息都会回复，特别耐心！给分也很好，老师会把要求说的很清楚，值得去听的课！
182312,3208,孙元涛,2023-11-14 12:01:29,5,5,0,很有见地、很有深刻思想的一位老师，上课给人一种娓娓道来的感觉，生动地向我们展示了教育学应该有的样子
187924,3208,孙元涛,2024-01-17 23:47:34,3,3,0,非常喜欢老师！讲课也很棒！
187928,3208,孙元涛,2024-01-17 23:59:58,2,3,1,怎么说呢，老师特别好，课也特别好，但是最后的分数出来跟预期有很大差距……
187983,3208,孙元涛,2024-01-18 02:48:03,3,3,0,孙老师特别特别好，上课很有深度，讲的很认真，可以称得上是先生，考完后请教孙老师问题，孙老师会非常详细的解答，还帮我分析了试卷，和其他老师形成鲜明对比，非常感激
188670,3208,孙元涛,2024-01-19 13:31:50,2,2,0,都满绩了，还要如何？
189055,3208,孙元涛,2024-01-21 13:08:29,1,1,0,很好很好
197604,3208,孙元涛,2024-07-21 07:15:12,1,1,0,完美啊
197743,3208,孙元涛,2024-08-08 01:39:33,2,2,0,深夜的时候问了孙老师几个教学哲学的问题，几乎秒回，回答一针见血，洞察深刻！
201810,3208,孙元涛,2024-11-06 12:19:11,1,1,0,好好好！专业课特别有趣
207384,3208,孙元涛,2024-12-21 05:51:19,2,2,0,男神…不多说，有幸选上教育学基础，学到的教育学、哲学等体系构架被反复用在其他课的作业上，收益匪浅😌🥹
213139,3208,孙元涛,2025-01-16 05:56:54,1,1,0,老师上课是抽人点名的，学期只有一个读书报告的作业任务量不是很大认真写还是很有收获的！！而且老师也会很耐心的回复写报告的一些问题！期末闭卷考但老师会带着大家复习背重点就很有用了！给分好好好 老师讲课真的很精彩～
213147,3208,孙元涛,2025-01-16 06:24:36,1,1,0,伟大，无需多言！
213823,3208,孙元涛,2025-01-20 06:44:04,0,0,0,好老师 给分也不错
51381,3216,杨明,2017-06-03 12:59:43,0,0,0,可以划船……
52626,3216,杨明,2017-06-21 15:12:40,0,0,0,很好的老师
52693,3216,杨明,2017-06-22 07:27:37,13,13,0,一路走好
52713,3216,杨明,2017-06-22 09:23:01,0,0,0,听说杨老师。
57206,3216,杨明,2017-07-06 04:47:01,0,0,0,今天才无意中看到这个消息 不知道是个什么样的人 但还是祝您一路走好
57417,3216,杨明,2017-07-07 12:08:20,2,2,0,虽然不认识您，但是希望您能够安心走好。凡事都有因果报应，相信人世会还您一个公道
57439,3216,杨明,2017-07-07 23:35:34,0,0,0,老师走好
124015,3216,杨明,2020-06-20 10:02:42,0,0,0,老师一路走好
156511,3216,杨明,2022-06-20 06:06:46,0,0,0,老师走好，天堂会善待纯粹的人。
156627,3216,杨明,2022-06-20 12:15:48,0,0,0,老师一路走好，愿在天堂没有欺骗
179247,3216,杨明,2023-09-03 12:58:56,0,0,0,老师一路走好
7655,3278,魏贤超,2015-09-15 07:38:00,0,0,0,听不懂
41932,3339,郭玉清,2017-01-13 08:55:08,-7,0,7,会有很多实践课，作业也挺多。学到的东西自然也多。老师也很好。
50498,3339,郭玉清,2017-06-28 07:25:07,8,11,3,垃圾老师，讲不明白还装逼
53525,3339,郭玉清,2017-06-27 01:46:13,-8,0,8,老师上课是引导性的学习，能学到很多东西～
53541,3339,郭玉清,2017-06-27 02:30:45,8,9,1,讲的不清楚
82487,3339,郭玉清,2018-07-08 10:26:36,5,6,1,给分差，很傲慢，脑子有病。
122969,3339,郭玉清,2020-04-27 03:21:50,4,4,0,教育学院的傻逼老师
123587,3339,郭玉清,2020-06-10 08:45:22,6,6,0,0分给老师，10分给助教。心疼助教跟这么个导师。\n\n助教是翻译器来着，没有助教完全不知道讲了什么，作业是什么
169338,3339,郭玉清,2023-02-25 12:45:13,2,3,1,垃圾老师，清高的要死，一点也不尊重学生，超级无语的，傲慢鄙视学生
94242,3353,于可红,2019-01-16 04:06:15,2,2,0,奇葩老师 上课扯一些没用的 很装
132602,3353,于可红,2021-02-02 14:49:54,2,2,0,给分差
14232,3363,徐琴美,2016-01-05 13:24:44,35,50,15,就是不让你学到一点东西！
22741,3363,徐琴美,2016-04-06 08:43:34,-35,11,46,她之前去哈佛大学当过访问学者，也有三十多年的临床心理咨询经验，所以感觉上课的案例还不错听了很有收获，也在用心备课。只是自己本身并不是一个友善善于倾听很有亲和力的人，给分严格。
22921,3363,徐琴美,2016-03-15 00:28:25,-20,12,32,她的所有课程布置的作业的要求都很模糊orz，讲课很好
23187,3363,徐琴美,2017-01-03 07:35:19,33,41,8,为什么不能打负分
23188,3363,徐琴美,2016-03-21 08:02:11,21,27,6,绝对不让你学到一丁点东西
23507,3363,徐琴美,2016-04-02 10:56:31,11,17,6,迟交作业教你重修 呵呵哒
24565,3363,徐琴美,2016-05-02 01:26:50,17,21,4,呵呵哒！规则来得个多，情绪管理作业要求麻烦得要死。认认真真做了给分这么低我真是不服！至少学过心理学的我不觉得她讲的心理学方面的东西有多少用处，而且一整个学期也就一直重复那么一两个概念而已。
24576,3363,徐琴美,2016-07-03 07:32:11,-31,10,41,徐老师讲课很好，给人指导很多，就是有点严厉，但是这也是一种认真负责的表现
25358,3363,徐琴美,2016-05-16 02:56:09,29,34,5,上大学到现在遇到的讲课水平最差的老师…一学期了一直在讲提纲，每节课能翻一两页ppt就不错了，总在说学习心理学的目的是什么，不讲实际的内容，留一些无趣的作业，每次上课感觉都在靠点学生回答问题和写各种奇怪的左右来填满三节课的时间，点你回答问题的时候还揪着你不放，上课上到最后都有种浪费时间的感觉，根本没法培养对心理学的兴趣，还不如看看书学的多。
26361,3363,徐琴美,2016-06-17 05:34:46,-25,7,32,很负责，想法比较多
26592,3363,徐琴美,2016-06-20 09:02:52,10,14,4,要求又多，事情也多，还总要回答问题，纠正你的想法。
28351,3363,徐琴美,2016-06-28 08:38:43,10,12,2,烦(-、-)
28967,3363,徐琴美,2016-06-29 04:33:26,7,11,4,情绪管理给分很严格啊，讲课听不进去
31045,3363,徐琴美,2016-07-03 06:59:51,14,17,3,讲课呆板，无端驳斥他人思想，给分莫名其妙的低。
31061,3363,徐琴美,2016-07-03 07:33:35,11,14,3,高傲自大，不接地气，自以为是
31062,3363,徐琴美,2016-07-03 07:35:08,10,17,7,你知道变态什么样儿么？就这老师这个样儿 上课对学生来说就是煎熬 不尊重学生 说话很做作 给分很低  自己没说清楚最后大作业的要求还怪我们自己没看明白 讲真 有点伤心 幸好以后再也没有她的课了呵呵呵
31067,3363,徐琴美,2016-07-03 07:39:31,8,12,4,老师太自以为是
31075,3363,徐琴美,2016-07-03 07:49:40,-20,8,28,讲课挺好的，会教给你学习的方法，认真听的话会有收获的
39673,3363,徐琴美,2016-12-27 02:41:25,7,10,3,毕竟能选上就算好了，但这不是你不讲干货还事多烦人的理由啊\n\n
39693,3363,徐琴美,2016-12-27 03:42:57,8,10,2,辣鸡老师
49579,3363,徐琴美,2017-04-19 07:25:49,7,9,2,垃圾老师
50695,3363,徐琴美,2017-05-04 10:28:36,-15,4,19,讲得挺好的啊～课程确实比较有用吧～老师也很和蔼～不知道为什么评分这么低
50702,3363,徐琴美,2017-05-04 11:03:15,-2,4,6,感觉老师还行吧，情绪管理上课就是用做问卷的方式来点名，一次小作业，一次论文，认真写给分还行的
50708,3363,徐琴美,2017-05-04 11:39:11,3,4,1,上课呵呵给分呵呵作业真迷
50738,3363,徐琴美,2017-05-04 23:28:03,0,3,3,还行吧，上课很水的，可以干自己的事
50837,3363,徐琴美,2017-05-06 09:02:32,3,5,2,竟然不能打负分，真不是我说什么，屁事多，讲得差，期末作业规范让我们自己去查，后来老师说字体都没有规定，无语了，这就是规范吗？还无故指责他人的想法，可以反驳，可以修正，但骂是怎么回事，醉了。
51592,3363,徐琴美,2017-06-07 10:55:36,0,1,1,。。。
52106,3363,徐琴美,2017-06-15 00:53:54,2,3,1,上了好几周的课了，不知道在讲什么
55908,3363,徐琴美,2017-07-02 15:27:12,3,5,2,可以打0吗
55920,3363,徐琴美,2017-07-02 15:59:31,3,4,1,说实话，感觉课程收获很一般。。平常还看到有些学生总课下去混脸熟，我实在找不到混脸熟的动力就没有去，而且看到这个J的评分不太好，也没指望最后分数多好，结果居然95，真的万万没想到。。厚脸皮地给选这个课的同学一点个人的建议：认真写期末论文就够了（最好找个具体的点分析，而不是宏观地写），平常只要每节课问卷做了，就算从来不发言也没啥影响……
55941,3363,徐琴美,2017-07-02 17:03:05,3,4,1,辣鸡辣鸡
55959,3363,徐琴美,2017-07-02 18:42:06,0,1,1,水课无疑
56261,3363,徐琴美,2017-07-03 10:45:40,-1,0,1,还行吧，推荐有心理学基础的同学去学，这样写论文也轻松点
58719,3363,徐琴美,2017-09-16 00:53:47,-3,0,3,还好啦\n\n
60146,3363,徐琴美,2017-10-11 10:25:51,0,2,2,改变了我对心理学老师的看法。
61289,3363,徐琴美,2017-11-13 16:37:20,3,4,1,不知所云 反正不是心理学
63092,3363,徐琴美,2017-11-28 08:47:23,3,4,1,学习与发展心理学，很痛苦。慎选
63141,3363,徐琴美,2017-11-28 15:32:58,4,7,3,学习与发展心理学，教育学专业课，事情多到崩溃，给分一般吧，感觉付出与收获不成比例
63189,3363,徐琴美,2017-11-29 03:54:29,1,2,1,你咋不上天呢
71365,3363,徐琴美,2018-01-28 10:57:36,-1,2,3,客观的说 这门课主要看自己 付出多少要展示给她你才能收获多少 平时作业要认真 期末好好写
77734,3363,徐琴美,2018-05-07 12:24:27,-6,9,15,真的是非常好的老师！！科研热情和实力都很强，为人也很亲切。可课堂有讨论交流是非常好的机会，前提是大家都积极参与进来。如果让我们自主学习就是“学不到知识”，那恐怕是自己的问题。\n\n如果反问、启发和讨论是“自大”，是“否定你”，那么一片大和谐又何来进步？\n\n不知道为什么会有这么多差评甚至是人身攻击，只是希望大家都能客观评价老师。
80635,3363,徐琴美,2018-06-28 14:29:07,3,5,2,最大的遗憾是不能打负分
83551,3363,徐琴美,2018-07-10 14:50:45,3,4,1,充满偏见  评分标准不客观  内容空洞
83581,3363,徐琴美,2018-07-10 15:51:17,1,2,1,完全不清楚老师想怎么上课
88660,3363,徐琴美,2018-11-05 06:10:13,4,5,1,2分老师名不虚传
88698,3363,徐琴美,2018-11-06 03:57:09,1,3,2,周三的课全都要去外面上 完全不考虑下节课有课还有12.15下课的同学 别的课迟到也要算成绩啊 只有这位老师的课不能吃亏 不能少时间 早去晚回 硬生生变成整个下午的课 而且一二节课根本就没有来 课程要求也没说 等知道了 已经不能退课了
88918,3363,徐琴美,2018-11-12 08:14:07,10,11,1,老师的确有学识有想法，但是有非常多硬伤。首先就是对学生缺乏尊重。这门课安排了很多课外实验比如去实验室和幼儿园，虽然收获很大，但是占用时间太多远远超出课程安排，也根本没有考虑人家后面有课的同学，人家要先走还指责他们。而且老师在课上鼓励大家问问题多探讨，到真的和她交流有时又一副看不起学生的样子，无缘无故diss别人。老师对于心理学很专业但是对于教育的一些看法实在难以苟同，上课也是随便漫谈不系统，个人认为上课内容实在要好好甄别，取其精华去其糟粕。
90897,3363,徐琴美,2018-11-27 07:15:55,1,4,3,上徐老师的学习与发展心理学，看得出老师在这个领域有非常厉害的研究，她带四个助教协助我们，还她带我们去西溪的实验室和幼儿园参观，虽然比较耗费时间，但是也真的是收获满满的。\n\n她期末会让我们以小组形式做实验，然后用poster形式进行展示。看英文文献 写实验报告是一种新尝试，难度挺大，但也收获满满。总而言之，认真学会有收获的!
92569,3363,徐琴美,2019-01-03 03:23:51,-3,2,5,学习与发展心理学，每周一篇三千+的实验报告/观察日志/读后感，每周要自费打车去一个幼儿园观察孩子杵一下午，上课极其无聊，给分极其低。这门课写的作业超过其他所有课的总和
93534,3363,徐琴美,2019-01-10 07:58:48,11,12,1,等你们到了大三，就明白徐老师其实已经不错了，唉，趁年轻，转专业还能抢救一下
97133,3363,徐琴美,2019-01-21 17:16:34,3,4,1,学习与发展心理学，理论课有点水，反正最后的考核是poster展示……老师的科研热情确实挺高的，不过在教学方面显得有点欠缺。平心而论实验课还是挺有趣的，接触到很多仪器设备还有幼儿园的小朋友；助教人也都很好，就是最后给分比较迷……\n\n话说想知道楼上3000+是怎么出来的？我们上的不是同一门课么
103357,3363,徐琴美,2019-02-27 12:38:34,-1,1,2,理论与实践结合，认真学会有很大收获
109108,3363,徐琴美,2019-06-08 13:03:46,1,2,1,品学兼差的老师
115520,3363,徐琴美,2019-08-01 05:45:27,0,1,1,毫无素养，不尊重学生，脑子里面全是水，品学兼差。
115574,3363,徐琴美,2019-08-05 11:57:49,0,2,2,中国最差老师
118019,3363,徐琴美,2019-10-19 02:21:50,1,3,2,听说是心理系混不下去了，才调到教育学院的
120244,3363,徐琴美,2019-11-26 01:51:54,-1,0,1,h h h
120293,3363,徐琴美,2019-11-27 12:50:47,7,9,2,他们现在在哈佛，他们都是从我实验室出去的... 我就经常开你们这些教育学的学生和老师玩笑... 我说你们不配学教育学... 什么是学习啊，这就是学习啊... 无内鬼，可不可以在评论区开个Soviet Daily版块 有点柯学的味道
122056,3363,徐琴美,2020-02-08 04:24:38,1,2,1,学习与发展心理学，去幼儿园实验，其实挺有意思，实验报告也每次认真写的，也深入进行了几个实验，体验不错，课下也与老师有交流，在老师指导下改进了实验，最后做出的结果二十来页，我也自认没有搭便车行为，大组报告亦是分工明确，个人的网课我也没有缺过，最后的成绩真的非常失望，我不知道老师自诩的规则在何处体现，是觉得每组中必然有个搭便车的人吗？功不唐捐果真是笑话。
123055,3363,徐琴美,2020-05-07 01:28:55,0,1,1,奇葩，不否认有科研能力，但是教学的话还是算了。
181155,3363,徐琴美,2023-10-10 07:16:28,0,0,0,学不到一点东西
183893,3363,徐琴美,2023-12-03 06:31:10,0,0,0,老师我求求你的创业基础快出分吧，一个月了
184723,3363,徐琴美,2023-12-22 10:33:41,1,2,1,不考试，就一个展示，期末一篇文章，每节课点名，没听过一节课但是最后4.5真的好感动，虽然老师有一些做法有点emmm，但是作为水课还挺好的
184840,3363,徐琴美,2023-12-23 09:46:05,2,3,1,创业基础几乎学不到东西，喜欢请外面的人来分享，老师本身性格没问题去找她问小组展示的问题还请吃饭了。事情不算多，一个小组展示，一个期末个人小展示（特别水）加两千字说明。主要是有创意就行了。想水课的可以考虑
185072,3363,徐琴美,2023-12-26 05:29:20,1,1,0,通识课挺好，蛮水的
185249,3363,徐琴美,2023-12-27 09:37:49,0,0,0,创业基础，可能课上学到的东西不会有你想象的那么多，但是和老师交流真的能打开很多思路，给分也挺好吧
185293,3363,徐琴美,2023-12-27 15:15:01,0,0,0,创业基础课给分还是可以的
185532,3363,徐琴美,2024-01-02 04:01:31,1,1,0,创业基础 课还是挺无聊的 但最后4.2我还是很满意的 和老师聊天约office hours 老师还会请你吃饭啊哈哈～
186902,3363,徐琴美,2024-01-13 13:14:03,0,0,0,创业基础事不多，一次小组展示一次期末个人展示，三次线上讨论题。每次都点名。虽然上课学不到啥，感觉和创业也没什么关系，不过水水还是挺开心的。绩点3.9，可能因为我没去刷存在感且期末展示主题和人撞了……
71316,3747,张洪汇,2018-08-27 08:55:40,1,5,4,垃圾垃圾
71557,3747,张洪汇,2018-08-27 08:55:45,0,2,2,不好听有待改进
71641,3747,张洪汇,2018-08-27 08:55:25,4,8,4,垃圾。
71821,3747,张洪汇,2018-08-27 08:49:36,4,7,3,利益熏心
72120,3747,张洪汇,2018-08-27 08:55:13,3,5,2,为什么没有零分这个选项
72487,3747,张洪汇,2018-08-27 08:55:36,3,5,2,糟糕的体验...
74563,3747,张洪汇,2018-08-27 08:48:47,4,5,1,智障老师，完全就一傻逼，三观完全扭曲\n\n油腻的中年男人
80400,3747,张洪汇,2018-06-26 06:10:23,0,1,1,还不错啊
153957,3845,吕阳,2022-05-18 03:29:40,0,0,0,讲课很有意思
141449,3877,马岚,2021-10-09 08:03:55,10,14,4,绝绝子
204065,3877,马岚,2024-11-23 14:31:21,0,0,0,啊啊啊啊啊啊最爱的老师！！！
72719,3905,胡亮,2018-01-31 03:18:27,2,6,4,人挺好的 给满了 感谢?
119263,3905,胡亮,2019-11-12 00:45:28,0,0,0,老师挺好的
120712,3905,胡亮,2020-01-15 17:33:13,0,0,0,未出分，感觉不错
121136,3905,胡亮,2020-01-20 00:14:36,8,8,0,上课较水，给分较差
122983,3905,胡亮,2020-04-27 11:15:28,2,4,2,内容比较到位，可混也可认真学到东西
132358,3905,胡亮,2021-02-01 05:15:46,-6,2,8,一共3次小测，2次会提前通知，1次随堂，3次取两次最高。上课会随机点人回答下问题，讲的有一些挺有意思的。最后一篇1k到1w的论文，我只写了1k5。讨论课比较无聊吧。最后闭卷感觉还是需要多背一点的。最后c+2.8，事总体不多吧，适合想水通核的，毕竟这玩意太难选了。
134666,3905,胡亮,2021-04-08 03:16:50,0,0,0,课教的东西比较实用，最后考试也比较简单
150324,3905,胡亮,2022-01-22 12:36:21,-2,0,2,给分挺好
154799,3905,胡亮,2022-06-05 13:21:29,0,0,0,很喜欢胡亮老师！
179445,3905,胡亮,2023-09-15 16:00:57,1,1,0,有待提升
208275,3905,胡亮,2024-12-26 12:42:47,0,1,1,布置的作业和论文和课件和阅读材料混在一起，上课也不说清楚
213047,3905,胡亮,2025-01-16 01:29:16,1,1,0,卡绩了，给分一般，讨论课内容比较无聊，中途会组织辩论赛，大作业要求1K+要打印出来，平时3次10分钟小测，背的内容有点多
213129,3905,胡亮,2025-01-16 05:13:25,2,2,0,事情有点点多。课程作业要一篇小论文3000字左右，占比25%，期末占比30%闭卷，助教评价占比20%？（有点忘了）学生互评占比10%，还有三次小测选其中两次分数（取高）占比10%，总体给分感觉还行，但给我卡绩了😢88 4.2
82480,4071,楼恒阳,2018-07-08 10:10:38,-1,0,1,业界良心！！！！！！！！！！！\n\n
87602,4071,楼恒阳,2018-10-08 06:02:25,0,0,0,特别棒！超级赞！浙大好老师！
108971,4078,包松,2019-06-05 02:14:27,0,1,1,晕乎乎
91103,4304,刘超,2018-11-30 02:25:54,7,7,0,老师知道的很多，但是是真的不会讲课
91373,4304,刘超,2018-12-07 03:51:31,14,17,3,辛苦老师了，是教育学院的错
91374,4304,刘超,2018-12-07 03:53:08,5,6,1,我蛮想听老师讲历史和自己的研究的，但无奈让他上教育社会学
91574,4304,刘超,2018-12-14 01:56:26,4,4,0,这样不适合上课的老师也是少见，上他的课如坐针毡
93602,4304,刘超,2019-01-11 01:58:03,5,5,0,老师真的博览群书，也可以看出他用心在和学生交流 ，但是实际讲课就有点一言难尽了。。
93661,4304,刘超,2019-01-11 08:21:29,13,16,3,作为科研工作者满分，作为传道授业的教师不合格。虽然课上有小零食，不点名，但是上课内容已经不仅仅是水可以形容的了。课上老师推荐的书籍都很有价值，但是老师貌似没有研究过教育社会学，没有发表过一篇关于教育社会学的文章，不知道为什么要来教教育社会学。虽然老师学识渊博，但这样真的可以么?第一个月讲了课本，课堂有效时间不超过一半，再然后进行了一个月的学生展示。。。其实老师为人不错，也不想抱怨老师，只想让他好好科研，把教育社会学托付给别人来教吧。。。
101287,4304,刘超,2019-01-28 03:33:51,5,6,1,学识渊博却不会上课，说话声不清晰，水课至少还算上课，而这个课甚至不算上课。说不上来有什么体验感，因为根本就没有机会触发什么体验感。
102697,4304,刘超,2019-02-21 04:35:40,2,2,0,如果你把他说的几本书看一下，基本就可以不用听了，书的内容远超教材，但确实教材也没有使用的必要，考核什么的都跟教材无关，内容还是有的，并不能说毫无收获，起码读了一本书，读懂了一种观点，还是可以的，上课如坐针毡没毛病，主要是逛一圈随机叫人回答上节课内容或前几节课的内容，稍微记下就能回答出来了
115575,4304,刘超,2019-08-05 11:58:48,2,3,1,居然没有进入低分榜
119625,4304,刘超,2019-11-14 09:09:50,8,8,0,球球老师不要到处走了啊，来回切界面很烦的
121916,4304,刘超,2020-01-23 17:36:50,8,10,2,老师给分这么好怎么才4.7分？？课的确水得一批，但给分超乎想象的好！！外专业快来选这个图书馆借阅量全浙第一的男人的课！！
129880,4304,刘超,2021-01-13 06:49:30,2,3,1,还没结课，但老师学识渊博，认真听真的可以学到很多
132174,4304,刘超,2021-01-31 00:16:12,2,4,2,超超，yyds!
140586,4304,刘超,2021-09-14 05:12:50,5,5,0,除了讲话太快没有重音，简直无可挑剔。思维非常快，能够推荐好多不同领域的书籍和文章，适合自学型的学生。不点名也不卡分数，nice！
145156,4304,刘超,2021-12-28 01:55:03,6,6,0,老师人挺好的 感觉和蔼可亲 但是最大的问题就是说话听不清楚啊！！！语速很快还有点含糊 听起来就是嗡嗡嗡…
150178,4304,刘超,2022-01-20 01:38:59,4,5,1,刘超，yyds！
172643,4304,刘超,2023-05-03 04:24:28,0,0,0,超超太棒啦！
176947,4304,刘超,2023-07-01 00:22:53,0,0,0,两门课都事少分高，推荐！！！
176948,4304,刘超,2023-07-01 00:22:53,0,0,0,两门课都事少分高，推荐！！！
176962,4304,刘超,2023-07-01 01:39:49,0,0,0,老师上课声音有些轻，但看得出来老师真的知识渊博，很尊重学生，当然给分也挺好🥹
177438,4304,刘超,2023-07-03 09:08:24,1,1,0,超超中外教育交流史和教育社会学都是给分的超人！
180205,4304,刘超,2023-09-20 14:15:20,0,0,0,好老师，给分高
188966,4304,刘超,2024-01-21 01:40:19,1,1,0,老师确实懂的很多 但是上课讲话不太清晰 最后给分很不错的
191518,4304,刘超,2024-04-24 07:15:35,0,0,0,emmm 人很好，感觉读过很多书，前面说老师不太会讲课的我觉得也不能完全怪老师，上课学生积极性这么低，老师估计也没法一直保持特别好的状态，但是声音确实有点小且有口音。。。
202744,4304,刘超,2024-11-14 06:20:49,0,0,0,就凭人社概论让我满绩，我就给他打高分！
207792,4304,刘超,2024-12-24 09:34:51,2,2,0,经院金融学勇闯教育学专业课，还没出成绩呢今天上完最后一节课，老师腿受伤了还在坚持给我们上课，非常的敬业，冲这一点给老师一个大大的满分
214615,4304,刘超,2025-02-14 15:28:36,3,3,0,人品好、给分好。先生之风，山高水长。
214839,4304,刘超,2025-02-18 07:12:18,0,0,0,建议老师考取普通话证书
217710,4304,刘超,2025-04-15 10:56:38,1,1,0,给分确实好，也确实知识渊博，循循善诱，私下里去问老师问题都得到了耐心解答；普通话不好确实也是真，但是能看出老师其实有在认真上课
128694,4317,黄聪,2020-12-25 04:34:26,0,5,5,雅俗不共赏，难以理解高山流水
129521,4317,黄聪,2021-01-06 15:00:11,-3,2,5,老师加油
160170,4317,黄聪,2022-09-14 06:16:35,-5,1,6,老师上课很有意思，这学期刚学，等学完再来评价，老师加油
177727,4317,黄聪,2023-07-04 12:23:54,2,8,6,老师讲课水平差就算了，没想到给分也这么差，意外。一整个上课不知所云，还喜欢评头论足自己的同事、学生，真心建议老师提升一下自己的授课水平。
197501,4317,黄聪,2024-07-17 12:47:42,2,8,6,这位老师不管是教学水平还是科研能力，都明显无法胜任其所扮演的角色。对其学习生涯乃至学术生涯的经历都不能深挖，见光死。真正了解他（能力以及为人）和喜欢他（或者说是不讨厌他）这两件事不可能同时存在。
203119,4317,黄聪,2024-11-17 04:52:50,0,1,1,给分真的很迷，不知道脑子里在想什么，超级无语，完全就是瞎给，还要考完试看慕课，超级多，考试五六道大题，超多填空，名词解释，和判断，根本写不完，不过写完和写不完也一个分数
206757,4317,黄聪,2024-12-17 11:40:17,5,7,2,黄老师的课我觉得受益匪浅，讲课内容贴切实际，非常好！！！
206776,4317,黄聪,2024-12-17 13:14:56,-1,0,1,老师讲课结合最新文献知识点，使我们学习到非课本的最新前沿知识，受益匪浅
79456,4343,黄亚婷,2018-06-06 00:16:06,-25,9,34,水平实在有限，感觉走后门当的老师吧哈哈
94872,4343,黄亚婷,2019-01-18 11:37:45,15,17,2,教院难得心思放在教学上同时又有干货不无聊的好老师，长得还漂亮！
115535,4343,黄亚婷,2019-08-01 16:55:12,24,25,1,认真，专业，敬佩，
123586,4343,黄亚婷,2020-06-10 08:43:12,18,18,0,老师很温柔，会一对一地帮你，学到了干货
124243,4343,黄亚婷,2020-06-28 04:04:15,11,13,2,上课认真，关注学生个体的选题，会有针对性的指点，人也很好。
124935,4343,黄亚婷,2020-07-21 16:25:53,22,23,1,老师认真负责，非常敬业，科研水平高，课后每次作业都是一对一反馈，耐心指导，一学期下来收获很大，感觉自己真的有了不少进步。
161417,4343,黄亚婷,2022-11-07 00:58:56,3,3,0,上过老师的公共关系，很有趣的一门课，学到了很多有趣的案例\n\n有知识、有条理、有收获!
166284,4343,黄亚婷,2023-01-11 16:36:52,5,5,0,老师人很好，给分也好，爱了爱了
187500,4343,黄亚婷,2024-01-16 11:40:05,1,1,0,老师人很好水平也很高，但没学到啥是我愚钝了
210249,4343,黄亚婷,2025-01-08 14:21:55,0,0,0,人好负责，但是要认真对待，不要学我。。
70910,4717,蒋明健,2018-01-28 00:04:10,1,4,3,老师点名就是随堂叫人回答问题，不来的人扣10分平时分，学校要求正态，还不错啦上课，虽然从来没听过
73064,4717,蒋明健,2018-03-07 09:15:12,50,62,12,普通的军理老师，事少给分看自己，还行
73079,4717,蒋明健,2018-02-01 01:39:53,40,47,7,老师可是大校啊，比较关心浙大征兵问题，期中论文就是这个
73107,4717,蒋明健,2018-02-01 02:27:54,2,4,2,没听过，没人听过课
73246,4717,蒋明健,2018-02-01 08:31:56,7,8,1,老师人很棒
73722,4717,蒋明健,2018-02-03 03:49:12,1,2,1,老师人很好
74576,4717,蒋明健,2018-03-04 01:52:09,1,2,1,还可以吧
74869,4717,蒋明健,2018-03-06 07:12:13,-1,1,2,还可以
75111,4717,蒋明健,2018-03-07 10:59:42,4,5,1,老师还是挺不错的
75133,4717,蒋明健,2018-03-07 12:38:20,0,4,4,给分不敢恭维
75870,4717,蒋明健,2018-03-20 10:30:13,-2,0,2,…………
75939,4717,蒋明健,2018-03-22 07:54:45,17,19,2,老师很有人情味，必须满分
77376,4717,蒋明健,2019-05-31 17:42:27,32,35,3,论文写了个三千字不到，点名都来了，绩点4.2，我觉得OK
79116,4717,蒋明健,2018-05-23 09:53:35,0,5,5,这老师还行，这姓余的助教真的很垃圾\n\n论文格式要求混乱无比，邮件也不回。
79691,4717,蒋明健,2018-06-13 00:17:40,-1,0,1,事少人好，给分还行，可能我论文没认真写吧才3.9
79907,4717,蒋明健,2018-06-15 05:16:59,-1,0,1,很不错
79912,4717,蒋明健,2018-06-15 06:00:30,0,2,2,不错 挺水
79993,4717,蒋明健,2018-09-17 15:34:35,1,3,2,没上过，想选
80187,4717,蒋明健,2018-06-21 07:39:35,5,7,2,老师好，上课轻松，课上会叫你划考点，平时就一次期中作业，倒数第二节课会搞个讲座，讲讲中国海建之类的，蛮有意义的，考试考好给分就不差。助教也好，平时点名没到助教还问问原因。。。。。。反正选了就没错。
80501,4717,蒋明健,2018-07-16 13:05:42,3,5,2,告知大家出分了，课水分还可以。
80509,4717,蒋明健,2018-06-27 08:26:38,-1,2,3,事少分好
84956,4717,蒋明健,2018-07-16 13:11:30,2,13,11,第三门88 又卡我绩点
84985,4717,蒋明健,2018-07-16 08:09:56,9,11,2,今天的我依旧等待
85022,4717,蒋明健,2018-07-16 13:28:36,19,21,2,军理4.2还可以接受的吧，也不需要怎么花时间，典型的事少分好。
85050,4717,蒋明健,2018-07-16 13:37:38,6,8,2,给分不错
85102,4717,蒋明健,2018-07-15 10:59:03,6,9,3,老师真的不考虑出分吗
85181,4717,蒋明健,2018-07-16 02:22:59,16,19,3,大家出分了在这里互相通知一下吧?都怀疑是自己出错了
85245,4717,蒋明健,2018-07-16 13:22:14,2,5,3,事少分好
85247,4717,蒋明健,2018-07-16 13:40:32,-6,6,12,辣鸡给分差，上课无聊。
85251,4717,蒋明健,2018-07-16 13:51:27,7,9,2,说实话上课水平不高，就是念课本嘛。但是事很少，而且毕竟是军理课还是可以理解的。给分还不错，倒数第二节的讲座还蛮精彩的，可以期待一下～最后复习资料建议去找吕强班的同学要一份。老师本身是负责浙大征兵的大校，所以这方面讲的比较多。
85254,4717,蒋明健,2018-07-16 14:04:15,2,4,2,讲课基本就是在念课本+画重点，偶尔会点名和提一些非常水的问题。事情很少，给分也不错。
85257,4717,蒋明健,2018-07-16 14:14:19,2,6,4,给分很一般
85258,4717,蒋明健,2018-07-16 14:19:25,3,5,2,非常好的老师，给分也很好，事情也少，就点一次名
85264,4717,蒋明健,2018-07-16 15:31:09,2,3,1,事少，给分看自己，感觉不错的
85279,4717,蒋明健,2018-07-16 16:36:17,14,15,1,上课水 但是事少，给分高 作为军理课来说不能再nice了
85334,4717,蒋明健,2018-07-17 05:28:13,4,4,0,老师事情少，就期中一篇论文，上课偶尔点名，给分好
85363,4717,蒋明健,2018-07-17 08:59:55,24,27,3,老师上课有点无聊，但是也挺轻松!\n\n基本没有平时作业，期中就一篇简单的论文!\n\n给分基本看期末考，开卷也要认真复习，那4.5还是不难的。\n\n偶尔点名，不来平时分基本上就凉了哈哈哈
85457,4717,蒋明健,2018-07-18 04:57:41,3,3,0,点名的
85595,4717,蒋明健,2018-07-20 09:30:51,10,13,3,老师讲课内容与教材高度符合哈哈哈！每次上课都要先说一句“同学们下午好”之类的印象特别深。认真写论文，随机点名回答问题和大规模点名都到的话，平时分应该没什么问题。开卷考试好好复习就能翻到（别忘了带上lq老师的军事技术的ppt事实证明考试用上了hhh）。老师给分挺好的～
86014,4717,蒋明健,2018-08-27 04:09:26,0,0,0,还好吧
87130,4717,蒋明健,2018-09-21 00:43:10,0,0,0,还行吧
88812,4717,蒋明健,2018-11-08 14:38:24,0,0,0,哈哈，不错
91647,4717,蒋明健,2018-12-17 05:45:52,4,5,1,大绩杀
92686,4717,蒋明健,2019-01-03 15:50:26,0,0,0,很ok\n\n
93866,4717,蒋明健,2019-01-14 05:11:04,20,21,1,老师 别忘了取走 插在本机上的u盘\n\n老师 别忘了取走 插在本机上的u盘
94479,4717,蒋明健,2019-01-16 23:33:31,0,0,0,老师很好，事少
94515,4717,蒋明健,2019-01-17 04:12:42,1,1,0,事情少上课水，但是一定要来因为会不定期抽点名，要是没来的话。。。。
95150,4717,蒋明健,2019-01-19 01:51:26,0,0,0,给分好
100523,4717,蒋明健,2019-01-26 08:45:37,6,6,0,老师真的还不考虑出分吗？
100736,4717,蒋明健,2019-02-01 14:22:26,-2,5,7,论文题简单好写 划重点 留一上午复习 绩点4.8 蒋老师太好了呜呜呜
100748,4717,蒋明健,2019-01-26 16:50:06,1,2,1,上课体验，比较轻松事少，给分很好，对上课精彩程度没有要求的同学再适合不过了，如果想要体验精彩课堂的，那么建议其他老师的课
100754,4717,蒋明健,2019-01-26 17:20:20,-1,0,1,u刚刚
100799,4717,蒋明健,2019-01-27 00:56:11,0,1,1,给分不好评论。
100814,4717,蒋明健,2019-01-27 01:08:45,2,2,0,朴素美
100822,4717,蒋明健,2019-01-27 01:23:25,1,7,6,老师超棒！感觉得到老师很认真，而且事情很少～期中论文字数翻倍+点名都到了+期末复习了一天把目录都看了，蒋老师竟然给了我满绩！！！喜出望外hhh
100910,4717,蒋明健,2019-01-27 05:50:33,3,4,1,事少给分好\n\n期中论文掐着字数写的，期末带了lq的资料去考场的，之前一点没复习做题也还行。最后4.5
101004,4717,蒋明健,2019-01-27 08:55:31,-5,6,11,为啥？我听说事少给分多才来的，结果期中论文也写了，点名没点到过我，考试内容都找到了才3.3？为啥？
101158,4717,蒋明健,2019-01-27 23:33:43,4,5,1,上课抽人点名 点到没在的话 平时分10分就没有了 论文的话 老师规定字数2500以内 让我这种憋不出字的轻松了不少 终于没有鹅颈了 考前只看了一遍书 打印了老师最后一节课给的目录 最后4.8 谢谢老师
101161,4717,蒋明健,2019-01-27 23:39:43,-3,2,5,上课很无聊 但是给分很好 点名看运气\n\n期中论文压线 期末没复习直接考 4.5
101937,4717,蒋明健,2019-01-30 00:03:25,2,3,1,事少\n\n但给分挺好
102562,4717,蒋明健,2019-02-08 10:22:05,0,0,0,事情少 上课虽然并没有某些老师那么有趣 但是能从方方面面感受到老师对学生是真的很好 上课也很用心 而且给分也太好了吧
103119,4717,蒋明健,2019-02-26 04:30:34,-1,1,2,很不错
103380,4717,蒋明健,2019-02-27 23:53:39,1,2,1,助教小哥哥超帅啊！！！
103385,4717,蒋明健,2019-02-28 00:49:16,10,11,1,助教小哥哥的笑点？？？
113538,4717,蒋明健,2019-07-06 23:21:12,2,4,2,上课中规中矩，不太有趣；老师人很好，很理解大家；事情少，给分好好复习了感觉成绩还是不错的。ps.这学期的滑冰助教小哥好好玩啊哈哈哈
113577,4717,蒋明健,2019-07-07 00:25:00,-5,2,7,一次全体点名，平时上课会以抽人提问的形式点名。一篇论文一次末考，事情比较少。上课老师向全班问问题的时候不要把他一个人晾在那里，主动回答期末有惊喜（论文水的一匹还晚交，期末也就那样，最后4.2）
113642,4717,蒋明健,2019-07-07 01:45:43,4,7,3,上课很无聊，没什么人听，绩杀
113658,4717,蒋明健,2019-07-07 02:20:46,2,7,5,都说给分好，为什么我节节课都去，论文认真写了五千多，考试也好好考，最后3.3……
113671,4717,蒋明健,2019-07-07 03:04:49,-1,0,1,军理课本身的确是不那么有趣的，但老师和助教xgg真的很好呀，老师是按照教材讲的，每节课都有重点内容，论文认真写，特别是要注意论文的格式，字数也没有必要过于鹅颈，按照要求做就行了～期末考试前可以去文印店买PPT复习，开卷考试还是比较轻松的～
114437,4717,蒋明健,2019-07-10 03:02:42,2,2,0,我……（无发可说
114738,4717,蒋明健,2019-07-11 07:59:48,5,5,0,老师很体贴学生，性格温和。平时任务很少。
121693,4717,蒋明健,2020-01-21 01:57:30,9,12,3,论文堪堪水过字数，复习了半天，最终4.8。非常惊喜，谢谢老师。感觉这门课最终还是看期末考试成绩多一点
121719,4717,蒋明健,2020-01-21 06:03:59,5,8,3,不说啥了，被正态到79，又能说些什么
121727,4717,蒋明健,2020-01-21 08:21:29,0,2,2,超级好
130246,4717,蒋明健,2021-01-20 05:17:38,1,1,0,考前来评，好老师，非常照顾学生
130446,4717,蒋明健,2021-01-22 12:00:35,0,1,1,好好好
131318,4717,蒋明健,2021-01-27 05:27:11,0,2,2,正如之前同学的评价，普通的军理老师，授课，作业，分数都是普通的，不做更多评价
131356,4717,蒋明健,2021-01-27 07:30:07,0,1,1,无语了，第一次第一次思政课分这么低，惨被正太
136552,4717,蒋明健,2021-06-21 03:00:19,0,2,2,还不错
138836,4717,蒋明健,2021-07-11 06:48:52,-12,4,16,偶尔抽人点名，全勤的我从未被抽到，相当于不上课的人跟我的平时分基本一样。所以正太真就随便找个倒霉蛋呗，一个个旷课的都拿了不错的分，着实无语，不明白给分的标准是什么，正太的标准是什么
140055,4717,蒋明健,2021-08-24 07:54:50,17,17,0,蒋大校以前是浙江省省军区军事法院的院长，现在在省军区。老师年纪比较大，平时上课任务不重，给分值得吹吹，拿个高绩点还是相对容易的；口音的话，吴语区的同学可能更适应一点，不过这个是小问题了。老师的点名方式比较特殊，上课保证到就行。总之，值得一试的老师
147855,4717,蒋明健,2022-01-11 04:15:49,2,2,0,还行
147865,4717,蒋明健,2022-01-11 04:35:52,9,9,0,满足一个好的军理老师所具备的一切特性，课水事少给分好
148064,4717,蒋明健,2022-01-11 12:25:42,8,8,0,军理本来就是水课，讲得好不如人好，蒋老师事少给分好，按照要求写论文，期末好好考，绝对不会让你失望的
150046,4717,蒋明健,2022-01-18 13:33:48,3,4,1,事少给分好
156034,4717,蒋明健,2022-06-17 07:41:28,24,26,2,出分了，4.8/93，个人比较满意。\n\n蒋老师算是比较传统的军理老师，上课基本靠念ppt，每学期的任务只有一篇期中论文，要求2500字左右，我就写了三千出头，根据结果来看也没怎么影响成绩，比较轻松。\n\n理论上来说是点名的，但实际操作是点人回答问题来抽样，因为班级人多所以大部分人抽不到，具体去不去教室还是看个人。\n\n关于考试，蒋老师不会发ppt，但会在期末前发相比于目录更加详细的提纲，非常有用。鉴于军理考试是无限制纸质材料开卷，建议找其他班级的同学或者文印店带一份ppt进去。考前提前熟悉一遍课本，八九成的题目都能直接找到原话。\n\n以上供参考，祝好成绩。
156140,4717,蒋明健,2022-06-18 02:30:45,2,3,1,4.8/94，老师人很好，这也是稍微一卷就能拿好分数的科目，很推荐。
156988,4717,蒋明健,2022-06-21 13:15:54,2,2,0,事少给分好\n\n课不用听\n\n论文也好写，不用查资料也没资料能查的那种
158036,4717,蒋明健,2022-06-26 11:00:14,8,11,3,不喜欢这老师，给分也没有想象的好，所谓的打分不过是幸存者偏差，你们就偷着乐吧
159015,4717,蒋明健,2022-07-04 12:53:09,1,2,1,课不用去上，点名点到的概率非常非常小。\n\n蒋大校很慈祥很和蔼。\n\n论文正常写就好。\n\n期末前多熟悉下书本，考试时把握下手速，很容易高分的。
166769,4717,蒋明健,2023-01-13 13:39:52,10,12,2,个人感觉给分确实不是很好，都认真做了但是不是很理想，可能是自己不太感兴趣
166779,4717,蒋明健,2023-01-13 14:35:20,5,8,3,感觉给分很好，我翻书很慢，感觉要寄了，最后三分钟怒做20题。本来做好3.0的准备了，但最后上四了，巨开心。因为我论文很用心在写，平时分很高（助教说的），然后上课我也是坐第一排认真听的，虽然翻书很慢，但是我很多还是有印象，所以在别人说都翻到了，但是卷面只有五十几，而我差不多一半少一些没翻到，但是卷面不错！！！爱蒋大校！！！
166966,4717,蒋明健,2023-01-14 11:39:49,-34,3,37,想要高绩点尽量别选这个老师，我一开始也是抱着侥幸心理来的。结果论文也好好写了，考试的题也翻得差不多，被正态到3.3。我就很疑惑，现在思政课哪还要求后30%的正态啊？？？从来没有一门思政课下4的人如是说，别来
167470,4717,蒋明健,2023-01-16 14:00:12,2,2,0,事情比较少，讲课中规中矩，一般般，所谓绩点什么的还是要看期末翻书速度
167835,4717,蒋明健,2023-01-19 10:50:09,7,15,8,emmmmm关于下面绩点的问题。还是那句话，你选这门课这个老师难道tm就是为了你那批绩点吗？确实很理解你努力了但没得到理想的绩点心情很差，但这怪老师吗？我论文是ddl前赶的，考试就打印了大纲约等于裸考，最后拿了4.5，但是我不会因此就说想水绩点就选这个老师。我能说的就是希望各位同学不要太关注老师评分了，除非是特别高的评分或特别低的评分的老师，其它中规中矩的老师会因人而异，差别很大的。像我刚选蒋老师的时候评分只有8分多，现在上9了，只能说面向不同学生会有差别，浮动大。希望大家理性评论。
168548,4717,蒋明健,2023-02-19 09:50:09,9,11,2,老师不错，不点名，不过有两节课会叫人回答问题，如果你没来，基本上就被正太到3.3了，楼下3.3的那个人是不是翘课刚好被提问然后没到呀😅
177794,4717,蒋明健,2023-07-05 01:58:18,4,4,0,上蒋大校的课挺轻松的，没什么压力。\n\n论文是命题作文，题目也比较贴近生活吧，不难写。\n\n平常上课是比较认真听的，考试应该是没什么问题的。\n\n考试前会给一份提纲，拿它打印了考试更好找。
177826,4717,蒋明健,2023-07-05 03:07:28,-13,3,16,给分特别求是。但是作为一个期中论文用gpt写、期末考试翻书一半没翻到的人来说，上四已经是最大的胜利。
189361,4717,蒋明健,2024-01-23 11:31:19,1,3,2,学期唯一一次签到没签上，论文水水过，考前从没翻过书。最后4.2供参考
189365,4717,蒋明健,2024-01-23 11:57:27,-1,0,1,老师人不错，给分一般
189406,4717,蒋明健,2024-01-24 03:13:48,0,2,2,主要还是看期末考吧，没点名到+期中论文+期末几乎全找到，满了
189639,4717,蒋明健,2024-01-26 08:14:12,0,1,1,还可以的老师，人很好，给分也还可以
195908,4717,蒋明健,2024-07-01 04:08:08,2,2,0,没想到，一个学期最低的一门课是军理\n\n修改一下评分，最低的确实是军理，但是期末考确实太难了吧，开卷考考出了不及格的巨分，平时分虽然没像隔壁cc和slp一样给满，但是确实给的挺高了，确实是期末考得太差，喜提3.6
195914,4717,蒋明健,2024-07-01 00:33:21,4,4,0,不会太差，但今年期末考那么难，根本找不到，肯定分数会比较低，那你也得像cc和slp一样把平时分给满吧，不然挺不公平的。最后绩点也不是很满意，中规中矩吧，是本人本学期最低绩点
196851,4717,蒋明健,2024-07-05 13:12:29,-3,0,3,不点名，上课较无聊，可翘；无小测，期中一篇论文，平时分不会像隔壁cc那样给满但也挺高的；想要好的总评期末成绩会比较重要，最后一节课老师给的例题和划的重点可以多看看
196990,4717,蒋明健,2024-07-06 09:38:55,1,2,1,求是 真的不捞，但是上课确实可以水。上课主动回答问题似乎没什么作用（本人每次课到场+主动举手回答课后记下名字，论文有好好写期末认真考提3.9）虽说开卷自己没找到一些题有责任，但是和付出比还是没到预期（本人工科，思政类课程普遍分数较高）老师是好老师，想冲高绩点的还是得多考虑。
197160,4717,蒋明健,2024-07-08 08:57:50,0,1,1,点名到了，期中论文认真写了，期末考试也认真准备了，感觉给分太求是了点，不如slp班
212045,4717,蒋明健,2025-01-13 05:50:14,2,3,1,给分挺好的 偶尔点名，会叫人回答问题
212050,4717,蒋明健,2025-01-13 06:01:15,3,3,0,这学期jmj老师给分很好，上课比其他老师水，论文也难度不高，我和我同学从来没听过课考试翻书也没翻到很多，一个86一个89，放心可冲！！
212051,4717,蒋明健,2025-01-13 07:30:17,3,3,0,4.8来还愿🙏感觉给分好像还不错，一个学期点两次名，偏偏有一次我还生病请假了，但完全不影响绩点。上课发言过一次登记了名字（感觉可能是加分项），论文写得非常认真而且详细结合生活实际，期末考一大堆翻不到估计八十出头，看样子平时分快给满了。老师人挺好的，还让我不要担心请假问题。
212052,4717,蒋明健,2025-01-13 06:05:16,3,3,0,老师其实挺好的，虽然讲课确实很无聊。平时分会给的比较高，有签到，就是在钉钉群里打卡那种，不是每节课都有，签到时间放的很宽，早八不上早十签了也行。期中一篇论文，老师给题目。期末考试还是要好好考，恐怕不怎么捞的。
212068,4717,蒋明健,2025-01-13 06:36:22,0,0,0,10分送上，典型事少分高，放心冲！大校人很好但是上课有点催眠，冬天一开空调更是眼皮打架。。不过平时没听课加上期末一点没复习，期中论文水到字数，最后能有4.5的绩点，非常满意！
212159,4717,蒋明健,2025-01-13 09:28:31,0,0,0,课是真无聊，老师还是挺好的，论文写的一坨但是给分还不错，考前的复习课也挺有用的
212161,4717,蒋明健,2025-01-13 09:37:47,0,0,0,老师真心不错
212263,4717,蒋明健,2025-01-13 15:07:57,1,1,0,上4了太开心了，谢谢老师
212271,4717,蒋明健,2025-01-13 15:59:41,0,0,0,老师还行，跟课友评价一致。\n\n关于考试我想说一点：老师的建议是先写多选再写单选最后判断题。个人尝试了之后发现多选实在太难，按这个顺序根本写不完，而且多选很多写了也是错，综合起来挺亏的，书翻到了也不一定全选对的程度。还是建议先单选再判断最后多选，多选翻不到的也别纠结太久。
212510,4717,蒋明健,2025-01-14 06:05:47,4,4,0,老师很好，会点人回答问题，不点名。本人认真听了，但期末都没记住，现场翻的，老师会捞，正好86分
212588,4717,蒋明健,2025-01-14 08:47:50,2,2,0,给分一般感觉，主要是这种科目还是另外两位老师给分好一点
212912,4717,蒋明健,2025-01-15 08:41:56,11,12,1,没听过课，总成绩96分。来讲讲期末考试的方法吧，首先肯定是提前把资料准备好，课本的目录看一遍（是资料里面那个详细目录，不是书上的），以及资料里面的PPT也看一下内容。然后考试的时候，不需要按照顺序一道一道题做，而是按照章节来做，比方说先做军事技术相关题目，然后做军事思想相关题目，这样翻书方便。老师会捞的，做不出来没关系。
213144,4717,蒋明健,2025-01-16 06:10:28,0,0,0,老师很好，还挺幽默的
221050,4717,蒋明健,2025-06-21 04:25:18,0,0,0,老师真的对学生特别好 考试前百般叮嘱 考试后还主动联系学生解释成绩的问题 考不好还会得到安慰🥲
221053,4717,蒋明健,2025-06-21 04:51:41,0,0,0,蒋老师对学生真的很好，考试前叮嘱的很仔细，给分也很好，就是出分有一点慢（相信是在捞我们），别的老师出成绩好几天了我们才有成绩，不介意这个的话猛猛选
221163,4717,蒋明健,2025-06-21 15:29:21,0,0,0,不点名 4.8
221168,4717,蒋明健,2025-06-21 15:59:21,0,1,1,不点名，给分很好，这学期期末及其恶心最后94，应该是捞满捞不上去了
221602,4717,蒋明健,2025-06-25 01:58:30,0,0,0,4.8还愿。早八，不点名。
222088,4717,蒋明健,2025-06-29 14:03:40,0,0,0,平时分会根据期末成绩捞，大爱
127475,4928,彭玉鑫,2020-11-23 10:54:52,13,14,1,彭老师上课氛围很好，人非常nice，考试也好过
127476,4928,彭玉鑫,2020-11-23 10:56:12,10,13,3,彭老师知识非常丰富，体育系难得的能讲明白课的老师。
128284,4928,彭玉鑫,2020-12-16 12:14:33,10,12,2,彭老师上课真的非常认真负责细致，能充分利用时间，形象条理，对重点知识的讲解十分清晰易懂，使同学们对知识易与理解，课堂气氛很好。同时又是一位非常有耐心的老师，学生不管有什么问题都会热心帮忙解决，以及平时作业和考试都不会为难学生，另外彭老师羽毛球打得也是相当厉害！！！
129680,4928,彭玉鑫,2021-01-11 02:19:01,6,7,1,分给的超级高，讲课超级好的老师~
152484,4928,彭玉鑫,2022-04-13 01:13:08,3,5,2,彭老师真的人太好了😭考试也超好过  专业知识也很强
154522,4928,彭玉鑫,2022-06-02 03:53:27,8,9,1,彭老师真的是世界上最好的老师，上课认真，你只要好好学，就可以拿高分，老师不恶心不为难，发自内心的感谢
155575,4928,彭玉鑫,2022-06-14 11:14:38,3,4,1,彭老师很不错 讲课好专业知识扎实 很不错
170967,4928,彭玉鑫,2023-03-13 11:30:12,-5,0,5,老师会点名……跨专业的同学注意一下哦
173018,4928,彭玉鑫,2023-05-11 10:34:29,-11,5,16,真无语了，谁懂啊，jrm，天天点名，一门物理课答题文字量比tm政治都多？？？每节课都认真听，结果给分怎么不算好呢，起码及格线上多几分，哈哈，哈哈，哈哈
174330,4928,彭玉鑫,2023-06-09 15:16:03,1,2,1,彭老师人超级好，考试前会给大家复习重点，认真按照复习都能得高分，认识的很多90多分、还有100分的，楼上肯定是不认真听老师的重点、不复习、又被老师打捞上岸但还抱怨的…
174331,4928,彭玉鑫,2023-06-09 15:18:44,3,3,0,彭老师人超级好，考试前会给大家复习重点，认真按照复习都能得高分，认识的很多90多分、还有100分的，楼上肯定是不认真听老师的重点、不复习、又被老师打捞上岸但还抱怨的…
181776,4928,彭玉鑫,2023-10-31 09:01:20,0,0,0,非常好！
191656,4928,彭玉鑫,2024-04-27 03:50:43,1,1,0,老师特别好 会画重点回去好好复习一定能拿高分
192061,4928,彭玉鑫,2024-05-08 11:03:36,3,3,0,感谢彭老师送我大学第一个100昏！满昏！满昏！
219153,4928,彭玉鑫,2025-05-22 11:24:15,1,1,0,跨专业，学半天，满了
79457,5039,张佳,2018-06-06 00:18:01,27,37,10,水平实在是不行
79854,5039,张佳,2018-06-14 10:52:16,11,20,9,水平真的有限
89455,5039,张佳,2018-11-19 07:49:13,-48,9,57,超级好
92053,5039,张佳,2018-12-25 16:34:01,17,30,13,这真的是个副教授不是小学老师过来代课吗？各种意义上的小学水平
92131,5039,张佳,2018-12-26 14:31:14,74,86,12,张佳老师授课时生动形象，极具幽默感，非常能调动课堂气氛，寓教于乐，激发学生无限兴趣，这也是张佳老师的课到课率极高的原因之一。张佳老师上课条理清晰，干货满满，从不水时间，让同学能真正有兴趣，有目的地集中精力听课，学到知识。（一条五毛）
92159,5039,张佳,2018-12-27 00:50:10,13,24,11,奇葩老师
92409,5039,张佳,2018-12-28 09:45:24,8,19,11,想吐槽的太多懒得说了
93659,5039,张佳,2019-01-11 08:04:01,-9,13,22,张佳老师讲课还是有内容的，只不过可能内容本身不是很有趣，算是教育学院尽心尽责的老师了，期末给分也好
93998,5039,张佳,2019-01-14 16:33:39,7,11,4,没那么差也不算好
103025,5039,张佳,2019-02-25 12:10:00,6,10,4,老师上了好几门专业课，有些课确实不是老师专长，但是很认真负责，也举很多案例，努力和大家互动
104774,5039,张佳,2019-03-27 12:51:18,3,5,2,。。。
105029,5039,张佳,2019-04-02 14:20:58,-1,4,5,给分很好
115582,5039,张佳,2019-08-05 18:34:43,-3,1,4,...\n\n
122708,5039,张佳,2020-03-23 08:51:13,-2,4,6,真的无语。。。
128279,5039,张佳,2020-12-16 14:39:11,11,12,1,老师人很好，非常温柔耐心，老师说过她3年多一共上了十几门课，有的课来不及准备，我上的课还是非常有内容，看得出是用心准备的，很有收获，成绩也客观公正
135141,5039,张佳,2021-05-03 09:43:44,7,8,1,上的教育规划，老师给分说实话还挺好的，但是老师不太擅长一对多沟通教学吧，特别是规划部分听老师上课经常会有在听报告会的错觉，决策部分就好很多，老师还有点小小凡尔赛，“我还记得我第一次投中核心高兴了一下午，现在的话，可能两三秒吧”
137245,5039,张佳,2021-07-02 13:35:16,9,10,1,张老师和邵老师是高教所的两个传奇，期末给分都很好，但是因为上课的原因，在同学里的评价一言难尽...其实张老师的课能顺着思路一起听下去还是挺有意思的，但是相比一对一的沟通，老师可能不大擅长在教学的环境里和学生做一对多的沟通...
153070,5039,张佳,2022-04-25 01:33:41,17,18,1,讲的其实不错，不亚于翟老师
154158,5039,张佳,2022-05-25 01:55:16,3,3,0,嗯...上这个课不要坐后排\n\n在上教育科学研究方法的下学期还有教育规划决策 现在已经开始愁了
157318,5039,张佳,2022-06-23 02:51:50,-2,1,3,一般般 和她交流起来感觉很累 思维很混沌
157865,5039,张佳,2022-06-25 07:26:34,7,7,0,很认真负责的老师
159097,5039,张佳,2022-07-06 05:44:53,6,6,0,《教育科学研究方法》课，体验蛮不错的。
162468,5039,张佳,2022-11-23 03:07:35,7,7,0,张佳老师是一位认认真真备课、踏踏实实上课的好老师，也很关心学生。张老师的课上是能学到干货和知识的，也能实现自己的进步和成长
162726,5039,张佳,2022-12-05 08:55:59,-4,0,4,。。。。。。
182710,5039,张佳,2023-11-19 19:00:58,12,12,0,教育规划与决策，老师还是很用心的，也比较关心学生
204539,5039,张佳,2024-11-26 13:39:26,0,0,0,教育规划与决策给分还可以
74670,5051,王慧敏,2018-03-05 05:05:17,5,5,0,为啥会没有查老师分数呢
75181,5051,王慧敏,2018-03-08 01:48:17,8,8,0,吃可爱多长大的萌系老师，上课很有想法，超赞~
75182,5051,王慧敏,2018-03-08 01:50:32,11,11,0,老师超可爱(๑• . •๑)
77118,5051,王慧敏,2018-05-02 11:02:06,2,3,1,老师的教育思潮课好评！西方教育史也非常给人启发！！
77407,5051,王慧敏,2018-05-05 11:30:07,5,5,0,王老师人真的超级超级好的！！！为什么没人来评论啊啊啊啊啊
78694,5051,王慧敏,2018-05-14 13:54:02,4,4,0,很可爱呀
84590,5051,王慧敏,2018-07-13 09:05:16,1,4,3,王慧敏老师的小迷妹，但是从来不敢加他的微信或QQ，听过西方教育思潮，教育名著导读还有教育历史与文化，自己对于西方教育史的脉络与框架基本上是王慧敏老师建立起来的。\n\n老师真的超级可爱，可惜以后没有他的课啦～
84606,5051,王慧敏,2018-07-13 09:53:36,1,5,4,王老师人超好，女票是王慧敏老师小迷妹~
84607,5051,王慧敏,2018-07-13 09:57:02,2,3,1,好老师 回调分 虽然教育史依然凉了
88800,5051,王慧敏,2018-11-08 07:34:45,21,21,0,上课内容很足，很有思想。教育学院最不水的老师之一，和水军提督肖龙海形成鲜明对比
89766,5051,王慧敏,2018-11-20 16:29:43,8,9,1,老师有点严肃也有点可爱哈哈哈\n\n上的教育名著导读会跟你讲述很多教育家的故事，评分有点严格但是私底下人很nice!\n\n总之觉得听老师讲完之后就真的想把所有教育名著读完|ω・）\n\n这门课呢，每次都会点名，而且只有论文评分，所以好好写，收获会很大，绩点也会不错的呀
89786,5051,王慧敏,2018-11-21 00:10:54,1,1,0,耐心负责
89859,5051,王慧敏,2018-11-21 05:12:14,2,2,0,底蕴深厚、深入浅出，绝不照本宣科，上课很有吸引力
90022,5051,王慧敏,2018-11-21 16:35:42,1,1,0,老师人超好，很耐心，推荐
90072,5051,王慧敏,2018-11-22 04:48:23,1,1,0,老师真的好，上课非常有启发性
90911,5051,王慧敏,2018-11-27 09:49:05,4,4,0,不错的老师，很有思想，认真听课的话绝对受益颇丰，平时任务很简单，人很好，给分也不错，基本只要认真读完一本名著就能拿不错的分
91310,5051,王慧敏,2018-12-05 10:57:37,2,2,0,哦哦哦
91341,5051,王慧敏,2018-12-06 06:21:23,1,1,0,超爱他(⑉°з°)-♡
93267,5051,王慧敏,2019-01-08 13:01:19,32,34,2,教育学院的真良心，崩溃时想一想教育史的精彩，也能在其他垃圾课上咬牙坚持下去了
93530,5051,王慧敏,2019-01-10 07:48:02,2,2,0,真名士
93709,5051,王慧敏,2019-01-12 06:38:12,2,2,0,一个真正值得满分的老师
99836,5051,王慧敏,2019-01-25 08:13:04,1,1,0,超级棒的老师，备课认真，交流真诚，收获满满
105360,5051,王慧敏,2019-04-10 13:58:21,2,2,0,再一次为王老师摇旗呐喊
105387,5051,王慧敏,2019-04-11 07:17:07,1,1,0,王老师冲鸭啊啊啊啊啊
108941,5051,王慧敏,2019-06-04 12:40:39,1,1,0,王老师最棒，有课程方面的事情找他立刻就解决掉了
113481,5051,王慧敏,2019-07-06 18:12:51,5,5,0,王老师真的上课超好! 很有学者之风 讲课娓娓道来 蕴含许多哲理与生活深思 很其余几位老师比起来 虽年轻 但是上课风格却独具一格 教育史给的考试范围还是四人中最少最精简的 给王老师比心!
118001,5051,王慧敏,2019-10-18 04:10:33,1,1,0,很好的老师，他推荐的书我都想去读！讲得蛮有意思，还有就是不要缺勤！不要缺勤！！不要缺勤！！！！
120409,5051,王慧敏,2019-12-04 00:56:46,3,3,0,温和而理性，言语又很有趣的老师！！！打10分嫌低了~
130933,5051,王慧敏,2021-01-25 09:20:37,5,5,0,喜欢王老师！！！外国教育史本来做个性还很怕拖均绩，但是老师很会捞！而且讲课也特别好！
131003,5051,王慧敏,2021-01-25 14:00:59,3,3,0,太好了
133438,5051,王慧敏,2021-02-28 16:00:49,3,3,0,敏敏子的课程千万别错过！教育史萌系带盐，又是为敏敏子疯狂打call的一天！
161288,5051,王慧敏,2022-11-03 14:43:25,4,4,0,敏宝的课干货满满，敏宝的学识也超级渊博，人又非常可爱 简直是男神级别的人物，身在教院，太幸福了😭😭😭
166421,5051,王慧敏,2023-01-12 08:33:39,4,5,1,王老师真的很好😭本来期末的读书报告是想凑字数混一混的，但他批完之后还认认真真地对我文章里提出的问题给予了答复，真的很感动，感觉是为数不多会认认真真看你写的东西的老师😭
166474,5051,王慧敏,2023-01-12 10:41:03,7,7,0,外国教育史划重点+海底捞，爱了爱了～
178464,5051,王慧敏,2023-07-12 05:05:08,-5,1,6,讲课一般，可能有趣，但是为什么那么执着于介绍教育家们的生平，感觉篇幅偏重太多了，涉及不到原理性的东西，给分一般（在教院里）
182512,5051,王慧敏,2023-11-17 00:23:14,1,1,0,好老师！！！！！
188105,5051,王慧敏,2024-01-18 08:00:52,0,0,0,外教史，老师第一节课说闭卷考大家真的不用担心，他会和我们一起努力的，真的很捞呜呜，hm讲课非常非常有意思，人也很可爱，教育名著导读就直接爱上了，满分！
166104,5251,田正平,2023-01-11 06:42:22,0,0,0,田老师yyds
180074,5566,眭依凡,2023-09-20 08:47:48,0,0,0,啥也不说了，上过就知道，很伟大的教育老师，思想品德高尚，狠狠爱了，大受感动
142249,5636,韩双淼,2021-11-09 08:52:29,8,12,4,挺好的老师，会努力记住全班的名字，虽然事稍多
167051,5636,韩双淼,2023-01-14 17:27:07,1,2,1,老师挺好的
179385,5636,韩双淼,2023-09-14 02:37:22,0,0,0,很不错的
182574,5636,韩双淼,2023-11-17 14:47:18,1,1,0,会随机点人起来回答问题（变相点名）回答不出来会生气，挺凶的\n\n老师水平挺高的，挺喜欢老师的。论文写的很认真，但卡绩了，心痛
182756,5636,韩双淼,2023-11-20 05:45:06,5,5,0,韩老师和顾建民老师一起开的高等教育学，两次辩论，一次小组读书报告分享，一篇大论文，偶尔喊人回答问题当做点名。\n\n韩老师特别温柔，水平也很高，内容蛮吸引我的，是我理想中的大学老师的样子，问到了之前讲过的内容没回答上来她会批评一两句（不凶），如果是新问题她会一步步引导你往正确答案的方向想，没回答出来也会鼓励你，让我想到了“循循善诱”这个词。课下问她关于论文的问题她也很有耐心，鼓励我们创新，用了实证方法会加分。\n\n给个十分哈哈哈哈哈哈
183048,5636,韩双淼,2023-11-22 01:15:42,2,2,0,韩老师水平很高，讲课略有些无聊（但跟教院别的老师比起来还是不错的，现在只觉得自己没有好好珍惜），平时课堂也注重调动大家的思考（叫教室里的人、点名单上的名字）；老师看着有点吓人但其实很温柔，同学发言不管说成什么样都会鼓励；这门课事情还挺多的，不过给分应该是非常仁慈的（看均绩和标准差）
183368,5636,韩双淼,2023-11-24 08:32:50,1,1,0,教院一贯的给分好
199438,5636,韩双淼,2024-09-23 15:29:48,1,1,0,嗯，打过
202587,5636,韩双淼,2024-11-13 08:42:39,1,1,0,不解释
202588,5636,韩双淼,2024-11-13 08:43:44,1,1,0,给分很好，会点人回答问题，很温柔的老师qwq
125923,5803,王树涛,2020-09-15 23:55:20,2,4,2,老师有点轻重音不分，听起来有点点吃力啊，但是备课很用心，只可惜我还是太菜了，听不懂哲学与伦理这么晦涩的课😭
128215,5803,王树涛,2020-12-14 01:19:09,4,5,1,还好
141380,5818,吴巨慧,2021-10-04 00:52:07,1,1,0,好好好
124041,5866,欧阳璠,2020-06-22 07:54:28,5,6,1,这老师太不靠谱了，只顾自己搞科研，教学行政上一塌糊涂
139860,5866,欧阳璠,2021-08-03 15:50:07,8,13,5,第一次让人厌恶到极致的老师。\n\n2倍语速读完ppt\n\n让助教搞个网上平台\n\n小组讨论要录音\n\n堂堂课小组讨论？？？？？？？？\n\n\n\n你不知道你讲的我们根本听不懂吗？你不知道生生互动根本不会有实质性提高吗？\n\n\n\n水课。哦不，烂课
183480,5866,欧阳璠,2023-11-26 14:36:00,2,4,2,教育学中的数据科学，很有收获的一门课
197745,5866,欧阳璠,2024-08-08 01:43:01,2,2,0,没有任何收获
123552,5925,耿凤基,2020-06-10 01:33:27,9,15,6,老师挺好，就是……唉
124412,5925,耿凤基,2020-06-30 11:59:13,-6,3,9,老师挺可爱的，而且交流下来也十分亲切，会鼓励你也会很仔细看你的论文提建议👀就是上课好容易让我走神，学完一个学期写论文我还是一头雾水(教育评估与干预)
156830,5925,耿凤基,2022-06-21 05:12:36,-5,8,13,上的是心理学导论，老师好可爱哇！！经常会提起家里打篮球的小男生哈哈哈哈哈哈哈哈w上课上得很开心，除了考前一天速成很痛苦之外都很好！考前背了10个小时最后4.8，还不错）
156833,5925,耿凤基,2022-06-21 06:28:33,3,5,2,老师人很好，上课也很有趣。考前背书背了两天，但最后卡绩点了，88，就有点伤心......
157681,5925,耿凤基,2022-06-24 10:03:37,2,4,2,事少给分一般
167048,5925,耿凤基,2023-01-14 17:21:55,0,4,4,事少给分一般，上课有点无聊
175790,5925,耿凤基,2023-06-26 15:11:07,1,3,2,特别好的老师!~
177977,5925,耿凤基,2023-07-06 02:21:05,0,4,4,耿老师给分真的超赞，谢谢耿老师，谢谢助教姐姐
193355,5925,耿凤基,2024-06-07 03:07:09,0,1,1,老师...
194979,5925,耿凤基,2024-06-26 07:16:57,1,4,3,垃圾...
195316,5925,耿凤基,2024-06-27 17:30:35,2,5,3,上课提问贼多，给分很垃圾
195595,5925,耿凤基,2024-06-29 03:03:13,0,5,5,老师真的很好，那些自己说老师给分不好、说垃圾的，自己想一想，老师上课时自己在干啥，自己的试卷写得怎么样，找找自己的原因，老师平时分都是直给，决定成绩的应该是期末考试，老师上课提问真的有助于思考，也不搞什么回答问题就加分这种，给了大家很多表达自己想法的机会。选到耿老师是我运气好。
195816,5925,耿凤基,2024-06-30 04:55:20,0,4,4,我是外专业的，我觉得老师给分很好啊，人也很好，给分大大超出我预期了
207131,5925,耿凤基,2024-12-19 10:50:57,4,4,0,心理学导论，上课的时候很痛苦，每节课提心吊胆，因为没有生物基础害怕被点起来回答问题(主要是就算认真听课也实在跟不上她活跃的思维，听不懂她的问题)，但是，期末狂背之后给分很不错。总的来说老师人挺好的吧，被点到答不上来也没什么，就是我是个大i人，会心理不适。
215290,5925,耿凤基,2025-02-25 04:18:44,2,2,0,老师你还是赶紧取消你研究出来的小学生作业单吧、求你了 补药ej呀
215291,5925,耿凤基,2025-02-25 04:20:21,2,2,0,老师取消课堂记录单吧、老师什么时候才能意识到这是在鼓励恶竞？！心理健康课恶竞到我心理不健康了！至少限制一下字数啊、说让大家自由发挥但又会给作业评三六九等、旁边的同学恶竞到第一节课作业就写了六页后续可能还有十几页的
215302,5925,耿凤基,2025-02-25 05:01:21,2,2,0,建议取消小学生课堂记录单，反对恶竞。每上一次课写五六页的记录单怎么受得了？？？一个记录单一分多还要被卷出花样想咋样
221114,5925,耿凤基,2025-06-21 09:57:50,0,0,0,不想说什么
221160,5925,耿凤基,2025-06-21 15:26:43,0,0,0,5.0 还愿
121736,6019,程春,2020-01-21 10:09:47,-169,12,181,垃圾
121823,6019,程春,2020-01-22 06:29:31,91,105,14,程春老师的军理课很棒！每节课都能让我认认真真高高兴兴听到下课，挺有收获的。老师本人性格也特别好，很关心学生，期末复习资料也是老师发群里的。最后给分也很好。强烈推荐~
121879,6019,程春,2020-01-23 05:12:30,62,68,6,希望大家给老师一些支持！老师很努力地在讲课，但是下面很多同学在干自己的事，没有听课，这让老师觉得是不是大家听不懂所以没什么反应，还在反思自己的问题。老师您讲的真的很好，老师加油！
122088,6019,程春,2020-02-12 14:12:35,12,16,4,程春老师很好的，要求不会严，会给我们整理复习资料，上课则讲一些让我们有所收获的实在的东西。
122464,6019,程春,2020-02-28 17:07:24,197,209,12,讲道理，冬天为了防止同学们课上睡觉着凉了而把门关上，凭这个就给打满分
122485,6019,程春,2020-03-01 09:44:17,6,10,4,zsbd
123422,6019,程春,2020-06-08 15:50:32,4,6,2,老师人真的很好 特别温和可爱 大家论文认真写 考试翻书快一点就没问题啦
123569,6019,程春,2020-06-10 05:48:20,48,58,10,程春老师真的很不错！退役军人出身\n\n对知识点讲解的很透彻。\n\n最重要的是！不拖堂！不拖堂！到点就下了！！！！！不点名！！！！！期末画重点！！！！！
124505,6019,程春,2020-07-02 07:05:07,-33,9,42,其实还不错啦，就是经常点到，作为思政课很多时候真的是不想去...基本上缺勤了半个学期，全靠隔壁寝代签到，最后考试稍微准备下就行，4.2挺满意了
126033,6019,程春,2020-09-17 00:12:36,1,8,7,第一节课就让我觉得这个老师很好
126084,6019,程春,2020-09-17 08:30:32,15,20,5,第一节课讲的历史让我想起了赵晖老师的现代中外关系，我觉得老师也可以去开一门类似的通识课
126359,6019,程春,2020-09-23 16:00:48,0,14,14,这老师鼓励鹅颈，不多说了，上课要坐前面，前面他才会关注，站起来回答问题加分懂了吧，几百个人的教室
126583,6019,程春,2020-10-04 00:54:34,1,6,5,老师人看起来就很好
126690,6019,程春,2020-10-14 04:30:28,-2,27,29,鼓励恶竞，这一点非常恶心。\n\n讲课确实是比较用心的，但是方方面面鼓励恶竞，经常说这个加分那个加分，还相信自己这样做是公平的。很烦。
126692,6019,程春,2020-10-14 05:15:08,3,11,8,抢前排混脸熟，平时分加十分太离谱了
126887,6019,程春,2020-10-27 00:21:16,-7,8,15,老师除了鼓励大家卷，其他都相当好。经常在课前走到教室后面和后面的同学沟通交流，讲课也相当清楚，授课时也是多媒体与教学相结合，让人能听得进去。
127074,6019,程春,2020-11-05 08:03:07,0,3,3,老师人真的超好！
129663,6019,程春,2021-01-10 11:06:19,3,3,0,很棒的老师，除了有点卷以外其他都非常好，热心回答问题
130409,6019,程春,2021-01-22 06:56:21,5,10,5,老师人很好，而且老师虽然偶尔有点名，但这也是应该的，不然对来上课的同学也不公平，老师平时备课很认真，课余还会跟同学沟通交流，而且老师给分真的很好，都是尽可能把你往高了给，强烈安利选老师的课
130410,6019,程春,2021-01-22 06:57:52,2,3,1,老师人很好，而且老师虽然偶尔有点名，但这也是应该的，不然对来上课的同学也不公平，老师平时备课很认真，课余还会跟同学沟通交流，而且老师给分真的很好，都是尽可能把你往高了给，强烈安利选老师的课
130415,6019,程春,2021-01-22 07:26:50,10,11,1,出分了来谢谢老师，老师人真的很好，上课也挺有趣的，感觉有在听取我们的意见有在改变，比如考虑到同学们说鹅颈这个学期我们班的ppt展示也没有进行。虽然我是咸鱼从来没有发过言一直也是坐在后排，但是论文好好写考试好好准备也拿到了满意的成绩。
130422,6019,程春,2021-01-22 08:43:57,-1,3,4,军理这种课，不点名感觉都没有去教室的必要，然而老师会点名。
130451,6019,程春,2021-01-22 12:50:12,1,3,2,不错。亚撒西（笑
130456,6019,程春,2021-01-22 13:25:25,0,3,3,程春老师讲课讲得超级棒！！！而且对同学们都很和善，经常会课后和前排的同学闲聊，给分也不错！（虽然我一次都没发言，但平时分也基本满了）
130461,6019,程春,2021-01-22 14:46:32,-13,6,19,课堂点名一次不落 参与课堂问答 参与了PPT展示 论文好好写了 考试好好准备了 最后卡绩在3.6。。。不是老师的问题，但我绝对不会推荐
130466,6019,程春,2021-01-22 15:21:27,4,5,1,军理课。考试考的不太好，毕竟也没学过，cc老师捞人是真的狠，平时分直接给满，感谢老师！老师人还是很不错的！虽然发言、展示有点麻烦。
130467,6019,程春,2021-01-22 15:23:01,4,5,1,老师非常温柔，讲得也不错，事少给分还好，很考虑学生感受，不错子
130469,6019,程春,2021-01-22 15:57:20,3,4,1,非常好的老师，上课讲的生动有趣，给分也是尽量往高了给。
130470,6019,程春,2021-01-22 16:11:26,2,3,1,老师真的不错！好
130472,6019,程春,2021-01-22 16:33:25,2,5,3,一点没卷（无展示无发言）\n\n开始有认真听，后来水了（\n\n论文有认真写，虽然写的过程很痛苦（不太了解这个领域），但是最后感觉论文还行。\n\n期末开卷都翻到了，老师发的机改分数也不算低，平时分基本给拉满了，最后4.5。\n\n老是因为正态分布没办法给所有人平时分拉高，还在群里和大家说明了。\n\n是好老师！上课内容很有趣！备课认真负责！大家快来！！！！
130507,6019,程春,2021-01-23 07:37:35,14,17,3,强推，温文尔雅，关照同学。
130513,6019,程春,2021-01-23 08:12:48,0,2,2,老师真的讲的很透彻，人很好，课程有条理
130519,6019,程春,2021-01-23 09:54:58,0,3,3,老师真的很好，强推
132436,6019,程春,2021-02-01 15:09:56,34,39,5,程春老师非常博学，学期初选课的时候老师还没有评分，但评论的内容基本都是好评，学期末了，老师的评分不出意外地在9以上。老师上课非常好，给分也非常好，但是我觉得让老师上军事理论这种必修课真是屈才了，因为其本身的“水课”性质，老师的才华很难表现。老师可以考虑开通识选修课，一定能火。不过最后还是要说，希望老师不要鼓励内卷，老师的初衷是希望大家都有参与，但是还是因为这个课程本身的性质摆在那，参与度低是必然的，鼓励内卷并不会真正提高同学们的参与度。
132517,6019,程春,2021-02-02 05:31:01,11,17,6,老师讲课很认真，提醒一下学弟学妹：最后军理考试翻书一定要快，先做多选，有一些提纲上没有的题目只能大致的估计在书上哪几章然后一页页的找
133691,6019,程春,2021-03-04 01:22:10,60,64,4,2021.3.4.第一次军理课，老师说综合之前同学们的看法，课堂发言和PPT展示不计入平时成绩（没听清是不是就不进行了）。只！能！狂！喜！
134020,6019,程春,2021-03-12 02:38:45,2,3,1,老师很好
134821,6019,程春,2021-04-16 14:47:50,-1,1,2,超棒的老师！人生阅历丰富，很博学。下课经常和同学聊天。非常尊敬他
135142,6019,程春,2021-05-03 11:54:38,1,10,9,老师人很好，很认真，很实诚，也乐于回答提出的问题。\n\n有个问题，不知道是不是普遍现象，大部分课程和考试不沾边，直到快考试了才开始涉及知识点。多亏了智云课堂，我听了隔壁老师的课才把知识补上。老师可能觉得思政方面的教育更重要吧，但也可能因此没办法很好地吸引大家参与课堂。\n\n还是希望课堂一定程度上服务于考试，而不是把各个章节直接跳过，都推给课下。改善一下就完美了！
135570,6019,程春,2021-05-14 11:51:00,3,7,4,程老师真的非常认真负责。我周五晚上咨询老师关于论文的问题，本来以为等老师周一上班后才能得到回复，结果老师马上阅读并解答了我的问题。此外，程老师课也上得很好，认真听能收获很多成绩之外的东西。有被程老师感动到
136037,6019,程春,2021-07-04 00:33:36,-1,3,4,棒棒棒！
136534,6019,程春,2021-06-20 10:55:13,41,42,1,比吕强讲得好
137009,6019,程春,2021-06-29 10:01:11,1,5,4,程老师一定是讲得最好最清楚的浙大老师之一
137278,6019,程春,2021-07-03 01:26:24,3,6,3,当时就想打分，一直没登上查老师，现在快两年了。\n\n他上课真的很好，温文儒雅知识广博，给分也很好。点名会提前告知我们。\n\n当然可能和军理书上没有那么大关系，但我真觉得书本老旧没意思哈哈哈，他就是随便说说我都觉得很好。军理嘛，考前翻翻。\n\n强推
137333,6019,程春,2021-07-03 08:53:57,0,2,2,老师真的很好 很亲切 讲的也有意思 我一个女生都能听得很开心
137794,6019,程春,2021-07-06 07:02:52,2,5,3,cc老师是真的很和蔼很认真很负责的一个老师，很深刻，理解学生，强推，虽然成绩还没出，还是来给个好评！！！
137908,6019,程春,2021-07-06 14:08:51,5,11,6,老师讲得非常好，强推。然鹅令我失望的是，每次点名都在，论文认真写了，考试认真考了，最后只有3.6.但老师还是很好的
137914,6019,程春,2021-07-06 14:26:55,1,4,3,老师是好老师！！会尽力捞人也不鹅颈，取消了上课发言加分，不过上课提的问题我是真的不会回答啦，老师每次提问看没人回答都感觉很失落，下次问点简单的说不定就有人回答了！
137922,6019,程春,2021-07-06 15:01:00,2,4,2,老师很体贴啊早八会让你吃点东西，，上课真的很有逻辑，，复习课也很精髓最后考试的时候都用到啦，，给分也很好呀！
137934,6019,程春,2021-07-06 16:16:29,0,3,3,今年考试题目过于奇怪，班里最高分才80.老师还是很好的，平时分都给满了。
137945,6019,程春,2021-07-06 18:53:11,1,2,1,虽然绩点不高，但是老师讲的真的很好了
139328,6019,程春,2021-07-14 10:51:22,3,6,3,老师上课很认真，内容也很丰富。期末试卷难，老师把平时分都拉满了。
143387,6019,程春,2021-11-25 00:52:50,-41,13,54,不知道是不是今年的变化，但感觉远没有评论里说的那么好。上课像在教小学生一样，一直在讲一些很表面且刻意政治正确的内容。让人感觉不到一点点老师自己的思想。\n\n另外就是，隔壁周三班没点过几次名，就这个早八班每节课都点。迟到两次就开扣平时分，早起困难症快逃。
145176,6019,程春,2021-12-28 05:41:52,3,7,4,男神，我的男神
145281,6019,程春,2021-12-29 00:50:01,10,13,3,好老师，很和蔼可亲，课讲的很棒！有很多视频，很好看！很好说话！事少！
145879,6019,程春,2022-01-03 14:41:56,4,8,4,反正就是好好好！讲课有意思！他有经历，也清楚原理，也有很多故事！事也不多，评分标准也很棒！而且考前资料非常足！冲！
147286,6019,程春,2022-01-09 11:53:38,2,8,6,嘿嘿嘿\n\n好好好！
147459,6019,程春,2022-01-10 04:53:26,6,11,5,给分很好啊，然后讲的兼具趣味性和知识性，非常令人敬佩的一位老师。
147460,6019,程春,2022-01-10 04:57:23,-1,13,14,老师人很和善，给分巨好
147461,6019,程春,2022-01-10 04:58:33,1,7,6,讲的很棒！！\n\n不过讲得非常正确很军是真的）\n\n毕竟是部队里的政委出来的..？）\n\n给分也很棒！\n\ncc我爱你！！
147462,6019,程春,2022-01-10 05:06:28,-3,8,11,。。。
147468,6019,程春,2022-01-10 05:05:02,0,4,4,O(∩_∩)O好耶
147470,6019,程春,2022-01-10 05:07:40,-20,8,28,老师我爱你 谢谢把我捞到4.8
147476,6019,程春,2022-01-10 05:12:53,-6,13,19,cc老师好，给分差\n\nslp老师不知道，给分好\n\n自己体会
147477,6019,程春,2022-01-10 05:14:44,-2,4,6,老师简直海底捞
147483,6019,程春,2022-01-10 05:18:55,-3,8,11,给分超好
147504,6019,程春,2022-01-10 05:57:41,-11,8,19,讲课好，给分巨差
147512,6019,程春,2022-01-10 06:22:55,-18,9,27,笑面虎，给分差哭了都
147516,6019,程春,2022-01-10 06:27:12,1,4,3,老师课讲得真的好，只是我菜菜考不高，但平时分只扣一点点，最后还是能上4
147560,6019,程春,2022-01-10 08:26:17,5,7,2,吹爆cc，很温柔的退伍军人，给分也很好
147568,6019,程春,2022-01-10 08:38:15,-1,3,4,我觉得给分挺好，如果不理想，可能自己交论文或者到课就有问题。
147587,6019,程春,2022-01-10 09:05:31,5,10,5,老师很看重论文质量，那些说给分差的，你们扪心自问论文有好好写吗，格式只是最基本的要求，不是说你格式对了就要给你高分。
147626,6019,程春,2022-01-10 10:32:27,0,2,2,【军事理论】挺好的老师，退伍军人，所以讲课有战忽局那味儿，有点键政要素但是确实很有趣。本学期上课也很轻松，点名都很少（隔壁有个班点了六次，我们班只点了一次），也没有别的任务，论文+期末考试结束。
147676,6019,程春,2022-01-10 12:06:34,-3,3,6,论文瞎写的 格式也不知道对不对 期末八十出头 4.5 老师上课上得挺好的
147872,6019,程春,2022-01-11 04:49:20,-7,7,14,老师讲的确实很好，但给分。。。\n\n室友lq老师，平时课都不上能拿4.8，我每节课都到，论文严格按格式，花了大精力写了5000多，就算不顶尖也还算行吧，期末开卷不多说，最后3.6。。。倒不是说对分数不满意，或许我确实菜，但对比一下感觉自己的努力喂了🐶
147954,6019,程春,2022-01-11 08:13:03,0,2,2,老师人很好，非常理解学生。论文错过ddl，说是降档评分，但最后给分还是很不错。
148046,6019,程春,2022-01-11 11:55:42,2,3,1,老师讲的真的很棒，还特别细心温柔，好好听的会有很大的收获
148667,6019,程春,2022-01-13 07:04:04,-1,3,4,你期末拿多少分，给分就该是多少，这点对哪个老师都是一样的......没必要一直纠结老师的给分咋样，这学期上课有感，不只是军理
149141,6019,程春,2022-01-14 13:57:17,23,28,5,讲得真的好，几次想要在军理课上写会儿作业，总是被老师吸引过去，最后就干脆不写了。论文认真写，考试翻书勤快一点就行了。\n\nps:东拼西凑的东西也叫论文？（并没有针对谁，只是在朵朵上看到有人不自知感慨一下）\n\npps：我分数也不高，不是既得利者😔
149168,6019,程春,2022-01-14 15:15:46,1,3,2,点到很多，缺了几次，给分还行，关键看论文质量和考试手速\n\n考试可以不复习，但记得去蓝田买资料，配合书基本上能找到所有知识（但不包括强军思想）\n\n平时可以不去，但是注意点到
149887,6019,程春,2022-01-17 14:13:58,8,9,1,一年后来点评一下 事少给分好 老师人很好 选
153469,6019,程春,2022-04-30 14:48:52,9,12,3,一个军理老师竟然可以这么温柔，呜呜……
153814,6019,程春,2022-06-24 05:48:45,-2,22,24,很好的老师
154916,6019,程春,2022-06-07 01:53:27,-37,2,39,一般的老师
154917,6019,程春,2022-06-07 01:53:18,-39,1,40,一般的老师
154918,6019,程春,2022-06-07 01:53:18,-37,2,39,一般的老师
155473,6019,程春,2022-06-13 09:02:32,9,13,4,楼上的，最后一节课新加的所谓小测只考五个判断，而且改成三次小测取两次最高分，什么意思不是很清楚？
155794,6019,程春,2022-06-16 04:28:30,3,6,3,虽说出来的分很一般，不过应该是期末考太低的问题……吧\n\n老师还是挺好的，上课也蛮有意思
155795,6019,程春,2022-06-16 04:39:59,22,26,4,程老师真的好温柔！讲得也很有意思！我不明白为什么一门平时成绩占百分之六十的课程有三次简单的开卷小测就会被说事儿多，一个学生来上课难道真的指望自己什么都不做就拿满平时分吗？
155801,6019,程春,2022-06-16 05:01:22,11,12,1,老师人也太好了 温柔又真诚 上课也很有意思！分低是我的问题 期末实在太差了 算了下老师平时分竟然给满了 谢谢老师
155802,6019,程春,2022-06-16 05:03:20,9,12,3,老师人很温柔很温柔，最后大家的平时分基本给满了，我三次小测全都摆烂平时分还是有97，有一次坐后排摸鱼忘签到，隔了两周才想起来钉钉上和他一说就立马同意补签了。人特别和蔼，讲课也很好，最后希望选他的课的同学都少少摸鱼~感觉cc的口头禅就是“同学们看我一眼”哈哈哈
155804,6019,程春,2022-06-16 05:04:04,2,3,1,cc我的超人！！！
155805,6019,程春,2022-06-16 05:29:34,3,5,2,虽然有三次小测，我做的也不理想，但是老师还是把平时分给拉满了，老师太好啦
155806,6019,程春,2022-06-16 05:08:13,0,4,4,这么好的老师谁不爱，期末考的一如既往的烂，我根本不擅长这种考试，但老师真的很好很好。平时分基本都给满了，而且老师很有个人魅力。吐槽小测的你自己想想，除了第一次很难，剩下的几次，你稍微听一下，那不就是白送分？
155808,6019,程春,2022-06-16 05:14:32,4,7,3,平时分拉满了，我的超人
155823,6019,程春,2022-06-16 06:38:42,2,4,2,cc老师事少给分好，平时分全拉满，扣分只会扣在期末考试的40%。
155827,6019,程春,2022-06-16 07:02:59,4,5,1,很可以的老师，期末的事情老师也管不了的，需要自己花时间的，平时分老师给的超棒，选！
155841,6019,程春,2022-06-16 08:02:43,-1,2,3,老师真的是非常非常有精神又又温柔的老师！可以学到很多很多！
155912,6019,程春,2022-06-16 13:49:18,1,2,1,老师人超好，讲课很认真
155914,6019,程春,2022-06-16 13:50:57,4,4,0,老师很温柔，讲得也很好，而且平时分也全部拉满了 。\n\n别听楼下的，平时事很少，老师的小测很简单而且还是开卷，根本不需要复习= =
155973,6019,程春,2022-06-17 02:42:16,2,5,3,程春老师我的超人！
156081,6019,程春,2022-06-17 12:00:45,1,2,1,老师上课的方式真的给我如坐春风的感觉！选他！
156085,6019,程春,2022-06-17 12:22:32,3,3,0,老师巨好，平时分都给拉满了
156305,6019,程春,2022-06-19 01:53:56,11,13,2,老师讲课很好，给分也很良心，只要你上课认真听+论文认真写（不用卷），平时分是能给满的。
157157,6019,程春,2022-06-22 05:47:06,12,14,2,平时分拉满的，有些人啊，看到自己分低，第一时间就感觉是老师给分不妥，我也一样，但是看到期末成绩，心想自己哪来的脸觉得自己考的挺好？？？我真是，真是菜且不自知。感谢老师救我狗命，分数公开，非常公平，老师很好，选他选他
159170,6019,程春,2022-07-07 09:12:30,5,7,2,超级认真的老师
162494,6019,程春,2022-11-23 11:43:58,1,2,1,cc老师 课堂吸引力没话说 而且让我规范了论文格式捏
163555,6019,程春,2023-01-08 13:38:59,6,7,1,军理课，可听可水，听了会很有收获。非常认真，虽然很多同学确实不感兴趣所以没听但他也不急不恼的。\n\n事情不多，会为学生着想。给分尚且不知道，但是已经可以给他打10分了。\n\n---\n\n出分了，呜呜呜，能不能给老师打11分啊\n\n平时分拉满了，然而并不是因为我卷，毕竟期末才6打头，感觉很对不起老师
164065,6019,程春,2022-12-17 15:27:34,2,3,1,cc老师真的很好，会让我不由自主的听他讲课，课前有的时候会有雷达点名，然后会有三次小测，一个论文，事情稍微多一点，但开卷小测真的不是很逆天啊，第一次体量大了点后面马上改了，还要怎么样啊，平时分直接给我拉满了，虽然期末考一般，但cc老师是个好老师没话说！
164333,6019,程春,2022-12-20 09:56:34,-2,1,3,老师很好，非常温柔，给分超级好，最后根据期末考的成绩公示，发现自己平时分就是给满的，也非常和蔼，和他讨论军事相关问题他都能从自己的经历出发给予讲解
164358,6019,程春,2022-12-20 11:15:10,-1,2,3,程春老师真的好温柔~当你接受他的声音和何炅很像的设定时hhh打开智云以为是听到了何老师的主持
165569,6019,程春,2023-01-08 12:36:15,2,3,1,cc，我的超人！
165572,6019,程春,2023-01-08 12:39:41,1,1,0,老师真的好好，人很温柔而且会尽量吧分数往高了拉，真的，我哭死
165573,6019,程春,2023-01-08 12:41:05,1,2,1,太棒了 真的无脑冲！
165574,6019,程春,2023-01-08 12:46:15,0,1,1,老师真的好好，上课很有激情，讲的也很不错，论文按时交，平时分拉满了我哭死
165575,6019,程春,2023-01-08 12:47:21,0,1,1,cc真的好，平时分拉满！！！强烈推荐！！！
165578,6019,程春,2023-01-08 12:51:29,-1,2,3,海底捞！放心选就完了！
165579,6019,程春,2023-01-08 12:51:51,3,3,0,问了一圈，平时分几乎都给满了，神仙老师
165583,6019,程春,2023-01-08 13:12:23,1,1,0,老师上课水平高，平时分也拉满了，可冲
165586,6019,程春,2023-01-08 13:20:24,4,4,0,平时分给满了，爱死cc了。平时讲课也能学到很多东西
165680,6019,程春,2023-01-09 09:07:49,0,1,1,爱死了！大学之光
165681,6019,程春,2023-01-09 09:07:49,1,2,1,爱死了！大学之光
165700,6019,程春,2023-01-09 10:17:08,0,2,2,老师很好，平时分直接拉满
165748,6019,程春,2023-01-09 13:30:25,-2,0,2,讲课好，非常有意思，如果听了的话会收获很多。不听的话老师也不会难为你。给分也好。
165853,6019,程春,2023-01-10 06:19:55,-1,1,2,老师给分实在是太好了，平时分拉满。我论文最后期限了才交，也几乎没扣平时分（而且论文是东拼西凑的）\n\n查分的时候真的有被温暖到！同时也觉得有点愧疚，感觉自己的态度配不上这样的分。\n\n另外老师人也很好，上课也很有意思，讲得很生动，吸引人，周二下午的军理课本是容易犯困的时候，但是老师讲得有激情，我也几乎没犯过困，能很舒服地听下来。\n\n真的很好，大家可以放心选他！
166101,6019,程春,2023-01-11 06:24:30,1,2,1,很后悔前两三节课没有认真听，cc老师是首位让我觉得思政课有意思的老师😭
166139,6019,程春,2023-01-11 07:31:20,0,1,1,平时分直接给满，讲课巨认真
166192,6019,程春,2023-01-11 11:34:09,2,2,0,cc老师人很温柔，平时分给我拉满了，挽救了我的期末
166452,6019,程春,2023-01-12 09:41:04,6,9,3,春啊！你人真的太好了呀！平时分直接拉满，小测也给好多次机会，就是为了督促我们平时学习。讲真，最后复习资料包给得也很实用，看过一遍大纲和书本上考场，翻书绝对来得及
166540,6019,程春,2023-01-12 16:41:12,4,7,3,我爱cc老师！平时60%+期末40%，平时的60分感觉几乎所有人都给满了！我一个期末六十多的绩点上4了（哭哭
167007,6019,程春,2023-01-14 14:49:28,2,3,1,不多说了。备课极其认真，讲课生动有趣，语言流畅清晰，每节课都是精品，点名小测统统说得清楚，期末平时分直接全部拉满，这样的老师哪里还有？！
167889,6019,程春,2023-01-20 02:11:56,3,4,1,我绩点一般，不过讲道理，是我自己的锅，期末考得不咋样，老师把平时分给我拉满了，很感激老师，让我一个期末惨不忍睹的学生拿到了4.2的绩点，程老师万岁
167905,6019,程春,2023-01-20 05:02:42,0,2,2,讲课认真干货多，小测和点名都会提前通知，平时分会给满，值得冲
167909,6019,程春,2023-01-20 06:44:13,0,3,3,平时分拉满，期末完全是我自己的锅，好老师。\n\n想听课能听到很有趣的课，不想听课也很适合划水
169507,6019,程春,2023-02-26 13:39:00,2,3,1,程春老师超级好，还很可爱，喜欢听他讲课
170183,6019,程春,2023-03-02 01:55:37,3,3,0,好老师，居然让我认真的听了每一节课
170433,6019,程春,2023-03-04 14:03:10,3,3,0,上课很有趣，老师很温柔，然后就是给分超好😭
173995,6019,程春,2023-06-05 13:27:26,5,5,0,非常好的老师，上课讲得很好很有意思，点名会预留30分钟，作业要求讲得很仔细，考试划重点也讲得很全面，之前复习时有一题不会就钉钉私聊问了老师，结果老师直接钉钉电话打过来给我讲解了好久，真是感动
174309,6019,程春,2023-06-09 06:52:16,2,4,2,军理讲的很有趣，人也很负责，好老师
174471,6019,程春,2023-06-13 00:10:43,1,2,1,老师讲课条理很清晰，而且讲课时说话很认真，虽然成绩还没出先打个好评再说嘎嘎嘎
176677,6019,程春,2023-06-29 16:31:10,7,9,2,没出分，但是忍不住来夸！\n\n在考前晚上十一点钉钉半问了老师问题，秒回而且最后还回了我“晚安”！！！凭这个动力我直接一夜翻完一本书(۶ꈨຶꎁꈨຶ )
177147,6019,程春,2023-07-02 01:55:27,2,3,1,老师真的很好，我哭死
177151,6019,程春,2023-07-02 02:04:06,-1,1,2,出分来评价，上课时富有激情，讲的也很有趣，让人沉浸在课堂中。给分也巨好，平时分直接拉满。可以无脑选他！
177152,6019,程春,2023-07-02 02:07:18,-1,1,2,程春老师纯纯海底捞😭😭有两次没去上课真的是我不识好歹了，感谢老师！！！！！！！！
177153,6019,程春,2023-07-02 02:07:18,1,1,0,程春老师纯纯海底捞😭😭有两次没去上课真的是我不识好歹了，感谢老师！！！！！！！！
177156,6019,程春,2023-07-02 02:13:27,-1,0,1,给分很好～
177158,6019,程春,2023-07-02 02:18:19,3,3,0,cc我永远的神
177159,6019,程春,2023-07-02 02:19:43,2,3,1,究极究极好老师！上课生动有趣，小测都会在群里提前一周提醒同学参加，各种通知真的都很及时！最关键的是老师给总评时是真的捞啊！平时分基本给满的！
177161,6019,程春,2023-07-02 02:29:19,1,3,2,cc是我干爹，速冲。\n\n签到错过的话，下课去找他签都行，给我整得非常愧疚。
177167,6019,程春,2023-07-02 02:52:47,0,1,1,老师的含金量不是我三言两语能说清楚的
177168,6019,程春,2023-07-02 02:54:11,4,4,0,老师给分很好，讲课也很棒
177192,6019,程春,2023-07-02 05:04:24,0,2,2,老师讲的超级耐心细致，回消息也特别快，最后平时分也拉满了，超级喜欢老师
177204,6019,程春,2023-07-02 07:18:00,1,1,0,cc 超级温柔超级好
177216,6019,程春,2023-07-02 09:15:49,0,1,1,老师特别好！上课非常投入非常认真，对学生也很好，最后一节课甚至说花五分钟跟大家道别. 给分超好，不信你就期末的时候算一算他给的平时分是多少
177222,6019,程春,2023-07-02 09:49:07,-3,0,3,值得一个满分
177262,6019,程春,2023-07-02 12:56:40,0,2,2,超级超级超级好的一位老师，讲课特别生动有趣，也非常体贴学生，讲解清晰，最后给分也很好，大赞！
177276,6019,程春,2023-07-02 13:50:44,1,2,1,讲课和给分都巨好，很实在不说大话空话的老师
177478,6019,程春,2023-07-03 11:13:03,7,7,0,10分 cc老师非常博学多识，上课也很有趣，从来不照着念ppt（实际上他的ppt做的很有水平，如果只看不听的话是看不出啥东西的）\n\n随堂小测全是上课强调过的点，有稍微注意的话满分非常简单；数字签到他甚至把数字卸载黑板上而且开半小时，生怕智云的同学签不上\n\n以及，平时分基本上全员给满\n\n怎么会有这么善良的老师啊啊啊啊啊啊啊w
177713,6019,程春,2023-07-04 11:39:20,10,10,0,老师每节课讲完我们班同学都会自发鼓掌\n\n大家自己想吧 最后绩点4.5
177753,6019,程春,2023-07-04 15:09:08,2,4,2,是我爹
178005,6019,程春,2023-07-06 06:41:25,7,8,1,神，给分真的好，讲课也极其有趣，我早八上都没犯困过，唯一需要注意的是：他真的很爱点名
178068,6019,程春,2023-07-06 14:23:01,1,2,1,满分不多说
178293,6019,程春,2023-07-09 14:43:18,6,9,3,每节课结束同学们自发鼓掌，已经可以反映出什么了
178465,6019,程春,2023-07-12 05:06:52,4,5,1,讲课有趣而且很清楚（虽然我没怎么听），人特别好特别和善，还把我们当小学生教涂卡细则，最后平时分捞满，怒赞！（虽然我还是卡绩）
178511,6019,程春,2023-07-13 05:10:10,21,23,2,懂不懂军理双圣的含金量啊~
182051,6019,程春,2023-11-09 05:28:45,-1,2,3,真的是超级棒的老师，超级棒的课堂
184107,6019,程春,2023-12-09 11:54:25,2,2,0,好好好
184136,6019,程春,2023-12-10 16:47:44,8,10,2,现在是2023.12.11 0：40 刚过论文的ddl 我因为论文的事去打扰老师 这个点非常耐心的秒回钉钉 真的是好老师！！！
184151,6019,程春,2023-12-11 06:52:38,3,6,3,陈春老师我干爹
185613,6019,程春,2024-01-03 01:41:56,1,2,1,少数从头听到尾的思政课，很享受的课堂
185946,6019,程春,2024-01-06 09:03:34,3,5,2,特别好！去年修了他的军理，人很和蔼声音好听，课间会和同学闲聊，专业能力很强，讲得也很有趣，思路很清晰小白也很容易听懂，下课大家都自发鼓掌，而且最后平时分都给拉满了。小测成绩一开始就说最差的一次不计入平时分，很为学生考虑。
188344,6019,程春,2024-01-18 16:53:25,2,3,1,真的好老师，能选上程春老师的课是我的荣幸
188458,6019,程春,2024-01-19 04:36:44,4,4,0,必须满分！！！
188476,6019,程春,2024-01-19 05:12:42,0,2,2,老师实在太好了！
188520,6019,程春,2024-01-19 07:01:51,3,5,2,程春老师我的超人，期末65总评86
188549,6019,程春,2024-01-19 08:22:48,2,3,1,神中神，cc真的超级好
188625,6019,程春,2024-01-19 12:24:49,-2,1,3,老师真的人太好了！！签到有一次没签上，平时分还是给满了呜呜呜呜好感动
188631,6019,程春,2024-01-19 12:28:17,1,1,0,程春！神！浙大的皇帝！
188661,6019,程春,2024-01-19 13:25:37,1,3,2,平时分99，，，卧槽了，拯救我照亮我
188684,6019,程春,2024-01-19 14:12:39,5,5,0,神中神
188724,6019,程春,2024-01-19 16:56:31,0,2,2,平时分战神，期末75都能给我捞起来，一看60的平时分给了59\n\n不解释了，选他没错了
188742,6019,程春,2024-01-20 06:53:45,22,24,2,我就问，还有谁把枯燥的军理知识讲的生动有趣？还有谁会把平时分拉满？还有谁会去掉小测的最低分？\n\n学军理不选程春，就像学数学不懂微积分，听凤凰传奇却不唱最炫民族风。\n\n请跟我复述：程春，神中神！！！
189074,6019,程春,2024-01-21 15:04:08,7,7,0,老师真的很好，讲课很认真很有趣，也会认真听取同学们的建议，非常有人格魅力，给分超级好，真正为同学们考虑的好老师，千言万语表达不出我的感谢！
189289,6019,程春,2024-01-23 01:35:24,9,10,1,平时分拉满，期末84综评94，谢谢老师。平时上课生动有趣，每节课下课大家都自发鼓掌，太好了。
189662,6019,程春,2024-01-26 12:32:18,15,15,0,期末64总评86，全方位10分的老师
190057,6019,程春,2024-02-17 14:12:41,4,6,2,不说了好到爆炸
190188,6019,程春,2024-02-25 03:39:08,9,9,0,好老师！上课水平很高，认真听会很有收获的。课下一些问题会耐心细致的回答，也懂体谅学生，以至于每周的军理都变成了非常期待的课程哈哈哈哈，非常幸运能够遇到程老师~
190326,6019,程春,2024-02-28 03:51:21,6,7,1,拉满！
190505,6019,程春,2024-03-06 11:03:57,10,11,1,太有魅力了，课上想看自己的书，发现根本看不进去
192320,6019,程春,2024-05-15 03:26:29,3,5,2,程春老师真的超级好！讲话特别温柔（虽然不知道这么形容好不好）！无脑推他的军理，讲课也讲的特别好！
193589,6019,程春,2024-06-13 10:47:08,2,4,2,程春老师我滴神！
194765,6019,程春,2024-06-25 10:11:51,3,3,0,期末74总评 90 你怎能不泪流满面
194777,6019,程春,2024-06-25 11:27:28,5,5,0,先生把我平时分拉满 我必须打10分作为回报（磕一个
194800,6019,程春,2024-06-25 12:28:34,11,13,2,你不许说他，他是我爹
194808,6019,程春,2024-06-25 13:26:07,2,2,0,期末64总评86，你不是我老师，你就是我的爹！！
194817,6019,程春,2024-06-25 13:55:47,9,11,2,他是我爹，我不许你说他
194821,6019,程春,2024-06-25 13:59:52,-1,2,3,神，无需多言。
194833,6019,程春,2024-06-25 14:56:04,4,4,0,神级好老师！无论是上课还是给分都好到极致，念书以来唯一使我上课全程跟着且听得津津有味的好老师，也感谢老师的精彩授课让我期末拿了86分的好成绩，生动的授课，清晰的条理，海底捞般的给分，没有任何理由不选程春老师的军理课。
194902,6019,程春,2024-06-26 01:39:25,-1,1,2,绝对的好老师！很体谅学生，但是上课也是非常得用心\n\n绩点上也很捞，选cc不亏！！！
195082,6019,程春,2024-06-26 17:22:28,6,6,0,不准不给我爹十分，有一次睡过头没签成到都给了我平时分满分
195092,6019,程春,2024-06-26 18:14:45,4,6,2,出分了，cc老师值得一个感动浙大人物😭\n\n期末72总评4.5😭😭😭平时分真的拉满了，最后一节课老师说感谢同学们，多多包涵，没认真听过一节课的我真的内心好愧疚啊，dbq老师我一直在赶其他作业或者在睡觉😭😭😭，cc老师真的是我上浙大以来最最温柔谦和的老师之一了，爱你老师😭😭😭
195093,6019,程春,2024-06-26 18:14:57,10,11,1,你不许说他，他是我爹😭😭老师讲课水平很高（大部分时间在写作业是我的错），平时点名都是学在浙大雷达，迟到的同学可能需要注意一下是否错过（我错过了一次，但后来发现之后给老师讲，给老师发了智云课堂上我的出镜截图之后，就帮我改成已签到了，后来上课时老师还会提醒同学们今天有签到，错过的到讲台上找他改，我哭死），老师非常体谅学生，给分更是无敌，期末没好好准备开卷才考67，最后总评被捞到87，算一算发现平时分给我给了满分…真的太感动了，都给我选cc的军理！！
195133,6019,程春,2024-06-27 02:06:33,2,4,2,好得不得了与完美的一位老师！\n\n体谅学生，讲课认真，人也很萌，给分超好
195314,6019,程春,2024-06-27 17:25:12,0,2,2,平时分全满，考不好是我的问题，不是我干爹的问题。
195639,6019,程春,2024-06-29 06:20:47,3,5,2,伟大无需多言
195964,6019,程春,2024-07-01 02:57:15,6,6,0,完全我的问题，期末自己考砸了跟老师一点关系都没有，讲课也好，平时分给满，无脑选就好
196225,6019,程春,2024-07-02 10:34:47,1,3,2,数字点名，但可以“补签”，约等于不点名
196942,6019,程春,2024-07-06 03:59:58,1,2,1,大爱cc！平时分捞满！虽然自己期末考的很一般，但是实际上有认真听过每一节课，系统的学习了很多军事知识！满分不解释！
196985,6019,程春,2024-07-06 09:29:41,2,3,1,平时分真给满 一分不扣 神
197069,6019,程春,2024-07-07 05:56:56,1,4,3,老师上课讲得很好，不过我这学期太忙了一直在写作业，最后期末也没考好，但老师真的太捞了，直接把平时分拉满，我这样总评都能上90，感谢老师
198022,6019,程春,2024-08-24 15:33:49,3,3,0,幽默并专业，温柔且关照
198331,6019,程春,2024-09-07 07:40:19,2,4,2,非常负责且热心的老师，在群里耐心回答同学们的问题！
198427,6019,程春,2024-09-09 02:03:12,4,5,1,给分很好，论文写了就满分，随堂测验都是讲过的，老师很和蔼
198456,6019,程春,2024-09-09 04:43:30,3,5,2,很好的老师，讲课、人品、给分
198483,6019,程春,2024-09-09 07:31:17,1,4,3,老师上课非常有趣！强推！
198584,6019,程春,2024-09-10 05:34:13,-1,0,1,111
198731,6019,程春,2024-09-11 07:00:15,4,4,0,特别特别好的老师
198947,6019,程春,2024-09-13 09:54:52,5,5,0,人品无敌、无敌热心
199509,6019,程春,2024-09-25 00:20:39,0,1,1,老师太棒了，学识渊博，温文尔雅，超级棒！！！
199923,6019,程春,2024-10-08 11:19:57,2,3,1,程春老师很好，讲课很生动有趣，军理必选
200937,6019,程春,2024-10-25 04:39:57,3,4,1,ccwan
201046,6019,程春,2024-10-28 02:14:51,2,3,1,很好的老师
201288,6019,程春,2024-10-31 06:26:43,5,6,1,今天老师来带了一节课，讲得真好
201349,6019,程春,2024-11-01 04:04:43,4,5,1,伟大，无需多言
201471,6019,程春,2024-11-03 14:18:15,36,36,0,my cc98，my home.\n\nmy cc，my family.
201655,6019,程春,2024-11-05 07:02:08,6,6,0,集人格魅力与专业素养为一体的老师\n\n听他讲课有一股浩然正气 满满的正能量
201836,6019,程春,2024-11-07 00:47:00,5,6,1,补发一个评论，我是去年选的cc老师的课，当时离论文ddl还早的很就肝完后就去问老师能不能帮我看看有没有什么问题，然后老师钉钉通话跟我聊了好久，超级耐心地跟我讲解有哪些不足之类的。上课讲的也好，放心选就是了
202810,6019,程春,2024-11-14 13:22:21,1,3,2,好老师
203065,6019,程春,2024-11-16 07:49:25,6,7,1,真好啊老师！雷达点名会开一节课，钉钉上问他问题也超级超级亲切！！！上课也很有趣
204549,6019,程春,2024-11-26 14:49:58,4,4,0,超级超级超级超级超级超级超级超级超级超级超级超级超级超级超级超级超级超级超级超级超级超级超级超级超级超级超级超级棒！！！！！！！！！！！！！！！！！
204668,6019,程春,2024-11-27 08:50:47,8,10,2,浙大最好的老师之一（我心目中唯一最好的），当之无愧
205114,6019,程春,2024-12-02 00:15:32,5,6,1,太太太太太太太太太太太太太太棒了吧！\n\n又划重点又给资料的老师简直太神仙了！
205790,6019,程春,2024-12-12 04:05:47,0,2,2,神中神，讲课好+给分好+人特别可爱QAQ
205808,6019,程春,2024-12-12 05:45:49,3,3,0,完美的老师
205905,6019,程春,2024-12-12 14:48:30,2,3,1,非常好
205971,6019,程春,2024-12-13 02:24:10,2,2,0,老师很好，就是査老师后过来上课的，确实值得10分，上课很细心为同学考虑，课后还很为同学考虑！
206043,6019,程春,2024-12-13 03:47:14,3,3,0,在最无能为力的课上遇到了最不想辜负的老师，唉——
206185,6019,程春,2024-12-13 07:29:55,3,4,1,程春老师真的绝世好老师，很有教学追求，所以上课真的上的很好，老师之前在部队待过，将军火理论部分真的很有意思……但是又对同学很好，平时分基本都是给满的，如果总评卡绩了，基本上都是老师平时分已经拉满但是还是救不了的情况（和同学亲自算过了），大家期末考前最好还是把书看一遍，画个重点，不要像我这个裸考的菜菜对着崭新的书阅读障碍了……
206291,6019,程春,2024-12-13 14:53:16,1,2,1,特别好的老师 讲课水平好 人品好 性格好
206471,6019,程春,2024-12-15 11:32:30,4,5,1,cc老师我要追随你一辈子
206702,6019,程春,2024-12-17 07:03:39,1,2,1,yyds，超级好的老师，今天早八睡过头了，到教室的时候已经下课了，但给老师说了一声老师还是给我补签了
206747,6019,程春,2025-01-10 01:01:00,18,18,0,无论你想认真听课还是想水课，选cc老师没错了！老师真的特别特别好！把那么无聊的内容讲得很生动，而且签到什么的都很宽松。一个为学生着想的好老师，最后的分数卡绩了，但是算了一下，老师把平时分给满了，那没办法了🫶🏻
206749,6019,程春,2024-12-17 11:01:27,3,3,0,老师很温柔很关心学生，有时候在课上干其它事都会有点愧疚
207104,6019,程春,2024-12-19 08:53:56,1,3,2,满分好老师，我甚至不看绩点就打分
207722,6019,程春,2025-01-10 01:03:53,5,6,1,老师超级好，讲课生动有趣，为学生考虑，给分也很棒（硬生生把我的绩点捞高了一个档次哈哈）\n\n我不允许老师的评分不是10.0！！
207753,6019,程春,2024-12-24 07:01:48,-2,0,2,必须满分
207754,6019,程春,2024-12-24 07:01:56,0,1,1,很好的老师，(*¯︶¯*)
207775,6019,程春,2024-12-24 08:12:08,2,2,0,无时无刻不在为同学着想的好老师
207961,6019,程春,2024-12-25 05:34:41,0,1,1,无需多言 助力10分😎
207993,6019,程春,2024-12-25 07:00:15,1,1,0,男神！
208018,6019,程春,2024-12-25 08:18:37,0,1,1,大一遇到的第一个好老师
208049,6019,程春,2024-12-25 10:24:18,-2,0,2,特别好
208129,6019,程春,2024-12-26 01:10:26,-1,0,1,男神～
208190,6019,程春,2024-12-26 06:20:20,0,0,0,伟大无需多言
208547,6019,程春,2025-01-03 14:36:40,1,1,0,老师给你10分保佑我吧
208946,6019,程春,2025-01-03 13:31:54,0,1,1,上课生动活泼，课后认真负责，神老师
208988,6019,程春,2025-01-04 05:44:08,2,3,1,很后悔这学期翘了好多节早八😭😭非常对不起程老师😭😭\n\n智云复习的时候听了最后一节课程老师的结课感言真的很感动🥹🥹非常好的老师！值得满昏！
209072,6019,程春,2025-01-04 10:53:49,-1,1,2,伟大，无须多言！\n\n上课很有意思，我认真地听了每一节课！老师对这门课是真的有情怀的！\n\n考场上翻不到题是我自己的问题😭老师是绝世好老师，写论文在钉钉问老师相关问题都是秒回，而且很耐心很温柔，男神！！！
209166,6019,程春,2025-01-05 01:38:46,1,3,2,超级可爱的老师～他的军理真的能学到东西！你会发现春老师的知识面超极广，政治、历史、地理他都懂。喜欢听他讲自己从军人一步步迈向教师的故事，真的是一个非常热爱军事也热爱学习的老师！
210593,6019,程春,2025-01-09 11:44:20,0,1,1,上课真的很生动，是会把我从ddl中吸引出来听课的水平，小测也会专门提醒，虽然现在还没出分但是单讲课水平给满分
210710,6019,程春,2025-01-10 01:03:33,5,5,0,好老师，无需多言，艾斯
210716,6019,程春,2025-01-10 01:11:31,-24,3,27,老师人特别好\n\n但是期末卡我绩Ծ‸Ծ
210720,6019,程春,2025-01-10 01:17:36,2,3,1,伟大，无需多言！
210724,6019,程春,2025-01-10 01:20:36,3,3,0,爆灯！！爆灯！！cc老师我们喜欢你
210725,6019,程春,2025-01-18 08:36:31,3,4,1,伟大无须多言
210728,6019,程春,2025-01-10 01:23:42,2,3,1,CC太好了呜呜呜呜，平时分给满了，真的感谢CC老师！老师讲的很好，而且能感受到老师在努力用各种各样的方式把枯燥的书本知识生动起来…特别好的CC！我们爱你！！！
210738,6019,程春,2025-01-10 01:40:45,1,2,1,真的好老师，上课很有意思，而且给分是真的会捞人！
210746,6019,程春,2025-01-10 01:46:38,0,1,1,神中神，都来选cc老师的课\n\n为了捞人平时分都是给满的
210747,6019,程春,2025-01-10 01:47:05,4,4,0,课讲的很吸引人，而且老师人不错，可以和他聊有关军事和历史的很多东西。期末总评他已经尽力捞了，可惜期末考太低，他捞不动，只有3.9，不过确实挺喜欢他的课，满分送上
210751,6019,程春,2025-01-10 02:00:38,-1,0,1,神中神
210753,6019,程春,2025-01-10 02:03:20,2,2,0,很好很有水平的老师，上课真的非常有激情，非常有深度
210754,6019,程春,2025-01-10 02:05:43,1,1,0,海底捞名副其实!!!!你把学生放在心里，学生把你高高捧起！！\n\n我期末考太差了呜呜呜呜 还是硬生生给我捞上了一个层级！！这门课绩点偏低和老师真的没有任何关系...他已经尽自己所能用一切方法提高我们的成绩了
210755,6019,程春,2025-01-10 02:11:12,-1,0,1,神捞，简直就是义父
210757,6019,程春,2025-01-10 02:14:00,1,1,0,出分了，cc太好了😭，平时分基本上给满了😭
210760,6019,程春,2025-01-10 02:16:02,0,0,0,单从授课水平上说，程老师也算是讲的很生动形象的老师了，而且老师自身阅历也十分丰富，在课堂上还能听到很多有趣的小故事。本人是易困体质，但是在早八程老师的课堂上还是能顶住不睡的，感觉还是课堂知识有亮眼有趣的部分的原因。至于最后的给分，我个人感觉老师给分蛮好的，虽然我的期末成绩不算很高，但是最后的成绩仍然不错，自己一算老师已经把平时分给满了。呜呜呜呜呜，鬼知道我那个论文写的什么东西。总而言之，程老师的军理课还是很不错的，老师人也很有耐心！
210762,6019,程春,2025-01-10 02:16:37,1,2,1,海底捞的好老师，为了捞同学们平时分都快给满了。讲课也非常非常有意思。非常好的老师，选！！
210768,6019,程春,2025-01-10 02:24:28,2,3,1,期末卡绩心碎碎的 拿着卷面分一算平时成绩 好家伙 原来平时已经拉满了😭完全是我的问题 cc配10.0😭
210771,6019,程春,2025-01-10 02:32:24,0,1,1,老师味大，无需多言！！
210796,6019,程春,2025-01-10 03:14:41,1,1,0,伟大，无需多言！
210814,6019,程春,2025-01-10 04:11:14,4,5,1,cc老师应该是点名的，不过是应校方的要求，一个学期应该点到不超过5次，而且是允许请假的，请假原因放得很宽（他自己说之前有一个学长向他请假说跟女朋友闹分手要去挽回他也给批假了），真的是很宽容很开放的老师。而且上课非常地有意思，我愿意评为我在zju修过的最有趣的一门课，他讲的课真正能让人觉得把上课时间用来赶deadline是很浪费的一件事。一个学期有四次小测，但是只计算三次较高的成绩，也就是说允许你有一次小测不来。另外期末考试cc老师真的替大家准备得很全，（虽然军理上课听了跟没听差不多因为根本记不住），但是他会给你划重点，并且会告诉你哪些章节PPT是需要印下来的，除此之外他还会提供之前学长整理的类似军理教材大纲的一个文档，考试的时候借用文档来翻知识点真的很方便，大大提高了做题速度和准确性，对于不熟悉教材的同学简直是如有神助。平时会有一篇论文要求交，只要你认真写了，平时分应该都给满的，真的超级能捞，哪怕上课的时候一节课都不听（但是还是建议听一下的，因为关系到小测），只要你平时论文认真写了，单单凭他发下来的复习资料，可以保你上4.2，真的是海底捞老师。这么好的老师10分送上！虽然以后可能不再听他的课了，但是我会一直铭记他！
210826,6019,程春,2025-01-10 04:40:23,0,1,1,老师课讲得很有趣人也很好，就是点名次数有那么一点点小多，课堂氛围也比较轻松。最后成绩虽然不好看，但算了一下平时分几乎被拉满了，是我的问题😭最后吹爆cc🫶🏻
210836,6019,程春,2025-01-10 05:08:42,0,1,1,提早下课，且平时分拉满！！
210845,6019,程春,2025-01-10 05:30:17,-2,0,2,cc老师我的神啊啊啊啊啊啊！！！！！上课超级认真超级有趣，绝对负责，特别温柔，而且有分他是真的捞啊啊啊啊啊！！！！
210852,6019,程春,2025-01-10 05:33:33,4,4,0,军理课首推cc老师！如果你喜欢军事，你可以在老师深入浅出的有趣讲述当中学到很多东西；如果你不喜欢军事，那冲着老师只有一篇要求1000字以上的小论文的作业/给满的平时分/贴心提供的划重点和整套考试资料/极为宽松的补签等等也应该选cc老师！！而且老师说卡绩也不是他想，是因为提交比例受限，以及总分低真的是期末考试不给力的原因（资料还挺难翻的，基本都六七十分）。反正遇到这样的好老师我课都不敢翘了，感谢老师把我捞上4分！
210882,6019,程春,2025-01-10 05:55:19,0,0,0,老师很好！平时分拉满了！
210957,6019,程春,2025-01-10 08:39:18,-1,0,1,大爱cc老师！！上课幽默风趣特别有意思，平时分基本给满，期末也不卡绩，伟大无需多言！
210978,6019,程春,2025-01-10 09:09:51,1,1,0,“请同学们抬头看我一下。”老师讲课很有趣，并不枯燥，不管是听课还是摸鱼都可以😌点名次数相较于隔壁lq老师多一些，而且还有小测，一共四次取其中三次最高。很惭愧本人没怎么听过课，小测应该是有一些错的，而且论文也是ddl赶了一晚上赶出来的，质量只能说及格的样子…但老师人真的很好，最后算了一下平时分是给满的。神。
210986,6019,程春,2025-01-19 10:58:27,2,3,1,老师上课特别有意思，特别好玩，人格魅力拉满，真的狂推cc，是我有事情都想乖乖听他的课，打call打call
211065,6019,程春,2025-01-10 12:43:15,-1,0,1,老师特别好！！讲课很好给分也很捞，最后卡绩是我自己期末没考好，老师已经把平时分给满了，大爱cc老师！！！
211137,6019,程春,2025-01-11 01:31:37,1,2,1,老师人特别特别好，平时签到就算没签上说明理由也都能补签，平时分只要认真完成到课和论文就基本是满分，给cc打出毫无争议的十分！
211612,6019,程春,2025-01-12 04:17:02,1,1,0,平时分给满了，但耐不住我期末考太差了，后人一定要好好听课啊，cc老师超级无敌好
211624,6019,程春,2025-01-12 05:02:52,1,3,2,cc老师绝对值得10分！选就完了！平时分包括签到+课堂小测+论文，基本都给满了！期末考开卷但是很难找，还是被老师捞到89了！谢谢老师！我爱你
211708,6019,程春,2025-01-12 08:35:24,3,4,1,跟着程老师上课真的能收获很多东西，很感谢程老师！（老师平时分给满了，但是我感觉军理开卷考还是要复习的，不要像本人一样一点没复习结果翻不到然后考个61就行）
211770,6019,程春,2025-01-12 11:19:02,-2,2,4,签到都签上，小测好好做，论文认真写（可以找程老师交流修改，老师真的特别特别负责有耐心），考前熟悉一下课本，基本上就是4.5以上了\n\n神🙏🏻🙏🏻🙏🏻
211840,6019,程春,2025-01-12 16:12:04,0,0,0,课讲的很好很有激情 有些课上我不赞成的观点提出来跟老师讨论也很亲切 推荐！
211845,6019,程春,2025-01-12 16:26:51,3,4,1,老师伟大无需多言，十分送上。建议军事理论期末考试更改题型，单一的选择题无法全面体现复习程度，随机性较高。
211886,6019,程春,2025-01-13 01:10:42,1,3,2,10不解释，军理唯一真神
211927,6019,程春,2025-01-13 02:01:04,-6,4,10,上课一学期逃课半学期，期末差点没写完，论文写得也一般般，出分捞上4.5，程老师神
212158,6019,程春,2025-01-13 09:26:45,2,3,1,很具有人情味的一位老师
212189,6019,程春,2025-01-13 10:36:18,4,4,0,神中神不解释\n十分
212527,6019,程春,2025-01-14 06:44:49,4,4,0,大学进校遇到的最好的老师！10分就是10分！不接受任何异议
212671,6019,程春,2025-01-14 12:10:25,4,4,0,海底捞！伟大！
212678,6019,程春,2025-01-14 12:24:06,3,3,0,选到cc的课就是赚到🥰
212723,6019,程春,2025-01-14 15:05:35,2,3,1,老师很努力的想要吸引同学的注意力，老师很好，军理这门课确实没什么意思，但是老师狠捞！
212835,6019,程春,2025-01-15 04:25:40,1,3,2,无敌老师，平时分全部拉满
212881,6019,程春,2025-01-15 06:56:26,1,2,1,平时分直接拉满，吹爆
213186,6019,程春,2025-01-16 09:01:02,2,3,1,备课认真，平时分给满，伟大无需多言！
213470,6019,程春,2025-01-17 14:04:28,2,3,1,伟大无需多言
213916,6019,程春,2025-01-21 08:56:30,3,4,1,海底捞的神
213929,6019,程春,2025-01-21 12:46:05,3,4,1,无需多言
213932,6019,程春,2025-01-21 15:16:34,0,2,2,老师太努力了，伟大无需多言
214587,6019,程春,2025-02-14 03:27:31,9,9,0,程老师我男神。军理期末考考不好了，出分的时候觉得不可思议，联系程春老师后，程老师非常尽职尽责，直接把我的答题卡拿出来手改了一遍，发现我确实是错了好多，但是程老师主动安慰我。上了程老师的课你就会发现这么好的老师世界上遇不到第二个了。
214690,6019,程春,2025-02-17 00:37:15,4,4,0,伟大无需多言！
214828,6019,程春,2025-02-18 06:23:29,18,18,0,上大学以来遇到的极少的对同学负责、真正充满教学热情的好老师，即使是一个对军事无感的同学，也能自然地沉浸在程老师的课中，包括充实严谨的知识、幽默风趣的讲述还有结合时事的社会责任感，还有一个印象深刻的，就是课堂互动是使用扫码文字表达，i人天堂。\n\n真正的学生喜欢的深入浅出的课，可见真心和诚心。\n\n从功利的成绩角度来说，程老师点名稍微有点多，但是！缺勤一两次都没有关系，一般会把平时分拉满的，真的是一个很关心同学真切需求而且做出实际行动的老师。
214843,6019,程春,2025-02-18 08:02:50,-9,0,9,课堂是有趣的，但可以补签是谣传
215298,6019,程春,2025-02-25 04:30:21,15,15,0,老师开通识课吧！！只教军理太浪费啦
215375,6019,程春,2025-02-25 12:35:23,6,6,0,老师真的很好，我期末考试没及格，但是论文很认真在写，老师也是把平时分拉满了，让我的成绩没那么难看，总之老师会看到你的努力，即便是在军理课
215663,6019,程春,2025-03-04 00:11:32,4,4,0,非常好的老师！给分好，期末发资料划重点，只是每节课都要雷达签到，但是老师本人真的超级好超级好超级好！讲课很有意思！
215864,6019,程春,2025-03-06 06:34:25,2,3,1,致敬salute
216718,6019,程春,2025-03-22 10:33:15,2,3,1,好老师！
219063,6019,程春,2025-05-20 07:41:15,3,4,1,很能共情同学的好老师，非常包容、开放、有热忱
219551,6019,程春,2025-05-29 13:49:32,0,2,2,很有魅力的老师
219820,6019,程春,2025-06-07 12:30:00,0,1,1,伟大无需多言
220159,6019,程春,2025-06-16 02:17:35,2,3,1,老师真的非常好耶，最喜欢的老师之一，好在方方面面🥰🥰
220321,6019,程春,2025-06-17 08:45:34,1,1,0,出分了，谢谢老师，老师平时分捞满，最后捞了一把让我没有卡绩
220322,6019,程春,2025-06-19 07:10:58,3,3,0,钉钉上几乎有问必答，很耐心的男神老师，凭什么不是9.99
220323,6019,程春,2025-06-17 08:49:11,2,2,0,伟大无需多言！平时分拉满了老师😭
220327,6019,程春,2025-06-17 09:09:11,-8,0,8,被赤石期末卷绩杀，枉费军理论文，最终还不如别人分高。
220328,6019,程春,2025-06-17 09:15:02,3,3,0,虽然军理最后分数不理想，但是再让我重新选我依旧选程春老师
220332,6019,程春,2025-06-17 09:34:22,0,0,0,伟大无需多言，平时分直接拉满了，男神！！！
220397,6019,程春,2025-06-17 16:05:57,0,0,0,我永远爱泥鸭🫶
220428,6019,程春,2025-06-18 02:20:01,2,2,0,cc老师讲课激情满满而且简单易懂，给分也超级好，宝藏级别的老师
220446,6019,程春,2025-06-18 03:14:19,1,1,0,老师开点别的通识课吧我真的会选的\n\n至于其他的～伟大无需多言
220458,6019,程春,2025-06-18 04:30:41,3,3,0,军事理论，cc老师已经把能捞的捞满了，只要正常完成小测论文平时分就几乎是满的了。可惜这次期末卷子……一言难尽。听了以往的经验没有多做准备，但占总评40%的满是客观题的期末使我终究是没有上4……
220475,6019,程春,2025-06-18 06:24:59,2,2,0,程老师讲的很好，但终究是我期末没考好没上4哭
220538,6019,程春,2025-06-18 12:08:21,0,0,0,是我太菜了老师对不起您
220967,6019,程春,2025-06-20 13:28:41,1,1,0,老师很好，平时分拉满，课也上得很好，伟大无需多言\n\n就是军理这门课真的太烂了
220976,6019,程春,2025-06-20 14:04:43,1,1,0,cc老师人真的的特别特别好，可惜军理期末卷子不当人
221058,6019,程春,2025-06-21 05:18:46,1,1,0,cc老师真的超级好，班里平时分基本给满了，上课水平也很高，是可以无脑冲的老师！
127073,6310,刘海峰,2020-11-05 06:59:33,1,3,2,我的妈这么可爱的文科资深教授只此一家好吗？吹爆不解释～
142279,6310,刘海峰,2021-11-09 23:37:36,2,3,1,独树一帜，大家风范
169782,6310,刘海峰,2023-02-28 01:26:04,2,3,1,超级棒
216232,6310,刘海峰,2025-03-12 15:00:06,0,1,1,很好的老师
205332,6628,杨娟,2024-12-04 12:23:49,0,0,0,纯傻逼，什么都不知道，还在那里指指点点
122710,6877,马静萍,2020-03-23 09:49:37,1,1,0,无语。。。
143867,6877,马静萍,2021-12-09 09:56:40,1,1,0,真的有病
171375,7061,陈娟娟,2023-03-23 00:10:13,7,11,4,提问莫名其妙，上课极其划水
171720,7061,陈娟娟,2023-04-03 06:58:56,7,14,7,老师人挺好的。虽然上课感觉不太熟练，但是即时向老师反馈请教，还是很有收获的
172004,7061,陈娟娟,2023-04-17 03:37:22,5,6,1,傻呗老师🙄
172585,7061,陈娟娟,2023-05-01 02:56:30,-3,3,6,老师的上课融入了项目化学习和基于设计的学习，体验式学习很不错，理论课可能一点干，但内容很不错
172602,7061,陈娟娟,2023-05-01 17:00:29,9,11,2,理论课上的乱七八糟，提问学生的都是一堆无聊又没意义的问题、像在水时长。娟姐作为教育学院的老师，教学成这个样子是蛮无语的哈。
172616,7061,陈娟娟,2023-05-02 07:09:40,4,5,1,考核标准变来变去，最后被绩杀
178958,7061,陈娟娟,2023-08-05 16:24:50,-2,1,3,老师人很好！
191161,7061,陈娟娟,2024-04-10 04:32:13,9,9,0,快跑！！！！！！！！！！！！！！！
191162,7061,陈娟娟,2024-04-10 04:33:23,6,6,0,上课烂的要死、
191191,7061,陈娟娟,2024-04-12 05:10:19,9,9,0,每周一张的思维导图，我自己做的方便理解复习不就好了，非得要什么“联系”。。。干干净净的思维导图你不要，知识点拆的七零八落然后加上歪七扭八的箭头你就能给99分，无语死了
191234,7061,陈娟娟,2024-04-14 09:58:05,2,2,0,，，，
192192,7061,陈娟娟,2024-05-11 06:36:46,7,7,0,快跑啊！！！！千万不要选她，不然整个短学期都会感觉像吃了屎一样难受
215434,7061,陈娟娟,2025-02-26 05:58:37,4,4,0,陈老师的课给人一种如上的感觉，能体会到左脑攻击右脑的感觉。可能老师在如何教学方面还是存在一些问题。但是老师上的课就是学习科学与技术啊。哈哈，只有苦笑啦。
215436,7061,陈娟娟,2025-02-26 06:10:57,1,1,0,快润。
215437,7061,陈娟娟,2025-02-26 06:13:00,1,1,0,five
218234,7061,陈娟娟,2025-04-22 06:41:06,0,0,0,没吃过屎的可以上
184237,7648,邹昱,2023-12-13 14:11:34,2,5,3,邹老师人很好很随和，会认真教好课堂知识，对学生也很耐心，只要不是特别离谱，给的分都挺好的，会点名
136236,7698,丁莺,2021-06-13 09:34:34,3,4,1,老师很用心
136237,7698,丁莺,2021-06-13 09:34:42,5,6,1,老师非常好 非常负责任 专业知识专业技能很强 脾气很好
141550,7698,丁莺,2021-10-14 03:53:35,1,1,0,可以啊
155170,7698,丁莺,2022-06-09 04:33:20,1,1,0,好的很
155528,7698,丁莺,2022-06-14 04:24:56,4,4,0,老师非常认真 非常好 非常漂亮
160102,7698,丁莺,2022-09-13 07:50:26,0,0,0,老师真的很赞！
161431,7698,丁莺,2022-11-07 02:19:01,0,0,0,老师很好 非常好 超级好
163728,7698,丁莺,2022-12-16 04:22:30,0,0,0,老师超帅超温柔
171713,7698,丁莺,2023-04-03 02:31:45,0,0,0,这辈子碰到的最好的教练
172140,7698,丁莺,2023-04-20 10:33:55,-1,0,1,很不错 老师很美 很负责任 很好 非常好 专业水平十分高
186466,7698,丁莺,2024-01-11 08:11:19,0,1,1,我不明白为啥我每天到的平时分和请假的人的平时分是一样的
188788,7698,丁莺,2024-01-20 02:38:46,-1,0,1,给10分是因为最高只有10分
139920,7909,李木洲,2021-08-19 10:41:38,-2,4,6,好老师，讲课娓娓道来
141197,7909,李木洲,2021-09-26 05:24:06,2,4,2,还是睡觉的收益比较大
141198,7909,李木洲,2021-09-26 05:24:32,-2,0,2,可恶，不懂他\n\n一个简单的讨论课没通知就算入成绩\n\n可恶
141199,7909,李木洲,2021-09-26 05:24:42,2,2,0,hmmm...
149497,7909,李木洲,2022-01-15 15:46:49,8,10,2,虽然老师讲课没有孙元涛老师那么有趣，但还是很用心的，没什么鹅颈，课程任务也不多（没有恐怖的五千字论文），考前会划重点，给分也很好滴！10分献上
161307,7909,李木洲,2022-11-04 03:28:15,1,2,1,父权制拥趸，教学计划稀烂，嗯嗯
168921,7909,李木洲,2023-02-23 12:31:48,0,0,0,人好事少给分好，讲课有点无聊
169784,7909,李木洲,2023-02-28 01:38:59,1,1,0,特别温文尔雅的老师
187630,7909,李木洲,2024-01-17 02:28:52,0,0,0,上课不点名但是会随机点人回答问题，没到的直接视为旷课一次了。别的都还行。
187633,7909,李木洲,2024-01-17 02:29:26,0,0,0,不点名但是上课会抽人回答问题等于点名了
216231,7909,李木洲,2025-03-12 14:59:39,0,0,0,很好的老师
153345,7922,翟雪松,2022-04-28 09:07:19,3,3,0,分数迷
153956,7922,翟雪松,2022-05-18 03:29:10,5,5,0,上课完全没有按照课程大纲走\n\n给分很迷\n\n学弟学妹慎选
173430,7922,翟雪松,2023-05-24 07:00:05,2,2,0,水平很低
173474,7922,翟雪松,2023-05-25 15:22:34,3,3,0,真的不行，水平太低
191543,7922,翟雪松,2024-04-24 12:05:09,1,1,0,给分还行，没有那么糟糕吧
130465,7941,吴寒天,2021-01-22 14:59:41,29,30,1,好老师！讲课特别生动可爱，人超级亲切~
133679,7941,吴寒天,2021-03-03 14:04:53,26,28,2,幽默风趣才华横溢魅力十足激情满满\n\n第一周就种草了\n\n这可能就是未来的爆款吧☆ﾐ(o*･ω･)ﾉ
135960,7941,吴寒天,2021-06-05 15:33:08,29,30,1,希望教院能多引进一些寒天老师这样科研能力强，上课内容充实，幽默风趣，关心学生的老师！
140905,7941,吴寒天,2021-09-17 14:28:30,16,16,0,寒天老师人超级好，讲课内容丰富，专业，幽默～
154846,7941,吴寒天,2022-06-06 07:15:56,3,3,0,爱老师
164133,7941,吴寒天,2022-12-18 09:34:55,2,2,0,很好！
177525,7941,吴寒天,2023-07-03 15:02:47,11,11,0,21级的改名后三位老师一起上的比较教育学没有发过言（发言占20%），被狠狠绩杀，后面的同学一定要多多卷发言，不要像我一样小丑😅吴老师的上课水平还挺高的，可以听一下
187792,7941,吴寒天,2024-01-17 12:49:48,7,7,0,吴老师授课水平和科研水平都比较高，幽默风趣，博闻强识，是不可多得的好老师，能学到有价值的知识。给分也很不错～\n\n这学期修读了全英文的全球高等教育与国际化通论，吴老师的英语很好听也很好听懂，课堂上鼓励大家用英语表达自己的观点，我感觉自己通过吴老师的课程很好的锻炼了英语的听读能力～非常推荐的一位老师！
143062,8134,于洁,2021-11-18 14:03:47,1,6,5,无语，别选！！！！！\n\n绩点拉胯至极也无语至极
145891,8161,汪靖,2022-01-03 23:09:55,-5,6,11,很傻叉
168273,8161,汪靖,2023-02-08 09:23:31,0,3,3,人好事多给分高，专业课也能理解事情比较多 但是很有收获
187509,8161,汪靖,2024-01-16 12:00:56,0,0,0,可爱捏，但感觉课有点难
135479,8191,陆彬蔚,2021-05-11 07:41:21,14,14,0,好看，我喜欢
136034,8191,陆彬蔚,2021-06-10 01:42:52,8,9,1,lbwnb
150894,8191,陆彬蔚,2022-02-21 01:34:42,3,4,1,温柔又美丽╮(￣▽￣)╭
172380,8191,陆彬蔚,2023-04-26 00:13:03,3,5,2,小陆老师真的很可爱，喜欢讲性别的那一块课程
191738,8191,陆彬蔚,2024-04-29 08:57:03,1,3,2,温柔可爱，但是讲课没重点且混乱
170601,9466,段世飞,2023-03-07 05:27:49,-7,3,10,首评！段老师上课挺好的，不过可能因为他太牛逼，所以他对我们要求也很高
181260,9466,段世飞,2023-10-12 11:39:43,-5,5,10,满满都是干货
181684,9466,段世飞,2023-10-28 04:28:20,-2,7,9,本科以来，在我心目中绝对水平和人品top 3的老师，为人真诚，上课也不会讲废话，关爱学生（本来想说top 1，谦虚一点hh）
181890,9466,段世飞,2023-11-03 12:54:58,-4,5,9,虽然经常旷课，咳，但是很喜欢这个老师
182897,9466,段世飞,2023-11-21 04:04:39,-4,5,9,特别特别好的老师
182924,9466,段世飞,2023-11-21 06:13:51,10,20,10,上课的内容和德育原理毫无关系\n\n整体比较肤浅 浮躁 像是论文辅导机构的销售人员\n\n非常不推荐
183202,9466,段世飞,2023-11-23 00:04:53,4,8,4,不踏实，希望老师先做好本职工作
183224,9466,段世飞,2023-11-23 02:27:13,5,10,5,上的德育原理，怎么说呢，讲的内容和德育没什么太大的关系\n\n感觉到老师很认真的想讲好，但是还是需要关注课堂需求\n\n给分也没有想象中的好，只能说中规中矩
184311,9466,段世飞,2023-12-16 14:15:22,4,6,2,感觉这个老师没有备过课（个人感受），上课完全是随性发挥，但是本身又没有这么多的积累\n\n还是希望老师能更加脚踏实地一些
186793,9466,段世飞,2024-01-13 05:48:52,1,4,3,上课没有PPT，感觉是新入门的脱口秀演员，有很多梗，一个都不好笑，上课没有任何的收获
187504,9466,段世飞,2024-01-16 11:55:23,3,5,2,感觉像个神棍，上课没几句就扯自己的学习经历讲自己的一些个人观点，毫无收获（虽然老师可能真的不懂德育原理没法上课）
187908,9466,段世飞,2024-01-17 17:56:44,2,4,2,德育原理：不备课，但是说自己有准备ppt，结果也没发给我们，那为什么不拿出来用？讲ppt总比上课想到什么讲什么好...但是课程考核上不会为难我们（不过说会给论文反馈但是好像没有给？）
197714,9466,段世飞,2024-08-03 12:35:35,6,6,0,段老师人品超好，对学生的所有问题都能耐心回答。能照顾到学生的真实需求，超喜欢！！！
197735,9466,段世飞,2024-08-06 12:33:42,2,2,0,飞飞人真的很好，课上也干货满满，气氛很好，班里同学最爱的老师之一
197744,9466,段世飞,2024-08-08 01:41:24,6,6,0,非全1.5w一年，段老师的2天的论文指导课起码值1w，很良心的指导，醍醐灌顶，感谢段老师引导入门！
197747,9466,段世飞,2024-08-08 04:40:35,3,3,0,满满干货！\n\n超喜欢这个老师！
217601,9466,段世飞,2025-04-14 04:07:20,0,0,0,课堂内容陈旧，缺乏与时俱进，好像鸡汤，听之无味，毫无用处，语言乏善可陈。
217713,9466,段世飞,2025-04-15 11:15:30,0,0,0,至今依然觉得，当初选择了段老师作为导师是很幸运很幸福的事情。不了解老师课堂上的情况，但是作为导师而言，他真的是我见过最负责最关心学生的老师之一
171289,9474,林聪,2023-03-21 02:35:53,4,9,5,太傻叉了
180432,9474,林聪,2023-09-21 15:15:38,5,6,1,很遗憾，他为了爱情，离开了浙大
184471,9486,陈丽翠,2023-12-20 10:08:30,2,3,1,老师备课和上课非常认真，是大四这门课里唯一一个不划水的老师。不过就大四这门课而言，作业太多了，每个老师都有作业QAQ
217821,9486,陈丽翠,2025-04-17 03:21:59,0,0,0,课讲得好，尤其是在其他老师的衬托下
201195,10146,Shadiev Rustam Narzikulovich,2024-10-30 03:06:56,3,3,0,不知道老师怎么想的，能不能退我学费
201548,10345,刘畅,2024-11-04 10:54:50,0,1,1,。。。
215755,10345,刘畅,2025-03-05 07:47:36,2,2,0,超级认真负责的老师，会认真对待学生的表达和观点，非常用心！！！！！！！！！！yyds！
216658,10359,李通,2025-03-20 08:30:25,1,1,0,很不错很不错
217077,10359,李通,2025-04-01 09:48:40,0,0,0,请吃饭的好老师
199516,10423,宋宪,2024-09-25 01:37:51,5,5,0,给班主任刷个10分不过分吧
206285,10423,宋宪,2024-12-13 14:13:17,2,2,0,给班主任刷个10分不过分吧
198353,10426,陈静远,2024-09-07 17:43:10,3,7,4,包你满绩
198363,10426,陈静远,2024-09-08 03:17:47,3,4,1,老师很温柔，讲课也还挺有意思的。课程是课题组的平行班，作业每个平行班都是一样的，分给的不错
