评论id,老师id,老师姓名,发表时间,点赞减去点踩数量,点赞量,点踩量,内容
16404,12,沈生荣,2016-01-18 04:59:00,7,8,1,呵呵.
16562,12,沈生荣,2016-01-18 11:21:39,9,10,1,其实课上得还不错，但是说好了给每个人都上八十，我直接一个79是怎么回事？
16585,12,沈生荣,2016-01-18 12:29:05,2,3,1,呵呵。
18004,12,沈生荣,2016-01-21 05:49:36,1,2,1,呵呵.
37985,12,沈生荣,2016-11-22 15:47:51,0,5,5,老师特别牛逼，上课扯各种在美国在德国在fda的经历等等，经历很丰富，讲的知识也很实用，据说不点名无考试只要最后上交一次作业就可以了……\n\n他说他的愿望是，你们人人都满分。
41128,12,沈生荣,2017-01-19 11:18:28,0,4,4,怎么说呢。。。老师人很好，要求很低，听起来很轻松也比较有用。但助教感觉没和老师沟通好，几节课老师去美国了，助教代课，感觉和老师的要求完全不一致，包括最后的作业。。。
44015,12,沈生荣,2017-01-17 08:08:41,2,3,1,老师还是挺好的，但是真的说好的80呢，为什么直接压在79了啊
44025,12,沈生荣,2017-01-17 08:21:58,5,6,1,什么鬼啊！！！第一节课说什么 我希望人人都过，人人都有个好成绩！！结果呢！！！你给我75分！！！3.0！！！绩点刷刷刷刷就给拉下去了好不好！！！
44035,12,沈生荣,2017-01-17 08:33:32,6,7,1,老师人挺好的，知道的东西也多，上课也轻松。但我只给及格分，因为这个助教实在是太烂了！老师本来说好的期末论文随便写没格式要求还特别强调别写太多，结果最后是助教改，论文都交上去了才提一些奇奇怪怪的要求......最后几次课老师去美国出差，都是助教上，迷醉，感觉助教只会念ppt，提一些无聊的问题（比如WTO是什么你知道吗？尴尬的问十分钟），英文发音简直比印度英语还让人崩溃：破fài（重音竟然在这儿）克特、噢热哥nāition等等等等，最后给分也差，请大家擦亮眼睛：千万不要被查老师上这个均绩蒙蔽了眼睛！！助教我给零分！！！
48525,12,沈生荣,2017-03-06 13:57:00,0,0,0,可以的\n\n
49589,12,沈生荣,2017-04-19 12:40:08,0,0,0,喜欢老师会讲很多有用的东西
49591,12,沈生荣,2017-04-19 12:54:23,0,0,0,很和善的老师
49676,12,沈生荣,2017-04-23 10:01:00,3,3,0,略水，念ppt之余讲些个人经历，刷绩点可以考虑。最后期末论文不宜学术化。
50283,12,沈生荣,2017-05-02 06:51:20,0,0,0,呵呵、骗人说给高分，上了贼船，还说什么自己很讲信用，辣鸡\n\n
50821,12,沈生荣,2017-05-06 02:04:08,1,2,1,这学期应该是老师自己给的分?绩点好高……大大大水课…最后的论文居然变成了展示一下直接给分
50835,12,沈生荣,2019-07-31 00:22:44,0,1,1,老师讲的还是挺好的，感觉春学期老师貌似亲力亲为给分，没见过助教。每节课都不点名，最后一节课展大概示下自己的文章的大略方向就行。不过虽然不点名，在最后一节课当你展示完把论文递给老师时，老师会判断你眼熟与否给平时分的
4495,97,刘东红,2015-06-24 02:55:52,2,4,2,讲课还好的，还算清晰，还会有一些有关企业的故事。就是ppt太难看了
34488,97,刘东红,2016-10-12 02:17:12,0,1,1,希望能认真备课…
114777,97,刘东红,2019-07-11 14:23:36,-2,0,2,很棒棒哟
145857,97,刘东红,2022-01-03 11:32:35,2,5,3,不懂得体谅学生，也算我们学院特色了。讲课符合学院水平，没有重点，一个不可多得的完美的浙大精英教师呢
145933,97,刘东红,2022-01-04 12:39:32,-2,3,5,同样是专业课，要么背海量知识点拿高分，要么舔老师拿高分，我宁愿选择后者【强】
62274,124,陆柏益,2017-11-24 01:34:09,-11,1,12,认真听，真的能学到很多东西：风险评估的步骤，数据的来源，特殊情况下的风险评估等等。老师很温柔，也会愿意帮你改论文，可能也是自己感兴趣的原因吧，反正很喜欢这门课。如果再加一点实践部分就更好了，不过短学期的课要求也不能这么高…
79878,124,陆柏益,2018-06-14 16:48:44,5,7,2,平时我就不评论了(食品专业课上过都知道大概怎么回事( 强行下载一个莫名广告APP来点名 还经常出各种状况 创新性实验真的呵呵哒 我们的负责老师原本就不是他 强行所有人统一手写最后的实验报告还有数据!!! 你知道我们组实验做了什么吗 就统一手写 人家可能只是去滴定 我们那么多仪器处理的数据 原本都是打印就好 又要全部写一遍 那我之前熬夜处理那些数据意义何在?怎么不早说? 加上当时组里面学霸又贪 各种没学过的文献方法测了好几个 光原理就比一般的实验报告多几页 还好几个!!! 全部写写完估计都四五千了 还不算讨论分析 引用的文献巴拉巴拉的 就一个号称帮助同学们了解实验流程的设置 平时占用了可能二三十个小时去做实验都不谈了 也算不了几分平时分 我只希望您能在轻描淡写 把一些可能都没了解清楚 的事情框死时 考虑一下有些同学的付出
84066,124,陆柏益,2018-07-20 13:10:15,7,11,4,上四很容易这种话还真是张口就来啊。给分不好就是给分不好，上课也不见得好到哪里去，另外如果真要我们上课好好听作业好好写像高中那样学，微积分都能满绩了吧，，给个4.2难道还算手下留情了？是，这门课是主干专业课不错，可别人家主干专业课都是怎么给分的？不少专业专业课都是3.9开始往上打，不求老师给分多么好，可这门课的卷面成绩比总评成绩还高这就说不过去了吧？
85221,124,陆柏益,2018-07-16 07:22:55,4,7,3,有学到东西，也付出很多，但给分真的很低。老师人还是很好的，希望以后给分多考虑一下同学们的付出，不说了，拿到低分还是有点小伤感55555
85277,124,陆柏益,2018-07-16 16:28:55,10,12,2,作为专业课给分太！差！了！我不知道您的标准是什么，但能不能多替学生想一想，也许我们最后确实没能学得很好很好，但作为一门专业课下手如此之狠是不是有些太过了。
85337,124,陆柏益,2018-07-17 05:38:46,-16,10,26,我觉得前面几位是不是有点脸皮太厚，讲真你上课真的有好好听吗？ 凭什么老师要给你一个上课没有完全好好听，课后不看，考前“认真复习”的人高分？摸摸自己良心再说话好吗？你要真的用功了，上4很难吗？你想上水课浙大有的是，但这门课是专业核心课程，你没完全好好学，也不要对自己有多少期望吧！？ 老师确实事情很多，而且很多时候说话不太算数，但是你个人的得分和这些有半毛钱关系？所以学弟学妹不要被前面几个人的评论误导，好好学，不要只从别人身上找茬，多看看自己是什么样的人。
85581,124,陆柏益,2018-07-20 02:15:16,12,18,6,食品化学与分析课，平心而论陆老师讲课是三个老师里相对最好的，但是我只能给及格分。作为一门双语课程，不应该仅仅只对学生高要求，几位老师上课的时候，经常连单词都不熟悉，有些时候甚至连接下来讲的内容都不知道，逻辑并不是很清晰，很容易导致学生神游，个人认为如果认真备课就不会这样子。作为一门专业核心课程，这门课内容多，但不深，很多都只是了解性的知识，学到的都是皮毛，而且记忆背诵的内容非常多，需要大量时间投入，可是收获我不觉得有很多。最后说一下成绩，我本人期末考试每一题都做出来了，自认为卷面90+，总评4.2，虽然可能已经不算低了，但绝对不是上面某位同学所说的那样轻松。这门课投入与最后成绩严重不成比例，老师讲课也不出彩，甚至在某种程度上有些糟糕，我觉得不是学生的问题，有些老师也该反省一下。以上。
86114,124,陆柏益,2018-09-07 11:11:17,-6,2,8,好好好
104645,124,陆柏益,2019-03-26 01:20:28,10,25,15,希望学弟学妹们别因为上了他的专业课就选这个老师读研，没啥学术水平，给不了什么指导。。。还总端着领导的架子。。。诶，能逃离食品这个坑就尽早逃离吧，本学院的老师还自带优越感orz，一年能发多少篇5分以上的文章心里没点数吗？除非特别热爱这个专业，否则读研还是能转就转吧……
127251,124,陆柏益,2020-11-17 07:05:54,4,14,10,认识有几年了，愿称之为柏益神牛
141334,124,陆柏益,2021-09-30 01:56:22,3,9,6,就没见过这么烂的老师
141893,124,陆柏益,2021-10-30 09:54:42,5,9,4,上课贼烂，徒有其表，夸夸其谈，教课真垃圾，屁事真多，还拖课yue了
144620,124,陆柏益,2021-12-23 00:30:42,3,5,2,你怎么有这么奇葩的人呀，我真是服了。
145174,124,陆柏益,2021-12-28 04:53:45,0,4,4,人很善良，但是占课太多
164581,124,陆柏益,2022-12-22 03:54:52,12,15,3,事情非常非常非常非常多，而且一天一个要求，讲课也很垃圾，我愿称之为本专业最离谱的老师之一，千万不要靠近他
180485,124,陆柏益,2023-09-22 02:46:03,2,4,2,垃圾玩意
192281,124,陆柏益,2024-05-13 12:58:24,6,8,2,各位学弟学妹们，还是那句话，不要因为上了他的课程就选这个老师读研，19年的评论写的很贴切，现在是24年，不仅学术水平没长进，领导架子更大了。信过来人的话，真的。
209564,124,陆柏益,2025-01-06 08:55:41,5,6,1,我的回答是
210238,124,陆柏益,2025-01-08 13:43:13,4,4,0,对不起，没忍住🥵。我说的是授课水平，感觉没上过课🥵。
216511,124,陆柏益,2025-03-17 15:13:13,0,0,0,什么鬼啊，上课都不知道在讲些什么
1723,238,何勇,2015-03-23 14:41:11,4,12,8,讲课讲得太烂，而且给分不行，通识课全班几乎没有一个满绩
4883,238,何勇,2015-06-30 06:43:49,10,22,12,课没有什么用，给分极低
8516,238,何勇,2015-09-22 04:34:16,-3,2,5,还行.
9143,238,何勇,2015-10-14 10:36:27,-3,2,5,呵呵呵
19496,238,何勇,2016-01-24 11:29:20,3,7,4,实在是没什么卵用的课 又麻烦 《全球定位系统和地理信息系统》
20939,238,何勇,2016-02-04 14:07:44,-3,1,4,
34627,238,何勇,2016-10-16 07:26:04,6,9,3,屁事血妈多 真受不了
36081,238,何勇,2016-11-10 11:45:14,1,5,4,老师感觉人还不错～但是真心不要选那个～地理空间信息学基础～筒子们～
46476,238,何勇,2017-01-22 00:33:16,3,5,2,事多课水分低考试难又什么都学不到，别选别选别选
47962,238,何勇,2017-02-27 14:30:01,5,9,4,为什么没有负分，事情太tm多了。\n\n但我给老师以考代教的方法给好评，毕竟期末考试的时候我把一学期没看过的书从头到尾翻了五遍，考试过程中感觉很充实。
49888,238,何勇,2017-04-27 02:19:20,1,3,2,上课什么都收获不了，任务又麻烦，考试开卷又很难，最后给分又极低，大坑
58821,238,何勇,2017-09-18 03:46:24,0,2,2,我觉得这个老师讲课挺有意思的(ง •̀_•́)ง
105783,238,何勇,2019-04-20 12:27:42,6,6,0,同学们，这个是可以申请专利的。
107310,238,何勇,2019-05-03 12:08:38,2,2,0,恶竞给分
107345,238,何勇,2019-05-04 05:45:40,3,6,3,恶竞垃圾，竺院某个班，除了恶竞一无是处
168444,238,何勇,2023-02-16 15:00:25,5,5,0,喜欢打牌。。。
175409,238,何勇,2023-06-24 15:41:29,4,4,0,勇啊，贵院怎么成这幅鸟样了啊
178380,238,何勇,2023-07-11 08:05:01,13,14,1,勇啊，你怎么把隔壁的小房间打通了给自己公器私用啊，贵院知道吗
198964,238,何勇,2024-09-13 11:35:41,-3,0,3,看了一圈，咱们院就没有好点的专业课吗。。。
37710,284,陈素珊,2017-07-01 00:59:24,-59,3,62,比较严厉，但能启发人
37724,284,陈素珊,2016-11-20 12:10:56,17,20,3,除了会令人催眠的念幻灯片什么都不会了。超级大水课——你还不能不选！
38904,284,陈素珊,2016-12-19 18:12:57,16,17,1,上课不能做别的事情…每节课都有作业要写好多字……
47454,284,陈素珊,2017-01-26 18:42:14,-1,2,3,
48027,284,陈素珊,2017-02-28 05:30:41,18,19,1,恶心哟
48029,284,陈素珊,2017-02-28 05:32:43,14,19,5,辣鸡老师
48463,284,陈素珊,2017-03-05 11:04:43,24,25,1,如果有零分，我一定不会吝啬，就是个sabi，上帝让她存在的意义就是考验我们对sabi的忍耐度的，hhh
51835,284,陈素珊,2017-06-25 09:36:58,34,36,2,点名每次到了，绩点2.7，室友五节课三次没签到，绩点3.9。说平时分给的很合理。合理你个呵呵
52270,284,陈素珊,2017-06-17 03:20:04,9,11,2,垃圾老师
52314,284,陈素珊,2017-06-18 08:31:08,10,12,2,发牌子点名真是舒服呦\n\n没什么有用的东西还一堆作业
52405,284,陈素珊,2017-06-26 03:36:51,53,60,7,请问你和苟某人是什么关系?
52424,284,陈素珊,2017-06-20 03:06:50,16,18,2,刷新了我对浙大老师认识的下限。真的很坑，事多分少，没事不要轻易尝试死亡。\n\n另外我想对老师说\n\n我去年买了个表，超耐磨
53049,284,陈素珊,2017-06-25 06:46:11,7,7,0,辣鸡老师
53050,284,陈素珊,2017-06-25 06:51:57,8,9,1,一种吃屎的感觉
53052,284,陈素珊,2017-06-25 07:22:39,10,10,0,事情多话多给分差，1分的课整那么恶心又学不到什么，真的烦
53057,284,陈素珊,2017-06-25 07:53:34,2,5,3,这就有点迷幻了 给分不知怎么给的
53061,284,陈素珊,2017-06-25 08:50:48,14,17,3,对老师仅有的那么一点点好感在看到分数以后荡然无存
53062,284,陈素珊,2017-06-25 08:47:43,6,8,2,绩杀吧，这学期好好听课，好好复习好好考试，绩点3
53063,284,陈素珊,2017-06-25 08:53:41,8,8,0,无聊\n\n没有用
53068,284,陈素珊,2017-06-25 09:19:01,11,13,2,刚开始觉得这么严厉可能挺好的\n\n后来 \n\n呵呵\n\n绩杀一枚
53096,284,陈素珊,2017-06-25 14:22:11,1,6,5,劝17学弟学妹 如果你发现你的预置是这个老师 别想别的了赶紧的换老师
53130,284,陈素珊,2017-06-26 03:31:24,7,9,2,考试辛辛苦苦写满了，最后给的分超低，真的不服
53131,284,陈素珊,2017-06-26 03:35:50,6,9,3,好好复习了很久，平时分不知道怎么给的，绩杀
53132,284,陈素珊,2017-06-26 03:43:22,13,13,0,这位老师给分不太讲道理，最高分80多
53386,284,陈素珊,2017-06-26 13:16:31,-16,3,19,老师挺严格的，形策期末背一下还是有效果的
53465,284,陈素珊,2017-06-26 16:17:23,-4,7,11,难以忘记那个被红卫兵站在身后盯着的夜晚，比较会说空话，如果想要认认真真上行策那可以选
53832,284,陈素珊,2017-06-27 20:30:28,10,10,0,绝对的绩杀，全班最高分80+，我认识的都没有上八十，sixsixsix，另外浙大你规定上90的不能超过20%，那干嘛不规定上九十的不能少于0%呢？？？
55270,284,陈素珊,2017-07-01 07:07:35,4,5,1,哇不知道怎么的就这么低的分，组长又是我，时事展示又是我，还当堂表扬了，平时分呢？这种课大家都应该改不了，所以只能来这里吐槽一下了。。
56873,284,陈素珊,2017-07-05 02:00:57,4,6,2,绩杀 别选
58955,284,陈素珊,2017-09-19 01:03:04,5,6,1,次次有作业，上课无聊得要死，还要求提前到？还特别讲形式。给分也垃圾。真是呵呵。
71148,284,陈素珊,2018-01-28 04:36:31,11,13,2,很庆幸她走了
74248,284,陈素珊,2018-02-08 02:11:13,26,29,3,陈素珊走了 张云飞也快滚吧
116300,284,陈素珊,2019-09-07 11:48:57,-5,0,5,滴滴滴
123255,284,陈素珊,2020-05-26 06:54:09,50,51,1,从“给分厚道徐小洲 制度合理林建华 尊重学生孙大雁 亲切友善祝秀香 从不绩杀陈昆福 分多事少陈素珊 知识广博看沈燎 讲话生动吴朝晖 声音洪亮陶虹向”前来观光
129122,284,陈素珊,2020-12-30 08:02:56,2,4,2,zjgbd
129124,284,陈素珊,2020-12-30 08:06:36,18,21,3,如果有负分绝对给负分。自以为是，高高在上。学生明明有实习经验，从实际出发的回答，因为不符合她的认知，即使是对的也疯狂开怼。一个没出过学校的人告诉学生们外面公司的运行规则。想想都觉得荒谬，学弟学妹快逃。
181679,284,陈素珊,2023-10-28 03:00:03,-21,5,26,唉老师其实挺热情的，刀子嘴豆腐心
190030,284,陈素珊,2024-02-11 04:09:07,5,7,2,从“给分厚道徐小洲 制度合理林建华 尊重学生孙大雁 亲切友善祝秀香 从不绩杀陈昆福 分多事少陈素珊 知识广博看沈燎 讲话生动吴朝晖 声音洪亮陶虹向 十罪七策王章野”前来观光
190873,284,陈素珊,2024-03-23 07:36:55,88,98,10,就你排挤赵老师和朱老师？
190876,284,陈素珊,2024-03-23 10:17:11,53,56,3,你有什么资格和水平去排挤赵老师和朱老师的？？？\n\n他俩是你能碰瓷的吗？\n\n你这么牛逼你怎么不上天呢，🤢
190878,284,陈素珊,2024-03-23 10:35:08,44,51,7,嫌S系建设模式太西化，太重质量，想把老赵和老朱排挤掉让青年老师们狠狠灌水冲业绩是不是？这么多一心向学、待人温和的青年老师，人心惶惶。你也配？这种东西怎么爬到这个位置的？
190879,284,陈素珊,2024-03-23 11:01:45,32,36,4,居然排挤赵老师，你算哪根葱？
190880,284,陈素珊,2024-03-23 11:32:50,32,36,4,垃圾透顶的行政人物来搞学科建设？神经
190881,284,陈素珊,2024-03-23 12:10:47,5,9,4,呵呵呵
190884,284,陈素珊,2024-03-23 13:15:16,16,19,3,你到底懂个什么社会学？
190885,284,陈素珊,2024-03-23 13:29:30,27,31,4,一个毫无相关学术经验的人，有什么资格来建立“社会学学科建设小组”？？？
190886,284,陈素珊,2024-03-27 02:44:35,26,28,2,来挖坟了\n\n“给分厚道徐小洲 制度合理林建华 尊重学生孙大雁 亲切友善祝秀香 从不绩杀陈昆福 分多事少陈素珊 知识广博看沈燎 讲话生动吴朝晖 声音洪亮陶虹向”\n\n狗屎一样的东西，纯畜生
190888,284,陈素珊,2024-03-23 15:11:41,4,7,3,你是？
190890,284,陈素珊,2024-03-23 15:55:02,8,11,3,是没有木琴的纱必！
190892,284,陈素珊,2024-03-23 16:20:32,4,8,4,赶紧到1.04，助力每一个梦想～
190893,284,陈素珊,2024-03-23 16:57:20,7,10,3,撒泡尿自己照照自己，ok?
190894,284,陈素珊,2024-03-23 17:10:03,16,19,3,单就搞政治斗争把一个学院弄得乌烟瘴气的，我觉得就值得扣。我是路人，但是这本身就不合理。\n\n如果学校还盯着国内的学科评估等蝇头小利，别说东方剑桥了，永远不可能发展成为所谓的“国际一流高校”，只不过是自娱自乐罢了。
190895,284,陈素珊,2024-03-23 21:04:41,3,5,2,真的垃圾
190896,284,陈素珊,2024-03-24 00:55:11,12,16,4,呵呵呵
190897,284,陈素珊,2024-03-24 01:13:17,19,22,3,大妈你啥也不懂啥也不会就别去沾边好吧
190898,284,陈素珊,2024-03-24 01:22:34,6,9,3,什么东西
190899,284,陈素珊,2024-03-24 02:09:27,10,14,4,那可是两位大师啊。
190900,284,陈素珊,2024-03-24 02:12:04,16,18,2,借刀杀人被当枪使都这么积极！
190901,284,陈素珊,2024-03-24 02:13:42,4,7,3,666
190905,284,陈素珊,2024-03-24 03:29:59,5,12,7,只会搞行政的老师会教学吗？一心搞政治，一点学术水平都没有，浙江大学人文社科早晚亡在这种垃圾手里
190907,284,陈素珊,2024-03-24 03:47:58,6,8,2,不喜欢
190908,284,陈素珊,2024-03-24 04:05:27,1,5,4,呵呵呵
190911,284,陈素珊,2024-03-24 04:49:51,19,22,3,就算你是上面指派的枪手，也不得不骂你，雪崩时没有一朵雪花是无辜的。你现在全盘否定赵老师的成果，以下犯上不懂礼数，公然挑衅，你是杀死浙大社会学系的帮凶
190912,284,陈素珊,2024-03-24 04:50:47,13,15,2,sb 东西就你也配 学科建设？\n\n赵老可以走 但是浙大不能没有赵老
190913,284,陈素珊,2024-03-24 05:15:37,21,25,4,你一个生工食品出身的老师，干涉社会学系的学术，是不是脑子进水了？
190914,284,陈素珊,2024-03-24 05:18:58,7,10,3,害群之马
190916,284,陈素珊,2024-03-24 07:38:28,7,10,3,我的评价是“史”
190920,284,陈素珊,2024-03-24 10:30:17,3,6,3,💩💩💩
190921,284,陈素珊,2024-03-24 11:15:18,9,12,3,搞不了学术，这种人上位，是浙大社会学系的灾难。
190922,284,陈素珊,2024-03-24 11:46:28,3,6,3,狗屎依托，最讨厌只会耍政治手段的废物了
190929,284,陈素珊,2024-03-24 15:05:02,4,8,4,你算什么东西？怎么上来的？尔等小人，只会显龌龊之能。
190938,284,陈素珊,2024-03-25 03:52:16,8,11,3,依托答辩
190945,284,陈素珊,2024-03-25 06:26:56,6,11,5,一个为社会学科贡献负能量的人
190978,284,陈素珊,2024-03-27 07:16:48,3,7,4,神经病
191036,284,陈素珊,2024-03-29 05:32:06,5,8,3,不好
191053,284,陈素珊,2024-03-30 15:27:01,9,12,3,构式一样的东西，纯畜生\n\n还好当时的两次排挤会议精神已经被推翻了\n\n祝老屎遗臭万年
191062,284,陈素珊,2024-03-31 11:38:05,8,11,3,a piece of shxt
191128,284,陈素珊,2024-04-07 09:06:23,6,10,4,死死死爬爬爬妖魔鬼怪快离开妖魔鬼怪快离开滚滚滚滚滚
191477,284,陈素珊,2024-04-23 11:31:39,8,10,2,a pile of shit
192186,284,陈素珊,2024-05-11 05:47:01,5,8,3,慅婗遤啑罼
197564,284,陈素珊,2024-07-19 07:32:56,7,9,2,䒑孴鬕蔱髀
198680,284,陈素珊,2024-09-10 23:47:31,7,9,2,若之，史
200068,284,陈素珊,2024-10-12 08:04:06,14,15,1,排挤赵老师乃至全盘否定赵老师的改革成果，有凭有据还自罢了，但群众的眼睛是雪亮的，你算什么东西？
200112,284,陈素珊,2024-10-13 08:51:46,11,12,1,滚出浙大！
201250,284,陈素珊,2024-10-30 21:16:25,13,15,2,泼妇大妈别脏了浙大社会学的学术净土
201447,284,陈素珊,2024-11-03 05:05:18,14,16,2,赶紧退休滚出浙大吧，一个行政人员还搞起学科建设来了，丢脸丢到全世界去了，给浙大声誉带来难以估量的损失
204109,284,陈素珊,2024-11-24 09:16:08,6,6,0,爬爬爬
207192,284,陈素珊,2024-12-19 16:26:27,9,10,1,1分好评，就是啥也不懂却想领导一起的猪，你国特色产物
208491,284,陈素珊,2024-12-30 00:38:13,17,18,1,一堆垃圾，老妖婆一个，让人想起乌姆里奇
208619,284,陈素珊,2024-12-30 06:09:17,11,11,0,楼上说乌姆里奇的狠狠点赞了\n\n我怀疑这人要遗臭千古
208628,284,陈素珊,2024-12-30 08:03:25,10,10,0,滚出浙大
208660,284,陈素珊,2024-12-30 13:46:49,6,7,1,low爆了吧陈书记
208689,284,陈素珊,2024-12-31 02:41:40,11,11,0,遗臭万年
210121,284,陈素珊,2025-01-10 08:40:13,8,9,1,说她排挤赵鼎新是太抬举她了，她也配。归根结底还是校领导和社会学另一帮人的意思 她就是推出来挨骂的。
214114,284,陈素珊,2025-01-24 11:40:41,7,9,2,陈书记把学校人事草菅人命的作风带到社会学系了吧
214500,284,陈素珊,2025-02-10 03:06:40,4,4,0,死妖婆下地狱去吧
29770,418,丁甜,2016-06-30 09:53:58,0,4,4,好老师！
44670,418,丁甜,2017-01-18 05:52:32,0,4,4,科科。
44741,418,丁甜,2017-01-18 07:45:52,0,2,2,实验课还行吧  看了4次实验 1次自己做  写了5份实验报告。 4.4
68389,418,丁甜,2018-01-23 05:59:40,-1,2,3,。。。
80174,418,丁甜,2018-06-21 13:13:44,1,9,8,明明自己没讲清楚硬说学生没听，无语……\n\n 学生没有话语权
13522,436,于勇,2015-12-29 02:32:44,0,0,0,上课让我想打瞌睡…
28449,436,于勇,2016-06-28 09:02:15,0,0,0,上课无聊，给分还好
168190,436,于勇,2023-02-01 08:51:18,0,0,0,机械设计基础给分不好吧。。。
173573,436,于勇,2023-05-29 07:54:48,0,0,0,好好好。
178235,436,于勇,2023-07-08 11:25:33,3,3,0,从某种角度上来说在某院甚至还不错，基本不点名，不整幺蛾子，不过给分真的是随机给的，建议不要浪费太多时间在这门课上。\n\n另外讲话声音太小了，没有一次能听清的。
178696,436,于勇,2023-07-18 12:21:51,0,0,0,机械综合设计给分中规中矩
188689,436,于勇,2024-01-19 14:30:05,0,1,1,不点名，上课声音好小，章节太多，课后需要很多时间自学。\n\n考试可能出ppt的例题，完全来不及做，选择填空大半不确定，A4纸要抄全。\n\n一周速成，低分飘过。
212984,436,于勇,2025-01-15 12:06:57,1,1,0,最后一节课重点划的什么东西，低分飘过
213537,436,于勇,2025-01-18 06:00:44,0,1,1,专业课。大学第一门感觉给分很差的课，要不是看出来又水又作还以为打错了。
213839,436,于勇,2025-01-20 09:05:24,1,2,1,讲句公道话，在农工大三上所有课程里设计真的算不错的了，助教哥哥很nice真的很负责，两位老师讲的也还算不错吧，起码言之有物学的到点东西。最终考试不算简单，跟材力知识激情联动了，但也没超出yy最后一节课划的重点范围（最后一题会是轴承大题强调过很多遍，例题都给了），不然跟制造的课程设置比比呢（汗）
221009,436,于勇,2025-06-20 16:08:07,0,0,0,不点名但是小测\n\n划重点跟娘们一样扭扭捏捏，划了的大部分都不考\n\n考了一堆材料力学
5086,523,应铁进,2015-07-03 13:35:29,2,2,0,挺机灵挺萌的老师，好像给分很慷慨的样子
35459,523,应铁进,2016-11-10 07:18:13,0,0,0,老师和蔼可亲
19933,532,蒋焕煜,2016-01-25 14:39:22,-8,5,13,非常好
24543,532,蒋焕煜,2016-05-01 10:12:30,-9,3,12,很好很好\n\n
38485,532,蒋焕煜,2016-12-07 01:00:55,14,23,9,两节课点两次名 以为自己讲的好死了 烂到不想听 还什么人生哲学 谢谢 这碗鸡汤您自己喝
60438,532,蒋焕煜,2017-10-20 02:11:30,4,11,7,上课铃一响马上点名，很棒，给你们养好习惯。对同学高要求，耐心回答问题，自然，给分很不错，或许可能是因为你不知不觉已经在跟着节奏认真学习的缘故吧
64364,532,蒋焕煜,2017-12-23 03:00:33,-22,6,28,棒! 非常棒! 人超级好，关心学生，学院还是有好老师的! 上课很幽默，有趣，可爱。不要失去希望哈哈哈
73953,532,蒋焕煜,2018-02-03 22:46:27,20,23,3,自以为是 油腻中年
91211,532,蒋焕煜,2018-12-03 11:04:18,22,24,2,上课吹吹牛 肚皮都是油
93246,532,蒋焕煜,2019-01-08 10:27:11,-15,1,16,完美!
93459,532,蒋焕煜,2019-01-10 01:30:21,4,6,2,搁这微信刷步数呢？
95033,532,蒋焕煜,2019-01-18 15:22:08,-16,2,18,男神！
95081,532,蒋焕煜,2019-01-18 16:47:28,6,8,2,给分极其不公平
130133,532,蒋焕煜,2021-01-18 01:31:36,9,9,0,上课很无聊，还要强制听讲，经常乱cue人，手机电脑都不能用
134714,532,蒋焕煜,2021-04-12 00:37:49,10,10,0,垃圾……
135494,532,蒋焕煜,2021-05-11 15:41:26,9,9,0,垃圾中的战斗机，完全不体谅学生，布置作业一堆，尺寸乱七八糟还自相矛盾，十多幅图一幅画好几个小时毫无意义。。
136665,532,蒋焕煜,2021-06-22 14:28:36,10,10,0,垃圾中的轰炸机。临近期末了又来一堆solidwork作业，而且还要基于原来的cad作业。你他喵尺寸给的都是错的，cad都是乱画的，还画sw…大无语
136741,532,蒋焕煜,2021-06-24 01:10:48,10,10,0,无语。整个人没法沟通，居高临下傲人姿态。布置作业尺寸不明，不负责任地让学生自行解决。期末还压榨学生，真的无话可说。农工学子就别想睡觉了。无语的程度只有上他的课才知道。
136872,532,蒋焕煜,2021-06-27 03:55:32,20,21,1,完全不体谅学生，讲课毫无营养。\n\n临近期末突然布置SW大作业？？？\n\n客观上讲，蒋老师不像一位大学教师应有的样子。布置作业可以，但请明确化。\n\n农工学子熬夜数天画出了十几张CAD图纸，作业量不言而喻。作为学生的我希望能够得到作业反馈，拿着自己画好的图纸问老师，能不能麻烦看看图纸哪里有问题，我改改。老师的答复是“如果这么多同学都像你这样问，我怎么看的过来？老师上课都讲过了”？？实际情况是，蒋老师在课堂上当众点出画的不好的同学的名字，虽然没有点到我，但我觉得这种做法实在可笑且极其不妥！\n\n另外，关于SW大作业，不可置否，老师之前是有说过要画SW，但从未明确化过作业要求，也未在班群里发过作业相关通知，且正常同学的思路是讲完SW之后再画图。结果，老师在24号的课上突然公布作业DDL是30号，他完全不体谅30号就要开始第一门考试、之前几天还正常上课的同学的感受！以及，目测SW作业比CAD作业量更大，难度更大orz
136882,532,蒋焕煜,2021-06-27 11:15:32,10,10,0,我觉得楼下的同学有点过于文明啦。\n\n这种人配被称作老师???
137368,532,蒋焕煜,2021-07-03 13:29:35,6,7,1,我是王斯
139552,532,蒋焕煜,2021-07-17 07:50:16,2,4,2,每节课都要点名 事情贼多 上课讲的太杂乱了 很自以为是 大学里遇到过最差最差的老师没有之一
141400,532,蒋焕煜,2021-10-06 10:14:54,-5,0,5,不错额
147844,532,蒋焕煜,2022-01-11 03:46:52,4,4,0,靠点名保持到课率，辣鸡中的战斗机！
151029,532,蒋焕煜,2022-02-22 09:30:02,-1,2,3,加油加油＾０＾~
151435,532,蒋焕煜,2022-03-03 06:59:46,-3,0,3,不错滴
151569,532,蒋焕煜,2022-03-15 06:39:28,15,17,2,我张一驰觉得很不错
151773,532,蒋焕煜,2022-03-15 06:39:11,1,3,2,我觉得不错！
151968,532,蒋焕煜,2022-03-22 05:37:35,13,14,1,我也觉得张一驰很不错
151972,532,蒋焕煜,2022-03-22 06:54:12,15,16,1,我觉得张一驰觉得不错的老师一定很不错
152319,532,蒋焕煜,2022-04-03 09:56:06,-4,0,4,老师挺好的
152715,532,蒋焕煜,2022-04-18 23:50:05,6,6,0,沙币玩意，估计他的教授头衔也是水的，建议彻查。他的论文狗屎一样，就是抄抄改改。
154114,532,蒋焕煜,2022-05-23 12:14:25,12,12,0,我张一驰觉得老师蛮可爱的
155756,532,蒋焕煜,2022-06-15 15:33:38,4,4,0,说利得沃克
163382,532,蒋焕煜,2022-12-14 07:52:13,5,5,0,傻逼！专业选修论文要写八页以上？期刊排版不给格式？
166774,532,蒋焕煜,2023-01-13 14:06:24,0,0,0,………
168442,532,蒋焕煜,2023-02-16 14:53:53,7,7,0,就没见过这样的混子老师\n\n不知道什么评上去的，好像跟哪个学阀是亲戚\n\n上课就在那边吹牛逼\n\n牛逼哄哄\n\n辣鸡学院吃枣药丸
179538,532,蒋焕煜,2023-09-18 05:16:56,3,4,1,老师还是有改进的，把复杂的图纸改成了选做
179916,532,蒋焕煜,2023-09-20 03:36:48,4,5,1,老师讲课还可以，但是教的软件啥的版本好落后，和以前比起来应该是改进了很多，复杂的图纸可以选做，上课有问题也很耐心教导，感觉人还是可以的
182514,532,蒋焕煜,2023-11-17 00:25:05,0,0,0,上课吹吹牛，肚里全是油，真的没水平
193821,532,蒋焕煜,2024-06-20 02:04:24,4,4,0,作业一大堆。上课三节课里一节课在水，还不如直接改成两节课，还一直用着老版2004，自己回去又下载不了这种老版本，还得重新学个新版本的用法，垃圾课
193856,532,蒋焕煜,2024-06-20 09:16:16,2,2,0,cad讲的一坨，不如看b站自学。\n\n考试和平时题目差不多，作业必做做完就没问题。
194475,532,蒋焕煜,2024-06-24 05:35:42,2,2,0,24年春夏机械制图。\n\n作业和安排应该比之前好多了，cad必做做完肯定没问题，SW导cad图纸一拉一转基本就完了，但一点不会或者太拖了也没办法。大班化的软件课本来就是低知识密度的，我觉得这种课挺矛盾的。功利一点的话，上课把标注的要求记牢，时间多可以听老师扯扯别的，不想听就回去自学。\n\n主观来说这门课上老师还挺和善的，不过一些问题确实会只跟你说“讲过了”，如果没太认真听课问之前先看看PPT。
204745,532,蒋焕煜,2024-11-27 15:00:31,0,0,0,非人哉！！！！！！！！！！！！！！！！！
107166,664,盛奎川,2019-05-02 03:55:26,4,5,1,干货足，任务多
107362,664,盛奎川,2019-05-04 08:42:49,6,7,1,上课还是挺好的
116449,664,盛奎川,2019-10-28 10:30:22,4,7,3,事事多。
116963,664,盛奎川,2019-09-23 11:33:42,6,7,1,很棒哦，老师很和蔼
118560,664,盛奎川,2019-10-28 12:55:08,22,35,13,事情好多 三次作业 五千字论文 不建议选生物质能通识课 我悔
118839,664,盛奎川,2019-11-07 02:03:42,3,5,2,事巨多
119188,664,盛奎川,2019-11-11 05:47:29,6,13,7,很喜欢盛奎川老师，温文尔雅，风度翩翩，让人想起触手温润的暖玉。上课干货挺足，就是老师只上前几节课。现在还不知道绩点，所以先感叹一句：得上此课，幸甚至哉。
119985,664,盛奎川,2019-11-17 03:09:32,0,3,3,5000论文真难搞哦，没兴趣千万别选
120131,664,盛奎川,2019-11-17 22:16:03,5,9,4,4.5，感谢盛老师对一个一脸懵逼的文科生的不挂之恩。
120162,664,盛奎川,2019-11-18 01:47:53,5,7,2,上课无聊，作业多，还有5000字论文，但是给分不错?
120173,664,盛奎川,2019-11-18 02:53:58,8,12,4,老师人很好 给分超高?我对生物一窍不通但还是拿了4.5 三次作业+五千字论文 不想做作业或者嫌麻烦的慎选 老师很幽默 后面俩老师也很赞的 想拿高分认真做作业就好～
120187,664,盛奎川,2019-11-18 09:36:07,2,4,2,三次作业，5000字论文\n\n给分奇奇怪怪\n\n我死了
120694,664,盛奎川,2020-01-15 09:53:57,0,0,0,还可以
121143,664,盛奎川,2020-01-20 00:44:48,1,2,1,还行吧
121302,664,盛奎川,2019-12-23 07:12:44,1,2,1,老师上课很幽默，虽然事情有点多，但只要好好做给分也是不错的
121325,664,盛奎川,2019-12-20 03:13:37,2,3,1,老师很和蔼\n\n上课也很认真 是一个很负责的老师\n\n我是人文的 上通识课不怎么能听得懂\n\n但是三次作业和论文 只要认真查资料准备 都没问题的 老师给分好 4.8\n\n真的感激!\n\n
121942,664,盛奎川,2020-01-25 00:57:39,1,2,1,很好的课，但是平常会有作业
123976,664,盛奎川,2020-06-18 10:50:36,3,5,2,物质能源与可持续利用。这门课的四个老师都非常优秀。课上能学到很多，就是任务比较多，每节课都会有作业。再加上最后3000字的论文。但是认真对待绩点不会低的。
127748,664,盛奎川,2020-11-26 10:05:23,-5,7,12,2020年秋冬学期 八周 每次都有作业 结课5000字论文 很认真 花费时间比vjf都多 结果令人难过 第一门通识课4.5分......很伤心💔\n\n\n\n回答很多次问题 但只有最后一节课的回答问题加分！！！！！！！！！！！！！！！！！！\n\n刚好最后一节课我在赶论文！没听讲！！！\n\n浪费了前7次回答。\n\n\n\n但还是努力和收获正相关性较强的一门课吧……
127757,664,盛奎川,2020-11-26 11:00:51,15,16,1,这门课事情有点多，每周都有作业+期末论文。确实老师是很认真，也很认真地想把课程变得有趣。但是才成绩上就真的有点令人无语了。我从第一节课开始每节课都坐在第二排（第一排没人坐），花在这门课上的时间真的很多，虽然不至于卷但绝对不是在混。结果成绩出来只有3.3.大一新生可能不太会写论文但是结合平常分我真的不理解自己为什么只有3.3.综合给个5分中评吧
127857,664,盛奎川,2020-11-29 03:11:50,2,2,0,秋学期的课，大概有七次作业每周都有。老师们人很好但是真的，要求3500的论文我写了5000，花在这门课上的时间很多。最后出来只有3.9，真的很不能理解。
128177,664,盛奎川,2020-12-10 08:35:02,3,3,0,老师讲的不错，但是这门课不建议选（除非走投无路），事巨多，评分还不高（我也是认认真真写作业认认真真写论文的啊，连4.0都没上）。不过能够长知识，就是最终得分不好说
131052,664,盛奎川,2021-01-25 16:51:56,0,1,1,秋学期的课，每周一份作业，最后还有一篇论文，事情真的挺多的。。。给分soso，并不是特别高，但三个老师都讲的很好
132077,664,盛奎川,2021-01-30 06:19:18,1,2,1,我也想不明白 每次作业都认真做完了 论文都认真写了修改交了最好给了个3.3 是歧视专业么 不建议大家选 事情多给分差
132210,664,盛奎川,2021-01-31 03:41:43,1,2,1,事超多，给分还不好，快跑。但是认真的说，三个老师讲课挺好的。
135301,664,盛奎川,2021-05-07 23:58:24,0,1,1,这门课三位老师都讲得很好很耐心，人也都很好。本高中纯文渣渣出分4.2，感觉还可以，基本和投入精力比较相符
138339,664,盛奎川,2021-07-08 14:27:17,4,5,1,老师人很好，每一个都会结合自己的学术研究进行讲解，亦师亦友，面对面交流，本四年不沾理科的文科生表示只要努力，5.0就在手里！
142253,664,盛奎川,2021-11-09 10:28:13,0,1,1,人特别好
142739,664,盛奎川,2021-11-15 16:16:50,-7,4,11,论文要求3000字，写了7000多，然后绩点3.3，平时每节课之后都有作业，只能说溜了
142778,664,盛奎川,2021-11-16 04:38:19,-2,2,4,生物质能源这门课作业真的多，虽然不用听课但是每周一千字作业的作业（抄ppt即可）论文也难写，大一新生只能疯狂copy，查重也降不下来，真的好绝望，结果成绩出来4.8太开心了\n\n如果你不混的话可以考虑来哦ヾ ^_^♪
142780,664,盛奎川,2021-11-16 04:52:36,5,6,1,欺负大一新生不会写论文呜呜呜
143098,664,盛奎川,2021-11-19 02:53:54,3,4,1,前面七千字的同学笑死我了，你不知道规定的论文字数上限是五千字么？连要求都不看写到7000是想卷别人吗？
144697,664,盛奎川,2021-12-23 08:11:03,0,0,0,事情少，平时上课可水，只要平时作业和论文好好的就可以了
146250,664,盛奎川,2022-01-06 04:23:57,0,0,0,生物质能源：可以让人感受到一门技术从实验室到实际工业的复杂，由于这种能源本身占比不大，非热点？知识点很细致，跟一般通识不太一样。\n\n每周作业，上课听了就是PPT的内容，很快就能写（抄）完，主要是让你复习一下。论文改到了3000字。写篇综述，格式要求达到，平时上课坐前面好好听，90+。
160452,664,盛奎川,2022-09-23 01:51:18,2,2,0,上课效率真的很高，平均一个晚上可以把3门课作业写完（反正我经常写完了微积分，线性代数，C程的作业），每周的作业基本是不用听课5分钟就能水出高分的，还不点名，要不是自修效率真的比在寝室高，我真会考虑旷课的
161953,664,盛奎川,2022-11-15 10:35:57,0,0,0,3分捏
161981,664,盛奎川,2022-11-15 14:55:31,0,1,1,事少分高，快冲
164617,664,盛奎川,2022-12-22 08:41:12,1,1,0,上课认真听，经常回答问题，作业认真写，论文也认真写，查了很多文献，结果只有3.3，是最低的通识课了。
186151,664,盛奎川,2024-01-09 05:55:11,0,0,0,最低分的通识课
25252,720,刘湘江,2016-05-09 02:30:54,0,2,2,很年轻…讲得很幽默…
31969,720,刘湘江,2016-07-05 09:16:45,3,4,1,不好\n\n
58735,720,刘湘江,2017-09-16 07:08:58,1,2,1,必须给自己的班主任打满分啊~
79850,720,刘湘江,2018-06-14 10:00:59,0,1,1,都这么帅了还有什么好说的呢？
153614,720,刘湘江,2022-05-06 03:28:04,2,2,0,闻所未闻🙏🏻
168410,720,刘湘江,2023-02-15 12:37:30,2,3,1,这个老师好像去新疆了，听说非常偏执，师生关系差得一塌糊涂，上课的材料都有点年代感了，不是很喜欢
1634,745,罗自生,2015-03-23 02:37:59,5,12,7,难得一个机灵的老师  上课不错 考试挺简单的 就是给分一般
2823,745,罗自生,2015-05-08 06:01:57,11,16,5,一定会点名。一定会吐槽报告里的标点符号。一定会刁难你。不一定会给你高分。
3333,745,罗自生,2015-06-02 11:13:54,18,24,6,上课信息量比较大，不给PPT下载，知识点上讲得还不错，会吐槽论文的排版和标点符号的全半角。
18401,745,罗自生,2016-01-21 14:22:39,-28,6,34,给分好
23428,745,罗自生,2016-09-16 11:18:31,-15,6,21,大爱ヽ(*´з｀*)ﾉ，老师人很好的，虽然比较严格，但是有利无害
27157,745,罗自生,2016-06-23 08:46:06,-12,0,12,可以可以
35377,745,罗自生,2019-02-25 15:23:51,23,30,7,老师真的比较严格 关于论文挑得比较细 不过 这个也真的是为了让我们规范 只是期末展示的时候好像排队轮流挨批呀? 期末考试是开卷 不知道最后给分怎么样 出分我会再回来的?||||||出分了 我回来了 分数比想象中低一点本来感觉已经做了万全的准备 也还可以吧...不过如果不好好做笔记 不好好抄PPT感觉是要完的 论文也要好好写多找些材料 格式规范 水过去的话....期末考试真的都是PPT 各位谨记！
35381,745,罗自生,2017-01-17 07:17:28,48,67,19,完。。。了。。。
35383,745,罗自生,2016-11-09 13:26:53,7,16,9,有负分想给负分，用了军理论文模版被批得一无是处，既然吐槽排版，那给模版呀，不给模版让我们猜喽?严厉没错，批评没错，请先给评分标准，给了评分标准我没做到我不会有怨言，不给标准是什么意思，我又不是你肚子里的蛔虫
35384,745,罗自生,2017-01-18 08:46:04,10,13,3,他和沈莉萍今年互换灵魂了
35385,745,罗自生,2016-11-09 13:48:53,2,4,2,很呕，呕呕呕呕呕.....
35803,745,罗自生,2016-11-10 08:14:41,2,6,4,不给PPT就算了，期末论文我改了好几遍结果被吐槽标点符号和版式问题，作业展示的环节被气炸了，特别挑剔的老师，一定会刁难你，劝能不选就不选，当然上课蛮有意思的，最后再提出一点，买书没用，题目都在PPT里面，特别坑。
36114,745,罗自生,2016-11-10 12:42:22,1,3,2,千万别选他的课你一定会后悔
36259,745,罗自生,2016-11-11 10:09:28,19,27,8,负面评论的都是上罗老师通识的，食品专业的学弟学妹别被误导。我们的专业课更严格哈哈哈不过课外罗老师绝对是一个人生导师很nice的。至于那些说什么论文模板的，你难道不知道不同的期刊格式是不同的吗？军理模板的字貌似太小了吧，大一大二的孩子还是naive。勿伸手，请自力！
36684,745,罗自生,2016-11-17 05:26:22,6,7,1,。。不想多说什么。\n\n\n\n
36831,745,罗自生,2016-11-16 07:17:33,-14,5,19,老师人很好只是很严格呀！认真的听老师上课感觉收获挺多的。\n\n最后给我的分有点让我惊喜
37001,745,罗自生,2016-11-17 04:58:57,16,19,3,绩点2.7  我还能说什么……我可是把PPT打印了带去抄的！！！
37003,745,罗自生,2016-11-17 05:04:11,4,6,2,老师上课ppt最重要，务必课后把它们都记下来。论文的挑剔也有一定的道理。但是好吧最后看到成绩我就有点醉了…
37010,745,罗自生,2016-11-17 05:57:25,-1,0,1,上通识课把PPT拍下来再打印出来考试一般没什么问题了。
37016,745,罗自生,2016-11-17 06:33:25,3,4,1,通识绩点超低
37054,745,罗自生,2016-11-17 07:47:37,8,8,0,通识课很水，想混过去想拿学分很容易，只要拍好ppt、考前整理好资料就保过；但是想拿高绩点难，老师要求还是挺严的，最后的小组展示一定要认真准备，最好问清老师的要求，比如标点符号?总之且水且珍惜吧
37058,745,罗自生,2016-11-17 08:13:34,3,5,2,上课认真听不拍照会挂。。。上课不听然后拍照把ppt打印出来 可能会高分哟
37105,745,罗自生,2016-11-17 12:02:36,2,2,0,事多，格式要求严格，给分很低
37309,745,罗自生,2016-11-18 09:22:31,3,3,0,绩点杀手，要求来的个多。还是别选这个课了。
37337,745,罗自生,2016-11-18 10:46:33,4,5,1,绩点超低
37756,745,罗自生,2017-01-17 07:35:38,1,5,4,他还不尊重学生！！
41273,745,罗自生,2017-01-10 10:58:58,2,3,1,这老师忒吓人了
41274,745,罗自生,2017-01-17 07:08:05,1,3,2,我只想呵呵
41287,745,罗自生,2018-12-26 17:06:04,31,45,14,2016冬学期的食品安全保藏学的第一组的那个上去讲PPT的那个胖子，穿军绿色的衣服的，能不能不要那么恶心。你自己加多少分我们不管，能不能不要那么刻意的怼我们其他人。明明你自己讲的也不是那么清楚，何必鸡蛋里面挑骨头为难大家？
42008,745,罗自生,2017-01-13 11:57:50,1,1,0,老师要求比较严格，会点名，考试以ppt上的内容为主，平时尽量不要缺席，老师经常点名的，会影响平时成绩
44192,745,罗自生,2017-01-17 11:47:45,4,6,2,这个老师唯一的好处就是说话算话，人家一开始就说不会给你高分，所以就不要想了，可是没想到会那么低。。。。。\n\n不是很懂不给下载PPT，还专考PPT的目的，大概真的是训练我们拍照的技术吧，您真是用心良苦\n\n然而，事实上，期末考试确实都在PPT上，可是并没有什么卵用，就算你全都写对了，最后给分还是他随便给的吧，总之就是各种要求，非得按照他说的来，然而就算按照他说的做了，也不会有好结果，这老师，真是谜。。。。
49015,745,罗自生,2017-03-21 11:50:49,-8,0,8,我爱你
59254,745,罗自生,2017-09-20 11:21:02,2,2,0,我当年出分83  3.9  觉得还行，虽然比想象中差了点但也没怎么样，几天后再看，成绩变成了80   3.6   fine，还有这种操作
61519,745,罗自生,2017-11-18 08:35:34,1,1,0,_(:з」∠)_
64933,745,罗自生,2017-12-28 03:53:40,-2,4,6,嗯我是上罗老师专业课的，来正个名。罗老师虽然说话非常直接不留情面，要求也稍微高一些（但是比我预期的严格好很多了），不过讲课真的很好啊，会给我们启发的呀。那些比较严格的要求也是对你自己好呀，多学习一些不是很好吗？而且说不给模版，去翻翻罗老师的论文不就知道了吗？要说给分，考试也很简单，背一下就好，自己平时也把展示和论文做好，罗老师会给你高分的。
65712,745,罗自生,2018-01-08 11:26:36,3,3,0,给不幸碰上的同学们提个醒：论文一定要注意格式！具体包括：脚注符号在句号内，段落对齐，顿号逗号不要乱用，引文格式严谨（最好选用知名期刊文章），字母缩写要展开来（不然听者不知道那是什么东西），还有，展示控制时间！
65714,745,罗自生,2018-01-08 11:40:20,2,3,1,本来是上沈老师的课的。结果半路杀出了个罗某，分低事多，还特别挑剔。
69737,745,罗自生,2018-01-25 09:45:18,2,2,0,老师很严，不会写论文的同学慎选，因为你会被整的很惨，而且要求不是一般的多，老师中途接这个班，让人真的很失望
69835,745,罗自生,2018-01-25 13:25:22,2,2,0,老师中途接的班，第一次看到通识课还会给出这么低的分的，关于老师个人的性格和说话的方式我就不好说了，一言难尽。
70155,745,罗自生,2018-01-26 07:32:29,1,1,0,老师中途接的班，写论文之前问他有什么要求，他说什么都没有，写好交上去以后一大堆要求，不明白为什么之前不交代清楚。老师说话算话，说不给高分就绝对不给，通识课里分最低的，绝对一个绩杀。?(?O?)
74704,745,罗自生,2018-03-05 08:09:36,3,3,0,唯一一门挂的通识。。。。。
90274,745,罗自生,2018-11-23 02:35:13,2,2,0,通识绩杀，慎选
106692,745,罗自生,2019-04-29 03:08:23,-2,2,4,老罗人真的很好！
112172,745,罗自生,2019-07-03 18:44:23,9,11,2,…我可能不能保研了…
114126,745,罗自生,2019-07-09 00:24:26,-7,1,8,其实老师上课还挺负责有趣的，只是我对这个确实不怎么感兴趣。把所有的ppt都拍下来拿去考试了，小组展示的做的一般就，竟然有4.8，真的万万没想到
114222,745,罗自生,2019-07-09 06:02:32,2,2,0,ppt全拍下来裸考去就行了
116083,745,罗自生,2019-09-03 07:09:37,2,2,0,我太难了/(ㄒoㄒ)/~~
116788,745,罗自生,2019-09-16 01:53:57,2,2,0,小学期绩杀 太难了
119783,745,罗自生,2019-11-15 23:49:29,1,2,1,讲的很无聊?通识课绩点挺低 我还打印了PPT去抄 结果只有2.7
119791,745,罗自生,2019-11-16 00:22:42,-4,0,4,没太有意思\n\n
122824,745,罗自生,2020-04-11 04:17:00,3,6,3,19年秋学期上的食品保藏，没有展示和论文，一次考试。老师讲得很认真的，说话也很温柔。虽然上课确实是要狂拍PPT，但整理笔记和听课的过程中也很有收获，几个重要的概念，老师也有提及。老师不是为学生的绩点服务的，如果一开始就没有抱着认真学习的态度，为什么还要期待高绩点呢？
132165,745,罗自生,2021-01-30 18:52:42,2,3,1,还不错的老师，没有同学那里评价的那么不堪，给分确实差一点，但是人很认真讲课也不错。推荐选
133480,745,罗自生,2021-03-01 06:14:50,-2,3,5,老师很负责任
142429,745,罗自生,2021-11-11 10:08:54,2,3,1,（食品安全保藏导论）虽然给分不咋地，但事少是真的，课外除了写论文没有花过别的时间。本人全勤+好好整理ppt+认真写论文，最后3.9，感觉还可以吧毕竟事少。但如果不是真心感兴趣的话听课还挺痛苦的，因为罗老师每次课都能讲七八十页ppt……
142430,745,罗自生,2021-11-11 10:19:52,3,3,0,食品安全保藏导论\n\n事真的少，分给的还不错，课程内容也还可以，还是可以学到一点东西，老师非常负责任，人很好，推荐选
142431,745,罗自生,2021-11-11 10:24:32,-1,0,1,很不错
142447,745,罗自生,2021-11-11 13:03:26,2,2,0,上课不点名\n\n最后一节课会对论文进行公开指导，对于大一来说还是很有用的
142464,745,罗自生,2021-11-12 01:51:15,2,5,3,给分挺差的，非常认真的记笔记结果最后只有3.9。一直到最后一节课才发现认真记笔记不如直接用智云课堂截课件，然后考试的时候直接抄课件。认真记笔记还不如完全不听课，考前把课件打印出来看一眼。唉，真的好失望
142481,745,罗自生,2021-11-12 04:53:41,3,3,0,不知道评分怎么评的…截课件是重点
142491,745,罗自生,2021-11-12 06:45:27,3,3,0,考试开卷，考的全是ppt上的内容。但老师不发ppt。所以最好平时上课的时候就在智云课堂上截ppt的图为考试做准备。\n\n最后一堂课当场批改课程论文，提的建议对大一同学们帮助还是挺大的。
142535,745,罗自生,2021-11-12 17:17:55,1,3,2,嗯…感觉就是中规中矩吧\n\n因为第一轮死活选不上通识课 所以二轮选课的时候就着容量未满盲选的…\n\n查老师里的评价确实挺吓人 但还是硬着头皮上了 其实老师人不错的 挺负责\n\n但是老师确实很注重论文格式 会在最后一节课当堂批改论文 揪出你们小组的错误 但大家都半斤八两 所以其实也就没啥好纠结的\n\n考试确实基本都是PPT 除了最后的论述题本人比较菜真的答不来了…\n\n最后出分4.2  确实被正态了 但确实又好像没什么好说的…
142671,745,罗自生,2021-11-15 03:55:21,0,4,4,挺好的老师
142807,745,罗自生,2021-11-16 10:11:46,6,6,0,专业课给分都这么差
144065,745,罗自生,2021-12-17 07:36:38,2,2,0,通识课老师教的东西还挺多的，讲的也挺细，期末就考ppt上的东西，只要把ppt看好记熟，问题不大。老师喜欢互动，人也挺活泼的。
148276,745,罗自生,2022-01-12 04:33:32,2,4,2,食品安全保藏导论。可以选，课程压力不大，推！！！
149670,745,罗自生,2022-01-16 09:46:43,0,2,2,老师好，老师妙，老师给分超级高！
149928,745,罗自生,2022-01-18 00:26:33,2,4,2,事儿少 很好水 老师也比较容易说话 给分超级高 考试很简单 整理好ppt就无敌了！食品保藏学！本人大一上上过最爽的通识课！都给我选！！
149959,745,罗自生,2022-01-18 04:53:45,3,4,1,食品安全保藏导论，课不水，认真上能学到干货的。期末考试就是ppt，所以上课完全不听没关系。老师没有以前的评论说的那么绩杀，人也比较温柔。事少，就小组合作论文+期末开卷考。水了一学期（😬）谢谢老师给我4.8
154232,745,罗自生,2022-05-26 12:38:41,3,4,1,罗老师虽然脾气略怪，要求略严，但是人还是很好的，尤其是对研究生很负责，很多都帮忙给找工作，工作后都还会给学生帮忙
154766,745,罗自生,2022-06-04 23:59:20,2,2,0,上学期上的，全程没听课，考核一个小组论文，期末开卷考，打印ppt全都翻的到，4.8
161279,745,罗自生,2022-11-03 10:57:11,0,1,1,运气不好的同学不建议选😅老师自己分小组，五个人的小组只有我一个不是留学生。下课立马找他想调整一下，老师：“那这样其他同学会有意见啊。” 你要不要听听看自己在说什么？感情我一拖四就不会有意见呗？倒不是说课程作业有多难，纯属是被恶心到了😅
161603,745,罗自生,2022-11-09 09:53:57,0,2,2,老师真的很好，他备课很认真讲的知识也很有趣（虽然不听也没关系但闲着听一听还是挺不错的），会有一些互动但是没有课堂表现分大家也不用紧张。他真的希望大家都能学到东西，不过一学期也没点过名，上课我也挺水的，就挂着智云截ppt转文字供期末使用，结课有个pre和小论文（小组 基本裁剪），考试很简单ppt都能找得到，给分很好，老师超级和蔼，不知道为什么分数这么低，在此为罗老师正名！
161838,745,罗自生,2022-11-14 10:43:31,2,2,0,开卷考全答出来 论文认真写 和同学一样喜提4.2 不知道是今年给分普遍低了还是怎样
161856,745,罗自生,2022-11-14 14:13:17,2,2,0,开卷考客观题全对 论文认真写 上课一点没听 4.2 去年好像给了不少4.8 就这样吧
161897,745,罗自生,2022-11-15 01:49:02,0,2,2,只想说被正太了，低，感觉我们小组都低，没有上学期说的那么好
164914,745,罗自生,2022-12-27 13:12:53,-2,2,4,罗老师说实话还是可以的，上通识课友好，而且有些考试题目课上会明显地暗示，论文要求确实严格，还有个期末的展示吧，反正事挺少的。就是要把PPT上的内容一页一页复制到我的笔记上去有点累，我认为如果认真完成任务和考试绩点不会差的
165417,745,罗自生,2023-01-04 14:27:26,1,2,1,“我知道你们对于通识课采取的是什么态度，所以我不会发PPT，期末考一道题都不会写的话不要怪我，自己认真听”
166333,745,罗自生,2023-01-12 03:37:15,4,5,1,食品安全保藏导论\n\n老师真的很好，上课也有互动。考试开卷，内容都在PPT上，平时上课的时候截图截好期末就会轻松很多。在课上是真的能收获食品保藏的知识的！最后4.2感觉还行。另外希望老师身体健康！
166416,745,罗自生,2023-01-12 08:06:08,1,1,0,通识，不发ppt，要自己存，不存的话期末可以埋了
169635,745,罗自生,2023-02-27 08:14:17,-1,1,2,老师挺好的
169675,745,罗自生,2023-02-27 10:39:41,0,1,1,给老师上个分，我觉得老师讲课还是非常认真的，期末考试不难也翻的到
173087,745,罗自生,2023-05-13 05:09:27,2,3,1,#%#*@/%#%*!=，￥*
182396,745,罗自生,2023-11-15 12:57:29,4,6,2,水杯老师，一节课讲近百页PPT，又难又混乱。期末考试不给PPT全要自己去智云文字识别整理，最后绩点还给得贼烂，卡到4.2不给更高。期末论文不怎么看内容就专门抠格式的毛病，标点符号全角半角，段首空两格，参考文献找不到，还说学生来上他的课是混学分，连个论文都不认真对待，格式不对全是态度问题。我寻思着你也没在课上教过我们格式啊？我们生来就会吗？那你上课的课件序号标的乱七八糟的、普通话又不标准的我们就没意见啦？很无语的老师
182406,745,罗自生,2023-11-15 15:01:11,1,3,2,不知道为什么老师分这么低，其实老师人很好上课也很认真，不点名，虽然不发ppt但智云上基本都能整理到，考前理了一天差不多理完，考试的题目都是可以直接翻到的，期末论文要求高，记得认真对待。平时没听课，最后绩点不高也不低，很满意，推荐选！
183839,745,罗自生,2023-12-01 03:09:19,2,2,0,。。。
185800,745,罗自生,2024-01-04 12:40:22,0,2,2,打了五分是因为希望得5.0（双手合十）其实连五分都不值 好恶心
188562,745,罗自生,2024-01-19 08:57:25,-1,2,3,《食品安全保藏导论》，很难不赞成楼上的“水杯老师”\n\n\n\n点名：除了有次课分小组，其他时候没点过名\n\n\n\n平时上课会走动，专挑没抬头听课同学问问题，回答不出来就会被冷嘲热讽一顿\n\n\n\n第7节课他要录像，让我们配合坐前面，并且想找同学当托；我很不幸被盯上了，当时想推脱，结果他来一句“跟浙大教授合作是你的荣幸”，好好好，您排面最大了\n\n\n\n平时没作业，要准备的就是期末小组论文加展示。而他对论文格式要求极其严格甚至还自相矛盾，比如我们组的论文就按照他说的期刊要求写，结果最后说我们的字体太小，“太小气”，我寻思这不是您的要求吗？\n\n\n\n期末开卷考考他私有的ppt\n\n\n\n我本人每节课都去了，在听到某些部分的时候也会认真听一段，我相信我对这门课至少是有上心的\n\n\n\n期末有一题没找到，总评79，喜提3.3。\n\n\n\n我打两分，多的一分是给您上课偶尔的幽默\n\n\n\n这课谁爱上谁上吧
190637,745,罗自生,2024-03-12 13:37:46,1,1,0,对于想要高绩点同学直接劝退，如前几位同学所说，课程论文的格式要求很严格，最后给分也不会给很高，平时上课还会点同学回答问题\n\n除开给分来说，听课还是能学到很多东西的，但是最后考试得分只能看个人PPT整理得全不全了
198929,745,罗自生,2024-09-13 04:02:25,2,2,0,老师很严格但是很幽默，通识课互动很多。想水的慎选
203277,745,罗自生,2024-11-18 18:44:22,1,1,0,果蔬保鲜工程，罗老师其实讲挺好的，专业课里难得的好老师。看得出来老师每次上课都是用心准备了的，也希望多教一些东西给我们。\n\n期末和历年卷没有其他专业课关联那么大，会出新题，背的东西很多，有一些写不出来。不过其实应该PPT上都有，都是上课内容。\n\n罗老师可能要求是高一点，最后绩点没有特别高吧，，但还是给了10分。
203547,745,罗自生,2024-11-20 03:24:28,3,4,1,4.8，吹爆毒舌心善罗老师
207141,745,罗自生,2024-12-19 11:32:45,0,1,1,挺好的老师，上食品安全保藏导论，七十多个人的课就来了二十七个人也没点名。上课严肃又不失幽默。\n\n就是个天天惦记蜜饯的可爱老师啊
208247,745,罗自生,2025-01-07 06:55:57,1,1,0,上课挺风趣的，挺严格的老头，对小组作业的点评很严格（甚至有些刻薄吧），期末考认真写＋小组作业不要复制粘贴给分还是不错的
209803,745,罗自生,2025-01-07 06:48:16,0,1,1,食品安全保藏\n\n小组作业被骂的狗血淋头\n\n但是4.8✓
209931,745,罗自生,2025-01-07 12:43:10,0,0,0,我是大一文科生，上的食品安全保藏导论，老师人很好的，很想教会我们有关食品的知识。上课不点名，认真听也能学到很多东西，不想听干自己的事就行，虽然有时候要提问，但是答不上来也没关系的，老师最多会开两句玩笑，期末考试开卷，题目都不难，最终拿到了4.5的绩点，非常开心
217457,745,罗自生,2025-04-10 15:36:32,2,2,0,罗老师基本不点名，但是上课喜欢叫人回答问题（不是点名回答，是随机叫低头的人起来回答）\n\n老师讲的内容有些挺实用的，但上课不算有趣\n\n小组作业写论文会给模板，但是给的模板一般，不如自己上知网找类似主题论文。论文格式方面建议上b站找教程，参考文献等格式一定要准确无误（ai写的一定要注意标点符号全角半角）\n\n不过老师刀子嘴豆腐心，给分非常好😍
30877,838,冯凤琴,2016-07-02 17:24:31,5,10,5,给分极差
85600,838,冯凤琴,2018-07-20 11:13:04,4,4,0,垃圾课程不解释
120534,838,冯凤琴,2020-01-12 08:33:18,9,13,4,食品安全通核课 强烈推荐 巨水无比的通核
122515,838,冯凤琴,2020-03-03 02:03:25,-3,2,5,垃圾老师
149771,838,冯凤琴,2022-01-17 00:45:08,2,2,0,对ppt的美观有一定的要求。
164958,838,冯凤琴,2022-12-28 05:47:31,2,2,0,别选，下头
166964,838,冯凤琴,2023-01-14 11:22:48,1,1,0,感觉水的，比其他通核要轻松点。给分看情况吧，我还行，个人比较满意
176237,838,冯凤琴,2023-06-28 06:46:55,0,0,0,食品化学事少给分不错，统共学了3天~
191066,838,冯凤琴,2024-03-31 13:09:58,0,0,0,笑面虎
9343,913,崔笛,2015-10-22 09:40:19,-9,4,13,好好好
51194,913,崔笛,2017-07-11 06:24:58,13,16,3,毁人一生
57149,913,崔笛,2017-07-05 22:51:25,12,13,1,屁事多 还很扣
67525,913,崔笛,2018-01-21 12:19:58,5,6,1,。。。。
79817,913,崔笛,2018-06-14 03:20:31,36,41,5,这是一门30学分的课
83313,913,崔笛,2018-07-10 05:14:26,6,7,1,呵呵呵
83314,913,崔笛,2018-07-10 05:15:13,5,6,1,事情多
92190,913,崔笛,2018-12-27 03:29:20,10,11,1,毁人一生 古板死脑筋
105016,913,崔笛,2019-04-02 08:04:06,9,11,2,毁人一生不是夸张 是真的
108067,913,崔笛,2019-05-14 03:19:36,11,12,1,建议退课
113062,913,崔笛,2019-07-05 22:09:51,1,4,3,令人作呕\n\n助教也是
113088,913,崔笛,2019-07-05 23:05:59,13,14,1,真的恶心
113108,913,崔笛,2019-07-05 23:32:24,22,26,4,有一种虚伪 叫崔氏关怀\n\n有一种绩杀 叫崔氏正义\n\n有一种形式主义 叫崔氏仪式\n\n有一种不知所谓 叫崔氏精通\n\n\n\n于是\n\n这个教师团队给你\n\n一个夏天的深刻记忆\n\n关于花里胡哨\n\n关于天使魔鬼\n\n关于垃圾分类\n\n\n\n还好\n\n山高路远\n\n后会无期
113194,913,崔笛,2019-07-06 01:26:23,13,14,1,破烂一个，事情贼多，课不咋交，考试还贼难，专业绩杀，大规模给你挂科，建议老师走人
113213,913,崔笛,2019-07-06 01:43:21,13,14,1,崔迪是谁？\n\n没流量，没人气，上她的课没压力？\n\n这课突破了课程学时的极限\n\n周末会让你留在学院做个pre\n\n中途参加过ASABE的征途\n\n最后换来的是绩点不堪入目\n\nall right，如果你的心态是大碗宽面，ok，那你去吧\n\n\n\n
113217,913,崔笛,2019-07-06 01:55:10,5,6,1,可能这就是副教授吧\n\n
113218,913,崔笛,2019-07-06 01:55:19,8,9,1,nmsl
113237,913,崔笛,2019-07-06 02:27:54,2,3,1,nmml
113364,913,崔笛,2019-07-06 10:02:42,-1,2,3,崔老师，您真好
113996,913,崔笛,2019-07-08 07:06:34,-4,2,6,助教和老师都挺认真的啊
114068,913,崔笛,2019-07-08 16:52:15,4,5,1,我来只是为了点个一分，为了这个老师多讲一句话都令人作呕
128755,913,崔笛,2020-12-25 07:09:27,1,3,2,实验课只交一项（自学能力！）
143514,913,崔笛,2021-11-26 03:03:41,0,1,1,。。。
143515,913,崔笛,2021-11-26 03:03:34,0,1,1,。。。
143516,913,崔笛,2021-11-26 03:04:27,0,1,1,啥都不讲，啥都不会，还觉得自己巨nb
144825,913,崔笛,2021-12-25 03:23:33,-1,1,2,。。。
164822,913,崔笛,2022-12-26 10:15:09,5,7,2,生工食品为数不多的像个人的老师，上课至少还能听。
166516,913,崔笛,2023-01-12 13:51:36,1,3,2,那个国庆，突然布置了五个作业，我赶完了四个，发现第五个还没上过，去问老师，老师说布置错了，还夸我好用功。老师讲课还是听得下去的，但喜欢点名，比较呆板。
166785,913,崔笛,2023-01-13 14:51:20,7,11,4,总的来说，崔笛老师是农工里上课还能听一听的老师了，上课内容比较有逻辑性，授课也还不错，对待学生也很友好。生物生产机器人实验的时候，给了大家特别多的机会来试错；生物生产机器人课上讲的东西也不错，听一听也能收获一些知识。不过说实话，农工的课太古董了，需要改一改，学院有说在改革，就看改革力度怎么样吧
166786,913,崔笛,2023-01-13 14:51:34,6,10,4,整个生物生产机器人也就崔老师的视觉部分还能学到一些东西，也能结合着生物来……其他老师可拉倒吧\n\n实验课老师也蛮负责，基本上有问必答，都留在教室里指导，比起在院楼机房里的傻B实验课要好些\n\n老师摔伤了坚持上课，不知道给分怎么样（也不知道哪个老师给分）
166789,913,崔笛,2023-01-13 14:54:50,3,7,4,hygg喜欢的老师就是好老师
166790,913,崔笛,2023-01-13 14:55:36,2,4,2,机器人和机器人实验这两门课就崔老师最当人了吧。理论课机器视觉部分有干货，实验课小车部分一步步带着我们做，还给出不少指导。不管她以前怎么样，她现在在我这里就是一位好老师。
167981,913,崔笛,2023-01-21 05:35:03,6,8,2,生物生产机器人给分不大行\n\n但是老师还是很认真的
167982,913,崔笛,2023-01-21 06:12:32,-22,1,23,除夕出分，居然发现机器人满了，心疼除夕还在工作的老师和助教学姐
168028,913,崔笛,2023-01-23 03:49:10,9,12,3,楼下要秀成绩的大可不必拉上负责的老师和助教，直接说我是大农工学子***，我可牛逼了。都大三下了还一个高三学生的思维，你确实适合读我们的专业
178238,913,崔笛,2023-07-08 11:35:31,-1,1,2,这种课你都能觉得你学到东西 你是有多菜？\n\n不针对老师，因为不是一个人这样，整个农工都是这样。\n\n你出去别的学院转一圈会发现在这里“认认真真”学四年最后和高中生没什么区别，在哪个学院你都不如别人专业，因为这个专业定位就有问题。
183078,913,崔笛,2023-11-22 05:01:01,-1,0,1,这就是农工人吗，连cuidi的这些b玩意都能觉得学到东西了，不得不说你们这些按部就班学农工专业课的人是真菜啊
184373,913,崔笛,2023-12-18 10:33:01,-1,0,1,表里不一嘻嘻
188212,913,崔笛,2024-01-18 12:03:45,0,1,1,吹笛傻逼玩意，跟着yb混成这样也算牛的
188421,913,崔笛,2024-01-19 03:11:03,0,2,2,非常的古板，蠢驴
189823,913,崔笛,2024-01-30 08:25:47,0,1,1,nmslnmslnmslnmslnmslnmsl nmslnmslnmslnmslnmslnmsl nmslnmslnmslnmslnmslnmsl nmslnmslnmslnmslnmslnmsl nmslnmslnmslnmslnmslnmsl nmslnmslnmslnmslnmslnmsl nmslnmslnmslnmslnmslnmsl nmslnmslnmslnmslnmslnmsl nmslnmslnmslnmslnmslnmsl
190874,913,崔笛,2024-03-23 07:44:44,0,1,1,真挺令人作呕的✋
191803,913,崔笛,2024-04-30 10:01:44,9,10,1,吹笛？？我们来评论区搓麻将吧！ \n\n\n\n 🀙🀚🀛🀜🀝🀞🀟🀠🀡🀢🀣 🀥 🀗🀐🀏🀎🀍🀌🀋🀊🀉 🀥 🀖 🀗 🀙 🀥 🀘 🀗 🀙 🀔 🀕 🀡 🀁 🀁 🀖 🀗 🀁 🀁 🀘 🀎🀍🀌🀋🀊🀉🀇🀉🀇 🀁 🀐🀏🀎🀍🀌🀋🀊🀉🀇🀆🀅🀁
192339,913,崔笛,2024-05-16 02:34:24,9,10,1,250\n\n250\n\n250\n\n遇上这种煞笔导师真有够倒霉的
192633,913,崔笛,2024-05-26 02:38:09,-4,1,5,ibe之光，推荐所有本科生都进崔老师组\n\n崔老师的眼界一定会带让大家受益匪浅\n\n加入我们新时代撸起袖子加油干
193251,913,崔笛,2024-06-05 06:11:56,-4,1,5,非常好的老师\n\n备课认真，会定期小窗私聊同学学习的情况\n\n给王老师打十分！
194182,913,崔笛,2024-06-22 11:08:20,-4,1,5,认真负责，在吹老司的课上学不到东西的同学建议多找找自己身上的原因\n\n作业是不是认真做了\n\n考试是不是认真复习了\n\n不要总是抱怨这门课是30学分的\n\n凡事多想想自己的问题
197722,913,崔笛,2024-08-04 11:58:20,-5,1,6,认真负责，在吹老司的课上学不到东西的同学建议多找找自己身上的原因 作业是不是认真做了 考试是不是认真复习了 不要总是抱怨这门课是30学分的 凡事多想想自己的问题
214614,913,崔笛,2025-02-14 14:34:43,0,1,1,不认真负责，在吹老司的课上学不到东西的同学建议多找找吹老司身上的原因 作业是不是认真留了 考试是不是认真出题了 要总是抱怨这门课是30学分的 凡事多想想吹老司的问题
23858,934,叶章颖,2016-04-19 02:00:46,4,5,1,呵呵哒了
49486,934,叶章颖,2017-04-17 02:09:42,5,5,0,讲得烂还点名
79436,934,叶章颖,2018-06-05 03:29:05,-3,0,3,还不错
122906,934,叶章颖,2020-04-20 02:18:18,2,2,0,思维不清，还要点名，听课就是浪费时间
134406,934,叶章颖,2021-03-27 02:04:44,0,1,1,考试是书本原题，抄还抄错了，漏抄了一个条件，题目根本就是无解。服了老师，也服了做题的同学。这就是浙大～恕不奉陪。
157107,934,叶章颖,2022-06-22 02:50:50,8,8,0,绩杀！
157119,934,叶章颖,2022-06-22 03:13:44,7,7,0,绩杀，纯纯nt课程
168387,934,叶章颖,2023-02-15 08:46:44,3,3,0,第一节课：同学们，我这课不会点名的\n\n第二节课：我们来点名，看看谁没到\n\n有碍观瞻的老骗子了
175242,934,叶章颖,2023-06-22 18:55:57,12,13,1,纯纯傻逼一个，最后一周弄个探究实验（就是上去被他怼），大傻逼。农工老废物真多，叶章颖算一个！
176055,934,叶章颖,2023-06-27 13:55:28,3,3,0,杀疯了，期末考试根本来不及写。老师，绩你抬没
185839,934,叶章颖,2024-01-05 00:21:23,0,0,0,老师其实算比较和善的 但是正在期末考试的时候还要我们准备pre确实太抽象了
3234,940,朱加进,2015-05-22 03:34:19,1,6,5,萌萌的老师，一直在笑…不过略水。。
6599,940,朱加进,2018-03-19 23:45:37,-5,12,17,傻逼
6763,940,朱加进,2015-07-22 10:04:31,15,18,3,人看起来那么憨厚……给分惨烈 肉疼……
23426,940,朱加进,2016-03-29 15:01:51,21,26,5,作业神烦然而他自己觉得超简单。。。每个作业要交一个ppt
24633,940,朱加进,2016-05-02 11:54:31,1,5,4,老师很认真，作业很多，
27805,940,朱加进,2016-06-27 15:49:27,-2,1,3,呵呵呵
30743,940,朱加进,2016-07-02 10:53:13,3,5,2,不知道上了什么，，结果要考试，，一脸茫然。
77194,940,朱加进,2018-05-03 13:55:03,-1,1,2,zzzz
107496,940,朱加进,2019-05-06 02:19:41,-7,0,7,其实老师的营养学给分还是不错的，只要你考试好好复习了
112441,940,朱加进,2019-07-04 07:44:43,0,0,0,实验课作业多。最后一节课老师说的重点非常有用，好好背！
124732,940,朱加进,2020-07-07 09:20:26,1,1,0,老师上课略无聊（PPT打天下） 这学期线上所以没做实验 课程考核就是实验报告+课程论文 因为大一下还没上实验课所以无基础 都是照着高中经验、问学长学姐最后完成的实验报告 课程论文算用心写了 没想到绩点那么高 真的很开心（诧异
129503,940,朱加进,2021-01-06 10:49:39,5,5,0,作业多又复杂，一门通识选修课，整得太过于专业化了，作业真的太复杂了，受不了
132368,940,朱加进,2021-02-01 06:45:37,4,5,1,作业多给分还低
135563,940,朱加进,2021-05-14 01:03:23,7,7,0,平时作业挺多（三次实验+一次小组展示+一次课堂作业），鼓励内卷，然而卷了也没啥用；\n\n考试卷面扣得莫名其妙，给分也莫名其妙，预估卷面八十几（是真的八十几，不是自我感觉良好）最后3.3……这据说已经不算差了……\n\n点名
138824,940,朱加进,2021-07-11 05:17:43,1,1,0,狗屎体验，辣鸡老师
168406,940,朱加进,2023-02-15 12:31:26,2,2,0,水平太差了，所以只能打哈哈
218026,940,朱加进,2025-04-19 09:15:08,0,0,0,营养学复习的破防，，前来打差评，，\n\n讲课依托，PPT也是依托，，，没啥重点，，
218793,940,朱加进,2025-05-06 03:19:28,0,0,0,老师注册营养师已经过期了，别老说自己是学院仅有的几位有证书的老师了（捂脸）\n\n了解过来只能说给分极差，出卷更是无语，这课大家要加油
117710,1064,王永维,2019-09-29 15:07:19,1,1,0,傻逼老师，上课随机分组。
119430,1064,王永维,2019-11-13 00:46:12,6,7,1,机械制图及计算机辅助设计 这门课的设置真的很不合理。上学期学的“机械制图及CAD基础”这门1.5学分的课，学到的东西都比这门2.5学分的多。关于零件图的制图规则，工程图学早已学过；关于装配图的规范，1.5学分的课也介绍得很好；关于老师在课上花大功夫介绍的autoCAD，真的没必要，为什么要用教室里2004版的？现在的版本里面每个功能都有介绍，根本不需要学，简直傻瓜操作。Solidworks可能还需要多讲讲，但老师只打算上一两节课，还好我上学期已经学会solidworks了…反正，这课的存在价值真的不太明晰，感觉1.5学分的机院的“机械制图及CAD基础”再加上“工程图学”完全可以覆盖这门课啊。
119594,1064,王永维,2019-11-14 03:52:43,1,1,0,喝~呸！你TM个憨批！
120532,1064,王永维,2020-01-12 08:28:42,1,1,0,给分细则很迷，感觉在乱打分
123489,1064,王永维,2020-06-09 06:49:34,6,6,0,上课太枯燥，物料学PPT作业毫无意义，重点知识不如看书自学。
152826,1064,王永维,2022-04-20 07:48:00,0,0,0,都给安排的明明白白，那你弄这么多选题干嘛呢
174278,1064,王永维,2023-06-08 16:46:44,8,9,1,生工食品这个傻卵子学院最恶心人的一点是，他恶心了你还要教你写心得体悟夸夸他，我他妈夸你妈的，一天到晚心得，得你妈的，一群臭傻逼。
175239,1064,王永维,2023-06-22 15:55:33,1,1,0,傻卵！
176357,1064,王永维,2023-06-28 14:12:06,2,2,0,byd sgsp学院，怎么能搞出这么傻逼的课程的啊
178023,1064,王永维,2023-07-06 10:11:14,2,2,0,你是会给分的
178033,1064,王永维,2023-07-06 10:20:31,2,2,0,赶紧似一似吧
178234,1064,王永维,2023-07-08 11:15:51,0,1,1,1. 非常喜欢点名；\n\n2. PPT 作业乱给分，认真做的人拿到的分数还不如那些直接把论文文字截个图贴到PPT里的人的；\n\n3. 提供的实验选题完全是自己拍脑袋想出来的，自己都没有做过，并且提供的实验器材还是有问题的；\n\n4. 表面和善，但是最后给分非常糟糕；
179290,1064,王永维,2023-09-07 12:53:53,-5,1,6,王老师，上课很认真，会问学生基础，调整课程
197034,1064,王永维,2024-07-07 00:36:44,0,0,0,过了✌️
197065,1064,王永维,2024-07-07 04:37:44,4,4,0,探究性实验直接让博士生带，仪器数据不准，还要写成论文格式，考试ppt上千页，还不能和生物环境一样半开卷，生工食品最脑瘫的专业课。
220558,1064,王永维,2025-06-18 13:08:26,-1,0,1,surge说你不行
221006,1064,王永维,2025-06-20 16:03:25,0,0,0,查到十年前这门课还是开卷的，就跑过来打差评了
56643,1082,应义斌,2017-07-04 06:38:45,11,13,2,农业工程毕业没用，那废话，你把我专业名字改回去啊！
108212,1082,应义斌,2019-05-16 13:10:28,8,10,2,联系退课
125336,1082,应义斌,2020-09-07 04:22:03,14,20,6,极其官腔的学术官僚。
128568,1082,应义斌,2020-12-24 04:01:20,21,28,7,国家精品课程就这？？？事巨tm多，分巨tm低。未来是农业工程的！！！农业工程NB！！！
167098,1082,应义斌,2023-01-15 03:05:33,18,22,4,我张一驰实名点赞我导yb老师
168384,1082,应义斌,2023-02-15 08:35:15,7,9,2,欢迎学习规章制度100页，全文背诵哦
169369,1082,应义斌,2023-02-25 15:25:58,7,9,2,屏幕前是后浪，田野里有希望，吗？？一个在农业工程（劝退专业）保研选手的自述：https://www.cc98.org/topic/4927538\n\n抄底好像要翻车，求问2020级退学的话，应届生咋算的？：https://www.cc98.org/topic/4970998\n\n农业工程的逻辑缺陷：https://www.cc98.org/topic/5054411
173088,1082,应义斌,2023-05-13 05:31:43,9,9,0,快逃，本科生千万别被骗了！
189825,1082,应义斌,2024-01-30 08:31:57,7,8,1,ibe是真的，套皮科研，我们不看别的，看那些拿出来宣传的“好论文”，都逃不出拿cv三大会里的一些模型，改一改，放到橘子上跑一篇，苹果上跑一篇，橙子上再跑一篇。为什么yb年纪这么大了还要挂名？可能这就是高引学者吧！ibe，nb！！！！
198118,1082,应义斌,2024-08-31 15:17:44,3,4,1,yyb one day no go away from sgsp\n\nsgsp bad bad bad for one day\n\nf**k u sgsp
8891,1141,李春英,2015-09-30 00:37:36,1,2,1,上课简直不知所谓，老师自己讲的东西都是前后矛盾的。实验课比较有趣。
10076,1141,李春英,2015-11-15 12:27:28,1,1,0,老师讲话没有逻辑，PPT内容啰嗦不清，考前不划重点，考试内容万万没想到。然而它是必修课，兄弟姐妹们珍重。
11621,1141,李春英,2015-12-08 06:36:15,0,0,0,不知所云。
16454,1141,李春英,2016-01-18 06:19:55,0,0,0,嗯，呵呵。
25008,1177,苏平,2016-05-05 00:17:03,0,0,0,老师挺好的 实验很有意思 考试之前划重点 出的题也不难 就是给分很坑而已
152724,1187,郭希山,2022-04-19 02:24:35,9,9,0,纯纯傻逼
155459,1187,郭希山,2022-06-13 05:50:35,8,9,1,上课完全没有条理，讲课全看心情从他的文件夹里随便挑俩PPT敷衍一下，实验课完全没有实验规划甚至实验指导书都没有。非常傲慢自大而有没有一点水平，在他眼里不做传感器的都是垃圾，不动手去玩单片机的都是眼高手低的，不去用一下安卓手机端编程的就是FW，实际上那章PPT的内容还全是从CSDN上抄下来的，然后说编程就这。这老师就是纯纯脑瘫，这课还要考试，上课不知道讲什么，千万别选，SB老师。在这里一比较朱松明老师上课有条理多了，有重点也能学到点东西，上课也会带很多传感器让实操使用，上课体验简直天差地别。
155495,1187,郭希山,2022-06-13 14:17:12,7,7,0,恶心的中年老男人
168405,1187,郭希山,2023-02-15 12:30:15,6,7,1,千万别选这个人做导师\n\n这将是你人生噩梦的开始
170949,1187,郭希山,2023-03-13 06:34:01,7,7,0,纯纯傻逼，觉得自己什么都懂，本专业学生都是傻逼，不如大专，上课不讲知识纯吹逼，呆逼一个
174838,1187,郭希山,2023-06-19 01:25:58,3,3,0,绝 不多说
174860,1187,郭希山,2023-06-19 05:52:19,4,4,0,好崩溃 简直是依托
195690,1187,郭希山,2024-06-29 15:09:33,1,1,0,上课很无聊，爱拉踩，也没什么重点，内容也有一大半是早就学过的。但是考试前划的重点还是很清晰的。
195748,1187,郭希山,2024-06-30 01:16:04,2,2,0,无话可说
195990,1187,郭希山,2024-07-01 04:27:59,1,1,0,我只能说难评，但是一想在贵院也正常吧。那四个2.5学分的选修课一个比一个抽象
36728,1223,方慧,2016-11-15 15:09:03,0,1,1,上课讲的挺好   每星期有一份实验报告
40075,1223,方慧,2016-12-29 05:34:47,3,3,0,简直疯了
60439,1223,方慧,2017-10-20 02:12:47,1,2,1,背着个外星人到处跑..虽然看起来人畜无害很软萌，但是给分很惨
117102,1223,方慧,2019-09-19 07:08:29,-2,0,2,课嘛...都可以选，学吧还是自学比较好，讲得比较快，而且vs.net一下午的课，听到中间很少有人能跟得住的，请谨慎选课
143828,1223,方慧,2021-12-08 01:50:40,-2,1,3,老师讲课很好，很赞
153532,1223,方慧,2022-05-04 05:15:20,6,6,0,太nt了
153533,1223,方慧,2022-05-04 05:14:46,6,6,0,真的无语\n\n莫名其妙就小测\n\n还喜欢乱点名
155318,1223,方慧,2022-06-10 16:33:48,5,5,0,精细农业，垃圾学院引以为傲的王牌课程，蠢到不能再蠢的内容，你找个厂工的都会测操场距离，都会按照步骤写你的GIS作业，都会找无人机论文ctrlCV\n\n真不知道这种课的意义是什么，事多分烂，把浙大学生当牛马使。\n\n贵院真的早点倒闭算了，别再招生害人了。
173617,1223,方慧,2023-05-30 10:09:27,1,1,0,实验指导书写的狗屁不通，美其名曰让你自主熟悉界面
194481,1223,方慧,2024-06-24 05:50:34,2,2,0,精农太无聊了，还有我真的不喜欢那些软件。
199739,1223,方慧,2024-09-28 13:30:49,1,1,0,上过程序设计课，基本上是带你过一遍概念。算是oop基础入门吧。老师人感觉其实挺好的，也解释过这些实验报告是要给学校留档用。对于完全没代码基础的小白可以考虑选个设计课入门一下。
15370,1225,胡亚芹,2016-01-14 05:43:21,8,9,1,好老师！Q
23810,1225,胡亚芹,2016-04-17 14:24:36,5,6,1,胡老师超级好！ww
23982,1225,胡亚芹,2016-04-23 15:41:51,5,5,0,老师人好！
24180,1225,胡亚芹,2016-04-28 06:28:20,5,6,1,胡老师简直太良心了！很有少女心 特别善良 给分好的没话说 喜欢！
35290,1225,胡亚芹,2016-11-07 13:43:43,7,7,0,超认真负责的老师，3000字心得真的会自己看，明年必选老师乳品工艺学！
36258,1225,胡亚芹,2016-11-11 10:02:12,5,6,1,中午考完，下午出分。给分良心
36273,1225,胡亚芹,2016-11-11 11:51:59,6,6,0,老师人真的超级好呀～
49754,1225,胡亚芹,2017-04-25 11:51:08,2,2,0,老师超好
65595,1225,胡亚芹,2018-01-07 02:00:14,0,2,2,没见过这么可爱的老师！！！
80775,1225,胡亚芹,2018-07-01 01:56:17,2,2,0,老师人超级nice，上她的课很享受！实验的3000字心得会看 PPT也是 还没考试没出分 就已经很想评10分
90630,1225,胡亚芹,2018-11-24 15:30:48,0,0,0,给分很好啊。考试周考试多，没有在这门课上花很多时间复习，结果很不错啦～
110355,1225,胡亚芹,2019-06-26 02:38:09,1,1,0,进浙大以来碰到最温柔可爱的老师！发邮件都会及时回 还满满的鼓励的话T^T（本人非食品专业）第一天早上考完第二天早上就出分 乳品工艺学 都给我选！！
110357,1225,胡亚芹,2019-06-26 03:37:55,2,2,0,这是 什么 神！仙！老！师！！！！\n\n昏天暗地一上午然后打开qq发现我还没起来的时候就在谢谢老师了？昨天早上考的啊这是什么神仙速度！老师超级温柔超级好！不好意思当面表白嘻嘻胡老师我好喜欢你！
117030,1225,胡亚芹,2019-09-18 11:30:13,0,0,0,贼棒?
124130,1225,胡亚芹,2020-06-25 02:38:19,3,3,0,食品学院里难得的天使，一点钟发私人消息能秒回的神仙老师！\n\n上课水平符合学院常规情况，但非常负责；考试属于常规，想水想学都可以在这里找到定位。
10399,1306,李铎,2015-11-18 12:05:27,13,27,14,老师讲话比较幽默，但是双语教学这发音也是醉了…自己身份很高自我介绍一节课，扣分毫不留情，点名不到直接扣五分
10703,1306,李铎,2015-11-23 01:08:31,2,5,3,点名略坑
11631,1306,李铎,2015-12-08 15:32:11,1,4,3,非常有用
13951,1306,李铎,2016-01-03 02:08:03,0,2,2,他不会告诉你有关考试题型的任何信息，这个比较捉急
14329,1306,李铎,2016-01-06 10:26:24,7,9,2,课程内容本身还是比较有用的 老师也挺有趣的
15185,1306,李铎,2016-01-12 13:26:37,-1,0,1,可以的
15404,1306,李铎,2016-01-14 08:38:22,6,7,1,内容挺好，最后3.9不知道算如何，不过确实能学到很多啦
15425,1306,李铎,2016-01-14 10:43:36,-4,2,6,老师上课很有趣 给分也很好
15486,1306,李铎,2016-01-14 16:01:04,6,8,2,听课比其他都认真(因为不让玩手机)，为嘛最后给分那么坑，醉了
15489,1306,李铎,2016-01-14 16:58:45,12,15,3,老师人很好，讲的特别风趣，内容也很有用。尤其是动不动那个well超有意思～考试双语建议带字典不要选牛津朗文，去医图借一本专业的生物医学化学词汇那种字典吧
15531,1306,李铎,2016-01-15 06:51:23,4,5,1,同学坐我旁边抄我的分都比我高
15620,1306,李铎,2016-01-15 23:41:53,5,7,2,给分坑
15623,1306,李铎,2016-01-16 01:12:21,4,6,2,考试选择题全英文，查字典也查不到。作业好好做，考试估分有90，然而不知为何给分那么低…3.6，创我通识课绩最低分…老师讲课挺好的，发音太醉。
15642,1306,李铎,2016-01-16 02:48:05,2,4,2,双语教学的发音真是醉了，不过老师人很好，给分也还不错~
15712,1306,李铎,2016-01-16 07:25:31,4,5,1,给分差，考试难
16251,1306,李铎,2016-01-17 14:36:10,0,2,2,给分差
21274,1306,李铎,2016-02-28 02:40:56,1,2,1,给分差
22000,1306,李铎,2016-03-02 05:25:05,-1,0,1,逗，不为绩点的强力推荐
22488,1306,李铎,2016-03-07 02:15:25,0,1,1,66666
23647,1306,李铎,2016-04-11 13:27:53,-1,0,1,前几节还不错...到后面变成讲自己发了什么论文，学生发了什么论文，好浪费时间
23799,1306,李铎,2016-04-28 09:11:07,0,1,1,期末考试任由学生作弊的臭傻逼
24210,1306,李铎,2016-04-28 10:09:04,2,3,1,说他给分低的同学可能是作业没有做得非常用心。认认真真地做了，考试也努力去答，会有很不错的成绩。
24236,1306,李铎,2016-04-28 16:07:04,1,2,1,李老师讲课还是比较有意思的，自带一口奇怪的口音，尤其是说英语的时候特别逗～平时不常点名，但建议不要逃课，因为一旦被抓到绩点会很惨的 QAQ～虽然看到很多人说老师不太好啊…但平心而论，如果认真听课还是能收获很多东西的～期中左右会交一个大作业，建议认真做，期末考是双语的，但查查字典看看PPT也还好啦～老师还是很慷慨的，如果你作业和考试都还不错的话绩点会给很高，满绩也是有的呢(≧ω≦)/
24847,1306,李铎,2016-05-04 04:18:10,0,1,1,给分好，上课也很有趣，就是喜欢吹牛
25295,1306,李铎,2016-05-09 10:40:13,0,0,0,给分真的差....创通识最低\n\n
31335,1306,李铎,2016-07-03 16:17:45,0,0,0,有意思的啊
11407,1374,李建平,2015-11-30 10:15:58,5,6,1,还好。\n\n
14915,1374,李建平,2016-01-11 03:12:00,0,1,1,好好好
20167,1374,李建平,2016-01-26 11:16:44,1,2,1,老师好棒，给分很好
20170,1374,李建平,2016-01-26 11:20:43,4,4,0,给分是真好，感谢老师。
33401,1374,李建平,2016-09-19 06:00:33,1,1,0,棒棒棒
34419,1374,李建平,2016-10-10 06:06:38,3,4,1,梦开始的地方，声音都在一个调上，PPT念的不错
43252,1374,李建平,2017-01-16 04:51:23,4,4,0,真心认真负责，给同学答疑解惑！！！群里不管问老师什么都会回答问题！（虽然有时候上课真的很容易睡着。。）
47337,1374,李建平,2017-01-25 10:35:18,1,1,0,我考试感觉考的还可以啊，怎么绩点这么低，上课念ppt水平还不错（虽然我不听），答疑态度很好，是个好老师。
48591,1374,李建平,2017-03-08 03:50:33,3,3,0,李老师上课认真负责，就是一学期都一个声调，上他的课好想睡觉，这门课很难的，但是老师有问必答，平时老师答疑非常认真，考前晚上下雨还赶到学校等着给同学答疑，大赞，给分公正
63812,1374,李建平,2017-12-15 08:30:49,1,1,0,李老师的讲课方式都是很有内涵的，成绩差的学生都听不懂
65030,1374,李建平,2017-12-28 09:30:10,0,0,0,上课上的是真不好，但是对学生很好
73005,1374,李建平,2018-01-31 14:26:14,2,2,0,虽然没怎么认真听过课，可是老师真心宽容负责给分好呀
89246,1374,李建平,2018-11-17 13:16:39,2,2,0,工程力学这个课主要还是看自己平时有没有认真学习(课程难度比较大) 换谁上都差不多的(念ppt催眠我觉得是必然的) 老师人是很好的 平时分基本给满 分数不好真的不能怪老师
99578,1374,李建平,2019-01-25 03:40:41,0,0,0,自己真的垃圾，老师给分真的好，而且老师很耐心。
99650,1374,李建平,2019-01-25 04:29:05,0,0,0,和蔼的老师\n\n答疑耐心！给分也好\n\n
134452,1374,李建平,2021-03-29 05:36:15,4,4,0,治学严谨，大家风范。上课细致，风度翩翩。\n\n释疑穆穆，诲人不倦。听君之课，如沐春风。
134453,1374,李建平,2021-03-29 05:52:51,0,0,0,和蔼负责的好老师，给分厚道
163290,1374,李建平,2022-12-12 07:29:02,1,1,0,评价是纯纯的念PPT，好好学还是自己学来的靠谱。\n\n一门好课课程是能给人带来收获的，而不是给人带来看也不是，不看也不是的内耗的。\n\n还是希望老师能够把课越上越好吧。
167952,1374,李建平,2023-01-20 16:04:55,3,3,0,君子之风无敌
168189,1374,李建平,2023-02-01 08:51:03,2,2,0,机械设计基础给分不好吧。。。
25007,1431,叶兴乾,2016-05-05 00:11:42,7,14,7,第一节课 咔咔咔布置两篇论文 直接记入最后成绩 果蔬三剑客 别人发酵工艺学都是基本全上4 呵呵哒
93166,1431,叶兴乾,2019-01-08 02:17:55,-1,4,5,老师人真的很奇怪?不能说老师是傻的，只能说不知道浙大为什么要招这样的老师来膈应我们。?
98849,1431,叶兴乾,2019-01-24 04:05:57,4,5,1,不能打零分真是太遗憾了
98850,1431,叶兴乾,2019-01-24 04:06:38,4,5,1,没学到东西
153052,1431,叶兴乾,2022-04-24 10:06:56,-3,0,3,老师做的很好。认真听讲还是能学到很多东西的，老师自身能力也很强。给分也很不错！！！
190640,1431,叶兴乾,2024-03-13 00:54:07,1,1,0,欠骂~
217399,1431,叶兴乾,2025-04-09 15:44:28,3,3,0,PPT一堆错别字、语病，毫无逻辑。序号混乱，格式混乱，应该让罗老师来批判一下这个PPT。。脑子有坑。。。\n\n布置作业叫我们批判微信公众号推文，上课BB一堆批判这些公众号，不想看你可以不看。。。无语。。而且布置作业上课是不提前说的，悄悄在学在浙大布置，还只给两三天时间。。
218437,1431,叶兴乾,2025-04-23 12:44:36,3,4,1,我草你吗的叶兴乾叶÷，狗市的甲骨文课件你是读都都不明白，整天就搁那拿低脂营销号的低脂小作文恶心学生，工科学生还要牛魔的评价行文逻辑，你麻薯了啊还要300字以内，牛魔的你遗书能300字以内吗就搁着限制字数，真300字了又左脑反驳右脑说写的不够详细。\n\n考试是用清朝老题的，一个特征工艺ppt和课本都没有，我看才是真的带清元老啊。\n\n还有那给分，我燥尔冯的，开始说什么给分都没问题的，完事了卡绩，宁出门是真小心点别撞大运了
218505,1431,叶兴乾,2025-04-24 05:20:41,2,2,0,神经老头
36543,1432,何国庆,2016-11-14 23:55:19,1,2,1,给分很差，明明考试内容是之前全部背过的，一模一样写在试卷上，给分还是很低
36561,1432,何国庆,2016-11-15 01:44:39,0,1,1,老师上课还不错的 只是期末分有点低。。感觉被套路了  毕竟专业课  同学们选的时候还是要谨慎
36875,1432,何国庆,2016-11-16 10:20:50,0,0,0,。。。
61777,1432,何国庆,2017-11-21 01:09:56,3,3,0,酿酒真的是超级有趣啊，老师讲的也很好，特别生动，咸鱼的时候也忍不住回来听两句。最后的品酒课真有意思。给分也蛮好的，嘻嘻嘻。
61894,1432,何国庆,2017-11-21 11:51:59,7,7,0,\n\n简单来概括，有以下几个特点:\n\n1.短学期，2学分。一周应该一次实验，一次理论。但是只上了两次实验课。幸福。\n\n2.然后，在农生环D座，我感受到了史上最混乱的实验室，第一次在实验室里吃东西，还是吃的实验原材料，就是一大桶的葡萄哈。\n\n3.两次实验，就是，可能时间有点久，一次酿葡萄酒，一次制备麦芽汁，感觉很简单。\n\n4.理论考试，你懂的，看书或者ppt就好。因为选课的人很杂，题目不算太难。和专业没有太大关系。\n\n5.最重要的，老师上课不无聊。因为内容本身，不是酵母菌啥啥特专业的东西的，而是比如葡萄酒分成，白，红，粉红葡萄酒之类的。老师感觉社会阅历很广，经常分享小故事。听听课，挺好的。\n\n6.最后一节课，真的美滋滋。三种啤酒，三种葡萄酒，三种黄酒，混着喝了九种酒的我，安全骑着我的自行车，回到了寝室。\n\n真的，感觉美滋滋。不要问我给分怎么样，就冲着这节课的内容，觉得，真心值了。
64238,1432,何国庆,2017-12-22 01:16:47,5,6,1,不知道为什么这么多人说给分不好啊，我考前花了一整天时间看了PPT，考试内容在PPT上都有，和专业一点关系都没有，只要好好看PPT就行了，就凭着老师给我的满绩，我也要给老师打个十分
82858,1432,何国庆,2018-07-09 08:34:09,2,2,0,老师人很好，上课也蛮有趣的。至于上面的评论说考试简单的指的是酿酒工艺。
85227,1432,何国庆,2018-07-16 08:14:48,4,4,0,发酵工艺学，课每周都上，一共三次实验，课嘛都是讲讲书，最后考试也就背啊背，表示不是食品专业的完全不知道重点是什么……背了一堆生物的定义结果一个都没考……然后考前还看到每个人手里都拿了一份提纲也不知道是不是他们内部资料？？？不过上课呢有比较认真听课，简答题都靠着自己的记忆，名词解释都是靠自己组织语言?也不知道算没算对，反正最后4.2还凑合吧。不过他们专业特别排外倒是真的，做实验的时候有个胖子一直吐槽我什么都不会，mdzz我化学实验做的比你多好嘛有什么资格教训我
89202,1432,何国庆,2018-11-16 16:45:16,3,3,0,选了酿酒工艺学\n\n考试题真的很基础，就是了解程度的题和概念解释\n\n老师上课很有意思，经常讲小故事以及传授人生经验，实验课可以吃实验材料（葡萄特别甜），品酒课喝了四五种啤酒好几种葡萄酒和黄酒，助教也很可爱，作业只有三篇实验报告
89494,1432,何国庆,2018-11-19 10:12:53,1,1,0,老师语速慢慢的，很耐心，但是让文科生会睡着……酿酒工艺学内容算不上有趣，实验还算有趣，要写实验报告，最后考试会给课件，有名词解释，简答，分析，拿出一天背课件没问题，只要背了理解了给分就好，文科生友好，但是如果不准备很有可能只有及格分
114864,1432,何国庆,2019-07-12 05:46:29,1,1,0,发酵工艺学\n\n自己是妓院的，选了这个课最后4.5，作为外专业这个成绩非常满意了。平时三四次实验，都不是很难，老师和助教都很nice，最后交了三份实验报告，写了一天左右就可以了。最后考试嘛，都是一些名词解释和问答题，基本都是ppt上的内容，就是ppt有点多orz，也就几百多页ppt吧hhh。我觉得我没有完全背过那些概念，考试的时候有好几个点没复习到，就凭借平时上课老师讲的和ppt上的内容结合自己的理解写上去了，提前一个小时左右就做完了，最后成绩也不错！当个性学分的话推荐可以选一下！
120039,1432,何国庆,2019-11-17 07:09:20,1,1,0,酿酒工艺学 给分极低 实验认真做了 报告认真写了 老师说平时占比很大的 就算我期末只考六七十分 也不至于总评六十几？ 排雷
120043,1432,何国庆,2019-11-17 07:37:38,1,1,0,老师人超好的！上的是酿酒工艺学，选来当个性。有三次实验课，两个实验报告，最后一节课可以品酒（还能把剩余的酒自己带走哈哈哈）最后一节课老师会带着回顾内容，可以稍微记一下，然后自己背下来就好。考试很基础，基本把老师提到的点复习到了就好。这课是我第一次写实验报告，个人觉得写的稀里糊涂的，然后考试的时候有几个点没有复习到就胡乱写的，以为最后分会很低，但是没想到上4了?
24297,1433,吴坚,2016-04-29 08:34:11,-6,6,12,超级赞，很有意思，作业不多，而且跟主修专业联系很紧，班里满绩很多，都是给每档次的最高分。\n\n
24397,1433,吴坚,2018-05-04 09:05:42,-4,9,13,老师讲的很认真，和老师聊起来很开心，老师明白讲那些同学容易接受。最令人惊喜的是好多人满绩，当然也有我
47882,1433,吴坚,2017-02-27 02:27:42,-6,3,9,还不错
49448,1433,吴坚,2017-07-27 22:46:52,0,4,4,五级制，巨坑
49799,1433,吴坚,2017-04-26 06:33:44,1,3,2,给分坑
49810,1433,吴坚,2017-04-26 08:15:35,1,6,5,给分毫无依据，讲课专业性较强，有些催眠。
49825,1433,吴坚,2017-04-26 09:06:24,1,3,2,给分是什么鬼？！真tm想打0分\n\n
49831,1433,吴坚,2017-04-26 10:08:01,-2,3,5,文科生听微电子完全听不懂，给分烂到爆，刷新我最低绩点，绩杀呵呵
49942,1433,吴坚,2017-04-27 10:37:43,1,2,1,唉，这学期的课是不是绩点都爆炸了，等级制真坑
49952,1433,吴坚,2017-04-27 13:29:18,1,4,3,完全不考虑非本专业学生的心情，完全没有通识课的气氛，给分其实也不怪老师，但是要一个非本专业的学生如何写出高分论文呢？如果有非工科的学生选到了这门课又没退的话，就别去听课了，反正不点名，又不考虑非本专业的感受，根本听不懂，不如自学。
55147,1433,吴坚,2017-07-01 02:03:23,0,3,3,千万别被微电子3.92的均绩骗了，现在是5级评分制，巨坑……
64306,1433,吴坚,2017-12-22 10:14:02,3,4,1,文科生说什么
77272,1433,吴坚,2018-05-04 09:05:02,0,2,2,上课水的，虽然难，但不听也不要紧。但tm给分巨坑啊!五级制是什么鬼，拉低均绩，无话可说
106756,1433,吴坚,2019-04-29 09:47:44,11,13,2,感觉老师很认真，选他课的人很少，感觉课堂很冷清，最后论文好好写拿个4.8
108937,1433,吴坚,2019-06-04 11:41:14,0,4,4,老师很普通，96人的班只有十几人选，有强烈兴趣和基础知识的推荐可以选，最后论文只要认真写，4，5页左右就可以了，真的可以学到很多知识，相比一些科技类的其他通识课，课程收获还算不错
116517,1433,吴坚,2019-09-11 03:21:39,0,1,1,适合有兴趣的和专业相关的同学，课比较水，认真听收获很大，给分还好吧
123968,1433,吴坚,2020-06-18 09:11:54,0,2,2,认真听课，不用听懂，但是一定要答题；给老师留下好印象，然后论文好好写，绩点还是有保障的
133830,1433,吴坚,2021-03-07 10:48:49,7,8,1,感觉有点不正确啊这个分数，老师很和蔼，我觉得就算不值9点多也值个8.5吧
134802,1433,吴坚,2021-04-15 12:17:46,-1,1,2,事情少，老师讲课负责，专业性强。
135093,1433,吴坚,2021-04-30 06:21:20,1,2,1,我觉得六点多分有点低啊……老师很好的，跟同学互动也挺多，课也上的很好
135110,1433,吴坚,2021-04-30 13:38:23,0,3,3,瞧不起文科生，文科生社科生慎选！！！！上课曾说过：文科生选我的课很煎熬，我看你们文科生也很煎熬。此外，上课内容不是按照通识课标准，明明是讲给有基础和他们本专业的人听的，收获不大，绩点2点多。
135140,1433,吴坚,2021-05-03 07:14:10,0,1,1,感觉比较适合有一定基础的同学参与，对文科生和社科生的话或许不太友好。虽然这样，最后论文好好写的话也可以拿个还行的绩点的，专业性要求其实也没有太高，但是最好和上课讲的制造技术相关。
135205,1433,吴坚,2021-05-06 02:49:55,2,2,0,总体来说老师对学生算是比较友善了，这门通识课想讲到无需任何知识储备都能听懂不太现实，老师前几节课主要讲历史，门槛比较低。总之对微电子稍感兴趣无脑入，偏文科想水学分慎入，后期基本听不下去的。论文好好写绩点不差的。另外点名会提前一周通知。
135364,1433,吴坚,2021-05-08 12:05:10,0,3,3,给分毫无依据，论文很认真地写了5000字，上课积极互动，课堂表现满分，最后是正态最低分，拉低均绩0.16，一个上课经常不来，论文用别的课的论文来交的同学反而4.5，给分毫无依据，巨坑
135559,1433,吴坚,2021-05-13 15:17:57,4,6,2,就授课的话，备课、调动气氛能力可以给9分甚至更高，少见的能控制好授课难度并且通过提一些有趣的问题使得课堂很活跃的老师\n\n不过只凭一次期末论文定分数可能是无奈之举但确实不太合理。 \n\n利益相关：5.0.
152878,1433,吴坚,2022-04-21 07:26:20,6,6,0,老师上课讲的内容可以说算是通识里面比较硬核的了，但是因为课程成绩评判基本上由论文决定，所以上课可水可不水。认真听的话还是能获得很多知识的，不过不想听的话也完全可以做自己的事。老师每次点名前一周会通知。总的来说还行，至少事少，给分不太清楚这学期如何，不过感觉一篇论文定成绩的考核方式还是有一定风险。但是对微电子感兴趣的同学还是可以无脑冲一波。
152883,1433,吴坚,2022-04-21 07:43:45,6,7,1,讲得很有意思\n\n给分巨好\n\n点名会提前通知
152890,1433,吴坚,2022-04-21 08:54:38,4,6,2,老师上课真的很热情，会和坐在前排的同学互动，如果想学的话可以学到很多知识的，虽然本菜菜（医学生）后面有些听不懂了，期末考评就交一篇论文，没有特别要求，而且老师人真的很好！感觉成绩给的都是范围内最高分
155717,1433,吴坚,2022-06-15 10:20:55,4,4,0,上课可听可不听\n\n点名会提前一周课上通知，也会多次强调，生怕有同学忘了\n\n整个学期作业就一篇论文，而且字数要求低（不需要卷字数）\n\n给分巨好
181996,1433,吴坚,2023-11-07 13:51:15,0,0,0,给室友点赞
191761,1433,吴坚,2024-04-30 01:33:30,3,5,2,授课内容对文科生极不友好（但与分数无关），评分只看一个期末论文，这学期卷了13k字满了
192001,1433,吴坚,2024-05-07 08:04:27,1,1,0,老师人很好，有点儒雅的感觉。只要不打扰课堂，基本都不会说什么。课程评分看小论文，偶尔回答问题会加分。点名是线下的，一两次吧。给分不错。
195219,1433,吴坚,2024-06-27 09:20:49,1,1,0,“学完不要连nmos和pmos都分不清”。学完我就记得这两个东西了。\n\n点名很少，课基本可以不用听。听了也很容易忘。\n\n考核完全看论文，写之前问下老师这个内容可以吗，然后多写点，分数应该不会低。
216022,1433,吴坚,2025-03-09 12:33:12,1,1,0,老师上课很认真的，讲的很好
218279,1433,吴坚,2025-04-22 10:36:14,1,1,0,非微电子专业的学生可能会听不懂，后面几节课比较偏理论，没有相应的知识储备可能比较枯燥。平时点名次数不多，而且老师在第一节课就告诉我们大概哪几节课点名，而且老师只在第一节下课点名，后面你直接走老师也不会怪罪。成绩主要看期末论文，只要用心写，字数达标，分数不会太低。上课的知识听不懂也没事。而且期末论文的题目范围很广，从相关历史到背后原理都可以。
218623,1433,吴坚,2025-04-27 08:15:23,1,1,0,事少分高
218879,1433,吴坚,2025-05-10 09:50:14,0,0,0,不错的老师
219514,1433,吴坚,2025-05-29 05:48:17,1,1,0,事少分高，点名会提前说
48796,1506,沈立荣,2017-03-13 06:44:37,0,0,0,课程水，事情居多  个性学分就不要选了
58787,1506,沈立荣,2017-09-17 12:40:09,0,0,0,还不错
70690,1506,沈立荣,2018-01-27 11:44:24,0,0,0,不知道上课都上了什么
85079,1506,沈立荣,2018-07-15 08:57:18,-1,1,2,沈老师水平很高，课程干活也很多
168401,1506,沈立荣,2023-02-15 12:25:31,0,0,0,这种混子根本不配做老师\n\n不知道怎么评的教授\n\n还好退休了，不然贻害无穷
30729,1531,陈卫,2016-11-17 03:35:39,5,10,5,差差差
30735,1531,陈卫,2016-07-02 11:18:40,2,15,13,上课就是 冬虫夏草 铁皮石斛 整一个推销药品的 辣鸡
30741,1531,陈卫,2017-12-28 11:15:33,-13,11,24,实验好好做报告好好写考试打印了展示的直接抄了最后一题 结果4.5。马马虎虎
30747,1531,陈卫,2016-07-02 10:59:01,2,12,10,为什么没有零分？
57481,1531,陈卫,2017-07-08 13:38:20,6,15,9,食品细胞工程挺有趣的，选课的时候每周有两次课，其实只上一次，之后有一次从周五和周日的实验课，写两份实验报告，3000字实验心得，还有课程展示，2人一组，期末开卷考，要带书，给分挺好的
57853,1531,陈卫,2017-07-16 10:25:23,3,5,2,冲着均绩选的个性课，结果并不好。只能说不是他们专业的慎选，会在期末的时候搞出很多事情，作为一门个性课一点都不值
65746,1531,陈卫,2018-01-09 01:21:29,-2,5,7,老师特别好，会与学生交流很多，而且会发现学生的亮点，加以鼓励
113515,1531,陈卫,2019-07-06 22:15:09,2,4,2,全外文课程后给分并不是很好.......
114031,1531,陈卫,2019-07-08 11:52:42,4,5,1,千万别报食品细胞工程！要做实验，写5篇实验报告，做一次全英文小组展示，期末要开卷考，，给分还可能上不了4，随便选门通识都比这个当个性好！
123498,1531,陈卫,2020-06-09 07:20:15,3,9,6,就是一个煞笔老师
133798,1531,陈卫,2021-03-05 12:25:53,8,14,6,食品安全作为一门通核真的相比其他通核巨水无比，社恐不用担心小组讨论和发言加分，因为根本就没有！！！\n\n展示肯定是通核都有的吧，这不是什么问题。有两次实验课，印象深刻有一次我们是烤饼干，另一次是微生物观察自己带食物还给报销。要写实验报告的，不过手写打印均可，大家都很佛，有人只交了两页纸（实验报告专门错开了考试周后很久才交）。\n\n前面说到的智慧树是因为老师很多节课都取消不上，挂）智慧树不是更轻松吗？而且答案都很好查。完全没有期末考试（只有智慧树上百度上能查到的选择题），最后一份调研报告，一份个人总结。调研报告很好写吧，大家也都不卷，个人总结提出对课堂的建议就差不多了。\n\n小组展示占分较大不过我们组的PPT出过两次很大的bug，最后我的分数4.5\n\n真的是迄今为止我上过的最满意的通核
149889,1531,陈卫,2022-01-17 14:31:31,2,7,5,食品安全 通核\n\n事少，给分好，不卷。不是组长，讨论课发言，报告认真完成，最后满绩。安利！
150415,1531,陈卫,2022-01-25 02:11:43,3,3,0,不喜欢。
164957,1531,陈卫,2022-12-28 05:14:19,3,3,0,不公平，烦
167109,1531,陈卫,2023-01-15 03:44:46,1,2,1,太恶心了，避雷食品安全，三绩点创烂世界，事情多得要死，给分很迷，我们小组几次展示都被助教夸过，最后报名的调研展示也被老师肯定了，实验报告调研报告视频课和测试都完成了，不知道是不是欠老师两个亿才给了这么恶心的分数，乐了，慎选
167409,1531,陈卫,2023-01-16 06:30:32,2,4,2,食品安全这个课本身形式多样[实验室实验、小班讨论展示、辩论赛、与其他高校的线上直播课、邀请政府部门官员讲课、智慧树mooc等等]，趣味性和科学性都很强，非常实用，几位老师讲课也很有水平，不过给分比较一般，我当了组长也就是3.9呜呜呜，能接受但是我觉得还是应该上4.2趴
168110,1531,陈卫,2023-01-28 07:29:48,3,5,2,食品安全通识课慎选，给分好像只有82.84.86.88四个分数，想要高绩点可以避雷
168380,1531,陈卫,2023-02-16 05:09:36,0,2,2,你们知道“海狗丸”的故事吗\n\n去问问吧 哈哈哈哈
188749,1531,陈卫,2024-01-19 23:19:01,2,3,1,食品安全，说实话感觉还行，任务是两次小组20分钟pre，一次辩论，期末一次小组20分钟的调研报告（可不展示）。没有线下考试全是线上。点名比较多。有烤曲奇测细菌实验。给分貌似还行？
188753,1531,陈卫,2024-01-20 00:25:16,2,3,1,食品安全通河，我只能说事少，但是分确实低
196605,1531,陈卫,2024-07-04 08:14:36,4,4,0,食品细胞工程，人少所以每次都点名。课是水的，但实验报告比较麻烦。期末开卷也不简单。给分很烂
199631,1531,陈卫,2024-09-26 11:31:02,4,4,0,说话满嘴爹味，喜欢吹牛逼，受不了一点
213231,1531,陈卫,2025-01-16 11:49:38,-2,0,2,食品安全通核 这个老师确实略那个 但是给分应该也许是助教给 分数还挺高的 然后对比其他通核我觉得算是事情不多的 一个调研报告三次小组展示然后有两次实验课（一次做饼干 一次测奶茶里的细菌）还有智慧树 我们小组的人合作起来很顺利 所以上课挺轻松的 总体是推荐的！！
214589,1531,陈卫,2025-02-14 04:12:34,3,3,0,给分很随便，一模一样作业，分不一样
219638,1531,陈卫,2025-06-03 01:19:29,0,0,0,崇洋媚外
5295,1748,王剑平,2015-07-06 10:06:05,7,9,2,王老师人超好，然而食工听不懂\n\n
5635,1748,王剑平,2015-07-09 01:18:40,10,10,0,人很好，就是讲课太温柔了，昏昏欲睡…但是人真的真的很好
8000,1748,王剑平,2015-09-16 12:12:36,7,7,0,很喜欢的老师～很棒～
12277,1748,王剑平,2016-01-05 08:20:05,3,5,2,怎么说呢，老师好给分也好。努力了分不会低，但是考试量大课程难，最难的专业课。只能怪课
16453,1748,王剑平,2016-01-18 06:18:45,3,3,0,老师人很好，赶在出分前给个厚道评价，Hhh。
20357,1748,王剑平,2016-01-27 06:37:23,2,2,0,老师人很好
27250,1748,王剑平,2016-06-24 04:27:37,2,2,0,给分好，期末考平时布置作业题，4.5飘过
47178,1748,王剑平,2017-01-24 10:10:34,5,5,0,王老师人格魅力太强大，好喜欢！虽然学的一脸懵，到最后考试给分超好！！总之平时要好好学，作业一定要认真做。考试计算题很多都是平时作业题目～～
47182,1748,王剑平,2017-01-24 10:27:34,3,3,0,超级可爱的老师，上课会发小零食给我们吃，放一些食品加工的视频给我们提神。虽然课程有点难，不过平时认真完成要交的作业，期末努力复习看书和题目，一定会有好成绩的！
66198,1748,王剑平,2018-01-13 02:54:16,2,2,0,非常好的老师，但是上课比较温柔，可能会不专心想睡觉，关心学生，邮件会亲自回复和指导，作业量不算大，上课内容干货多。
105612,1748,王剑平,2019-04-17 07:41:01,3,3,0,难道没有人觉得老师很帅吗
36838,1751,陈健初,2016-11-16 08:06:36,6,8,2,给分好差啊，明明ppt背的滚瓜烂熟，绩点还不到四
62984,1751,陈健初,2017-11-27 23:44:15,0,0,0,很和蔼一个老师，会动手跟我们一起做实验。给分很好，期末考试也很良心（上课听了的都会），就是五分实验报告一起写有点懵逼。
63781,1751,陈健初,2017-12-14 15:54:53,0,0,0,陈老师幽默，讲课生动有趣
63782,1751,陈健初,2017-12-14 16:07:29,0,1,1,老师人超级好！
63784,1751,陈健初,2017-12-14 22:22:37,0,0,0,陈老师人超好
89730,1751,陈健初,2018-11-20 12:08:45,2,2,0,外专业的学生一定不要去选，血淋淋的教训（如果你能背熟ppt除外）
89749,1751,陈健初,2018-11-20 14:34:45,0,1,1,饮料工艺学有点硬核，是闭卷考加实验报告，了。你付出多少收获多少，这门课不太能水，想水课的同学慎选。课程内容很丰富，但是上的时间太少，导致出现了解了很多但都不太了解这种状况。
90062,1751,陈健初,2018-11-22 04:19:10,4,4,0,人挺可爱的，但是给分好差啊。。。食品专业的老师你们是铁了心不给自己的学生活路吗。。。
90081,1751,陈健初,2018-11-22 05:30:56,-3,0,3,给分公平合理，对得起付出（扪心自问没认真学过这门课的人别来误导下一届
92422,1751,陈健初,2018-12-28 13:03:12,5,5,0,老师是很好的老师，人很好。但是我真的想不通为什么最后绩点会这么低。我觉得我该做的都认真做了，也从不翘课。
143882,1751,陈健初,2021-12-10 04:46:28,2,2,0,老师人挺好的，就是给分真的无语了
145777,1751,陈健初,2022-01-02 05:23:55,0,0,0,就是给分少 其他号还好
1722,1774,冯雷,2015-03-23 14:40:11,21,30,9,讲课很差劲的，通识课一直死气沉沉学不到什么东西，而且布置的大作业很麻烦，给分非常坑
9142,1774,冯雷,2015-10-14 10:35:26,11,14,3,讲课死气沉沉  无聊死了
19277,1774,冯雷,2016-01-23 18:09:21,10,12,2,无趣至极
19497,1774,冯雷,2016-01-24 11:30:08,17,20,3,《全球定位系统和地理信息系统》  剧毒  千万别选
20940,1774,冯雷,2016-02-04 14:08:15,-6,1,7,
30319,1774,冯雷,2016-07-01 09:06:19,-10,1,11,顶一下。
35011,1774,冯雷,2016-10-29 11:37:40,9,11,2,讲课烂 屁事多 真心烦
36045,1774,冯雷,2016-11-10 10:50:27,8,9,1,辣鸡老师～
39442,1774,冯雷,2016-12-22 18:04:33,6,6,0,事情真特么的多啊。。
46232,1774,冯雷,2017-01-21 03:48:46,6,7,1,生无可恋
49119,1774,冯雷,2017-03-27 05:14:42,8,9,1,阉割版的ppt和超麻烦的实验
78969,1774,冯雷,2018-05-18 05:59:12,13,14,1,垃圾老师，我大一犯了个小错误此后四年班会就没办过或者没通知我参加，作为班主任完全不够资格！据说当老师以前是修公交车的，还是修公交车比较适合你，教书育人你真的不够资格！差评，活久见，和zyf一样遇到的最差的老师，没有之一！
79506,1774,冯雷,2018-06-07 08:32:30,4,4,0,先给一分，不管了
79520,1774,冯雷,2018-06-07 17:56:01,3,4,1,感觉是个傻子，毕设我按照硕士生的标准做的，\n\n答辩现场老师就提醒我2g要修改一下改成4g或5g，他在另一个组没看到我答辩，给了我2点多，平均85，nmsl.这种人不是眼睛瞎就是目光短浅！毕业还要恶心我一次，祝你sqj.
80151,1774,冯雷,2018-06-20 17:09:36,4,4,0,烦，没办法沟通，眼里只有成绩的老师，都大学了
80717,1774,冯雷,2018-06-29 14:59:18,3,3,0,他当班主任你会体验到成绩对老师对学生的态度的重要性！
99952,1774,冯雷,2019-01-25 10:37:26,7,7,0,奉劝农学的学弟学妹，千万不要选精细农业，全班绩杀。?
104291,1774,冯雷,2019-03-16 17:49:19,0,1,1,mmp
115319,1774,冯雷,2019-07-18 12:07:28,-1,2,3,挺好的啊
116535,1774,冯雷,2019-09-11 07:34:07,20,22,2,农工导论✘\n\n美国农业历史导论✔
126009,1774,冯雷,2020-09-16 11:52:26,2,2,0,绩杀！
126037,1774,冯雷,2020-09-17 01:04:59,3,3,0,绩杀！
134259,1774,冯雷,2021-03-21 16:13:02,-9,5,14,冯老师人挺好的，很乐意帮助同学，人也很好讲话，真的很喜欢他。而且，有什么问题去咨询他，他都会给你讲的很好啊，真的非常好的一个老师。
134501,1774,冯雷,2021-03-30 07:53:28,2,2,0,差劲…
134907,1774,冯雷,2021-04-28 16:41:41,3,3,0,好垃圾啊……司马脸老师
135075,1774,冯雷,2021-04-29 07:42:57,3,3,0,离谱 认真做作业根本做不过一群水水过的 令人失望 给分乱给
152495,1774,冯雷,2022-04-13 07:01:22,5,6,1,无脑吹GPS黑北斗，用北斗测的比GPS准就问别人是不是模块坏了。说北斗一点好话就开始疯狂质疑。
155317,1774,冯雷,2022-06-10 16:33:18,16,17,1,精细农业，垃圾学院引以为傲的王牌课程，蠢到不能再蠢的内容，你找个厂工的都会测操场距离，都会按照步骤写你的GIS作业，都会找无人机论文ctrlCV\n\n真不知道这种课的意义是什么，事多分烂，把浙大学生当牛马使。\n\n贵院真的早点倒闭算了，别再招生害人了。
155777,1774,冯雷,2022-06-16 02:10:48,0,3,3,老师人很好的 但是精细农业成绩低真的是有原因的…大题根本找不到答案
159085,1774,冯雷,2022-07-06 03:24:57,-7,1,8,好人呀
170715,1774,冯雷,2023-03-08 10:59:18,8,10,2,农生导挺好的，教学生怎么跑路。大一能听到这课就好了。农工学子还是要努力刷绩点，能保研保研，能出国出国，利用好浙大的平台。
172090,1774,冯雷,2023-04-19 07:12:21,0,1,1,真的想过农工学院想培养什么样的学生吗？吹浙大吹美就好脸。。。真有你的
172897,1774,冯雷,2023-05-09 12:46:49,1,2,1,农工导还不错。虽然讲的确实全是老美的东西，但这个领域老美本来就强，学院和老美交流也多，不这样讲还能怎么样呢？还有第一节课放的学生去向和未来的出路也挺有用。
180526,1774,冯雷,2023-09-22 10:22:03,0,0,0,阴阳怪气成了精
17597,1851,鲍一丹,2016-01-20 12:53:18,0,10,10,臭傻逼
36649,1851,鲍一丹,2016-11-15 07:54:33,-1,1,2,老师真的讲的蛮好吧
61861,1851,鲍一丹,2017-11-21 10:03:29,-2,2,4,讲得还不错，比较详细且考点清晰全面，但是给分不够好
142549,1851,鲍一丹,2021-11-13 04:35:55,-2,2,4,还可以的
142555,1851,鲍一丹,2021-11-13 07:14:00,8,9,1,给分不行
142581,1851,鲍一丹,2021-11-13 15:43:44,9,9,0,每节课都点人回答问题，给分稀烂
142582,1851,鲍一丹,2021-11-13 15:47:19,6,6,0,不会多给分的
142593,1851,鲍一丹,2021-11-14 03:49:31,7,8,1,教的跟考的差距很大
143391,1851,鲍一丹,2021-11-25 03:06:10,-15,0,15,鲍老师的讲课水平是不错的。自控不是水课，对数学要求挺高，但一学期认真学下来会有很多收获。平时认真写作业，定期总结，考前多刷题，会有好成绩的。
161748,1851,鲍一丹,2022-11-12 05:02:31,2,2,0,给分很求是，哈哈🥲
161789,1851,鲍一丹,2022-11-13 10:43:54,2,3,1,给分太差了，太差了，建议大家去b站找西北工业大学卢京潮老师《自动控制原理》学，卢老师讲得特别特别清楚
161790,1851,鲍一丹,2022-11-13 10:57:58,4,5,1,是一位连孙优贤院士见到了都会自愧不如的人民好教师捏😋😋😋
162048,1851,鲍一丹,2022-11-16 09:16:15,0,0,0,阿弥陀佛
164660,1851,鲍一丹,2022-12-22 16:11:27,0,0,0,给分稀烂，不过听说明年退休了，可喜可贺可喜可贺
168120,1851,鲍一丹,2023-01-29 03:27:48,2,2,0,一丹一丹，沾点扰摊
168399,1851,鲍一丹,2023-02-15 12:04:30,2,2,0,院长夫人就是可以躺\n\n上课上的稀巴烂\n\n就知道展示展示
6044,1885,郑晓冬,2015-07-10 12:31:39,-3,1,4,无聊
32729,1885,郑晓冬,2016-07-12 00:47:58,2,4,2,没有平时作业，几乎不点名，考试内容主要靠背，给分不错
32833,1885,郑晓冬,2016-07-17 05:50:41,1,3,2,其实给分和助教很有关，助教极好
85228,1885,郑晓冬,2018-07-16 08:22:47,2,3,1,郑老师很和蔼的！给分也好
105525,1885,郑晓冬,2019-04-16 03:56:38,-2,1,3,老师人挺好的，食品安全事有点多。
106145,1885,郑晓冬,2019-04-25 08:41:45,-1,2,3,老师人挺好，她的助教太给她丢人了，特别是那个男助教
106353,1885,郑晓冬,2019-04-26 14:14:05,-2,9,11,这个老师弄智慧树网上学习简直是脑子有问题，非常恶心，每隔一两分钟视频会跳出弹窗问问题，这种垃圾课本来就是混学分的，不想听还要强迫学生听，一定要把学生弄得难受了才好。建议大家慎选食品安全通识课。
106799,1885,郑晓冬,2019-04-29 15:18:56,5,10,5,老师人挺好的，但是食品安全事情真的多，看网课，调研报告，还有一个短学期中至少两次的展示，但给分还不错，慎重选课
106803,1885,郑晓冬,2019-04-29 15:49:37,-2,1,3,助教小姐姐很温柔，给分很好！\n\n
106831,1885,郑晓冬,2019-04-30 03:40:22,1,5,4,老师很有货，助教及评判标准让人存疑，当了小组长每节课都签到章节测试基本满分课程笔记曾经第一结果最后给我绩杀，这门课干脆改叫辩论课得了，每节小课都要展示，助教明确说选了辩论有加分，慎选，绩杀。
120533,1885,郑晓冬,2020-01-12 08:32:27,4,5,1,偶尔点名 通核食品安全相比起其他通核巨水无比 建议与助教打好关系😂
132196,1885,郑晓冬,2021-01-31 02:08:27,2,2,0,上课没啥意思，听不听都没人管，每节课都要在钉钉里签到，大班课在考核里占比很小，各种其他的事情多，而且说小组长有加分，但作为小组长，最后是4.2，感觉不算高，而且成绩给的是A-，没有分数，同组同学十分认真，慕课也满了，但最后是b+，emmm不太满意吧，小组讨论课也比较尬
133797,1885,郑晓冬,2021-03-05 12:24:10,2,3,1,食品安全作为一门通核真的相比其他通核巨水无比，社恐不用担心小组讨论和发言加分，因为根本就没有！！！\n\n展示肯定是通核都有的吧，这不是什么问题。有两次实验课，印象深刻有一次我们是烤饼干，另一次是微生物观察自己带食物还给报销。要写实验报告的，不过手写打印均可，大家都很佛，有人只交了两页纸（实验报告专门错开了考试周后很久才交）。\n\n前面说到的智慧树是因为老师很多节课都取消不上，挂）智慧树不是更轻松吗？而且答案都很好查。完全没有期末考试（只有智慧树上百度上能查到的选择题），最后一份调研报告，一份个人总结。调研报告很好写吧，大家也都不卷，个人总结提出对课堂的建议就差不多了。\n\n小组展示占分较大不过我们组的PPT出过两次很大的bug，最后我的分数4.5\n\n真的是迄今为止我上过的最满意的通核
136521,1885,郑晓冬,2021-06-20 04:16:56,0,0,0,【微生物】事情贼多，贼麻烦，真烦
19071,2283,茅林春,2016-01-23 07:56:40,5,8,3,别选别选
19075,2283,茅林春,2016-01-23 08:04:00,4,8,4,上课无聊\n\n给分极低\n\n没有平时分\n\n全班没有一个人上4\n\n大学以来最低分
19115,2283,茅林春,2016-01-23 09:38:02,10,13,3,我并不觉得我不认真，可能和老师不是一个世界的
19221,2283,茅林春,2016-01-23 16:29:00,8,10,2,呵呵，学分再低也不要选。#妈妈问我为什么跪着哭
21300,2283,茅林春,2016-02-28 03:23:49,7,9,2,有史以来觉得最差的一个老师，不要问我为什么哭出来
25996,2283,茅林春,2016-06-15 03:21:45,1,3,2,全班六七十分是怎么样的体验\n\n
58193,2283,茅林春,2017-08-19 10:13:46,0,2,2,呵呵呵
104302,2283,茅林春,2019-03-17 08:23:43,2,2,0,老师上课蛮认真，果蔬实验也很有意思
105288,2283,茅林春,2019-04-09 07:55:00,2,2,0,老师很认真啊，理论课和实验课也很有意思，自己觉得真的学了很多。很奇怪，这么不错的老师，选的人竟然这么少！
105739,2283,茅林春,2019-04-19 11:04:28,1,2,1,还可以哇
123028,2283,茅林春,2020-05-02 13:07:25,1,2,1,蛮好过的课
153183,2283,茅林春,2022-04-26 12:40:02,3,3,0,认真上课，认真写论文，认真复习，就可以收获满满，成绩也好看，成绩与付出成正比！
153582,2283,茅林春,2022-05-05 06:45:49,1,1,0,认真上课，认真学就很好过，题目不难，但是要认真学
22649,2319,成芳,2016-03-09 06:36:12,1,2,1,坑让我们自己讲
65421,2319,成芳,2018-01-04 00:58:38,4,7,3,操你妈
124296,2319,成芳,2020-06-29 02:05:25,0,1,1,教学资源还是比较丰富的，有很多视频之类的，但是我感觉我论文很认真写了，小测也基本翻书翻到了，绩点很低。老师总感觉还有一种看不起的语气(不知道是不是我太敏感了)。但是也没用，必须选这门课啊。\n\n可能还是要上课多发言吧
166087,2319,成芳,2023-01-11 05:13:18,2,2,0,装备工程给分不算好的 而且虽然不用考试但是任务量挺大 建议学弟学妹们慎重考虑哦
5271,2325,章宇,2015-07-06 07:45:53,4,19,15,作业多但分数高，还没有考试
5358,2325,章宇,2015-07-07 03:14:43,2,11,9,课堂氛围好，不怎么水，内容丰富，作业挺多但是给分很好
8006,2325,章宇,2015-09-16 12:36:19,2,8,6,讲得不错
9153,2325,章宇,2015-10-14 12:27:31,26,46,20,我要回答问题，爸爸
9305,2325,章宇,2015-10-21 02:44:29,3,4,1,不考试作业多
10002,2325,章宇,2015-11-14 06:59:56,5,6,1,事情有点多，风险评估什么的文科生会被虐。要高分的记得参与辩论
10724,2325,章宇,2015-11-23 03:27:55,3,19,16,现代食品安全科学内容挺有意思，不点名，不考试，交论文，给分很棒
11039,2325,章宇,2015-11-24 03:23:15,1,3,2,好老师，能选上他的课感觉很幸运
11040,2325,章宇,2015-11-24 03:37:47,3,8,5,年轻的老师。上课内容充实。作业还行，认真做论文选去辩论一定有高分！
11055,2325,章宇,2015-11-24 04:15:36,4,15,11,老师人又帅  又土豪 听说还是哈佛博士 给分不能更棒了
11080,2325,章宇,2015-11-24 05:34:57,-1,6,7,给分低(┯_┯)
11096,2325,章宇,2015-11-24 06:35:36,1,2,1,上课超好啊，能懂很多\n\n
11115,2325,章宇,2015-11-24 09:53:45,-3,1,4,好好好
11126,2325,章宇,2015-11-24 11:17:03,1,3,2,真的能学到很多知识
11262,2325,章宇,2015-11-26 03:55:28,4,6,2,还行。。但是不是很喜欢回答问题，所以课堂分给的不高应该，但是还是能学到知识的，积极的同学选，多回答问题
11366,2325,章宇,2015-11-29 03:43:32,3,3,0,上课不答问题分数不高
12621,2325,章宇,2015-12-23 15:45:17,-9,1,10,可能对上课积极性要求高   明明最后论文写得不错也88分  从不点名
13081,2325,章宇,2015-12-24 19:17:31,-3,1,4,棒棒棒
13358,2325,章宇,2015-12-27 07:49:47,-1,4,5,哈佛男神  \n\n肉制品上的不能更棒 上课思路清晰 考前给重点  \n\n通识课的课堂氛围超好（其实风险评估只要按时交了作业大家都是一样的  嘘）
14981,2325,章宇,2016-01-11 11:40:08,-41,4,45,参加辩论，堂堂回答问题，然而只有4.5TAT
15467,2325,章宇,2016-01-14 13:31:07,-1,1,2,给分厚道，只答过一次问题，论文3000要求只写谢3100的给分也4.3
15594,2325,章宇,2016-01-15 13:46:49,-1,4,5,给分超好 满了
21821,2325,章宇,2016-03-01 07:23:51,-1,1,2,从不点名。人帅给分好！上课有回答问题，论文，最后一节课是辩论…
21896,2325,章宇,2016-03-01 13:03:18,0,0,0,回答问题…
22677,2325,章宇,2016-03-10 00:57:18,-1,1,2,棒棒哒
24319,2325,章宇,2016-04-29 10:33:01,0,2,2,会有一次小范围点名，上课十分有趣，课堂氛围很活跃。课程作业有几次，但每次量不大。还有一次课堂测试和小组展示。可以学到不少东西。给分不错。推荐。
37762,2325,章宇,2018-12-26 12:55:11,0,5,5,有人真的是欲求不满，88太低？4.5太低？真是不要碧莲呵呵哒，嫌低别选我食品的课
46830,2325,章宇,2017-01-25 07:38:33,5,8,3,一个乱打分的老师。恶心的加分制度。
72394,2325,章宇,2018-01-30 05:03:31,-1,1,2,肉制品课挺有意思，老师人好，给分有点玄学
91649,2325,章宇,2018-12-17 06:53:50,6,6,0,破事很多的课
91688,2325,章宇,2018-12-18 02:38:04,3,5,2,老师很帅，知识也不错呀。课堂测试还是比较水的~就是鹅颈好严重啊，心好累不想做展示了给多少分随缘吧...想拿高分甚至满的话，真的会耗你很多时间了。
91692,2325,章宇,2018-12-18 02:50:40,8,27,19,助教智商感人。展示加分先到先得这种东西居然挑别人上课的时候说，一没预告，二时间段也不对。而且挑起恶竞不嫌事大。第一次见到这么迷的助教\n\n老师还行吧，但是评分标准真是复杂，作为一门通识课事情是真的多...
91694,2325,章宇,2018-12-18 03:53:44,15,23,8,助教真实的让人感到不舒服，表面无辜其实说出的话都阴险地撺掇着学生恶竞，每周都要在群里提哪个哪个环节部分涉及到课程成绩。然后再冠冕堂皇地说什么人人有机会但是实际情况却根本不是这样。
92028,2325,章宇,2019-01-08 12:43:20,10,13,3,恶竞课，干货课：如果你只是想学知识，选；如果你想拿高分，退课吧。因为上课展示的机会是靠运气拿的（微笑）论文虽然是评分标准但主观性也很强。恶竞真的严重。评分制度真的不公平。
93087,2325,章宇,2019-01-07 08:50:58,-1,1,2,很好啊
93224,2325,章宇,2019-01-08 07:28:54,3,3,0,真的还是可以获得许多知识的，也不像其他科学类通识课那么枯燥无聊，就是事情很多，有发言要求，恶竞很严重。。。老是要抢各种展示。上课形式是很丰富，然而感觉有点太注重形式了，如果不是喜欢积极发言和展示的。。。
93273,2325,章宇,2019-01-08 15:01:41,3,8,5,为什么这样说助教啊....虽然抢机会和回答问题不是非常公平的，但是最为一门通识事情已经很少了好吧？助教小姐姐蛮可爱的，而且是为大家着想的那种
93886,2325,章宇,2019-01-14 07:04:21,1,2,1,发言只叫女生。。。
93897,2325,章宇,2019-01-25 15:21:45,2,5,3,首先老师肯定是没话说的，但是大家也知道这是一门通识课，必然有正态，这样一门课抢展示机会（群里抢红包，几十个人抢十几个机会），抢发言机会（真的很恐怖上课前排全举手，老师不叫你你就白搭），抢辩论机会（这个是看论文选的），此外一次论文一次作业一次随堂考，这个课已经不是一句“事情不少”可以概括的，不客气的说就是事情多的要死，而且从某种意义上来说，论文课你恶个竞，考试课你好好准备都能拿好成绩，这个课很靠运气，因为不是你不努力抢不到机会啊..\n\n听说下个学期改通核了，想选的学弟学妹请慎重，通核事情更多。而且我真不是很喜欢助教，挑拨恶竞什么的不说了，上完课就把所有加过她微信的同学全部删了，有这个必要嘛？
98066,2325,章宇,2019-01-23 04:43:56,-1,0,1,求老师给个好分！拜托了?
99497,2325,章宇,2019-01-25 01:14:48,2,5,3,老师很好，助教也很棒。我认为这是我遇到最可爱最贴心的助教了，课程设计如此，可能助教姐姐确实有不妥当的地方吧，但是不能都指责她啊！助教姐姐真的很温柔很可爱！我是给满分的！\n\n真的一分付出一分收获吧，成绩是一点一点赚过来的，说实话展示的机会不多，但老师给了很多发言的机会，自己积极主动才好啊~\n\n也是一节干货课，确实负担也不大，爱了。
99508,2325,章宇,2019-01-25 01:38:54,0,3,3,满了满了 老师好评！
99565,2325,章宇,2019-01-25 03:26:16,2,4,2,第一次满绩，老师的课很有干货。评分标准也很明确，唯一不好的就是竞争太激烈了，回答问题抢不到
114803,2325,章宇,2019-07-11 23:27:10,-1,2,3,其实呢，这门课改成通核之后呢，鹅颈好像好了一些，但是在讨论课上还是存在。但是至少都给了大家发言的机会，只展示了两次，仍然有3.9，给分算比较好了。
114847,2325,章宇,2019-07-12 03:26:11,-1,1,2,挺好的，是一门挺水的通核。
114852,2325,章宇,2019-07-12 04:19:51,0,0,0,事情挺多的，但只能说最后拿到的分对得起花上去的时间～个人展示一次+没参加辩论+上课偶尔发言+开卷考前打印了ppt，最后4.8供学弟学妹参考。助教xjj很nice，安排了两节展示课机会，上课也会故意给回答问题的机会，而且问题大多不是很专业性的，更偏向于个人感受和经历这样子吧。以上说的都是讨论课，理论课感觉大家都在自习（溜走 但两位老师挺好的～
115074,2325,章宇,2019-07-15 07:06:20,1,3,2,?杀啊 期末考感觉不差 平时作业也认真做 结果2.4 还是个通核3学分啊
117908,2325,章宇,2019-10-09 15:24:30,-2,1,3,（迟到的评论）通核食品安全科学上课体验相当好，可水也可学到很多东西，一次个人展示（名额有限 需要自己抢）+一次辩论+一次当堂小组展示+一次期末小组展示。助教小姐姐人很nice，就是第一次上课不太会把握讨论课节奏，偶尔有点小尴尬。课友也超级nice！！！给分的话我一次个人展示+辩论+偶尔发言+考试乱答最后4.5，总之这堂课是我大二下学期的快乐源泉之一，非常推荐！
118038,2325,章宇,2019-10-19 06:26:01,-1,0,1,声音好听！上课温柔却不会让你睡着
122332,2325,章宇,2020-02-24 08:58:01,2,2,0,平时没有作业，有一次论文（辩论那方面），一周一次理论课（全班一起上，老师从不点名，也不问问题），一次讨论课（讨论课是分成四个小班，助教来上，会有很多回答问题的机会，而且还记每个人的次数，吃过几次零食），偶尔几次的ppt小组展示（最后一次的展示占比大），还有一次课堂辩论（交论文之后，自主报名，若人多，老师可能会在报名人里正反方各取论文成绩好的前四名），没有期中考，有期末考，开卷，打印讲义，考试综合性很强，不会很直白，
122628,2325,章宇,2020-03-09 07:17:30,-1,0,1,每次上课都好饿
122765,2325,章宇,2020-04-01 12:22:55,1,1,0,老师挺好的，但是事情真的略多了..默默吐槽2月24号的评论为啥不早点发...一个学期好几次展示还有论文还有作业还有辩论\n\n
123764,2325,章宇,2020-06-14 02:17:10,-1,5,6,现代食品安全科学，事少分高可水，第一门满绩的课。期末开卷考，内容都可以在老师发的复习材料里找到。学期论文一篇，2000。平时每节讨论发个言就好，助教们讨论课还会经常发吃的给大家。老师上课讲的也很有意思，内容很充实，认真听课可以学到不少东西，不听也不会影响开卷考试。还不赶快选上？
124027,2325,章宇,2020-06-21 07:32:36,2,3,1,期末大作业，我要去世了，太恶心了简直 ，三个破题做了一天，各种查资料。平常每周讨论课都要发言，要不然没有平时分，期间两次大作业，我写了几千字那种，还有一个个人展示，保持微笑，老师很严格 ，助教还可以，不水 ，对文科生还好，我就是想吐槽一下期末大作业
124600,2325,章宇,2020-07-03 12:01:21,-1,1,2,表白助教xjj～超温柔超棒！
124603,2325,章宇,2020-07-03 13:01:01,-24,1,25,上课还行，难度适中，作业也挺少，感觉自己已经做得挺好的了可是只有4.5，也不知道为啥。
124627,2325,章宇,2020-07-04 05:49:54,0,0,0,适合喜欢回答问题上课积极回答的同学，事情比较多。
124773,2325,章宇,2020-07-09 02:11:36,0,0,0,还可以，老师对学生的要求其实还是很高的。期间两次大作业，还有若干次小组展示，最后还有一次个人展示和期末大作业/考试。经常强调作业和展示需要体现出来和没上过这门课的人的区别。讨论课发言不清楚究竟重不重要，因为我发言次数还是挺多的，但是最终成绩也没有特别出彩，可能是期末大作业整烂了吧。
133478,2325,章宇,2021-03-01 05:40:16,-3,3,6,从头水到尾，好像期间两次展示，反正都是靠着小组的dl自己就帮忙查查资料，期末考就是抄书，讨论课发过几次言，最后4.5，不知道通识里算不算高，但是我觉得这门课挺合算的
134787,2325,章宇,2021-04-15 05:54:30,1,4,3,蜜汁给分
149813,2325,章宇,2022-01-17 06:11:20,-2,3,5,感谢老师拯救我的绩点
149836,2325,章宇,2022-01-17 07:56:20,3,3,0,给分很迷
154227,2325,章宇,2022-05-26 11:44:40,18,24,6,校青志能给20个小时数，凭什么不能给150个？1为\n\n什么给20你们心里没数吗？\n\n座谈会是校团委组织的，说明这个问题校团委也清\n\n楚，很大很复杂。l其实是他们课题组根本不想出面\n\n(简称装死），校团委没办法才作为第三方来协调\n\n沟通。\n\n科研被试不就是公益志愿者，我不理解校团委为什\n\n么不能发。而且被试是被迫的，你们是主动的，所\n\n以你们是志愿者。1无fuck可说\n\n我每多给你们100块，我就有一个博士/硕士一年没\n\n有补助了。道德绑架您最牛\n\n扯皮了两周，最后还是这个结果，只能说这个课题\n\n组厚颜无耻到一个地步了。坐拥国家千万级课题的\n\n青年导师，在这件事上真就是不要脸到一个地步了。
154229,2325,章宇,2022-05-26 12:16:23,9,10,1,从小时数的事来看，人品有问题
154230,2325,章宇,2022-05-26 12:18:18,16,21,5,建议往后的学弟学妹不要选这个老师的课，不清楚的可以98搜生工食品学院咖啡干预项目，欺骗学生，把学生当廉价劳动力，这种老师不配给浙大学生上课
154273,2325,章宇,2022-05-28 00:02:31,8,9,1,太垃圾了不用多说
159941,2325,章宇,2022-09-09 10:56:03,7,8,1,纯傻逼
165089,2325,章宇,2022-12-29 04:55:19,2,2,0,事儿比较多，最后一个星期了又是pre又是报告的，无语，卷发言，分还没出，期末考开卷但感觉不简单。
168017,2325,章宇,2023-01-22 13:42:38,-10,1,11,给分挺好的，86
168298,2325,章宇,2023-02-09 14:21:21,-1,4,5,讲课讲得不错。现代食品安全事情少，课程也有些无聊，给分没有想象中那么好。
168383,2325,章宇,2023-02-15 08:34:18,7,9,2,咖啡干预项目这这件事情真的是刷新认知下限\n\n千万别选这种老师做导师
173362,2325,章宇,2023-05-21 08:12:45,22,24,2,上学期选的，我什么也没做错，课都来了作业都交了，考试不说优秀至少复习加认真答了最后3.3？？？\n\nC程差点挂我都没这个生气，因为这个完全是莫名其妙的低
186325,2325,章宇,2024-01-10 13:43:40,11,11,0,不知道别的通核是不是这样 这课平时作业也太多了吧。。。\n\n3次小组展示 一次辩论 1次小作业 三次大作业（感觉都要卷字数的样子）\n\n期末考开卷但是有些题书上没有 上课不听不太可能对\n\n老师讲课讲的还行 虽然有点无聊但是仔细听能学到点东西\n\n但是想要轻松水绩点的快逃吧
189827,2325,章宇,2024-01-30 09:09:22,8,8,0,考完20天出分 而且美美被卡了。。。。
189852,2325,章宇,2024-01-31 08:05:10,4,5,1,上课很水很水，从来不用听。但是平时的作业实在实在太多了，两周就留一篇论文，越到后面留的越多越勤。真的作业太多了，pre了三次。事太多了。而且老师实在nt，嫌助教给的分太高，给学生调低总评，我请问呢，怎么会有这样的老师？期末考试开卷考但是实在算不上简单，但是助教姐姐真的人美心善，助教太好啦！！总之，🐙你晚上别睡太死，大家快跑！！！！！！！！！
191383,2325,章宇,2024-04-19 03:08:13,3,5,2,真的很让人讨厌，上课tmd 巨巨巨无聊，而且事情非常非常多，总共做了四次pre，一篇膳食报告、一篇大论文，一次小论文、一次辩论赛，而且问题是这个sb老师最无语的事情就是他还期末考试最后压分，他让助教把每个人的成绩都下调了五分，真的很恶心很恶心
192869,2325,章宇,2024-05-31 06:07:12,0,3,3,我真的要服了，一共四次的pre外加一次辩论赛，再外加三次报告（而且工程量不小），其他通核课多不多我真的不知道，但这门课是真的很多。而且，本人在课上积极卷发言，作业也有再好好做，期末也好好复习了，最后那张卷子出的真的很难，总评还不好。体验就是差，很差，相当差，各位没选的赶紧跑！！！！！！！！
196707,2325,章宇,2024-07-05 01:19:29,-3,4,7,okk一学期上完了，成绩也出了，我只作为一个课程体验者的身份说下我对现代食品安全科学这门课的感受。\n\n首先我声明我不清楚之前章老师发生过什么事情，我也就课论课。这门通识核心课很有意思，上课认真听你会发现干货满满，有很多生活常识，而且老师上课讲的一些细碎知识点是考试很大几率会考到的。\n\n其次对于一些评论说的助教鼓励恶竞的问题，我完全没发现啊。。。还说老师上课问问题点不到你名。。。这完全是空穴来风，我见到的是上课基本没人愿意回答问题，所以回答问题攒平时分也很容易啊……\n\n再说说这门课的作业，我个人觉得这门课作业不是很占时间，饮食记录、小组展示、调研报告也就这些吧。总之我感觉完全没压力，如果你认真对待了，很容易拿好分的。\n\n最后的最后，很高兴在这门课上拿到了4.8，谢谢老师和助教~
208078,2325,章宇,2024-12-25 13:13:59,0,1,1,额，，不太明白，但我个人感觉事情和任务其实没有大家说得那么多。老师比较和蔼，助教姐姐人美心善，她的师兄师姐们也很好。虽然助教姐姐承诺过她们给分都不错，但期末考前还是有点忐忑，希望最后绩点能让我过个好年。
208240,2325,章宇,2024-12-26 10:13:22,4,4,0,章鱼大傻逼
214002,2325,章宇,2025-01-23 00:35:12,3,3,0,。。。
214021,2325,章宇,2025-01-23 03:13:45,4,5,1,凭啥给老子3.3，你个大畜生\n\n傻逼玩意\n\n日死你全家
214090,2325,章宇,2025-01-24 00:47:52,1,2,1,给了7分。一开始我觉得卡绩找东西也就图一乐，直到我发现我们辩论赛的四个人全部都被卡了，我就开始怀疑这是不是故意的了
214161,2325,章宇,2025-01-26 06:11:25,-4,0,4,给分很好，老师很专业
13544,2359,韩志英,2015-12-29 06:24:55,-3,6,9,老师很认真，可惜上课方式不佳，反正我是自学的。
17386,2359,韩志英,2016-09-22 11:51:04,-6,7,13,我给韩老师满分 是个耐心的好老师
17406,2359,韩志英,2016-01-20 07:51:01,17,25,8,气死我了
17408,2359,韩志英,2016-01-20 07:33:50,8,13,5,差差cha
17410,2359,韩志英,2016-01-20 07:34:17,10,14,4,一半时间都在做测试
17412,2359,韩志英,2016-01-20 07:35:43,7,10,3,每节课都要随堂测试 每次上课第一节课讲课 第二节课随堂测试 给分低
28153,2359,韩志英,2016-06-28 08:10:15,1,5,4,该老师是一个非常非常刻薄糟糕的老师！98上有人在郁闷小屋发贴控诉和其交锋的经历。
33902,2359,韩志英,2016-09-22 11:50:44,4,8,4,从没见过这种老师，说话音量和自言自语没区别，从不看学生一眼，讲课几乎只是读一下概念，不讲概念从何而来要到哪去，讲题目让我们自己看从不解释，造成讲课过快，不得不用课堂测验来凑时间，还经常傻站着等下课，醉了
34696,2359,韩志英,2016-10-18 11:41:37,1,5,4,课讲的不知道啥玩意 喜欢边走边拿着书照着书上一字不落地读 还他妈时不时低头看看你有没有在听课 ：)
38467,2359,韩志英,2016-12-06 07:04:28,1,5,4,她竟然让我们念书...念书...题目从来只读一遍，问她问题从来没说上来过。老师您还是认真做科研好吗，好的。
39585,2359,韩志英,2016-12-26 01:17:06,5,8,3,为什么没有0分？我靠，水平真臭，题目不会做，只知道照着答案读一遍，还让我们念书，你为什么不教大学语文？读PPT，在干什么也不知道，居然还有时候傻站着等着下课，我就想知道你是怎么申请成功开这门课的？差差差！
41087,2359,韩志英,2017-01-09 06:37:36,-1,4,5,老师人很好，理论力学自己做就好
42375,2359,韩志英,2017-01-14 05:40:39,-1,6,7,跟叶尊忠比韩志英是天使?
43949,2359,韩志英,2017-01-17 06:58:09,1,4,3,给分超级差，堂堂课测验，讲课讲不清楚，辣鸡
43963,2359,韩志英,2017-01-17 07:12:35,1,7,6,韩老师至少还是为我们的成绩着想的，不管是考前的专门针对考试题目的复习还是出成绩前叫大家赶紧上交平时作业好拉平时分。这些都良心啊。我不知道大家的偏见都从哪里来的。我课堂测验都不做的照样过了啊。。。
44549,2359,韩志英,2017-01-18 02:48:04,0,3,3,考前专门找成绩不好的同学辅导确实还算尽职，但是上课上得确实不敢恭维，可以说完全没作用，平时分也抠得很死，给分低。
46961,2359,韩志英,2017-01-23 05:41:48,-1,2,3,
58859,2359,韩志英,2017-09-18 06:00:26,-7,3,10,为了把评分刷到理力均绩，给个10分吧
66484,2359,韩志英,2018-01-17 03:30:50,5,8,3,很好啊
68730,2359,韩志英,2018-01-23 16:17:34,2,7,5,和高中老师一样，很负责。
72147,2359,韩志英,2018-01-29 12:58:59,4,7,3,很好的
72521,2359,韩志英,2018-01-30 09:28:34,-5,2,7,很负责的老师，真的，老师很用心想让我们学好。但是教的的确不好，事后也都是老实给分不调分。
74546,2359,韩志英,2018-03-03 10:46:48,1,6,5,老师真的很负责给分也是尽量给高，虽然教学水平是不如其他学院的老师，但大家如果选上韩老师的课千万不要因为评分就不想读理论力学毕竟这门课还是要靠自己的。
87871,2359,韩志英,2018-10-16 12:05:38,-7,1,8,老师好好看
94349,2359,韩志英,2019-01-16 07:10:25,-9,2,11,美女老师，真的好漂亮啊
95447,2359,韩志英,2019-01-23 13:02:15,1,5,4,真的是非常负责的老师，也很想让我们都考好，在临近期末的时候会布置每日小练，但不是强制的，在学习理力感到迷茫的时候，老师还会鼓励我们，真的是一个非常好的老师，谢谢老师！最后的成绩我得到我期望的啦！
98465,2359,韩志英,2019-01-23 13:10:11,2,4,2,老师真的好！认真负责！
98502,2359,韩志英,2019-01-23 13:52:20,-2,4,6,老师超级无敌爆炸负责，人真的超级好的！我物理不好，理力本来就很难，幸亏有老师带着我学，选韩老师血赚不亏
98601,2359,韩志英,2019-01-23 15:34:43,-4,0,4,老师很负责，就是上课随机抽点名比较烦
99662,2359,韩志英,2019-01-25 04:38:06,-3,1,4,老师真的很用心，每节课都认真备课，考试前还每天坚持提醒我们做小练习，给分也好，思思姐姐真的超棒的！
99666,2359,韩志英,2019-01-25 04:42:39,-4,0,4,老师真的很负责   虽然上课会听睡着
99685,2359,韩志英,2019-01-25 05:03:57,-6,0,6,认真负责，大学这样的老师已经很难得了！
100378,2359,韩志英,2019-01-26 04:05:30,-6,0,6,老师很负责
116885,2359,韩志英,2019-09-17 03:49:49,-5,1,6,老师很负责，和蔼。声音有点好听。讲的很清楚。虽然会课堂测试，但是为了体谅我们，都很简单的啊。
117549,2359,韩志英,2019-09-26 01:06:37,6,6,0,想睡觉，大号催眠药。有高中物理基础的人听着很累的。\n\n而且事情很多，比别的教学班多了论文和实验，占用大量课外和考试周时间。
120993,2359,韩志英,2020-01-19 08:08:32,-3,0,3,(T ^ T)是我太菜了
121285,2359,韩志英,2019-12-24 02:05:10,7,8,1,脑瘫学习通
121862,2359,韩志英,2020-01-22 17:57:21,6,6,0,？？？？
129746,2359,韩志英,2021-01-12 02:58:04,5,5,0,教学水平不太行
131420,2359,韩志英,2021-01-27 12:14:52,7,7,0,在浙多年遇到的最nt的老师，考试前问题基本不答，让你自己总结，上课毫无内容，还一堆屁事。
132561,2359,韩志英,2021-02-02 09:14:51,-5,2,7,感天动地好老师啊，这给分拯救了我这学期惨不忍睹的均绩，虽然要去很多作业很多，但是平心而论老师真的很负责
138981,2359,韩志英,2021-07-12 05:31:53,0,0,0,哈哈哈
141020,2359,韩志英,2021-09-22 00:03:03,3,3,0,大sx
143657,2359,韩志英,2021-11-30 10:13:00,2,2,0,dsxyg
147612,2359,韩志英,2022-01-10 09:45:51,6,6,0,事情屁多、讲课贼乱，自以为教的很好，很多事情一问三不知。明显的答案错误，她能告诉你：“就是这样，反正韩老师我认为没错。”
147979,2359,韩志英,2022-01-11 08:45:53,4,4,0,聂麻麻滴
150200,2359,韩志英,2022-01-20 08:02:37,15,15,0,感觉这个老师啥也不会，对于很多理论力学的题目自己也没搞明白，又过于负责，只能讲些最浅层的东西。把学生当初中生一样。
160255,2359,韩志英,2022-09-16 02:01:59,6,6,0,幼儿园大班老师，上课像是在带小孩
161143,2359,韩志英,2022-10-29 04:00:37,3,4,1,老师教学水平不行，讲课又讲的这么浅，导致作业也不会写，尤其是运动学的加速度那块综合题，差评！
161209,2359,韩志英,2022-10-31 23:56:30,3,3,0,什么傻逼，每节课都点名，经常小测，作业还多的要死。
161235,2359,韩志英,2022-11-01 14:59:15,3,4,1,每节课都点名，同一门课的其他老师的所有小测加起来都没她多，到最后一口气布置作业要全一天交，屁事是真的多，改题目看图给分，不知道还以为是学工图呢
161494,2359,韩志英,2022-11-07 15:54:30,6,6,0,没见过这么nc的，一个秋学期，三个小测一个期中？？？主要是学校没有安排期中考她自己加的，每节课都点名，还会随机叫人点名and做题？？？每节课都不得安生
165453,2359,韩志英,2023-01-06 07:44:14,3,3,0,教的啥东西
170389,2359,韩志英,2023-03-03 11:54:12,8,8,0,讲课不好，给分烂。不能理解。
179544,2359,韩志英,2023-09-18 05:50:35,-9,4,13,韩老师挺好的，上课挺有意思而且能学到东西，在贵院算是一股清流了
183138,2359,韩志英,2023-11-22 10:59:51,-8,2,10,理论力学秋学期上完，还没考试，来给个好评\n\n每节课手势点名（个人来说不翘课可接受），我倒是挺喜欢老师的讲课方式的，很细致，会真的敲黑板划重点。平时摸鱼多（诶嘿），全靠总结课。\n\n跟冬学期的邓老师比起来，我还是更喜欢韩老师的课，韩老师你快回来啊QAQ邓老师的课还是太跳跃了\n\n作业一章四题，室友看了直接流下不甘的泪水，看以前的评价，应该是改过了。但对“作业交了就满分”提出异议，不知道落实情况\n\n两次小测，静力学一次运动学一次，好像卷面及格就不会有太大差距（忘记原话怎么讲的了）
184522,2359,韩志英,2023-12-21 09:37:49,2,2,0,智障，414啊
190684,2359,韩志英,2024-03-14 09:49:53,7,7,0,韩老师说实话还是比较负责的，平时也比较照顾学生的学习体验，作业也不会刚布置马上就要教。虽然有两次小测但是总体来说小测给分还是相对不错的，也起到了巩固知识的作用。然而如果说有问题的话主要是理论力学这门课的设置吧，确实属于难度太大的那种课程，学起来实在是太吃力了。
33221,2376,周文文,2016-09-16 03:12:24,-2,5,7,要狗带了
41507,2376,周文文,2017-01-12 05:35:25,3,8,5,老师很好，食品通识课积极发言就好了
41586,2376,周文文,2017-01-12 08:24:04,-2,7,9,食品微观世界！讲课是读ppt，每个小组要展示，必须提问，还有论文，不定时点名，给分不怎么样！！
41662,2376,周文文,2017-01-12 10:18:26,7,10,3,飘过\n\n很饿 每节课都很饿\n\n
41704,2376,周文文,2017-01-12 11:26:29,-3,3,6,非常棒的老师，会给看有意思的小视频，上课也会讲自己在国外的小故事，给分很公道，看重的不是你论文写的多漂亮，主要是课堂参与度和小组展示，讲的内容看个人兴趣（我觉得很有意思）课堂也很轻松，不会讲很多特别专业的知识，很贴近生活！
41799,2376,周文文,2017-01-12 15:55:15,9,24,15,虽然课很水，但老师人很好很温柔，在课上可以干自己的事儿从不来管你。分低的完全是因为做展示不走心或者上课从不提问或者上课直接不来，pre好好展示，课上积极提问，每次点名都在，包你上4！
41824,2376,周文文,2017-01-13 02:09:43,-2,4,6,老师很温柔，没考试，上课你问两个问题，写一篇小作文式的论文，和准备一个share，你就离满绩不远了，哈哈哈。
46829,2376,周文文,2017-01-22 11:51:07,-3,0,3,老师很好。人很好，很温柔，遇到问题会热心解答，真的非常热心。对同学们不强求，课上玩手机也行（基本上都在玩手机）。就是内容对于非食品专业的可能会有些无聊，但老师会放些小视频调剂调剂，还会分享在在国外的经验，会点名，不要缺，指不定什么时候就点了。别人做展示的时候要积极提问，可以加平时分的。没有考试，论文要求也不高，主要看平时有没有缺和提问情况。给分很好，使我这学期最高的一门。总之，建议选。
52414,2376,周文文,2017-06-20 02:16:54,-1,1,2,老师人很好，通情达理，评分也比较科学合理。只要按要求做，多多提问哪怕不知道什么分也会高的
52753,2376,周文文,2017-06-22 12:36:14,5,7,2,内向的不喜欢发言的还是别选了  容易被正态
54418,2376,周文文,2017-06-29 09:53:39,-1,3,4,食品生物技术，两次实验报告，外文文献翻译，事情不多，给分不错。
54441,2376,周文文,2017-06-29 10:11:25,-1,2,3,食品生物技术给分好
61705,2376,周文文,2017-11-20 07:52:41,-1,2,3,食品微观世界。老师很棒，上课积极提问+展示做好+期末一篇1500的论文，最后分很高。
61712,2376,周文文,2017-11-20 08:25:37,8,8,0,不喜欢发言的孩子慎选，最后给分要命
61745,2376,周文文,2017-11-20 13:36:45,-1,0,1,老师人超级好，没有考试，有个presentation和论文，好好写就OK。虽然这么说似乎上课就不用听了，但老师的课很有意思的，忍不住会好好听课。
61865,2376,周文文,2017-11-21 10:12:23,1,3,2,上老师的课非常舒服，平时几乎没事，总共要花时间的就是小组展示和论文，每节展示课最后的课堂互动多参与，高分还是ok的
65215,2376,周文文,2018-01-01 05:05:15,0,2,2,老师很温柔，食品微观世界之前讲微生物的时候对于非本专业的可能有些无聊，但是最后几节讲各国食品简直棒！晚课结束感觉又饿了……
89630,2376,周文文,2018-11-20 04:51:51,2,5,3,老师人很好，只要上课积极发言最后论文走心一点展示做好一点上四很容易，我不是相关专业的上课有点水，不过上课看纪录片还是很有趣的。关于点名……说真整个课堂二十个人都没有老师看都能看眼熟吧？迟到都行好歹还是去一下啊
89637,2376,周文文,2018-11-20 05:51:11,-4,0,4,虽然课很水，上课也很沉闷，但是老师认真的很好，虽然我是一个纯文科生什么都没听懂，但是最后满了！满了满了！
118837,2376,周文文,2019-11-07 02:02:59,-1,1,2,这课突出一个字：水，你只要把展示认真完成，1500字论文写好，上课多提问就可以啦，老师真的非常非常好。
118949,2376,周文文,2019-11-08 08:32:02,-2,3,5,老师讲的很好，懂的很多，但课的确水，玩手机啊睡觉都不太管，可能是因为内容太专业了，所以像我这样一个文科生觉得完全不知道在说什么。但老师真的好，给分就看三个，一是小组展示，她会给几个题目让小组去查资料汇报，第二是论文，主题自选但要与课程有关，第三是平时提问，就是每个组展示完会让同学提问，这个尽量每次都提！我一个纯文科生，根本不知道课在讲啥，但认真对待以上三项，老师给了4.8学分，超级感谢老师！！
119011,2376,周文文,2019-11-09 10:41:23,-1,3,4,周老师太棒了！上课很有趣！基本不点名，最重要给分好！她点名的两节课我刚好都翘了，论文和展示也是全组最水，以为自己完蛋了，结果绩点4.2！
119041,2376,周文文,2019-11-10 01:37:19,4,5,1,真的垃圾  每次点名都在  也按要求提问了  展示好好做了 论文已经尽一个文科生最大努力写了  3.0？？你在逗我？
119076,2376,周文文,2019-11-10 05:01:49,1,2,1,课很好玩，给分杀人。对于那种并不怎么喜欢发言的同学（比如我）来说真的很要命。有一个提问题次数的指标，然后你会发现交流环节基本上是一群文科生互相为难。如果想要高分，pre和论文好好做是必须的，然后一定要抢前排座位提问，哪怕是傻逼的问题也要问出来，否则像我一样提不出问题或者坐在后面轮不到提问，最后只有两次提问记录，论文再怎么好好准备也就是3.3的命，服了
119112,2376,周文文,2019-11-10 12:26:43,1,3,2,上着上着就饿了。\n\npre和论文个人觉得很划水，但是争取每次坐前排尽可能多的提问，每次点名都在。所以最后给分还蛮不错的。
119223,2376,周文文,2019-11-11 10:36:41,1,3,2,可以水，但绩杀，上课认真与否真没关系，分全在论文展示和提问上。一个做不好就绩杀，反正我3.3
119341,2376,周文文,2019-11-12 07:11:31,12,13,1,怎么说呢，被卡绩了确实有点伤心，而且其实整个课程里面上课上的很不舒服?，主要是因为老师的给分机制，每次小组展示起来一堆人问一堆乱七八糟的问题，就是为了混分数才硬生生地问了一个问题，其实什么展示的东西内容都没有听过，甚至有个人问出了人肠胃里面有多少种细菌这种问题，吃相极其难看！小组展示个人要被打分，其实下面的人都是随便打分的，根本没听过，但其实那样还好，有些人为了压住别人的分数防被正态打分贼低，5分只给2.3分，我当时都是打4.5分的只有真的觉得他失误太大才给3。我小组展示的组长emmm有点坑，拖延症+没组织，一言难尽。但老师真的很好，她脾气很好很好，很温柔，然后课上可以开玩笑可以玩耍，上课干什么也都不会说，课可以水也可以好好听，其实上课干货也讲了不少，可进可退吧，要是以后能改下打分标准就好了。。。
119396,2376,周文文,2019-11-12 15:12:13,11,28,17,卡绩 ?干了很多事 上课天天问问题 论文、展示都做了很多事情 一个文科生真的不知道说什么了……
119545,2376,周文文,2019-11-13 11:39:32,9,10,1,绩杀啊，去世了，不喜欢发言要人命啊
119580,2376,周文文,2019-11-14 02:05:04,0,3,3,看了评价真可怕，我给其他同学展示评分从来没下过4，微笑微笑
120031,2376,周文文,2019-11-17 06:28:36,-4,1,5,食品微观世界 用百分百的热情（强烈的竞争心态）对待这门课，你一定会学会很多，但是大部分与课程本身无关。总之还是很锻炼的。不要在意细枝末节的，微生物本来就很复杂的，解释不清
127946,2376,周文文,2020-12-01 05:11:40,-1,0,1,还可以吧，可以水课
127954,2376,周文文,2020-12-01 07:09:42,-6,0,6,满绩飘过
128059,2376,周文文,2020-12-05 00:20:28,-4,1,5,老师好看，课水，事少，还会捞人\n\n我一个文科生一整学期啥都不知道但是认认真真做作业和翻译论文，最后拿了4.8
130360,2376,周文文,2021-01-21 10:52:39,-2,1,3,上的食品微观世界通识，事不算多，一次pre+一篇论文翻译+课上水了三次提问=4.2，不功不过吧，上课可以听get一点知识也可以水。老师人还是不错的，甚至延了好几天ddl，还是比较推荐的
135972,2376,周文文,2021-06-07 02:23:02,4,4,0,呵呵呵
136551,2376,周文文,2021-06-21 02:35:42,0,3,3,傻逼一个，事情贼多，想一出是一出。专业课还搞个人互评，辩论每组5个人，每个人2分钟，说个🔨 ？而且展示还给每个人打分，有的人看起来事情不多，但花的心思可能多，真的就想一出是一出。你要是没脑子就去请教老教师怎么上课，而不是把一些有的没的搬到课堂上来。不会上课就不要上课，不要在这里恶心人，三学分的课搞得跟十学分一样。好歹体谅下学生吧，一天到晚搞什么幺蛾子。真的狗屎一样的课程体验，你要毁了郑晓冬老师积累下来的好名声了。
142459,2376,周文文,2021-11-12 00:05:03,-3,0,3,上课很轻松，几乎不点名（只有一次好像是看人太少了吓唬一下我们点了名，好像并没有记谁没到）上课也可以干自己的事情。两次讨论一次期末论文，有spoc课要刷，我不喜欢发言，也没抢到机会发言，不过绩点也上四了，感觉讨论和论文认真对待会有回报的。（文科生
142563,2376,周文文,2021-11-13 11:01:31,4,4,0,没想到给分这么低，讨论课有发言，ppt和论文也认真做了，结果……
142828,2376,周文文,2021-11-16 15:22:10,3,4,1,一切正常对待，万万没想到分这么低。课水事多分低，各位自己考量。一门通识课搞了个2.4，我笑死了
144244,2376,周文文,2021-12-21 02:11:34,5,5,0,2.4，没提过问
145394,2376,周文文,2021-12-29 10:08:33,-1,0,1,两次小组展示，结课一篇3000字论文，快结课的时候点过一次名。个人感觉事情还行，展示难度不算很大，我是高中学过生物的文科生，（其实也没感觉学过的生物派上了什么用场。）论文写的也一般般，4.2，平平无奇划过啦
147494,2376,周文文,2022-01-10 05:35:52,-1,2,3,吹爆zww老师，感觉是很温柔的老师，慕课测试忘记做超时了还给我补上了。平常事情没有很多，主要是两次小组展示的pre，期末一篇论文，我觉得给分超级不错哇哇
153053,2376,周文文,2022-04-24 10:07:56,0,2,2,上课会提问 给分很棒
154076,2376,周文文,2022-05-22 14:51:01,-3,0,3,老师非常好
161848,2376,周文文,2022-11-14 12:52:12,0,2,2,理科生，蛮喜欢文文，觉得文文是一个温柔的老师，认真一点，理科生也能取得好成绩，虽然可能比预期稍微低一些，但是89分很高程度怀疑是文文把我从4.2调到4.5的，如果真是这样，谢谢文文捏
163477,2376,周文文,2022-12-14 11:57:46,-1,1,2,食品微观世界两次个人pre＋期末一个文献翻译或者论文\n\n基本全没听结果成绩还不错~老师真的很温柔
176236,2376,周文文,2023-06-28 06:45:42,-2,1,3,微生物学了一天，给了4.5，好!
176473,2376,周文文,2023-06-29 04:36:53,0,1,1,食品微生物学给分还不错的
176474,2376,周文文,2023-06-29 04:36:55,0,1,1,食品微生物学给分还不错的
182445,2376,周文文,2023-11-16 05:12:30,-4,1,5,分多事少，上课基本不听也能有4.8，冲就对了
182477,2376,周文文,2023-11-16 10:20:45,3,3,0,可以水，给分迷
182557,2376,周文文,2023-11-17 11:56:16,1,1,0,事不多\n\n但是卡绩
182579,2376,周文文,2023-11-17 16:06:44,4,4,0,辛辛苦苦认认真真做了两次pre和技术论文（第一次写），3.9\n\n我尽量不去想是老师的问题，因为小组互评里有萨哈比莫名其妙给我刷低分......\n\n这个绩点不高不低，但是有点愧对于我在这个占了两节晚课要做两次pre的普通通识课上做的一切努力......\n\n老师还是挺好的，课听不听随意，不点名，讲的内容属于有生物基础就全都能听懂然后完全失去兴趣、文科生如果有兴趣可以听的程度\n\n还是对成绩不太服气\n\n算了 知足罢
182633,2376,周文文,2023-11-18 15:11:09,-3,1,4,食品微观世界：老师人挺好的，回消息很及时，事也比较少（mooc+两次pre+论文），有时都不用去教室上课；给分也还不错吧，本文科生选的是翻译论文，老师有捞到4.8，感谢捏
182799,2376,周文文,2023-11-20 09:35:04,1,1,0,大作业5min谷歌翻译的，拿了3.9，课是一点没听一直写作业。就这样吧，通识课绩点估计这样子也是正常，况且是我自己太摆了（悲）
182800,2376,周文文,2023-11-20 09:35:02,-1,0,1,大作业5min谷歌翻译的，拿了3.9，课是一点没听一直写作业。就这样吧，通识课绩点估计这样子也是正常，况且是我自己太摆了（悲）
182963,2376,周文文,2023-11-21 08:59:47,-2,1,3,服了 被正态了   文科生怎么学   高中就没学生物什么的  论文认真写了  展示都认真完成了  才3.6
183604,2376,周文文,2023-11-28 00:26:53,1,1,0,小组展示准备挺花时间，我最后选的是论文翻译，翻译了好久，其他时候事都不多，上课挺水，不听也没啥
184353,2376,周文文,2023-12-18 06:19:04,0,1,1,文文老师人特别特别好！食品微观世界这门课也特别好！课堂展示两次，MOOC上看课做题，最后一篇论文，可以自己写，也可以在给定期刊上选一篇英译中。事少给分好！老师自费买蓝纹奶酪给我们吃，其实挺好吃，没有传闻那么难吃。可冲！！！
185262,2376,周文文,2023-12-27 12:03:22,1,1,0,两次pre都认认真真做了PPT，并且和小组同学排演展示，期末论文也是第一次写但努力把格式内容什么的都做好了，但是3.9 。。。\n\n老师上课完全不用听，作业抄抄能过，但是在一些奇怪的地方会揪着你不放。比如因为PPT模板用的是和风所以有“亲日”之嫌，哎。\n\n展示评分由同学打，不过据说“你打的分如何也会影响老师给你的分数”，不知是真是假，或许是因为我给别的小组一律4.5分（满分5）所以老师觉得我很水故而卡绩？？
196604,2376,周文文,2024-07-04 08:12:18,0,0,0,实验报告手写，还要辩论外加调研报告，事情真多。给分也一般啊，还是我太菜了…
203105,2376,周文文,2024-11-17 00:56:23,3,3,0,给分非常求是
203763,2376,周文文,2024-12-02 16:56:01,6,6,0,课是每节课都去的，点名是不点的，pre是认真准备了的，互动是积极参与了的，作业是按时交了的，结果还是绩杀，，，
203836,2376,周文文,2024-11-21 11:50:39,3,3,0,哎，怎么说，老师人还是挺不错的，事情也不多，就是两次pre要准备好还有期末的一篇论文，我们组第一次pre准备错了，老师说只能给基础分，虽然准备的很认真很伤心，但这毕竟是我们自己的问题。就是别人pre之后要提问这个环节我觉得对我这种i人实在有点不友好。最后拿了均绩3.9，哎。
217405,2376,周文文,2025-04-09 16:19:10,0,0,0,微生物主要看期末，平时分大家都挺高的好像。文文姐人很好，但是我不喜欢她。当班主任一直说食品多么多么好，可以去外企巴拉巴拉。外企多难进你不知道吗？\n\n这几年文文姐组还是挺火的，很多人想去，对学生不严格，很温柔。如果想去文文姐组里读研建议在她手下做个srtp。想读研考公的话是个不错的选择。
24002,2487,阮晖,2016-04-25 04:24:14,7,12,5,长的帅
163890,2487,阮晖,2022-12-16 11:59:58,5,7,2,选了老师的酿酒工艺学，感觉老师还是比较耐心和蔼的！提醒作业时间，考前会划重点～每周一次理论课，一次实验课。理论课比较平淡，实验课比较有趣（酿葡萄酒、酒酿、米酒等+品酒），很多操作其实老师帮忙做了，比较轻松也挺快的。课程考核实验报告+考试，需要花一些时间写+复习页数很多的ppt，最后给分还可以:D
181825,2487,阮晖,2023-11-02 01:13:40,2,3,1,真希望我所有的课都是阮老师来教（\n\n选了老师的酿酒工艺学。老师大部分时间看上去有点凶，不怎么笑，但是实际上是位好说话而且有趣的老师。也能感受到老师真的很喜欢自己酿酒喝。平时实验课也很有意思，强推。
184635,2487,阮晖,2023-12-22 04:27:47,1,2,1,大力推荐阮辉老师的酿酒课，老师超好的。理论课可能闷了点，但实验课很有趣，而且老师帮忙了很多。实验报告40%老师都给满了，期末考前考老师也划重点了。
197393,2487,阮晖,2024-07-12 09:48:53,1,2,1,牛马老师，自己不点名把学生落在服务区上，一点恻隐之心都没有，反手扣帽子推卸责任，呵呵
197394,2487,阮晖,2024-07-12 09:48:54,1,2,1,完全不负责，短学期不点名不数人，把学生落在服务区，让学生在高速服务区自己打车，不报销，还把责任怪到学生头上。纯nt
202696,2487,阮晖,2024-11-14 01:58:29,1,1,0,酿酒工艺学很有趣！！感觉老师萌萌哒，实验课也很有趣，真的让我有点喜欢上了酒与酿酒，给分也特别好，虽然我课程没怎么听，但考前背了一天知识点最后喜提4.8
203091,2487,阮晖,2024-11-16 15:13:30,1,1,0,老师真的超级好，只点了几次名，实验课挺有意思的。期末考前还会划重点，提到的知识点基本上都会考到（考前背一背就可以），真的真的超级推荐这门课！
206180,2487,阮晖,2024-12-13 07:14:15,0,0,0,呵呵哒，卡绩点
32425,2489,蒋益虹,2016-07-06 16:14:35,19,19,0,绩。。。sha
51013,2489,蒋益虹,2017-05-12 10:17:07,14,14,0,没见过这么恶心人的老师
52912,2489,蒋益虹,2017-06-23 12:53:56,7,8,1,有毒，给分差，不给ppt。
56672,2489,蒋益虹,2017-07-04 08:28:05,12,12,0,这个老师简直有毒，智障一样，讲课也不好。
57639,2489,蒋益虹,2017-07-11 10:05:57,7,7,0,很多同学总分比考试分数低
58752,2489,蒋益虹,2017-09-16 13:37:25,9,10,1,14食品强如彭博最高分也只有4.9...彭博的答卷还是被该老师点名表扬为“样卷”
77632,2489,蒋益虹,2018-05-07 03:48:33,3,4,1,喜欢在奇怪的时候点名回答问题，讲课一般，事情多，绩杀。但是！\n\n这是必修课，凑合上吧还能退咋的，想啥呢
78621,2489,蒋益虹,2018-05-14 02:29:34,3,3,0,上课好痛苦
79991,2489,蒋益虹,2018-06-18 17:55:58,-1,2,3,老师很好看但是为什么绩杀啊。。。其实很认真在听了。。只不过期末考试可能有些空没记住 真的凉凉
80293,2489,蒋益虹,2018-06-24 13:00:59,0,0,0,无语……
82976,2489,蒋益虹,2018-07-09 11:40:14,1,1,0,巨爱点名，不按套路出题……
85152,2489,蒋益虹,2018-07-16 00:16:13,10,10,0,讲课讲不好，只会点名让学生念屁屁踢。是绩杀没错。
85154,2489,蒋益虹,2018-07-16 00:26:44,8,9,1,为什么没有0分…不会讲课是业务能力问题，绩杀是人品问题，很多人总分低于卷面？还每节课都点名?
85158,2489,蒋益虹,2018-07-16 00:36:04,2,3,1,她的两门课我都学的时间最久可是分数超级超级低 明明人在外面跟我说她已经检查过试卷了没有问题 还规定学生不能看试卷真的太恶心了
85207,2489,蒋益虹,2018-07-16 04:54:34,2,2,0,我从没想过一门认真学了的专业课能这么低分
85562,2489,蒋益虹,2018-07-19 14:31:04,1,1,0,这老师辣鸡
108815,2489,蒋益虹,2019-06-03 02:02:00,4,4,0,还没有考试，但是我已经受不了这个老师来，为什么有人可以每节课点20+起来回答各种问题，整个课上的心惊肉跳的，要是最后还是绩杀就不能忍了
109143,2489,蒋益虹,2019-06-10 03:30:02,3,3,0,科研不清楚，但讲课确实没什么水平，狂念PPT念到你想夺门而出。课程也贼烦，期末会发考试提纲背，但其实给分还是普遍很低，很看心情。期间要做PPT，要做实验写实验报告，要上课回答问题，要点名，期末还有很多要背的(背不到的)，只想给个微笑。
109144,2489,蒋益虹,2019-06-10 03:53:29,1,4,3,n m s l
114899,2489,蒋益虹,2019-07-12 15:14:17,1,2,1,16级给分其实还可以
141067,2489,蒋益虹,2021-09-22 13:33:50,1,3,2,感觉蒋老师人还挺好的呀，怎么分数这么低....
154326,2489,蒋益虹,2022-05-30 09:06:42,2,2,0,懂不懂两点几分的含金量啊（战术后仰）
158623,2489,蒋益虹,2022-07-01 00:31:16,2,3,1,什么垃圾绩杀老师？给分全看心情是吧，整张卷子就不到五分的同学ppt出题做错才给三点几怎么不去死啊
158630,2489,蒋益虹,2022-07-01 01:49:40,1,2,1,讲课感觉还行，但是有点催眠。主要是分数很迷，做梦都没想到那么低分，害
158666,2489,蒋益虹,2022-07-01 07:06:20,1,2,1,垃圾垃圾垃圾！！！！！！！无语
158956,2489,蒋益虹,2022-07-04 02:30:25,-8,5,13,老师最后一节课会发提纲，按照提纲和同学的ppt背，考试全都考到了，最后成绩也4.5，也没楼上说的那么不堪吧
174056,2489,蒋益虹,2023-07-01 17:15:55,6,7,1,我时常怀疑和担心这个老师的精神状态是否正常。。。。
175655,2489,蒋益虹,2023-06-26 05:16:53,5,5,0,上课上的心惊肉跳，考试考的人哑口无言
176247,2489,蒋益虹,2023-06-28 13:31:31,4,4,0,有那么多考点可以考，考试非要考几道上课没明确讲过和模棱两可的题，不知道怎么想的
178223,2489,蒋益虹,2023-07-08 08:06:00,-4,1,5,其实蒋老师人也挺好的，负责认真的老师！没有楼上说的那么差！
178269,2489,蒋益虹,2023-07-09 06:36:24,3,3,0,上课不停叫同学起来答题
196967,2489,蒋益虹,2024-07-06 06:47:25,2,2,0,她评分这么低是有原因的家人们，上课爱点人回答问题，每个人都要交一份ppt然后提前一天抽人上去讲，最后给分奇差。但是这是必修课，我们又能怎么办呢，敢怒不敢言。。。。。
197759,2489,蒋益虹,2024-08-10 11:54:25,0,0,0,食品大三众多水课之中藏着的毒物，九九八十一难的最后一难，巨傻逼的一个老师，平时事情那么多，又是ppt又是实验又是实验报告又是心得体会，期末考试居然还tm有斩杀线，据我所知的每届都会挂人
74033,2522,郑荣进,2018-02-04 11:20:18,1,1,0,老师是个好老师，就是话太多了
96573,2522,郑荣进,2019-01-21 06:43:12,2,2,0,很有意思的老师
97743,2522,郑荣进,2019-01-22 14:44:21,0,0,0,不值得
115611,2522,郑荣进,2019-08-08 13:12:51,0,0,0,呵呵了
159462,2522,郑荣进,2022-07-22 05:07:44,1,1,0,我不明白，为什么不教就让学生设计，每天生不如死
168411,2522,郑荣进,2023-02-15 12:41:50,1,1,0,老头乐，人还挺好的
175005,2522,郑荣进,2023-06-21 02:33:10,10,10,0,被怼不要反驳，不然被怼的更惨。微笑，点头(#^.^#)
178045,2522,郑荣进,2023-07-06 11:10:52,0,2,2,人很好，脑子也正常，这在贵院很少见。唯一的问题就是有点啰嗦。
180202,2522,郑荣进,2023-09-20 14:04:09,0,0,0,这不是傻呗是什么？
119763,2736,吴丹,2019-11-15 12:07:52,5,7,2,不建议非生仪系的学。
119934,2736,吴丹,2019-11-17 01:20:46,7,7,0,明明是一门通识课，还想要我们学多少工科只是吗，给分太差了……
120037,2736,吴丹,2019-11-17 06:51:18,2,4,2,给分低
120220,2736,吴丹,2019-11-24 07:03:08,8,10,2,通识课对外院的人不太友好。
160480,2736,吴丹,2022-09-23 17:19:52,3,5,2,女神！
162000,2736,吴丹,2022-11-16 02:08:27,2,4,2,上了老师的通识，学到了很多
164709,2736,吴丹,2022-12-24 03:22:27,1,3,2,老师很好很负责
171849,2736,吴丹,2023-05-07 07:07:22,1,4,3,明年从yq回来上大佬的通识课
182163,2736,吴丹,2023-11-11 06:42:30,0,0,0,有这么可爱的大佬吗
183211,2736,吴丹,2023-11-23 01:05:57,0,1,1,外专业选了生物医学工程的先导课，给分挺不错的，谢谢老师！
183603,2736,吴丹,2023-11-28 00:26:01,3,3,0,通识课事多分低 痛！老师很温柔但是不建议非工科的同学选。
183903,2736,吴丹,2023-12-03 09:04:09,2,2,0,给分比较低
183904,2736,吴丹,2023-12-03 09:04:10,2,2,0,给分比较低
184058,2736,吴丹,2023-12-07 11:20:26,4,7,3,生医工的导论课。从来不点名，上课内容比较多，事儿也比较多，最后的考核给分只看三次作业和大作业（个人完成）\n\n理论上要拿分你只需要对着上课ppt查点资料把作业卷到极致就能拿高分\n\n观察了周围几个同专业的同学，最后绩点只作业（专题报告）字数成正相关而且接近于线性关系（在3.0到4.8范围内已验证）\n\n别看什么不推荐非本专业同学选课和对非本专业同学不友好了，我看对本专业同学也挺不友好的
184529,2736,吴丹,2023-12-21 12:27:05,3,3,0,给分低
184877,2736,吴丹,2023-12-24 02:30:25,23,26,3,不是查老师怎么还把这位放在生工食品，这位是生医工咖位最大的佬之一了
190453,2736,吴丹,2024-03-04 13:16:34,6,8,2,吴丹大神怎么设定在生工食品啊，笑死了，才发现
193060,2736,吴丹,2024-06-03 07:28:08,7,8,1,生物医学图像处理，这么垃圾的课，不懂为什么又给加回来了，太傻逼太逆天了，讲课讲的也听不懂，不如网上找的资料清楚，不知道这门课意义是什么？对于仪器方向来说
193226,2736,吴丹,2024-06-04 16:19:56,9,10,1,BME名师中的名师，女神级人物。\n\n不过数字图像处理这门课太抽象了，听不太懂，一学期下来感觉自己什么也没学到……
197472,2736,吴丹,2024-07-16 07:44:35,3,4,1,好老师！学术水平高，亲切耐心
198210,2736,吴丹,2024-09-06 03:43:07,10,11,1,这培养方案绝对是吴丹老师改的
203796,2736,吴丹,2024-11-21 06:05:37,3,3,0,偶像丹姐，生仪真神
207871,2736,吴丹,2024-12-24 15:48:53,1,1,0,吴丹老师治学非常严格
213772,2736,吴丹,2025-01-19 16:57:23,14,14,0,治学严格，概括得好。来说段评书，博君一乐：\n\n\n\n丹姐本人读博时，导师分配给她一个普普通通的小动物成像课题，要求用DTI去扫小鼠。在Hopkins一楼没有窗户、“不见天日”的实验室里，做搞老鼠的课题，放到如今的丹组简直是无法想象的天崩开局。然而丹姐本人怎可能服输？搞老鼠对普通人而言是令人痛苦的重复劳动，但对她而言是技术迭代的更快速度与数据源头的更高自由。她硬生生把这个平平无奇的课题磨了两年给盘活，2013年在小鼠离体脑上做出了全世界最高分辨率（50um）的弥散磁共振定量成像技术。\n\n\n\n丹姐在回国之前，四年在ISMRM做了七个oral，拿了六个Oral的最高荣誉。有幸听过一次丹姐的oral presentation，八个字来形容：光芒万丈、锋芒毕露。彼时两位学界中生代邀请了四位讲者，Upeen的黄浩邀请了他自己的小老板，JHU的陆老板邀请了丹姐。黄浩的小老板前脚在talk中给出了一个脑发育的metric（cortical thickness）在年龄轴上“存在拐点”的论述。无巧不成书，丹姐随后的talk中恰好涉及一项相同的研究。不同的是，丹姐直接给出她的学生对这个metric拐点的定量判断：第30个月。于是所有注意到这点的听众都发现：浙大的在读学生做的课题，在精细度和完成度上超过了美国藤校千挑万选的Ph.D完成的工作。\n\n\n\n学术新星从来不是一个人，而是一个团队。带出这种学生的团队，其领袖才有资格被定义为“学术新星”。她对课题的要求是不会低的，因为她当年就经历过这样的“破局时刻”。\n\n\n\n她就是这样的科学家，做事直来直去、干脆利落，工作稳健可靠，宛如艺术。如果你想学些真本事，去她那里拜师永远是个好选择。只要有时间，她会站在每个人的工位后面花半小时以上的时间查进度，查完一轮要三天。在她手底下出来的课题，往往“一看就是健壮的、经得起考验的东西”。
215011,2736,吴丹,2025-02-20 05:19:57,0,1,1,吴丹大神基本可以说是一个讲课生动，重点突出，上课能吸引人的可爱老师\n\n另外，丹姐被查老师放在生工食品学院是因为生工食品学院有个和丹姐同名的实验师，所以查老师只有这一个条目
215064,2736,吴丹,2025-02-20 11:34:33,0,0,0,讲课好的大牛老师！
216478,2736,吴丹,2025-03-17 06:52:34,0,0,0,每次学院路过打招呼都觉得很亲切
221158,2736,吴丹,2025-06-21 15:16:00,0,0,0,（生仪学院的吴丹老师）丹姐的生物医学图像处理非常好，老师很认真，条理清晰，平易近人，平时也不喜欢点名。
13359,2755,陈启和,2015-12-27 07:51:22,-4,4,8,业界良心！
18125,2755,陈启和,2016-01-21 08:02:12,1,7,6,课程质量真心不咋的，就会给高分
36262,2755,陈启和,2017-05-01 02:52:53,-1,0,1,水到飞起
77702,2755,陈启和,2018-05-07 10:36:29,-1,0,1,巨水分低
147312,2755,陈启和,2022-01-09 13:22:49,2,5,3,生工食品学院不可多得的好老师了，没有叽叽歪歪的屁事，没有考前变卦，给分还算可以，考前还会划重点！
171100,2755,陈启和,2023-03-16 02:07:15,-1,0,1,算是专业课里事少的了，给分基本就是看你期末考试考得怎么样
176729,2755,陈启和,2023-06-30 02:13:21,9,11,2,“如果一个房间里有希特勒，墨索里尼和cqh，给我一把枪和两颗子弹，我会杀cqh两次。”\n\n外专业的快跑，本专业的自求多福吧。。。
200771,2755,陈启和,2024-10-22 06:22:03,2,2,0,狗操的陈启和，就是个人渣
208952,2755,陈启和,2025-01-03 14:19:30,2,3,1,我是家暴男
217882,2755,陈启和,2025-04-17 11:45:35,1,1,0,家暴男还行，上课会划重点，也会扩展一些东西。讲课水平还行吧。
220489,2755,陈启和,2025-06-18 08:10:42,0,0,0,微生物检验，他是好人。发酵，懒得喷。。。。。。。
90146,2779,李晓丽,2018-11-22 08:10:28,6,8,2,无聊 老师实验课一言不发让你自己做
198088,2779,李晓丽,2024-08-30 02:40:01,2,4,2,李老师对学生特别好，尊重学生，上课氛围很好
205439,2779,李晓丽,2024-12-06 09:25:18,1,3,2,课堂氛围蛮好的，老师脾气好，有平常小作业。
214688,2779,李晓丽,2025-02-22 05:30:53,1,2,1,有点意思
217580,2779,李晓丽,2025-04-14 00:55:01,1,1,0,早八习题课天天点名
219707,2779,李晓丽,2025-06-04 11:01:44,0,0,0,无敌了
24542,2790,饶秀勤,2016-05-01 10:14:19,0,0,0,一般般
49756,2790,饶秀勤,2017-04-25 13:05:07,2,2,0,绩杀王
79589,2819,俞永华,2018-06-11 03:05:33,-1,1,2,垃圾玩意
186849,2819,俞永华,2024-01-13 08:56:49,5,5,0,很好的老师，上课讲话一直是笑眯眯很亲和的样子，对同学们也很友善
152592,2866,刘松柏,2022-04-27 02:48:54,0,1,1,还行吧，比较水
92453,2977,泮进明,2018-12-29 04:31:36,6,8,2,老师很亲切
145876,2977,泮进明,2022-01-03 14:26:03,6,9,3,老师很不错，非常亲和
149481,2977,泮进明,2022-01-15 13:54:34,-5,9,14,不想多说啥，你上上就知道了
164336,2977,泮进明,2022-12-20 10:09:23,10,12,2,可听可水，老师很幽默
190106,2977,泮进明,2024-02-21 17:00:56,4,10,6,大学写作。老师人很好，从来不签到，课可听可水，认真听的话真的能学到很多写论文方面的知识，给分也很怪好的，我们班级均绩有4以上
203312,2977,泮进明,2024-11-19 05:30:58,3,3,0,老师很亲切！
213497,2977,泮进明,2025-01-18 01:41:38,1,2,1,老师啊，老师确实很亲切，可听可睡，但是...我这么认真，写论文改4，5遍，还是只拿了4.2...老师我真的好难过
2160,3145,叶尊忠,2015-04-03 11:39:48,7,28,21,能够影响你一生的老师。满分不解释
3933,3145,叶尊忠,2015-06-17 10:23:56,-8,8,16,爽
8194,3145,叶尊忠,2015-09-17 11:05:55,3,21,18,叶老师真的是很棒的老师，人和蔼可亲，又负责，满分棒棒哒
17060,3145,叶尊忠,2016-01-19 14:05:10,-3,17,20,很庆幸有这样一位老师做过自己的班主任。
17061,3145,叶尊忠,2016-01-19 14:05:24,-4,1,5,
32047,3145,叶尊忠,2016-07-05 13:10:53,5,26,21,有毒。
41846,3145,叶尊忠,2017-01-13 04:26:11,13,34,21,事儿妈…
42370,3145,叶尊忠,2017-01-14 05:36:23,27,47,20,可以影响了一生的老师? 怀疑楼上是不是上了假老师
42374,3145,叶尊忠,2017-01-18 08:26:15,35,70,35,叶尊忠成功转移了我们对其他老师的火力。跟叶尊忠一比，韩志英 汪开英都是学院老师的楷模
46960,3145,叶尊忠,2017-01-23 05:40:20,-2,10,12,还可以
48905,3145,叶尊忠,2017-03-16 03:19:55,11,30,19,这可能是你遇上的最好老师\n\n不要嫌事多
50497,3145,叶尊忠,2017-05-03 07:32:06,1,15,14,叶老师作为班主任的负责程度跟高中老师有的一拼，大学遇到这样的班主任很难得呀.虽然上课的时候对作业要求比较多，但也是为了我们好：）
51174,3145,叶尊忠,2017-05-23 00:48:14,-1,11,12,好好好好好啊
51270,3145,叶尊忠,2017-05-26 15:05:33,1,16,15,为什么叶老师分数那么低？那么好的老师浙大真的屈指可数了。真心感谢感恩。
53349,3145,叶尊忠,2017-06-26 12:22:58,-1,11,12,事情多，给分高，受益大。
54775,3145,叶尊忠,2018-12-12 15:57:01,5,23,18,误人子弟
57638,3145,叶尊忠,2017-07-11 09:32:19,2,14,12,对于喜欢他从事的方向的人来说是福音，对于对硬件不感兴趣的人来说是噩梦。个人认为，贵专业方向这么多，强行逼着所有学生上一样的课已是不合理，再配合上叶老师的认真程度，真的能让人觉得毁了一学期
65043,3145,叶尊忠,2017-12-28 10:42:48,-9,2,11,em....不谈了
65330,3145,叶尊忠,2018-01-03 05:10:55,10,24,14,不解释。为什么在论文提交日期前2天才发布所谓的补充说明，不是每个人都生来就会写论文的，你好歹说一下具体要求啊。每次都要我们问才更新要求，每次更新都要我们进行重新修改。无力吐槽
65362,3145,叶尊忠,2018-01-03 10:41:07,5,16,11,有毒不解释
65384,3145,叶尊忠,2018-01-03 13:11:57,0,11,11,花式点名+破事极多
65423,3145,叶尊忠,2018-01-16 11:37:23,-5,9,14,从没见过如此厚颜无耻之人
65424,3145,叶尊忠,2018-12-12 15:57:11,-8,9,17,傻逼，从没见过这么垃圾的人
65425,3145,叶尊忠,2018-01-04 01:24:59,-4,6,10,不主动将课后和作业要求，不主动问啥都不知道
65430,3145,叶尊忠,2018-12-12 15:56:55,0,17,17,逼着学生阿谀奉承他 伪善 也就他的亲儿子会给他刷评论
65431,3145,叶尊忠,2018-01-04 02:03:11,-4,4,8,事儿奇多
65434,3145,叶尊忠,2018-01-16 11:38:04,-4,4,8,预言一下，这次会有钓鱼邮件的套路嘛
65448,3145,叶尊忠,2018-01-04 04:00:35,5,13,8,炒鸡棒！强烈推荐！一定要选
65515,3145,叶尊忠,2018-01-16 11:37:58,-6,6,12,哦没见过事情这么多上课这么麻烦的老师 求求你快别当老师了吧 折磨学生
66182,3145,叶尊忠,2018-01-16 11:37:51,2,11,9,老师，您的要求真的多到我看完一遍都记不住有哪n条，只能战战兢兢完成作业，反复确认，生怕有哪一条未能达到您的要求就可能这项作业又被扣分了。要知道您有n项作业，有n个打分，加权项那么多，真的是怕做了这么多作业，结果分数只有一点点。但我想，不管如何小心，老师的高要求还是达不到，分数还是要扣掉n分。对课程的感想心得，请问老师是想让我们对您授课方式，授课内容，授课布置的作业，实验安排以及n项内容进行评价和感想吗？请问老师能接受怎么样的评价呢？正面的还是负面的？如果因为老师会看到负面的内容就可能大家做了n项作业，拿了一个超低的分数，那么大家所有人的文章就变成了溢美之词。这样的感想心得，一般都是违心之作。希望老师不要太过注重形式方面的内容，无谓增加大家的考试周负担。谢谢叶老师，祝您早日升官[微笑]
66185,3145,叶尊忠,2018-01-12 15:31:10,-4,4,8,微笑 微笑 微笑
66333,3145,叶尊忠,2018-12-12 15:57:23,15,29,14,叶老师对学生要求高，给分实事求是但普遍都会很好！某些评论不要用事多，论文难写恶意为由给差评。我觉得学到了上课学到了很多实用的东西，一点都不水，很棒的老师！
66338,3145,叶尊忠,2018-01-15 07:17:27,7,21,14,叶老师的课的确事情很多，但是每一件事情都特别能够提高个人的能力，感谢叶老师把我男朋友培养地这么好！
68072,3145,叶尊忠,2018-01-22 14:38:02,-4,3,7,怕了，我怕了
68102,3145,叶尊忠,2018-01-22 14:51:25,5,12,7,超想上叶老师的课！仰慕很久了！
70703,3145,叶尊忠,2018-12-12 16:00:07,-5,4,9,。。。
71136,3145,叶尊忠,2019-06-21 09:33:10,-6,26,32,那些匿名骂老师的，真的无语。原来和我一起上课的，是一群目无尊长的地痞流氓。叶老师的事情的确很多，但是他是想我们学到东西啊。那些什么事都想水的同学，请你们自动退学。就算你水到文凭又怎样，你还是会被社会淘汰。祝你们庸庸碌碌的过完你们水逼的一生。
74864,3145,叶尊忠,2018-12-12 15:58:55,5,10,5,认真负责无私奉献
75090,3145,叶尊忠,2018-03-07 10:16:31,4,7,3,事情多，但能学到东西，而且给分真的不错
76480,3145,叶尊忠,2018-04-10 22:57:35,5,10,5,真的很为学生着想，是个很负责的好老师，大学期间能遇到这么个老师对自己提出这些要求感到很幸运，以后可以少走弯路
77208,3145,叶尊忠,2018-05-03 16:58:48,5,9,4,上课都是十足的干货，事情较多，给分很好。
83076,3145,叶尊忠,2018-07-09 15:21:39,1,5,4,疯狂式点名法了解一下\n\n疯狂式修改法了解一下\n\n不过也算是学习了形式上漂亮的本领
84829,3145,叶尊忠,2018-07-14 03:07:26,-3,0,3,并不是说他不好，而是不会把握好一个度。
90821,3145,叶尊忠,2018-12-12 15:59:43,5,9,4,请摸摸自己的良心，好好想一下自己到底是嫌事情多还是这个老师真的不好，这样愿意倾囊相授，细致入微授课的老师你们在这诋毁什么啊！不想上别上，预置这个课又不是老师的责任
91528,3145,叶尊忠,2018-12-12 15:48:58,5,8,3,叶老师是上大学以来对我个人影响最深的老师，不解释，拉满。
91529,3145,叶尊忠,2018-12-12 15:59:05,3,6,3,非常好的老师
91530,3145,叶尊忠,2018-12-12 15:51:34,5,9,4,好老师，不解释，拉满。打低分的，就是六个字，鸭西啦，梁非凡。
92041,3145,叶尊忠,2018-12-25 15:09:33,4,7,3,跟别的老师比起来作业多，要求多，事多，不喜欢，给分差。个人观点求求楼上键盘侠少tm judge别人
92501,3145,叶尊忠,2019-01-01 01:58:38,6,11,5,首先，必须客观承认叶老师的确是一个认真负责的好老师，愿意培养学生，为学生付出。但是，叶老师布置的任务基本会打破一种平衡，对于喜欢做他这个方向的同学来说有着极大的好处，但对于70%(估计)及以上的人来说，为完成该老师的任务的付出与收益相差太多，得不偿失，甚至有一定可能因为不得不生产的学术辣鸡损害绩点，强烈建议对于自己有明确规划且与叶老师方向不同的人慎重选择，如果真的不幸选上，在合适的时间点战略性放弃和退课不失为一种好的选择。附：叶老师对于培养学生的战术有较好的水平，但其培养学生战略水平极差。
94772,3145,叶尊忠,2019-01-18 05:51:27,3,4,1,课是上得不错，可是为啥期末啥都不说啊，重点不划题型不说
103653,3145,叶尊忠,2019-03-04 00:11:02,3,5,2,垃圾垃圾
108485,3145,叶尊忠,2019-05-26 19:15:01,-2,1,3,超级赞的老师！！！事情的确多，但课程内容都超级有趣，而且干货满满啊！老师超级耐心负责，对菜鸡也很热心。至于2学分的课上出12学分的感觉之类的话，emmm反正不是必修课，老师上课前也会强调这门课很辛苦，受不了就退课呗。
108653,3145,叶尊忠,2019-05-30 12:07:41,-1,1,2,人好，很好很好的那种
139559,3145,叶尊忠,2021-07-17 08:22:11,0,3,3,可能是学院最好的老师了 因为他把学生当个人 例如 汪开英 蒋焕毅之流哪个不是自以为是 压榨学生 自己却一点也不付出 把学生当sb
142660,3145,叶尊忠,2021-11-15 03:00:11,-9,0,9,好老师啊 幽默风趣
144016,3145,叶尊忠,2021-12-16 02:39:52,20,21,1,成天卖情怀，虚伪教条，事情多
163308,3145,叶尊忠,2022-12-12 11:15:26,-4,1,5,研究生以来遇到的最好最认真的老师
163805,3145,叶尊忠,2023-01-03 20:09:15,7,7,0,呵呵呵
166205,3145,叶尊忠,2023-01-11 12:06:18,16,16,0,上课扯扯淡，考试背不完。给你备早餐，快来打比赛。
166792,3145,叶尊忠,2023-01-13 15:02:29,-1,6,7,从我的体验来说，叶老师算是农工里对待学生很友好的一位老师了，会很关心学生的想法，不管是对于自己的研究生还是本科生都特别友好，很让人感动。教学水平和科研能力可能不是那么出色，对待学生也会有一些自己的要求，但是并没有push，算是一位关心学生、体贴学生的老师吧。
167874,3145,叶尊忠,2023-01-23 08:52:40,7,14,7,生物生产机器人这给分😅\n\n编辑：真的假的？？？有这么多人满绩？？？我身边的人都是三点几🙄
167875,3145,叶尊忠,2023-01-19 16:12:43,-5,1,6,给分好，仍然给1分
167876,3145,叶尊忠,2023-01-19 16:14:24,11,11,0,下面说给分不错的建议和贵院锁死，一个都不准跑妈的
167989,3145,叶尊忠,2023-01-21 07:55:37,-23,2,25,机器人满了，谢谢叶老师，学弟学妹们认真学考试和分数没问题的🤓
168029,3145,叶尊忠,2023-01-23 04:42:07,7,11,4,全天下都知道你满了，别到处刷了行吧，这里是评价老师的地方不是你秀分数的地方，没拿过满绩来这里叫是吧。还好好学没问题，这门课平时学什么你告诉我。不愧是我们专业，培养的都是人才
168030,3145,叶尊忠,2023-01-23 04:46:37,5,9,4,戾气别太重了，它大学好不容易一个满绩，秀秀怎么了？
168031,3145,叶尊忠,2023-01-23 05:07:29,6,10,4,大三这个阶段选择重要性远大于卷一两门水课的绩点，选择转专业的卷项目和外院的课，选择出国的卷托福雅思，选调的卷经历。卷我院课程最好的去向就是留在这个学院，比保研线高的卷的那点绩点全部作废，学弟学妹在绩点足够的时候还是好好想想自己大四的去向，下面的格局还是小了
168033,3145,叶尊忠,2023-01-23 07:44:46,1,11,10,底下秀分数的，我也满了，身边认识的也满了好几个，我们有人刷吗？我照样为这种烂课打一分。一直以为贵院的专业课那高分应该是一种耻辱。有这点精力不如多卷点cs 金融 数学课吧，贵院这种逆天课本就是随缘给分，take it easy
172963,3145,叶尊忠,2023-05-10 11:52:34,15,15,0,大三下学期强制参加机器人竞赛。还得必须有建模和动画，心得体会。看一群俱乐部里的队伍秀，想跑路还得浪费时间。毫无含金量，写简历上都拉低档次。老师说没建模可能挂科，队友还摆烂，模型动画都要我搞。服了这lj专业了，学弟学妹们赶紧跑路！！！！！
210740,3145,叶尊忠,2025-01-10 01:41:49,0,0,0,逼迫人一定要进arc一样……
210838,3145,叶尊忠,2025-01-10 05:10:28,0,0,0,这门课程是人能想出来的吗
8517,3182,裘正军,2015-09-22 04:36:29,1,2,1,很喜欢点名
34926,3182,裘正军,2016-10-26 13:47:43,1,2,1,太差评
58229,3182,裘正军,2017-08-26 13:50:31,0,2,2,很好啊
90363,3182,裘正军,2018-11-23 09:12:43,5,6,1,垃圾玩意儿
115325,3182,裘正军,2019-07-18 15:29:20,-4,1,5,裘老师讲的很好
118943,3182,裘正军,2019-11-08 06:48:31,5,6,1,讲的跟狗屎一样
143077,3182,裘正军,2021-11-18 18:18:37,4,4,0,给分真的差
143079,3182,裘正军,2021-11-18 23:25:09,1,3,2,讲的挺好的，只能说学弟学妹们考前留一下考试题型和方式吧，记忆的内容太多了真就是默写，别和我一样觉得代码看懂了就算复习完了…
143092,3182,裘正军,2021-11-19 01:50:43,9,9,0,讲课真的听不懂，给分也是真的差，不过我确实也没怎么听
143153,3182,裘正军,2021-11-20 04:17:43,17,19,2,杀疯了杀疯了，鲍一丹裘正军在19级杀疯了
161781,3182,裘正军,2022-11-13 05:38:51,-10,2,12,试卷出的好烂…不过老师人还是不错的
162461,3182,裘正军,2022-11-23 02:03:10,1,1,0,真的不好
162467,3182,裘正军,2022-11-23 03:07:26,3,3,0,捏麻麻的，出背诵试卷就算了，你麻痹还给分这么烂，sb学院贵人多
162471,3182,裘正军,2022-11-24 11:28:29,3,3,0,绩杀王者，学弟学妹们一定要好好写实验报告，好好做作业，不然最后拿的分还没你卷面高
162485,3182,裘正军,2022-11-23 07:44:48,4,4,0,微机，本该是一门有点像计组的课程，而老师讲的烂就算了，出的试卷，那你嘛叫试卷？考背诵题，靠背指令，100分的试卷编程题10分其中4分还是ppt原题？大头都在背概念，这也叫微机？这也叫工科？给分也不行，还三天两头点名，学在农工这种鬼专业就偷着乐吧，别越学越傻都万幸。rnm，nygc！\n\n利益相关，修过计院硬件课学过汇编，但这课考背诵，考不过死记硬背人，愤愤不平写下。
162492,3182,裘正军,2022-11-23 10:16:39,9,9,0,杀疯了杀疯了，鮑一丹和裘正军在20级杀疯了
162517,3182,裘正军,2022-11-26 01:09:22,4,4,0,绩杀王者，一个nt
162528,3182,裘正军,2022-11-24 12:01:55,3,3,0,老师人好个勾巴，平时分狠狠扣，试卷考背诵，讲课读ppt，我不认为浪费我时间还给我低分的玩意是什么好东西
162554,3182,裘正军,2022-11-25 07:06:48,4,5,1,这讲课水平，这ppt，这试卷，这给分，不骂句sb这说不过去吧
163155,3182,裘正军,2022-12-08 08:19:22,3,3,0,多少沾点
163180,3182,裘正军,2022-12-09 03:52:53,4,5,1,如果想要高绩点，我的建议是：选别的学院的相关课程再覆盖这门课，如控院的嵌入式（虽然很硬，但给分好，而且你获得的也会比这多得多的多），当然，覆盖之前你还得找你院的贵物教务处吵个架。\n\n\n\n\n\n这个建议同样适用于自控，噢不，是鲍氏控制理论，就你那水平，这么说吧，我还真觉得没我高，恭喜退休，造福后人。\n\n\n\n\n\n就是说不知道为什么贵院的老师看起来都那么自信，大概彩笔都是自我感觉良好的吧。现在最恶心的词汇就是诸如“图文并茂”“条理清晰”“创新性”之类的，您们看要不先把二十年不变的ppt和作业创新一下？\n\n\n\n\n\n这种不会与时俱进，不会批评与自我批评、广泛听取学生呼声，又天天大搞特搞展示主义、报告主义、“创新”主义的学院就是在用学生的生命养一帮活在上世纪的贵物。
163385,3182,裘正军,2022-12-14 07:55:12,12,13,1,sb玩意我真是越想越气不过啊，你麻痹计院的课60分平时分老师给了几个52都被学生骂得狗血喷头了，你麻痹qzj老子三十分平时分，点名都到了作业都交了，实验报告写了交了你妈的扣我六七分，能不能414啊，贵院的课烂的跟他妈依托答辩一样，还给你打低分千方百计不让你跑，我操你妈生工食品学院，一群傻卵，就你妈是畜生，学生在你们眼里连屁都不是，那你在我们眼里也猪狗不如
164279,3182,裘正军,2022-12-20 06:31:28,6,6,0,反正我是挂掉了……
164883,3182,裘正军,2022-12-27 08:24:23,1,1,0,死板，做作
166332,3182,裘正军,2023-01-12 03:36:51,8,8,0,凭心而论，大学里花的时间前三多的课了，拿了大学最近绩点。真的是影响一生的好老师捏。建议在意分数的同学大四学或缓考
167551,3182,裘正军,2023-01-17 09:01:27,9,9,0,考试前：评论区的同学怎么能这么说这位老师，人很好啊\n\n考试后：＊＊＊＊\n\n出分后：＊＊＊＊＊＊＊＊
167942,3182,裘正军,2023-01-20 14:43:15,9,9,0,If Hitler， Mussolini and QiuZhengjun were in a room and I were given two bullets， I would shoot QiuZhengjun twice.\n\n臭狗，20届农工学子大三上最讨厌的玩意
168119,3182,裘正军,2023-01-29 03:26:35,5,5,0,正军正军，扰里长蛆
169915,3182,裘正军,2023-02-28 11:14:26,3,3,0,卧龙！
182732,3182,裘正军,2023-11-20 02:57:47,2,3,1,老灯，该爆金币了
182734,3182,裘正军,2023-11-20 03:01:07,6,6,0,纯纯背书课，ppt，作业题，实验代码全背一遍就行。每年有十多个挂的，还是得认真听课，背指令，啃书，认真写实验报告。第三章指令必须全记住，上课仔细听，提问的时候格外注意，可能会考。\n\n上课喜欢PUA，笑面虎。贵院的课纯纯浪费时间，不如选其他学院的微机覆盖，虽然难但能学到真东西。
198962,3182,裘正军,2024-09-13 11:32:27,1,1,0,看评价有点慌
201429,3182,裘正军,2024-11-02 13:31:36,-3,1,4,老师人其实还可以，感觉平时上课和说话都挺不错的
203231,3182,裘正军,2024-11-18 07:37:31,1,1,0,背书课，期末试卷就是纯背书，背得越多越细越好，实验好像就仿真实验考了一下，其它都没有涉及到。教的嘛……我只能说你都在农工了还指望能学到啥……
215923,3182,裘正军,2025-03-07 11:53:57,1,1,0,我一学期没听课，最后背了一早上作业题过了\n\n室友单片机领域大神，全程带着我们做的单片机实验，毕设也是自己画板子搞的，最后因没有背作业题被挂了😅
79990,3325,沈建福,2018-06-18 17:54:11,0,0,0,老师人挺好的，会发讲义，忘记拿了老师还会把讲义拿下来给你的那种，一般一次课讲完之后会发放一套章节习题作为点名，据说是到了就有分。我只有3.3很醉，所以期末考试一定要背好啊。。。什么都考。。真的什么都考
38486,3358,汪开英,2016-12-21 02:21:04,7,9,2,能躲则躲
46954,3358,汪开英,2019-01-21 09:23:41,8,12,4,一个一节课不上的老师，事情超多，假的考试范围，给自己专业的分还低
47523,3358,汪开英,2017-01-29 07:04:52,13,16,3,自己从来没上过一节课，却事情特别多
65044,3358,汪开英,2019-01-21 09:23:03,5,7,2,神人啊
66143,3358,汪开英,2018-01-12 05:57:56,11,13,2,为什么没有零分选项？
68980,3358,汪开英,2018-01-24 07:24:59,11,12,1,事情非常多！期末还想着怎么折腾学生！要求非常多！真的很糟糕！很想骂人！！！！想着法子怎么折磨人！
69853,3358,汪开英,2018-01-25 14:02:03,7,9,2,逼脸不要，事多，自己啥都不干，净想着怎么忙死学生，佩服佩服
71130,3358,汪开英,2018-02-03 09:04:53,-9,5,14,好(✪▽✪)\n\n
73846,3358,汪开英,2018-02-03 08:50:54,7,10,3,没见过如此傻x的老师，还真把自己当老子了哈，什么逼事都要管，从来没好脸色，真想装逼您倒是拿个诺贝尔去为国争光啊，瞧把你牛逼的，建议您早点退休，我说的是实话
74660,3358,汪开英,2018-03-05 04:18:41,6,6,0,事儿妈
91191,3358,汪开英,2018-12-03 04:38:42,10,12,2,这课谁不能上？我奶奶来都能开着门课 上课找别的老师 实验课放周末 去外地七个小时车程来回 参观一小时 nmsl？
91384,3358,汪开英,2019-01-16 03:36:24,10,14,4,期末考试是真的牛逼
91385,3358,汪开英,2018-12-07 11:46:11,7,8,1,论如何在一个星期内熟练掌握并运用有道翻译
91396,3358,汪开英,2019-01-21 09:22:55,6,7,1,真的不行这老师
91524,3358,汪开英,2018-12-12 12:58:53,5,6,1,表面民主，真特么牛逼
93460,3358,汪开英,2019-01-10 01:33:56,3,4,1,期末考试要求最后一周才出 我佛了 这个老师说以为这学期只有这么一门课吗？ 还瞎jb安课表 我rm真的np
93730,3358,汪开英,2019-01-21 09:23:29,3,4,1,铁憨憨
94239,3358,汪开英,2019-01-16 03:38:11,7,8,1,我不是针对该课的每一个老师，而是只针对汪开英一个人
94262,3358,汪开英,2019-01-16 05:29:29,9,11,2,傻逼课，期末考试，两张试卷，一个72分钟，一个48分钟。第一个时间到了，有些人没写完，突然延时，第二张只有30分钟。cnm的，10点到了，再不交不收了？ 第一份试卷提早写完的同学时间都被你吃了，你nm呢\n\n
94773,3358,汪开英,2019-01-18 05:52:29,3,5,2,铁弱智
95043,3358,汪开英,2019-01-18 15:31:41,2,4,2,太傻了这课
96594,3358,汪开英,2019-01-21 07:11:31,3,4,1,不好啊
116859,3358,汪开英,2019-09-17 01:14:04,14,16,2,你把你副教给我交了!纯jb混子
135698,3358,汪开英,2021-05-19 10:32:12,15,16,1,奇奇怪怪的外出实践 从时间安排到现场教学的内容 完全凌乱。 冒雨在泥泞山路上走 完全不管走在后面的同学 总共三分之一的人在泥路上根本找不到老师 呵呵
135901,3358,汪开英,2021-06-02 04:24:42,7,8,1,爬爬爬爬爬爬
139556,3358,汪开英,2021-07-17 08:02:28,6,6,0,自以为是的老师
150758,3358,汪开英,2022-02-17 15:11:20,9,10,1,两天就开学了改开课时间。。。
150913,3358,汪开英,2022-02-21 04:46:17,-14,1,15,非常好
152585,3358,汪开英,2022-04-15 08:12:50,19,20,1,简直**，上课在后面转来转去一直拍照，一节课要求点两次名不说，整个人狂妄自大，在其他教授发言的时候不断打断只顾自己一通输出，搞得自己很厉害啊。。和这样的老师待在同个学院简直耻辱。。。
152598,3358,汪开英,2022-04-15 12:19:00,-3,6,9,我不允许你们这么骂我的开英姐姐~
152606,3358,汪开英,2022-04-15 14:56:58,7,7,0,纠正一下刚才那位同学，是一节课三次点名
153794,3358,汪开英,2022-05-11 07:12:27,9,10,1,圈e别黑老师啊
154087,3358,汪开英,2022-05-23 03:51:05,42,43,1,汪老师非常好👍原定11:25下课的课还愿意用自己的时间给我们拖堂上课，真的好暖🥰
154088,3358,汪开英,2022-05-23 04:05:40,25,27,2,汪开英是真傻逼！汪开英是真傻逼！汪开英是真傻逼！汪开英是真傻逼汪开英是真傻逼！汪开英是真傻逼！汪开英是真傻逼！汪开英是真傻逼！
154089,3358,汪开英,2022-05-23 04:20:18,4,8,4,汪老师真的很好 正所谓良师益友 学弟学妹们不要错过这样的好老师好吗
154828,3358,汪开英,2022-06-06 03:18:35,8,8,0,无语子
154888,3358,汪开英,2022-06-06 13:08:22,8,8,0,怎么会有这么ex的**的
154889,3358,汪开英,2022-06-06 13:08:22,8,8,0,怎么会有这么ex的**的
155417,3358,汪开英,2022-06-12 10:12:08,9,9,0,哈哈，他🐴了个b
155449,3358,汪开英,2022-06-13 04:30:49,8,8,0,纯纯**
155688,3358,汪开英,2022-06-15 08:02:55,7,8,1,每张纸只能写半面你觉得自己很幽默吗
158613,3358,汪开英,2022-06-30 17:07:01,8,8,0,还有几天就要交了，张嘴来句查重率不超过10%，站着讲话不腰疼是吧。给自己辩解大段发文字，向你提出质疑就回两个字。
168402,3358,汪开英,2023-02-25 07:06:21,9,9,0,大家千万别选她的课\n\n别选她做导师\n\n那将是你的噩梦开始
170863,3358,汪开英,2023-03-10 16:16:59,3,3,0,逆天，两头不讨好第一次见
173526,3358,汪开英,2023-05-28 01:27:55,14,14,0,临近期末周末早八把大火叫到教室看那b老师钉钉直播，周末给你组织去什么垃圾大棚浪费半天，你妈的，贵院个个畜生
174862,3358,汪开英,2023-06-19 05:58:39,6,6,0,不是，这5.28的评论怎么那么像我说的话，但明明不是我发的呀
177864,3358,汪开英,2023-07-05 06:36:13,9,9,0,阴魂不散的环境工程，考完了还那么多b事，甘霖娘
177991,3358,汪开英,2023-07-06 04:07:17,6,6,0,你没事吧？
178087,3358,汪开英,2023-07-06 18:32:14,5,6,1,i了i了，但他的研究生真惨
178091,3358,汪开英,2023-07-07 00:59:15,6,6,0,贵院典型代表人物
178206,3358,汪开英,2023-07-10 02:39:46,6,6,0,每节课点名。周末还要去参观渔场，羊场。课程设计浪费时间。老师上课口语感人。考试A4纸一定要抄全，考的很细。大题和作业2差不多，前面要抓紧做，考试有点来不及。平时占60%，平时尽可能卷起来吧。终于不用上这傻逼课了。
179072,3358,汪开英,2023-08-27 12:07:51,1,1,0,666
196217,3358,汪开英,2024-07-02 09:15:10,11,13,2,哈哈哈哈哈哈？？？？？？？？？？？？？大作业是拖到考完试才安排展示的，论文是展示完占用短学期课时间要求更改提交的，安排及其不合理...最后一节课两个老师一唱一和讨论中国孩子和外国孩子的不同？还表示不理解有人会因为没钱放弃免学费出国留学？其实我觉得中外孩子确实有所不同，曾经有教育家做了一个实验，把中国孩子和美国孩子放到高塔上，让他们自己下来。美国孩子在高塔上站了一天，没法顺墙壁爬下来。而聪明的中国孩子因为玩过原神，打开风之翼直接飞了下来。僵化的思维，落后的体制永远无法培养有创新意识的大科学家。
108523,3459,岑海燕,2019-05-27 15:26:08,23,26,3,屁事多 而且不通人情 自己想怎么来怎么来 助教都很用心十分负责 可惜老师爱装逼
134541,3459,岑海燕,2021-04-01 03:52:27,15,18,3,傻逼老师，屁事多。
159211,3459,岑海燕,2022-07-08 06:53:56,12,15,3,不要选她做导师，屁事巨多
168400,3459,岑海燕,2023-02-15 12:21:54,25,31,6,不要选她做导师，硕士都能延毕，博士生读个七八年起步\n\n精致主义，现在帽子来了，对学生要求更高了
170687,3459,岑海燕,2023-03-08 07:05:34,6,7,1,呵呵，我只呵呵
173089,3459,岑海燕,2023-05-13 05:33:14,9,11,2,不要选她做导师，你真的会后悔的！\n\n博士能读八年！八年抗战都结束了！
179294,3459,岑海燕,2023-09-08 01:23:47,10,11,1,小人得志的绝佳典范
180479,3459,岑海燕,2023-09-22 02:21:32,3,6,3,太累了，事情好多
190372,3459,岑海燕,2024-02-28 17:08:23,8,9,1,自以为是的煞笔***
23427,3529,陈士国,2016-03-29 15:06:34,3,5,2,给分很好的老师，彬彬有礼，很和蔼的老师
66658,3529,陈士国,2018-01-18 05:00:16,3,3,0,老师脾气超级好的，也很有耐心。给分也很棒！
142793,3529,陈士国,2021-11-16 07:37:50,0,1,1,给分超好，也很耐心
162062,3529,陈士国,2022-11-16 11:38:41,7,7,0,挺有意思的一门课，老师性格很好，上课有很多有趣的视频，实验课也好玩，对于外专业来说很友好，期末好好准备分数不会差的
170554,3529,陈士国,2023-03-06 11:33:35,0,0,0,老师很儒雅，其实上课能学到的东西还是挺多的，除了有点无聊。给分巨友好！我愿称之为捞人大师。
170555,3529,陈士国,2023-03-06 11:33:54,0,0,0,老师很好 给分很好！很有趣且不点名
179390,3529,陈士国,2023-09-14 06:59:09,0,0,0,捞人大师
183424,3529,陈士国,2023-11-25 23:51:46,0,0,0,老师超级好的，期末之前还会安排答疑，是我见过钉钉回消息回的最快的老师了，基本秒回。讲课也很有意思最后给分真的真的超级棒！
220491,3529,陈士国,2025-06-18 08:14:22,0,0,0,陈老师科研挺厉害的。人其实挺好的，还帮我签了推荐信。
60249,3584,徐惠荣,2017-10-15 16:07:01,-4,0,4,新生之友超级和善。\n\n
67130,3584,徐惠荣,2018-01-20 10:07:34,5,7,2,老师给的重点果然全懂了就能90分，剩下的10分就看天意了
94345,3584,徐惠荣,2019-01-16 07:08:55,3,7,4,徐院长举世无双!
94474,3584,徐惠荣,2019-01-16 16:28:34,-1,3,4,徐院长我爱死你了
100893,3584,徐惠荣,2019-01-27 04:46:18,-4,0,4,徐院长举世无双 记住了 他说考什么就考什么
101830,3584,徐惠荣,2019-01-29 08:14:43,0,3,3,牛逼，说考啥就考啥，对着考纲复习就能得高分
164939,3584,徐惠荣,2022-12-28 02:30:07,5,5,0,为什么今年不画重点了，差评
167744,3584,徐惠荣,2023-01-18 23:42:50,3,5,2,给分不大行啊 但是上课还蛮认真的\n\n还有为啥今年不划重点
167758,3584,徐惠荣,2023-01-19 02:51:20,12,14,2,随着惠荣开始不划重点给分变差，彻底宣告你院已完，再也没有像人的老师了
167877,3584,徐惠荣,2023-01-19 16:24:54,6,6,0,是我的问题吗，今年给分好差啊？？？\n\nsb
168394,3584,徐惠荣,2023-02-15 09:13:21,7,9,2,及其虚假伪善，还很抠门，给分随意\n\n也是这个学院毕业的，就是这帮人把这个sb学院越高越丑
168607,3584,徐惠荣,2023-02-20 08:04:58,-1,2,3,我源神必满绩，问就是op是这样的
168752,3584,徐惠荣,2023-02-21 16:02:50,1,3,2,我畅神4.8！！！
168762,3584,徐惠荣,2023-02-22 01:42:51,1,2,1,我牛神1.5！
178236,3584,徐惠荣,2023-07-08 11:26:46,2,2,0,创新性展示完全没有搞得必要。
179325,3584,徐惠荣,2023-09-11 00:54:31,2,2,0,秃瓢老头心态差
188869,3584,徐惠荣,2024-01-20 10:28:43,3,3,0,据说三次没到算挂，考试占50%，PPT全背一遍就能拿高分。浪费时间演小品，纯浪费时间。。。。
200946,3584,徐惠荣,2024-10-25 07:25:15,1,1,0,哎，留点体面的话吧
201296,3584,徐惠荣,2024-10-31 07:44:13,1,1,0,春春的S B，碧阳晚意
212989,3584,徐惠荣,2025-01-15 12:11:48,0,0,0,喜欢在上课开始后设置三分钟点名时限
47361,3683,陈晶妍,2017-01-25 12:16:47,-4,3,7,上课会做游戏挺有趣的。老师讲的内容都是创业的基础知识。事情不多。给分不错。还是蛮开心的~
47507,3683,陈晶妍,2017-01-28 12:20:07,-4,3,7,自己体会
47761,3683,陈晶妍,2017-02-24 02:19:04,-8,2,10,给分好上课有趣
52117,3683,陈晶妍,2017-06-15 02:25:38,-3,1,4,美女老师哟。小身材大能量，上课蛮用心的
52692,3683,陈晶妍,2017-06-22 07:25:24,5,8,3,公平公正的来说，老师人还不错，但上课组小组的方式并不是很公正，具体考核不怎么到位
56587,3683,陈晶妍,2017-07-04 04:38:38,4,10,6,我没有哪节通识课付出的比这节课多，给出的分数让我GPA暴跌，真后悔报了那节课，上课又无聊。。。
56781,3683,陈晶妍,2017-07-04 15:22:12,3,5,2,还不错
59055,3683,陈晶妍,2017-09-19 08:26:55,3,4,1,第一天上课，很有一种过家家的感觉，不是特别喜欢这种方式
63214,3683,陈晶妍,2017-11-29 08:06:32,5,6,1,学不到什么东西就算了，评价体系模糊不清，主观性大到爆炸，没有创业兴趣的同学别想拿这门课得高分J类，推荐隔壁职业生涯规划。
63352,3683,陈晶妍,2017-12-01 08:11:46,3,4,1,我觉得不行。没有任何创业想法的同学不要选这个课哦，无论是上课还是考核你都会非常痛苦，成绩出来你就会开始追问人生的意义宇宙的边界我不应该在车里应该在车底
63381,3683,陈晶妍,2017-12-02 05:30:24,1,1,0,老师超级用心，案例十分经典，也十分新颖，期末会找真正的投资人给同学的项目评分，给同学接触大咖的机会。
63957,3683,陈晶妍,2017-12-20 05:35:35,0,0,0,我认为是一门很有意义的课。是一门可以认真去上的课，而且老师非常棒，教会了我很多。
70901,3683,陈晶妍,2018-01-27 23:29:52,1,2,1,幸好她不再教这门课了。
71147,3683,陈晶妍,2018-01-28 04:34:59,1,1,0,课堂形式丰富，强调投入，体验创业的过程，最后以展示的方式考核，还是很不错的啦，支持～
19498,3724,刘飞,2018-12-28 05:47:35,5,9,4,通识课《全球定位系统和地理信息系统》剧毒
20941,3724,刘飞,2016-02-04 14:08:38,1,3,2,
38421,3724,刘飞,2016-12-04 08:11:51,0,5,5,特别好的老师，上课时候特别可爱，会分享很多东西给我们
39154,3724,刘飞,2016-12-21 11:34:23,0,3,3,特别好，特别可爱的老师
43300,3724,刘飞,2017-01-16 06:04:14,0,5,5,很好的老师，很有才华的老师
46248,3724,刘飞,2017-01-21 04:45:29,1,4,3,感觉老师挺好的，也很负责任！
99619,3724,刘飞,2019-01-25 04:12:58,6,10,4,被正太了，实在没想到这门课也会正太
106432,3724,刘飞,2019-04-27 10:35:54,0,5,5,老师蛮好的，智慧农业给分也不错
106436,3724,刘飞,2019-04-27 11:04:39,-2,7,9,新课   智慧农业   给分巨好，事情巨少，只有一次展示，没作业，最后开卷考试完全书上原文so easy. 赞赞！老师特别幽默可爱?
106477,3724,刘飞,2019-04-27 23:33:45,0,5,5,老师还行，课可水。但是拿到了历史最低的绩点也是没想到。\n\n考核：展示+考试。展示分数低的话就凉了。
107046,3724,刘飞,2019-05-01 04:27:11,4,4,0,评分系统不公平
107311,3724,刘飞,2019-05-03 12:09:35,5,6,1,人好，上课也还，但是给分，呵呵呵
108582,3724,刘飞,2019-05-29 03:45:26,-5,3,8,老师的智慧农业是不错的，给分还可以
109869,3724,刘飞,2019-06-20 02:23:25,3,4,1,可以不听课，最后展示做好即可的典型水课。
110546,3724,刘飞,2019-06-27 10:44:43,4,9,5,老师确实讲得很棒，不过《智慧农业》这门课奉劝大家不要预订教材，定价139元，而且完全用不到
116040,3724,刘飞,2019-09-01 07:06:26,25,32,7,傻逼老师，分组说七个人，最后要踢一个人
116041,3724,刘飞,2019-09-01 07:13:53,14,15,1,过于傻逼，事精，屁事多
116042,3724,刘飞,2019-09-01 07:15:07,15,16,1,6767磨磨唧唧
116044,3724,刘飞,2019-09-01 07:32:01,9,9,0,难顶阿
116045,3724,刘飞,2019-09-01 07:32:01,7,7,0,难顶阿
116046,3724,刘飞,2019-09-01 07:34:37,14,17,3,脑子不太灵清 分组都分不明白 还是回去养猪吧
116047,3724,刘飞,2019-09-01 07:35:53,6,7,1,6767676767？\n\n666？777？\n\n小学数学没学好
116048,3724,刘飞,2019-09-01 07:35:54,3,3,0,在线被开飞机，你太聪明的亚子\n\n
116049,3724,刘飞,2019-09-01 07:36:21,1,2,1,...\n\n
116334,3724,刘飞,2019-09-08 13:41:27,-1,18,19,我觉得《智慧农业》超好的呀，我上学期选的。平时事极少不点名，没作业，只有一次小组展示，最后开卷考试几乎全是讲义PPT上的，最后4.8过。老师也超和蔼，上课的时候经常开玩笑，还在下课时问过我建议。
118834,3724,刘飞,2019-11-07 00:38:27,-10,3,13,智慧农业真的很好的一门课！事少，老师上课尽力在使专业知识贴近生活，而且很和蔼，下课可以和他交流。
120167,3724,刘飞,2019-11-18 02:07:21,-10,2,12,智慧农业事少分多，推荐
124245,3724,刘飞,2020-06-28 04:08:33,7,8,1,给分完全取决于你分到的小组，我们全组都没上80，通识课这样给分可还行
124265,3724,刘飞,2020-06-28 07:28:33,0,2,2,憨批老师，努力做小组展示，最后连80都没上，一门通识课这样搞也行？，还要别人怎么给你美言？好吧，你们快去选他的智慧农业，给分超好呢
124435,3724,刘飞,2020-07-01 07:36:19,0,0,0,给分不甚好，讲课没意思，混混沌沌而过
128746,3724,刘飞,2020-12-25 06:36:54,-6,3,9,智慧农业还是不错的，水是真的水，最后3.9过我也很满意了
136814,3724,刘飞,2021-06-25 04:26:35,3,3,0,期末最后一周布置了三个作业，平时事情多
138929,3724,刘飞,2021-07-12 00:30:16,0,0,0,给分差
140971,3724,刘飞,2021-09-18 17:03:24,1,1,0,新生之友都不出现，确实是有够忙的哦
141747,3724,刘飞,2021-10-24 11:42:39,1,1,0,讲课生动
144230,3724,刘飞,2021-12-21 00:55:16,1,1,0,老师很博学，人也真的很好！如果是专业学生会学到很多知识，可惜我是为了科技创新）
150876,3724,刘飞,2022-02-20 11:20:26,0,0,0,快逃\n\n给分迷
154425,3724,刘飞,2022-06-01 07:33:53,3,4,1,垃圾课，作业贼多。白嫖方案。煞笔老师
154768,3724,刘飞,2022-06-05 02:19:14,9,9,0,精细农业课程组就是四个傻逼
155316,3724,刘飞,2022-06-10 16:32:40,15,15,0,精细农业，垃圾学院引以为傲的王牌课程，蠢到不能再蠢的内容，你找个厂工的都会测操场距离，都会按照步骤写你的GIS作业，都会找无人机论文ctrlCV\n\n真不知道这种课的意义是什么，事多分烂，把浙大学生当牛马使。\n\n贵院真的早点倒闭算了，别再招生害人了。
158126,3724,刘飞,2022-06-27 05:57:29,0,0,0,还行的
161928,3724,刘飞,2022-11-15 05:33:59,-6,0,6,智慧农业，嘎嘎水，成绩只看分享，必冲🥳
163607,3724,刘飞,2022-12-15 13:58:04,1,1,0,给分不好，课也一般。
168393,3724,刘飞,2023-02-15 09:07:31,7,7,0,精细农业，垃圾学院引以为傲的王牌课程，蠢到不能再蠢的内容，你找个厂工的都会测操场距离，都会按照步骤写你的GIS作业，都会找无人机论文ctrlCV\n\n真不知道这种课的意义是什么，事多分烂，把浙大学生当牛马使。\n\n贵院真的早点倒闭算了，别再招生害人了。
178098,3724,刘飞,2023-07-07 02:34:58,3,4,1,刘老师，我错了，看过隔壁王俊王永维那俩王八蛋之后才知道您开的课是多么好，lfgg带我走吧呜呜呜呜呜呜呜
179335,3724,刘飞,2023-09-12 01:33:04,1,2,1,事多分少\n\n0.5学分的短学期课程\n\n要求多的上天 而且讲都讲不明白\n\n还讲一些逆天大道理\n\n还有为你们好所以加要求之类啥呗操作\n\n刘飞我阐述你的梦\n\n\n\n其他精细农业老师也很逆天\n\n但绝对没有这位反人类\n\n气死我了 进贵院真的会缩短寿命
183181,3724,刘飞,2023-11-22 14:13:56,0,0,0,呵呵呵
186685,3724,刘飞,2024-01-12 12:36:14,0,0,0,给分不好
193181,3724,刘飞,2024-06-04 08:12:04,1,1,0,期末周最后布置两个小组合作论文是真抽象，就这种实验课还值得我们专门写一次报告吗？？？纯纯形式主义乱七八糟不知所云
193584,3724,刘飞,2024-06-13 09:46:05,-3,0,3,精细农业真的没什么听的，要不以后改成录播课吧。\n\n不过两个作业都很简单，老师也教了，找几篇文献整合一下，或者找一些英文的翻译一下。哈哈
202116,3724,刘飞,2024-11-09 14:43:52,0,1,1,上课水水的，就当涨知识了，pre好好做给分不错！谢谢老师！
202193,3724,刘飞,2024-11-10 15:12:37,0,0,0,史中史
202814,3724,刘飞,2024-11-14 13:43:45,1,1,0,超级绩杀
203328,3724,刘飞,2024-11-19 07:27:05,0,0,0,给分随机 快跑吧第一门通识课在这里拿这么低绩点
125340,4030,费兰兰,2020-09-07 04:40:01,0,2,2,真的拉跨
192936,4030,费兰兰,2024-05-31 21:14:45,0,0,0,低能完了
73954,4057,傅迎春,2018-02-03 22:47:16,1,3,2,满分 老师很优秀 也很可爱
75664,4057,傅迎春,2018-03-15 02:28:56,-1,1,2,老师耐心且帅 给分应该还不错  科技论文写作认真学确实能学到不少论文规范
78332,4057,傅迎春,2018-05-11 02:44:30,2,4,2,老师不太喜欢点名，导致很多人没来听课，怎么说呢，老师人挺好，看得出来也很认真负责，为学生着想，但是课程本身实在有待加强
78382,4057,傅迎春,2018-05-11 08:05:43,0,3,3,年轻老师，这个课也很年轻。我觉得挺好的，老师讲了两个写论文常用的软件，挺实用。一次小组展示，一篇论文，上课还是挺轻松的。希望通过这种课变成论文大神也不太可能，但也会有一个大概的了解。好评！
135244,4057,傅迎春,2021-05-06 17:34:25,1,4,3,科技论文写作评分就不合理，两次作业就决定成绩，还都是小组一起的作业，小组队友随机分配，结果每个组人数还不一样，最终小组没互评，几个人一个分，随到小组队友贼躺;两次作业，任务都是靠展示，最后论文写作也就看个格式，论文本来是七个组互相审稿，结果竟然两两配对，结果第七组没有审稿对象，要求直接给老师，结果之后还要求提交一个审稿结果，搞毛啊，展示还要提别人组的问题，结果都没审稿对象，去哪拿结果;课无聊，就讲格式，不如自学
135250,4057,傅迎春,2021-05-07 00:17:01,2,3,1,课程无聊，不推荐选择，评分草率
163306,4057,傅迎春,2022-12-12 11:10:32,1,1,0,课程很无聊...作业还贼多。不如自学。
173572,4057,傅迎春,2023-05-29 07:53:58,0,0,0,好好好。
73425,4136,韦真博,2018-02-01 14:23:07,8,11,3,课很无趣，老师也很牵强地在上课
73428,4136,韦真博,2018-02-01 14:26:00,1,2,1,虽然成绩和自己也有关系。但是课是上的真的不好，交作业是照发邮箱，也没有反馈。感觉有点拎不零清。
87745,4136,韦真博,2018-10-11 07:21:16,0,1,1,不预习.真.一点听不懂
101079,4136,韦真博,2019-01-27 12:20:17,-4,3,7,趁还没出分来评论一下，老师讲课很认真，也很想同学们互动。对于同学特别关心，我一周前下课问了个问题，老师没时间回答，到第二周上课前专门来找我，帮我答疑解惑，必须给满分
119304,4136,韦真博,2019-11-12 03:49:32,1,2,1,搞个展示什么都不讲明白，要展示的前一天才说要求，??差劲?
120235,4136,韦真博,2019-11-24 13:22:00,3,4,1,上课无趣，总是让我们做些没意义的事，而且实验课占用我们私人时间上，加上给作业总是拖，害得我们都赶得很紧张！实验要求以及计算也没说清楚
133479,4136,韦真博,2021-03-01 05:41:06,-12,1,13,给分很好！
157631,4136,韦真博,2022-06-24 06:15:13,4,5,1,给分又差 讲课又拉 哈哈 一门课直接拉爆均绩
175078,4136,韦真博,2023-06-21 12:09:25,1,2,1,难顶噢不好评价了
175374,4136,韦真博,2023-06-24 10:02:39,1,2,1,恶心人
177079,4136,韦真博,2023-07-01 15:06:00,0,2,2,感觉老师给分变好了，好像没有之前说的那么糟糕
197106,4136,韦真博,2024-07-07 17:52:10,0,0,0,给分迷，垃圾不多说
81978,4187,王俊,2018-07-06 16:42:45,5,8,3,浙大原来有三个王俊...
111116,4187,王俊,2019-06-30 01:34:34,3,3,0,上课不给PPT，讲的内容都是十多年的旧东西，每次上课八点一打铃就拍照点名，给分巨低，刁难学生
125988,4187,王俊,2020-09-16 10:18:07,3,3,0,生工食品学院的sb代表（没人反对吧？）\n\n\n\n钉钉上课，迟到一节课，一句道歉都没有\n\n\n\n给分极差
163614,4187,王俊,2022-12-15 16:28:08,3,3,0,没开课先来骂贵院的sb一下，希望不要不识抬举
172541,4187,王俊,2023-04-29 09:27:07,6,7,1,sgsp最逆天的课之一，一学期五个ppt还闭卷考，逆天他妈给逆天开门，逆天到家了
174279,4187,王俊,2023-06-08 16:47:17,5,5,0,生工食品这个傻卵子学院最恶心人的一点是，他恶心了你还要教你写心得体悟夸夸他，我他妈夸你妈的，一天到晚心得，得你妈的，一群臭傻逼。
178032,4187,王俊,2023-07-06 10:59:47,5,5,0,具备了我院破课所有典型特征:\n\n事多，五个ppt，还鼓励多做，此其一。\n\n分烂，是真的很烂，此其二。\n\n什么都学不到，这没什么，我院的课就不可能学到东西，此其三。\n\n心得体会，一坨大便，此其四。\n\n爱点名，这也是我院风格，此其五。\n\n学弟学妹们自重。
178056,4187,王俊,2023-07-06 12:30:49,2,4,2,赶紧414
178101,4187,王俊,2023-07-07 02:42:05,3,4,1,分烂，但王俊的部分好歹还是能速成的，恶心的是王永维，鼓励多做的也是王永维，隔壁那个才是真傻逼
179291,4187,王俊,2023-09-07 12:54:47,-1,1,2,内容详实
197033,4187,王俊,2024-07-07 00:34:19,0,0,0,没挂哦耶
197064,4187,王俊,2024-07-07 04:34:37,1,1,0,上课不清，ppt又长又臭，考点不明，消息不看，还没王永w负责。每个点都故意提一嘴，还不告诉答案，美名其曰锻炼自学能力，师者所以传道授业解惑也，我要自学都会了还要你教啥？？？？
221008,4187,王俊,2025-06-20 16:06:04,0,0,0,期末不发ppt，还喜欢突脸学生\n\n十年前这门课还是开卷的\n\n怎么做到课程内容不变还越改越折磨人的
221477,4187,王俊,2025-06-28 06:46:47,0,0,0,课堂和ppt是学院通病
71899,4474,张云飞,2018-01-29 05:15:42,12,12,0,nmsl\n\n
74842,4474,张云飞,2018-03-06 05:45:23,3,5,2,6666
74885,4474,张云飞,2018-03-06 08:59:23,9,10,1,狗就一个字，我就说一次
90692,4474,张云飞,2018-11-25 09:19:58,11,11,0,是不是要换个地方骂zyf 了？
91728,4474,张云飞,2018-12-19 02:57:18,16,17,1,好评给一分
93920,4474,张云飞,2019-01-14 09:06:20,11,11,0,加大力度
98793,4474,张云飞,2019-01-24 02:42:38,10,10,0,nmsl
104592,4474,张云飞,2019-03-24 17:43:26,10,10,0,nmsl
104704,4474,张云飞,2019-03-26 08:11:56,10,10,0,一星好评?
105088,4474,张云飞,2019-04-03 11:30:19,9,9,0,nmsl
109146,4474,张云飞,2019-06-10 05:27:05,8,8,0,无fuck说…就是谁碰到谁倒霉
111245,4474,张云飞,2019-06-30 17:54:00,5,5,0,垃圾玩意
114699,4474,张云飞,2019-07-11 04:15:56,5,5,0,日常打卡1分
115506,4474,张云飞,2019-07-30 08:17:25,6,6,0,nmsl
116249,4474,张云飞,2019-09-06 14:09:06,3,3,0,1分好评
117443,4474,张云飞,2019-09-24 11:21:52,2,2,0,呵呵呵
117673,4474,张云飞,2019-09-28 16:04:14,2,2,0,喜欢名利
112444,4661,李莉,2019-07-04 07:52:16,-2,3,5,棒棒哒
112445,4661,李莉,2019-07-04 07:52:38,0,4,4,相当享受
112446,4661,李莉,2019-07-04 07:52:55,0,5,5,老师太nice了，尽可能得给高分，考试良心，太棒了！！
112475,4661,李莉,2019-07-04 10:38:03,-1,3,4,好好好
112951,4661,李莉,2019-07-05 15:10:46,-1,6,7,没有上过莉姐的课，但是作为班主任真的超级好
126507,4661,李莉,2020-09-29 01:06:13,-2,2,4,莉姐太好啦
143238,4661,李莉,2021-11-22 04:20:35,4,7,3,给分相当垃圾
160240,4661,李莉,2022-09-15 13:16:27,8,9,1,就想问为什么没有零分
167725,4661,李莉,2023-01-18 15:26:32,15,21,6,表面一套背地一套，对成绩好的学生态度跟其它一般的学生完全没法比，交流时言语里有一种莫名阴阳怪气的感觉
171079,4661,李莉,2023-03-15 14:07:31,9,9,0,两面派阴阳人罢了
182253,4661,李莉,2023-11-13 10:00:42,0,0,0,满分\n\n莉姐很豪爽，建议外专业的同学和食品专业的同学组队，有些东西还得是专业的人做得更好些
135076,4952,林涛,2021-04-29 07:43:29,7,9,2,呵呵 给分随机
151850,4952,林涛,2022-03-17 13:37:34,-15,4,19,很喜欢林老师课堂上生动的授课风格以及穿插自由互动的授课模式，虽然导论还没有结课，但是还是要给林老师点赞！
168385,4952,林涛,2023-02-15 08:42:51,12,16,4,接触过多次，个人观感不太好，感觉对自己比较自信且做事比较功利
171571,4952,林涛,2023-03-29 05:45:20,2,3,1,事是真多，
172089,4952,林涛,2023-04-19 07:10:50,5,6,1,太高傲了…成功人士的傲然，要求也挺离谱的。。。。别的专业跨专业选的快跑吧。。。
172899,4952,林涛,2023-05-09 12:53:27,-1,3,4,楼上的批评挺有道理。毕竟是一路读到底最后留校的老师，可能对本专业的认同感过强了。但同时跟着这样的老师还是能学到一些东西的。
134858,5301,刘德钊,2021-04-19 08:06:34,2,6,4,基本全在念屁屁涕
198702,5301,刘德钊,2024-09-11 03:57:00,2,2,0,讲解清晰，挺负责的老师
163307,5342,平建峰,2022-12-12 11:12:52,4,5,1,读PPT...浪费时间
168391,5342,平建峰,2023-02-25 07:09:33,4,4,0,照着PPT还能念错，不知道在讲什么东西\n\n还一副黑脸，跟谁欠他一样
160777,5802,谢丽娟,2022-10-11 04:03:36,5,6,1,有点无语
161533,5802,谢丽娟,2022-11-08 08:53:20,14,16,2,不想上课可以不上。上课上到一半非要同学来讲，怎么你的工资也要分我们一半嘛？话都说不利索，到底怎么当上老师的
162049,5802,谢丽娟,2022-11-16 09:23:06,2,2,0,讲课不认真啊
166915,5802,谢丽娟,2023-01-14 08:12:13,9,11,2,学弟学妹们如果发现谢老师上课比较“消极”，千万要冷静，因为她上的一般不是考试重点，人去了签个到就行，听不听都一样的。\n\n当然具体怎么个“消极”，我希望同学们务必亲自体验一把，确实是比较令人大跌眼镜的。
167024,5802,谢丽娟,2023-01-14 15:52:49,-3,0,3,一般般。
168389,5802,谢丽娟,2023-02-25 07:08:54,8,10,2,这老师RP有点问题\n\n对自己的学生尖嘴PUA
168505,5802,谢丽娟,2023-02-19 04:11:41,-8,0,8,不错的
181600,5802,谢丽娟,2023-10-24 03:14:23,3,3,0,依托答辩
181601,5802,谢丽娟,2023-10-24 03:19:03,8,8,0,好评如潮，好老师，幽默风趣，可惜没有0分，否则我会给个0分的。贵院真乃神院，多个小丑粉墨登场，逗得人捧腹大笑！
181602,5802,谢丽娟,2023-10-24 03:27:55,3,3,0,不想上课你就辞职啊
165293,5804,林星宇,2022-12-31 06:06:18,8,9,1,家里似乎有很多小孩😅😅😅
165473,5804,林星宇,2023-01-06 17:26:30,1,3,2,还可以，新老师还需多多磨炼（
167000,5804,林星宇,2023-01-14 14:09:18,4,6,2,只能说他绩点是真的给的低，我也不想说啥了，感觉讲课也不是很清楚，虽然可能也怪自己没有好好学
167001,5804,林星宇,2023-01-15 02:43:05,5,13,8,给分低+上课不清楚+小测麻烦（就只有周六的一小撮时间测……\n\n让我印象深刻的是考完后群里发菜菜捞捞的图时，他问，“这图是什么意思”\n\nemmm
167003,5804,林星宇,2023-01-14 14:38:12,5,6,1,能选其他分高的老师尽量还是选其他老师吧，，，只能说林老师确实还需要锻炼，上课讲得不是太清楚，给分不太好或许说太求是？
167087,5804,林星宇,2023-01-15 02:30:28,7,8,1,选的不是这个老师的课，被调了过来，上课无聊没有重点，小测逼事贼多，开放时间短，给分差，喜提人生新低，只能说快跑。
167108,5804,林星宇,2023-01-15 03:39:50,-18,7,25,讲的还清楚的，可能有一些部分认为我们在普通化学里学过会讲的比较快（我一开始以为是这个老师的问题，后来用智云去听了一下别的老师的课发现大家都差不多...）我只靠上课+看书，认真完成作业，然后期末复习的时候半开卷考试记满A4纸，最后绩点4.5☺️
167209,5804,林星宇,2023-01-15 05:45:17,4,5,1,给分是真低，上课也上不清楚，直接给我整个历史新低
168904,5804,林星宇,2023-02-23 10:22:22,0,1,1,给分太低了！！！每周六有小测雾
173360,5804,林星宇,2023-05-21 07:16:01,2,2,0,没拿到绩点但是先来吐槽，讲课真的很不清楚。。。。。。。。崩溃了。。。。。。。已在看别的老师的智云了
176945,5804,林星宇,2023-07-01 00:09:51,7,7,0,上课不清楚，给分很差，避雷
177087,5804,林星宇,2023-07-01 15:18:46,0,0,0,给分低
177261,5804,林星宇,2023-07-02 12:54:22,-1,0,1,这次给分还可以，讲课是用心的，虽然可能不太会讲，但总体还好
177594,5804,林星宇,2023-07-04 01:36:11,1,1,0,给分中规中矩，不太会讲课。
179346,5804,林星宇,2023-09-12 08:39:22,0,0,0,^_^
193562,5804,林星宇,2024-06-13 05:12:19,1,1,0,垃圾 屎
194244,5804,林星宇,2024-06-23 01:15:23,1,1,0,无须多言
196484,5804,林星宇,2024-07-03 17:15:46,3,3,0,。给分差的要命 滚吧
196542,5804,林星宇,2024-07-04 06:11:41,3,8,5,水课，适合作为跨专业，事少，我4.8
196612,5804,林星宇,2024-07-04 09:12:38,1,2,1,要是选了林老师的分析化学就润了吧，上了包哭的
218228,5804,林星宇,2025-04-22 06:33:14,1,1,0,讲的一坨狗屎，“这个我们就不讲了啊，比较重要，大家自己下去要看一看”，刚上课跳一堆，那你讲了个寂寞。。。
141761,5848,郭鸣鸣,2021-11-11 13:36:06,31,33,2,自己英语讲的那么烂，也好意思要求我们用英文作答，有本事你纯英文授课呀？你配当老师吗？学弟学妹们，赶紧逃离食品！快！逃！
142304,5848,郭鸣鸣,2021-11-19 09:53:33,53,55,2,给分什么垃圾？舔老师分就高笑死我了😅
142309,5848,郭鸣鸣,2021-11-10 05:20:26,19,20,1,学弟学妹可以看看前一届的智云课堂感受一下老师给人的震撼【微笑脸】🙂
142318,5848,郭鸣鸣,2021-11-10 06:53:52,24,26,2,全英文课件上课只会照着念一遍，考试中文答题倒扣分，有时常常会让我有身在异国他乡的错觉😊
142332,5848,郭鸣鸣,2021-11-10 08:46:58,22,23,1,这种课搞双语我认了，考试用中文回答还会扣分？上课只会念一遍ppt再翻译一遍，有些单词自己都不认识。说好了发言加分，结果在座位上答下话都算？垃圾课程内容加上奇葩老师属实是A-专业的特色，能逃离食品这个坑就快逃吧
142376,5848,郭鸣鸣,2021-11-10 16:44:12,38,39,1,此前，我仍然对每一个老师，至少是浙大的老师，持有最低的乃至一丝期望。\n\n至少是在取得与努力不成正比之后的成绩，或者是日复一日机械般没有光明的重复记忆，我仍持最低的标准去期待我们专业（一个所谓充满未来的专业）能带给我的一丝惊喜。\n\n就像是撕开被暗黑笼罩的阴霾，当经历了各种课程的摧残，发现等待着的还是不堪。新老师，第一次授课，我本以为会不落窠臼，能给我印象中的食品专业带来新鲜的血液，去重新审视我周遭的环境。\n\n我不知道也不理解这门课程的安排与设置，急急忙忙的授课却搭配不相干的引言。我不能认可在考前三周设置的论文字数，我更不能认可老师的出尔反尔，甚至是在考前三天才通知的中文作答扣分。\n\n一门课的好坏不止或不在于这门课程能教予我们的知识，而在于对我们能力的提升。而食品专业的专业课大多数是对能力没有提升的，机械的实验报告，不知所谓的课程论文……但仍有些老师或课程是能给我们启发的（如工程力学）。\n\n我不知道评价一个老师好坏的标准是什么，是按时完成课程教学目标还是同学们的积极性？我想未必，但带给学生（大多数）的只有对这门课的厌恶或不满，如此的老师必定不是一位好老师。\n\n另外，专业课不用正态，不必糊弄我们。前方黑暗，深陷泥泞，\n\n我仍尽力在破乱中找寻归途。
145207,5848,郭鸣鸣,2021-12-28 08:04:41,14,14,0,不知所云，只会念PPT，没啥真本事。。\n\n学弟学妹们慎重选择
145326,5848,郭鸣鸣,2021-12-29 04:54:10,10,10,0,没啥东西，就会读ppt
145327,5848,郭鸣鸣,2021-12-29 05:48:32,8,8,0,慎重选择
150539,5848,郭鸣鸣,2022-01-29 14:17:47,9,9,0,郭鸣鸣？\n\n郭÷！
154014,5848,郭鸣鸣,2022-05-19 06:19:10,7,8,1,呵呵呵
161195,5848,郭鸣鸣,2022-10-31 14:06:29,-13,2,15,老师人很好
161745,5848,郭鸣鸣,2022-11-12 02:37:46,7,7,0,她读ppt连人工智能都甘拜下风
161752,5848,郭鸣鸣,2022-11-12 07:22:58,7,7,0,什么郭触？不给PPT，上课微笑杀手，你青椒压力大在课堂上面晕倒我还同情你呢，想不到你转接压力的方式是把压力转接给你的学生是吧，郭触？没啥水平，不该去反省为啥和你同龄的女老师已经升教授了，你还搁这整天感动自己恶心学生吗？
162220,5848,郭鸣鸣,2022-11-18 02:10:39,10,10,0,她读PPT不如人工智能读PPT，绝了
162225,5848,郭鸣鸣,2022-11-18 02:50:41,7,7,0,呵呵呵
162293,5848,郭鸣鸣,2022-11-19 09:06:19,-12,1,13,郭老师其实蛮认真的，但奈何教学能力确实有限，可惜可惜
162323,5848,郭鸣鸣,2022-11-21 15:48:17,16,16,0,亲眼看着老师在离我不到五米的地方从讲台晕倒昏迷的时候，我知道她是一个好的科研工作者。\n\n但一个好的科研工作者一定是一个好的老师吗？\n\n我一时间不知道该怎么评价，没有任何逻辑的ppt，且首页的目录很多提到要讲的东西ppt上根本没有。\n\n最关键的是老师居然在考试前两天的时候出尔反尔，从一开始反复强调的只出英文名词解释到还有英文填空题，我并不反对一门双语授课的专业课关于英文的考核形式，但是作为一个留学几年的老师，英文水平真的过关吗，上课的英文大多是机械地念着思维跳跃性极强的ppt，且不说重音发不到点子上的“乡土英文”，甚至还会喊学生起来读ppt，拜托，老师这一点也不酷好吗，我小学展示的时候都知道不要让你的同学尴尬地起来读ppt了，课上的真的很屎好吗。当然我觉得这也是合情合理的，有着多重身份的老师当然要选择好把重心放在教学上还是自己的科研上。但是最重要的是一门课程最起码要让同学们学到知识，而不是让同学们在复习的时候感受到极度的痛苦和对这个专业的厌恶。虽然最后拿到的分数让我还是比较满意的，但是我觉得老师真的该好好想想如何改进这门课的考核方式，好好想想怎么修改自己牛头硬安马嘴的ppt和考虑要不要上课还是用大家都懂的纯正国语来念ppt吧
164702,5848,郭鸣鸣,2022-12-23 13:35:31,8,8,0,求求您别祸害食品的可怜孩子们了，忍受了一整个短学期的蹩脚英文，还要忍受不知所云的试卷和莫名其妙的给分机制
182182,5848,郭鸣鸣,2023-11-11 15:58:32,6,7,1,好好好，ppt读的好
182186,5848,郭鸣鸣,2023-11-12 01:44:33,4,7,3,一如既往的烂，新疆二本的塔里木大学过来的交换生同学都觉得她课讲得烂
183683,5848,郭鸣鸣,2023-11-28 12:34:26,-5,0,5,老师讲的一般般，但是狠狠捞了我，很感激
189655,5848,郭鸣鸣,2024-01-26 09:40:26,4,4,0,纯SB
192447,5848,郭鸣鸣,2024-05-20 07:26:29,8,8,0,“我觉得上课还聊微信的同学不应该坐在教室里”\n\n“下面是谁在用鼠标啊 真的很影响我上课”\n\nwflbb这里是大学
199514,5848,郭鸣鸣,2024-09-25 01:27:41,12,12,0,纯傻逼老师，先不讨论口音的问题，你就不能要么用英文要么用中文讲课嘛，讲的不英不中；\n\n从头到尾都是读ppt，显而易见几乎没有备课；\n\n不允许学生用鼠标，说吵到她了，我只能呵呵呵呵呵呵呵，不好意思你的讲课真的吵到我认真学习PPT了呢；\n\n叫学生起来回答问题，我搞不懂你tm到底是提问还是训话，这种老师是怎么混成浙大的老师的；\n\n这种老师竟然还能有研究生招生指标，我只能说，来一个劝走一个，凭借一己之力拉低全社会对浙大食品的印象
199515,5848,郭鸣鸣,2024-09-25 01:29:18,3,3,0,逆天，太逆天了
199517,5848,郭鸣鸣,2024-09-25 01:50:18,8,8,0,2024年9月25日早九点，郭➗，我操你妈
199746,5848,郭鸣鸣,2024-09-29 01:17:25,3,3,0,还搞上辩论了呵呵
199747,5848,郭鸣鸣,2024-09-29 01:26:07,3,3,0,适当提问活跃课堂氛围，过分提问拖慢教学进度，影响学生上课思路，容易胆战心惊。
199748,5848,郭鸣鸣,2024-09-29 01:35:51,6,7,1,喜欢提问？一节课跟玩牛魔酬宾弹弹堂一样左右连坐，烦死了一节课屁用没有让你跌早八过来听称冯真的是死了，要我说什么最该冷冻就是你这张β嘴
201335,5848,郭鸣鸣,2024-11-01 01:30:31,1,2,1,今天之后，希望考试之后也能说我太爱你了
201510,5848,郭鸣鸣,2024-11-04 05:36:50,4,4,0,写评语的时候看到背景“听gmm老师的课是怎么的体验”真的笑出了声\n\n塑料口语，中文夹杂英文\n\n私人恩怨课上报复训话\n\n全场提问，颇有大清洗的感觉\n\n自己声音微弱，还要我们大声回答\n\n有没有念PPT我也不清楚了，一开始就不想听\n\n考试名词解释和填空还要英文回答\n\n鼠标也是历史遗留问题，还要下场找鼠标\n\n被调休搞晕，直接少讲一章\n\n知道自己挖的坑多了，期末就透一下题，少考一点没讲的来挽回一下风评。但是在我看来，就算是有一个好的成绩，也不影响我对gmm打低分。每次看到PPT首页的Ph.D就觉得讽刺无比
201572,5848,郭鸣鸣,2024-11-04 11:55:42,3,3,0,复习过程中终于把一门课程的知识点串联起来，最后给到自己关于这门专业课的一个结论是它把关于食品本身的化学、微生物学、毒理以及营养等内容和食品加工和贮藏相关的装备工艺相结合，是本专业内容之间建立联系的过程。\n\n但是回到上课的课堂上，上课内容枯燥，讲课形式无聊（几乎全都在照着ppt读而且口音害，），课堂交流生硬甚至很多时候非常逆天，而最后用十分低级的方法仿佛在“试图挽回风评”。。我觉得老师的问题蛮大的。
203278,5848,郭鸣鸣,2024-11-18 18:46:16,1,1,0,逆天老师\n\n不多说\n\n其实只听最后一节课就好，其他都是依托
217404,5848,郭鸣鸣,2025-04-09 16:12:09,0,0,0,为什么这种老师都能过考核？PUA学生，不让学生毕业。非升即走怎么不走啊我去。。垃圾老师，千万别去她组里！
168390,5862,周振江,2023-02-15 08:58:37,13,17,4,看得出来很热爱生活\n\n对学生也还不错\n\n生工食品一股清流了
214985,5862,周振江,2025-02-19 17:27:28,2,2,0,上课很认真，讲课有内容\n\n很亲切的老师，无条件从你的回答里找对的部分肯定并鼓励，是不坐前面会担心他伤心的类型（虽然我还是往后坐🥹）\n\n事少分高🥰
123975,5888,张玺铭,2020-06-18 10:49:28,1,11,10,生物质能源与可持续利用。这门课的四个老师上课都非常用心，能够学到很多，知识。就是事情会比较多，每节课都会有作业，最后还有3000字论文。认真对待绩点不会低！
134567,5888,张玺铭,2021-04-02 00:55:19,-1,3,4,知识量很大，作业很多
182366,5888,张玺铭,2023-11-15 07:27:28,0,0,0,老师真的很好，每节课的作业其实 ppt 里都可以找到答案，不用考式期末只需要写一篇论文就可以了
182966,5888,张玺铭,2023-11-21 08:56:33,1,2,1,这门课平时作业只要抄PPT的内容，我自己会习惯再多扯两句。然后就是课程论文，字数确实有点多，对大一新生来说有点点难。但是按我自己的体验只要认真水完就有很高的得分（我自己拿到了人生中第一门满绩，超开心的）。老师很幽默，不过就是上课有时会有点困，我一般都是看回放三倍速的，大家可以自己衡量一下哈
183036,5888,张玺铭,2023-11-21 16:25:54,0,0,0,张老师讲课可能不会特别吸引大家的注意力，但是老师上课非常认真负责！感冒了嗓子不舒服还一直坚持讲课。写论文查资料比较花费时间，不过上课的时候可以稍微水一点～每周都有作业，课程论文的任务也还是比较重。文科生最后拿了4.8心满意足了
183041,5888,张玺铭,2023-11-21 16:54:31,0,0,0,是有点小有趣的老师喔～作为一个高中不选生物从文选手，感觉上课是有点枯燥的，但老师给分可太好了！！！前提是平时作业和结课论文得认真写（无pre）
183459,5888,张玺铭,2023-11-26 12:29:05,1,1,0,不点名+作业简单+给分高，直接拉满
191968,5888,张玺铭,2024-05-06 12:39:17,3,3,0,张老师是个很热情的老师，后期课程论文没有思路可以和他交流。真的相当nice。\n\n每周都有作业，但是作业简单，可以从ppt中抄。\n\n总之，这门课程是给分真的很好！！！！
203155,5888,张玺铭,2024-11-17 12:37:22,-1,0,1,生物质能那门课分低
204677,5888,张玺铭,2024-11-27 09:46:31,0,0,0,文科生慎选吧，期末论文挺重要的，决定了绩点。看均绩意义不大，对社科或人文的来说。
205773,5888,张玺铭,2024-12-12 03:20:43,0,0,0,生物质，期末论文占比很大。老师应该比较喜欢科学研究类的论文，但是文科生真的看不懂那些化学方程式啥的，最后写了几千字的政策分析💔 绩点不高不低吧只能说
210453,5888,张玺铭,2025-01-09 07:49:47,1,1,0,可再生能源甚至不愿意出作业题
122208,5898,林宏建,2020-02-20 03:48:05,3,6,3,老师讲课风度翩翩，很棒！ppt讲到重要的地方会提醒我们拍下来，因为作业要用到，真的很贴心！
122251,5898,林宏建,2020-02-21 04:40:40,1,3,2,老师上课很用心，非常重视学生的意见，选修课内容也上的很有深度，积极引导学生思考。课程论文用心写分数不会差
122821,5898,林宏建,2020-04-11 02:09:21,3,9,6,老师超棒的，有个问题不懂线上问了他，他马上打电话告诉我。上课重点也突出，不紧不慢，很棒
124495,5898,林宏建,2020-07-02 03:37:02,4,6,2,老师好棒！感觉学识炒鸡丰富，上课视频什么的补充资料也很多，也非常积级和同学们互动 _(:з」∠)_\n\n绩点的话差不多就好，班级里神仙太多了😂
132076,5898,林宏建,2021-01-30 06:17:56,-16,6,22,有一说一给分真的垃圾 事情多作业多 明明都认真做了 论文也完成了给了个这么差的分
168386,5898,林宏建,2023-02-15 08:44:56,0,1,1,林老师是个用心负责的好老师
179133,5898,林宏建,2023-08-28 08:38:48,2,2,0,是班主任，很认真负责
181215,5898,林宏建,2023-10-12 00:56:01,6,7,1,生工食品为数不多的几个正常老师了
181782,5898,林宏建,2023-10-31 12:28:50,0,4,4,上课上的不怎么样，一直传话筒提问，下课了还到处看学生电脑在干什么，大学老师这样有点无语的…还说论文每天写一两百字，写论文不用讲究思路完整性的吗？？？
182968,5898,林宏建,2023-11-21 08:51:27,-3,1,4,这门课平时作业只要抄PPT的内容，我自己会习惯再多扯两句。然后就是课程论文，字数确实有点多，对大一新生来说有点点难。但是按我自己的体验只要认真水完就有很高的得分（我自己拿到了人生中第一门满绩，超开心的）。而且老师超可爱，有一次上课说：“我看你们都抱着电脑，能一边做作业一边听课也不容易。”下课后又说：“让我来看看你们上课都在干嘛？”实际上过了很久等我们都准备好了才下来转一圈（亏的我准备得如此充分，也没太大用处），总之人很可爱。最后，论文就是按他的要求一天两三百字，挺容易的，构思好框架后写起来很轻松的。
183037,5898,林宏建,2023-11-21 16:28:07,1,1,0,林老师上课很积极，希望我们能更加认真听讲，于是可能就会请一些同学起来回答问题。但是如果愿意主动站起来回答问题的话，老师会很开心，会来主动指导一下课程论文，非常负责。
183040,5898,林宏建,2023-11-21 16:50:10,0,2,2,很耐心负责的老师～没有赶过这门课的ddl，平时作业基本布置后三天内就上交，论文认真写了（可能角度选得比较独特，没有跟别人撞选题，但格式其实是乱套的）高中不选生物，生物知识储备极差，不影响这门课程的学习，感谢老师助我人生第一个满绩！！！
190313,5898,林宏建,2024-02-28 02:11:12,5,7,2,很认真负责的一个老师，跟随林老师进行了工程力学的学习，上课彬彬有礼，对待同学的态度也是很温和的。课后曾经为了解答我的一个疑惑探讨了将近两个小时，让我在大学感受到了老师的温暖。最终平时分满分，期末卷面96也是很满意的
203157,5898,林宏建,2024-11-17 12:39:07,1,1,0,不想说
205286,5898,林宏建,2024-12-04 02:06:52,4,5,1,上的是工力课，只能说上课就是念ppt然后点人回答问题，课上的一坨还一定要听因为要随机点人回答问题
205324,5898,林宏建,2024-12-04 13:48:33,1,1,0,题目讲比较细，上课会提问
213731,5898,林宏建,2025-01-19 10:27:43,1,1,0,难评……
213737,5898,林宏建,2025-01-19 11:15:26,1,1,0,工程力学，上课纯念PPT且有备课不充分以至错漏嫌疑。
213949,5898,林宏建,2025-01-22 03:31:38,0,0,0,工程力学，老师有点人机，但是给分非常好，上课会点人回答问题，但是如果每天坐最后一排就不会被点到。从材料力学开始没学过，是可以补天速成的一门课。上课感受很拉跨，考试感受还行。
214107,5898,林宏建,2025-01-24 09:18:42,0,0,0,上课纯念ppt，作业没有明确的评分标准，给分一般\n\n上课可以做自己的事情，有随机点名提问，无发言加分
185700,5917,钱湘群,2024-01-03 15:37:19,1,1,0,好老师，很温和，愿意帮助学生
160281,5954,王一娴,2022-09-16 10:43:15,0,4,4,超级好的老师！！！\n\n很耐心，很喜欢和本科生相处\n\n必须满分！
160282,5954,王一娴,2022-09-16 10:43:41,0,3,3,是新生之友，人真的很好啊！！！\n\n有耐心，跟我们分享各种经验\n\n带我们参观实验室\n\n实干又有效率，真的很nice\n\n还请吃饭不能再好了😍😍😍
160295,5954,王一娴,2022-09-17 10:52:07,0,2,2,新生之友的最佳人选！耐心专业高效率好相处，榜样作用明显^_^
124266,6091,刘羽飞,2020-06-28 07:34:41,5,11,6,给分差
141748,6091,刘羽飞,2021-10-24 11:44:31,1,4,3,讲课生动
144231,6091,刘羽飞,2021-12-21 00:56:14,0,4,4,老师人超好！贼可爱！也在尽力把专业知识讲得很生动！
161927,6091,刘羽飞,2022-11-15 05:33:39,0,2,2,几乎没怎么听课 pre好好做就能拿不错的分
163606,6091,刘羽飞,2022-12-15 13:57:00,0,2,2,给分一般，课还不错。
164493,6091,刘羽飞,2022-12-21 08:44:43,1,2,1,偶尔点名，上课可以一直水，只要做好最终的pre就行，想摸鱼的可以来
182185,6091,刘羽飞,2023-11-12 00:17:34,4,4,0,上课上的跟shit一样，ppt自己都不懂，上课只会重复pid是什么
182874,6091,刘羽飞,2023-11-21 02:01:02,2,2,0,shit shit shit
182891,6091,刘羽飞,2023-11-21 03:43:00,8,8,0,上课质量不高，念ppt，没有公式推导，但会透露考点，每节课开头提问。\n\n老师第一次上课可能也还没学透，推荐跟着b站学，考前把ppt和作业过一遍。\n\n考试占比80%，平时签到和作业一定要交。考试题型变了，选择，填空，判断，大题。\n\n大题有一大半没做，本来以为只考了60多，居然被捞到了80多，平时分感觉拉满了。\n\n一定要早点复习，别和我一样考前两天刷夜速成呜呜，等成绩太煎熬了o(╥﹏╥)o
182959,6091,刘羽飞,2023-11-21 08:23:38,-2,1,3,给分挺好的
182976,6091,刘羽飞,2023-11-21 09:26:31,4,4,0,给分好差😦
183262,6091,刘羽飞,2023-11-23 08:47:25,1,3,2,智慧农业，真的水，但是老师偶尔会点人起来回答问题，最后只有一个pre好好做还是可以拿不错的分数的
186173,6091,刘羽飞,2024-01-09 07:19:28,2,3,1,老师人是很好的，就是自动控制理论课讲的真的不太行，不知所云，感觉ppt下一页在讲啥都不知道。推荐自学。老师考试内容侧重点也非常不均匀，前面一个大章的内容花了很多时间复习，一点没考。最后一节课随便讲讲的最后一章考了将近30分，感觉很不合理。\n\n省流：考试很重要，推荐从一开始就b站自学，然后考前刷一遍ppt，因为有填空，ppt上例题其实好像也没那么重要，因为题型多变，多跟b站刷题吧。
190664,6091,刘羽飞,2024-03-14 00:35:03,0,0,0,上课进度龟速，老师看起来也不懂，只会重复结论完全没有推导过程，在线求b站自学网课
191334,6091,刘羽飞,2024-04-18 01:04:04,1,1,0,所以第六章要学什么啊😯
199562,6091,刘羽飞,2024-09-25 11:11:39,1,1,0,智慧农业\n\n课中评论\n\n老师人很温柔 感觉人很好\n\n可惜大部分人（包括我）没听课\n\n感觉课程没什么重点  就是听听农业现代化智慧化  涨涨知识
202115,6091,刘羽飞,2024-11-09 14:43:29,0,1,1,上课水水的，就当涨知识了，pre好好做给分不错！谢谢老师！
202194,6091,刘羽飞,2024-11-10 15:11:57,1,1,0,真的难评
202815,6091,刘羽飞,2024-11-14 13:45:18,1,1,0,超级绩杀
218457,6091,刘羽飞,2025-04-23 16:53:27,0,0,0,智慧农业很认真的做的pre，结果被重创，连班级的均集都没有，很难评的老师
220466,6091,刘羽飞,2025-06-18 05:00:59,0,0,0,上课emm就那样，但是自控考试是真不难，好好复习就能高分过
193638,6243,赵建,2024-06-14 07:41:35,0,1,1,很有意思的老师
206357,6243,赵建,2024-12-14 13:20:36,3,3,0,生工食品第一帅
219379,6243,赵建,2025-05-26 07:04:44,0,0,0,生工食品第一帅
138543,6290,徐恩波,2021-07-09 16:31:51,2,7,5,上课前老师都会播乳制品工艺相关的影片，理论实验课都上的很有趣，助教也很好！
193470,6290,徐恩波,2024-06-11 08:21:37,0,0,0,老师很好
220343,6290,徐恩波,2025-06-17 10:54:56,2,2,0,特别喜欢划重点然后考重点之外的内容，分数也是不捞的，工科的课考试全是默写，上课也学不到啥东西，想水跨专业学分可以选
220487,6290,徐恩波,2025-06-18 08:05:05,0,0,0,支持楼上，内容没什么意义，科普性质，要背很多东西。不知道学这些有什么意义，以后写公众号去科普吗？分数也是不捞的。实验课就是做做吃的，感官评价一下。内容是水的，分数是不高的。完全不懂食品的这些老师到底想培养什么样的人才。感觉食品就是考公水货的聚集地。ps:徐老师在学院里面也是蛮厉害的哈~我真是呵呵
162006,6397,李阳,2022-11-16 02:37:12,0,0,0,慈祥，事少
176239,6397,李阳,2023-06-28 06:48:38,0,0,0,人好事少，很亲和！
221456,6397,李阳,2025-06-23 17:51:47,0,0,0,好老师，乐意帮助学生
200706,6739,吴斌鑫,2024-10-21 07:26:08,8,8,0,老师：hunting的时候如果野鸭landing了就不能shooting了~
163157,6801,徐文道,2022-12-08 08:46:54,2,2,0,会打篮球
164414,6801,徐文道,2022-12-21 02:06:16,0,0,0,很好的班主任
207409,6839,程焕,2024-12-21 10:33:23,0,0,0,太优秀的老师！
198162,7030,杜冬冬,2024-09-03 08:59:44,0,0,0,科研一坨
212986,7030,杜冬冬,2025-01-15 12:08:23,0,0,0,最后一节课划的重点基本不是考试得分重点
139951,7036,王校帅,2021-08-22 12:29:35,7,9,2,太棒了
139952,7036,王校帅,2021-08-22 12:29:07,6,7,1,王老师和蔼可亲，排球贼好
139953,7036,王校帅,2021-08-22 12:29:10,6,7,1,太棒了
199541,7036,王校帅,2024-09-25 05:50:58,3,4,1,作为第一届食品工程原理授课改革（原由韦真博老师一人进行教学，现前两章节由王老师教授）的学生，不得不说一句老师很认真，对于知识的教学很负责任，且态度诚恳，经常问我们这些同学有没有听明白。点名方式是点同学回答问题，不过也都是一些简单的知识类问题，不会恶意给学生难度。课程结束出分后遇见老师，老师还很关心的问了我的成绩。总之，确实是目前专业课遇到的少见和善、认真的老师。也希望老师也始终如初，有更多的生食学子能感受到您的温柔和风趣~
190691,7468,赵敏洁,2024-03-14 14:03:27,7,7,0,赵老师是个非常非常好的老师！！！为人和善，体贴学生。
192218,7468,赵敏洁,2024-05-12 10:51:13,3,3,0,老师超级好，虽然人少但是讲课非常仔细，给分也很好
194038,7468,赵敏洁,2024-06-21 14:00:47,2,2,0,虽然只有几个人选这门课，但还是讲的挺认真，考试前会发一份整理的资料，连一节理论课都没上过的同学也给了2.4，能捞人。
199061,7468,赵敏洁,2024-09-14 13:59:27,1,1,0,赵老师对人可好了，平易近人，尊重学生，并且专业基础知识十分扎实
153838,7627,徐艳群,2022-05-13 00:10:17,1,2,1,这老师上课把自己的实验数据给学生处理，丢一大堆作业，完事还不讨好，不要选不要选...
201010,7627,徐艳群,2024-10-26 15:49:35,0,0,0,s        a
126300,7672,张鑫,2020-09-22 04:05:55,6,6,0,老师很棒的！！！\n\n讲课贼清晰！！！\n\n而且和我同名！！！
195689,7847,SONGMING ZHU,2024-06-29 15:08:29,0,0,0,每节课都点名，课没怎么听，复习看ppt就行，但没有郭一样的逆天发言。
168711,7857,鲜于运雷,2023-02-21 09:26:12,-1,6,7,周六晚上开组会的神仙导师？
190307,7900,Binxin Wu,2024-02-28 00:31:00,0,0,0,(〃ﾉωﾉ)
133925,8780,丁冠中,2021-03-09 15:27:33,0,0,0,真正的教育家
174083,8916,肖航,2023-06-06 06:21:34,5,6,1,适合教高中，抓纪律
218794,8916,肖航,2025-05-06 03:22:06,3,3,0,哈哈我最讨厌的学院老师
219484,8916,肖航,2025-05-28 09:39:52,3,3,0,。。。
220042,8916,肖航,2025-06-14 04:13:40,3,3,0,“你不想听课你就get OUT”
220619,8916,肖航,2025-06-19 02:51:53,2,2,0,get out!
220661,8916,肖航,2025-06-19 05:58:11,1,1,0,见过最恶心的老师，上课态度极其糟糕，不评价其研究能力，但他上的课纯纯让人作呕
162727,9131,周鸣川,2022-12-05 09:11:40,19,19,0,什么鲨吊老师，不讲经济基础讲上层建筑，自己讲不好怪同学没人听，都不好好反思一下。
164821,9131,周鸣川,2023-01-14 13:12:36,35,40,5,我真傻，真的！我单知道毛巾学院的老贵物多，可怜的孩子们被他们玩弄得苟延残喘；我不知道新来的也会是如此。我一清早起来就去上了课，打开我的Matlab R2021a，可它说这样不行，这个太新了，我们得用旧的。它是很温柔细又腻的，点名报菜名时从不含糊，形式百花齐放，根本没有创新瓶颈！它真的很懂机器人与控制，所以我们一定也很懂！天呐，我们毛巾学子多么博学！控制、CS、EE、机械，甚至是GIS、化学、生物，全都臣服在我们脚下；地啊！我们毛巾学子多么坚韧！8页？8000！展示？漫画！一次？好多次！发烧？湿毛巾！完成任务的喜悦简直时刻洋溢在我们的脸上！\n\n有这样一位充满着毛巾文化自信和讲课站位高度的年轻毛巾的加入，毛巾学院一定能抗住外界的各种纷扰坚守初心不动摇！\n\n-----\n\n[res，zmc_handle] = vrep.simxGetObjectHandle(clientID，'/path/to/zmc'，vrep.simx_opmode_blocking);\n\n[res，My_handle] = vrep.simxGetObjectHandle(clientID，'/path/to/me'，vrep.simx_opmode_blocking);\n\n[res，zmc_parent_handle] = vrep.simxGetObjectParen(clientID，zmc_handle，vrep.simx_opmode_blocking);\n\nzmc_parent_handle == My_handle\n\n\n\n>> logical\n\n\n\n>> 1\n\n-----\n\n不是我他妈日你妈啊，我真的破防了。都做到最后了发现尺寸对不上，我一问别人才知道你在第二个班说了这件事，还发了一些指导。然后第一个班捏？？？铃木错捏拿钙臂给告堪欸，你知不知道你有几个班级啊？
166078,9131,周鸣川,2023-01-11 04:50:06,13,14,1,6666666666666666
166168,9131,周鸣川,2023-01-11 09:01:56,-5,4,9,老师很年轻，和大家看上去没什么代沟。看得出来很想教会大家，但求求别用一种像是教宝宝的感觉，讲一点点就点个人上去写，六个课时上人工智能，不如其他工科学院一个课时讲的内容多……希望老师认识到，好老师不需要点名同学们也会足够认真听课，不行的老师就算次次点名签到查人，同学也是逢场作戏没人听……加油川川！
166241,9131,周鸣川,2023-01-13 08:23:52,18,18,0,水平还是挺高的，但人品不行，喜欢点名，叫人回答问题。毛巾学院风格，薪火相传，一脉相承，农工学子忍忍就过去了，毕业跑路就不用被这sb学院折磨了。\n\n----------------\n\n期末考完了。wqnmd，计算题忘给图表，我tm考场上回忆了20分钟ppt上的图。实验完全靠自学，上课一看就没备课。\n\n---------------\n\n考完了还得做他的机械手实验，wcnmdgb，PPT直接照搬博客，上课算DH参数算了一节课，完全靠自学，V-REP网上资料少的一批，贵院迟早要完，农工学子赶紧跑路，别在sb学院浪费青春！！！！
166349,9131,周鸣川,2023-01-12 04:41:43,-17,4,21,不错的呀 大家是不是黑错人了
166504,9131,周鸣川,2023-01-12 12:33:08,8,8,0,呃呃呃懂得都懂
166519,9131,周鸣川,2023-01-12 14:46:13,11,11,0,依托答辩，实验完全靠自己，指导书就是给你指向错误的方向
166791,9131,周鸣川,2023-01-13 15:02:19,8,8,0,懂的都懂
166804,9131,周鸣川,2023-01-13 15:48:31,-17,1,18,周老师超级棒，人很负责。每次上课都很用心准备课程内容，无论是实验还是理论课，老师都会自己先把要讲的东西提前准备。讲的内容也是大家最喜欢听的，又清晰又利落。超棒的一个老师。
166912,9131,周鸣川,2023-01-14 08:04:05,13,13,0,上课水平非常一般，可能是缺乏教学经验的缘故，因此不做进一步评价。\n\n    最后一个虚拟机械手的实验可以看出老师自己都没有做过，一次性塞一堆内容：理解机器人学的基础知识、掌握V-REP软件、查阅（早已过时的）API文档、完成V-REP与MATLAB之间的通讯等，另外还有无数小坑要自己踩，完全没有重点，这么多的工作量堆在一个1学分的实验课的1次实验，实在是欠考虑！不过也可能是因为这学期突发疫情转入线上教学，所以老师对这个实验的准备非常不充分。希望老师在下一次布置该实验时至少让同学们采用新版本的V-REP，因为原来的API文档可读性几乎为0，并且很多函数已经弃用，同学们在实验的时候遇到的莫名其妙的困难很多！\n\n    另外值得一提的是，周老师的实验指导书是我本科两年多读下来见过的最糟糕的实验指导书，语句不通顺、表意不明确的状况时有发生（例如求最小外接矩的实验指导书中，坐标变换的矩阵居然是错的，竟然有这种低级错误？），希望周老师可以抽空检查一下自己带教实验的指导书。\n\n    欧对了还有期末线上考试的时候闹出乌龙，确实是比较搞心态的。\n\n    不过最后还是很感谢老师，最起码和学生是有在积极沟通的，钉钉群消息都会及时回，这一点贵院的某些老师是做不到的。
167550,9131,周鸣川,2023-01-17 08:59:04,2,7,5,真是一位讲课清晰、事少、简单、给分好、不卡绩的好老师捏
167564,9131,周鸣川,2023-01-17 10:43:11,-11,2,13,实验出分还可以吧 给分中上 不知道理论课怎么样
167592,9131,周鸣川,2023-01-17 13:45:45,5,5,0,喜提3.9捏(o^^o)
167618,9131,周鸣川,2023-01-17 17:26:54,5,8,3,笑死，居然有人说给分好，实验课辛辛苦苦搞的，全部评分都是良，几乎所有人都是良，优秀的好像没什么人吧，乐\n\n我觉得我的实验课做的水平是可以的了，实验报告质量也不错，最后居然都是良，只能说小看sgsp的小贵物了
169510,9131,周鸣川,2023-02-26 13:58:04,6,6,0,fuck
178954,9131,周鸣川,2023-08-05 08:20:37,-3,1,4,老师有点太年轻了，经验不足，但态度很好，和学生也可以建立有效沟通
179366,9131,周鸣川,2023-09-13 08:45:52,-7,0,7,亲和的老师
181258,9131,周鸣川,2023-10-12 11:33:17,-6,0,6,还不错啊
203308,9131,周鸣川,2024-11-19 16:09:49,-2,1,3,111
215158,9131,周鸣川,2025-02-23 08:28:59,0,2,2,学术能力不错，本博士生受益颇丰，感谢周老师的栽培~
218937,9131,周鸣川,2025-05-13 18:21:53,0,0,0,上课水平一般，但对组内学生是真不错，不做横向，会听你的想法，做的东西算学院里很前沿的了，就这几点就已经完全薄纱其它老师了
168624,9142,王文骏,2023-02-20 10:12:28,0,1,1,老师很负责，讲课很认真，但是这门课真的有点难呜呜
189903,9142,王文骏,2024-02-02 17:43:12,1,1,0,。。。评论错了，不是这位老师，不好意思。
218795,9142,王文骏,2025-05-06 03:24:31,0,0,0,老师人蛮好的 主要是这个课程的问题\n\n学弟学妹们可以注意，老师对pre的要求还是挺严格的，控时+内容+美观，最好好好搞哦
181377,9155,蒋茜静,2023-10-16 06:13:01,17,18,1,111
183146,9155,蒋茜静,2023-11-22 11:42:10,16,16,0,原来是第一次上课，我就说这么可爱的姐姐怎么没人评分捏🤤🤤🤤
186096,9155,蒋茜静,2024-01-08 09:48:07,10,10,0,蒋老师yyds
188578,9155,蒋茜静,2024-01-19 09:56:04,9,9,0,美女姐姐，人美心善
192655,9155,蒋茜静,2024-05-27 04:18:22,7,7,0,美女姐姐
193189,9155,蒋茜静,2024-06-04 09:20:55,7,8,1,美女老师！很温柔！好像是没点过名，上课会随机叫几个人回答问题，不过问题很简单，答不上来也不慌，不会为难你。【生物质能源与可持续性利用】的作业是每周几个小问题，线上交，PPT中都能找到，不会花很多时间，大作业是一篇论文。无小测，无考试，不点名（搭班老师可能会点名）
193442,9155,蒋茜静,2024-06-11 03:58:52,8,8,0,带毕设的老师，人美心善～
193637,9155,蒋茜静,2024-06-15 02:57:37,8,8,0,为什么我们才貌双全、天生丽质、莺惭燕妨、倾国倾城、冰雪聪明、秀外慧中、蕙质兰心的蒋老师不是满分？？？
194469,9155,蒋茜静,2024-06-24 05:28:26,6,6,0,美女老师，人美心善，上课事情也不多
198082,9155,蒋茜静,2024-08-29 06:48:50,3,3,0,蒋老师为什么不是满分，为什么？
204520,9155,蒋茜静,2024-11-26 11:39:27,3,3,0,可爱捏😊
204936,9155,蒋茜静,2024-11-28 20:02:16,3,4,1,姐姐长得像张婧仪，人非常好…特别耐心回复我的补选邮件
205330,9155,蒋茜静,2024-12-04 11:39:34,3,3,0,老师真的很美很可爱很温柔，我一直不敢上课回答问题，但是老师就给我一种没关系慢慢来我等你的感觉，给上课胆小又想要突破自己的人很大的鼓励啊啊啊啊啊谁懂！！！！下课之后太激动发了一些谢谢老师的话给她，她还鼓励我继续加油🥺🥺🥺祝我越来越勇敢，真的很温柔，水都舍不得水了🥺
206111,9155,蒋茜静,2024-12-13 05:38:25,3,3,0,美丽温柔善良可爱
207419,9155,蒋茜静,2024-12-21 12:07:02,3,3,0,讲课认真，长得也超级漂亮
216843,9155,蒋茜静,2025-03-26 14:03:24,2,2,0,吹爆蒋老师
216866,9155,蒋茜静,2025-03-27 12:13:38,2,2,0,蒋老师人美心善，高知分子，没有架子，有能力又谦虚，美貌是她最不值得一提的优点。
217410,9155,蒋茜静,2025-04-10 02:57:46,2,2,0,美女老师人特别好，吹爆
217830,9155,蒋茜静,2025-04-17 04:11:30,2,2,0,老师真的很好，讲的很认真，害怕我们觉得枯燥还会放视频，希望出分也能达到预期！
178057,9328,刘鹰,2023-07-06 12:31:48,1,2,1,思政教育
193740,9329,沈明卫,2024-06-17 06:46:05,4,4,0,老师人挺好的，不是主讲也不刁难人。
193874,9329,沈明卫,2024-06-20 11:21:56,3,3,0,老师人非常好
194180,9329,沈明卫,2024-06-22 10:50:34,3,3,0,不错哦
194183,9329,沈明卫,2024-06-22 11:10:41,2,2,0,老师非常好
175121,9330,杨暄,2023-06-21 15:59:35,0,2,2,杨暄老师真的是一个好老师，讲课很清楚也很关心学生！！
179324,9330,杨暄,2023-09-10 15:40:38,-4,1,5,认真负责
182414,9330,杨暄,2023-11-15 17:33:05,0,1,1,话筒癫公
191033,9330,杨暄,2024-03-29 03:11:38,1,1,0,上课事情也太多了吧？2分的课，实验课最多只能占到一分，但是任务量巨大，相当于每周都是3分大课的期末大作业的作业量，要求单人solo，还要做PPT，最恶心的是随机抽人上去pre，真的吐了。两次实验课都拖课，吃不了饭。课讲得也极差，ppt reader~~
192219,9330,杨暄,2024-05-12 10:54:30,1,2,1,其实老师也还好，实验报告会很认真地给出反馈和批改意见，就是实验课拖堂的问题有点大，上课实验课容易饿
217400,9330,杨暄,2025-04-09 15:47:40,0,0,0,营养学实验课作业量巨大。。上课也是只读PPT，非常无聊，很坐牢。不过老师还算亲和。
220605,9330,杨暄,2025-06-19 01:29:22,0,0,0,杨暄是对的😭😭没有其他老师对比才知道你上课有多好
170062,9478,李正龙,2023-03-01 07:27:12,2,4,2,。。。
192657,9478,李正龙,2024-05-27 04:24:00,1,1,0,111
219398,9478,李正龙,2025-05-26 11:02:00,1,1,0,给分不好，上课挺水的
218791,9582,李冬阳,2025-05-06 03:12:17,1,2,1,非浙本对浙本的报复\n\n贬低型教育 典型海归装货
218792,9582,李冬阳,2025-05-06 03:14:45,1,1,0,装货。一节课吹牛，一节课讲成功学。
219890,9582,李冬阳,2025-06-10 05:05:21,0,1,1,最后一节课的展示点评还是非常专业中肯的，课题组看起来经费也充足，要是前期不那么贬低式教育就好了。现在不吃蛇的原因真的不是家道中落啊、、、
220344,9582,李冬阳,2025-06-17 10:57:57,0,1,1,下头男，课件上来就吹嘘自己老师的研究成果，然后考试根据这个出15分的论述题，毒素案例也是讲不明白的，又散又乱，还要根据这个出题目，原先的17种基础上每个都再拓展几个，一点逻辑都没有，考试周还喜欢发低脂短视频到群里说是“有意思的视频推荐大家看”，滚吧下头男
179354,9688,史瑛,2023-09-12 16:01:00,0,2,2,水平不行，脾气还差
220490,9688,史瑛,2025-06-18 08:12:41,0,0,0,讲话像催眠一样，死死的。感觉比我还像尸体。讲课一坨，还不划重点。还不如家暴男。
198163,10242,崔绍庆,2024-09-03 09:01:35,-4,1,5,懂得都懂
214643,10412,蒋增良,2025-02-15 14:55:37,0,0,0,蒋哥好
218579,10412,蒋增良,2025-04-25 04:30:18,0,0,0,新人福利，助力10分😁
