评论id,老师id,老师姓名,发表时间,点赞减去点踩数量,点赞量,点踩量,内容
35300,20,杨秦敏,2016-11-08 03:18:30,-6,8,14,很棒的老师，上课也上的蛮好的
109331,20,杨秦敏,2019-06-13 06:43:03,12,16,4,比较自傲  说话自顾自 咄咄逼人 不给人辩解的机会
117713,20,杨秦敏,2019-09-30 00:59:08,7,13,6,sb专业认知随机给分nmsl
118260,20,杨秦敏,2019-10-24 04:29:24,-2,1,3,啦啦啦\n\n
119130,20,杨秦敏,2019-11-10 23:32:27,5,7,2,磨磨唧唧
125057,20,杨秦敏,2020-08-22 04:41:16,19,28,9,专业认知给分太迷了
125114,20,杨秦敏,2020-09-01 02:21:09,9,10,1,严格5级制给分，只有5个等级，这不闹吗
126018,20,杨秦敏,2020-09-26 14:25:39,-1,9,10,很好的老师！上课认真！
139857,20,杨秦敏,2021-08-03 09:57:07,1,3,2,给分挺迷的
140954,20,杨秦敏,2021-09-18 08:51:15,-2,8,10,经常性地骂学生脏话
144107,20,杨秦敏,2021-12-17 16:09:41,-6,7,13,千万要避开这个脏话骂人的b
151975,20,杨秦敏,2022-03-22 07:58:57,14,18,4,跟杨老师从本科到博士毕业，科研上很严谨，要求很高，但从来没有用脏话骂过我，倒是这上面的一些同学口吐芬芳
152572,20,杨秦敏,2022-04-15 02:27:36,13,17,4,自控双语班，春学期上课体验还是很不错的，比隔壁院长班好多了
155482,20,杨秦敏,2022-06-13 12:10:37,3,7,4,上了老师的自控课 个人认为讲的很好 没有评论说的那些情况
159399,20,杨秦敏,2022-07-16 05:08:17,-4,2,6,专业认知给分出乎预期的高
173877,20,杨秦敏,2023-06-04 04:48:01,0,0,0,111
182571,20,杨秦敏,2023-11-17 14:40:51,3,5,2,现控讲的非常好，评分不能反映上课水平。不过给分还不知道怎么样。
188464,20,杨秦敏,2024-01-19 04:43:19,2,3,1,上了杨老师的自控和现控，老师真的讲的特别清楚，而且上课也很有激情，和同学也会有交流\n\n非常推荐！！\n\n但是杨老师班里的平时分不是作业交了就有的，所以作业要好好做（
13769,37,王慧,2015-12-30 18:32:29,16,23,7,老师人特别好！是控制学院的主任，非常和蔼负责，也是自控原理主编之一
24044,37,王慧,2016-04-26 06:03:01,-7,5,12,信号与系统基本是念PPT，教材也有很多印刷错误，什么都没学到
25118,37,王慧,2016-06-25 01:10:37,0,6,6,说没学到东西的，你是上课没好好听课吧
28072,37,王慧,2016-06-28 08:04:07,0,3,3,王老师特别好，人很和蔼，上课也非常轻松愉快。
32543,37,王慧,2016-07-07 12:46:24,1,3,2,王老师讲课很细致认真，人也和蔼可亲
49439,37,王慧,2017-04-12 23:45:32,-2,0,2,不错的老师
87531,37,王慧,2018-10-02 06:38:18,1,1,0,一种非常好的体验。
89534,37,王慧,2018-11-19 11:50:34,1,1,0,老乡，老师很和蔼
113446,37,王慧,2019-07-06 17:24:12,1,1,0,好老师！收获很多
113727,37,王慧,2019-07-07 06:13:14,1,1,0,很和蔼可亲的老师呀~
2851,109,张武明,2015-05-09 00:40:50,2,40,38,又水又坑
8210,109,张武明,2015-09-17 12:27:03,-28,6,34,我是看着教务网上没有考试才选的，第一节课tm说第八周考试真是醉了
9411,109,张武明,2015-10-26 10:38:17,-8,4,12,要考试吗？
11374,109,张武明,2015-11-29 10:06:33,9,16,7,怎么成绩还没有出
11412,109,张武明,2015-11-30 13:18:39,7,11,4,今天是十二月一号分还是没出吗？
11516,109,张武明,2015-12-03 09:12:05,25,59,34,没有期末考试，只要交一个报告和一个PPT，花了一天的时间来写的，竟然得了87分，出分慢了点，毕竟不是改卷子，而是读报告和看PPT
19915,109,张武明,2016-01-25 14:21:52,20,27,7,堪称绩好\n\n
20880,109,张武明,2016-02-03 01:03:09,-2,3,5,前几周超级水，后面一周赶一赶，认真做ppt和报告就没问题。
21067,109,张武明,2016-02-14 23:54:18,2,4,2,微机课讲的挺水的。。全靠自学啦。出分不是一般的慢。。。
21249,109,张武明,2016-02-27 12:29:54,2,6,4,好好好
21410,109,张武明,2016-02-28 15:19:48,2,5,3,还好，最后作业好好做不错的
22304,109,张武明,2016-03-03 11:04:19,16,22,6,老师有点帅
23804,109,张武明,2016-04-17 10:18:12,6,11,5,绩点哈哈好
24810,109,张武明,2016-05-04 00:54:48,2,5,3,最后作业好好做，分不会低，平时比较水，点一次名
31340,109,张武明,2016-07-03 16:30:08,-4,8,12,给分 创我通识课新低  也就呵呵了
31372,109,张武明,2016-07-03 22:21:11,8,10,2,老师挺认真负责的 每次来得都很早 最后作业认真做 得分会不错的
32858,109,张武明,2016-07-19 05:05:04,2,3,1,挺水的，给分好
37514,109,张武明,2016-11-19 08:12:57,2,3,1,给分还不错。最后的PPT和论文好好写，平时上课比较水。
37638,109,张武明,2016-11-20 01:58:23,4,5,1,老师还是不错滴。。给分很客气hh\n\n
37768,109,张武明,2016-11-21 02:41:20,9,16,7,张老师人很好，上课会讲各种各样的东西。但我选这个课原来是想学一点遗传算法的内容，但老师很快跳过，基本没讲，有点遗憾。认真做最后的课题报告的话，给分还不错
37855,109,张武明,2017-12-22 01:54:55,13,24,11,老师感觉干货不太多，本来想了解一下生物进化变化的，但是并没有了解多少，但是老师给分还是不错的哦，只要你好好写论文做PPT
46470,109,张武明,2017-01-22 00:17:09,2,3,1,微机课讲的昏昏欲睡，但是人很好。主要听后半段毛老师讲，其实两个老师都很可爱，给分感觉很惊喜，因为答题时感觉错了很多，平时还是要好好做作业的，给分速度也没有很慢，十天左右出的。
46480,109,张武明,2017-01-22 00:43:07,8,9,1,讲的知识性的东西不多，毕竟属于一门水课，但是给分很好，看均绩也能看出来，ppt，报告好好做没问题的
46528,109,张武明,2017-01-22 01:53:29,-10,8,18,挺水的吧，中间会有点名，主要就是最后几周的ppt展示和论文，论文就要求1500字很少的，ppt展示的时候不用提问，写下问题就有加分，也不是很麻烦，认真对待一下。老师给分很好，谢谢老师给我了满～
48429,109,张武明,2017-03-03 08:20:25,2,4,2,老师给分棒棒的，就是期末交一篇报告和ppt，人很好
49480,109,张武明,2017-04-16 12:17:10,0,0,0,求问报告和PPT是在考试周结束时截止吗，谢谢
50769,109,张武明,2017-05-05 05:55:02,-1,1,2,给分好，上课嘛。。。比较蛋疼，想学日语的可以去听听2333
50840,109,张武明,2017-05-06 11:26:50,5,8,3,一开始以为讲的水，后来真的听了感觉还是可以学到很多，要争取最后ppt汇报的机会，给分真心不错！
50878,109,张武明,2017-05-08 01:02:11,2,4,2,老师上课很认真，然而实在让人没法专注地听下去。基本没有下课，连着上两个半小时，最后ppt和报告认真做，得分会不错。
50950,109,张武明,2017-05-10 02:07:56,2,4,2,积极做PPT，多提问，给分绝对良心
57380,109,张武明,2017-07-07 05:34:31,4,5,1,张老师上课挺有意思的，因为在日本留过学所以会讲很多关于日本的风俗文化(尤其是吃的←_← 如果愿意的话，下课后和老师聊聊天也是很好的。\n\n上课只要积极提问，做展示，分数一般都很好的。恩，就是这样了。\n\n
57382,109,张武明,2017-07-07 05:47:05,4,7,3,给分非常非常好，而且老师人特别好，我最后期末作业差点迟交了，老师还专门发短信提醒。
57432,109,张武明,2017-07-07 16:07:18,2,4,2,老师人很好，认真选题，选感兴趣的，多修改成绩会好的！
59167,109,张武明,2017-09-20 05:12:50,9,16,7,课程里面所包含的思想确实挺好的。老师有句话：进化不是为了争第一，而是为了追求不被淘汰。对人启发非常大。
62659,109,张武明,2017-11-26 09:41:33,-2,2,4,。。。。
62681,109,张武明,2017-11-26 11:02:18,2,7,5,上课内容无聊但给分很好 只有第一节课有点名 也没有上课发言提问什么的 会提前20分钟左右下课 不考试   最后有一个ppt和1500字以下的论文 最后三节课个人展示 不想上去展示写问题也可以 我没有展示只写了问题然后认真写了写论文就4.2了
62713,109,张武明,2017-12-04 05:17:02,-4,10,14,你们得分高了就不要再说了，老师的课十分水，我努力做的论文与提问都被无视了，这种明明很努力却得不到回报的感觉你们懂吗？
62759,109,张武明,2017-11-27 01:46:24,5,8,3,上课水水过了，最后做PPT和写论文，上台做展示和提问会有加分，给分挺好的哈哈
62975,109,张武明,2017-11-27 14:52:31,2,7,5,卡档91
63096,109,张武明,2017-11-28 08:58:01,2,6,4,老师绝对绩好，讲进化也比较透彻，全方位介绍了生物进化，最后的报告和PPT也不难，只要认真做绝对没问题的
63100,109,张武明,2017-11-28 09:06:51,5,9,4,挺水的课，老师讲的课有点无聊，但是老师人还是很好的，最后作业是一个PPT加1500字的论文，最后两三节课进行展示可以加分，别人展示时提问问题也可以加分（只需要写下来下课交上去就行），好好做得分应该不会差的
63134,109,张武明,2017-11-28 14:19:44,1,4,3,老师很棒！而且讲的课程也比较有意思，通过做报告真的能让自己了解到许多原来不知道知识，而且老师会告诉你如何做好一份报告，感觉这门课对自己还是挺有帮助的。给分也很好。
63825,109,张武明,2017-12-16 02:01:35,-8,1,9,给分好，满绩
64090,109,张武明,2017-12-21 03:08:01,1,4,3,值得社科文科上的K类（还是T来着）的通识，老师和蔼可亲，耐心解答，平时事情少。而且如果选题新颖，老师最后的PPT啊论文啊还有他说建议大家做的都做一些，分真的好！要是老师上课用麦可就更好了:)
64331,109,张武明,2017-12-22 12:59:14,4,9,5,大水课，语调又平平的，我想听也听不进去，严重怀疑听他课的有没有五个人…任务很轻，成绩很好看，老师很儒雅很温柔哦
64797,109,张武明,2017-12-27 07:11:15,0,4,4,老師很好的！\n\n虽然说他上课的内容我都不太理解但是期末考覈和這些關系不大，一分報告一份ppt用心做肯定能取得好成績。99的滿績在等你(∂ω∂)
65334,109,张武明,2018-01-03 05:48:34,0,1,1,事少，给分也好
71374,109,张武明,2018-02-08 09:14:29,3,7,4,上课没有一点干货。\n\n
71939,109,张武明,2018-01-29 06:20:53,1,1,0,超级喜欢的老师，上课很棒，也有很多的人不来上课很水，就是出分太慢了
71945,109,张武明,2018-01-29 06:26:52,3,7,4,上课学不到任何东西，学不到任何，学不到任何。每个人对课程追求的东西不同，学学问的还是不要来浪费时间了。
72925,109,张武明,2018-01-31 11:09:00,2,2,0,很温和耐心 等待分数中:)
73561,109,张武明,2018-02-02 03:34:37,1,1,0,最后一门出成绩的课。
73871,109,张武明,2018-02-03 09:32:05,-1,0,1,老师很耐心，上课要抓住机会展示、提问，给分很好！
73904,109,张武明,2018-02-03 12:46:27,-3,1,4,虽然出分是真的慢，但是给分是真的好(✪▽✪)。
73913,109,张武明,2018-02-03 14:05:16,-2,1,3,老师超温柔，给分超好，第一个满绩，? ? ? 事情不多还很好玩，很棒棒呢。
77065,109,张武明,2018-05-23 02:15:06,8,13,5,老师很好 但是我上课做了展示也写了不少问题  也很认真的做了ppt和报告 最后拿了3.6...有点迷...
78743,109,张武明,2018-05-22 11:35:09,12,18,6,想看干货的可以选门生物工程专业课嘛，又不是不能选\n\n选个通识课说没干货，搞笑？
78837,109,张武明,2018-05-15 14:08:19,3,3,0,我只是很想知道是不是就我没有成绩...
78843,109,张武明,2018-05-15 15:56:01,4,6,2,楼下 我也没有
79084,109,张武明,2018-05-22 10:30:10,2,3,1,课是真的水，出分是真的慢，但是事情少给分好也是真的
83978,109,张武明,2018-07-11 15:52:40,8,10,2,学不到东西\n\n报告认真写了做了展示题了问题80+\n\n真是又水又谜
84014,109,张武明,2018-07-11 23:08:23,2,4,2,上课无聊，展示＋提问最后3.9卡绩 无话可说
85408,109,张武明,2018-07-17 12:26:12,-1,1,2,老师人挺好的。有点水。论文和ppt好好写就行啦，给分挺好的。
91010,109,张武明,2018-11-29 02:06:01,0,2,2,课挺水的，作业要认真做，同学展示多写问题，给分不错的
91052,109,张武明,2018-11-30 09:38:59,2,3,1,这门课不值得 给分坑
92886,109,张武明,2019-01-05 10:25:47,0,4,4,一门恶竞的课，如果你写的不够多，连3都上不了
98674,109,张武明,2019-01-23 18:04:34,-21,0,21,鹅颈，干货少，给分一般（通识里算是给我好的了，但是还是只有4.2，拖低了我的均绩……）各位看着选择。
98700,109,张武明,2019-01-23 23:46:09,-1,0,1,之前没时间做ppt就放弃了上去展示的机会，最后肝ddl肝了一两天，给了我96，太惊喜了（报告别真的以为写1500就够了）
98819,109,张武明,2019-01-24 03:36:11,1,2,1,上课水是真的，甚至课件都很多重复也没有太多实质性内容，但我选这门课是看到给分好来的，但怎么说呢 有点迷吧。展示了 ppt和报告做的不算出彩但也平均水平也有吧，报告3000不到字数，查了很多资料。最后3.9。成绩当然可以接受，但看到楼上不展示的满绩，心里还是有点心塞。展示的问题可能有加分，但应该不至于超过展示的同学吧。。。另外看最近的评论好像是有点下降，可能以前给分好？
98970,109,张武明,2019-01-24 06:02:44,3,3,0,展示+4000不到的report 97分 展示了未必高分 展示的人里不知所云的多了去了 报告倒是确实1500估计写不出什么东西
101070,109,张武明,2019-01-27 12:08:25,1,1,0,上了生物进化与设计，老师把作业要求讲的很详细，认真做就好，鹅不鹅颈我也不清楚，反正我报告真的只写了1500，有4.8，没有上去做展示，只写下了展示的问题，不打算做展示就写了好多问题，然后每次点名都在，老师人挺好的，讲课也很有条理。
107480,109,张武明,2019-05-05 14:48:31,4,4,0,我只想知道什么时候出分。。。。
107692,109,张武明,2019-05-08 10:06:39,1,1,0,点名是第一次和第五次课.我觉得课还算有意思吧(?除了高中生物部分emmm）.最后是一个ppt+报告word（1500～2000字），展示可不做。我报告2000字左右然后展示略崩..最后也上4了）
107702,109,张武明,2019-05-08 11:23:40,4,4,0,老师人很好，很儒雅，对同学的疑问都会很耐心解答，虽然这门课我个人觉得确实学不到什么东西，不一定要展示 但是在纸上提问一定要多，ppt和报告认真准备一下，成绩不会差的
107732,109,张武明,2019-05-08 15:30:24,2,2,0,老师的课很充实 但实话是三节课听下来会很累 后两周老师会留时间给同学做展示 大概有30-40个同学做了展示 没做展示也没关系可以写下问题作为平时分 期末的PPT+报告开始没什么思路 最后大概3000+字 刷夜写完的 绩点上4 我觉得很好了
107733,109,张武明,2019-05-08 15:40:03,0,0,0,老师真的给分挺好的，ppt和报告好好写
107854,109,张武明,2019-05-10 11:16:06,2,2,0,成绩很迷，不知道怎么回事
107864,109,张武明,2019-05-10 13:44:22,-4,1,5,分数有点迷\n\n第一批上去展示的，个人感觉展示内容也比较生动\n\n报告也写了3700\n\n然而还是没有上4？
109317,109,张武明,2019-06-13 05:37:16,2,3,1,上课可以不听，认真听也会有收获。认真写报告3000+，展示，好好写问题，给分不会差。
113117,109,张武明,2019-07-05 23:46:17,1,1,0,老师人挺好 但是被正太了呜呜呜
113143,109,张武明,2019-07-06 00:17:32,1,3,2,这个老师真的是给分太好了叭！我选了老师课之后，看了查老师评论，本来是想展示的，结果因为没时间做ppt我就没展示，就准备了好多问题，期末的报告3000+，结果就满绩点了！我自己都没想到能满，我的天，老师真的好。展示真的可以不用做，只要你准备很多问题，并且报告用心血。最后再给老师一个赞！
113182,109,张武明,2019-07-06 01:17:02,1,1,0,人好，事少，分多。\n\n老师上课和蔼，会很耐心地回答你的问题，总共点两次名，期末交一篇论文一个PPT，展示无所谓做不做，本人虽然做了，但一个没做的课友疯狂提问题也满了（当然期末论文和PPT要认真做）。\n\n总之，墙裂安利！！！
114065,109,张武明,2019-07-08 16:03:21,1,2,1,给分挺好，事情真的少，拯救了本学期满课的我
116440,109,张武明,2019-09-10 13:11:43,-12,2,14,非常好的老师，但是管的太松了、也没有什么任务，我就水水拿了4.8，挺惭愧的
118924,109,张武明,2019-11-08 00:49:50,1,2,1,老师用的是几乎全英文的ppt，如果想学知识的话，老师提供的文献会帮助你很多。事很少，不认脸，就看你的报告与ppt！
120301,109,张武明,2019-11-28 00:05:16,4,4,0,张老师给人一种知书达礼的知识分子感觉。张老师的水平很高，课程难度还是比较大的（如果你认真听），但是不会考试，老师的主要目的还是希望各位了解“进化”这一生物与社会现象，是一堂非常好的知识普及课。张老师的课事情少，分数高，不会影响其他专业课的学习。最后的ppt展示积极参与，期末报告好好写就绝对没有问题啦～总之强烈安利！
120455,109,张武明,2019-12-09 02:51:54,0,1,1,老师人真的很好，提早下课，上课想听就听，老师都允许睡觉的，不听都不好意思啦。给分真的很好，平时没有作业，认真完成报告（真的挺简单有趣的），ppt，写写问题，分数也很不错啦
121153,109,张武明,2020-01-20 01:18:25,0,1,1,很好，老师很儒雅
121330,109,张武明,2019-12-19 10:56:38,3,3,0,只能给一个中肯的评价吧，课还没上完但我已经知道他上课什么样了，讲的东西不少，但总而言之就是按照一个套路讲不同的事情，可以用换汤不换药来形容吧，听不到什么东西，听课总想睡觉，还没有接触到鹅颈的部分，总之就事少这一个好处
123596,109,张武明,2020-06-10 10:48:43,1,2,1,一个字：棒！！！人文学子可冲！！！
124710,109,张武明,2020-07-06 15:55:22,-1,1,2,给分没那么好。。
126176,109,张武明,2020-09-18 12:18:05,0,0,0,能把嵌入式系统上成一门通识课hhhhh。老师很和蔼也很耐心，听不明白就去问吧！
128001,109,张武明,2020-12-03 01:49:39,4,6,2,生物进化与设计事少分好，上课很水不听也行，只有第一节课点名，期末交1500字论文和一份PPT，PPT展示和纸上给PPT提问都能加分
133104,109,张武明,2021-02-08 08:16:23,4,9,5,给分看不懂了\n\n上课点到、展示、提问，该做的没有漏下的，最后给我2.7？？？这门课简直笑话
133297,109,张武明,2021-02-24 02:41:50,0,1,1,生物进化与设计。课程内容其实有点水，有几次签到，后半学期进行课堂展示或针对展示提问算平时分，最后交展示PPT和小论文，没有考试，出分慢了点。
135584,109,张武明,2021-05-15 13:31:12,3,4,1,老师给分很好，事少，做ppt和论文就好，对社科生极其友好。
150535,109,张武明,2022-01-29 09:40:53,1,3,2,生物进化与设计，刚出分来写写。第一节课点过唯一一次名，老师反对无意义的卷字数，认为精炼的语言更能体现水平，考核形式是1500字论文＋ppt。老师很儒雅，风度翩翩，上课内容很有深度。给分很好。
150951,109,张武明,2022-02-21 10:26:05,0,1,1,只有第一节点了名，真的事少分多，课也可以不听（个人是文科生觉得没意思没听，可能是我的问题，但是分真的好，适合课多精力少的人）
155284,109,张武明,2022-06-10 07:19:02,1,2,1,为嵌入式攒一波运气，求求老师了，一点不会啊啊啊啊啊啊
155287,109,张武明,2022-06-10 07:57:36,2,3,1,上了老师的生物进化与设计，老师人真的很好很和蔼，给分也真的特别好，结课前一直拖延导致没有去pre但在最后认真按要求交完作业后也有很好的分数
157983,109,张武明,2022-06-26 02:57:56,1,2,1,生物进化与设计。老师很和蔼，给分超级好！！！！不像有些通识会给人被辜负的感觉
159147,109,张武明,2022-07-06 22:36:19,3,4,1,被狠狠捞了！老师有些话唠，但很和蔼，很有耐心！
159253,109,张武明,2022-07-09 11:25:07,-2,1,3,生物进化与设计真的逆天，点名到了展示做了PPT和word报告都交了就给3，问就是对展示提问和感想得分多？那倒是一开始就说清楚啊，感觉准备展示完全白干
159255,109,张武明,2022-07-09 11:17:49,2,2,0,快选！！！！！满了火速来评价\n\n好好写上课的提问，早点去pre，好好写报告和ppt，成绩会超级好！！！！！！！！\n\nzwmyyds
159277,109,张武明,2022-07-10 11:52:35,4,4,0,生物进化与设计\n\n努力花了三天好好润色了一下自己的ppt和论文\n\n论文也就2000字左右  \n\n上课什么的事情是真的少 最后几节课好好写问题就行了\n\n因为好好写论文和做了ppt 希望能拿高一点绩点 但5.0还是超出我的预料了\n\n适合事情少的同学\n\n老师虽然上课讲的比较空洞 但自身素质很好 有一股文人气质\n\n想要留学日本的同学可以和老师沟通\n\n总结是事少分高。谢谢老师🙏
159286,109,张武明,2022-07-10 16:11:53,1,1,0,生物进化与设计\n\n作业只有1500字以上论文和对应的ppt\n\n论文和ppt都好好做了 大概花了零零碎碎合起来两三天时间\n\n平时真的没有其他事情   最后几节课要认真做提问和记录\n\n因为好好卷了一下 想着能拿高分 但5.0还是意外之喜\n\n事少分高  谢谢老师\n\nps：有日本留学愿景的同学可以联系老师
160931,109,张武明,2022-10-20 05:17:22,0,0,0,嵌入式高级实验出分来评。老师给分挺好的，而且人很好，提的意见比较温和(bushi
162541,109,张武明,2022-11-24 17:25:51,0,0,0,嵌入式和嵌入式高级都选了张老师，老师很佛系，嵌入式课程的实验难度应该是各个班最低的，而且给分非常好。
164058,109,张武明,2022-12-17 14:04:56,2,2,0,课程：生物进化与设计\n\n评分：8/10\n\n到我写这篇评价时分还没出来，所以这篇评价的内容不包含绩点。\n\n课确实比较水，上课的感觉就是老师准备了很多，讲了很多，又感觉和什么都没讲一样，从来不点名/提问，每次上课就看到大家都在自习数学什么的。感觉课程的核心内容半个小时就可以概括出来吧，老师大部分讲的都是些例子。课程最后需要一篇论文，有字数上限，一个展示的ppt，展示不必须，但展示了，展示申请的提交时间越早，会给予加分，展示过程中记笔记/记录问题，之后上交也有加分，最后1-2节课都是展示时间，但是还是有人没展示的了，提前展示还有好处是你更有可能展示完，而非由于时间到了被掐掉，并且展示题目最好找些不太一样的（不要像我一样连着三个同一个题目的）展示的题目大概是进化/进化设计在某一方面的应用。老师人很和善，没啥让我特别难受的点（也许等成绩出来就有了？）。
164710,109,张武明,2022-12-24 04:05:48,1,1,0,评了个10分\n\n但是出分是真的慢，秋学期的课冬学期快结束了还没出分
166173,109,张武明,2023-01-11 09:52:32,2,2,0,上课纯纯划水，报告和pre好好做，多写点问题，然后满绩了！谢谢老师！
166186,109,张武明,2023-01-11 10:57:50,0,0,0,课程：生物进化与设计\n\n评价：8/10，展示了提问了，给分没想象那么好，但还可以。老师很温和，没几个人听。
166244,109,张武明,2023-01-11 13:56:27,0,0,0,喜提3.0 谢谢老师
167096,109,张武明,2023-01-15 03:03:56,-3,0,3,生物进化与设计。课水 一节课都没听过，最后大作业限制字数，5.0谢谢老师
168304,109,张武明,2023-02-10 06:17:49,0,0,0,生物进化与设计，上课很水事情少，期末一个PPT一篇论文，给分一般
169401,109,张武明,2023-02-26 03:16:32,2,2,0,老师讲的很好，任务不多，认真写论文和做ppt，成绩会很好!
170104,109,张武明,2023-03-01 11:11:11,3,3,0,事少给分好，还要什么单车，快选
49992,171,陈剑,2017-04-28 07:56:20,24,25,1,讲课声音有点小
50581,171,陈剑,2017-05-03 15:50:11,-17,4,21,良心老师，讲课声音小但很有深度，给分绝逼好！但是课程很辛苦，2学分的课作业量跟4学分的差不多，会占用很多时间。
50660,171,陈剑,2017-05-04 06:09:29,-11,6,17,老师浙大本科，课堂稀松平常，喜欢由同学们来回答问题，当然期末也有加分。老师领进门，修行在个人。
50764,171,陈剑,2017-05-05 04:11:35,-14,2,16,老师声音小\n\n数模本来就是靠自学的\n\n大作业时间要规划好否则爆炸\n\n最后给分蛮好
64221,171,陈剑,2017-12-21 15:24:17,16,16,0,有点坑
76653,171,陈剑,2018-04-17 08:05:09,11,11,0,睿智zszs
76825,171,陈剑,2018-04-24 07:40:44,-10,3,13,老师还不错。但是课有点鹅颈。想要突出的话得自学很多东西。占用的时间也不会少。慎选。
76833,171,陈剑,2018-04-24 09:13:31,20,23,3,照本宣科，这个老师不适合上课
115343,171,陈剑,2019-07-19 04:53:24,12,13,1,深海巨坑，慎选
122626,171,陈剑,2020-03-09 06:36:51,13,13,0,催眠。。
122699,171,陈剑,2020-03-20 09:37:23,21,22,1,催眠＋1\n\nPPT抄英文教材？\n\n上课纯念PPT？\n\n还有\n\n你麦有问题炸人半学期耳朵还说是鸟叫？
124612,171,陈剑,2020-07-03 23:53:14,11,12,1,这老师上课只是为了完成任务，就没打算教会学生。这位浙江省特聘专家课程上花没花功夫自己最清楚。ljls
150724,171,陈剑,2022-02-16 05:10:46,27,28,1,首先，课讲的是一坨shit，凭这个我打一分；\n\n其次，讲课是请你来念PPT的吗，念错了还要倒回去重念，以后考虑把PPT发下来我们学生自己回去念吧！我们语速比你快，声音还洪亮；\n\n还有，回应楼上那句“不想教会学生”，不是不想教会，是没那个能力，自己都模棱两可，站讲台上能不虚？\n\n然后教室那个麦坏了，全班同学都听出来了，还在那说鸟叫，我tm整个大无语，坏了你叫后勤去修啊！又没让你修，下次修不好自己带麦来啊！合着没麦了不会讲课是不是，这人没担当，遇到问题不会自己扛。\n\n这PPT一看就是手下研究生做的，自己反正肚子里一点墨水没有，上去就照着念，没要求你高屋建瓴，没要求你深入浅出，上课内容弄得整个跟教材查重率百分之百，真行啊。
151747,171,陈剑,2022-03-14 13:08:21,35,41,6,短学期上了一半，来评价评价这位陈老师。讲课声音小，照本宣科我就不再多说了，主要还是水平差得令人发指，我觉得我上去比他讲的都好，说个拉格朗日插值多项式，非要用似懂非懂的“比例”去解释，估计自己也是不会推这个公式的；至于他的助教嘛，则是更加nb，MATLAB学习的word文档都是不知道哪一年的版本，完全没有用心备课。槽点还有很多，我就不一一细说了，如果和我一样是必修课的话，就和我一样在课上睡觉吧（对了，他还鼓励课堂发言鹅颈）
153503,171,陈剑,2022-05-11 15:07:13,16,16,0,老师课讲的实在一般，而且声音比较小，助教有些工作做的也不到位，给分还不好，慎选
153576,171,陈剑,2022-05-05 03:52:38,15,15,0,课讲的不好，声音小而且不清楚，效率很低，慎选
159460,171,陈剑,2022-07-21 17:53:24,13,14,1,sbcj
164684,171,陈剑,2022-12-23 09:51:45,7,7,0,课讲的非常不清晰，而且声音非常小，给分也一般
171402,171,陈剑,2023-03-23 11:17:02,8,8,0,水平太差了，随便问他个问题都回答不上来
171539,171,陈剑,2023-03-28 02:51:41,12,12,0,依托答辩
179876,171,陈剑,2023-09-20 02:37:25,0,2,2,其实相比之前我突然觉得还行
190488,171,陈剑,2024-03-05 14:03:25,1,1,0,臭傻逼，草泥马的
191085,171,陈剑,2024-04-01 18:24:23,2,2,0,脑瘫老师\n\n脑瘫课
193611,171,陈剑,2024-06-14 02:13:24,1,1,0,屎
13887,207,叶炜,2019-11-13 01:35:10,26,40,14,......
23897,207,叶炜,2017-12-28 01:29:10,7,9,2,我只上了老师的通识，感觉老师确实是个好老师，但是不太会教，通识课上讲得好深奥哦(ᵒ̤̑₀̑ᵒ̤̑)
25038,207,叶炜,2016-05-05 02:46:08,-1,3,4,讲得超级好，很感兴趣。给分也很好！赞！
33774,207,叶炜,2016-09-21 12:20:37,-1,1,2,非常非常好
33794,207,叶炜,2016-09-22 00:00:23,4,7,3,老师很萌，我一个社科的听课都觉得物联网这课很有意思。欣赏华为所以总是给我们讲华为的各种好处。
36562,207,叶炜,2016-11-15 01:45:52,2,4,2,很不错的老师，上课比较有趣，虽然没怎么仔细听，作业布置的不多
37330,207,叶炜,2016-11-18 10:20:10,1,3,2,听不懂给分还低亏我写了这么长时间的论文
37393,207,叶炜,2016-11-18 16:05:03,5,5,0,讲的不错 但是给分差
59161,207,叶炜,2017-09-20 04:21:57,-1,0,1,很好的
60290,207,叶炜,2017-10-16 16:03:51,-2,1,3,很有趣，推荐\n\n
62701,207,叶炜,2017-11-26 12:57:57,2,2,0,好评，分高，幽默\n\n
63314,207,叶炜,2018-09-14 04:47:28,2,4,2,老师人很好诶，在做ppt展示的时候他也会很认真地听然后问一些问题。给分也还不错。
66292,207,叶炜,2018-01-15 02:28:50,0,0,0,技术前沿，幽默，不错的老师
87908,207,叶炜,2018-10-17 11:35:33,0,0,0,冷自己，独角戏
90107,207,叶炜,2018-11-22 06:35:18,-4,0,4,作业认真做，给分就可以。
93585,207,叶炜,2019-01-10 14:44:17,4,5,1,课比较水，中途有一次小组展示和测验，不是很难，给分比较一般，期末一篇5000以上的论文或者文献翻译，不是很推荐
107027,207,叶炜,2019-05-01 02:45:26,-5,0,5,出分了来评一波\n\n给分还蛮好\n\n事略多\n\n想竞倒是都可以竞
107036,207,叶炜,2019-05-01 03:21:28,1,5,4,老师挺萌的～不过上课有点硬核，不是很感兴趣的话有点点无聊\n\n有一次开放性题目的小测（会提前说题目，可以上网查资料）有一次小组展示 两三次平时作业（不耗时的!） 期末的话没有考试 自选一篇5000+论文或者翻译提供的英文论文 （总的来说事情稍稍有点多）\n\n只有你认真对待!!给分就可!!（真的!）
107062,207,叶炜,2019-05-01 08:28:54,-2,1,3,用心理解能学到很多前沿的知识。\n\n听听过就算的也能被科普一下。\n\n给分比较良心合理的。\n\n很想跟着老师一起做研究。
117771,207,叶炜,2019-10-01 02:36:07,15,16,1,讲得还行，但作为只有半个学期的通识课，作业是真的多，两次课后作业—一次简答，一次设计方案，还要三人一组找资料，做PPT，拍演讲视频；还每个人翻译文献+制作PPT？？？这种作业真的不会有人想做，要轻松的千万别选！！！
119456,207,叶炜,2019-11-13 02:08:08,5,6,1,刷新我的最低绩点
119459,207,叶炜,2019-11-13 02:18:48,3,4,1,物联网事是真的多，不过至少给分不玄学，努力和收获是成正比的，绩点虽然不算高但基本符合我出分前的预期，是个好老师
119463,207,叶炜,2019-11-13 02:38:52,1,4,3,事情真的很多 很认真完成了 也只有4.2
119467,207,叶炜,2019-11-13 02:48:09,-1,1,2,还行吧 虽然事情有点多 花点时间去做还是能拿4.5 不算失望
121262,207,叶炜,2019-12-25 05:44:02,1,2,1,有一说一，课挺好的，小组讨论会督促人去自主学习，我就觉得学到了很多新颖的物联网思想，包括翻译论文的过程也是接触了最前沿的物联网技术。最后写的论文能够把整门课学到的硬知识用上。整门课不点名不恶竞，教务网标注的双语只是有些ppt是英文，上课无压力还能学到东西不好嘛？
123877,207,叶炜,2020-06-15 17:18:28,1,3,2,物联网事挺少的呀，可能老师调整了？一次10分钟pre视频（疫情原因），一次随堂作业（百度一下搜集一些资料，做几个小表格就好啦）一篇论文翻译+PPT。给分很高。本人人文专业，有部分内容听不太懂，但是框架很清晰，我知道他在说哪方面的内容，不过数理知识跟不太上就是了。可水可听，推荐
127431,207,叶炜,2020-11-23 03:34:36,0,1,1,期末大作业千万不要选论文翻译，赶ddl的时候头都要炸裂了
127436,207,叶炜,2020-11-23 04:27:54,-1,0,1,拉胯。
128652,207,叶炜,2020-12-25 02:33:17,1,1,0,老师人不错，上课不点名，讲的都是相关领域的基础知识，相当于扩展自己的见识？期末大作业有点肝，要求3000字论文或者一篇论文翻译+概要PPT，平时有一次小作业以及一次物联网相关领域的展示。最后个人给分还行，仅供参考
129595,207,叶炜,2021-01-08 07:34:09,8,12,4,嵌入式系统建议选其他教学班
136880,207,叶炜,2021-06-27 10:34:37,4,6,2,嵌入式系统建议选其他教学班
142627,207,叶炜,2021-11-15 00:10:59,1,2,1,被卡绩了...狠狠难受住
153104,207,叶炜,2022-04-25 13:18:40,10,11,1,物联网。\n\n作业都认真写了，小组展示还被助教选为优秀展示，结果3.9，给分巨差。
161560,207,叶炜,2022-11-09 05:36:39,0,0,0,上课不知所云，给分烂的一披
162549,207,叶炜,2022-11-25 06:06:41,3,3,0,智能设备给分真烂
182832,207,叶炜,2023-11-20 13:34:31,1,1,0,物联网与信息系统。作业都认真写了，小组上台展示，结果3.9，给分差差。
189075,207,叶炜,2024-01-21 15:05:35,2,3,1,物联网与智慧系统，1.5分的通识课事情也太多了，给分也很一般
190720,207,叶炜,2024-03-16 01:52:14,4,4,0,嵌入式一节课121页ppt，一节课过了数电几乎所有的重要内容，目前体验非常不佳
201291,207,叶炜,2024-10-31 06:57:24,0,0,0,嵌入式高级实验，结题展示一开始好好的，后面突然开始怼人，前面的做很烂都温柔地放过了，后面的就被各种挑刺。服气
204451,207,叶炜,2024-11-27 05:57:39,2,2,0,物联网期末被杀绩，全班最高了也只有4.2
3547,290,黄平捷,2015-06-17 01:31:23,11,13,2,真是降低智商的过程
20929,290,黄平捷,2016-02-04 09:34:46,11,12,1,呵呵，与众不同的笑点
48949,290,黄平捷,2017-03-18 03:22:19,14,14,0,感觉他啥都不懂，净瞎讲
91603,290,黄平捷,2018-12-15 10:18:12,4,4,0,自己成天混的不行，啥也不会，就知道催学生赶紧做，啥也不管，就天天催，还一副娘娘腔，不知道能不能把这老师开除了？
104084,290,黄平捷,2019-03-25 23:59:37,43,47,4,业务能力不如蔡徐坤
104361,290,黄平捷,2019-03-19 00:36:44,10,10,0,呆子老师，上课讲不清楚还喜欢瞎几把提问，请问老师，问的东西和上课有关吗？说拖进度请老师自己想想为什么
105263,290,黄平捷,2019-04-09 01:31:11,7,7,0,不知所云，从来就没听懂过他讲的课，还经常随机点名提问一些奇怪的问题
105285,290,黄平捷,2019-04-09 06:41:50,6,6,0,自以为是，不是自己专业领域还不懂装懂，不认真听同学想法，毁人不倦
108936,290,黄平捷,2019-06-04 11:24:16,1,1,0,垃圾课
109380,290,黄平捷,2019-06-13 14:22:06,4,4,0,csb
109906,290,黄平捷,2019-06-20 06:10:01,2,2,0,见过考试前让同学猜自己考试会考多少分的吗？没见过请选他的课，还说什么要满绩去私下找他（？？？
109917,290,黄平捷,2019-06-20 07:18:57,4,4,0,这铁憨憨会上课？真的孤儿你讲尼玛？
110112,290,黄平捷,2019-06-23 08:19:43,2,2,0,请看到这条评论的同学退了他的课去选另一个老师，不然你会后悔的
110192,290,黄平捷,2019-06-24 09:54:48,2,2,0,搞笑，呵呵\n\n不是喷就是一堆废话
114276,290,黄平捷,2019-07-09 17:12:03,1,1,0,铁憨憨 会上课不？问个傻逼问题 莫名其妙以为自己很厉害 天天拖进度 上你课真的遭罪 那是真的牛皮
114821,290,黄平捷,2019-07-12 01:07:23,1,1,0,简单的知识讲很多遍，难的知识一带而过，一定要换老师，听他的课很煎熬。。。
115625,290,黄平捷,2019-08-11 11:16:59,6,6,0,听老师的课如同看小丑表演一般
117391,290,黄平捷,2019-09-24 01:19:53,5,5,0,控院“本能帝“
117639,290,黄平捷,2019-09-27 06:32:54,1,2,1,一节课提问三次电离的概念
117888,290,黄平捷,2019-11-10 05:39:28,2,3,1,傻逼哦尼玛的故意说没考的要考骗学生，有你这样的老师吗
119020,290,黄平捷,2019-11-09 13:55:01,0,0,0,呵呵。
119024,290,黄平捷,2019-11-10 02:06:15,2,3,1,别的不说了，考前加压是真的强，又要开始熬夜了(◔.̮◔)。考后回来修评，考试周两大笑话，冰舞哥和平捷哥
119025,290,黄平捷,2019-11-09 15:34:21,10,11,1,有一说一，考前最后一天组织答疑，有用的东西一点不讲，搞些边边角角的东西还不讲清楚，搞人心态是真的牛批。哦对了，提问加0.1分简直是行为艺术
119044,290,黄平捷,2019-11-10 02:35:08,1,1,0,那个说要熬夜的，没必要。要问为什么，今天八点考卷发下来你就懂了。
119099,290,黄平捷,2019-11-10 09:41:46,1,1,0,憨是真的憨
128150,290,黄平捷,2020-12-08 23:20:22,-35,5,40,二逼，草泥马，老子第一次绩点比课程均绩要低，你妈死了
136036,290,黄平捷,2021-06-10 02:39:21,3,3,0,有毒，快跑啊
139432,290,黄平捷,2021-07-15 11:59:36,4,4,0,什么狗吧
139433,290,黄平捷,2021-07-15 11:59:56,2,2,0,奉劝大家快跑
152060,290,黄平捷,2022-03-24 10:04:39,-1,5,6,捏麻麻石蜡捏麻麻石蜡捏麻麻石蜡捏麻麻石蜡捏麻麻石蜡捏麻麻石蜡捏麻麻石蜡\n\n据说手下phd读8年最后去送外卖  捏麻麻石蜡捏麻麻石蜡捏麻麻石蜡捏麻麻石蜡捏麻麻石蜡捏麻麻石蜡捏麻麻石蜡捏麻麻石蜡捏麻麻石蜡捏麻麻石蜡捏麻麻石蜡捏麻麻石蜡捏麻麻石蜡捏麻麻石蜡捏麻麻石蜡捏麻麻石蜡捏麻麻石蜡捏麻麻石蜡捏麻麻石蜡捏麻麻石蜡捏麻麻石蜡捏麻麻石蜡捏麻麻石蜡捏麻麻石蜡捏麻麻石蜡捏麻麻石蜡捏麻麻石蜡捏麻麻石蜡捏麻麻石蜡捏麻麻石蜡捏麻麻石蜡捏麻麻石蜡捏麻麻石蜡捏麻麻石蜡捏麻麻石蜡捏麻麻石蜡捏麻麻石蜡捏麻麻石蜡捏麻麻石蜡捏麻麻石蜡捏麻麻石蜡捏麻麻石蜡捏麻麻石蜡捏麻麻石蜡捏麻麻石蜡捏麻麻石蜡捏麻麻石蜡捏麻麻石蜡捏麻麻石蜡捏麻麻石蜡捏麻麻石蜡捏麻麻石蜡捏麻麻石蜡捏麻麻石蜡捏麻麻石蜡
152365,290,黄平捷,2022-04-07 02:32:48,1,1,0,快跑！
152369,290,黄平捷,2022-04-07 03:36:46,1,1,0,吐了。。
174145,290,黄平捷,2023-06-06 15:23:35,-7,3,10,计控hpj神中神！有免费的午餐！儿童节还给每人发六块一红包！
182423,290,黄平捷,2023-11-16 02:45:35,9,9,0,首先，恭喜你捡到宝了，一个说“我从来不点名”和“这次随堂小测（交手写纸，包括学号姓名）算点名”中间时间不超过15分钟的人，一个在复习课上说“最好手写，但是不手写也不会强制检查”，结果考试前30个h的时候，在钉钉群发了一大段话，表示巡考人员要查，“我们约定手写A4”。上课巨抽象无比，喜欢随机点人回答问题，一节课讲一张PPT，是一张思维导图，占10%内容，剩下90%全靠自学。\n\n再次提醒，你捡到宝了，控院评分最高的老师，不是没有原因的。“引用自贾平凹《丑石》”
182533,290,黄平捷,2023-11-17 10:05:19,0,2,2,6666
182540,290,黄平捷,2023-11-17 09:17:51,1,1,0,好好好这么好
182542,290,黄平捷,2023-11-17 09:49:53,0,0,0,唉真服了
182544,290,黄平捷,2023-11-17 10:20:47,10,10,0,还不如原神教会我的东西多😋
182568,290,黄平捷,2023-11-17 14:35:08,3,3,0,大家攻击阿龙的时候不用替他担心，他叠甲叠得轻车熟路，答疑让人提问都知道先说句“大家不要说攻击性、侮辱性的话”“大家不要讲违法的事”，咱学生没那个击穿护甲的能力，可以放心攻击
182569,290,黄平捷,2023-11-17 14:35:34,3,3,0,非常坏老师，恨来自玉泉
184494,290,黄平捷,2023-12-21 02:14:43,16,17,1,必须10分。年少不知阿龙好，错把高飞当成宝。选择阿龙早上9点打卡下午3点下班。每天只让学生工作5-个小时的老师，再坏能坏到哪里去呢？
185408,290,黄平捷,2023-12-29 02:30:19,0,0,0,爱小测
185417,290,黄平捷,2023-12-29 04:18:30,2,2,0,快逃！！！！！上到第15课，小测了8次（每节课小测10～30分钟不等），剩下没测的是另一位老师上的，难评\n\n上课不讲知识，一直在提问，某次坐在最后一排最靠边的位置一节课被提问3次\n\n一直问些奇奇怪怪的问题，“xxxx请举手”，举手了还会走过来跟你握手，见过最抽象的老师，没有之一
189539,290,黄平捷,2024-01-25 09:44:11,4,7,3,虽然黄老师讲课的水平不是特别好，但对学生很友好，人也特别好说话，而且给分很好，1.6的评分过低了
190408,290,黄平捷,2024-03-01 06:38:02,0,0,0,很想活跃课堂氛围的老师
190410,290,黄平捷,2024-03-01 08:29:25,0,0,0,还可以吧
190490,290,黄平捷,2024-03-05 14:53:00,1,2,1,老师业务能力确实可能不太行，但是人还是不错的，主要给分不错
213739,290,黄平捷,2025-01-20 05:18:42,-10,2,12,虽然上课方式比较与众不同，但老师人还是不错的\n\n平时小测还是有用的，而且跟老师说会了，他就会帮你登记成满分\n\n\n\n传感最后平时分拉满了👍
217031,290,黄平捷,2025-03-31 13:59:03,1,1,0,呵呵。
217299,290,黄平捷,2025-04-08 01:49:02,3,3,0,豪赤🤪🤪🤪🤪🤪
218951,290,黄平捷,2025-05-15 03:56:34,3,3,0,幽默。
220671,290,黄平捷,2025-06-19 07:03:40,2,2,0,阿龙经典语录整理（持续更新）：\n\n1、考前有同学问阿龙：PPT上说验算调节阀开度92（要求小于等于90），但又工程上可用，如果考试遇到这种类似情况怎么办？\n\n阿龙：你可以跟负责的工程师商量一下，或者你把标准改一下。
2413,292,刘山,2015-04-29 13:08:14,1,4,3,从来不点名。讲课听不懂。
3691,292,刘山,2015-06-17 02:18:31,0,5,5,上课认真，点名为平时分
57195,292,刘山,2017-07-06 04:01:39,1,2,1,上课还好，给分呵呵
64222,292,刘山,2017-12-21 15:25:00,4,5,1,给分超好！
64505,292,刘山,2017-12-24 16:14:22,1,1,0,一一一
73696,292,刘山,2018-02-02 16:45:40,1,1,0,上课接到电话会去回，别的方面都是比较好的老师。
84010,292,刘山,2018-07-11 17:32:42,11,11,0,数值事情暴多，一周两个报告，太肝了\n\n给分还不错吧，均绩4.2摆在那\n\n老师还是很认真的，但我们的水平达不到他的预期，感觉上数值课很多都弄不透彻
84032,292,刘山,2018-07-12 01:26:18,1,2,1,数值事情贼多，半个学期下来两万加的报告。这门课本来应该是偏数学算法的课，但实际效果就是公式的matlab实现。不过对熟练matlab是有一些好处的，如果夏学期课不多可以选一下。
124765,292,刘山,2020-07-08 14:24:37,0,0,0,给分不错
124771,292,刘山,2020-07-09 01:14:48,2,3,1,给分贼好！夏学期半个班谢谢老师，感觉基本全员满绩，虽然事情确实蛮多的但好像这门课就是这么设定了，并不是老师的缘故
124772,292,刘山,2020-07-09 02:06:38,4,4,0,老师很可爱的，上课按照ppt讲，但是大致的原理还是会提及的，具体的推导老师也会提醒让我们课后看书，作业难度也不算太高，但注意要听清楚课上老师的要求，比如必须要用哪些方法进行计算，而不是自己觉得用哪些方法就ok了。大作业主要就看有没有用到课上讲的东西吧，还有选题是否有意义、是否新颖，不用搞地特别复杂。最后给满了，还是谢谢老师（但不至于像楼上说的全员满绩啊喂，也不看看以前学习帝的数据）
124815,292,刘山,2020-07-10 09:48:32,2,2,0,老师讲的我觉得蛮好，思路清晰，课程作业量比较多，给分不错，好老师！
135973,292,刘山,2021-06-07 03:49:23,-2,1,3,不太好
144195,292,刘山,2021-12-20 08:18:27,2,2,0,刘老师上课讲的很认真很好，部分作业和考题偏难，鼓励大家多思考和创新，认真去实践和思考确实能学到很多，在机器人方面能打下很好的基础
152377,292,刘山,2022-05-18 01:18:22,6,10,4,数值计算方法。每次作业都独立写，大作业写四百多行最后86。。。
153174,292,刘山,2022-04-26 10:58:25,3,3,0,机器人建模与控制，对于这种很需要逻辑推导的课程，老师讲课真的很细致，推导的时候甚至可能把自己绕进去（莫名有点可爱），这样反而课程进度更友好，更贴近初学者的思考模式，如果上课不犯困认真听的话，还是能跟上课程进度的。
153965,292,刘山,2022-05-18 06:52:03,0,1,1,给分不错
153998,292,刘山,2022-05-18 15:40:59,2,2,0,给分好，一周1-2份报告比较难顶，自己独立写，参考过CSDN，按照格式，说清原理和画好流程图，给分不错，大作业不需要特别难，选一些上课内容涉及的题目，给分就不错，虽然没满但是也给过90了。还是很不错的老师，就是上课有点困。
154119,292,刘山,2022-05-24 02:13:39,-2,0,2,这门课作业确实很多，但是对于熟悉matlab还是有帮助的，给分不错
154808,292,刘山,2022-06-05 14:40:56,-1,1,2,。。。。
165851,292,刘山,2023-01-10 06:11:41,15,18,3,智控真的是控院上课拧螺丝，下课造飞机的典型代表了，老师理论知识讲的很好，但是作业真的太痛了。。。
167730,292,刘山,2023-01-18 15:58:41,4,9,5,智控给分很好，就是这课太硬太痛苦了，四个小作业一个大作业
167960,292,刘山,2023-01-20 17:25:40,0,3,3,智能控制技术这门课主要学习了模糊控制和神经网络控制，内容比较硬，作业也比较困难，不过还是挺有收获的，可以加深对于控制方法与策略的理解。刘山老师很认真，理论部分讲得很细致，就是让人容易感觉有点犯困，22-23冬学期这次给分不错。总体来说还是值得一上的课程。
174448,292,刘山,2023-06-12 08:56:51,1,1,0,数值事情非常多，一周两篇报告且难度不小，不过老师人还是挺好的，认真做完给分也不错
185096,292,刘山,2023-12-26 07:57:33,18,18,0,比隔壁班作业多一倍，1.5学分的课上出3学分的效果，实在垃圾🤮🤮🤮🤮🤮🤮🤮
189922,292,刘山,2024-02-02 10:46:57,0,1,1,给分很不错的，作业是有点多，但也算是有收获的一门课
192344,292,刘山,2024-05-16 05:20:59,2,3,1,机建给分确实行，不点名，不小测。期末考试好几道题不会做，空了很多，最后还能89/4.5，不卡绩。大学本科最后一门硬课就这样结束了
192496,292,刘山,2024-05-22 03:45:28,3,5,2,【数值计算方法】\n\n点名：印象中似乎没有\n\n上课：感觉有点催眠有一说一。看ppt即可\n\n作业：四篇ddl一天的上机报告和五篇ddl一周或者两周的课后作业，个人认为按照ppt的指示其实难度并不大，但工作量确实很大毕竟要写一篇完整的报告\n\n大作业：个人认为难的是选题不是方法，方法其实很多都是用自己之前课后作业的程序，但找到一个新颖、有研究价值且难度又较为合适的选题确实非常不容易\n\n给分：个人认为给分还不错\n\n总体：还是能学到不少东西的，但作业量确实不小，给分不错。建议期中压力较小的同学选
193025,292,刘山,2024-06-02 15:16:36,0,0,0,数值，给分说好不好，说差也不差，不点名，一般吧
204851,292,刘山,2024-11-28 06:33:33,2,2,0,智能控制技术，作业很抽象\n\n另外是会点名的。。今天就在第二节课上课期间雷达突击点名
205601,292,刘山,2024-12-10 04:11:58,3,4,1,助教打分随意，而一次作业就占很多总评，可以说令人厌恶
206331,292,刘山,2024-12-14 09:58:10,4,4,0,给分很差
208404,292,刘山,2024-12-27 11:08:49,12,12,0,智控这作业真抽象吧。。
211829,292,刘山,2025-01-12 15:50:10,5,6,1,智控大作业做破防了，来这里留个言。。\n\n这作业跟上课上的有半毛钱关系吗。。实验可以认为毫无指导，关键是自学都不知道要上哪学，体验实在是太糟糕了。\n\n1.5学分的课上出3分的感觉
213648,292,刘山,2025-01-18 23:32:49,-12,1,13,还可以吧
213846,292,刘山,2025-01-21 06:32:28,14,14,0,分出了更一下，总评喜提所有专业课最低，这课建议关了…\n\n查了一下作业给分依托且作业和上课毫不相干，体验远不如隔壁电控，电控至少考试分数是能掌握在自己手上的，这课简直一言难尽！！打一分是因为没有零分，千万别选
213889,292,刘山,2025-01-25 03:10:15,14,16,2,很恶心，老师给的评分标准我认为助教根本没有参考，作业的平均分不到8分，也没有任何反馈说出问题在哪里。大作业给分可能更差。而且在一次作业分数超过10分的情况下，助教给分只会批发7 8 9而不是百分制或者按照作业的原始分给分。可以说你的分数根本不掌握在你身上\n\n\n\n上课和作业基本没有关系，有些作业要学的内容在网上很难找到资料。事情很多，非常不推荐，就是既累又被恶心\n\n\n\n楼下问作业什么样子？我怎么知道？既然你同学知道自己作业分，那拿着插件看不到班上平均分吗？要我夸你们很棒吗\n\n\n\n编辑为“啧啧啧”那位，原话可是好奇一下不到8分的作业是什么样子身边的都是9分以上。至于另一位说的平均分，可以看98上的有人分享的插件，插件可以查看学在浙大作业分数和最高分最低分平均分。去掉0分的作业打分显然也是不好的，不然没道理这里这么多人。都大三了控院有几门课会有一堆同学写查老师评论呢？
213894,292,刘山,2025-01-21 05:01:17,6,7,1,千万别选
213900,292,刘山,2025-01-21 05:40:50,11,11,0,智控给分一坨
213903,292,刘山,2025-01-21 06:51:25,9,9,0,智能控制技术，课程教授方法感觉较脱离主流方法，讲课比较难顶，作业非常不符合学分，不是很建议。给分貌似，，也没有那么好，不知道是不是换了助教？
213927,292,刘山,2025-01-22 12:45:13,-5,2,7,啧啧啧
213983,292,刘山,2025-01-22 11:21:32,0,2,2,智能控制技术真是神课。
214041,292,刘山,2025-01-23 07:09:08,2,3,1,【24-25冬 智能控制技术】\n\n楼下的“作业的平均分不到8分”和“在一次作业分数超过10分的情况下，助教给分只会批发7 8 9”不知道真假哈。如果的确是基于事实的话麻烦放一下来源，不然有因分数低而泄愤的嫌疑。老师讲课8分水平吧，属实没有21级及以前的学长学姐说的那样好。智控这门课也一般……如果一门课是以自学为主 且课程组不能起到什么作用的话，我觉得需要考虑一下这门课存在的意义，或者反思一下教学质量（？）。尽管控院多数课都是这样的螺丝-火箭性质的课。
216707,292,刘山,2025-03-21 13:13:29,3,3,0,吐槽一下逆天助教lyj，24-25冬学期智控可以说是事多分低，不过老师只负责讲课，而课程给分90%取决于助教的给分，确实助教有很大的锅。\n\n当时出分时候我还在反思自己的问题，直到我到24-25春学期的周三机器人建模控制实验课再一次遇到了助教lyj。这个实验一句话的指导都不给，6点30到教室就说“做好的来验收”，这不是逼着我们抄学长的代码吗？？？您确定轨迹规划实验一个晚上没有任何指导是能做出来的？？？周一晚上周春琳老师的实验班级老师和助教至少讲解了半个多小时，到周三一句话指导都不给，不知道老师和助教在想什么。。。
218902,292,刘山,2025-05-12 08:37:06,2,3,1,数值计算方法：这课工作量较大，每周有一篇matlab报告要写，这个比较费事，有一篇小报告是上机作业，这个贴代码贴结果很快能解决，最后一个大作业自己选题自己用课上算法解决。但是给分还算厚道，基本上报告你写的详实一点，把图表、格式、包括那些公式都自己打出来会显得你极其认真，最后大作业也是多多分析，多多写字，不需要你有多强的工科数学底子，写细了 把点都覆盖到了再美化下格式助教就给你高分。我个人觉得这门课拿分就要摆出认真的态度，就ok了。老师讲的不太清楚，不过照ppt抄，再用ai生成就足以应对所有作业。其实比那些上课很水，分数随机给，该拿投入时间多的拿低分，压根不学的拿高分的课强多了
219123,292,刘山,2025-05-22 03:12:05,4,4,0,看到挺多人吐槽助教的，我20级，和他是同届，他给我的感觉的确是不太好相处，有点看不太起其他学生，尤其是自动化专业的，因为他自己是竺院机器人，绩点排名也挺靠前。\n\n至于刘山老师，我觉得真的真的是一个很好的老师，本科阶段收到了他不小的帮助
219931,292,刘山,2025-06-11 10:16:45,0,0,0,控制学院为数不多的认真对待本科生授课的老师，大作业相对来说比较多，但是如果确保准确和工作量，给分是好的。在混乱邪恶的控制学院，已经是为数不多的善良守序的老师了。
32851,328,周春琳,2016-07-18 16:43:38,0,1,1,无法评价
49268,328,周春琳,2017-04-01 00:52:28,-3,1,4,好好ヾ ^_^♪
78330,328,周春琳,2018-05-11 02:33:37,1,1,0,他的助教啥都不懂，醉了
85443,328,周春琳,2018-07-18 02:15:36,12,16,4,轮式一个长学期老师来了3次，其余时间是根本不怎么管的研究生助教，求求周老师别开这门课了，自己不想上也就算了 不要再坑学生了 轮式机器人有几个是好的你心里没点b数吗？自己到底教了学生什么 你心里没点b数吗？不管不问 自生自灭 最后绩点贼低
108401,328,周春琳,2019-05-23 02:47:46,3,4,1,老师很帅
116602,328,周春琳,2019-09-12 03:14:07,0,1,1,虽说老师真的神龙见首不见尾，但是好像给分还行？
128186,328,周春琳,2020-12-11 03:28:36,4,5,1,不只是一个工科老师
128188,328,周春琳,2020-12-11 04:48:52,5,5,0,人文情怀
128189,328,周春琳,2020-12-11 05:54:50,8,8,0,三观很正，讲课还不错，很有想法的老师
129506,328,周春琳,2021-01-06 11:33:04,5,5,0,上课很有趣
168374,328,周春琳,2023-02-14 15:08:33,9,9,0,双足机器人的给分是认真的吗？
169411,328,周春琳,2023-02-26 03:53:40,0,0,0,双足被薄纱留\n\n学弟学妹加油
171797,328,周春琳,2023-04-06 01:58:02,4,4,0,周老师人真的很好！！对学生特别细心，说话很温和，又很有思想，真的是我理想中学者的样子！！
218934,328,周春琳,2025-05-13 15:07:37,1,1,0,机器人导论上的很好
7688,357,赵豫红,2015-09-15 09:04:58,4,4,0,温文尔雅
114822,357,赵豫红,2019-07-12 01:08:28,10,10,0,老师不错
130011,357,赵豫红,2021-01-15 02:17:12,5,5,0,老师很nice。自控12都是赵老师的，讲的很清楚给分也不错。自控毕竟是主干课，学弟学妹想要学好，也请务必努力！
132872,357,赵豫红,2021-02-04 09:22:13,1,3,2,老师太好了！自控课太棒！
144760,357,赵豫红,2021-12-23 12:49:11,-1,2,3,给还要
152735,357,赵豫红,2022-04-19 05:17:53,7,8,1,老师讲课很好，思路清晰，人也很不错
153964,357,赵豫红,2022-05-18 06:41:08,10,10,0,我能做的唯有给你满分
153991,357,赵豫红,2022-05-18 13:27:40,0,1,1,老师讲课很好，给分也很好
154040,357,赵豫红,2022-05-20 04:19:00,2,2,0,嘿嘿嘿
154098,357,赵豫红,2022-05-23 06:19:05,3,6,3,不许和我抢zyhjj（悲
154099,357,赵豫红,2022-05-23 06:20:47,3,3,0,能选上zyhjj的课是我的福气
154100,357,赵豫红,2022-05-23 06:25:23,5,5,0,豫红姐姐我的超人！！我爱你！！！！！！
157842,357,赵豫红,2022-06-25 05:44:16,1,1,0,yhjj我的超人！！！讲课好，不要怕小测因为小测给分很好（推测是给满了，虽然我感觉自己错的一塌糊涂），平时分给的很好，期末很捞，我爱yhjj！
159592,357,赵豫红,2022-08-21 10:49:35,0,0,0,哈哈哈
161194,357,赵豫红,2022-11-17 05:58:24,0,1,1,偶吼吼，现控加油ヾ(◍°∇°◍)ﾉﾞ\n\nyhjj是不是在捞我QAQ
162216,357,赵豫红,2022-11-18 01:54:25,0,1,1,感谢yhjj把我自以为炸了的现控捞回来了，上课很温柔，而且讲课很清晰(希望控院其他老师学习一下
162537,357,赵豫红,2022-12-09 12:50:49,2,3,1,讲课清晰易懂，待人温柔善良。感谢豫红姐姐从春学期到秋学期的一路指导！
174469,357,赵豫红,2023-06-12 20:25:33,8,10,2,数值计算方法给分并不好
175678,357,赵豫红,2023-06-26 07:30:19,5,6,1,数值计算给分一般，作业很多，但是学到了很多东西，老师上课也上的很好
181263,357,赵豫红,2023-10-12 11:48:26,2,3,1,已经大四了，才想起来没有给赵老师打过10分的好评，特来打好评。\n\n控院的现代控制理论和数值计算方法是跟着赵老师学的。赵老师上课讲的很清楚，她是学院为数不多能讲清楚课的好老师。
197833,357,赵豫红,2024-08-15 13:41:20,4,5,1,自控（甲）满绩前来还愿\n\n讲课清晰，ppt和作业安排合理\n\n控院大二下体验最好的一门课和最好的老师！
200815,357,赵豫红,2024-10-23 01:47:13,0,1,1,好！考研专业课复习都是看老师回放的！
201295,357,赵豫红,2024-10-31 07:42:27,0,1,1,预置的yhjj，好幸福
201709,357,赵豫红,2024-11-21 04:45:25,5,7,2,现控无论是从课程内容安排、作业安排，还是老师的教学态度以及教学效果来看都是自动化大三上最正常的一门课，必须给老师一个10分好评！\n\n只不过期末考的计算量实在是太大了，没什么思维含量就是带参高阶矩阵计算，实在不太能理解为什么要出成这样，不知道出分会不会很惨烈……希望课程组改进一下吧。\n\n出分了，确实比较惨烈。。。
219587,357,赵豫红,2025-05-30 09:58:04,0,0,0,数值讲的一般般吧，没有以前说的那么好\n\n最后一次课下课点了一次名\n\n给分还不错
221973,357,赵豫红,2025-06-28 07:09:56,0,0,0,讲课不错，老师很温柔，不过略微有点催眠，PPT有一说一有点花花绿绿了，给分不错，也没有实质上的点名，综合来看就是这门课最优解。
25031,397,姜伟,2016-05-05 02:24:14,3,3,0,男神，讲的仔细负责，很照顾同学们
50229,397,姜伟,2017-05-01 15:49:24,0,0,0,好好好
50735,397,姜伟,2017-05-04 15:58:00,0,0,0,平时作业认真做 给分还不错
57806,397,姜伟,2017-07-24 05:48:18,0,1,1,很水的
74733,397,姜伟,2018-03-05 10:28:44,2,2,0,机器视觉只在差不多最后一节课点过一次名，平时上课讲的还可以，有三次平时的作业和最后的大作业
78436,397,姜伟,2018-05-11 17:25:15,0,0,0,老师人很nice\n\n
116239,397,姜伟,2019-09-06 13:15:58,0,0,0,还好吧
124488,397,姜伟,2020-07-02 01:30:57,0,0,0,给分很高的
125770,397,姜伟,2020-09-14 06:49:02,0,0,0,还不错
125813,397,姜伟,2020-09-14 11:48:30,0,0,0,真是好老师！
126878,397,姜伟,2020-10-26 12:01:32,0,0,0,找不到这么好的老师了，有风骨。教的好，考的少，给分好
127921,397,姜伟,2020-11-30 09:46:04,0,0,0,男神！！！老师人超级温柔，数据结构讲的很详细，小白友好，好好听课做作业最后收获很大！平时不需要花太多时间，但学的东西很实用，爱了爱了！
127940,397,姜伟,2020-12-01 00:57:02,0,0,0,讲的好，给分也好
133124,397,姜伟,2021-02-09 03:12:56,11,12,1,很有学者的气质，讲课 作业也挺好的\n\n缺点是ppt做的不够简洁，重点不突出\n\n\n\n建议机器视觉单独开课，和刘勇的机器学习放在一起直接拉低了课程好感度
143512,397,姜伟,2021-11-26 02:09:33,1,1,0,老师给分太好了吧，讲课也很好，作业不多，吹爆姜伟老师
143575,397,姜伟,2021-11-27 12:21:45,0,0,0,超级好
143577,397,姜伟,2021-11-27 13:09:20,1,1,0,很有学者气质，儒雅随和，对学生很好，作业什么的都可以商量，对完成度要求也不严格，更在意学生能不能学到东西，非常好的老师！
150139,397,姜伟,2022-01-19 09:31:19,0,0,0,好老师必须10分
153173,397,姜伟,2022-04-26 10:53:52,0,0,0,数字图像处理  选到就是赚到
178475,397,姜伟,2023-07-12 06:40:45,0,0,0,数字图像处理，总共2次小测6次作业，上课ppt内容很多但掌握老师划的重点即可，给分不错
182600,397,姜伟,2023-11-18 04:21:00,1,1,0,数据结构，对小菜鸟很友好的课，给分很好，考试内容基本都是上课讲的，平时作业压力也不是很大。老师很温柔，好老师必须10分！
182628,397,姜伟,2023-11-18 13:02:22,0,0,0,十分，雷达点名一次，小测（伪）点名一次，期末考的全是课件，给分巨好
195710,397,姜伟,2024-06-29 17:18:50,0,0,0,点名占比太大
199608,397,姜伟,2024-09-26 07:49:01,2,2,0,9.几的评分还是高了\n\n数据结构课讲的实在一般
201417,397,姜伟,2024-11-02 09:10:05,-1,0,1,好老师
202445,397,姜伟,2024-11-12 23:37:56,1,1,0,数据结构讲的不错，内容不深，很简单，给分很好，第七次课点了一次名
202451,397,姜伟,2024-11-12 23:53:31,0,0,0,好好好
217041,397,姜伟,2025-03-31 16:20:41,0,0,0,儒雅，男神
107840,480,徐正国,2019-05-22 07:33:34,4,4,0,还可以，老吓人
107841,480,徐正国,2019-05-10 10:42:52,-4,0,4,挺可爱，但是课讲得一般般
116407,480,徐正国,2019-09-10 02:41:16,17,18,1,还可以的
126445,480,徐正国,2020-09-27 04:32:52,0,0,0,小聪明
137017,480,徐正国,2021-06-29 12:01:21,10,10,0,自控甲 \n\n讲的挺清楚，而且事少，整个学期小测一次没有讨论
144758,480,徐正国,2021-12-23 12:47:06,-1,0,1,嘤嘤嘤
161903,480,徐正国,2022-11-15 02:07:00,3,3,0,老徐！
197669,480,徐正国,2024-07-26 07:18:41,4,4,0,上的徐老师的自控，课讲得挺好，重点突出，逻辑也挺清晰，老说要小测最后也没小测hh
201294,480,徐正国,2024-10-31 07:41:13,4,4,0,课讲的很清楚，最重要的是！老师说学自控就是告诉我们犯错了没有关系，通过反馈后调整就好，呜呜呜呜
5206,517,赵均,2015-07-06 00:41:14,1,3,2,上课只会念PPT，还会催眠。学生提问不会回答，含糊其辞。
50688,517,赵均,2017-05-04 09:48:00,1,1,0,从头讲到尾，没有一点废话时间。。将这么多课压缩到一个学期实在有点不人道
84660,517,赵均,2018-07-13 12:49:42,-2,0,2,讲的不错！给分也很好！
88347,517,赵均,2018-10-29 06:46:29,1,1,0,很好的班主任！
106823,517,赵均,2019-04-30 02:24:42,2,2,0,哈哈哈老师有点可爱，讲话有回音
107825,517,赵均,2019-05-10 06:32:24,6,6,0,自带回声效果
109680,517,赵均,2019-06-18 10:43:38,1,1,0,略微不太舒适
109776,517,赵均,2019-06-19 06:47:30,0,0,0,其实还不错啦，讲课还是很清楚的，催眠也是真的，自带回声也是，中规中矩还不错的老师。
114371,517,赵均,2019-07-10 00:05:09,0,0,0,谢谢老师抬一手 本来以为必挂无疑都想缺考了呜呜呜
139134,517,赵均,2021-07-13 03:52:30,-2,1,3,给分还可以
144751,517,赵均,2021-12-23 12:29:58,0,0,0,i哦姐姐
155736,517,赵均,2022-06-15 12:09:32,0,0,0,信号还没考，希望老师捞捞
156175,517,赵均,2022-06-23 03:26:37,4,5,1,总体还好，就是上课催眠，分还没出，希望老师能海底捞！！！拜托了\n\n出分了！老师你是我的神！本来以为大概率挂科，没想到分数还看的过去
157321,517,赵均,2022-06-23 03:28:44,1,3,2,给分太好了，浓浓师生情！
157322,517,赵均,2022-06-23 03:33:05,1,3,2,上课虽然有点催眠，但……真的海底捞好吧！\n\n同时赞美助教ly老师，平时分应该是给的很好的！
157323,517,赵均,2022-06-23 03:34:11,-6,3,9,信号分析与处理，上课不用听，不如看ppt或者看书。\n\n给分超级超级好，期末考两道大题瞎写，本来以为会下4没想到4.8，平时分应该也是拉满的，所以做大作业不用有心理压力，自由发挥就ok，给分特别好！\n\n课程安排是每周小作业+一次四人大作业+期末考，期末考卷子上只给五种变换的公式和傅里叶变换的其中几条性质，所以绩点主要靠期末考前女娲补天使劲背）
157325,517,赵均,2022-06-23 03:35:50,0,0,0,好老师～虽然上课我一直想睡觉 但老师上课很认真的
157330,517,赵均,2022-06-23 03:41:31,0,1,1,不点名，可以不听课甚至不去，但是给分真的超好呜呜呜，被狠狠捞了www
157333,517,赵均,2022-06-23 03:50:04,-2,0,2,老师给分真的太好了
157377,517,赵均,2022-06-23 05:36:33,-2,0,2,老师给分实在太太太好了！
157690,517,赵均,2022-06-24 10:39:48,-2,1,3,老师给分好好啊~
176693,517,赵均,2023-06-29 17:25:06,12,13,1,老师企业自动化给分超好，就是这课居然两天早八难顶（虽然也不点名（狗头）
178474,517,赵均,2023-07-12 06:33:38,-1,3,4,上过两门课，信号和企业自动化。老师讲课一般，信号事情略多，企业自动化几乎没有事情，都不点名，给分都很好。
195850,517,赵均,2024-06-30 10:02:04,5,8,3,这给分也不行啊，不明白评分依据是什么
195859,517,赵均,2024-06-30 11:07:14,-3,2,5,企业自动化，事少，给分还行
196044,517,赵均,2024-07-01 09:05:22,6,6,0,感觉给分很差。。
196696,517,赵均,2024-07-04 23:42:23,6,6,0,讲的一般，给分是真不行。感觉自己努力了一个学期，最后出分跟预期大不相符。
196775,517,赵均,2024-07-05 05:36:21,1,2,1,老师不调分不调分不调分！平时分没人给满，最低总评扣1.6。直接给我卡绩了88.4=88
196828,517,赵均,2024-07-05 10:54:51,3,3,0,信号。讲课一般，主要是PPT有点花而且使用的符号与教材、电院PPT不同。人挺好，作业上交宽松。\n\n\n\n貌似只有赵均老师班上有大作业，最后平时分是助教打作业和实验的分，老师打大作业的分，两个合在一起是平时分。助教那边今年给得不高（多数90以下），大作业估计也不会高多少，总得来说今年平时分大概没有多高。对比往年评论，这是黑化的开始？\n\n\n\nPS. 更推荐看张健的课以及找一套电院的PPT
196978,517,赵均,2024-07-06 08:10:46,11,11,0,不是我说啊，早几年控院各种专业课老师的评价是真的搞笑。点名计网ycj和大数据zch（这俩都是早年奇奇怪怪的刷评导致的评分虚高，然后在去年反转了风评），其余哪些老师我就不举例了，反正大家以后学专业课都会看到。一堆“老师好好啊”“老师好帅”“nice”“yyds”这种莫名其妙的短评，导致一堆体验其实一般般的老师评分莫名其妙的高。这些个摁舔的短评我是真不理解，你要说老师好，好歹说一下具体哪里好吧，就直接这样摁舔，我都怀疑到底前几届是不是有几个畜生故意这样刷的好评来恶心人，因为一堆自动化专业课老师下面都是这种奇奇怪怪的短评，给人很浓重的刷评味。很多老师明明综合来看是个6-7分的水准，早年总有一些畜生短评恶心人，强行把分数拉上去，这不就是欺负我们自动化的同学一般不喜欢写査老师老师评价吗？隔壁计院那么多喜欢写査老师评价的人，也没见自动化专业课早年那种摁舔的评价啊？\n\n\n\n说回赵均老师本身，给分的确一般，不能说好，也不能说差。结合我上过他的两门课（信号、企业自动化）的体验，综合下来就是：从不点名、事情少、给分普通，适合想划水的人去，综合给8分。
196998,517,赵均,2024-07-06 12:15:01,0,1,1,坐标信号，我自己的分数挺好的，但是结合已知的其他几个朋友，给分好像确实很差。讲课的话，很无聊很平淡，找不到什么教学上的优点。
197110,517,赵均,2024-07-08 01:00:26,0,0,0,上课无聊，给分没有预想的好，还有大作业
197234,517,赵均,2024-07-09 15:45:44,12,12,0,20级老东西偶然看到来留个言，zj老师20级的信号确实给分非常好，均绩在4左右，当时出分的时候同学们也都很高兴，并不存在刷分之类的事情。\n\n猜测大概是22级的助教换了，导致给分出现了很大的变化。zj老师本身很佛系，可能主要由助教给分，20级当时的助教ly学长也确实很好，还会钉钉私戳作业没写完的同学补齐作业，最后平时分大概也是给的挺好的。\n\n所以还是不能单凭查老师评分来选老师，只能说你院的本科教学随机性很大，还是平时认真学来提高鲁棒性了（
198399,517,赵均,2024-09-08 13:33:39,0,0,0,24年上的信号，上课确实不点名，作业、大作业也很水，但是最后给分感觉真的一般，主要是平时分给的差，大作业不知道怎么给分的，感觉平均都不高（甚至感觉是按照期末考分数来给的）
220152,517,赵均,2025-06-26 09:25:15,0,0,0,不点名，上课很一般，课件有一部分是控院原本信号与系统课改的，所以和电院不一样，其实质量还行，只能说各有优劣吧\n\n大作业答辩拷打有一点的\n\n今年给分确实好
220907,517,赵均,2025-06-20 09:52:50,0,0,0,智能制造与企业自动化，事情少，赵老师不点名，另一个老师点过一次名，平时作业就是一次读书报告+一次mpc，期末大作业是汇报+报告。给分我们组还不错，不知道其他同学怎么样。
221756,517,赵均,2025-06-26 03:50:45,0,0,0,虽然上课有点无聊但是给分好
9508,725,刘勇,2015-10-29 05:21:44,1,24,23,每次迟到1～10分钟不等\n\n下课时间拖延5分钟～提前45分钟不等\n\n每章节ppt长度2-100页不等\n\n但有一点是确定的：别选他课……
11769,725,刘勇,2015-12-14 15:31:25,5,9,4,点名的
22832,725,刘勇,2016-03-13 07:13:07,8,19,11,为什么不能打负分？
31137,725,刘勇,2016-07-03 09:10:13,0,1,1,上课H还是可以学到不少的
31760,725,刘勇,2016-07-05 01:26:25,3,3,0,全靠自学，经常提前下课，上课很无聊。
40475,725,刘勇,2017-01-03 14:19:35,2,4,2,不开心
60676,725,刘勇,2017-10-26 10:17:47,2,2,0,差评！
132672,725,刘勇,2021-02-03 09:04:18,2,2,0,讲课差评 给分差评
133122,725,刘勇,2021-02-09 03:16:27,3,6,3,控院本科生授课最差老师\n\n讲课毫无章法，随意更改课程时间
137045,725,刘勇,2021-06-30 03:27:58,3,3,0,上课的目的不是让不懂的学生听懂，不说人话，搞一堆抽象的概念在那里自嗨呵呵呵\n\n动不动就调课，差评！
144196,725,刘勇,2021-12-20 08:25:29,2,2,0,快逃快逃。。上课内容和方式一言难尽，随意调课，期末绩杀疯了
147750,725,刘勇,2022-01-10 16:14:58,3,3,0,救命 真的讲不明白 感觉对授课没有那么认真啊 钉钉也不及时回 ppt也不放 考前啥也不讲 不知道是课程组有大病还是老师有大病
154756,725,刘勇,2022-06-04 14:53:40,2,2,0,。。。
203965,725,刘勇,2024-11-22 09:04:09,10,12,2,上课挂名，本人从未出现过。本来想给2分的，发现不能点，那就1分吧。控制学院好好上课的老师不多，不好好上课的刘老师是典型代表。另外学生招一堆自己不管，可能也不认识，开题答辩自己挂个名人不到现场，只能说唯一的优点是不瞎指导。
208586,725,刘勇,2024-12-29 16:36:52,1,1,0,垃圾东西，课程挂名，一节课没见到过，钉钉里问课程消息也是已读不回，狗屎
217234,725,刘勇,2025-04-05 14:36:02,-1,0,1,科研大佬，组里发过两篇tro，但教学一言难尽
217244,725,刘勇,2025-04-06 09:44:29,0,0,0,上课懒得上，让组里硕士生上课被督导发现，天天出差换课，对本科生课程极度忽视
26387,762,卢建刚,2016-06-17 11:49:08,3,6,3,慎选…
26956,762,卢建刚,2016-06-22 02:03:39,-7,6,13,全英文的java 卷子也是英文的 讲课讲的比较清楚 关键是老师人很nice啊！
29210,762,卢建刚,2016-06-29 12:03:11,2,6,4,讲的还可以，但是给分呵呵
29379,762,卢建刚,2016-06-29 15:58:19,1,3,2,讲真根本听不懂，专业课给分比体育课还低，也是呵呵了
29555,762,卢建刚,2016-06-30 03:18:14,-6,2,8,老师很认真，很负责，好好听课好好看，肯定在4以上！\n\n但是如果不好好学，四十几分的人也有，不过是少数。
29844,762,卢建刚,2016-06-30 11:34:52,4,5,1,照着中文书念。何必上英文课
29988,762,卢建刚,2016-06-30 16:12:58,2,3,1,讲的真心辣鸡。自学花了好多时间。给分呵呵。大学最低分。
30239,762,卢建刚,2016-07-01 06:29:10,3,4,1,听老师上课很痛苦
58033,762,卢建刚,2017-07-25 02:45:52,1,2,1,老师课上的挺好，但是考试挺难的，光靠课件里的那些东西根本没法应付考试。平时成绩占了50%，所以总评还不错。
114782,762,卢建刚,2019-07-11 17:11:19,0,2,2,cnm，sb，我那么认真学最后80，恶心
114806,762,卢建刚,2019-07-11 23:57:36,3,3,0,我多么希望如果能给负分
114870,762,卢建刚,2019-07-12 06:49:55,3,3,0,JAVA给分太低，慎选
125460,762,卢建刚,2020-09-09 13:44:40,10,12,2,JAVA考试完全是文科考试，无聊的一批，考的都是没有任何营养的东西，讲课也很拉胯，感觉老师完全停留在十年前的技术，建议不要选
125843,762,卢建刚,2020-09-14 23:52:23,3,3,0,考试很迷，给分很恐怖
130898,762,卢建刚,2021-01-25 07:40:45,0,0,0,过时的技术，魔幻的考试，误人子弟
148111,762,卢建刚,2022-01-11 13:57:29,0,1,1,给分还行，老师改了大概哈哈哈哈
169854,762,卢建刚,2023-02-28 06:23:58,2,5,3,不知道为什么大家觉得卢老师不好，感觉老师巨好，平时分给的也很高，因为疫情，考试大部分都是ppt上的例题。作为一门选修课真的很友好，补天一天拿了4.2，感觉很不错的老师，讲课和说话都很温柔的。推荐缺学分的人可以选一下，作为小白入门java也是很好的。
214542,762,卢建刚,2025-02-12 01:21:34,2,2,0,建议真的要选的话，能保证其他更重要的课还忙得过来（模电、大物等），因为如果要学懂每周要花的时间不少，需要很多自学时间。我就是属于那种其他课来不及，学这个Java每周花了不少时间看课本做作业，但又急匆匆地潦草完事。实际上我上课即使听了，课后还翻课本，我也还是云里雾里。对于考试，最后的编程大题，只要好好看过ppt都没有问题，选择题会考一些语法的细节问题，填空题比较恶心。我复习了2个小时，最后写不出来提早交卷，得了三点几。
3065,778,周建光,2015-05-13 10:48:31,0,11,11,感觉老师讲的东西拓展了我们的思路大作业对我们的科研也有很大帮助
15447,778,周建光,2016-01-14 11:58:05,5,6,1,浪费时间，特别是大作业，大而泛之
24900,778,周建光,2016-05-04 09:16:09,1,4,3,均绩4.2的课程我拿了3.4，简直不敢相信_(:з」∠)_老师讲的还挺好的
25032,778,周建光,2016-05-05 02:25:11,-2,3,5,老师很注重培养我们的科研思想，大作业是一次很难得的机会。
48168,778,周建光,2017-03-01 05:12:20,1,2,1,666
50995,778,周建光,2017-05-11 09:46:58,1,1,0,给分全看个人喜好
50996,778,周建光,2017-05-11 09:47:12,-2,2,4,挺好的，能学到东西
51021,778,周建光,2017-05-14 03:32:36,1,4,3,评分不就看签到和大作业吗？全勤，大作业该干的也都干了，神提莫78分什么意思？
52230,778,周建光,2017-06-16 07:17:40,2,2,0,给分很随意神奇，慎选\n\n
58962,778,周建光,2017-09-19 01:45:09,14,16,2,垃圾..
59287,778,周建光,2017-09-20 12:35:13,0,0,0,好无聊啊，我想退课了
59678,778,周建光,2017-09-26 00:57:41,-4,1,5,是真的棒
71378,778,周建光,2018-01-28 11:11:08,-2,1,3,上的cps通识课，课程内容正好和我的其他课程相配，对思路拓展挺有帮助。老师也挺好的嗯。
112665,778,周建光,2019-07-04 23:54:37,2,2,0,均? 是4点多的课拿了3整，算垫底的了吧，给分全看大作业
126238,778,周建光,2020-09-21 09:34:25,-3,1,4,谢谢老师
126239,778,周建光,2020-10-03 13:58:55,-5,2,7,好老师，挺好的老师
154755,778,周建光,2022-06-04 14:52:44,1,2,1,。。。
162362,778,周建光,2022-11-21 02:30:51,5,5,0,让同学讲课真tmsb
162363,778,周建光,2022-11-21 02:51:00,4,4,0,垃圾老师，人机课让同学自主讲课，在同学讲课的时候疯狂打断，一点都不会尊重人。
162386,778,周建光,2022-11-21 10:56:35,1,1,0,去牛魔大酬宾
171167,778,周建光,2023-03-17 08:17:16,2,2,0,人工智能与机器学习，快逃！！！！！！！！
196628,778,周建光,2024-07-04 11:07:06,0,2,2,机器人智能感知分析，顶级好课，给分非常好
203761,778,周建光,2024-11-21 02:56:49,0,1,1,上过人机课，dddd
3541,859,吴俊,2015-06-17 01:30:18,13,15,2,温和
5398,859,吴俊,2015-07-07 07:56:51,1,2,1,讲得灰常详细，巨有耐心
11275,859,吴俊,2015-11-26 07:13:36,0,0,0,讲课很清楚
55847,859,吴俊,2017-07-02 12:53:19,0,2,2,突破0评论。。。其实讲课不怎么好，不激情啰嗦而且一到重点就说不清楚。不过是一位认真负责的老师，所以总体感觉还行吧。
86454,859,吴俊,2018-09-16 11:48:20,1,1,0,认真负责，人很nice。但讲课稍微有点枯燥、无重点\n\n
115383,859,吴俊,2019-07-20 08:24:55,4,6,2,早课老师会带着一杯麦斯威进来（啊不对，其实老师来的比我早\n\n机器人学给分有点好，本来以为要挂科了\n\n老师是真的帅气，我也想像他一样
119378,859,吴俊,2019-11-12 12:19:08,1,1,0,老师讲的真的挺好的！我给满分
144759,859,吴俊,2021-12-23 12:48:21,1,1,0,刚刚好
156346,859,吴俊,2022-06-19 07:20:11,5,6,1,上了吴俊老师开的三门专业课，自控是有突击小测的，其他没有，但据说机器人学1也是有突击小测的，老师讲课很温和很细致，认真听可以跟得上，是好老师
171474,859,吴俊,2023-03-25 12:08:26,3,3,0,自控原理每周的作业和上课讲的内容没什么关系，经常是先留作业后讲课
173247,859,吴俊,2023-05-16 14:40:04,4,4,0,太tm能小测了
178212,859,吴俊,2023-07-08 05:34:40,6,6,0,我感觉是控院讲课数一数二好的老师了，真能听进去，有的老师一开口就想玩手机🦶
178784,859,吴俊,2023-07-22 13:08:41,5,5,0,老师课讲的很好，很清楚，就是《机器人建模与控制》这课真的挺难的要多花点时间
179681,859,吴俊,2023-09-19 08:21:35,0,1,1,没挂我，谢谢老师，周二五节课连上真顶不住
192782,859,吴俊,2024-05-30 10:36:38,4,4,0,神中神，控院为数不多的能把课讲清的老师，一定要珍惜，不过yysy，他是真的喜欢小测
194028,859,吴俊,2024-06-21 13:03:55,6,6,0,他是真的喜欢奶茶
199607,859,吴俊,2024-09-26 07:47:25,-1,0,1,控制论几个老师里讲的最好的
204249,859,吴俊,2024-11-25 05:02:29,3,3,0,我最喜欢的老师，非常认真负责，非常亲切温和
206367,859,吴俊,2024-12-14 14:53:35,9,9,0,控院讲课三幻神：吴俊、陈曦、赵豫红\n\n选上他们的课绝对赚了
211460,859,吴俊,2025-01-11 13:34:19,2,2,0,感谢吴老师
211772,859,吴俊,2025-01-12 11:23:18,1,1,0,吴老师是控院之光
30612,895,梁军,2016-07-02 04:59:48,0,8,8,矜矜业业
102830,895,梁军,2019-02-24 02:14:45,0,7,7,老师讲课还可以，很认真，但是给的分数好像有点严格啊……
144769,895,梁军,2021-12-23 13:33:38,0,1,1,哈哈哈
144843,895,梁军,2021-12-25 05:54:29,3,3,0,体谅学生，不水
145251,895,梁军,2021-12-28 13:08:24,8,9,1,系统论出分前来评价，老师人很好，实力很强，以前一直带研究生。但这门课压根不适合低年级学生学，啥啥都不会，没很强数理基础没法学。课程很硬核，想学有很多东西可学，作为通识课非常费时。平时作业加起来一篇感想，3、4次随堂作业，期末一个大作业一个闭卷考，大作业展示自愿原则，有加分5-8，保底5。我自己花了很多时间，学得很痛苦，希望老师给个好分吧
146867,895,梁军,2022-01-08 00:14:47,1,2,1,真的是认真负责的好老师
157581,895,梁军,2022-06-24 00:36:37,1,2,1,课是水课，但老师给分又很严格，主要是没有评分细则，主观成分太多了。对了，千万别做他的课代表，那真的是免费打工。
157845,895,梁军,2022-06-25 05:49:43,2,2,0,给分真的很求是，或者说感觉给分比求是还差一点……所有运筹学平行班里唯一一个闭卷考还给分差的，大作业给分也很求是（差），讲课很好，只能说能选其他教学班就不要选这个，毕竟课可以智云听……
158061,895,梁军,2022-06-26 13:40:44,1,1,0,运筹学各种事情比较多，还有思政报告，给分有点奇怪，建议还是选别的班级。不过老师讲课挺好。
163681,895,梁军,2022-12-16 02:51:55,0,0,0,很敬业
175998,895,梁军,2023-06-27 11:22:55,0,0,0,如果你是工高的，上的是系统工程。那么他给分是真的好，平时作业做一做，然后布置的讨论做一次，最后考试其实就是五道概念题，最后结果还不错。上90了。
176343,895,梁军,2023-06-28 12:55:10,6,6,0,《运筹学》\n\n本以为会是一门比较硬的课，但是上下来感觉并没有想象中那么偏算法，课后作业布置的也很少，课程最后评分主要就看大作业&随堂考试。\n\n感觉收获没有想象中大，但是给分还算正常
197300,895,梁军,2024-07-10 13:06:40,0,0,0,运筹学给分一般（4.2），上课不太能学的到知识，期末小组作业报告+随堂测验，小组作业能抱到大腿就好，比较轻松
220153,895,梁军,2025-06-29 14:45:32,0,0,0,讲的比较浅，但还是很生动且清晰。注重思想方法轻计算，作业用ai编程很快，期末考也简单\n\n但是给分很差很差……最高4.5 自己权衡吧
16651,904,张光新,2016-01-18 15:29:51,0,0,0,呵呵呵
58316,904,张光新,2017-08-28 13:02:25,0,0,0,呵呵呵呵
64110,904,张光新,2017-12-21 03:58:29,0,0,0,.......
79783,904,张光新,2018-06-13 13:40:47,1,2,1,拖堂很难受
80406,904,张光新,2018-06-26 06:57:39,1,1,0,呵！拖课！
85705,904,张光新,2018-07-27 00:54:48,2,2,0,拖堂   真的是能拖堂。。。出分还超级慢
95117,904,张光新,2019-01-19 00:26:47,-7,8,15,啊老师人超好诶评论怎么肥四？老师很认真负责的，虽然平时会拖课但是人真的超nice！我超喜欢这个老师╰(*´︶`*)╯
103101,904,张光新,2019-02-26 03:23:37,1,2,1,你知道什么叫恶心吗
115684,904,张光新,2019-08-18 12:35:29,-2,1,3,有收获
125649,904,张光新,2020-09-12 14:16:10,0,4,4,计算机控制系统。老师很有水平，结合自己的工作经验讲课，干货挺多。课本身挺硬的……反正是核心专业课，花的时间很多。本菜期末考炸了ORZ，老师还是可以的。\n\n（黄老师太惨了233，疯狂被张老师diss。上过的人都懂hhh）
136412,904,张光新,2021-06-17 15:40:16,19,21,2,授课内容不适合碳基生物。
139228,904,张光新,2021-07-13 11:24:44,12,13,1,快逃.jpg
160393,904,张光新,2022-09-21 07:22:03,43,46,3,这是个倒霉的老师，摊上了不该摊上的人
160401,904,张光新,2022-09-21 10:28:00,14,15,1,孟伟的老师
176054,904,张光新,2023-06-27 13:52:24,10,15,5,听孟伟说张光新是个精致的利己主义者，如果是这样的话那张光新快点下台吧
200692,904,张光新,2024-10-21 04:05:04,0,2,2,老师水平很高，授课干货满满
218754,904,张光新,2025-05-01 11:39:10,2,2,0,上课上的没有任何内容啊
218903,904,张光新,2025-05-12 11:09:52,3,3,0,计控实验依托浓泻
219930,904,张光新,2025-06-11 10:09:27,2,2,0,很好的老师，使我大脑旋转，使我化羽成仙
220803,904,张光新,2025-06-20 01:23:23,1,2,1,业务水平和shi一样，上课听不到一点干货，验收可以为难，屁话一堆，不愧是孟伟的导师
19661,907,杨春节,2016-01-25 04:55:35,20,31,11,挺好的  虽然控制论真的是神课
29992,907,杨春节,2016-06-30 16:23:11,-1,4,5,老师人超级好，给分更好！
30031,907,杨春节,2016-07-01 00:03:05,6,9,3,温文尔雅，男神气质！！给分超好
34244,907,杨春节,2016-09-29 03:48:36,-3,1,4,还是挺好的
34245,907,杨春节,2016-09-29 03:50:00,0,2,2,讲的不错
34349,907,杨春节,2016-10-06 03:13:57,-2,1,3,还是不错的老师萌萌萌
42664,907,杨春节,2017-01-14 23:16:31,-1,2,3,好老师\n\n
45823,907,杨春节,2017-01-20 06:48:31,-1,2,3,男神气质
50928,907,杨春节,2017-05-09 06:54:23,-1,3,4,人帅。
57051,907,杨春节,2017-07-05 09:38:57,-3,1,4,作业很少，上课偶尔点人回答问题，最后一节课会划重点，给分好
57183,907,杨春节,2017-07-06 02:15:04,-2,1,3,很好，很好
57709,907,杨春节,2017-07-12 16:51:44,-2,4,6,按照知识点一个一个讲下来，生动度一般，是很希望大家听懂的那种老师。希望同学们能够积极回答他的问题，他会很开心的。计网收获不大，但也算基础入门，计算机网络这门专业课学得还算是比较轻松的。适合别的专业选择作为个性课程。
69780,907,杨春节,2018-01-25 11:23:46,0,8,8,控制论神课，求别再开了
93101,907,杨春节,2019-01-07 10:33:11,-2,3,5,计网给分挺好
98939,907,杨春节,2019-01-24 06:58:50,-4,0,4,哈哈哈
112856,907,杨春节,2019-07-05 06:27:22,12,15,3,上课和过春节一样自在
118621,907,杨春节,2019-10-29 16:01:26,-1,4,5,老师好帅啊
118907,907,杨春节,2019-11-07 13:24:33,2,6,4,助教好评！！！！温柔帅气小哥哥(ฅ•﹏•ฅ)
126180,907,杨春节,2020-09-18 12:33:25,13,15,2,不管天气炎热寒冷，永远有一件笔挺的衬衣。怎么会这么有腔调啊！我的奋斗目标了！
134772,907,杨春节,2021-04-14 12:33:14,0,5,5,老师真的好儒雅，而且特别关注学生听没听懂，虽然但是我没有好好听真的对不起他......
152972,907,杨春节,2022-04-22 14:22:18,-4,2,6,给分前来给杨老师好评。上的是计网，老师讲课很好，温文尔雅。
153018,907,杨春节,2022-04-23 15:49:09,-1,4,5,感谢春节哥哥捞我🥰🥰🥰
153046,907,杨春节,2022-04-24 08:12:34,0,5,5,每次上课必穿着笔挺的衬衣，儒雅随和，对学生很温柔很耐心，会关心学生听懂了没有，上课会叫人起来问问题，但是问的不难也绝不会刁难学生。\n\n春节爸爸真的好好，我哭死
154935,907,杨春节,2022-06-07 03:29:54,-4,4,8,控制论都给我选
156359,907,杨春节,2022-06-19 08:16:14,-2,3,5,温润，儒雅\n\n是我想成为的样子
157844,907,杨春节,2022-06-25 05:46:56,-9,3,12,春节爸爸的计网真的很好，我哭死，男神魅力max
158059,907,杨春节,2022-06-26 13:38:10,-9,2,11,春节gg非常温柔，会记住同学们的名字并交流互动，计网讲课很清晰，可以看出老师的用心，课程体验非常好！
160841,907,杨春节,2022-10-17 02:51:36,-9,3,12,上半年上的计网，控院的个性化。老师很有学者气质，温文尔雅，讲课很在意同学有没有学懂，偶尔点名问问题也只是想了解有没有讲明白，人不在也不会说啥，坐前排的还能记住名字。上课体验非常好！
172647,907,杨春节,2023-05-03 09:10:49,15,15,0,讲课还行，不过计网给分好像一般般欸
172762,907,杨春节,2023-05-06 10:16:30,14,16,2,讲课确实还行，但计网给分真的只能用烂来形容。\n\n期末考试考四个层，一共6个ppt（总页数有六七百），半开卷考试。\n\n应用层和传输层讲的时间占70%，网络层和数据链路层讲的时间加起来都没超过一周半，但是考试考了特别多网络层和数据链路层。并且期末试卷的题型是真的离谱，全找一些奇奇怪怪的点出题，就纯看考生的运气好不好（有没有抄道那个知识点），完全不能体现学生的知识水平。\n\n如果不是自动化专业的同学并且是为了出国而选这门课的话，建议去选电气学院或者光电学院的计算机网络。如果是自动化专业的同学的话，建议放弃这2.5个学分别选，如果出国有硬性要求的话，也尽量选择别的学院的计算机网络。
172774,907,杨春节,2023-05-07 05:26:32,10,10,0,给分很烂
172835,907,杨春节,2023-05-08 06:02:54,13,13,0,快跑，给分纯烂
174470,907,杨春节,2023-06-12 20:26:08,12,13,1,人好，但给分差
177680,907,杨春节,2023-07-04 08:06:36,13,14,1,学期结束来评价一下。计网我真的呵呵了，老师人或许还行，但这门课完全就是烂分烂课
181558,907,杨春节,2023-10-22 16:43:03,9,9,0,烂中烂
199606,907,杨春节,2024-09-26 07:46:32,1,1,0,仅针对控制论\n\n上课会按名单叫人回答问题 不过答不上来没关系 也不算点名（所以经常叫一串人都不在\n\n人确实风度翩翩 讲的中规中矩
212829,907,杨春节,2025-01-15 04:34:24,2,2,0,控制论真是神课\n\n事少分高，无敌了
7690,945,杨再跃,2015-09-15 09:07:27,1,1,0,水从中来，无聊蛋疼
31930,973,戴连奎,2016-07-05 07:39:02,2,4,2,非常搞笑！
31931,973,戴连奎,2016-07-05 07:39:08,-11,3,14,有趣，好玩，给分好，必选
62564,973,戴连奎,2017-11-26 02:58:46,-1,2,3,自动化导论，偶尔吹吹牛，还是可以的。知道的还挺多，也不是特别无聊，希望可以保持下去。
73984,973,戴连奎,2018-02-04 03:16:16,-1,5,6,mdzz
85416,973,戴连奎,2018-07-17 13:54:57,2,6,4,听他的课，有一种眼前一亮的感觉，有时甚至亮得睁不开眼。
129678,973,戴连奎,2021-01-11 02:15:46,35,36,1,在线吐血好吧期末突然更改5k论文要求 文献综述要查重这是人干的事？？？
129679,973,戴连奎,2021-01-11 02:22:27,24,24,0,期末突然要求查重
129681,973,戴连奎,2021-01-15 17:36:30,25,27,2,老师人挺不错的，开朗，会分享故事，讲课效果还不错。\n\n就是突然加作业条件，发通知消息有点不及时
129682,973,戴连奎,2021-01-11 02:19:44,28,28,0,论文马上上交了，突然说要查重？？？？\n\n大一新生听了一节课就能自己写作出5000字以上论文？可笑
129683,973,戴连奎,2021-01-11 02:23:27,15,16,1,一学分通识课查重就离谱
129684,973,戴连奎,2021-01-11 02:24:30,14,14,0,真的吐了，5k字文献综述性论文还突然改条件查重，一群啥也没学的大一新生，写个5k字的啥也没见过的论文就够难了，还要查重。而且下周就考试了，就不觉得说的太晚了吗
129685,973,戴连奎,2021-01-11 02:26:14,18,18,0,呸，辣鸡论文
129686,973,戴连奎,2021-01-11 02:28:31,14,14,0,考试周突然改5k字论文要求，大一新生听一节课要写5000字论文且单次引用不能过100？？？老师做个人吧
129690,973,戴连奎,2021-01-11 03:01:08,12,12,0,半学期1学分的课，5000专业论文临近期末要求查重，我给1分不过分吧
129698,973,戴连奎,2021-01-11 03:51:47,10,10,0,考试周突然要求论文查重\n\n作为大一新生写专业发展方向的论文5k已经很艰辛了谁不是论文缝合的呢有这个必要吗。。。
129923,973,戴连奎,2021-01-13 14:24:10,5,5,0,突然查重就离谱
129979,973,戴连奎,2021-01-14 10:58:41,4,5,1,考试周改作业要求 好活
130010,973,戴连奎,2021-01-15 02:15:03,4,5,1,我向来不惮以最大的恶意推测戴老师的
130012,973,戴连奎,2021-01-15 02:17:23,1,5,4,本来说好改成周六上课，周五原来课程的时候突然就点名，飞奔到教室去上课，辣鸡
130020,973,戴连奎,2021-01-15 04:11:49,-1,5,6,骂老师感觉真没必要
130070,973,戴连奎,2021-01-16 10:28:51,2,2,0,查重就离谱
130165,973,戴连奎,2021-01-18 10:11:55,0,1,1,很认真的老师，喜欢和学生“课堂友好交互”，作业很硬核。。。
131971,973,戴连奎,2021-01-29 16:43:44,7,7,0,五级制的评分真的蠢，减少自己的工作量结果学生倒霉，优秀-4.5绩点之下就是良好-3.5，问题是正态的第二档80-89的最低分80分都有3.6绩点，我们戴老师真实太好了呢，怕吴校长的正态不能拉开差距所以就采用这种五级制评分，你真棒！
132166,973,戴连奎,2021-01-30 20:15:17,7,7,0,辣鸡，nt，控制工程给自己班级开小灶然后猛考另一个班没讲过的知识点 还有意思？
133153,973,戴连奎,2021-02-11 00:33:00,4,5,1,自动化导论，绩杀水课，花费时间不说所有课程最多吧，为了论文属实用了不少时间，到头来喜提所有课程最低分
133154,973,戴连奎,2021-02-11 02:53:17,3,3,0,给分奇差，五级制是真的nt
133156,973,戴连奎,2021-02-11 04:34:19,3,3,0,给分奇差
133171,973,戴连奎,2021-02-13 00:53:29,1,1,0,。。不能骂人那没事了啊
133175,973,戴连奎,2021-02-13 13:44:10,0,0,0,出隔壁班没讲的内容
133512,973,戴连奎,2021-03-01 12:17:04,6,7,1,控制工程一的助教情商低的可怜
133582,973,戴连奎,2021-03-02 09:53:20,-9,1,10,太简单了，我zhn满了
133957,973,戴连奎,2021-03-10 13:12:34,6,8,2,讲课水平属控院一流
139230,973,戴连奎,2021-07-13 11:30:14,4,5,1,能学到的那点可怜的知识和花费的巨量时间与精力完全不成正比。呸！
146057,973,戴连奎,2022-01-05 09:39:12,0,3,3,过程控制课程任务繁重无比根本不符合这门课标定的学分，仿真作业和纸面作业起飞，个人大作业和小组大作业并行，实验从中午做到晚上十点钟。老师本身讲课水平堪忧，对课堂节奏把握奇差无比，十一月末线上上课时喝粥（过几天转线下上课结果忘了，全体同学赶到教室结果只能看直播），更别提上课的时候拿女同学开玩笑，对学生没什么尊重。这样的老师是控院的耻辱，只能说是苟史。
165850,973,戴连奎,2023-01-10 06:08:47,6,6,0,老师讲课水平很高，很专业，在过控课程组乃至控院都算前列。人很好，很和蔼，为学生着想。这次线上考试戴老师坚持和学院斗争想改线下，后来没办法，线上改了开卷。考题大题基本是平常做过的练习题。总之，是体恤学生又很有水平的老师。希望老师退休生活愉快！
171168,973,戴连奎,2023-03-17 08:25:42,3,3,0,上课很好，能让学生有收获，也体谅学生，过控这门课也没想象中那么烂，总体来说是控院比较好的老师了，2.6分也实在太低……不管怎么说，祝老师退休生活愉快
12508,1038,徐祖华,2015-12-23 11:47:27,2,7,5,良心好老师
79272,1038,徐祖华,2018-05-29 12:45:31,3,5,2,cnm四周七份报告
84307,1038,徐祖华,2018-07-12 13:35:23,0,1,1,被卡绩了有点伤心 不过上课 给分还是挺不错的
84446,1038,徐祖华,2018-07-13 01:25:37,-10,3,13,水平不够就别选人家的专业课
85107,1038,徐祖华,2018-07-15 11:37:28,5,6,1,课上的还行，不是控制学院的千万别选这sb课
85417,1038,徐祖华,2018-07-17 14:36:13,2,3,1,不是控制学院学生，单说数值计算方法，作业是真的多每周要花很多时间写报告，不过用心的话还是能从老师这里学到不少东西的，给分也很良心的。
97140,1038,徐祖华,2019-01-21 17:48:49,9,13,4,我劝退一波：不是控制学院的不要选他的数值计算方法，首先这门课比起其他工科学院的数值方法类课程简单的一批，底下说水平不够就别选的和井底之蛙没什么两样，去选个数院的机械的就知道人家是两倍的课时学你三倍的东西。课程非常的水内容也不多，然而作业多到爆炸。另外这个老师给分对外院学生极其不公平，我自认为作业比某些拿了4.8的水货认真多了，最后绩点简直不能看。开课就不是奔着学知识去的，所以别给自己添堵。
133474,1038,徐祖华,2021-03-01 05:29:58,7,8,1,还行吧，数值计算报告太多了，不过好好写，给分良心
153873,1038,徐祖华,2022-05-14 15:02:28,14,15,1,其实还行，就是这课报告实在太多了，给分还挺好的
161738,1038,徐祖华,2022-11-11 17:02:19,2,2,0,给分很好
195142,1038,徐祖华,2024-06-27 02:48:00,3,3,0,坐标数值计算方法，讲课一般般，这个课最大的作用是逼迫我学会了matlab的简单使用，如果有基础的前期实验估计轻松拿捏了。作业量很大，一周两个报告持续5周，最后还有一个大作业，我知道的人最后报告（连代码）都卷了15到20＋页，最后给分蛮好的，其实老师人也不错，就是作业太多了...实验报告还必须一天内提交
196078,1038,徐祖华,2024-07-01 12:34:05,5,5,0,数值计算方法\n\n感觉虽然内容有讲难的方法，但是不影响我们写作业。注意各类的ddl拿个高分容易。
218905,1038,徐祖华,2025-05-12 13:06:58,0,0,0,讲课一般但是可以不听，去教室防一下考勤就行，认真写报告就能有不错的分数，就是很耗时间，春学期不闲的还是不要选
48506,1162,王酉,2017-03-06 07:33:59,2,5,3,上个会讲故事，也有知识点，是个不错的老师诶
49513,1162,王酉,2017-04-17 11:16:32,7,8,1,老师很风趣幽默，经常在课上讲各种段子，但又能自己绕回来。讲解清楚，热心帮助同学，如果能讲得再有深度一点就好了~
51421,1162,王酉,2017-06-05 08:52:37,1,2,1,老师人真好～～～
78541,1162,王酉,2018-05-13 00:15:51,1,2,1,挺好的\n\n
78624,1162,王酉,2018-05-14 03:12:54,2,4,2,666
83739,1162,王酉,2018-07-11 06:44:27,11,15,4,999
96474,1162,王酉,2019-01-21 04:51:50,1,2,1,海星吧，重点勾的不错
110383,1162,王酉,2019-06-26 08:18:29,0,1,1,还行吧
116780,1162,王酉,2019-09-15 18:30:29,-177,7,184,上的机器人与人工智能导论课，老师人很好，但卡绩了，4.2卡得我好难受π_π，均绩又变低了，给9分吧，还是自己太菜了，唉
130166,1162,王酉,2021-01-18 10:27:47,7,8,1,我上的王老师的机器人与人工智能导论以及后面的实践课，真的很喜欢王老师，上课讲的清楚，还很关心学生。
134594,1162,王酉,2021-04-03 13:42:36,2,5,3,上课反正很少讲知识，水课可以，硬核课程就别了。
136823,1162,王酉,2021-06-25 06:39:02,14,21,7,嵌入式避雷\n\n实验要求做不知所云的自行添加功能，永远不知道他希望得到什么\n\n实验给分极迷，运行顺滑流畅系统与丐中丐系统同样分数\n\n熟悉的人评分会有一点加成，缺乏公平
137309,1162,王酉,2021-07-03 04:48:13,3,5,2,能好好讲讲课吗
139904,1162,王酉,2021-08-16 02:51:24,23,26,3,讲课是挺有趣，可是4.30考完的试，我就看看8.30能不能出分。
151540,1162,王酉,2022-03-07 05:33:49,15,15,0,前两节课说了三遍我是phd，生怕别人不知道，有时候一分钟能翻十几张PPT，一遇到关键点就开始吹牛逼，不知道在干嘛，那些吹他牛逼的，我知道这个老师科研很厉害，但是他的本科授课能力真的很垃圾。
152405,1162,王酉,2022-04-08 10:29:23,22,25,3,讲课水平真心不咋地，上课喜欢吹牛，有意思是有意思但是真的没办法让人抓住重点，作业的深度远超上课得到的内容，嵌入式系统这门课目前体验不佳
158959,1162,王酉,2022-07-04 03:04:22,2,2,0,王老师还是挺好的，我是大四毕业生，课程出分当晚就跟我说考得还行，挺关照学生的。嵌入式划重点也很好。
158963,1162,王酉,2022-07-04 04:09:54,6,8,2,嵌入式本身（应当）是一门比较重实践的课程，所以导致很多同学反映“上课不知道在听什么”，这是各个教学班都存在的问题，就wy老师的课堂而言 至少春学期51部分的课程我觉得还是挺受益的（夏学期32的部分大家就不太听了咳咳 是做了实验之后才有一些感受），最后复习课也很有帮助（最后别的班同学也是靠wy班的复习课复习的x）。嵌入式可以说在老师的带领下入了门，btwSTM32的实验我真的做得很痛苦，最后的最后给分个人感觉很好！！出乎意料得高555 另外上课会讲故事，总体给我的感觉也很关心学生，很愿意回答问题且耐心。嵌入式推荐选
177005,1162,王酉,2023-07-01 04:46:48,1,1,0,嵌入式复习听一节wy的复习课就够了
177177,1162,王酉,2023-07-02 04:03:28,0,0,0,听wy复习课
177688,1162,王酉,2023-07-04 08:46:57,0,0,0,老师人不错，期末的复习课也很有用，还没出分，期待一下吧
179634,1162,王酉,2023-09-19 03:16:06,5,6,1,人挺好的，讲的也还行，不过出分是真的慢，补考都过了，还不出，\n\n\n\n以下一段来纪念王酉出分\n\n\n\n为什么这个英雄要有结印呢？我也不知道，反正有病。等那个b印子结完了我人都死了一万次了，尸体都僵硬了，儿子都出生了儿子都去世了孙子都出来了孙子都去世了全家都玩没了族谱都写了二十多，多张，多个章节了，mdbd说不定人类都移居到太阳系以外去了tm那个印结完了nm什么都没有了。还要结结结结结没事儿捏捏捏捏捏不知道那个b手在那捏什么，一定要捏一下装这个b吗？你直接按了不行吗？那装置有延迟吗？装置又没有延迟人在那装什么b疯呢？一直摁摁摁摁摁nmb呢，摁完了nmb！和平都蓄满了！！！出来拉我了！！！直接把我干死了！！！！！还在那结
184634,1162,王酉,2023-12-22 04:22:45,8,8,0,在机器人导论课上认识了王酉老师。关于讲课水平，我个人认为是控院嵌入式这门课本身的理念就有很大问题，每个班级的老师讲出来的东西基本上都是半斤八两。王酉老师是一个很和善的老师，本科生有关于出国的国家选择，方向选择，以及是否读PhD的疑问，只要你问，王老师都会很耐心的解答，平易近人。
191437,1162,王酉,2024-04-22 10:58:17,2,2,0,老师人挺不错的，但是上课水平真的比较一般，甚至可以说有点烂。。可能也有一部分是嵌入式系统和机器人导论这两门课课程本身的原因吧。。
192634,1162,王酉,2024-05-26 11:21:22,12,12,0,机器人导论，讲课和给分都不行
192754,1162,王酉,2024-05-30 05:06:33,6,6,0,上的王老师的机器人导论，这门课很难评，感觉知识不成体系，确实只能算是稍微了解机器人各个方向的一些知识。王老师上课比较划水，考试前会划重点。
192911,1162,王酉,2024-05-31 13:15:33,11,11,0,23-24春夏机器人导论的给分挺一般的。。
192982,1162,王酉,2024-06-01 15:58:33,10,10,0,老师的嵌入式似乎是从这个学期开始小测点名，感觉这个学期点了五次吧，小测测的都是当堂讲的内容。\n\n不好的地方：\n\n1.上课比较喜欢扯东扯西，废话扯皮很多，讲课的逻辑似乎比较零散（当然这也有可能是嵌入式这门课的性质所致）\n\n2.嵌入式的实验数量虽然不多，但是相比较下确实比一些教学班难度略大，相对耗时。\n\n好处：\n\n1.可以直接不听他的课去看英文教材之类的，因为他就是照着这个讲的，而且教材似乎写的更清楚些\n\n\n\n另外，个人建议出门右转选陆豪健老师的班，别问我为什么。\n\n\n\nPS：\n\n1.可以选择智云，王酉老师的复习课\n\n2.我相信王酉在指导学生方面是一个好老师（虽然实验验收不指导hhh）
193026,1162,王酉,2024-06-02 15:21:29,-18,2,20,上过他的很多课了，对学生挺好的，就是那种“不愤不启，不悱不发”的老师。\n\n\n\n楼下说机导给分一般的，有没有想过是可能你期末考考得不好（期末占比60%，你考不好怪老师给分一般？）\n\n机导大作业差距不大，只分ABC三挡，根本没差几分（十几个组只有一两个组是A或C）\n\n\n\n机器人基础实践，认真做就行，根据最后实现的功能和他认为你们项目的难度评分
194415,1162,王酉,2024-06-23 17:26:09,-21,2,23,复习课伟大
196342,1162,王酉,2024-07-03 03:40:24,2,3,1,lx是反话
197103,1162,王酉,2024-07-07 17:03:25,11,11,0,我倒要看看什么时候出分
197572,1162,王酉,2024-07-19 18:32:29,7,7,0,6.24考的嵌入式 7.20还没出分……今年复习课还卵用没有，不知道出分会是什么鬼样子，纯纯死缓
197916,1162,王酉,2024-08-20 17:33:58,8,8,0,6.24考完的嵌入式今天才终于出分，悬着的心终于死了，给分很烂
197943,1162,王酉,2024-08-21 09:26:05,5,5,0,难评……
205618,1162,王酉,2024-12-10 07:09:15,-46,2,48,哎，讲课还行，可惜被卡绩了，才94
208431,1162,王酉,2024-12-27 13:48:39,2,2,0,老师是好老师，对学生很好，有问题钉钉秒回\n\n但是嵌入式系统课程确实有很多值得改进的地方…
218981,1162,王酉,2025-05-16 05:29:15,1,2,1,机导这门简直是纯纯的达芬，王酉的给分也不太透明，大作业需要卷，最后出分是在一个多月后
220150,1162,王酉,2025-06-15 15:16:59,0,0,0,机导上课吹牛，大作业看重机械结构的可行性，展示课纸质点名数人头，给分一般
51981,1163,许超,2017-06-14 03:40:52,0,5,5,老师好棒
65925,1163,许超,2018-01-10 09:27:12,5,8,3,。。。。。。。
74553,1163,许超,2018-03-03 11:49:30,1,8,7,老师比较严格，但是给分很好
76990,1163,许超,2018-04-27 10:59:17,-5,4,9,老师讲课特别棒！很吸引人~
139901,1163,许超,2021-08-15 09:39:46,-10,3,13,这个老师超级好，选课直博最优解。
178075,1163,许超,2023-07-24 13:42:56,9,12,3,啥比老师，根本不会上课。3分的课期末最后一个大作业来给分，分数按照笔记页数和文件大小给，根本不看内容。怎么能有人给那么高的分？
178078,1163,许超,2023-07-06 15:33:32,24,25,1,鉴定为逆天\n\n最速出分の传说（花了半天就出分了）\n\n平时作业布置了想不起来收，最后收了平时笔记当平时作业\n\n从期末前三周就说要布置大作业，最后一节课做课堂测试，结果考试周开始了大作业还没发，发了之后只有几天准备时间\n\n给分非常随机，但是如果够卷，那不会差（比如平时笔记交一两百页上去）\n\n上课跟着记了笔记，也才20多页，不知道一两百页怎么写的\n\n大作业嫌弃压缩包太小，后悔没把原神安装包打包进去\n\nddl战神是也\n\n总结：讲课讲的挺好，可以学到东西，但是对想要高绩点的同学不太友好（最优化这门课3学分），选课慎重
178138,1163,许超,2023-07-07 05:54:33,11,12,1,腊鸡老师，不会上课不会留作业。作业说了一学期下节课留结果考试周留，据理力争下考试周后两天交。作业给分不看内容，看文件大小，看笔记不看内容看页数看封面看目录，有人卷了一百多页直接满绩，卷怪臭sb，老师也臭sb
178178,1163,许超,2023-07-09 10:02:19,6,6,0,秋冬学期的据说给分还不错\n\n而且ddl一拖再拖，不是学生拖，是老师拖\n\n春夏选了的变成🤡\n\n🤡🤡🤡🤡\n\n🤡🤡🤡🤡🤡🤡🤡🤡🤡🤡🤡
178227,1163,许超,2023-07-08 09:17:22,7,7,0,课堂内容：讲得有活力，是认真讲课，会经常下讲台和学生互动\n\n课后作业：一个课堂笔记，鼓励页数越多越好，要求Latex；一个实验，跟着Matlab的讲义把倒立摆仿真完成；之后还有啥我弃修了不知道\n\n为什么弃修：\n\n讲课内容实际和网上搜到的内容差不多；\n\n不喜欢收作业，但喜欢随口布置作业，换句话说布置完作业之后收不收看他心情，然后什么时候收怎么收都不讲，下完课跑得比学生还快(夸张)，就会出现辛苦写完作业但其实他看都不看、和平时分可能也没有半点关系的情况；\n\n没有强制收过作业，但是有说不交作业干脆变成随堂测试，但估计也没有；\n\n说是前半学期仿真实验，后半学期实物实验，说是用乐高积木来做教具，然后一直没有，从乐高正版到国内高仿到啥也没有，直到期末都没有；\n\n说有考试但最终也没有；\n\n说有大作业但是也一直没有，说是组队，但最后情况我不知道，看起来像是个人任务；
178326,1163,许超,2023-07-10 05:19:33,-5,0,5,好好好
178437,1163,许超,2023-07-11 14:25:29,-20,1,21,老师上课的内容属于那种需要一直跟着走，一步跟不上就很难听懂后面的那种，同时老师会给出时间让大家思考问问题，感觉认真学可以学到不少东西。之前学了自控现控不知道怎么用，做了大作业后多少知道一些了。然后老师会推给我们一些很不错的学习资料。总体感觉还是蛮不错的。\n\n至于最后的笔记考核，如果一直带着整理的话应该还是比较轻松的，由于老师一直要求用latex，所以有的同学没有用latex整理的分可能比较低，但其实如果调整出一个看着不会头痛的行间距，老师的一次推导其实latex就可以打个四五页这样，整理20多页的分比较抽象可能是没用latex?二阶倒立摆大作业其实空间很多，感觉其实就大作业而言还是很能看出区分度的。\n\n缺点是平时作业确实抽象，但是确实从前几节课就让我们用latex整理笔记作为作业，感觉作为期末统一作业也无可厚非。对就是这样，所以说平时上课感觉很不踏实
178497,1163,许超,2023-07-12 14:50:55,3,3,0,衮丨鲧
178604,1163,许超,2023-07-16 14:11:00,0,1,1,好好好
178605,1163,许超,2023-07-16 14:11:43,1,1,0,😅😅😅😅😅😅
178693,1163,许超,2023-07-18 06:20:20,6,6,0,详情搜索98“用latex做笔记完全没有任何效率啊”
191210,1163,许超,2024-04-12 03:16:39,-1,0,1,典型的呆子
191211,1163,许超,2024-04-12 03:51:56,0,0,0,自动化导论，其他的不好说，拖堂16min。
191217,1163,许超,2024-04-12 10:58:35,2,2,0,自动化导论，最逆天的一个老师，拖堂15分钟，但是上课又一点知识含量都没有，课后作业让人迷惑，1分
195590,1163,许超,2024-06-29 02:31:12,4,4,0,我愿称之为控院最傻逼的授课老师，学分少，事情贼多，拖ddl，上课对着书抄都抄不明白，就这种人还老师？
198850,1163,许超,2024-09-12 07:05:43,1,1,0,信口开河，讲课随意
85671,1178,邵之江,2018-07-25 01:31:28,12,15,3,咖啡机很不错
104581,1178,邵之江,2019-03-24 07:06:47,4,5,1,别选，别选，别选
106395,1178,邵之江,2019-04-27 04:34:27,0,5,5,控院院长，水平很高，所以也把我们的水平看得很高，讲课还行
114307,1178,邵之江,2019-07-09 17:35:26,-6,9,15,学弟学妹千万不要错过邵总这么好的老师
152043,1178,邵之江,2022-03-24 02:59:50,5,6,1,上课事情好多，节节课课堂练习，每节课都会随机找人回答问题，令人恐慌😭😭😭
153976,1178,邵之江,2022-05-18 09:43:07,0,1,1,嗨害嗨
165377,1178,邵之江,2023-01-03 15:58:01,0,1,1,电子信息工程中的数学模型这课能开出来感觉就不容易了
181427,1178,邵之江,2023-10-17 12:23:13,-3,1,4,23秋的控制论讲得很通俗，上课PPT看得出来是最近做的，也比较风趣。还没考试不知道给分如何ʕ⁀ᴥ⁀ʔ
191690,1178,邵之江,2024-04-28 06:37:06,-3,0,3,事多，但是给分不错
194073,1178,邵之江,2024-06-22 01:15:59,7,7,0,一坨屎
198997,1178,邵之江,2024-09-14 00:07:09,10,10,0,不好好说话，阴阳怪气
200003,1178,邵之江,2024-10-10 17:36:55,11,11,0,不像是一院之长/书记，平常吊儿郎当的，上课不好好讲，对自己的研究生也不上心
200072,1178,邵之江,2024-10-12 09:17:20,3,3,0,整个工智所没几个好老师…尤其他这个大组
200569,1178,邵之江,2024-10-19 10:02:47,5,5,0,不能好好说话，颐指气使，阴阳怪气。
207381,1178,邵之江,2024-12-21 05:17:21,4,4,0,德不配位
214972,1178,邵之江,2025-02-19 15:12:51,3,3,0,垃圾，说一套，做一套
215601,1178,邵之江,2025-03-02 11:27:16,5,5,0,傻逼，我操你妈
4238,1373,宋执环,2015-06-18 08:40:56,28,34,6,老师很萌！虽然通识课大家并不专心但他还是很想与同学们互动！\n\n
7714,1373,宋执环,2015-09-15 10:31:30,0,2,2,内容丰富\n\n
8640,1373,宋执环,2015-09-23 12:03:54,-1,2,3,老师看起来很和蔼，虽然感觉没什么人听，但还是很认真，不过不知道给分怎么样。
19660,1373,宋执环,2016-01-25 04:54:35,3,4,1,还可以吧 虽然控制论真的是神课～
33748,1373,宋执环,2016-09-21 10:15:57,-3,2,5,第一节控制论试水10分
33810,1373,宋执环,2016-09-22 01:47:59,-8,5,13,有助于睡眠\n\n
33834,1373,宋执环,2016-09-22 04:22:23,5,7,2,老师语速有点快，但是很好很耐心。。10分
34240,1373,宋执环,2016-09-29 02:58:37,2,5,3,老师是真正的大神～虽然通识课专业的东西不多
34348,1373,宋执环,2016-10-06 03:12:18,0,1,1,讲的还是很不错的
34353,1373,宋执环,2016-10-06 06:05:03,1,1,0,66666666给分不错
34917,1373,宋执环,2017-01-20 06:47:35,1,2,1,萌哒萌哒萌萌哒
35376,1373,宋执环,2016-11-09 12:12:01,2,3,1,特别认真，老师温文尔雅，而且注意到一个细节，下课走之前自己把黑板擦干净，没有比较不知道他教的怎样，但要给满分
56323,1373,宋执环,2017-07-03 13:16:26,0,0,0,老师人很好，很有亲和力。但是给分....比预想中要低一些吧，也许是我菜
63742,1373,宋执环,2017-12-14 01:59:49,1,1,0,老师是大神，学识渊博，与人和善
69762,1373,宋执环,2018-01-25 10:31:22,0,3,3,他讲的通识倒还是通识
69778,1373,宋执环,2018-01-25 11:22:38,22,24,2,求别开控制论通识课了，对于其他专业的人来说神坑。秋冬学期2学分的课程，给分等级制，额，，，
69876,1373,宋执环,2018-01-25 15:12:43,-11,11,22,老师是好老师，神他妈五级给分，劳资每节课都听，论文写了8000+结果3.5。\n\n是真的生气本来gpa都能上4.4了结果神tm3.5？？\n\n老师是好老师，要怪就怪制度吧。想要绩点的就不要选了。
98935,1373,宋执环,2019-01-24 06:57:13,5,6,1,呵呵呵
102828,1373,宋执环,2019-02-24 02:10:23,2,2,0,讲课很一般，基本就是念ppt，不点名，但最后给分比较严格，所以作业一定要好好完成
115098,1373,宋执环,2019-07-15 12:58:53,6,7,1,老师，考完14天了，求求你出个分吧
115907,1373,宋执环,2019-08-25 08:44:59,6,9,3,控制论课程没有想象中的那样硬核！只需要要做好讨论课展示，考好期末考试。期末考试全部都是课堂ppt里的内容，打印下来照着抄就行。给分挺好的（91虽然卡绩，但也比较满意了）但是出成绩是真的慢！
132927,1373,宋执环,2021-02-05 04:33:47,0,3,3,人文大类，上的控制论，最后a-。\n\n上课有时候硬有时候水，比较偏理论的可以不听，硬一点的能懂则懂，不懂也没必要强学。最后考试很水，会有一个计算题，据我所知考了两次稳定性，基本没有数学要求，照着公式就好。成绩主要看平时的展示和发言，如果想拿高分每节课保证一次发言（本人没有很卷，几节课发言一次），展示好好做（可以不做老师要求的题目，做自己感兴趣的各种xx控制论都可以）。最后，如果你想水，来控制论没错；如果你是社恐，不想小组讨论，来控制论也没错。至于为什么很多人说控制论神课，我也不是很清楚........
132930,1373,宋执环,2021-02-05 05:59:14,2,2,0,看起来控制论好像是今年才升级为通核的？\n\n反正这课神了，平时啥事儿不用做，课也不用听，两次十来分钟的个人展示，讨论课只用提问就算发言，我有几次课没去好像也没事，期末也没有论文。期末考试开卷我是直接去那里翻资料做的，之前一秒钟的课和ppt都没看过，最后做出来感觉良好。最后给分A/4.5 ，看楼上说有A-的档，不知道有没有A+?不过也无所谓了，一门通核课能让我一个学期从来不在上面花心思就能拿这个分数，很满足了。\n\nbtw，我是计算机方向的，所以期末有些题结合自己专业有很多可以写的，估计是因为期末考得好分才高。
134182,1373,宋执环,2021-03-18 05:49:22,5,6,1,血泪经验，DSP不要选不要选不要选！\n\n太可怕了吧，选课之前没提示，后来发现，信号系统学得不好的，数字信号处理没学过的同学，请直接自己主动上断头台（微笑）\n\n上课很佛，但是难啊根本听不懂，最后出来刚好3，室友因为有一次点到签名没去，最后2.7。。。。。。（另一个大佬室友也是3，我的成绩真的第一次和大佬离这么近）
135927,1373,宋执环,2021-06-03 13:10:44,5,5,0,讲得是真的烂
136498,1373,宋执环,2021-06-19 10:19:31,4,4,0,很烂别选别选别选，宁可低定也要退课，这老师真是XX。
138611,1373,宋执环,2021-07-10 03:07:15,0,1,1,控制论神课，别选
141690,1373,宋执环,2021-10-20 08:06:46,0,1,1,真的是一只笑面虎，表面说给我们啥啥不影响，最后一点点记着全给扣了，说话特别阴险。别选别选别选，完全绩杀。
158750,1373,宋执环,2022-07-02 00:34:10,-10,5,15,控制论，很轻松就两次pre一次开卷考，就是4.5/91卡绩了呜呜呜呜呜
190587,1373,宋执环,2024-03-10 15:29:30,0,0,0,控制论 上课说话很含糊听不清，比较枯燥
196943,1373,宋执环,2024-07-06 04:02:45,1,1,0,给了6分，说话含糊不清，给分也一般般。。。
197481,1373,宋执环,2024-07-16 11:37:59,2,2,0,神课\n\n理论课点了2-3次名 都是szh本人点(ycj的点名提问应该是不算出勤)\n\n讨论课两次pre 水水过就行\n\n从大二摸鱼人的角度 还是很不错的
23846,1379,王保良,2016-04-18 14:44:43,-4,1,5,非常nice
60878,1379,王保良,2017-11-01 03:02:09,12,14,2,长见识了，第一次见到有老师是掐着秒表计迟到的
132569,1379,王保良,2021-02-02 11:13:02,-7,1,8,传感与检测很nice，讲的很清楚，给分好。
133140,1379,王保良,2021-02-10 06:16:38,-9,1,10,传感课讲的很好
142711,1379,王保良,2021-11-15 11:15:19,-2,1,3,老师非常热情，对我们非常耐心，讲的也可以
143051,1379,王保良,2021-11-18 11:43:51,-1,1,2,dsp最后开卷考，给分还行，平时老师很负责，并且很喜欢学生找他问问题
153493,1379,王保良,2022-05-01 21:41:36,13,14,1,如果一个老师在学术上毫无含量，就会在形式上找你麻烦。
160259,1379,王保良,2022-09-17 08:16:16,10,11,1,完全同意“ 如果一个老师在学术上毫无含量，就会在形式上找你麻烦。”\n\n什么年代了 不让学生用电子设备 这还是专业课 我建议老师自己别用ppt先\n\n另外 让学生上课好好听讲的办法根本不是规定一堆形式的东西然后沾沾自喜以为自己主宰了什么东西 而是切实提高自己的教学水平\n\n自己讲的烂 当然没人听
160260,1379,王保良,2022-09-16 02:52:07,4,4,0,上课不能看任何电子产品
160581,1379,王保良,2022-09-27 11:08:53,3,3,0,上课不准用电子产品 讲课水平一般下，我的评价是 建议他别用ppt再来要求我们
160942,1379,王保良,2022-11-17 12:20:20,-3,2,5,这么好的老师怎么才7分，我吹爆，顺便求老师捞一手。
161094,1379,王保良,2022-10-26 15:23:09,9,10,1,DSP作业多的要死，上课不知道讲什么，作业要求完全说不明白，临近期中突然开始爆炸性作业，真的边骂边写，恶心死了
171152,1379,王保良,2023-03-17 04:25:20,-6,0,6,老师认真负责，个人喜欢纸质书，不让用电子设备感觉还好，而且作业少讲课仔细，玩手机又不管，真的好老师
200978,1379,王保良,2024-10-26 02:33:01,3,3,0,上课迟到半分钟锁门，和我对视不让进，隔道墙听智云有意义么。。\n\n“掐着秒表计时”是真对啊\n\n上课讲的挺认真？没怎么听，被形式弄心寒了
202029,1379,王保良,2024-11-08 11:24:04,0,1,1,dsp系统设计，虽然作业巨多且麻烦，但是老师巨会捞人
202336,1379,王保良,2024-11-11 18:03:46,0,0,0,上一位同学说捞人，但给我的给分巨差。我视角的这门课：PPT全英文，教材全英文，中间还有一次全英文作业，作业巨多，听了课之后能听懂能理解，光靠自己看ppt几乎无法理解，所以几乎是强制性听课。老师很热心解答同学问题很认真。
203326,1379,王保良,2024-11-19 07:20:42,-1,1,2,专业课说实话应该不存在捞不捞人这一说法。给分好不好代表着自己考的好不好。至少考试所有内容都是老师上课专门讲过的，认为给分不好的能讲出来DSP这门课期末考试有什么难点吗？作业好好写平时分肯定有95，考试就算平时不听作业好好做了，最后拿个4.5也不是问题吧
213543,1379,王保良,2025-01-18 06:33:57,0,0,0,态度很认真（但可能有些过？指的是点名方面）
19784,1434,牟颖,2016-01-25 09:12:56,4,6,2,讲课声音超级小，当年上的全是医疗仪器，最后翻译一篇论文。
23965,1434,牟颖,2016-04-23 02:28:12,-8,1,9,给人感觉是在实验室还行，讲课好像不是很用心
24653,1434,牟颖,2016-05-03 02:37:20,4,7,3,事情超多。。给分很一般
32539,1434,牟颖,2016-07-07 12:24:13,3,7,4,讲课一般……几乎没什么讲课，主要是学生做展示
48105,1434,牟颖,2017-04-25 12:40:38,16,20,4,全是学生自己展示，学不到东西的
49315,1434,牟颖,2017-04-11 12:54:26,31,48,17,我想说qnmlgb，谁反对谁赞成\n\n
49377,1434,牟颖,2019-01-04 06:57:34,13,15,2,英语论文看吐了 来打个分 到目前为止最后悔选的课
50227,1434,牟颖,2017-05-01 13:55:04,-9,5,14,只要多刷脸，，积极举手，给分很高
50412,1434,牟颖,2017-05-02 17:59:53,8,8,0,有点迷吧
52229,1434,牟颖,2017-06-30 16:09:00,13,16,3,学习帝上我们这次的新生研讨课均鸡3.6  新生研讨课均鸡只有3.6！事情巨多一周一个pre  然后还要上课发言刷脸   期末看一篇跟自己专业毫不相干的英文论文然后翻译   反正为了这课我加一块刷了五天夜  花的时间比我微积分都多【默哀一下自己爆炸的微积分】绩点出来虽然不低但是完全给付出的努力不成正比 可以说是最后悔上的一门课了。
52474,1434,牟颖,2017-06-20 09:32:42,12,17,5,事情多给分低，明明每次展示都超级认真地准备了，论文也很认真写了，最后。。。。。。。。。。。。。。。。。。3.3.。。。。。。。。。。。。。。。。。。。。
54019,1434,牟颖,2017-06-28 08:29:32,10,12,2,到目前最后悔的课，是我到现在通识的最低绩点，我每次展示都很认真的啊，同时最后的论文翻译也很认真，全是同学展示，学不到一点东西
54534,1434,牟颖,2017-06-29 14:07:12,-3,1,4,事情多，但老师人不错
90684,1434,牟颖,2018-11-25 08:46:16,3,4,1,昏昏欲睡，超级后悔
92548,1434,牟颖,2019-01-02 11:30:55,13,16,3,我们一群大一新生，在基本不掌握专业知识的情况下翻文件自己讲先进的仪器，还要对完全不了解的仪器提出问题。可能是我明白得太晚了，最后几节课才明白这是一门教我们翻文献编学术垃圾的课。
93250,1434,牟颖,2019-01-08 11:20:36,5,6,1,太无聊，事情多
93693,1434,牟颖,2019-01-12 02:00:17,2,2,0,呵呵呵呵呵
93713,1434,牟颖,2019-01-12 07:53:42,5,6,1,选上的退掉就好
96657,1434,牟颖,2019-01-21 08:43:08,4,4,0,千万不要选，真的没意思！！！
96738,1434,牟颖,2019-01-21 09:51:45,-3,6,9,上课一定要积极举手提问，小组内要主动上去展示，期末实验报告对文科生来说比较困难，但是可以请教老师如何去写，期末给分还行的。老师很和善的
98646,1434,牟颖,2019-01-23 16:30:18,2,3,1,坑坑坑
105468,1434,牟颖,2019-04-15 02:11:21,4,4,0,上的最坑的一门课，她一上课我就根本坐不住的那种感觉，事情还巨多，而且她的作业是你想不到的那种坑，哪怕学分不够到了拿退学警告的那种地步，我也不会再选她的课了
106363,1434,牟颖,2019-04-26 16:49:47,0,2,2,只要参与课堂，打分都挺好的
106916,1434,牟颖,2019-04-30 08:27:03,1,3,2,老师人很好，非常和善。事情比较多，拿高分很看小组合作。就是课讲的一言难尽...
119140,1434,牟颖,2019-11-11 00:51:33,5,5,0,绩杀绩杀绩杀，只能学到如何上网查资料
119141,1434,牟颖,2019-11-11 00:59:03,6,6,0,太无聊了，课上的手机都没电了
119157,1434,牟颖,2019-11-11 02:20:14,-4,2,6,不算太差
119165,1434,牟颖,2019-11-11 03:09:04,5,5,0,绩杀\n\n上课无聊，全是个人pre
119238,1434,牟颖,2019-11-11 13:40:03,4,4,0,拉我绩点
119336,1434,牟颖,2019-11-17 11:45:34,4,5,1,cnmdb
119392,1434,牟颖,2019-11-12 14:44:15,1,1,0,难说啊
119473,1434,牟颖,2019-11-13 03:27:23,5,5,0,走流程还是直接喷
119539,1434,牟颖,2019-11-13 11:00:14,-3,1,4,其实挺不错的老师，查资料的过程中可以学到很多，听同学展示也很有趣。
120091,1434,牟颖,2019-11-17 11:44:08,1,1,0,太烂了\n\n
126177,1434,牟颖,2020-09-18 12:21:41,3,4,1,讲道理没有教什么知识，但教了我们如何生产学术垃圾。说起来不好听，但这才是很有可能受益终生的东西。
126285,1434,牟颖,2020-09-22 01:04:10,1,1,0,怎么回事
126688,1434,牟颖,2020-10-14 04:03:34,5,5,0,第一个星期的展示就给了三天时间，tm微积分线代一堆作业没写搞这个
127600,1434,牟颖,2020-11-25 02:40:38,1,2,1,老师人很好，我论文粘贴复制的最后给分都很好，重在展示和上课提问！！！
130353,1434,牟颖,2021-01-21 09:08:02,0,0,0,讲课有一点无聊，但是老师人很好的，很温柔。(生物传感器技术)
135070,1434,牟颖,2021-04-29 02:46:03,0,2,2,还好，感觉上课认真点，成绩总是不差的，4.5
142665,1434,牟颖,2021-11-15 03:18:06,1,2,1,老师人很好。但上课要做很多的小组展示，很累
147950,1434,牟颖,2022-01-11 08:00:34,3,3,0,老师几乎不讲课事情巨多给分特别低别选超级坑
166738,1434,牟颖,2023-01-13 11:24:38,0,0,0,上课多点互动，课堂展示认真准备，最后要交的论文基本就是将一篇国外的翻译成英文的，成绩就95了。
198322,1434,牟颖,2024-09-07 03:36:38,0,0,0,HHH
23199,1475,胡瑞芬,2016-03-21 15:15:58,11,13,2,求认真备课……
58385,1475,胡瑞芬,2017-08-30 08:59:55,0,3,3,还可以
59430,1475,胡瑞芬,2017-09-21 09:39:35,-5,1,6,。。。
61500,1475,胡瑞芬,2017-11-18 01:23:48,4,8,4,自习。
62328,1475,胡瑞芬,2017-11-24 08:11:00,1,3,2,老师很可爱。。反正不点名不考试，水一水就过去了。
62332,1475,胡瑞芬,2017-11-24 08:39:54,-1,1,2,就讲的内容很广挺前沿的，认真听会有收获的
62375,1475,胡瑞芬,2017-11-24 13:25:26,1,3,2,讲得很清楚，内容也很丰富很前沿。ppt很简洁，不会有大段大段的文字，也会经常放一些TED和BBC的视频，来拓展视野。是一门很有趣的工科课，你会为大自然中各种奇异的构造折服，也会自然产生对机械仿生，神经仿生，纳米仿生的兴趣。老师非常的友善，并且很愿意倾听学生的想法，如果你在放生技术方面有自己见解，这是一个展示自己的舞台。这门课没有对与错，只求探索未来的无限可能。
62382,1475,胡瑞芬,2017-11-24 13:57:20,1,3,2,老师人很温柔很照顾学生。好好写论文，加油吧＾０＾~4.5的我忍不住打了个十分
62790,1475,胡瑞芬,2017-11-27 03:29:03,0,3,3,仿生学还是很有意思吧，上课语气比较平淡。给分好，但还是要展示和论文用功。
63433,1475,胡瑞芬,2017-12-04 03:43:57,-8,2,10,做线性代数的课，4.5分
64590,1475,胡瑞芬,2017-12-25 11:29:01,0,1,1,如果你是思维开阔，对新科技比较感兴趣的，建议你选，因为你可以去轻松地和老师去交流，或者听老师给你展现科技，当然也可以水着听了，老师没有怎么点名，而且吃东西水手机也不管，很温柔的老师，给分也很好，我上这个课不是想水，单纯地有时候听不懂，(不过这点老师结课的时候还道过歉，况且最后的展示和论文也不需要太学术)总之，老师很好了
73207,1475,胡瑞芬,2018-02-01 07:21:49,-2,1,3,点名很偶尔，展示论文认真做，给分稳稳的～
90664,1475,胡瑞芬,2018-11-25 03:54:29,0,4,4,听评论里的回答说水课但是绩点高我真的很生气，明明自己上课认真听，和老师互动，论文我也自认为好好写，展示也好好做，绩点3.3，就很搞笑呵呵
92817,1475,胡瑞芬,2019-01-04 14:57:55,3,8,5,我每节课都认真听，上课也算比较积极的参与互动了，展示也很棒，老师也反应很好，论文写得也很认真，但是绩点。。。3.3我想死了。
97718,1475,胡瑞芬,2019-01-22 14:06:35,5,7,2,老师是那种文静的轻声慢语的那种。备课认真，也在尽自己最大的力去使这门课变得有趣。不可否认对于大部分人来说，这门课本身就是无聊的，但是如果真的想要学到什么还是要看自己。期末有展示和论文(没有具体字数要求)，其他时间还是蛮轻松的，学到的知识的确蛮多。
97724,1475,胡瑞芬,2019-01-22 14:15:31,-14,1,15,水课  一节课没听过 全靠大佬展示 得了4.8
97725,1475,胡瑞芬,2019-01-22 14:15:40,0,3,3,首先，这门课水不水取决于你自己的心态，想水的那就水吧，但想学的的确能学很多东西，这门课真正学到的是创新的思想。考核是一次课堂展示，一篇论文，如果好好准备成绩不会差的，而且在准备中你也可以学到很多。最后，老师特别温柔，也很负责，点赞！
97726,1475,胡瑞芬,2019-01-22 14:15:43,0,4,4,认真听课，认真展示，论文也写了很多字，也写的很认真结果tm3.3？真的醉了。。。
98560,1475,胡瑞芬,2019-01-23 14:54:38,1,3,2,不点名 上课水水就行了 但是老师会讲的很认真 虽然PPT是去年的 最后论文和展示好好做就行 平时没什么事
102535,1475,胡瑞芬,2019-02-05 06:44:53,-3,1,4,事少分高老师好
104676,1475,胡瑞芬,2019-03-26 02:57:40,-1,1,2,事少分高 大佬带我飞
119904,1475,胡瑞芬,2019-11-16 23:55:52,0,2,2,给分不错，上课水一水就过去了
119908,1475,胡瑞芬,2019-11-17 00:08:42,0,1,1,展示+不限字数的报告，老师挺温柔的，玩手机做作业也不会管。我的报告水水的最后3.9，虽然低于这门课的均绩但是还能接受
119955,1475,胡瑞芬,2019-11-17 01:56:43,-3,3,6,老师是剑桥博士，水平真的很高，能让你了解很多前沿的知识。展示加论文，我的展示崩了 ，但是论文认真写，还是拿了4.8，强推这门课。
119992,1475,胡瑞芬,2019-11-17 03:53:57,-4,2,6,？为什么我认真听课，展示也大佬带飞，写了报告才3.3？
121123,1475,胡瑞芬,2020-01-19 18:09:54,1,4,3,社科生完全没有类似基础，刚开始看到这个课名我很懵 所以上课很认真就怕自己听不懂了期末爆炸，后来发现真的可以收获很多开拓很多视野，老师也尽力深入浅出了，而且超温柔。\n\n认真互动坐在最前边（偶尔上课睡着老师应该也看得清清楚楚）展示还算成功（虽然三人小组另外两个理工男的情况下基本我一个人社科的出力 准备阶段还是很崩溃）论文认真写 最后94=4.8 虽然差一分5.0有点点小遗憾但也很满足了。另外 之前说论文不限字数 在这学期同学提议下改成了5000字上限的 基本也说明老师也是反恶竞啦
132018,1475,胡瑞芬,2021-01-30 03:04:17,-1,1,2,不错～～就是容易困，希望改进上课方式。
143223,1475,胡瑞芬,2021-11-21 23:48:03,0,1,1,老师特别好，给分也还可以
143240,1475,胡瑞芬,2021-11-22 08:09:57,2,3,1,认真听课 认真展示 认真写报告 同下绩杀3.3...\n\n上课也从不写作业。。认为课水高分想选的小心下一个绩杀\n\n老师是挺温柔 人很好 但是成绩看老师喜好了……
143327,1475,胡瑞芬,2021-11-23 10:54:25,0,0,0,老师挺好的
145556,1475,胡瑞芬,2021-12-30 08:27:25,0,0,0,不错的老师
145791,1475,胡瑞芬,2022-01-02 10:41:11,-3,1,4,现代仿生科学与工程导论。\n\n94->4.8\n\n老师讲课水平挺高，讲得也挺有趣的，就是期末设计的要求有点高了（虽然我交上去的也不怎么样）
146498,1475,胡瑞芬,2022-01-06 17:13:26,1,1,0,还可以，上课比较枯燥，仿生课，干货还是有的。可惜我一直在写作业一节没听；论文好好写分数不低
150450,1475,胡瑞芬,2022-01-25 12:24:44,-1,1,2,现代仿生，上课很水，不点名不提问\n\n一篇论文定绩点，给分挺好
150462,1475,胡瑞芬,2022-01-26 00:35:31,0,1,1,老师是好老师，但是我不配🥺
150492,1475,胡瑞芬,2022-01-26 15:42:31,0,2,2,展示一般般 老师给提了很多建议 后来论文和期中期末两次的展示基本没啥关系 但是论文写的还是蛮认真的 最后4.5 写论文的过程能学到很多东西
161827,1475,胡瑞芬,2022-11-14 07:47:58,0,0,0,老师真的很温柔，给分爷不错
161921,1475,胡瑞芬,2022-11-15 04:42:38,3,3,0,芬芬真的好好，平时没作业，也不点名，就是课程中期有个小组讨论，就是和大家介绍一下小组关注的可以用仿生技术解决的问题，期末小组pre，介绍一种仿生技术（可以是期中小组讨论中的），并写个研究报告（3000字以内），技术不用我们自己研究，主要就是论文的查阅和我们自己的归纳，总而言之我觉得这是努力与收获绝对成正比的一门课，我虽然平时没怎么听，但是期末好好做了，最后5.0满绩，很满意，大家快去！
161922,1475,胡瑞芬,2022-11-15 04:43:52,1,2,1,啊啊啊啊我爱芬芬，纯纯的文科生对仿生学根本一窍不通，上课也几乎没听过，超级害怕这门课会让我喜提最低绩点，结果成绩出来很惊喜！最后认真写了一篇研究报告、做了一个小组展示就拿到了4.8。老师很温柔，讲的东西很超前很先进（但语速很慢，很容易催眠），课上从不点名，也不强制回答问题，最后论文字数也有上限，不用担心会有恶性竞争。总而言之，言而总之，强烈推荐，不要因为课名就被吓退~
163898,1475,胡瑞芬,2022-12-16 12:32:55,0,0,0,老师讲课认真，主要是给分超好
182702,1475,胡瑞芬,2023-11-19 15:42:23,-2,0,2,给分不咋地，期末报告认真写了，小组展示也很好，最后绩点实在难看，不知道自己问题出在哪
182772,1475,胡瑞芬,2023-11-20 07:27:31,3,3,0,总评还没出，先来打个10分。\n\n我上的是胡瑞芬老师秋学期的仿生课。老师上课真的好温柔，也很尊重学生。点名的话是线下签字，好像就最后一节课点了。\n\n如果只是想对仿生科学有个粗略的了解，那这门课是一个很不错的选择（同时还会拿到一个让人满意的gpa）。但受限于课时，上课的内容是比较有限的，如果已经有了一定的基础，想要有更深入的了解，这门课可能不是一个很好的选择。另外有关上课氛围，我们这个班上课比较沉闷，一般只有两三个同学会和老师主动互动（但我看其他通识课好像也差不多）
182978,1475,胡瑞芬,2023-11-21 09:29:48,1,2,1,给分好，而且报告不卷字数，反观这学期上的另外一门课，字数卷到11000只有3.9…
183023,1475,胡瑞芬,2023-11-21 14:30:08,3,3,0,现代仿生科学与工程导论，大一，秋学期，社科生，纯文科背景，绩点4.8\n\n只要论文好好写，小组展示好好弄，绩点不会低！但是听室友说冬学期改成英文教学了，作业也不一样了，变成了翻译一篇英文文献。这不就更简单了吗？很好的课！老师人很温柔，事儿少分高，如果想水完全可以水，认真听的话也干货满满。赞了！
184868,1475,胡瑞芬,2023-12-23 16:00:58,0,1,1,更新：\n\n满绩啦！
190113,1475,胡瑞芬,2024-02-22 05:39:28,0,0,0,老师人真的很好
218090,1475,胡瑞芬,2025-04-21 00:31:35,0,0,0,人工智能真的学不下去了
221763,1475,胡瑞芬,2025-06-26 05:22:42,0,0,0,人工智能基础c海底捞
221782,1475,胡瑞芬,2025-06-26 08:03:02,0,0,0,人工智能基础c海底捞 hrf心软的神
5773,1486,宋春跃,2015-07-09 09:49:56,21,26,5,很爽～
6661,1486,宋春跃,2015-07-17 10:12:38,3,6,3,专业课最好的老师，上课的理念会告诉你为什么我们学这个，容易使同学建立学科架构。
49641,1486,宋春跃,2017-07-06 13:21:16,1,1,0,老师给分棒棒哒
57192,1486,宋春跃,2017-07-06 03:36:27,0,2,2,讲故事讲故事讲故事讲故事
76326,1486,宋春跃,2018-04-03 04:25:13,2,2,0,听老师的课真的像听TED！！！
108087,1486,宋春跃,2019-05-14 11:07:39,1,1,0,超棒。。。。。。
120417,1486,宋春跃,2019-12-04 07:07:19,-1,0,1,好好好
122777,1486,宋春跃,2020-04-03 06:20:45,9,10,1,老师人很好…但我始终没摸清楚老师的讲课逻辑…
123292,1486,宋春跃,2020-05-30 06:44:40,3,4,1,会给学生建立整体的知识框架，告诉你为什么要学这个内容，这个内容在实际工程中有什么应用，而不是纯粹地讲题目。唯一有点蛋疼的是会突击小测，小测题虽然不难，但是总让人猝不及防。但作为老师，可以说真的做到传道受业解惑了。
139037,1486,宋春跃,2021-07-12 08:39:55,9,12,3,宋老师是一位非常好的老师，是我进大学以来最符合我想象的理工科老师。作为一门个性课选的自控乙，整个班都是其他专业的学生，而且常来的也就十个人，但宋老师依旧非常认真对待。善于用故事和需求去引入知识，会教你为什么会需要这个，为什么要学这个。即便站久了腰痛也会坚持为我们上三节课。考试虽然是全英文的，但可以在考场上问他单词，而且也会捞我们，不过我是考的太差了所以绩点依旧爆炸。不过自控乙课程很难对于我们这些非控制专业的人来说，老师也不太喜欢下课，所以选来做个性要做好煎熬的准备。
160218,1486,宋春跃,2022-09-15 06:16:56,3,4,1,最长评论把我想说的都说完了，宋老师确实是难得的理想理工科老师\n\n\n\n除了考试由于课程考点散和无历年题等原因难以把握之外都很好\n\n\n\n不过建议带着电路、复变等基础来上，否则你想跟上老师思路也不可能跟上
171103,1486,宋春跃,2023-03-16 02:51:45,9,11,2,上课讲思想，作业靠自学，作业还不少，实话实说有点难受
171769,1486,宋春跃,2023-04-04 12:56:47,5,7,2,老师讲得很好，但是这个课对于外专业的人来说真的没必要选，上这门课、阅读这门课的教材，整个就是对控制专业祛魅的过程。只能说课还是蛮恐怖的，而且不知道意义何在。
172448,1486,宋春跃,2023-04-27 03:39:37,0,0,0,***
173296,1486,宋春跃,2023-05-18 04:19:51,14,15,1,老师人挺好的，学术水平也很高，但也身体力行地证明了学术水平与教学水平是可以分道扬镳的\n\n1.与自动控制这门辣鸡课有关，对外专业的人太不友好\n\n2.老师是启发式教学，只讲原理，不讲例题，课后作业、考试全靠自学，对于习惯了12年应试教育的大多数人来说太不友好
174321,1486,宋春跃,2023-06-09 09:51:43,4,4,0,电子白板单推人强烈建议学校把宋老师的课安排在有电子白板的教室（
175868,1486,宋春跃,2023-06-27 15:06:32,0,0,0,***
177947,1486,宋春跃,2023-07-05 16:37:52,2,2,0,我为什么要选自控乙当跨专业，我真该死啊
177966,1486,宋春跃,2023-07-06 01:20:38,2,2,0,别选自控乙
178064,1486,宋春跃,2023-07-06 13:52:42,3,3,0,选自控乙的，最好修完信号与系统、复变函数、电路原理，不然你会很难受。宋老师上课挺投入的，但只讲思想不讲作业例题，很多东西需要自己去慢慢理解。期末考半开卷全英文，但非常简单。不过想刷绩点的慎选，给分很求是。
179449,1486,宋春跃,2023-09-16 04:51:33,2,2,0,傻孩子，快跑！
181486,1486,宋春跃,2023-10-19 04:36:13,1,1,0,忘记评自控乙了，怎么说呢，建议想学自控甲的来选
182045,1486,宋春跃,2023-11-09 03:16:49,3,3,0,老师人很真诚，别的班都有小测，就他没有，到最后一节课也没有
183245,1486,宋春跃,2023-11-23 06:12:10,3,4,1,启发式教学的老师
196512,1486,宋春跃,2024-07-04 01:30:02,5,5,0,真的是启发式教学，“不点名”是因为他全班人都认识了🤭
196574,1486,宋春跃,2024-07-04 06:12:13,3,3,0,老师人挺好的，非常有活力，会记着每个人的名字，课上也会经常带些零食。老师的讲课方式偏向启发式，而且喜欢互动，喜欢提问，讲课的风格还是比较独特的，虽然我个人不太喜欢，基本是自学＋上课划水，但是老师的人是真的好，总的来说好老师！
203613,1486,宋春跃,2024-11-20 07:09:21,0,0,0,还行吧，上课感觉有点快了\n\n今年考试卷子有点抽象啊
214025,1486,宋春跃,2025-01-23 04:08:48,1,1,0,老师很好！讲课有时候不按照课本来，但是跟着他的思路就会发现他其实讲得很清楚。感觉现控是你控院少数老师知道自己在教什么、学生知道自己在学什么的好课了
221088,1486,宋春跃,2025-06-26 09:25:43,0,0,0,24-25春夏自控只在51调课雷达点名一次，无小测\n\n但每次上课收发作业基本把人认齐了\n\n给分还不错
221793,1486,宋春跃,2025-06-26 09:28:51,1,1,0,整个学期就点过两次名 但是刚好那次不在 宋老师差不多认识班里的每一个人 非常非常认真 讲课也很有激情。\n\n刚开始上自控甲的时候，感觉他在按照自己的逻辑讲课，让我们理解自控里面的公式都是怎么来的，如何环环相扣，导致和作业之间有点区别，需要自学一下。但是问题不大，后面会好很多。\n\n总之是非常好的老师，讲课很吸引人，很喜欢和同学交流嘻嘻
24875,1540,陈曦,2016-05-04 06:11:14,29,31,2,陈老师讲的很仔细，对信号系统也有自己的见解，是很用心的在教学。
76580,1540,陈曦,2018-04-15 14:28:58,0,0,0,Question？
78441,1540,陈曦,2018-05-12 00:24:20,11,12,1,时间就是虚无。————控制学院首席男神你陈曦爸爸
78754,1540,陈曦,2018-05-15 04:32:49,-1,1,2,讲的还行，但给分有点坑
79578,1540,陈曦,2018-06-10 14:19:53,-55,7,62,浙大两年以来给我的听课体验最差的老师之一，课不上完从不给课件，理由是给了课件大家就学完了不来听课了？？有毒吧？\n\n上课还不断点名问问题，强行制造互动。\n\n偶尔冷幽默，给分还行，但是真的不是一个好老师，慎选！
84035,1540,陈曦,2018-07-12 01:31:02,7,8,1,陈曦老师是这个学期上过我控专业课里讲课最有水准的老师了。无论从知识层次到授课方式都很舒服，而且能看得出他是真的很关心学生体验的老师。不知道上面的同学在黑什么。
102829,1540,陈曦,2019-02-24 02:12:27,1,5,4,满分老师，虽然给分不理想，但是讲课很有水平，很认真，会让我们听懂，而不是水过去
106425,1540,陈曦,2019-04-27 09:15:37,-8,0,8,听说给分不好……可怕
108945,1540,陈曦,2019-06-04 13:58:44,-2,3,5,老师给分不太好吧，其它都还行，稍微偏古板些
124877,1540,陈曦,2020-07-14 08:47:13,-124,8,132,音乐课的陈曦，很垃圾，给分很迷，论文都是六七十分的吧
125647,1540,陈曦,2020-09-12 14:11:04,3,3,0,控院的陈曦，有幸上到陈老师的信号与系统真是太棒了。老师非常亲切幽默，讲课水平也很高。考试需要刷题。
130139,1540,陈曦,2021-01-18 03:43:20,-18,2,20,键盘乐，事情比水课多，比硬课少，分还没出可能公正一点（毕竟没人得了低分开心得了高分不开心对吧）\n\n想了解了解键盘乐可以考虑，想舒舒服服上水课时不时再翘个课的还是别来了。第一堂课说我这课不点名但你们尽量来教室听，结果好几节拖堂点名，听辨范围一次23首一次29首还是有点多的，比起来西方音乐简史那个听辨，记忆时间要长好多好多。
133637,1540,陈曦,2021-03-03 05:13:25,1,3,2,超级好，很温柔
133737,1540,陈曦,2021-03-04 10:02:52,3,4,1,陈曦老师人又帅又温柔啊啊啊啊啊啊上课讲的也超级清楚呀，乐理小白完全不用怕！我爱陈曦老师～
133915,1540,陈曦,2021-03-09 11:19:19,2,4,2,控院和音乐的陈老师都超级奶思！
134691,1540,陈曦,2021-04-09 14:50:10,3,3,0,钢琴男神绝好！！
135974,1540,陈曦,2021-06-07 03:49:53,-26,0,26,不太好
136483,1540,陈曦,2021-06-18 14:12:57,34,35,1,看评论要气死我了，这是大学以来遇到的最好的老师，认真地对待每一堂课，讲课的时候整个人都发光，弹钢琴做赏析的时候都能感受到老师对自己事业对音乐的热爱；讲课的内容也很有启发很有用，每个周最幸福的就是上陈老师的课，平时作业也特别少啊，而且也不会以水平绝对值评判学生，看重态度和进步的，能上陈曦老师的课是我的幸运！！！
136775,1540,陈曦,2021-06-24 08:32:18,5,6,1,超爱陈曦老师，今天视唱练耳结课了。老师很会鼓励人，人也很帅。但是视唱练耳对于音乐小白来说有一点点难，但如果每节课认真听还是容易的。
136971,1540,陈曦,2021-06-29 03:57:51,10,11,1,视唱练耳笔试有一点点难，是我自己摸鱼的后果\n\n老师真的非常nice，很温柔，而且很有气质，人也很好！
136993,1540,陈曦,2021-06-29 08:15:15,4,8,4,视唱练耳的陈曦。老师很好，上课准备很用心，对音乐有独到的理解和热爱。\n\n但是课程本身对零基础小白完全不友好，老师确实想让零基础的同学也能享受这堂课，但是无奈班级还是以有基础的同学为主，进度自然会拉快，上课也是以有基础的同学为主要对象。课堂体验就像旱鸭子混入游泳中级班。\n\n最终考试也很痛苦，完全被大佬吊打，自己像个傻子。课程结束得非常难受。很努力想跟上，坐前排，做笔记，预习复习，但还是比不过别人的童子功。只能说老师很棒，是我自己的问题。\n\n此生再也不愿看见五线谱
137094,1540,陈曦,2021-07-01 01:52:32,55,57,2,我陈曦男神，在这里认真评价的第一个老师。\n\n一开始对音乐院校不太了解，看到陈曦老师的自我介绍满不在乎。\n\n上百度搜了伊斯曼之后惊的我差点把手机扔了。\n\n上课时，三个关键词：认真、认真、认真。陈曦老师从来不敷衍，他会精准地将课堂内容掐到每一分每一秒，为了我们的期末考试周末冲到琴房去录了一下午的复习材料，记下了班级所有人的名字，在最后一次的口试还针对性地提出了你的不足和改进方法。\n\n有这么负责的老师你自然会学到许多，在这之外，陈曦老师的气质.....还是学不来。\n\n一句忠告：老师在内容上和授课上一点都不会敷衍，如果你没有乐理基础，选了这门课想要绩点就不要划水。我个人是个小白，准备视唱练耳考试的时间和大英四持平......\n\n在大学阶段，能接受到这样的博雅技艺（也算通识）教育实在是很幸运，以这堂课为起点，五线谱在我的眼中逐渐有了生命，对音乐的了解也不再仅仅局限于议论文论据的水平。\n\n感谢陈曦老师，超爱陈曦老师！
137125,1540,陈曦,2021-07-01 10:32:11,3,3,0,针不戳
137592,1540,陈曦,2021-07-05 08:00:41,4,4,0,视唱练耳。真切的感受到努力的意义！\n\n很感谢陈曦老师一学期的不断的鼓励，原来在音乐方面因为很差而很自卑，我想以后不会了。\n\n自己算是零基础小白，但乐理学起来真的不难呀，就上课认真听，当然老师讲课的魅力也不可能让我去干另外的事情，（除了偶尔还是战胜不了瞌睡虫），基本上都能听懂，不懂的去问老师也很耐心。\n\n有一个小组展示，一开始很害怕，因为自己什么都不会，但被组里的dl带着感受了音乐剧的魅力，开心！！！
138921,1540,陈曦,2021-07-11 18:45:16,13,13,0,永远爱cxgg！！！在键盘乐艺术史的课堂上你可以感受无数看似遥远的古典音乐背后有趣的故事，可以感受到cxgg现场弹琴散发的无限魅力，可以了解音乐家的无数种死法......即使对键盘乐不了解也可以很容易感受到他的魅力，直接冲！！！！！！！
138926,1540,陈曦,2021-07-12 00:06:54,7,7,0,人间理想
138936,1540,陈曦,2021-07-12 01:22:15,10,10,0,如果说第一位认识的男神老师，那一定是cxgg，猛男沦陷呜呜呜\n\n上学期蹭听视唱练耳的智云课堂，这个学期亲临现场听键盘乐艺术史，太绝妙的体验了，大开眼界、获益颇丰（应该来说键盘乐是我所有课里打开手机频次最少的）\n\n老师真的很认真，课准备得认真，内容丰富、资料充实；而且改作业也真的认真，在学在浙大上提交了那么多论文，只有老师给了我评语的反馈，特别感动！\n\n平心而论键盘乐确实有一定难度，也不是那么水；但是上了老师的课，才知道什么叫，人间值得！永不后悔这一学期奇妙的键盘乐之旅！
139007,1540,陈曦,2021-07-12 07:16:05,3,3,0,陈曦老师真的又帅又温柔呜呜
139059,1540,陈曦,2021-07-12 09:59:33,2,2,0,我直接男神!
139728,1540,陈曦,2021-07-22 01:07:41,14,19,5,大家注意呀，这是控院的老师，不是体艺部的老师，课否有音乐课陈曦老师，可以去那评（这是我第一次见到重名原来有这好处😂）
139733,1540,陈曦,2021-07-22 05:53:55,33,33,0,万年懒虫了，为了敬爱的男神，第一次来查老师动笔。\n\n键盘乐艺术史是补选上的，从此，每周三的晚上就成为了我的快乐源泉(*^▽^*)\n\n陈老师人帅衣品佳，气质出众，声线迷人，谦谦君子，温润如玉；浙大工科校友，毕业转投钢琴之路，热爱音乐，心里有火，眼里有光；伊斯曼钢琴博士，功底深厚，技惊四座，几乎每节课都能近距离欣赏masterpiece；备课用心认真，讲授生动风趣，从来不觉无聊，连PPT都是该死的优美和谐；师德人品，无可挑剔，课上鼓励同学们表达对音乐的直觉和思考，课下论文和观后感会给出中肯的评语，令人感动...\n\n最后，感谢一学期键盘乐艺术史的旅程帮我叩开古典音乐的大门，个中奥秘，留待他日继续探索\n\n听陈老师说11月会开一场独奏会，已经迫不及待了！课友们都支棱起来(#^.^#)
142886,1540,陈曦,2021-11-17 05:48:05,2,2,0,视唱练耳课讲的很好，老师很温柔
143678,1540,陈曦,2021-12-01 11:45:47,9,9,0,上这么久了第一次来评价，是大一的，当时选课只有四个名额60进1都给我进了，我真的大震惊。陈曦老师真的好酷啊，今天疫情第一次上网课真的都感觉人格魅力太大了。开课时就说周三的键盘乐音乐史的晚上是给我们繁忙生活中的放松！真的每次上课都很治愈，老师也很有趣，无论喜不喜欢音乐真的都能有陶冶情操的效果！小组介绍的学长学姐也都好牛！虽然还没考试什么的，但感觉上老师的课真的都会很开心，喜欢喜欢！！！有才华的喃人就是有魅力！cxggyyds！
144361,1540,陈曦,2021-12-21 07:15:11,2,2,0,我爱老师 陈曦yyds
144514,1540,陈曦,2021-12-22 03:46:30,3,3,0,老师真的太好了呜呜呜好有耐心钢琴技术也超高
145178,1540,陈曦,2021-12-28 05:50:31,2,2,0,男神男神男神！
145392,1540,陈曦,2021-12-29 10:04:47,11,11,0,今天视唱练耳刚结课  来评价一波\n\n真的没想到大学能遇到这样的老师 认真负责 温文尔雅  虽然是一门音乐课 但老师和同学们都非常投入  作为一个不懂乐理的小白 从来不认为乐理是有意思的 从来忽视自己会从音乐中得到什么  体会到什么 平时也只是喜欢听歌 喜欢唱歌 但是陈曦老师那份对音乐的敬畏和热恋 他身上的气质让我知道了热爱的东西终是能改变一个人的 对他的评价已经不能限于一个好老师，只能说是真音乐家 真艺术家！！\n\n没有博雅技艺和美育的uu速速来报（虽然十几进一概率很小但是还是要报）有了的uu也可以去真的很值得
147669,1540,陈曦,2022-01-10 11:52:28,24,24,0,老师真的特别棒，即使知道本菜鸡一定会被正态，我也要给陈曦老师打时分。我上的是打开艺术之门钢琴，可以说是零基础甚至负基础起步。但是陈曦老师真的特比特别好，每节课结束以后都会自己再留很长时间给大家答疑。最后会拍合照，鼓励你，希望你继续热爱音乐！！！！\n\n虽然钢琴真的好难，我就是老师口中那个说“钢琴课时间花的比微积分还多的同学”，并不断调侃感觉被关上艺术之门……不过老师真的超棒超有趣。不能因为我不擅长就昧着良心给老师打低分吧！！\n\n为什么最高只有十分！！！！
148514,1540,陈曦,2022-01-12 17:33:36,128,150,22,老师很好，但是钢琴十级的同学请你们能不能不要来选这个课划水啊，真正想打开艺术之门的人打不开，还要面临更大被正态的压力，花那么多时间练习，出分3.3，真的心碎了😭
149254,1540,陈曦,2022-01-15 01:26:22,9,9,0,守护世界上最好的cxgg！！！
149416,1540,陈曦,2022-01-15 09:01:44,6,6,0,出分了我又来啦！本来担心自己论文写的一般般拿不到很高分呢！不过还是拿到不错的成绩啦！！！很喜欢cxgg的课，只能说每节课都有去，练习听歌识曲的曲子也都有好好听（但是真的好多哇）。每次上课听到老师弹琴都真的是一种幸福。艺术史推荐！！！
150530,1540,陈曦,2022-01-29 03:52:36,10,10,0,听键盘乐的课实在是一种享受！手机都舍不得拿出来看一眼的那种！关于音乐、关于作曲家、关于作品、关于人生，老师会很积极鼓励大家去思考更深入的问题，也能收获到知识以及知识以外的东西。老师人真的非常好QAQ 谦和温柔又有趣，不选会亏！
152601,1540,陈曦,2022-04-15 12:45:47,11,12,1,和蔼可亲、耐心、钢琴王子——男神级人物\n\n热爱音乐的小伙伴可以来试试，课上有很多干货，讲乐理知识（对小白可能需要花一点时间记忆理会）。上课三节课时间一般一节讲知识，一节小组pre，一节欣赏音乐（cx老师都有独到的简介，十分有趣的）。平时作业不算多，期末考试也没有超纲的内容，认真学就可以了。
152610,1540,陈曦,2022-04-15 16:10:46,10,10,0,讲的很细仔、清楚，上课会经常停下来问我们有没有问题，人超级和蔼，知道我是玉泉老哥以后还主动要送我回玉泉，老师真的太好了
154478,1540,陈曦,2022-06-02 01:23:36,22,24,2,全校最好的音乐老师，专业水平、人品和教学水平都是。越懂音乐越能明白他到底有多牛，都给我去上，都别跟我抢，望周知
154568,1540,陈曦,2022-06-02 06:54:21,10,10,0,堪称完美的男人
154607,1540,陈曦,2022-06-02 11:44:01,8,8,0,男神 真的男神 从来没有遇到这么温柔真诚的老师
155142,1540,陈曦,2022-06-08 16:50:16,8,8,0,视唱练耳：无论有没有音乐基础都可以学会都可以学到很多东西的课程。老师真的很温柔，很有耐心。非常推荐
155206,1540,陈曦,2022-06-09 09:45:05,19,19,0,音乐课的陈曦老师是真滴好哇，满分老师。话说为啥控院的陈曦老师还没跟体艺部的陈曦老师分开，现在这个样外面显示的是控院的陈老师啊
161261,1540,陈曦,2022-11-02 11:49:11,10,11,1,陈曦老师真的很温柔，上他的键盘乐音乐史我都很心疼他，明明几乎没有人在听，他还是很认真地在讲。另外，请上可以想划水的人不要太嚣张好吗，陈老师在讲课时你带着耳机哼歌真的好吗，我都为你感到害臊！
163696,1540,陈曦,2022-12-16 03:16:25,42,47,5,给大家一点冷知识，zju有两个老师，重名了，都叫陈曦，一个是控制学院的老师，一个是教钢琴视唱练耳的老师。
163826,1540,陈曦,2022-12-16 07:44:19,1,1,0,陈曦老师我爱你，太有魅力了！
163894,1540,陈曦,2022-12-16 12:14:31,2,2,0,老师挺好的
164031,1540,陈曦,2022-12-17 10:49:27,6,6,0,来积攒点运气，让我打开一下钢琴的艺术之门吧，球球了......没看到评论的时候，我想的是，这个老师好厉害...教控制学居然还会搞音乐......
164444,1540,陈曦,2022-12-21 04:11:50,11,11,0,来自大一秋冬学期视唱练耳的小白一枚\n\n如果你是和我一样完全没有接触过乐器、声乐的小白，要做好心理准备\n\ncxgg温文尔雅如沐春风，上课分享的乐理知识也十分硬核\n\n如果课程压力大，抽不出时间来巩固的小白可以暂退\n\n笨人误打误撞选进视唱练耳，被一众大佬虐的体无完肤\n\n每节课都坐在第一排努力跟上老师的节奏，平时还要看B站补补\n\n但是！！！cxgg是看进步打分的，小白完全不用怕，他真的会很贴心的照顾新手\n\n例如每次节奏和旋律听写都写不出来的我（真的没有音乐细胞嘛www）他会先绕过我，最后再来教我怎么听\n\n他真的，我哭死。 混到脸熟后还经常在餐厅碰到他给我打招呼qwq\n\n对比其他课程来说，视唱练耳平时作业少，平时认真听，期末复习一下乐理就好啦。\n\n虽然现在还没有出分也还没有期末考，但是还是想来夸夸我男神！
165167,1540,陈曦,2022-12-29 14:38:13,4,4,0,cxgg真的太好啦！视唱练耳刚考完期末考来留个评论，课程结束了难免有点小失落，这个学期在视唱练耳课上真的很开心！\n\n老师真的很温柔也很喜欢和大家交流，有感受到老师的真心！！！
165532,1540,陈曦,2023-01-16 08:21:50,9,9,0,键盘乐艺术史事情少分还高，平常只是上课听了听，听歌识曲的题库花了一两个星期循环播放（我本身就很喜欢音乐所以并不是什么有压力的事情），期末小作文写出真情实感，就满绩了。老师也非常有水平，看他演奏是一种享受，人也非常好。强推cxgg！
166230,1540,陈曦,2023-01-11 13:06:23,21,21,0,是我不论绩点多少都要先过来打十分的老师了
166544,1540,陈曦,2023-01-12 16:55:33,4,4,0,我爱陈曦老师（半夜过来打分）我不允许有人不知道陈曦老师，上课真的很温柔人很好，认真学真的能学到很多东西，上课氛围也很好，小组合作也很愉快，期末考试老师也很宽容。最后我爱陈曦老师😍
167363,1540,陈曦,2023-01-15 15:43:27,4,4,0,键盘乐艺术史被狠狠捞了一把，抚慰我被大寄基伤害的小心灵！cxgg我永远的男神😭😭😭 听力小测一塌糊涂，期末论文马马虎虎，结果4.5的绩点真的完全超乎想象，出分了马上来给cxgg疯狂点赞😍😍😍
167386,1540,陈曦,2023-01-16 02:08:24,3,3,0,键盘乐艺术史收获了人生中第一个满绩，cxgg yyds
168035,1540,陈曦,2023-01-23 10:58:04,2,2,0,我爱陈曦老师🥲
168056,1540,陈曦,2023-01-24 16:59:29,2,2,0,我爱他！
169186,1540,陈曦,2023-02-24 14:29:25,11,11,0,陈曦老师人超级好 人又帅 又温柔又幽默 还会给我们看有趣的视频 给分很好 不选陈曦老师的课后悔一辈子
169187,1540,陈曦,2023-02-24 14:29:30,-17,2,19,老师讲课也讲得很好 给分也很好 我几乎一节课没听都有4.2
169839,1540,陈曦,2023-03-08 06:24:17,30,34,4,谢谢 想谈师生恋😍😍😍😍😍😍😍😍😍😍😍😍😍😍😍😍😍😍😍😍😍😍😍😍😍😍😍😍😍😍😍😍😍😍😍😍😍😍😍😍😍😍😍😍😍😍😍😍😍😍
171387,1540,陈曦,2023-03-23 05:41:07,17,17,0,如何能抵抗一个有趣又温柔、声音好听、会弹钢琴搞音乐的帅气老师的魅力😭\n\n陈曦老师的音乐鉴赏课是我满课周三的限定份治愈和心动❤️
172433,1540,陈曦,2023-04-27 01:40:55,13,15,2,感觉要变弯了🤣
172709,1540,陈曦,2023-05-05 02:40:23,10,10,0,今年选上了两个陈曦老师的课！钢琴和信号与系统🥰两位老师都超级好！
174274,1540,陈曦,2023-06-08 15:14:50,16,16,0,上的是陈曦老师（体艺部）的打开艺术之门——钢琴，趁着期末考之前先来评一波！！（放烟花）\n\n首先要表白cxgg，我真的特别特别喜欢你，能不能和我谈恋爱QAQ...\n\n这学期点过一次数字点名，平时没有作业，约4人一组每组要pre，第八周有期中考（120/min的速度爬音阶+自选曲目），第十六周有期末考（90/min的速度爬音阶，任选g大调或f大调+自选曲目）。\n\n上课轻松又愉快，老师对曲子信手拈来，从拉二到菊次郎的夏天（弹菊的时候还给同学们丢了一个很可爱的小眼神！！就是那种“哎呀，这首曲子你肯定认识吧？”的那种萌萌小眼神🥺），对各个时代的音乐大家也是了如指掌，有很丰富的音乐知识；与此同时，cxgg对待同学们的态度很亲切，完全不会因为你是小白而低看你或态度不佳（我是一个很容易在老师面前觉得自己班门弄斧、而总是很紧张的人，但是在cxgg面前也能感到放松）\n\n不过，讲一句实话，钢琴本身是一个有点复杂的乐器orz......我是有一点点钢琴基础的，所以对上课内容会觉得比较轻松，如果很社恐、且钢琴0基础，慎选。\n\n下周就要期末考了，我会努力好好弹的！！哥哥也不会让我伤心失望的吧？🥰🥰🥰（出分之后会再回来一次~）
174626,1540,陈曦,2023-06-14 16:58:40,10,11,1,虽然《古典与流行音乐鉴赏》只是一门通识课，但却带给了我进入ZJU二年以来从未有过的课程体验。在正式告别之前，老师感人肺腑的发言，又让我回忆起了高中毕业时那种平淡而又伤感的场景……\n\n虽然每一次课的时间很有限，但我仍然很享受这样的音乐之旅。可能这门课于我最大的意义，就在于让我在枯燥重复的日子里又找回了自己曾经的热爱吧。\n\n老师在上课中抛给了我们一个问题：音乐的power是什么？这个问题对应了第一次课老师给我们提的另一个问题：你们听音乐的目的是什么？音乐的作用是什么？没想到自己的回答竟然起到了抛砖引玉的作用，引出了一众同学的回答，能够看见大家对音乐不同的感受与理解，也是一种奇妙的体验。虽然我和大多数同学素不相识，但对音乐的热爱却让我们凝聚成了一个共同的整体。\n\n而在最后，老师回答了课中的这个问题——音乐的power就是empower our soul，无论我们处于怎样的情景下，音乐总能引发我们灵魂的共鸣，这就是音乐最大的力量。回想自己这二十多载的人生，在每个阶段都会进入像现在这样的低谷期，而音乐总是我的良伴，陪我度过艰难而漫长的岁月，让我有重新爬起的信念。能启发我这番思考的一门课，或许才是我心目中最好的课程吧～
174661,1540,陈曦,2023-06-15 07:16:45,15,15,0,选的钢琴，必须10分，强烈支持。老师太温柔了，以至于我不每周课后练习三天钢琴就感到惭愧的地步。期末考紧张到窒息地弹奏完，只见老师面色凝重，很努力地说一些安慰的话，我的心瞬间掉进了冰池里，后悔自己为何如此紧张不堪，绩点什么的已经不重要了，让老师失望就是我最大的罪过啊啊啊啊！
174917,1540,陈曦,2023-07-27 11:06:49,30,30,0,真正的鼓励型老师，真的很善于发现每位同学的闪光点\n\n\n\n语言难以描述我对老师的爱。10分送上
174935,1540,陈曦,2023-06-20 05:07:18,11,11,0,cxgg，男神，我超爱！\n\n浅谈一下打开艺术之门-钢琴的期末考\n\n对于第一次接触钢琴的小白来说还是有点小难度的，主要是看谱识曲+（独奏+音阶上行下行）/四手联弹。\n\n看谱识曲就是会在课程后期介绍乐史上的几位大师，介绍生平及谱子风格（运音记号，织体，拍号，调性，技巧等），会有总结，会发题库，最后考试形式就是从谱子中截取有典型性代表性的一页两页让你根据风格辨别是哪位大师的哪首作品，不含弹琴部分，不要妄想多听几遍听音色旋律辨别（像我一样wwww），最后两题可能会出题库外但是课上有展示过的曲子让你识别是哪位作曲家。总体来说就是有点难，本小白就是一团浆糊程度。\n\n独奏就安心练适合自己的曲子就好啦，可以选自己喜欢的也可以选老师提供的期末曲库或者英皇的曲子！\n\ncxgg尊的是宝藏男孩，冲爆艺术之门！
176868,1540,陈曦,2023-06-30 13:11:54,13,13,0,我是前面2023.6.8的同学，已经出分了，成功满绩！！🥰🥰不枉我狠狠背了两天的谱子（拼命记调式、拍号、大致的音符分布、甚至想背不同谱子的画质.....)这是我人生第一个满绩555555......cxgg我爱你！！🥰🥰
177009,1540,陈曦,2023-07-01 04:56:47,18,19,1,很幸运，在大二即将结束时就已经上了陈曦老师的三门课了（大一上键盘乐艺术史，大一下视唱练耳，大二下古典与流行）。\n\n课堂上处处能感受到老师对古典音乐的喜爱与专业知识的充沛，各个音乐大师的生平与著名作品信手拈来，对作品的内涵也有很独到的理解。\n\n老师总是以一个很开放包容的心态对待我们每位同学的展示以及对音乐的理解，总的来看，我们学校流行音乐方面的老师是缺失的，但陈曦老师作为古典出身的老师依旧能以开放的心态学习流行音乐方面的知识，并且在我们学校开设《古典与流行音乐鉴赏》这门课程，我觉得已经弥补了很大的空白。\n\n希望本科四年能够把陈曦老师在校开的每门课都体验一遍。
177248,1540,陈曦,2023-07-02 11:31:59,-68,3,71,当面一套背后一套的
181626,1540,陈曦,2023-10-24 14:15:39,9,10,1,老师我喜欢你
181900,1540,陈曦,2023-11-04 04:53:13,9,9,0,四年青春最美好的回忆之一就是听曦哥弹琴
185474,1540,陈曦,2023-12-30 05:41:41,5,5,0,视唱练耳：无需多言（其他好评中的内容均属实），十分奉上
185711,1540,陈曦,2024-01-03 18:50:18,22,22,0,结课啦！第一次来查老师写评论，先给老师奉上一个十分～\n\n（以下是碎碎念，本人废话特别多，长文预警）\n\n大二上因为缺博雅技艺哐哐一顿狂选，没想到艺术之门真给我踹开了\n\n在选上视唱练耳后的几天，我还犹豫要不要退掉，原因很搞笑，只是因为我发现要口试，尬得我两眼一抹黑。不过幸好我没有干这样的混账事！第一节课结束后我就决定我一定要留这门课了，因为我发现了许多命运的巧合。那节课老师分享了几首曲子，这几首在我人生的不同阶段各有一席之地。老师弹完《river flows in you》的时候我还悄悄抹眼泪了。记得高三有一段时间我靠窗坐，每天午休结束前一分钟洒水车会从窗前经过，本来那辆洒水车放的一直是《故乡的原风景》，但是在一个早春的雪天它突然换成了《river…》，那时的我总在担忧不确定的未来，但那天刚好某次考试出成绩，我考得特别好，所以对未来又十分憧憬。每每听到这首曲子，我都会想到那个忧虑但又充满希望的自己，和窗子缝隙里涌进来的潮水般的凉风，以及萦绕心间的乐曲。这是我残留的为数不多的不算差的高中记忆。\n\n这只是一个小“巧合”，还有特别特别多的巧合。通过这些巧合，陈曦老师重构了我的记忆。我从4、5岁开始学琴，一直磕磕绊绊到12岁，12岁之后几乎再也没有碰过琴，甚至在上老师的课前我都没有重拾这门技艺的打算。我自认为记忆力很好，也非常重视回忆，但我依旧忘性很大，所以特别感谢老师总能用一首曲子或者一句话调动起我淡忘掉的那些愉快的旧时记忆，也特别感谢老师教会我更多的乐理知识，可以让我模仿着去理解和解释为什么我会对某一段旋律情有独钟。\n\n室友a后来说没想到你上了视唱练耳从此发现了人生美神（笑晕）陈曦老师真的是我的人生美神！\n\n视唱练耳还是我大学以来唯一一门从未想过结果，只享受当下的课程。正因如此，我看到了一种和自己的焦虑和解的可能。\n\n感谢陈曦老师！
185712,1540,陈曦,2024-01-03 18:50:18,8,8,0,结课啦！第一次来查老师写评论，先给老师奉上一个十分～\n\n（以下是碎碎念，本人废话特别多，长文预警）\n\n大二上因为缺博雅技艺哐哐一顿狂选，没想到艺术之门真给我踹开了\n\n在选上视唱练耳后的几天，我还犹豫要不要退掉，原因很搞笑，只是因为我发现要口试，尬得我两眼一抹黑。不过幸好我没有干这样的混账事！第一节课结束后我就决定我一定要留这门课了，因为我发现了许多命运的巧合。那节课老师分享了几首曲子，这几首在我人生的不同阶段各有一席之地。老师弹完《river flows in you》的时候我还悄悄抹眼泪了。记得高三有一段时间我靠窗坐，每天午休结束前一分钟洒水车会从窗前经过，本来那辆洒水车放的一直是《故乡的原风景》，但是在一个早春的雪天它突然换成了《river…》，那时的我总在担忧不确定的未来，但那天刚好某次考试出成绩，我考得特别好，所以对未来又十分憧憬。每每听到这首曲子，我都会想到那个忧虑但又充满希望的自己，和窗子缝隙里涌进来的潮水般的凉风，以及萦绕心间的乐曲。这是我残留的为数不多的不算差的高中记忆。\n\n这只是一个小“巧合”，还有特别特别多的巧合。通过这些巧合，陈曦老师重构了我的记忆。我从4、5岁开始学琴，一直磕磕绊绊到12岁，12岁之后几乎再也没有碰过琴，甚至在上老师的课前我都没有重拾这门技艺的打算。我自认为记忆力很好，也非常重视回忆，但我依旧忘性很大，所以特别感谢老师总能用一首曲子或者一句话调动起我淡忘掉的那些愉快的旧时记忆，也特别感谢老师教会我更多的乐理知识，可以让我模仿着去理解和解释为什么我会对某一段旋律情有独钟。\n\n室友a后来说没想到你上了视唱练耳从此发现了人生美神（笑晕）陈曦老师真的是我的人生美神！\n\n视唱练耳还是我大学以来唯一一门从未想过结果，只享受当下的课程。正因如此，我看到了一种和自己的焦虑和解的可能。\n\n感谢陈曦老师！
187528,1540,陈曦,2024-01-16 12:35:33,8,8,0,还没出分，但是陈曦老师就算给我挂了我也愿意给十分（虽然cxgg超温柔，肯定不会这么做）。真的超级无敌好老师，因为是补选上的，所以前几节课没听到，cxgg超贴心的帮我找了以前上网课的视频（琴房好像没有录播）。然后，cx真的好帅呀，男神，声音也好听，人还超温柔。最后，谢谢陈曦老师真的打开了我们的艺术之门！（我爱cx啊啊啊！！！）
187664,1540,陈曦,2024-01-17 03:56:30,5,6,1,钢琴满了！！！谢谢老师！\n\n\n\n真的很推荐这门课。我是零基础大音痴，属于合唱每次都会大跑调带偏旁边同学于是被勒令闭嘴的那种音痴TT还是那种每次考试都会背谱的笨蛋，老师说可以不背的，但是问题就是我做不到视奏，于是每次能顺着弹下来的时候就不得不会背了（）加上班上确实有不少同学钢琴水平本来就很好，课上视奏也会经常跟不上，所以总是很自卑。\n\n\n\n但是老师会很温柔地安慰你，而且不是那种很敷衍的，是真的让人觉得老师有看到你的进步，即使很慢很微小。我一直觉得我弹得这么烂老师真的会注意到吗，但老师真的会看到，背谱，踏板的处理，折指的改善……第一次视频作业战战兢兢地看老师听完了已经准备emo了，结果老师说这不是做得很好吗的时候瞬间活过来了！！！期末考也是，努力很久很久结果最后还是弹错了一个音，强弱变化也没有做好……但是被老师的总结安慰到了。说得特别好！但是内容是啥欢迎大家选课亲身体验（doge）\n\n​\n\n想起来补充一下。看谱识曲有一个非常好用的小寄巧（可以说吗）调号！！以及想区分肖邦的三首曲子也很简单看左手伴奏的形式就可以了。（以及，背画质是没有用的）
187866,1540,陈曦,2024-01-17 15:30:28,4,4,0,大学里第一个满绩！\n\n老师特别温柔有耐心，很会鼓励人，而且也记得住学生，平时碰到了也会打招呼，上课什么曲子都信手拈来，因为之前期末考试识谱的时候听了很多古典音乐，有一些很喜欢现在也会经常听，感谢陈曦老师！永远的男神！
188242,1540,陈曦,2024-01-18 13:13:03,9,11,2,啊啊啊啊啊啊啊啊啊啊啊啊啊啊啊啊啊啊啊啊啊啊啊啊啊啊啊啊啊啊啊啊啊啊啊啊啊啊啊啊大学第一个满绩！！！！！！！！！！！！111
188316,1540,陈曦,2024-01-18 15:29:36,11,12,1,视唱练耳，拿到了大学第一个满绩！陈曦老师真的很好，人格魅力与音乐素养毋庸置疑，无需多言，参见前面同学的评论。陈老师给分也很好！他上课时说过，之前的课上要求比较严格，他想了想觉得乐理知识对于同学们以后可能也没有什么很大的帮助，于是降低了很多难度，任务量也非常轻松。我是女生，虽然很喜欢听歌，但是唱得并不是很在调上，而且音色比较沙哑，音调也比一般的女生低。这学期就是课上认真听，重要的地方（老师会讲很多遍的，你肯定能听出来重点是什么），只有两次作业（是唱一段节奏和旋律，而且是不看绝对水平，只要按时提交了就是满分，10分钟就能完成），期末考核是口试（唱两段旋律和一段节奏，其实本人唱得并不好）和笔试（一些乐理知识，只要上课听，在考试前老师也会带着大家复习，不会很困难），然后就收获了满绩！真的很开心！每次去上视唱练耳课都能让心情变得很好～给陈曦老师打call～
191577,1540,陈曦,2024-04-25 08:38:49,4,5,1,老师好好啊呜呜呜体贴地问我是不是有早八，哪怕天天在他课上迷迷瞪瞪他也还是说没关系看出来我很累了他的钢琴课就是来放松的他不会说什么的呜呜呜，我哭死真的
192890,1540,陈曦,2024-05-31 10:01:18,3,4,1,不解释，无脑选！
192907,1540,陈曦,2024-05-31 12:38:36,3,4,1,老师太好了，我哭死
193130,1540,陈曦,2024-06-04 02:30:33,4,5,1,很能够感受到老师对音乐的热爱，也会被这种热爱所感染
193606,1540,陈曦,2024-06-13 15:02:01,8,9,1,上大学以来遇到过最好的老师，在西三钢琴教室的回忆伴随着窗外的虫鸣，教室里的花露水味道和大家的合影落下尾声。离开时一位同学正好在弹奏菊次郎的夏天，回寝室的路上阳光特别好，我哼着菊次郎的夏天，莫名感到一阵惆怅。陈老师的钢琴课虽然不是专业课，像陈老师所言也许不会对未来的学业有什么帮助，但这门课一定是我大学四年最快乐的一门课程，是我未来都会不断回忆的美好记忆。特别感谢陈老师！老师的优点我就不多说了，前面的评论句句属实，选上这门课也不亏我其他课掉光的运气转移，值了！
193619,1540,陈曦,2024-06-14 03:31:19,8,9,1,快毕业了才第一次写评价~这学期选上了视唱练耳。陈曦老师是真正地认真对待和尊重每一位同学，很厉害的老师却特别谦逊，分享音乐充满热情、幽默有趣，每周二满课人到晚上都很暴躁，但是上完陈曦老师的课莫名就被治愈了变得平静安心。喜欢音乐的同学不要错过！cxgg是大学上了这么多课最喜欢的一位老师！
193651,1540,陈曦,2024-06-14 11:30:08,7,8,1,陈老师真的特别好，真的非常谦逊温柔的一位老师，就算你没有基础、什么都不会，他也永远可以找到你的优点，告诉你没关系，有进步，很棒...会跟我们说上这个课就是在放松，只要享受音乐就好，然后会给我们分享各种有趣的音乐，以及一些音乐中的故事，也通过音乐告诉我们，感情就是要表达出来，有什么想要说的话一定要勇敢的说出来...非常感激陈曦老师这一学期的陪伴，只是我还是不太好意思对他去很认真的道谢，只能在这里发出来啦，希望大家都能好好珍惜陈老师的课，真正通过美育课程喜欢上音乐。
195599,1540,陈曦,2024-06-29 03:27:23,2,4,2,cxgg太好了。。。真的是上大学以来遇到的最好最好的老师。选钢琴课是因为之前有一点基础，感觉会比较轻松，然后上课的时候老师说看得出我有基础，对我有一定的期待，让我有一点点压力，特别害怕辜负老师，最后四手联弹也选了难度比较高的曲子，期末考试前认真合奏了好多次。好在最后期末表现还不错！cxgg的好是会让人比起担心分数不高，更担心让老师失望的那种好😭😭😭最后满绩了真的谢谢老师，如果能有机会希望还能上cxgg其他的课。
196657,1540,陈曦,2024-07-04 14:22:20,1,1,0,陈曦老师真的是大学以来最符合我对大学老师期待的老师，无脑冲就好！！
197532,1540,陈曦,2024-07-18 05:41:13,3,3,0,感谢陈老师让我读懂音乐，虽然只是略知皮毛，但真的影响很大。考试有难度但给分很好，超赞！
200002,1540,陈曦,2024-10-10 17:32:22,22,22,0,（控院的陈曦老师）\n\n选他的课无所谓，但别傻傻地跟他读研读博！实验室方向杂，他水平还不够，绝大多数学生完全得不到科研指导。另外，他现在一心扑在项目上，不管博士硕士，都是项目牛马，尤其是专硕，各种出差，发配湖州、绍兴、大连…聊项目秒回，问别的已读不回。没有时间观念，时常晚上打电话，临时拉讨论，每次都能低效讨论大半天…罄竹难书啊！为什么还有源源不断的同学进组？
200921,1540,陈曦,2024-10-24 19:08:10,0,1,1,曦哥真的太帅了
212626,1540,陈曦,2025-01-14 09:52:21,0,0,0,神，无需多言
212830,1540,陈曦,2025-01-15 04:21:00,0,0,0,神仙老师
215876,1540,陈曦,2025-03-06 10:39:13,1,1,0,刚开学，上课还没多久，已经被陈曦老师的魅力深深折服！老师真的是一位谦和有礼的绅士呜呜呜！我爱老师！
219680,1540,陈曦,2025-06-04 04:22:27,1,1,0,视唱练耳无脑冲，你会被男神的人格魅力深深折服。
219765,1540,陈曦,2025-06-05 08:49:04,3,3,0,钢琴：神，男神，少有的让我结课以后感到不舍的老师，没什么多说的了，就是神，什么时候老师开演出我必去
220299,1540,陈曦,2025-06-17 07:53:08,0,0,0,视唱练耳，每周在专业课堆里有一门神清气爽的课谁懂！我是纯小白，亲测难度不会很大的不要有顾虑，老师一直是鼓励式教育，希望上课的宝宝们都能好好享受!
221379,1540,陈曦,2025-06-23 07:07:10,1,1,0,视唱练耳|陈曦老师真的是一位令人尊敬的老师，温柔、谦和、儒雅且尊重学生。作为一个没有基础的同学，陈曦老师从来没有否定过我，反而会一直受到他的鼓励，最后也圆满完成了期末考试。最后一节课下课在回去的路上，我哼着自己抽到的曲子《摇篮曲》的节奏，想到老师说的话“我希望音乐课上的某个点就这样让你们记住，然后在今后的人生带来一些光明的片刻。”我想，这也是老师开设这门课的意义，是音乐赋予我们的，生命的意义！
221393,1540,陈曦,2025-06-23 07:44:29,0,0,0,怎么两个陈曦老师混在一起了（笑）大多数也是评价音乐老师陈曦的。那像我这样想看看另一个陈曦老师怎么样的怎么办呢（笑哭）
221616,1540,陈曦,2025-06-25 02:48:24,1,1,0,老师非常非常好\n\n但是是不是像评论区中说的无脑冲 我认为还是要慎重\n\n\n\n很多人选这个课大抵是为了美育分吧\n\n对于这类人而言，特别是从小从来没有接触过音乐乐理的人来说\n\n这堂课除了欣赏部分，还有一些探讨哲思（比如首尾两堂课放的视频）的部分\n\n乐理部分、节奏部分、旋律部分实在是太难了\n\n特别是乐理部分，虽然我好好学了\n\n但是我觉得学这些内容并不是大部分人进入艺术之门的路径\n\n其实蛮枯燥的\n\n\n\n上课的话，前排氛围会好一点，高手也比较多\n\n各位理工科大神散落在教室的后方\n\n刷手机的刷手机 逃课的逃课\n\n\n\n我能感受到老师对音乐的热爱\n\n我也能感受到前排同学对老师的热切回应\n\n但我感受不到我内心被音乐、被乐理感召的感受\n\n如果真想学点什么\n\n建议选他的钢琴
331,1577,熊蓉,2015-03-15 00:57:30,4,6,2,老师很厉害 讲课很贴近学生
628,1577,熊蓉,2015-03-15 08:36:05,3,5,2,美丽与智慧并存
1308,1577,熊蓉,2015-03-21 19:17:29,1,3,2,机器人导论课让我对机器人有深刻的了解。\n\n
4999,1577,熊蓉,2019-02-25 00:54:24,23,33,10,机器人导论课实在太赞 通过各种视频让我们了解机器人前沿发展 想选她课的以后一定要认真 会收获很多的
6950,1577,熊蓉,2015-08-23 03:23:05,2,7,5,不好多说
11818,1577,熊蓉,2015-12-16 05:56:11,2,3,1,超级好的老师
12868,1577,熊蓉,2015-12-24 07:07:18,7,8,1,很和蔼的老师
20709,1577,熊蓉,2016-01-30 06:24:02,5,7,2,老师很平易近人，对学生很好，给分也不错
41203,1577,熊蓉,2017-01-10 03:35:55,3,3,0,很有收获，她知识很渊博，愿意和学生交流，人相当和蔼
43183,1577,熊蓉,2017-01-16 02:58:37,1,5,4,老师挺不错，但是奇怪的就是新生研讨课莫名被正态了，只有3.3
43208,1577,熊蓉,2017-06-14 05:39:50,1,2,1,绝对的好老师
62115,1577,熊蓉,2017-11-22 12:03:57,3,6,3,东西很有用，干货很多，但是讲的相对比较乏味，比较不有趣。但是听听还是很有收获。
63117,1577,熊蓉,2017-11-28 11:28:04,2,3,1,绩杀？！
63270,1577,熊蓉,2017-11-29 23:33:23,2,6,4,呵呵，某些人自带拿高分的光环。\n\n
64912,1577,熊蓉,2017-12-28 02:35:10,1,2,1,熊老师讲课挺有意思的，还会给我们看机器人的视频，只是给分有点低啊。。
67040,1577,熊蓉,2018-01-20 06:24:50,2,3,1,老师是真的学识很渊博，通过这堂课会收获很多跟机器人有关的知识。但也正是因为老师的专业性很强，所以在小组展示和设计报告的准备过程中要查询专业性知识，好好准备（很有可能会被质疑…）总的来说是一节会让你对机器人产生兴趣的好课，为老师打call！
125650,1577,熊蓉,2020-09-12 14:18:20,11,11,0,熊老师无论是教课、指导本科生都超级nice啊啊啊！！是我的本科导师，可惜gpa太低没法保研，要不然能进熊老师的组有多好。sigh。
132776,1577,熊蓉,2021-02-09 08:56:16,10,11,1,机器人学出分前来评：这门课是上大学以来硬核程度能排前5的课程（哈哈第一第二应该要给数分12），每一个大作业都不容易，轨迹规划、ICP、EKF，都需要自己在理解的基础上经过大量尝试和迭代才能完成，但做完确实很有收获。丰富的大作业、广泛的内容、大学以来见过最大的助教团队，都可以看出老师在这门课上的用心。当然移动机器人博大精深，内容涉及极广，课上也只是做总体概览（这也导致有时候觉得进度较快较难理解哈哈哈）。考试难度较大，涉及范围极广，复习未能全部覆盖，选择和大题答题都有所欠缺，还未知成绩几何，但上了这门课确实很有收获。\n\n出分后补充：老师是好的，就是应该没调分，还是自己菜的原因吧，均绩0.01没了。
144194,1577,熊蓉,2021-12-20 08:14:54,4,5,1,熊老师讲课确实非常认真非常非常好，水平真的高，课程难度系数很高但是收获巨大，最后课程成绩还是挺不错的。有幸在老师的实验室学习和研究一段时间，老师的研究非常前沿，尽管非常忙但是对学生的态度非常好，愿意与学生细致交流和答疑。可惜最高只能给老师打十分
174375,1577,熊蓉,2023-06-11 07:29:54,4,5,1,智能移动技术，控院难得一见的好课，很难很累但有收获，实属不易\n\n熊老师对课程很负责，是我大学三年中遇到的唯一一位会因为学生不听课而生气的老师，不过给分比较求是
178783,1577,熊蓉,2023-07-22 13:07:16,5,5,0,智能移动技术这课内容挺难的，考核是三个project，第一个比较花时间，第二三个还好，老师给分挺好的
190044,1577,熊蓉,2024-02-15 11:26:23,1,2,1,老师很好，大一新生给老师发邮件询问课程以及老师的研究方向，老师详细回复
191994,1577,熊蓉,2024-05-07 03:53:59,2,2,0,智能移动技术，老师讲课还不错，不过这课春学期和机建撞在一起，感觉压力还是有点大的。最后给分感觉一般
198213,1577,熊蓉,2024-09-05 06:59:06,3,3,0,呵呵，感觉心思不在教学上面
402,1602,李光,2015-03-15 01:57:42,7,23,16,非常有趣
1895,1602,李光,2015-03-26 04:43:24,51,73,22,有深度，听完很受启发，难得的好老师！
4174,1602,李光,2015-06-18 03:05:31,-2,13,15,一直在扯国外哪里好……听了完全没用！
5062,1602,李光,2018-05-21 08:35:32,3,19,16,很一般
5537,1602,李光,2015-07-08 05:46:43,4,30,26,上课吹些没用的。几乎没学到什么东西
8188,1602,李光,2015-09-17 10:41:32,10,24,14,好玩，就是学不到很多东西
9990,1602,李光,2015-11-14 02:28:04,-2,11,13,人很好，适合人际交流，但是不适合讲课，内容大多是展示。留学归来，总是觉得国外好。。。我也是醉了
10127,1602,李光,2015-11-16 12:50:50,0,13,13,只要认真参与肯定分数让你满意~赞一个
10129,1602,李光,2015-11-16 14:29:46,-1,7,8,学不到东西
11228,1602,李光,2015-11-25 11:54:43,16,34,18,老师自己说给分很好 可是并不好
11410,1602,李光,2015-11-30 12:48:51,2,28,26,一直在装逼，从未遭雷劈。\n\n真心想学知识的人不要选择这门课，学渣来水分倒是很好的选择，因为没什么知识，最后给分也很随意，人品好就拿高分。
13219,1602,李光,2015-12-25 08:31:43,-4,5,9,平时上课水水可以的，认真完成大作业分数就会高，但五级制的评分确实有点小坑，最高也只有4.5
15398,1602,李光,2016-01-14 08:17:30,0,2,2,很好的
15539,1602,李光,2016-01-15 08:06:02,-2,2,4,还可以
15540,1602,李光,2016-01-15 08:06:21,-4,2,6,任务还算轻，喜欢扯淡，挺好的
15756,1602,李光,2016-01-16 08:30:54,5,10,5,就喜欢这种老师一直在讲故事的课，楼上的好像都很喜欢不水的课，那就去选梁清华啊
15853,1602,李光,2016-01-16 12:30:14,0,5,5,其实还是很不错的，老师虽然比较有个性。会给一点写论文的指导。
23995,1602,李光,2016-04-24 16:29:51,4,8,4,人很好的老师，可以把这课当作是一场交流会来听...能扩充眼界，但是没有深入讲解
24043,1602,李光,2019-04-28 06:39:40,-42,10,52,就是一傻屌，巨坑\n\n
24096,1602,李光,2016-04-27 03:15:46,3,8,5,挺好的，最后要交一篇读书报告
24288,1602,李光,2016-04-29 07:00:17,11,18,7,其实没有那些同学说的那么差，老师还是很厉害的，假如单纯为了刷分是没什么太大意思，但是通过这门课程学习之后你可以知道如何讨论如何规划尤其是出国方面的只是我相信李光老师还是有自己读独到的见解的。
28997,1602,李光,2016-06-29 05:37:14,-3,4,7,十分烂
29087,1602,李光,2016-06-29 08:26:46,-5,3,8,上课很受启发，好好听，好好参加谈论，读书报告好好写，会满绩的
29415,1602,李光,2016-06-29 17:37:55,6,10,4,学识很渊博，情商也很高的老师，赞一个
36123,1602,李光,2016-11-10 13:03:40,-3,1,4,听老师上课还是很好的，很少有水手机的，只是也学不到什么
36976,1602,李光,2016-11-17 01:54:07,-3,4,7,水死了，给分完全看人品
37209,1602,李光,2016-11-18 02:08:21,-2,2,4,老师人很好，也非常的博学，讲课也很有意思，最后的读书报告用了心分肯定高。
37436,1602,李光,2016-11-18 23:44:57,-4,3,7,不知道老师给分的依据，发邮件给他也从来不回……对绩点不太看中的人可以考虑。
37446,1602,李光,2016-11-19 01:08:32,6,8,2,老师要求的仿生读书报告挺费脑的，考验创新能力。平时上课较为轻松，有趣但确实知识不多。
37820,1602,李光,2016-11-21 07:44:32,2,5,3,很不错，老师很热心，但说真的上完课知道怎么出国留学多于仿生的知识
37884,1602,李光,2016-12-27 06:59:59,4,7,3,超级好！
38470,1602,李光,2016-12-06 08:28:41,8,11,3,超级好
39423,1602,李光,2016-12-22 14:30:18,0,2,2,超级好的老师，讲课活泼有趣，作业只有一篇论文。
39886,1602,李光,2016-12-28 06:14:09,-3,6,9,3.3绩点，你们看着办
40435,1602,李光,2017-06-22 10:03:32,-2,9,11,真不知道他怎么评分的！！辛辛苦苦花了好久写的论文，却给了这样一个被炒鸡正太的绩点！！
40789,1602,李光,2017-01-05 13:36:45,20,26,6,李老师真的算是我的人生导师了，我和老师进行了一番深刻的交谈后我决定改变自己的人生之路了，今天是最后一节课了，好不舍啊，尽管知道老师不会玩微信一定不会看到，但我还是想借这个平台感谢一下老师，老师能在大一遇见你是我最大的福气!
41432,1602,李光,2017-12-30 06:46:38,11,18,7,给的分真的太好，当然写了1万多字论文挺累的，上课有自己的小故事很有趣。很亲切的感觉。
42465,1602,李光,2017-01-14 09:06:16,-1,5,6,给分坑
50052,1602,李光,2017-04-29 02:38:18,2,7,5,老师很棒哇，给分很好，上课也很自由。想说啥就说啥，反正就是一门讨论课，套用老师的一句话，教室里说的话出了门就什么都不算。所以可以尽情的讨论呐，反正不怕被查水表23333。期末的报告写的认真一点，多花点精力，成绩绝对不会差！\n\nｂ(￣▽￣)ｄ
50161,1602,李光,2017-04-30 12:22:06,0,3,3,给分真的好，上课内容也很有趣。
50309,1602,李光,2017-05-02 09:40:44,0,2,2,想出国的同学极其建议听！有干货，好说话。
51663,1602,李光,2017-06-08 05:43:07,5,8,3,说国外好很正常啊，这个领域中国比得过国外？上课以拓展视野为主，实际有用的知识确实没多少，老师会讲一些出国方面的事情和准备，总体比较轻松，就是论文确实要下功夫。我个人是比以前会更多的观察生活了，灵感就是生活，我码了一篇相关的论文，最后是满绩了，觉得我个人的付出是得到回报了。其他同学的情况我不清楚，但因为我讨论课发言很多，所以老师可能对我印象比较深。对部分同学，我提醒一下，有时自己觉得论文写得好是没什么用的，同班级比较你不见得有多好，关键还是看灵感和真实。
52610,1602,李光,2017-06-21 11:23:12,-3,4,7,绩点非常坑，爱信不信
52680,1602,李光,2017-06-22 06:32:25,1,3,2,老师还是蛮不错的，有话直说，感觉虽然专业知识收获不大，但是感觉老师的的确确是在用心教学生做人做事，楼上那些说什么世界观崩塌的，不要太玻璃心了，老师知识说出了事实！
52717,1602,李光,2017-06-22 09:48:42,11,13,2,不只是学术还有阅历啊，不想别的老师就知道读ppt。反正根本不想翘课，上课感觉很舒服，很喜欢的一个老师。
52726,1602,李光,2017-06-23 10:17:44,22,40,18,2017夏学期的新生研讨课。给学弟学妹们的建议是 1不要缺课。2最后的论文一定要提前认真写，多查找些文献，详述理论和应用。3上课讲的仿生知识很多而且挺系统，讲出国留学的话也有用，这部分不感兴趣可以自习。
52728,1602,李光,2017-06-22 10:18:21,-4,3,7,瞎几把给分
52729,1602,李光,2017-06-22 10:22:15,8,12,4,老师上课很有趣，就是有点水。也会讲一些国外的事情，对有意向出国的挺有帮助。最后给分，只要报告好好写，有自己想法在里面，分数不会低。
52743,1602,李光,2017-06-22 11:48:28,-3,4,7,论文要求10000字，辛辛苦苦写了两天，结果给分神特么低，真的心累！
52747,1602,李光,2017-06-22 12:10:42,2,5,3,给分好棒
52766,1602,李光,2017-06-22 15:39:00,-5,7,12,冲着控制学院副院长选的课，结果成了大学成绩最低的课，控制的好多同学分数都很惨。。。
52793,1602,李光,2017-06-23 02:40:39,2,4,2,老师教授的知识除了仿生，还有一些课外的知识，收获很大，觉得是个可以做来当人生导师的老师，真的好！
52865,1602,李光,2017-06-23 08:42:08,5,8,3,老师还是不错，新生研讨课会讲很多仿生的例子。期末万字论文认真写，平时上课不缺课还是可以拿个4.5绩点
52995,1602,李光,2017-06-24 14:01:23,5,7,2,如果上课认真 真的能学到很多仿生的知识 老师讲的段子也很有意思啊
53086,1602,李光,2017-12-21 03:18:39,-8,4,12,讲些没用的……以及最后的15页报告他给的范例随便复制粘贴一段再搜索就可以发现都是抄的hhh
60429,1602,李光,2017-10-19 16:28:51,1,2,1,很好的老师
61815,1602,李光,2017-11-21 05:48:43,0,2,2,研讨课长视野，很轻松
61816,1602,李光,2017-11-21 05:49:04,-1,3,4,给的分不好
61835,1602,李光,2017-11-21 07:22:53,8,10,2,老师真的超棒！尤其是第一节课的时候他说课堂上饿了能吃东西困了能睡觉我就对这个老师充满了好感。课上氛围很轻松，而且不无聊。老师也会讲很多出国方面的知识，对未来规划有很大帮助。仿生作为一门通识课对于大一学生是比较难懂的，但老师还是以科普为主不太会讲专业知识，还是能了解很多的！然后最后论文脑洞一定要大！！！要敢想一些稀奇古怪的创新思路！
61862,1602,李光,2017-11-21 10:05:25,9,12,3,这是一门除了最后的论文都很水的课。论文是可以水但是绩点会不保(눈_눈)，论文不水分数绝对不一般。平时会吹吹牛，讲些留学事项，课堂气氛相当活跃。如果不介意写长论文的可以选
61888,1602,李光,2017-11-21 11:29:32,3,3,0,享受，好好听课，这是一节很放松的课。
61925,1602,李光,2017-11-21 23:52:50,2,3,1,给分超赞 上课亲和
66161,1602,李光,2018-01-12 08:09:10,1,1,0,喜欢老师，分享给我们很多干货，还有出国留学的东西！
67668,1602,李光,2018-01-22 04:43:41,3,3,0,讲的很精彩，能学到不少东西。最后就一篇十五页的论文，还算水。
67905,1602,李光,2018-01-22 09:33:20,8,8,0,新生研讨课，小班，只有30人，老师一直强调按照正态比例必须有10个人下80，这是没办法的。最后几乎完全看期末报告给分。报告内容不一定要多新颖奇特，但写的过程中花了心思动了脑子一定会有回报。老师课堂内容很丰富，比较拓宽眼界，仿生前沿、出国留学，都会讲，但是总觉得有一点水。
69264,1602,李光,2018-01-24 11:42:58,8,10,2,大爱李光老师。但是千万不要缺课哦。只有一篇论文，论文好好写
69544,1602,李光,2018-01-25 03:25:47,-3,5,8,不谈了 自己构思1w字论文 18页 被正态 搞不太懂 上课很水 没啥有用的   给分真的瞎鸡儿给，不建议选
73341,1602,李光,2018-02-01 11:09:30,0,8,8,3.3\n\n大学最低绩点\n\n你们随意
77871,1602,李光,2018-05-08 09:28:38,-1,0,1,课水人好给分还行吧。
77881,1602,李光,2018-05-08 10:39:39,0,0,0,推荐相关专业的和有留学意向的同学报，课后可多和老师就专业问题、深造的问题聊聊天，老师课讲的挺有趣的
77894,1602,李光,2018-05-08 11:05:32,1,2,1,老师上课很好玩，经常讲国外的事情，而且任务也不多，就期末一篇万字论文而已，只要你认真写，分数不会太低，给老师比心
77901,1602,李光,2018-05-08 11:38:50,3,4,1,就问一句  还有更帅的男神吗
77920,1602,李光,2018-05-08 23:56:24,7,9,2,每次去上课我都带了大物作业，可是。。。从没写过，因为注意力完全集中在老师身上啊！老师上课真的很有趣，还以专门买一些实验器具让我们做好玩的心理实验，还会送我们外文杂志，在国外留学方面，仿生方面收获很多，感觉老师很厉害，就最后论文有点多，说实话我觉得自己论文很差的，结果给分还蛮好，感觉有点对不起老师。。。
77923,1602,李光,2018-05-08 14:54:21,1,2,1,老师超棒超好的
78080,1602,李光,2018-05-09 09:04:16,2,3,1,老师讲课挺生动活泼的，是我最喜欢的老师之一，认真写论文，不旷课，分数不会差
78199,1602,李光,2018-05-10 03:02:45,3,4,1,老师上课很有趣，每次下课都会很耐心解答同学的问题。一方面讲的仿生导论会放很多有趣的视频，讲解也很易懂，一方面还会讲很多留学的见闻。上课会有几次点名。平时没有作业，就是最后一篇15-20页的论文，认真去写的话还是有收获的。大学第一门满绩，还是很感谢老师的！
80637,1602,李光,2018-06-28 15:18:06,14,16,2,文科生艰难完成20页论文 希望有个好结果
81058,1602,李光,2018-07-03 13:19:03,0,2,2,完美！！！只要感兴趣的，非常非常推荐
81189,1602,李光,2018-07-04 08:44:34,-2,3,5,打分很是迷，啥玩意，莫名其妙很低
87899,1602,李光,2018-10-17 07:06:31,-3,2,5,老是扯
89418,1602,李光,2019-04-28 06:34:01,-6,6,12,垃圾，写了半个月的论文最后这么差的分数
89586,1602,李光,2018-11-20 01:15:10,5,6,1,上课蛮有趣的，就听他扯。\n\n可以了解到一些国外的知识，仿生的知识基本没学到。\n\n上课认真听，报告也有好好写，结果被正态了。\n\n3.3感受一下。\n\n
89688,1602,李光,2018-11-20 09:23:14,6,7,1,上课挺有趣，报告要认真写（来自3.3的血泪教训）
92214,1602,李光,2018-12-27 05:18:39,2,5,3,老师人真的很好，期末论文我有好好写但是分数很低，3.3。如果想刷绩点的话尽量不要选，心塞。
93553,1602,李光,2019-01-10 10:18:17,3,3,0,老师讲得挺好的内容也很有趣\n\n就是。。。论文字数好多哇。。。\n\n对考试粥太不友好了
96513,1602,李光,2019-01-21 05:25:07,3,4,1,特别好
96518,1602,李光,2019-01-21 05:27:03,2,3,1,老师讲课真的很好，很有趣，让你不想玩手机，最后论文好好写，绩点不会辜负你的!
96703,1602,李光,2019-01-21 09:27:27,2,3,1,很有触动，很好的老师，给分也不错，只是论文要求15到20页，写得我头晕
96809,1602,李光,2019-01-21 10:07:10,-2,1,3,这可能是我大学期间绩点最高的一门课了
97953,1602,李光,2019-01-23 02:38:02,-2,1,3,谢谢老师，给了我他教学生涯里第二高的分，我的论文没恶警哈哈哈
99601,1602,李光,2019-01-25 04:02:13,2,3,1,老师讲课真的很棒！也让我们有了对人生的规划。期末的论文提前一个月开始写，对查点资料，有自己的创新点，用心写会拿高分的！！！
101754,1602,李光,2019-01-29 04:02:34,-1,4,5,挺好的，平时没有作业，课也不强制要求一直抬头看，只要接受期末论文写的时间长字数多就可以选。期末论文提前两三周写，每天写一点，平时多记录灵感下来，选一个自己能拖字数的课题，就是弄好框架填进去凑足字数就行...最后给分很好！第一个4.5！
106565,1602,李光,2019-04-28 06:42:44,2,4,2,给分不错 上课可以不听 人很好
106637,1602,李光,2019-04-28 13:29:15,2,3,1,听老师的课真的是一种享受，不知不觉就可以开阔自己的眼界。老师见多识广，而且口才很好，选老师的课绝对不后悔。
106726,1602,李光,2019-04-29 05:54:41,0,1,1,感觉很棒\n\n
106744,1602,李光,2019-04-29 07:51:09,-1,3,4,老师上课很有趣很幽默，快乐满满，期末论文一定要用心写，最重要的是用心（亲身体会），跟字数和用时没有太大关系，，建议逻辑清晰，用词准确，让每一句话变得精简，给分很好，满了。
106800,1602,李光,2019-04-29 15:27:02,3,3,0,好。。\n\n
106984,1602,李光,2019-04-30 14:02:18,4,7,3,对那些骂老师的我真是无语了，你可以觉得老师讲课或给分不好，你咋不在论文最后课程评价里提呢? 就因为绩点没达到自己的预期就破口大骂显得你素质很高是吗？  老师绝对是好老师，我上大学以来第一门不想水的通识课。
111786,1602,李光,2019-07-02 22:56:36,-2,2,4,谢谢老师的满绩\n\n
111860,1602,李光,2019-07-03 01:28:13,0,1,1,体验很好的一门通识课
112928,1602,李光,2019-07-05 12:30:42,2,5,3,老师讲的很好啦～同为控制学院的我听得很开心(哈哈老师魅力强大到你根本不愿意拿出手机)。论文好好写就可以满绩了！还有坐在左边的那位xjj很可爱嘻嘻
114042,1602,李光,2019-07-08 12:50:35,0,1,1,李老师真的好好，而且对于想出国的人来说他能给你提供方向！
115904,1602,李光,2019-08-25 08:03:20,15,15,0,费尽心思写了好久论文。论文有自己的创新点，而且查了很多资料，真的没有水。结果被正态3.3。建议写不出硬核内容的人慎选
117124,1602,李光,2019-09-19 13:45:58,1,1,0,老师很棒，课很有趣～尽管可能有的观点我不太认同但是的确见多识广，也很幽默。课堂氛围好，课堂体验不错～
118904,1602,李光,2019-11-07 13:03:35,0,0,0,上课感觉不错，不是倾向于专业性的，但重在开拓视野。等绩点ing
118905,1602,李光,2019-11-07 13:03:35,0,0,0,上课感觉不错，不是倾向于专业性的，但重在开拓视野。等绩点ing
119037,1602,李光,2019-11-10 00:45:56,3,4,1,被正态了？？好吧或许是我水平不够，但是读书报告确实写了很久，20页的读书报告自认没有水，很难受。不过应该不能怪老师，就是对我来说，付出与得到不成正比吧。
119173,1602,李光,2019-11-11 03:57:30,0,1,1,喜欢！只要论文花了心思好好写就能拿高分哒！老师上课很幽默，跟同学们关系很好
124204,1602,李光,2020-06-27 03:21:40,0,0,0,给分不错，老师很和蔼，有问题能够耐心解答。仿生科学导论课程内容不算硬核，主要是介绍性的，能够开阔眼界。论文要有自己的想法，还是挺有挑战性的。推荐！
126944,1602,李光,2020-10-29 04:28:53,-5,2,7,脱粉了，b
127440,1602,李光,2020-11-23 05:19:15,0,1,1,老师上课非常有意思，不仅仅是仿生学的相关知识，同时也有很多出国留学的经验，以及还有有趣的实验。只要读书报告认真写让老师看到诚意就会给你高绩点。太感谢老师了！！
127721,1602,李光,2020-11-26 05:33:48,4,4,0,李老师的课真的很有趣！上课内容主要是仿生前沿科技，各种资料非常丰富，的确大开眼界。李老师口才很好，风趣幽默，人也很亲切，科研经历和国外经历都很厉害，留学方面也会讲一点。平时一点作业也没有，期末的报告15页有点难写，但认真写分数还可以
129263,1602,李光,2021-01-02 17:09:51,0,1,1,针不戳
133360,1602,李光,2021-02-26 09:44:28,2,4,2,很有意思的一位老师，上课形式单口相声+小剧场，学到了很多有用的知识和没用的知识。上课的时间引人入胜，把电脑放在宿舍吧，他的课吸引力比刷手机电脑强。提醒课程最后的大论文需要要创意+拼命卷，要不然给分可能不一定好看
161140,1602,李光,2022-10-28 14:29:23,5,5,0,老师知识渊博，上课风趣幽默，可以学到很多知识
172272,1602,李光,2023-04-24 05:32:21,-2,0,2,老师上课很轻松，给分很好
175416,1602,李光,2023-06-24 17:39:32,-21,8,29,sb玩意，给分这么差，一门通识课你在这高傲什么，撒泡尿照照自己丑恶的嘴脸吧
182287,1602,李光,2023-11-14 05:50:51,-3,0,3,还可以哦，老师期末论文也就是当成正常通识课论文交的，然后就有4.5
182611,1602,李光,2023-11-18 08:29:18,4,4,0,唉，写了10000论文最后不理想，不确定性存在
186153,1602,李光,2024-01-09 06:05:13,-4,0,4,上课轻松也挺好玩，每节课去就行，最后论文正常写别太摆就好，4.5中规中矩
186160,1602,李光,2024-01-09 06:37:57,2,6,4,呵呵。快跑吧。
186169,1602,李光,2024-01-09 06:53:46,1,2,1,评分很好，想水课的人推荐，但要好好写论文！！！！
200907,1602,李光,2024-11-19 10:37:08,-3,1,4,4.5中规中矩
201875,1602,李光,2024-11-07 05:43:57,4,5,1,仿生给分不行
202410,1602,李光,2024-11-12 12:03:38,10,10,0,仿生给分太差！
203161,1602,李光,2024-11-17 13:02:56,3,3,0,嵌入式系统高级实验瞎打分
206905,1602,李光,2024-12-18 09:07:16,1,1,0,嵌入式系统只是挂名，全部是王酉老师来上，最后英文考试很抽象，给分也不是很好\n\n建议选电院pyg/llx教学班
207536,1602,李光,2024-12-23 02:10:16,1,2,1,很风趣很渊博但是期末论文比较难奥
208780,1602,李光,2025-01-06 04:25:26,4,5,1,仿生给分不好，上课说的好听，结果还卡绩
209160,1602,李光,2025-01-05 01:21:00,3,3,0,被卡绩了
209314,1602,李光,2025-01-05 11:47:09,3,3,0,给分真的很迷很迷。。。
210572,1602,李光,2025-01-09 11:20:39,0,0,0,仿生挺不错的，属于想水可以水，想听听着也挺有趣、会有收获的一门课。论文确实要好好写，基本就是论文决定分数啦，感觉更重质量而不是字数（老师应该只看纸质版的报告，可以把字号调大一点，加上封面、目录、图片，5000+就有10面了），注意一下论文格式，最好有一点关于仿生的设计想法，言之有物分数会高一点。老师本人有点健忘，感觉对钉钉用也不是很熟练，可能对绩点和分数转换也不太了解或者关注，不太会去特意调分数（不是很喜欢卡绩这个说法，愿意去调分数的老师肯定大家都喜欢啊，但是因为没调分数去苛责老师感觉有点过于唯绩点论了）。
210714,1602,李光,2025-01-10 01:08:31,1,1,0,仿生导上课不强求上课听讲，期末给分还行，不过有概率会被绩杀，不会写报告的慎选
219473,1602,李光,2025-05-28 06:53:34,1,1,0,仿生给分不好
219933,1602,李光,2025-06-11 10:28:51,2,2,0,非常高傲，自命不凡，人脾气大性格倔，要是惹他不高兴你就完蛋了！
32690,1879,张建明,2016-07-09 12:23:35,-17,3,20,真心好老师
118832,1879,张建明,2019-11-06 23:51:07,-11,3,14,还行。
121642,1879,张建明,2019-12-11 06:47:44,-14,5,19,tql
122427,1879,张建明,2020-02-27 06:33:51,-16,4,20,tql
122666,1879,张建明,2020-03-14 16:16:52,-16,3,19,tql
133514,1879,张建明,2021-03-01 12:17:30,-19,2,21,tql
136612,1879,张建明,2021-06-22 02:26:53,-15,1,16,人巨好，巨负责人，甚至你的事情比你还上心
150471,1879,张建明,2022-01-26 03:39:21,11,12,1,过程控制能不上就不上，点名，小测，提问，等你能想象的这个课都有。期末不捞的。
154753,1879,张建明,2022-06-04 14:50:04,5,6,1,。。。。
159930,1879,张建明,2022-09-09 06:54:31,-32,0,32,机器人与人工智能导论。老师很和蔼，考试内容都在最后一节课的复习ppt里。考前ppt里的公式都理解都能做出来。本来怕挂，复习了一周后，总评90
160758,1879,张建明,2022-10-10 02:50:44,21,24,3,人机课几乎节节课点名，还会数到课人头抓代签。\n\n而且迟到也会登记打勾。\n\n上课纯念ppt而且念的很慢orz\n\n以上
161171,1879,张建明,2022-10-31 02:11:29,17,17,0,“没有人承认那我们集体扣两分？”
161645,1879,张建明,2022-11-10 02:06:07,17,18,1,能别选他就别选了吧 讲的很一般纯念ppt不说 还巨喜欢点名 “这是你们逼我的”\n\n本来人工智能与机器学习就是烂课纯纯坐牢 真是烦
161885,1879,张建明,2022-11-15 00:23:49,4,4,0,emmm
161943,1879,张建明,2022-11-15 08:08:01,8,8,0,讲课一般
162040,1879,张建明,2022-11-16 08:08:15,14,14,0,建议别选张老师的人工智能和机器学习和过程控制
170618,1879,张建明,2023-03-07 08:23:40,11,11,0,坐牢，点名，给分很差甚至是相比于其他平行班也是很差
171194,1879,张建明,2023-03-18 03:24:05,14,14,0,出分来评论一下，给分无敌烂，事情还多还点名，隔壁某班不点名不小测给分还好，你倒好反着来。
176783,1879,张建明,2023-06-30 06:22:26,23,23,0,纯出生
178539,1879,张建明,2023-07-14 03:01:35,10,10,0,“大家都别走 我们随时随地点名”
198077,1879,张建明,2024-08-28 17:19:49,2,2,0,人工智能与大数据综合实践：课程相比隔壁机器人实践事情少，要求在mo或者华为平台上完成实验，然而实验可以认为无任何指导，最后给分烂（大二提前选了好后悔啊。。。似乎正常大三上是可以不算进保研成绩的？）。
201618,1879,张建明,2024-11-05 02:53:50,28,30,2,出生东西，45分钟小测都不提前通知的？
201619,1879,张建明,2024-11-05 02:54:13,19,19,0,有病，怎么让学生不爽怎么来
201620,1879,张建明,2024-11-05 02:55:31,14,14,0,确实是神人
201621,1879,张建明,2024-11-05 02:55:32,15,15,0,sb老师开喷
201622,1879,张建明,2024-11-05 02:57:22,14,14,0,上课屁事多，冬一周45分钟小测不通知，纯出生
201624,1879,张建明,2024-12-11 10:25:27,7,9,2,...
201629,1879,张建明,2024-11-05 03:43:45,6,6,0,快跑！
202345,1879,张建明,2024-11-12 02:07:06,12,12,0,没吃过史的可以来选这个老师的课
202348,1879,张建明,2024-11-12 02:39:23,8,8,0,有点手段就全用在学生身上了👍🏻
203286,1879,张建明,2024-11-19 02:27:17,8,8,0,初生东曦，碧阳晚意
203287,1879,张建明,2024-12-03 02:50:08,6,6,0,没吃过史的可以来选这个老师的课\n\n抓几个不让考试的更是逆天
203885,1879,张建明,2024-11-21 17:44:17,7,7,0,张建明我真的要控制一下你了
205674,1879,张建明,2024-12-12 04:40:25,-20,2,22,老师超级好！就过控这门课而言绝对值得一个十分，比隔壁运控好得不知道哪里去了
206666,1879,张建明,2024-12-17 04:14:06,6,6,0,别选就对了，快跑
206668,1879,张建明,2024-12-17 04:16:54,3,3,0,老师超级好，只要我们都不提问题，每个小组都是满分
207870,1879,张建明,2024-12-24 15:23:03,8,8,0,你不是来上课的，你是来折磨学生的
207873,1879,张建明,2024-12-24 16:40:25,14,14,0,老师上课很敬业，很关心学生的学习状态，上课会设置一分钟点名来督促学生学习。\n\n给分也很好，只要展示的时候没人提问，就可以打满分。\n\n课程内容十分充实，作业，小测，实验，期末考试样样俱全，为学院培养优秀的人才。\n\n教学很负责，为了让同学们好好复习，在最后一次课结束后才通知期末不能带A4。\n\n这样的好老师真的不好找了，老师太辛苦了，希望老师早点退休，让大家都脱离苦海。
208139,1879,张建明,2024-12-26 15:27:50,9,9,0,人机展示课分两节，周二的课看人少，说点个名吧，也是逆天。\n\n\n\n还不止点名，答辩环节一直问问问，你是真能问啊。\n\n有个法学的小组ppt最后一页放了个蒙特卡洛算法在法律领域的意义，他还抓着这个问，真是气笑了。\n\n\n\n周四的课我怕他点名，到教室坐牢，结果直接不来了😅😅😅
208578,1879,张建明,2024-12-29 14:54:02,6,6,0,以下针对过控：因为没人回答问题，课件上的题目不讲答案。冬一周45分钟的小测不提前通知。考试要求每年一变，并且最后一节课后才通知。
208652,1879,张建明,2024-12-30 12:06:52,8,8,0,人机课整个学期唯一一节用来展示的早八，看人少就点名，是真tm逆天，你有点手段全用来对付学生了是吧
210534,1879,张建明,2025-01-09 10:16:39,5,5,0,听他的课完全没有任何收获
214007,1879,张建明,2025-01-23 01:01:02,3,3,0,不会给分就别当老师，去大四选别的老师也别选这逆天
214015,1879,张建明,2025-01-23 02:37:14,5,5,0,坐标过控，他的唯一作用，就是让我怀念秋学期上课的王雷老师。\n\n不同人对给分好不好的评判标准不一样，给分暂且不论，但其他逆天事包括但不限于：1、小测不提前通知而且还放在了期中考试周，生怕我们考高。2、大作业展示双标，有的组他自己指出问题，有的组有问题但因为大家没提问就说要给满也不指出他们的问题？3、看人少了就点名。4、超级喜欢点人上课回答问题。5、最后一次课才通知考试不能带A4，如果我没记错，这课刚开的时候好像是开卷考，上一届是A4半开卷，到我们这就闭卷了？得亏期末卷子没出太难。相比之下，王雷老师不怎么点名，讲课认真，唯一一次小测还是讲完课后再做的，也就是我们已经差不多把知识点掌握了之后再做。\n\n总之他不愧是教过控的，有点手段都用来控制学生的学习过程了，简称过程控制，太拟人了。本来过控是大三自动化为数不多还能学到些有用知识的课了，最后复习的时候也确实感觉有些东西很有意思，可惜有很多地方体验感都被这老师破坏了。总之希望他赶紧退休吧，尽量别选这老师。
214103,1879,张建明,2025-01-24 07:31:18,5,5,0,上过的都懂 一副高高在上针对学生的模样
214986,1879,张建明,2025-02-19 17:41:18,6,6,0,令愿背负骂名也要当出生吗，哈基明你这家伙
217252,1879,张建明,2025-04-06 16:05:28,3,3,0,人品不行，针对学生，不诚信，文字保证的事情竟然翻脸不认人。上课把自己吹的多牛多关心学生，私下对自己的学生做出背信弃义的事情。
219480,1879,张建明,2025-05-28 08:43:48,2,2,0,这老师纯纯sb，表面一套，背后一套，装得好像很关心学生，实际天天各种阴阳怪气，还背信弃义，想一枪爱死这个剑冢
48451,1883,侯迪波,2017-03-09 09:58:32,3,6,3,为什么没有0分
48950,1883,侯迪波,2017-03-18 03:22:57,4,4,0,讲的一般，没什么亮点
63837,1883,侯迪波,2017-12-17 06:41:05,0,4,4,挺好的，
65926,1883,侯迪波,2018-01-10 09:30:35,0,0,0,。。。。
73985,1883,侯迪波,2018-02-04 03:17:29,5,5,0,mdzz
85731,1883,侯迪波,2018-07-31 03:27:18,6,11,5,上课需要扫码做题，忘带手机相当于旷课，上课时常出现结巴，这个这个这个……感觉对课程教学不是很重视，成绩已经拖了20几天还没出，个人觉得这种老师不适合开课，不如专心科研。
85755,1883,侯迪波,2018-08-02 10:02:30,1,1,0,不好...
91146,1883,侯迪波,2018-12-02 02:14:13,2,2,0,上课昏昏欲睡，念ppt耳
134365,1883,侯迪波,2021-03-25 01:52:16,7,8,1,讲得太差
151502,1883,侯迪波,2022-03-05 12:03:49,0,1,1,建议取消课堂研讨，内容都讲不完还让研讨
151514,1883,侯迪波,2022-03-06 13:06:52,10,10,0,在做侯老师的作业，特意来给个1分解解气，官职没到副院长的高瞻远瞩布置不出来这种《优秀》作业
171172,1883,侯迪波,2023-03-17 08:52:16,19,20,1,依托答辩
173179,1883,侯迪波,2023-05-15 03:28:49,32,33,1,自动化导论，依托答辩\n\n隔壁信电导那才叫导论\n\n没讲什么干货就让我们交paper，我把IEEE正刊的翻译过来交上去，论文给分那叫一言难尽
215819,1883,侯迪波,2025-03-06 01:19:15,1,1,0,念ppt
83672,1891,陈金水,2018-07-11 03:36:36,2,3,1,老师不错，但别上控制的java面向对象编程
83673,1891,陈金水,2018-07-11 03:36:36,1,2,1,老师不错，但别上控制的java面向对象编程
129028,1891,陈金水,2020-12-29 02:18:44,-1,2,3,为什么不要上控制的JAVA，我觉得老师讲的挺好的。第一节课老师说平时这门课都爆满，但是今年很不给面子。大概能猜到是怎么回事，哈哈
130407,1891,陈金水,2021-01-22 05:04:21,0,1,1,说实话上课体验真的还不错\n\n人也不是很多，相当于是小班授课\n\n跟老师互动互动就很滋润\n\n但是老师下手是真滴狠，给分是真滴低\n\n能选其他课还是选其他的吧～
130899,1891,陈金水,2021-01-25 07:41:16,1,1,0,这老师真的懂JAVA吗？？？
153175,1891,陈金水,2022-04-26 11:04:19,2,3,1,对课不对人，2022年新开的控院深度学习，课程体验上不知道比之前的控院人工智能与机器学习好到哪里去了。。。对人的话，讲课还算逻辑清晰，中等偏上，7分。
175540,1891,陈金水,2023-06-25 12:02:10,1,2,1,纯垃圾老师 师德师风问题严重
176530,1891,陈金水,2023-06-29 09:55:44,3,3,0,上的课程是控院开设的《深度学习》\n\n关于老师和课程内容：\n\n老师上课循序渐进，讲课内容还算清晰，课程体验不错，比控院的《人工智能与机器学习》好太多了。（《人机》真是门烂课，各种方面的烂）\n\n深度学习更细节的东西很难涉及，毕竟课程学分不多，学时有限。\n\n关于考核：\n\n点名和提问采用随机方式，没记错的话，几乎每节课必点。\n\n每周一个作业，共8个。期末有两个大作业。还有一个附加题，做了能额外加平时分。\n\n每周作业就是上课的内容，ddl为下一周的周日。每周作业不算难，理解了内容，照猫画虎就能做。\n\n大作业需要做的工作多一些，但是不难，只是需要花时间。所以不要拖延，我就是因为拖延导致最后比较紧急，考试周连续好几天都在肝大作业，不拖延绝对轻松做完。\n\n附加题做了，但是时间太紧急，没做完，所以没有额外加平时分，但是只要不翘课，平时分应该不会低，所以不做附加题平时分也能很高。\n\n总结，是门中等偏上的好课。在烂课如云的大环境里，这门课显得太可贵了。
194605,1891,陈金水,2024-06-24 14:25:08,2,3,1,控院开的《深度学习》，因为假期其中有一周没上课，也因此少了一次平时作业。作业总的而言不难，而且很多都可以去kaggle之类的地方抄，期末两个大作业的难度也不算大，就是调参很费时间。给分不错，身边好多同学都是4.5以上，好几个同学满绩点了，算是比较推荐上的一门课。体验比人机真的是好了不知道多少
220185,1891,陈金水,2025-06-16 05:26:17,0,0,0,作业基本是拷打大模型写代码+调参，89/4.5，比较推荐
5382,2120,丁立仲,2015-07-07 05:27:28,1,4,3,老师讲课还是很有自己的想法的，不过我每次都是十分钟之后就听不下去了。。
7008,2120,丁立仲,2015-08-26 02:58:35,10,16,6,上课挺无聊的，人是好人。给分一般
7838,2120,丁立仲,2015-09-15 14:32:57,5,6,1,丁老师还不错哦！
8727,2120,丁立仲,2015-09-24 15:58:25,-2,0,2,还好的
9344,2120,丁立仲,2015-10-22 10:39:49,0,3,3,讲课风格很有趣
28191,2120,丁立仲,2016-06-28 08:14:27,3,5,2,不轮到展示的话平时还是很水的，给我的分也不错。
28563,2120,丁立仲,2016-07-01 07:12:54,2,7,5,确实不清楚老师怎么给的分，可能是几次点名＋展示＋考试？或者考试占大头吧，人生第一门满绩是形策，这我也是没想到。。
28607,2120,丁立仲,2016-06-28 10:57:45,4,7,3,给分烂，不知道是看什么打分的，绝对坑。
28956,2120,丁立仲,2016-06-29 04:21:54,5,6,1,给以分其实还好
48762,2120,丁立仲,2017-06-26 10:31:36,18,22,4,上课其实挺不错的，挺希望我们努力学习的
53135,2120,丁立仲,2017-06-26 03:59:45,1,4,3,丁老师给分还不错，上课也还行 就是课程本身有点无聊
53153,2120,丁立仲,2017-06-26 05:15:36,1,4,3,给分为什么这么低啊啊啊啊
53159,2120,丁立仲,2017-06-26 05:33:18,-3,0,3,感觉比自己预期的分数低，不知道为什么。
57984,2120,丁立仲,2017-07-20 03:40:44,1,2,1,呵呵呵
60271,2120,丁立仲,2017-10-16 10:04:32,6,7,1,丁老师上课非常有意思\n\n
60491,2120,丁立仲,2017-10-22 11:37:36,-2,4,6,老师很好啊，我只上了第一节课就想给满分。\n\n上课挺幽默的啊。然后还鼓励我们爱玩游戏的男生以后去游戏公司，去“祸害”韩国日本hhh。PPT也很好
60956,2120,丁立仲,2017-11-05 10:06:44,5,5,0,挺有意思的\n\n
60957,2120,丁立仲,2017-11-05 11:01:44,8,8,0,展示每人1分钟 计时一秒钟都不能超过的 展示的同学们千万注意时间
63726,2120,丁立仲,2017-12-13 14:26:53,1,3,2,丁老师居然开始上课！！！\n\n不知道课上的怎么样，人是非常好的人
76001,2120,丁立仲,2018-03-23 13:20:08,0,1,1,我觉得还可以
83484,2120,丁立仲,2018-07-10 11:34:57,1,3,2,老师还行，但是为什么课堂展示的花样这么多，上学期是小组展示，这学期改成辩论，轮到我们组突然改成一分钟即兴演讲……给分还行，形策考前还是得好好看PPT，背一下思考题
84261,2120,丁立仲,2018-07-12 11:15:00,-24,5,29,给分极差 通过不正当手段交了一张基本是标答的试卷 自以为满绩了 结果才3.6  慎选
84481,2120,丁立仲,2018-07-13 02:56:25,-4,3,7,给分不好，事还不少。
84583,2120,丁立仲,2018-07-13 08:41:29,-1,1,2,给分一般，还可以。我是第一组做展示的，效果很差，感觉自己挺悬的。但是因为本身对国际政治感兴趣，也在上党章学习课，期末考试除了背的东西还写了些自己的想法，可能有加分吧。4.2\n\n老师人本身看得出上有思想的人，上课也不算无聊。
85433,2120,丁立仲,2018-07-18 00:33:41,5,6,1,上课就是那样，正统思想。展示花样玩的很多。很意外在我缺过一次点到的情况下仍然给了4.5，说明期末还是最重要的，ppt一定要好好背，不仅是思考题，每一页都要熟悉，考的挺细的。选择题全是时政，这一年基本只考了十九大报告和六月份的时政，考的也很细。
86425,2120,丁立仲,2018-09-16 00:45:48,-1,0,1,不错哦
91158,2120,丁立仲,2018-12-19 09:51:36,1,1,0,讲课无聊
104021,2120,丁立仲,2019-03-10 10:45:49,-3,1,4,讲课尬的不行，bug一堆。
112744,2120,丁立仲,2019-07-05 01:57:11,2,4,2,老师真心希望我们能好好听一听课程内容，真心希望我们把个人未来和国家前途命运结合起来，关心国家大事。\n\n给分感觉还好，考试应该批卷比较仔细吧，字迹工整与否好像影响不大，但无论是论述题还是作文一定要写出要点，要结合学的内容，看前最好把所有内容的提纲背一下\n\n除此之外，还有展示，感觉一定要抠紧时间吧，这类展示应该是很轻松了吧\n\n丁老师和助教李老师都很好
128211,2120,丁立仲,2020-12-13 13:38:39,0,1,1,老师是山东人，很温和，也很帅，讲课还行叭，反正是水课
139689,2120,丁立仲,2021-07-20 03:28:06,-1,0,1,上了老师的形策课，老师人是不错的，也很有家国情怀，不过感觉老师应该是一个比较守规矩的人，任何事情可能都要向上级报告一下\n\n给分的话，害，上课都去了，作业也写的不错，也上台演讲了，但分真的低，可能是我天生不擅长政治吧
163512,2120,丁立仲,2022-12-15 00:30:15,-1,1,2,很好的老师
181343,2120,丁立仲,2023-10-15 11:22:04,-1,2,3,只会无脑吹，一点学识没有
181390,2120,丁立仲,2023-10-16 11:50:22,1,1,0,把BBC说成BBS（可能是口误）\n\n说巴勒斯坦没有BBC（实际上有）\n\n人很平易近人，但是对zz无脑且傲慢
200616,2120,丁立仲,2024-10-20 10:59:54,0,1,1,上个形策也是叫上了 德法老师都有点自知之明形策都叫上了？
208436,2120,丁立仲,2024-12-27 15:10:50,0,0,0,化学系学业进步奖学金就是丁书记的主意，可见其人文关怀，必须满分！
33184,2289,杨江,2016-09-14 14:36:47,-1,2,3,人特别好
73569,2289,杨江,2018-02-02 04:00:01,-4,1,5,好老师 作业少
129596,2289,杨江,2021-01-08 07:34:54,12,16,4,嵌入式系统建议选其他教学班
144182,2289,杨江,2021-12-20 06:55:41,0,0,0,一个小组，我是组长，两个队员，我和其中一个队员被卡绩，另一同学提了一分，原因是我和那个同学选了这个老师的课。
144699,2289,杨江,2021-12-23 08:13:30,-5,1,6,老师挺和蔼的 智能设备全程划水 大作业两天肝完 给分还挺好
155608,2289,杨江,2022-06-14 15:25:34,2,3,1,老师挺可爱的，但嵌入式课程设置很不合理，建议选隔壁
156122,2289,杨江,2022-06-17 15:47:15,4,4,0,嵌入式，boring
162539,2289,杨江,2022-12-09 12:50:23,-1,0,1,智能电子设备开发，比较水，上课讲的和大作业没什么关系。老师人很好，就是讲课无聊了点，给分一般。
162550,2289,杨江,2022-11-25 06:10:13,3,3,0,嵌入式给分好烂
162647,2289,杨江,2022-12-01 16:34:07,5,5,0,智能设备给分好差
195056,2289,杨江,2024-07-07 05:35:49,8,8,0,嵌入式给分真的烂，nmd越想越气
196291,2289,杨江,2024-07-03 00:09:01,6,6,0,上课根本听不懂
197052,2289,杨江,2024-07-07 02:52:40,4,4,0,nnd嵌入式，你上八节课，点名点了四次，还经常故意藏在最后一节课快下课的时候点，上课讲的啥啊？还这样搞学生？要是讲得好我不来是我的问题，我真无语了。实验要求也比别的班多，比别的班难，作业也多，每周都有，最后一次作业还要写51程序，都nm14周了，还写51啊？讲得烂，作业多，实验难我也算了，关键这给分也尼玛一坨，真气死我了，本来绩点就不高，还给我卡，气的我大早上睡不着。选上你是我的福气，我是真服气
203254,2289,杨江,2024-11-18 12:18:13,1,1,0,慎选吧
205085,2289,杨江,2024-12-01 06:54:00,0,0,0,智能电子给的一坨…而且这课两个报告加一个大作业，大作业还水，给分给成这样也罢。还有上课屁也没学到，老师不用话筒，差不多前三排才能听到。如果实在缺学分，不介意给分，而且石吃少的可以选一下
205247,2289,杨江,2024-12-03 08:00:42,0,0,0,智能电子设备给分真的一般，虽然挺水的
209519,2289,杨江,2025-01-06 07:25:06,0,0,0,智能电子设备开发很水，给分很不明不白，反正给分不好……不介意绩点的可以选
171383,2360,苏宏业,2023-03-23 03:38:47,1,3,2,已读不回。。。。
171642,2360,苏宏业,2023-03-30 11:48:37,1,1,0,同楼上，已读不回
180694,2360,苏宏业,2023-09-25 02:59:02,-1,0,1,老师上课很认真，ppt也有很认真的准备。\n\n讲课非常有逻辑，至于已读不回，问他要ppt，确实没回，但是默默发在了学在浙大上
196757,2360,苏宏业,2024-07-05 03:31:02,3,4,1,开兰博基尼上课，有钱。讲课风格挺活跃的
46471,2415,冀海峰,2017-01-22 00:20:46,0,1,1,老师人好讲的也好，喜欢研究思考题，会花一节课讲扩展内容，检测注意最后大课认真听讲就好了
109807,2415,冀海峰,2019-06-19 11:14:47,0,1,1,超级棒！
126957,2415,冀海峰,2020-10-30 01:57:26,3,3,0,有条理，包容学生上课做自己的事，超级棒！
128687,2415,冀海峰,2020-12-25 04:18:31,0,0,0,嵌入式系统：\n\n讲课很有启发，而且很清楚。老师人和很好\n\n（不过还是有发言加分这个选项，如果不想卷的话会比较麻烦）
132571,2415,冀海峰,2021-02-02 11:14:45,2,3,1,老师很nice，对同学态度好很耐心，传感与检测给分好（不过这课主要靠期末突击），课上有发言加分环节
132588,2415,冀海峰,2021-02-02 13:30:10,0,0,0,老师很好
177260,2415,冀海峰,2023-07-02 12:52:43,0,0,0,好，很关心学生。\n\n传感技术导论的大论文，期末考紧张的话可以延迟提交，让我们安心复习
178338,2415,冀海峰,2023-07-10 09:51:36,0,0,0,好消息：传感技术导论上课人少给分一般，论文5000字我手快写断了，展示还是互评（）感兴趣可以选
178526,2415,冀海峰,2023-07-13 12:03:11,0,0,0,传感技术导论给分一般，通识课能选其他的还是选其他的吧，感觉真不咋滴~
213544,2415,冀海峰,2025-01-18 06:35:06,0,0,0,人好，认真，会提问，鼓励发言有加分
4957,2450,程鹏,2015-07-01 13:56:05,3,6,3,好
55222,2450,程鹏,2017-07-01 04:23:36,-1,4,5,讲的非常好，给分很不错，从来不点名
124812,2450,程鹏,2020-07-10 08:57:46,0,1,1,大数据课程讲得不错，不过好像整体打分比隔壁班差一点啊。
135057,2450,程鹏,2021-04-28 11:31:08,1,6,5,唉 讲课讲不清 不看群消息 计网这种垃圾课还是别选了 即使知识点记住了英文考试也会把你搞懵的
154068,2450,程鹏,2022-05-22 09:55:47,3,5,2,控院开的计算机网络，老师讲的一般吧，但这门课太离谱了，控制的阉割版的计网，短学期要学的东西太多了，最后期末考试题量很大qwq
155508,2450,程鹏,2022-06-13 18:02:20,2,4,2,很好 收获挺大的
200375,2450,程鹏,2024-10-16 10:50:50,1,1,0,很不错
6566,2534,陈积明,2015-07-15 11:01:42,-3,5,8,好
8598,2534,陈积明,2015-09-23 02:49:41,2,6,4,吹牛。。\n\n
9519,2534,陈积明,2015-10-29 06:52:55,7,15,8,不讲干货尽扯淡
48947,2534,陈积明,2017-03-17 23:52:05,19,32,13,课程准备不用心，课上的内容挂羊头卖狗肉，期末交一个糊里糊涂的大作业。
63754,2534,陈积明,2017-12-14 03:47:16,2,4,2,课堂上还是挺长见识的
88773,2534,陈积明,2018-11-07 12:57:21,7,13,6,觉得浙大本科的研究生不行\n\n上课必问竺可桢学院学生问题\n\n让助教最后一周不要给学生答疑实验内容\n\n讲课也是到处扯，我服了\n\n
88860,2534,陈积明,2018-11-10 12:28:30,13,16,3,最小肚鸡肠的老师…\n\n比赛不顺那学生撒气
89074,2534,陈积明,2018-11-15 06:43:23,6,8,2,听课get不到点，只得佛系复习，文化课最低分get
89077,2534,陈积明,2018-11-15 07:44:58,3,5,2,差差差
89094,2534,陈积明,2018-11-15 12:34:19,1,3,2,买一本top down认真看完比整门课收获大多了，要学计网就去上计网，这种课本来课时就少，水分还大得多，学术视野不是靠听扯谈增长的吧。
102855,2534,陈积明,2019-02-24 08:37:15,17,27,10,计算机网络与无线传感\n\n绩点4.2，分挺好的，但老师这个人真不咋滴。主要问题在于讲话语气特别不尊重学生，总是说自己喜欢招矿业大学的研究生，因为他们基础扎实而且认真努力，相比之下浙大学生水平根本好不到哪去还不肯努力吧啦吧啦...（他也不反思一下浙大牛人这么多，自己为啥偏偏招不到优秀的浙大研究生）还经常呼吁不能总是学生给老师打分，希望能有一个系统让老师给同学打分...
124486,2534,陈积明,2020-07-02 00:58:21,17,21,4,的确不尊重学生。对研究生也是召之即来呼之即去，天天帮他干杂活、写申请书。
156121,2534,陈积明,2022-06-17 15:44:16,2,4,2,学术大咖 要求确实高了一点 但是不水成绩
126532,2681,葛志强,2020-09-29 11:06:54,-14,4,18,简洁明了，含金量挺高
134181,2681,葛志强,2021-03-18 05:51:50,9,12,3,绩点很低...事情很多大三下选的课，事情真的挺多的，小组合作完成一个优化问题，真的没有这个经验的同学还是别上课了，卷的不成样子，为什么不自己看看网课学呢，很多公式细节解释不清楚，感觉没啥收货，争取保研之前被绩杀一波影响真的太大了
135926,2681,葛志强,2021-06-03 12:49:16,9,9,0,不建议选，任务重，绩点低\n\n上课：教大家折纸飞机\n\n课后作业：请制造航空母舰\n\n大家自行体会吧
136497,2681,葛志强,2021-06-19 10:18:11,6,7,1,运筹学简直神坑，不要选，不要选，不要选，真的被坑惨惹，绩杀鸭
137137,2681,葛志强,2021-07-01 11:49:47,8,9,1,葛老师：这课水太深，你把握不住，还得老师来划。我就想知道，8周的系统工程，有人听吗？上课念100多页的概念性ppt，全靠最后2场突击的课堂小测拉高到课率，问问题已读不回。建议控制学子能躲多远躲多远
139717,2681,葛志强,2021-07-21 04:12:32,4,6,2,保研边缘试探选手，出分后，帮我确立了考研的必走路线，我谢谢你。
139726,2681,葛志强,2021-07-21 15:26:53,4,5,1,学习小纸船，力求制造航空母舰！emmm
139727,2681,葛志强,2021-07-21 15:33:02,6,6,0,哎，一言难尽
151589,2681,葛志强,2022-03-08 12:11:20,-1,0,1,别选别选别选赶紧润
152008,2681,葛志强,2022-03-23 03:26:35,1,1,0,本以为那些讲得不好、逼事贼多、强行点到拉到课率的老师都会给的分高一点吧。葛老师：格局小啦，我偏走政策创新，给你来点意外惊喜。该卷的都卷了，甚至还去查英文文献了，最后绩点没有室友抄抄百度复制CSDN，甚至还在报告里贴几十页的代码的报告来的高...我就想问评分是看页数的吗？您也太忙了这些报告都舍不得看一眼。
172984,2681,葛志强,2023-05-11 00:52:53,1,2,1,据说葛老师科研项目贪污被告上法庭了）
133181,2699,吴维敏,2021-02-14 13:07:34,-1,6,7,课程要求不多，结课后会bg全班，希望物流这门课以后还会开
173559,2699,吴维敏,2023-05-29 03:34:55,5,9,4,忘记上课迟到一小时拖堂让同学们等着
21068,2705,毛维杰,2016-02-14 23:55:13,0,5,5,还好吧，讲的挺清楚的。微机课。
34309,2705,毛维杰,2016-10-01 03:45:19,-1,1,2,很好的
58197,2705,毛维杰,2017-08-20 03:58:23,-1,1,2,很好的老师
133170,2705,毛维杰,2021-02-13 00:52:31,-14,2,16,嵌入式系统，讲课可以～
155285,2705,毛维杰,2022-06-10 07:20:25,-1,1,2,为嵌入式攒一波运气，求求老师了，一点不会啊啊啊啊啊啊
158057,2705,毛维杰,2022-06-26 13:32:45,1,3,2,老师人很好，不过嵌入式以自学为主
159148,2705,毛维杰,2022-07-06 22:37:49,0,2,2,老师讲课很清楚很详细，最后也被狠狠捞了。
191102,2705,毛维杰,2024-04-03 02:36:32,3,3,0,讲课不行
220149,2705,毛维杰,2025-06-29 14:44:19,1,1,0,前半学期两次点名性质的小测，题目可看智云\n\n实验验收很宽松，报告/平时均分90，给分一般吧\n\n课也讲的一般，优点就是事相对较少
35489,2735,王智,2016-11-18 13:56:51,-11,4,15,老师很棒！很高但是讲话非常温柔，注重创新，一点都不水哦
35594,2735,王智,2016-11-10 07:30:16,-8,3,11,有点小水，作业不多\n\n
37331,2735,王智,2016-11-18 10:21:48,13,15,2,讲话难听懂而且我学了这么长时间的论文给分这么低拉低均?啊
37370,2735,王智,2016-11-18 13:46:54,30,38,8,真的认真对待了，可能上课是比较水，但老师布置的任务都认真完成了，论文写了三四天，不说多好吧，一个辛苦分要给吧，给个3.3的绩点，真的气，还是我第一门出成绩的课，心情全毁了，只能说我至少没有敷衍了事吧！受挫很重啊。
37392,2735,王智,2016-11-18 16:04:02,10,11,1,很无聊 给分差
37970,2735,王智,2016-11-22 11:31:59,7,8,1,上老师的通识……感觉很认真的在讲然而语速有点快 我真的听不懂啊QAQ\n\n给分不是很好 也有可能是因为我课堂测验完全蒙蔽的缘故(●—●)
38183,2735,王智,2016-11-25 11:32:00,6,8,2,听不懂老师说啥，一脸蒙逼
38423,2735,王智,2016-12-04 08:48:14,-5,3,8,挺轻松的
39940,2735,王智,2016-12-28 08:42:27,-4,1,5,上课坐中间都听不清，讲课的内容始终给人不明觉厉的感觉，不过老师教的很认真，注重学生自己的看法，想认真学的记得坐前排。
49121,2735,王智,2017-03-27 06:35:29,16,20,4,第一次见到有老师用网络翻译软件把ppt翻译成中文的 十分服气\n\n请王老师给我解释一下“健壮的指纹”是什么意思 什么是在“签名空间中最近的邻居”\n\n敷衍就算了 求你说话语调语速正常点好吗 我知道你北方口音 我也是北方人 我听不懂 听不清 好吗\n\n不管给分多少 都不想上你的课 谢谢
59027,2735,王智,2017-09-19 07:03:34,1,1,0,文科生一脸懵逼。语速超快，英文ppt，翻译文献做得我吐血，给分一般
60604,2735,王智,2017-10-25 06:04:22,-2,0,2,没有体验，听不清，作业还多，还要小测
62540,2735,王智,2017-11-26 01:38:25,0,0,0,？？？
62542,2735,王智,2017-11-26 01:41:33,-3,1,4,给分很合理， 上课很有意思 很喜欢这个老师
62565,2735,王智,2017-11-26 02:59:24,5,6,1,千万别选，大绩杀。上课根本听不清他在说什么，认真写论文结果绩点奇低，真的不知道他怎么评的分。
62566,2735,王智,2017-11-26 02:59:44,7,8,1,打分低，低到爆
62689,2735,王智,2017-11-26 11:35:12,1,4,3,老师上课的确听不太清楚在讲什么，上课很水但是小测题还是很简单的，最后的论文和翻译还有观点都可以自己挑着做一个，也取消了期末的考试，减轻了我们的负担，我和我的好多同学给分都比想象的高，谢谢老师和助教? ！
62694,2735,王智,2017-11-26 12:11:52,2,3,1,本来以为自己要炸结果给分不错。平时作业是有好几次不过都不会太难，认真做给分不会太低。助教小姐姐也很nice
62702,2735,王智,2017-11-26 13:01:00,1,1,0,说话不清楚，，，课堂测试简单，，，
62742,2735,王智,2017-11-26 23:13:32,1,2,1,从头到尾认真做，论文也认真写了，最后给分奇低，感觉付出与回报不成正比。
63313,2735,王智,2017-11-30 10:41:02,0,1,1,出乎意料的得到了相当高的绩点。课堂小测忘记写过程，下课去找老师问可不可以补上，他也很耐心等着我交给他了才走。还是挺好的。（虽然真的坐在后排会听不清老师在说什么。）
66460,2735,王智,2018-01-17 00:56:49,1,1,0,实在是太差了
76189,2735,王智,2018-05-10 07:26:39,4,5,1,全英文PPT说话声音小，坐在后面完全不知道他在说什么。课堂测验随便搞一道题目完全懵逼，论文快考试了才布置，辛辛苦苦写了6000多字绩点却很低，可以的。
76669,2735,王智,2018-04-18 02:15:19,4,5,1,这个课，作业多，老师上课语速快，都听不太清讲什么，PPT还是英文的，公式什么的根本不懂好吗，论文春七才布置 ，可怕的是要五千字呀五千字，小测都不知道要测什么，完全懵逼，复习都不知道从何下手，为绩点担忧。。。。
78198,2735,王智,2018-05-10 02:54:29,0,0,0,给发不好
78233,2735,王智,2018-05-10 05:57:07,1,1,0,随便弄的一道题决定占比不少的\n\n小测成绩，老师你可以的。
90105,2735,王智,2018-11-22 06:33:36,2,2,0,老师自己有水平，然而并不在意是否学生能听懂......但作业认真做，还是能有好成绩的。
104768,2735,王智,2019-03-27 11:15:27,9,9,0,我还以为是外教，没想到是中国人
105079,2735,王智,2019-04-03 08:10:25,2,2,0,垃圾。
105622,2735,王智,2019-04-17 11:12:04,1,1,0,一个通识课非要要求这么专业化，展示一定要按照你的想法才是好的吗？随意打断别人的展示，讲话声音小
107074,2735,王智,2019-05-01 10:27:09,-1,0,1,物联网还好（主要是给分还好\n\n能感觉到老师有点东西\n\n讲话确实听不清 他的课想听就坐前排这样\n\n比较对我胃口的 虽然有人感觉被怼了或者怎么样 我们那次展示还比较中老师点的 其他组或多或少存在不足老师也都提出改进意见了 我觉得还是比较中肯的\n\n起码给分不会辜负努力 看自己吧
119478,2735,王智,2019-11-13 03:59:33,0,0,0,要吐血
123527,2735,王智,2020-06-09 10:42:38,1,1,0,老师讲课很快，语气比较单一，网课时代表示很催眠，容易睡着，但是ppt内容很充实，而且也确实有有趣的内容，睡不着应该能学到很多，但是给分...我睡着的部分下课看了回放做了笔记，所有任务都没有逾期认真地好好地完成了，期末的翻译也为了找专有名词花了很多时间心血，因为过程分没有公开所以也不知道哪里出了问题，或许是对人文学生不友好？得分最低的通识了，3.3分看得我心里拔凉...避个雷吧，我觉得可能对这方面没有很充足的了解的话，凭着一些兴趣就选挺物联网这个不明智的，也祝选了的大家有所收获，看淡得分。
123878,2735,王智,2020-06-15 17:20:08,-3,2,5,物联网事挺少的，一次10分钟pre，一次随堂作业（百度一下搜集一些资料，做几个小表格就好啦）一篇论文翻译+PPT。给分高，可水可听。
134613,2735,王智,2021-04-06 01:51:56,2,2,0,讲话听不懂根本，语速又快讲话又混，听个锤子，本身听懂就累还要费心思听你在讲什么
135255,2735,王智,2021-05-07 02:13:51,8,8,0,老师上课内容很有意思，只是语速快，听不太清楚。算是我最认真对待的一门通识课了，作业认真做，论文写了很长时间，结果还没达到平均分，真的有点不理解，受到打击了，可能同学们都很强吧。唉，继续努力吧。
142048,2735,王智,2021-11-04 15:52:34,1,2,1,上课自己和自己玩，上通识课用的全英文ppt，嘴里全是专业名词。或许是我太菜，理解不了吧
142676,2735,王智,2021-11-15 04:34:24,-1,2,3,认真听能听到很有用的知识~给分也很好，期末就一个大作业，非专业的人也能选~
142754,2735,王智,2021-11-16 02:23:26,-2,2,4,快跑 😓😓😓语速快到不行完全听不进去  认认真真完成每项作业 精益求精最后被正态 🤗
142770,2735,王智,2021-11-16 03:53:41,-1,1,2,专业性很强
144764,2735,王智,2021-12-23 13:02:26,-2,0,2,好好好
151403,2735,王智,2022-03-02 10:49:40,0,2,2,他说话是一直都有哼气的习惯吗，还是只是偶尔得病了？
151606,2735,王智,2022-03-09 07:57:31,2,2,0,讲课很烂 不如📷\n\n烂烂烂快逃
152400,2735,王智,2022-04-08 02:39:50,1,1,0,老师你上课能安静点儿吗？打扰我自学了。\n\n讲话语速快，听不清，不如别讲。
152813,2735,王智,2022-04-20 06:04:26,3,3,0,经典听不如不听系列，合理怀疑他的嘴被开水烫过
153103,2735,王智,2022-04-25 13:18:14,12,12,0,物联网。\n\n作业都认真写了，小组展示还被助教选为优秀展示，结果3.9，给分巨差。
153816,2735,王智,2022-06-02 02:23:40,1,3,2,快逃 真的信号还不如选相机 跟着他你连作业都不知道做哪里 学一个学期什么都学不到 助教也是纯烂人 真的难崩
156136,2735,王智,2022-06-18 02:03:00,3,3,0,老师人挺好的，学术水平很高，不点名，就是讲话比较糊涂，上课进度也比较慢，可能不太适合教学，建议多自学，多问问其他班布置了什么作业
158242,2735,王智,2022-06-27 17:18:06,4,5,1,只有展示课点名，平时靠自学，期末给分不错
158245,2735,王智,2022-06-27 22:49:47,2,4,2,智宝💗智宝💗
158285,2735,王智,2022-06-28 05:18:58,-1,0,1,给分好就完事了
159258,2735,王智,2022-07-09 12:07:17,0,2,2,信号处理与分析，给分超级好，平时课没怎么挺听（老师口音太重听不懂），期末之前一夜速成，还上了90
162602,2735,王智,2022-11-28 05:02:27,2,3,1,老师很好，如果你是一名理工科的学生，想要在通识课里得到的不仅仅是1.5个学分，那我真心推荐物联网这门课。听王智老师的课对于我这种大英3水平的人来说很有挑战，你能在这他的课程中学到超多有关物联网技术的名词。建议和朋友一起选，随堂测试的时候有个照应。大作业是一篇论文翻译并制作PPT，展示是根据老师上课内容联系生活进行适当拓展
180804,2735,王智,2023-09-26 11:36:21,0,1,1,“父母，有一个即可
182139,2735,王智,2023-11-10 13:38:53,3,4,1,听不懂听不懂，ddl到了提作业要求，😅😅
182733,2735,王智,2023-11-20 03:00:24,2,2,0,物联网给分不太好，作业就是期末的英文文献翻译和平时的一份PPT制作，事比较少上课专业知识不多，不介意给分的可选
182812,2735,王智,2023-11-20 11:33:06,0,0,0,很难评，学不到什么东西，给分很一般\n\n期末作业做的很无聊，要么5000字论文要么翻译英语论文。当英语联系差不多😅
183195,2735,王智,2023-11-22 15:05:15,1,1,0,上课说话完全听不清，期末翻译作业非常多，我用一个星期一大半自习时间都勉强写完，最后绩点也很低
184639,2735,王智,2023-12-22 04:35:43,1,1,0,可以说很水
184810,2735,王智,2023-12-23 04:27:56,1,1,0,最后给分有点低
197043,2735,王智,2024-07-07 02:04:28,11,12,1,口齿不清，嘴里可以炒菜了...上他的课简直了，啥都听不懂（中文意义上的听不懂），很多课友都这么觉得。给分也不好，麻了
219511,2735,王智,2025-05-29 05:35:15,3,3,0,口齿不清，作业布置要求不明确，信号大作业难度过高，能选张健杨欢班就去张健杨欢班
219517,2735,王智,2025-05-29 06:24:02,3,3,0,期末周被他一天一个规则的大作业搞得心惊胆战，真的想一出是一出。。狠狠避雷吧
219521,2735,王智,2025-05-29 06:55:21,2,2,0,至今上过最烂的一门课，大作业要求一天一变，讲课什么都听不清，还突击了一次课堂测试，没吃过史的可以选
219584,2735,王智,2025-05-30 07:25:19,2,2,0,傻逼，不仅口齿不清，大作业要求也讲不清，司马玩意
8073,2749,张颖,2015-09-17 01:47:25,13,17,4,还可以
25249,2749,张颖,2016-05-09 02:27:20,2,2,0,说话特别慢，想睡觉
45039,2749,张颖,2017-01-19 01:09:47,4,4,0,上了老师的思修课，很温柔，不过思修课比较水没看出啥水平，很喜欢笑，有时候讲起家里的事能从眉眼里看出幸福感
48942,2749,张颖,2017-03-17 07:15:21,0,0,0,一般般吧
60383,2774,黄志尧,2017-10-18 13:56:53,-1,1,2,我们的新生之友，给个好评
67165,2774,黄志尧,2018-01-20 11:15:13,-1,3,4,课上的泽号
72296,2774,黄志尧,2018-01-30 00:21:49,1,5,4,黄老师非常好，上课轻松而且很有趣，课程任务不重，分享很多自己的经历，而且最后给分也非常给力。
141043,2774,黄志尧,2021-09-22 06:46:45,4,8,4,之前以为是个受人尊重的老师，后来发现就是个傻逼，品行败坏，斯文败类
141894,2774,黄志尧,2021-10-30 09:57:49,2,3,1,这种人活着，就是个毒瘤，祸害（pua）自己的女研究生，garbage
151756,2774,黄志尧,2022-03-14 17:12:35,2,6,4,听过现居欧洲某国学姐的经历，感觉这个人就是个人渣，自己家庭不幸福，就利用导师职权性骚扰女学生，令人恶心，浙大也有这种败类，还天天觉得自己很牛逼，奉劝女研究生们远离这个恶心玩意
171164,2774,黄志尧,2023-03-17 08:10:01,-5,1,6,从本科生上课的角度看，黄老师还是可以的，至少上课重点明确突出，不点名，也没什么作业，体验很好。缺点是上课不用PPT。给分正常，不调也不捞，不过其他几个班似乎也这样。几个教学班中选的话还是推荐黄老师。
176662,2774,黄志尧,2023-06-29 15:33:07,7,10,3,比较喜欢信口开河的乱讲。表现的很渊博，很多东西都经不起推敲。所以比较容易迷惑本科生吧。平心而论，本科生课讲得不错。But对研究生完全是另一幅面孔。组里有因为和他争执托福的，也有默默忍耐然后抑郁的。喜欢骂学生猪脑子。喜欢表达自己对研究组的绝对控制权地位。挺一言难尽。
185858,2774,黄志尧,2024-01-05 03:42:06,11,11,0,自作聪明，复习课不开麦克风，我搁这儿听你嗡嗡嗡呢
185884,2774,黄志尧,2024-01-05 10:38:58,10,10,0,复习课不开麦，后面的同学根本听不清，提醒之后让大家适应他，还有迟到的同学不让进教室，只想说装nm呢
189924,2774,黄志尧,2024-02-02 10:50:36,-1,0,1,讲课还行吧，给分真的一般。。
197431,2774,黄志尧,2024-07-15 03:45:03,-5,0,5,妙不可言
199640,2774,黄志尧,2024-09-26 15:04:03,4,4,0,斯文败类，假
208337,2774,黄志尧,2024-12-27 02:33:52,7,7,0,把学生当成贼防
208344,2774,黄志尧,2024-12-27 02:51:26,11,11,0,"""我对我的声音有充分的自信"""
208345,2774,黄志尧,2024-12-27 02:54:01,9,9,0,故意不用话筒，教室没有智云；课件过于没用，个人莫名自信。\n\n横批：南平
208347,2774,黄志尧,2024-12-27 03:10:38,9,9,0,复习课不开麦，只能说评分还有很大下降空间
208415,2774,黄志尧,2024-12-27 12:03:33,5,5,0,咱控院最不缺的就是抽象老师🤪
214006,2774,黄志尧,2025-01-23 01:00:06,0,0,0,给分一般
125,2922,杨亮,2019-10-22 02:00:08,20,208,188,其实是个自评贴。自己觉得讲得还可以。很多课上的东西没有好奇心重要。思修课水或不水，只是你们选择不同态度下学到的东西截然不同而已～～
7157,2922,杨亮,2015-09-09 02:24:46,32,61,29,左右左   左右左
7159,2922,杨亮,2015-09-09 03:15:03,27,36,9,我不管，我想静静\n\n
7160,2922,杨亮,2015-09-11 02:44:07,3,17,14,左右左
7161,2922,杨亮,2015-09-09 04:10:36,4,17,13,左右左，左右左
7162,2922,杨亮,2015-09-09 04:22:21,3,17,14,左右左
7181,2922,杨亮,2015-09-10 02:57:46,-22,13,35,外表虽然严肃，但是人还是蛮好的~时常会有各种新奇的想法。
7191,2922,杨亮,2015-09-10 09:05:00,-14,41,55,脑洞很大的老师，情商很高，现实中很萌，QQ里更萌。
7285,2922,杨亮,2015-09-13 02:15:55,-19,5,24,感觉萌萌哒，认真就会有收获
7296,2922,杨亮,2015-09-13 07:56:11,-19,6,25,又认真又萌
7382,2922,杨亮,2015-09-14 05:20:52,-2,11,13,左右左右左右左。。\n\n
7577,2922,杨亮,2015-09-15 05:15:18,-4,7,11,右 右 右左右
7686,2922,杨亮,2015-09-15 09:04:01,-11,25,36,指导员迷之上篮威武！
7837,2922,杨亮,2015-09-15 14:31:50,-7,13,20,有思想有情怀有媳妇?
8005,2922,杨亮,2015-09-16 12:31:28,-9,4,13,左右左左右左
8052,2922,杨亮,2015-10-15 01:13:22,-16,2,18,很棒的老师
8951,2922,杨亮,2015-10-04 04:47:06,-9,4,13,左右左 左右左
9562,2922,杨亮,2015-11-01 07:31:55,-9,5,14,左 左 左右左
9704,2922,杨亮,2015-11-05 01:24:24,-16,4,20,很有趣，interesting\n\n
9951,2922,杨亮,2015-11-13 07:12:17,-17,4,21,额，今天才知道老师原来是控制的，听老师的课挺好玩的
12871,2922,杨亮,2015-12-24 07:11:47,-16,2,18,有趣作业不多会有测验
12999,2922,杨亮,2015-12-24 13:02:53,30,36,6,好为人师
13001,2922,杨亮,2015-12-24 13:08:55,-17,5,22,帅气的很
15071,2922,杨亮,2016-01-12 01:43:16,-16,10,26,有趣的老师，迷一般的作息规律
18156,2922,杨亮,2016-01-21 08:26:50,-19,2,21,大爱指导员！左右左！
19596,2922,杨亮,2016-01-25 01:31:37,-15,6,21,萌死了，真的
19598,2922,杨亮,2016-01-25 01:37:46,-16,10,26,熬夜工作很拼的老师，很有思想不功利的老师~
19600,2922,杨亮,2016-01-25 01:52:35,-15,9,24,讨论的问题都很有趣很有价值，我原想思修的话，讲来讲去也就那些，但是杨老师会让你学到新的东西
19601,2922,杨亮,2019-07-14 05:18:12,7,26,19,经常凌晨3点钟在群里向我们汇报工作进展，“触碰”我们的心灵(^_^)╭(°A°`)╮(๑•ั็ω•็ั๑)
19602,2922,杨亮,2016-01-25 02:03:54,-19,2,21,真心不错
19606,2922,杨亮,2016-01-25 02:14:23,-11,21,32,很多小组讨论让人有思考 不局限于课本 不像其他老师有一些很麻烦的作业 很幽默
21194,2922,杨亮,2016-02-26 04:59:33,-15,6,21,老师很有趣，上课经常会问一些有趣的问题，充满了正能量，给分也超棒！\n\n
22367,2922,杨亮,2016-03-04 02:53:12,-17,2,19,老师上课很有趣的，和学生也很亲近，很善解人意，会参考学生的想法
34319,2922,杨亮,2016-11-12 14:36:15,-19,5,24,老师超级萌。会在思修群里给你聊各种人生经验。下一届的小朋友们一定要选亮亮的思修课哦。
34686,2922,杨亮,2016-10-18 07:18:49,2,24,22,在QQ匿名与众同学斗图
35100,2922,杨亮,2016-11-02 07:41:38,-16,3,19,有思想 思修课一点也不枯燥 尊重同学想法 课堂气氛很活跃 热爱亮亮
40611,2922,杨亮,2017-01-04 09:32:46,-22,4,26,很棒哦
40791,2922,杨亮,2017-01-05 13:43:41,-17,4,21,亮亮简直男神哇
46626,2922,杨亮,2017-01-22 04:21:18,-16,12,28,思修这样的课 听谁的不是听\n\n亮亮总想启发我们 可能是我中毒太深 \n\n这么多年的应试教育是一个学期改变的了的吗。而且平时让组长评分的机制也不完善，抱紧组长大腿的人分数自然高。觉得很不公平。我就是这么关心绩点，就是这么世俗，辜负亮亮。
46677,2922,杨亮,2017-01-22 06:42:58,-17,6,23,亮亮的思修课才是真正的思修，真的能学到很多思考问题的方法，会有一些启发的。给分也很好哦。
47412,2922,杨亮,2017-01-26 05:38:12,-17,9,26,亮亮人好，给分正经，搞辩论的，喜欢多方面考虑问题。上课也喜欢启发一下同学，鼓励同学对于一个问题发表自己的独立见解，这一点非常好。告诉大家做事不要太注重绩点，应该是指要以做事本身为目的而不是以绩点为根本目的。结束后4.5分，希望以后还有再接触亮亮的机会。感谢杨亮老师。
47776,2922,杨亮,2017-02-24 10:23:37,-27,2,29,上课很认真，事例都很贴合，和学生打成一片，福利很多，观点犀利深刻，很喜欢
48082,2922,杨亮,2017-02-28 10:23:43,-18,6,24,男神男神！听课之后立马转粉！！最后一节课发橘子萌死了～
48303,2922,杨亮,2017-03-02 04:13:15,-15,4,19,重点是 事情和其他思修老师比真的少！！
48317,2922,杨亮,2017-03-02 06:06:26,36,40,4,被正态了，不知道为什么
58363,2922,杨亮,2017-08-29 15:26:56,-9,1,10,。。。
58542,2922,杨亮,2017-09-01 03:41:44,10,31,21,垃圾货色
58558,2922,杨亮,2017-09-03 05:33:20,-15,5,20,很有情怀的老师
58569,2922,杨亮,2017-09-28 12:39:54,52,64,12,很水很垃圾的老师
58579,2922,杨亮,2017-09-05 14:14:58,-18,2,20,歌唱得不错
58608,2922,杨亮,2017-09-08 13:03:21,-3,20,23,二团三连前来报到
58627,2922,杨亮,2017-09-11 06:24:03,-15,9,24,我是在天津新生见面会上第一次见到杨亮老师，后来在军训中他担任了我们的指导员，我认为很不错
58633,2922,杨亮,2017-09-11 12:06:44,26,43,17,狗？多少连散了心里没点*数？被你整的没吃晚饭又淋了一个小时雨解散了还要拉出来遛？
58672,2922,杨亮,2017-09-18 12:25:11,37,45,8,正态坑啊
58682,2922,杨亮,2017-09-14 10:48:09,-14,7,21,很认真负责的老师
58684,2922,杨亮,2017-09-14 13:19:06,-26,3,29,脑洞很大，嗓门很大，情商高，口才好
58788,2922,杨亮,2017-09-17 13:55:08,-11,7,18,一开始还好，等后来进表演连就不管我们了
58942,2922,杨亮,2017-09-18 15:41:13,71,81,10,军训瞎给分，比旁边的连整体低了10分左右，真是无语，还好意思说全团唯一一个劈枪连，感觉是全团唯一一个低分连吧！
58943,2922,杨亮,2017-12-25 06:29:06,79,90,11,军训绩点都能这么低，全连的绩点都低的没边，倒是几个半训的上了九十分，要是军训能选老师就好了
58970,2922,杨亮,2017-09-19 02:38:11,-18,2,20,指导员威武\n\n
58975,2922,杨亮,2017-09-19 03:18:33,-18,5,23,上课很有意思
58976,2922,杨亮,2017-09-19 03:21:25,34,40,6,劈枪扣分？
60143,2922,杨亮,2017-11-24 15:58:10,39,47,8,给分全是一档最低分，好意思吗？正态狗
60753,2922,杨亮,2017-10-29 12:12:59,32,38,6,因为他布置的恶心论文给他打一分\n\n呵呵\n\n写论文写到哭泣
60836,2922,杨亮,2017-10-31 03:39:28,34,38,4,实在受不了每周都要拖堂。。现在已经13分钟了还在讲讲讲饿死了还讲还讲。因为拖堂，本来勉强有趣的课都没趣了草
60837,2922,杨亮,2017-10-31 03:40:43,34,35,1,拖课大王
64551,2922,杨亮,2018-12-11 11:45:34,-70,7,77,声明下，军训成绩有人造谣半训同学多上九十是不符合事实的。队列 思政  卫生都有不同折算，部分同学队列辛苦但其他表现不佳也是公平的。从个别同学回复态度来看，还真和正态分布无关，这是来到大学的第一课。每天要监管还枪没空多去表演方阵激励也没办法，这是唯一的抱歉。（老师留）
64644,2922,杨亮,2017-12-26 02:08:27,-7,6,13,有时候拖堂，有时候会提早放的? ? ?
64648,2922,杨亮,2018-01-22 06:05:34,-15,5,20,思修分还没出来，先膜老师！求老师不杀！爱您
64654,2922,杨亮,2017-12-26 03:21:34,-28,1,29,呜呜呜杨亮老师我爱你(ღ♡‿♡ღ) 听着家乡口音很有归属感哈哈哈哈
64655,2922,杨亮,2017-12-26 04:24:55,-15,5,20,他不会告诉你怎么去拿高分，他只是时不时告诉你大学以后的路要自己选自己走。学一些分数以外的东西比分数本身要重要。
65927,2922,杨亮,2018-01-10 09:32:56,90,90,0,绩点3.0其他连唯一的一个3.0是被参谋长抓到玩手机
66666,2922,杨亮,2018-01-18 05:37:31,-15,5,20,思修考前二十分钟:亮亮正在黑板上写字 好可爱 好喜欢他
66794,2922,杨亮,2018-01-19 05:37:37,48,55,7,浙大最垃圾的老师之一，没有人性
67137,2922,杨亮,2018-01-20 10:12:43,-17,4,21,老师很有趣也有思想，会有很多讨论，不知道有没有别的课还能上，成绩没出来前评一发吧。前面那个军训3.0的，是没看过我们连吧，什么都认真做了还踢正步了一片3.0，还有2.7的，别瞎抱怨了。
67667,2922,杨亮,2018-02-07 09:04:37,142,160,18,看到你们都骂他，我就放心了，希望以后的同学们不要被查老师评分误导了，要看最新评论你才会真地了解这个老师。
68306,2922,杨亮,2018-01-23 03:04:56,41,45,4,前面那个说什么别瞎抱怨了的人，你思维真的挺有趣，你的意思是说你们连也给分很坑，所以就不应该抱怨了？也就是说你们连的指导员跟这个老师一样，披枪方阵选进去了站过岗了，绩点还是3.0，2.7，这个老师就不该被喷了？给分不合理，不考虑学生们的感受，学生也不会对老师尊敬，而不是说什么也有老师也是这样子就别喷了好吧！我们军训时尽力了，也熬过了披枪的累和晚吃饭，他在给分的时候，不尽力，明明只要30%79以下，当时有多少人下79了大家也都看在眼里。这就是所谓的大学第一课吧？开学先给你的绩点当头一棒，真的挺讽刺的……
71011,2922,杨亮,2018-01-28 01:48:24,-15,2,17,很有思想很幽默的老师啊~给分不错
71070,2922,杨亮,2018-01-28 02:22:42,14,15,1,。。。
71115,2922,杨亮,2018-01-28 03:23:43,21,24,3,给分不太好，觉得小组评价贡献度这个有点不好。而且就以期中的贡献度为准了，那下学期的贡献就不会被算进去有点失望。\n\n虽然事情没那么多，但是同样给分也没那么好呀，所以慎重考虑吧还是。
71117,2922,杨亮,2018-02-15 01:41:18,-31,5,36,事情不多，就一篇论文，一篇小组合作的调研报告，还有期末考试。但是给分好，上课基本没发过言，4.5。可惜被卡档了，不过也挺出乎意料的了。
71128,2922,杨亮,2018-02-01 08:34:06,116,124,8,在上课的时候把查老师被差评的截图放到ppt里。还自行解释…这真的震惊到我了…感觉作为老师，心胸有点狭隘，过于在意别人看法不如做好自己，很多好老师无需解释查老师的评分自然都能接近满分，这就是差距吧。
71134,2922,杨亮,2018-01-28 04:09:36,-15,10,25,我觉得老师思维很敏捷，问的问题有些咄咄逼人却也很有启发性。思修课的质量真看老师，当然刚开学的时候水了把后期有点后悔。期末考试感觉挺没必要的。课时太长，容易走神。最后绩点一般般。
71143,2922,杨亮,2018-01-28 04:31:11,-16,3,19,亮亮超有趣！非常有思想的老师 平常基本没作业 一次论文一次调研报告 只要认真付出了会有好?点的 当然小组组长优秀负责也很重要 期末还发红包哈哈哈
71153,2922,杨亮,2018-01-28 04:59:57,-16,3,19,非常可爱的老师！会教我们理性地思考问题以及更有逻辑性地答简答题。虽然最后不一定会记住多少关于思修的内容，但更重要的思考的技能却是可以让人受益终生的。感谢！
71567,2922,杨亮,2018-03-31 04:13:35,96,109,13,身边老有同学议论当初那次不堪回首的军训，跑来写下些大实话。不想说脏话，只是感到惋惜，自己确实没突出之处，但勤勤恳恳写了每一次通讯稿，因为不爱说话而在互评里拿了较低分吧（可能），可至少也被选去打了军体拳，不大明白为何只有2开头的绩点....
72123,2922,杨亮,2018-01-29 11:45:01,-17,4,21,老师自己的教学思想很先进，但是只能说还不适合我们当前的教育现状。给分比较一般，但是上课比绝大多数思修老师有意思。。。
72379,2922,杨亮,2018-01-30 06:04:22,207,232,25,补充一下，军训时连部的均绩肯定在4以上，我认识的半训的同学一个4.2一个3.9，而很多全训的，没有请过假，没有违纪，按时交稿，认真打扫的?点以3为中心波动。我不否认别的同学的努力，但我也不会轻视我的投入。所以，那些拿了高分的同学请不要再维护指导员了，首先，恭喜你们，你们是获胜者，但付出被践踏的人不是你们，你们没有资格对真正的被绩杀者指手画脚。指导员，对，有一些幽默和情调，确实吃了苦，但同时，自以为是，非常自负，排合唱，多次打断别人的指导，以自己的观念给军训评分，正态的相当，不说恶意，起码没有对学生的理解和支持。所以，没有经历过他的绩杀的同学并深深喜爱他的同学请继续爱他，而我，只能讲，无话可说。
73632,2922,杨亮,2018-02-06 00:06:54,3,3,0,亮狗吾儿
73840,2922,杨亮,2018-02-03 08:36:48,36,39,3,hi～我系渣渣量，学生，我焦锅很多，但系游戏，我只喜欢 贪玩坑人，哲次，贪玩坑人 来了，你没有得过的船新低分，垃圾回收，（py）交易自由，今晚八点，准时装比！！！
74044,2922,杨亮,2018-07-06 01:38:33,70,71,1,本来想评2分，发现点不了，就评了1分\n\n\n\n\n\n道貌岸然，自以为是，盛气凌人
74100,2922,杨亮,2018-02-05 06:02:46,48,52,4,军训的老铁们也别太激动啊，这条狗的思修给分也很坑啊，这个智障亮狗整天就知道拖课布置作业，给分还神他妈蛇皮的低，这个傻逼怎么还有脸面上课，自以为是道貌岸然，赶紧滚出浙大吧！傻逼亮狗！
74229,2922,杨亮,2018-02-07 08:55:03,1,1,0,辣鸡老师\n\n
74364,2922,杨亮,2018-02-15 01:41:01,41,41,0,我希望这样的老师别来军训了
74415,2922,杨亮,2018-02-20 07:30:43,20,28,8,各位同学，\n\n会思考，有情怀。\n\n不要一天到晚只知道骂人。\n\n他妈的。
74503,2922,杨亮,2018-03-02 01:09:13,36,42,6,作为一名军训老师，他很好地交给了大一新生一个道理————大学生活，没有那么多公平。
74539,2922,杨亮,2018-03-03 07:05:49,16,16,0,军训绩杀
74908,2922,杨亮,2018-03-06 10:50:27,-26,0,26,杨老师超有趣的hhh一起备战到清晨的指导老师
75627,2922,杨亮,2018-03-14 08:00:55,1,3,2,军训飘过
76181,2922,杨亮,2018-03-28 10:06:31,21,22,1,诡辩、装笔、辣鸡
76193,2922,杨亮,2018-12-13 15:00:10,-90,4,94,安利下：http://weibo.com/ttarticle/p/show?id=2309404221589745984832\n\n\n\n我还真特意去查了下同时“被预置”选了军训和思修的人怎么会有这么“惨”。。。\n\n╮（╯＿╰）╭  大概唯一的解释就是这和有人放下微积分试卷的时总觉得能拿满分一样吧，而有人两次都感觉不错哈。只是对教育教学感兴趣，不针对任何人或事。老师必须在意那些有价值的评价，它会带来不足的反思和业务的改进；但老师也必须坚持有价值坚持的标准，没了坚持，他也会被奴役。\n\n\n\n看似有人咬牙切齿，只是大家各有坚持，你不会变，我也不会，缘份而已。（老师留）
79263,2922,杨亮,2018-05-29 08:04:30,32,33,1,"除了没进办公室坐着，以及大合唱上台唱歌，其他都都按照我能想到的""最高标准""做了，军训绩点3.6飘过。劈枪，没迟到没请假，搬水，穿小两号的鞋磨出过血，流出的汗浸皱过手，打到一半不想写了，就这样吧。。。"
79330,2922,杨亮,2019-10-22 04:13:12,-6,27,33,声明下，我就是不想给你们高分，这是唯一想说的。（老师留）
82351,2922,杨亮,2018-07-08 03:13:42,1,1,0,辣鸡老师\n\n
86032,2922,杨亮,2018-08-27 15:34:51,25,26,1,这绝对是条狗
86949,2922,杨亮,2018-09-19 13:51:34,10,11,1,你们去看看今年的军训成绩，再对比一下我们去年的。平均分差距能有10分以上了吧，呵呵。随便点开一个连一眼扫过去一堆满绩，我们当年才几个？一个连的成绩就只成了你证明自己所谓“公平严格不水”的牺牲品，你是真的做到了还是只是自以为是假惺惺的虚伪标榜？呕。
87464,2922,杨亮,2018-09-29 06:17:38,22,22,0,其他的我不说，军训的时候就您那个形象还天天把控制学院挂在嘴边，您配吗？您就是个思政老师，控制学院的研究硕果跟你有半毛钱关系吗？您怕不是个反向黑哦。\n\n个人认为浙大最配的上0分的老师，看到你们都在骂他我就放心了。
87784,2922,杨亮,2018-10-13 05:52:23,21,22,1,上课的样子真的接受不了，对每个同学回答问题的评价都是各种diss，不知道意义何在。。
88085,2922,杨亮,2018-10-22 03:20:30,19,19,0,呵呵呵了，不讲道理的家伙
89522,2922,杨亮,2018-11-19 11:29:48,19,19,0,喜欢怼学生，逼格高
90674,2922,杨亮,2018-11-25 06:13:16,23,23,0,给小组中的成员排名次打分没必要，您这样真的没必要，各种恶竞…
91742,2922,杨亮,2018-12-19 06:15:10,51,52,1,这个人的思修课给人非常压抑的感觉，评分制度就是给恶竞量身定做的。为人喜欢炫耀，非常适合舔狗同学和分奴同学。对于想把精力放在学东西而不是拿绩点的人十分不友好。
92814,2922,杨亮,2019-01-04 14:38:00,-20,7,27,与其抱怨，不如考虑一下应不应当拿到好的成绩。
93431,2922,杨亮,2019-01-09 13:59:47,14,15,1,辣鸡老师
94185,2922,杨亮,2019-01-15 13:08:58,21,21,0,感觉是查老师里被喷的最惨的一个，一个思修老师对自己没点认识，天天这个那个的，自以为上课很有个性，自以为有实力
94380,2922,杨亮,2019-01-16 09:07:54,57,57,0,考完试了，过来评论一波。说实话，这是这一学期让我最不喜欢的一个老师。虽然还不知道绩点怎么样。但是上他的课总是不是特别舒服。经常会有一些看似十分高明有深度的课堂讨论。而组内的打分制度又非常助长鹅颈，必须要1-9排名，不能同分，基本上我组里就是组长一排，剩下其他人也都不好意思说什么了。老师也给人一种非常自负自以为是的感觉。印象深刻的一次是有一次老师说他有点感冒，本来不想来上课，想找个人代课，但发现又没有人讲的比他好，就只好自己来了。总之就给人一种很爱装13的感觉，常常卖弄学识，时不时在群里莫名其妙地发一些东西，也经常在深夜在群里发条消息，似乎是在表明自己工作多认真，工作到深夜。希望老师读了这么多经典的书之后也能知道“谦逊”二字怎么写吧！因为我觉得一个真正负责任的老师是不会如此热衷于卖弄自己的。
94472,2922,杨亮,2019-01-16 15:55:22,11,14,3,杨老师的这种教学方式的确会助长恶竞的风气。不知道自己绩点会怎么样，但估计也好不到哪去，毕竟上课的时候我是最沉默的那种人。我只是觉得老师的教学方式不能直接说是对的或是错的，但是真的非常不适合不喜欢发言的同学。老师的平时为人处世方面确实有种盛气凌人的感觉，但是总体来说也挑不出什么太大的毛病。总体评价中规中矩吧。（再说一遍，不喜欢发言的同学真的别选杨老师）
96242,2922,杨亮,2019-01-20 14:51:52,-17,1,18,个人认为老师上课特别好\n\n真的\n\n思修这门课是一个水课，本来没有想着会学到什么\n\n但是事实上老师的课很有意思\n\n学习这门课会学到很多\n\n辩证思维\n\n人文思维\n\n法治思维\n\n课堂讨论会听到许多很多价值的观点\n\n啊语言表达能力不太行\n\n但是真的觉得这门课老师讲的很好\n\n老师其实也很可爱\n\n严格要求也是做事严谨认真的身体践行吧
96249,2922,杨亮,2019-01-20 15:05:04,36,38,2,实在无法理解杨老师为何要在查老师上不断自评，如果有那么一大部分人认为你的授课方式或者给分制度有问题，我认为您首先要做的是进行自我反思，而不是一味地在查老师里给自己刷分（至少我现在是这么怀疑的），给自己进行一些无谓的解释，这些对您自己，对往后的上您思修的学弟学妹都没有好处，最多只是显现出您个人视野的狭隘与偏执。我承认您可能确实非常有学识，至少比我有学识多了，但我真的认为这些作为一个大学老师的一些基本素养还是要有的。以及，我真的认为您的最新自评“我就是不想给你们高分”很过分，这不是一个大学老师所应有的气度！
96284,2922,杨亮,2019-01-20 16:18:09,13,14,1,嘿嘿嘿～难受～哟……老夫鬼刀一开，走位，走位，绩杀，难受～
96370,2922,杨亮,2019-01-21 01:24:12,16,19,3,那些说学到东西的 比如辩证思维 请问您的高中语文在学什么？ 背美词美段吗？
96695,2922,杨亮,2019-01-25 10:03:17,-26,6,32,不是舔不舔的问题…平心而论我拿了高绩点自然开心（会有拿了高绩点然后喷老师的吗？），但是高绩点又不是舔来的。这门课有正态必须有30%的人3.3以下，所以楼上还不如抱怨为什么自己是这30%。你觉得你认真完成了所有，但是你不知道其他人比你更努力。不是老师渣，不是舔，只是因为相对运动。
99904,2922,杨亮,2019-01-25 09:25:02,-18,5,23,老师人还是很好的，上课经常让我们讨论一些时事热点，给我们推荐一些值得一读的书。嘴上说就是不给你们高分但是实际给分很好。本以为会被正态但是分出来比预期的高了好多。谢谢老师啦o(^o^)o
99919,2922,杨亮,2019-01-25 09:49:09,-17,1,18,老师人很好，教我们学会思考，也交给我们许多人生哲理，给分也很好。
99922,2922,杨亮,2019-01-25 09:53:46,-15,2,17,舔狗舔到最后应有尽有
99926,2922,杨亮,2019-01-25 09:59:50,-17,2,19,很有思想的帅小伙。
99936,2922,杨亮,2019-01-25 10:11:59,-11,4,15,上课挺无聊，但是给分不错
100432,2922,杨亮,2019-01-26 06:28:26,0,8,8,其实老师讲课还是蛮有理有据的，但是评价体系...呃，只能说鹅颈温床吧。有一次因为有同学去过宪法纪念馆，老师就在课上说要加10分平时分，感觉这样的加分实在有些鲁莽，至于说给分，还是蛮不错的，至少我们这次的班是这样子
102858,2922,杨亮,2019-02-24 11:14:34,-41,1,42,非常好的老师！跟着杨老师能学到很多
104660,2922,杨亮,2019-03-26 02:00:23,12,12,0,各位可以试试加入校辩论队，一定会感动于平日工作学习繁忙的队长团用肉身为队员挡住名义指导老师的各种无脑行为。顺便，不要因为这位老师，误解了辩论、辩手和辩论队。
105455,2922,杨亮,2019-04-14 10:39:23,10,10,0,自大至极
105695,2922,杨亮,2019-04-18 12:50:28,5,5,0,顶不住
105698,2922,杨亮,2019-04-18 14:35:24,6,6,0,创新思维与创业方法。一个半学期的课，作业是不是有点多了。最后一节课拖堂1个小时，服了。能想象下个星期就是考试周了。这个星期还要做一个ppt，还要根据他的建议重新修改企业计划书的绝望吗？
105821,2922,杨亮,2019-04-21 09:35:37,14,14,0,总是带着一种鄙视和嘲讽的语气
106910,2922,杨亮,2019-04-30 08:07:10,-16,1,17,可以学到不少有用的东西，了解到老师对于社会的深刻见解
107514,2922,杨亮,2019-05-06 06:25:12,15,15,0,社会实践的指导老师，他但凡帮我联系一个企业我都任他批评，一点忙不帮全靠我自己厚着脸皮联系企业，最后还一堆破事嫌你参观不到位，要不是还得问他要报销我当时就得跟他怼
107555,2922,杨亮,2019-05-07 00:10:17,14,14,0,零分的体验，自以为很有逻辑，其实只是满口诡辩。还各种炫耀自己，自以为是。
107591,2922,杨亮,2019-05-07 08:09:08,9,9,0,自我感觉过于良好
107836,2922,杨亮,2019-05-13 02:17:24,19,19,0,感觉其实很幼稚，但是偏偏爱装成熟
107905,2922,杨亮,2019-05-11 05:28:06,5,5,0,呵呵呵
108055,2922,杨亮,2019-05-14 02:25:07,-13,2,15,4.2 海星吧……
108061,2922,杨亮,2019-05-14 02:41:04,9,9,0,创业课夸夸其谈
108272,2922,杨亮,2019-05-19 05:52:31,10,10,0,nmsl
108790,2922,杨亮,2019-06-02 12:26:24,9,9,0,给一分是因为没有0分，从没见过这么厚颜无耻的老师
108791,2922,杨亮,2019-06-02 12:37:01,19,19,0,你每天刷一遍查老师评分的样子像cxk。这种老师为什么还没被挂上知乎呢？我浙学子何时如此忍辱负重了？
108848,2922,杨亮,2019-06-03 07:07:30,3,5,2,感觉就是，自以为很厉害，很有见识，懂的很透彻，实际上平平，虽然思修的给分对我来说够了，但公道来讲，这不是个好老师
109211,2922,杨亮,2019-06-12 03:04:48,3,3,0,超级啰嗦
109319,2922,杨亮,2019-06-13 05:49:45,8,11,3,你们总玩老师留的梗有意思吗（老师留）
109501,2922,杨亮,2019-06-16 04:42:13,2,2,0,一言难尽
109548,2922,杨亮,2019-06-17 02:28:40,14,15,1,上课有气无力，日常怼天怼地，给分全靠恶竞，三观渣到离奇，平心而论，很糟糕的老师了，不信的话可以亲自体验
109756,2922,杨亮,2019-06-19 04:55:46,5,5,0,老师很装，上课无聊，建议换老师
110846,2922,杨亮,2019-06-28 10:47:30,2,3,1,弟弟\n\n
111008,2922,杨亮,2019-06-29 05:49:55,35,36,1,声明一下，我是傻逼。(老师留)
115059,2922,杨亮,2019-07-15 03:02:38,8,8,0,过了一学期，看到他的评分越来越低，我就放心了，想当初看到8+的评分我还以为这是个不错的老师?
115609,2922,杨亮,2019-08-08 06:45:04,3,3,0,课讲的还行，但人真的不咋滴。考前说认真听课能打高分，考后又在群里说光听课不够。还说一大堆看似有道理的话，我们差点就信了
115871,2922,杨亮,2019-09-04 01:14:41,14,14,0,第一次知道何为自负
115891,2922,杨亮,2019-08-23 14:03:19,5,6,1,听说今年军训当指导员了？那开学估计有一大堆1分了?
115895,2922,杨亮,2019-08-24 04:28:22,2,2,0,？？？
115929,2922,杨亮,2019-08-26 13:21:35,13,13,0,老师这辈子怕不是受了刺激
115947,2922,杨亮,2019-08-26 13:50:29,-12,4,16,哎 虽然军训合唱表现不好 但杨老师开导我们 丝毫没有责怪我们 并且对分数的看法很淡 常常吊吊嗓子 讲讲笑话 喜欢！！！
115997,2922,杨亮,2019-08-28 14:58:53,6,6,0,呵呵呵
116002,2922,杨亮,2019-09-07 00:18:04,-1,6,7,还可以吧
116005,2922,杨亮,2019-08-29 04:52:28,-17,0,17,思想很深刻
116036,2922,杨亮,2019-09-07 01:11:55,6,7,1,好啦成功3.9\n\n合唱和队列都不是我想不参加的啊
116066,2922,杨亮,2019-09-02 06:23:56,7,7,0,辣鸡！
116146,2922,杨亮,2019-09-04 13:55:00,-17,2,19,好极了，军训评分不是他定的，各位绩点低的去找副指\n\n歌好，人好，认真负责
116185,2922,杨亮,2019-09-05 16:03:35,1,3,2,hhh
116219,2922,杨亮,2019-09-06 09:54:02,8,8,0,我佛了…这个打分，果然1分是有原因的，遇上他的人保重
116224,2922,杨亮,2019-09-06 10:34:14,17,17,0,本来想打10分，但是0不太好，就去掉了
116226,2922,杨亮,2019-09-06 10:32:16,7,8,1,军训给组内按排名给分的指导员就是屑
116235,2922,杨亮,2019-09-06 11:57:12,4,5,1,有点思想有点幽默不可否认，但是，自以为是、给分低这两点真的没话说。
116247,2922,杨亮,2019-09-06 14:01:42,4,4,0,军训卡绩老手，碰见了建议申请连部，普遍分高。鄙人全勤被卡3.3
116248,2922,杨亮,2019-09-06 14:05:12,5,5,0,卡绩难受得一逼，多给一分很难吗？
116264,2922,杨亮,2019-09-07 00:27:22,-17,3,20,杨亮军训给分确实比其他指导员低，但是均绩也没有前面显示的那么恐怖，我估计整个连的均绩能到4
116657,2922,杨亮,2019-09-12 11:32:58,-15,4,19,军训4.5怎么说呢，你要非常突出啦，不然真的不行，但人还是很好的，有点小可爱，内心还是有点孤独的
116677,2922,杨亮,2019-09-13 02:33:31,-16,0,16,觉得均绩也没有楼上说的那么低下，有些话虽然自以为是了点，但还是比较幽默，也有点道理
117095,2922,杨亮,2019-10-22 09:49:34,-21,7,28,原话摘过来，仁者见仁智者见智吧\n\n   你们是否知道微积分肯定有一定比例的挂科概率，而且肯定不是小概率事件。\n\n   你们是否知道明年的现在就要准备出国交流筛选面试申请了？而且很多人的英语都在滑坡中？。。\n\n   你们知不知道你们在社团里认识的妹子，其实只是别人的老婆。以你的实力只允许作为别人青春中的一段美好回忆，但不太值\n\n   你们是否了解未来的就业市场，对女生都不太友好，既不想加班，又想收入高些，且父母没有没有给予炫耀的面容及身材时，且想自食其力具备选择男友的权力的时候，读书是比减肥还容易的性价比最高的捷径？得托付？\n\n   一群愚蠢的小直男们哎，你们的思想成熟期总会比同龄女生晚些的，这是科学统计规律。但整天灌水不学习的债，迟早以另外的形式偿还。青春赠送的礼物，早已暗中标好了价格。
117340,2922,杨亮,2019-09-23 05:43:20,19,19,0,作为一个曾经是他同学的老师，很高兴乐见此人一而再、再而三的给母校教学设立下限指标。
117662,2922,杨亮,2019-10-03 12:15:59,4,4,0,无话可说
118154,2922,杨亮,2019-10-22 02:29:31,3,4,1,骂他就对了
118155,2922,杨亮,2019-10-22 02:32:29,8,8,0,欠我1000块奖学金呢
118162,2922,杨亮,2019-10-22 02:54:26,4,4,0,浙大最傻逼的老师，没有之一
118163,2922,杨亮,2019-10-22 02:55:59,3,3,0,如同听一个憨憨在上课
118164,2922,杨亮,2019-10-22 02:57:39,5,6,1,事真多，能多为学生考虑少做点政绩工程吗？
118166,2922,杨亮,2019-10-22 03:01:56,2,2,0,真的废物
118171,2922,杨亮,2019-10-22 03:23:46,4,4,0,希望老师做事能像说话那样“辩证求是”，不负自己心中的“少年”
118185,2922,杨亮,2019-10-22 08:48:58,4,4,0,B事贼多，整天整些没用的，都TM两个月了还在始业教育，不去还给你记小本本，恶心
119290,2922,杨亮,2019-11-12 03:03:02,1,1,0,渣渣亮
120207,2922,杨亮,2019-11-24 01:56:41,4,4,0,就是你举报了查老师？整天上课放查老师截图喷这喷那，从来不从自己身上找原因
120951,2922,杨亮,2020-01-19 01:25:43,4,4,0,据说会给自己刷分…
121255,2922,杨亮,2019-12-25 09:06:32,4,4,0,这里本来要填听你上课是什么体验，我寻思你也没上课，或者你把你上的东西叫课？我不知道填什么。
121590,2922,杨亮,2019-12-12 09:55:14,2,2,0,自己刷分很爽吗？
122247,2922,杨亮,2020-02-21 01:03:21,0,0,0,。。。
122301,2922,杨亮,2020-02-23 11:20:27,5,5,0,实话实话 感觉思维太古板了 而且但凡与他思想不同就会怼你，喷查老师评论也是这个道理，给自己刷分也是
122684,2922,杨亮,2020-03-18 13:49:05,2,2,0,特地前来考古 军训被坑惨
123866,2922,杨亮,2020-06-15 10:06:52,3,3,0,军训被坑惨
123872,2922,杨亮,2020-06-15 13:55:29,1,1,0,tuotang
124672,2922,杨亮,2020-07-05 23:27:59,8,8,0,钉钉时代创新创业选手。基本每次课结束都会有小作业，虽然看起来任务量不大，但是要花的时间其实也不少，都是一些需要高度浓缩总结的作业。上课水平低，而且有很明显的自负语气，与之前的评论描述完全符合。会叫同学连麦回答，但凡是与他想法不一样的回答，都会被指点（怼）一番。最后有一次商业计划书的大作业，作业量很大，组均页数20+吧，然后还要线上答辩，几个油腻中年人对着你稚嫩的商业计划书从头喷到尾，像极了网络喷子的风范，确实很多组都是初次接触商业计划书吧，但是也用到了你上课讲到的少的可怜的干货，难道就一点闪光点都没有吗？为什么我看不到一句鼓励学生的话呢？最后出成绩，呵呵，距离最终答辩结束一个半月之后，这人终于出成绩了，被绩杀了，但我都觉得麻木了。
124979,2922,杨亮,2020-07-30 04:11:22,0,0,0,hhh
125349,2922,杨亮,2020-09-07 09:15:33,6,6,0,伊丽莎白
128914,2922,杨亮,2020-12-26 17:22:04,2,2,0,垃圾！！！
129013,2922,杨亮,2020-12-28 11:31:57,0,0,0,emmm  我只想说  这位老师真的挺喜欢和同学怼的。
132197,2922,杨亮,2021-01-31 02:23:17,19,20,1,整个人就一傻逼，还tm有脸来自评？你tm脸要不要了
132381,2922,杨亮,2021-02-01 08:14:07,14,15,1,浙江大学是没人了吗？这种老师还配留在浙江大学？
132558,2922,杨亮,2021-02-02 08:51:22,19,19,0,不是，这个东西好在课上说自己教的好。要不是因为你还要给我们成绩，你不会真的以为我们会草草附和你吧。
132641,2922,杨亮,2021-02-03 09:39:03,4,4,0,～～。
132684,2922,杨亮,2021-02-03 09:53:44,-34,0,34,上了这个学期的思修课，单论课堂内容给9分，1分只扣在公认的上课节奏问题上，个人认为课上讲的内容很不错，如热评所说，思修学到的内容多少，还是取决于对待知识的态度。如果记下课上提及的内容，课后去了解，会有所收获。\n\n至于给分问题，目前看来没有其他评论所说那么不堪，但每个环节都很重要。调研可以去查找借鉴学习好的量表问卷；论文再三注意要求，提早准备不要最后赶；志愿者不要忘做；平时有空翻翻书，自己额外补充法律常识，大题多写点等等。。内容都不水，但不代表不能拿到还可以的成绩。
132799,2922,杨亮,2021-02-03 17:40:52,23,23,0,不知道哪来那么大脸夸自己，什么叫思修课上的好，看看隔壁梁清华，封丽萍，潘贤林，倒霉选上了这个班。
133506,2922,杨亮,2021-03-01 10:56:33,5,7,2,我上课水课，不一定具有很大发言权。\n\n首先，这个老师上课，emmm，天马行空，扯得老远巴远，感觉很高深，但是也不知道学了啥。总体，就一般般。\n\n其次，我尤其抨击他的小组活动报告评分加入组与组互评的分值。我就讲讲我们小组的经历。我们小组活动报告写了一万字，实打实每个人一点点敲出来的，PPT也很认真做了，虽然可能选题不是很好，但是绝对算不上特别差。然后最后有一个展示和打分。其他小组会有多少人看你写的？基本没有，展示只给六分钟，什么都来不及说，其他小组可能报告就几千个字，而且格式就不太规范，而我们真真确确按照论文格式写的，最后评分我们组最后一名，而第一名的组答辩PPT就是把他们的小组报告复制黏贴一下。那天我真的直接被气哭，真的就对不起我的组员，逼着他们那么认真地弄，结果最后还不如别人随便弄弄。好像老师是会看评论的，那么我希望老师可以仔细思考这样一种评分方式是否公平。\n\n至于给分的话，个人感觉当小组长比较重要。组员的分我没好意思问，但是我作业正常完成，期末考试考前一两天背背提纲，考试乱写，最后绩点4.2，参考吧。
140049,2922,杨亮,2021-08-24 06:33:38,2,2,0,左右左 不解释
140050,2922,杨亮,2021-08-30 12:52:28,14,14,0,喜欢阴阳怪气、上纲上线，恶心
140058,2922,杨亮,2021-09-07 13:53:41,16,16,0,杨亮哈麻批
140060,2922,杨亮,2021-08-24 10:41:36,6,6,0,这玩意儿就是傻逼不解释。
140068,2922,杨亮,2021-08-25 12:15:53,10,10,0,四十多岁还当辅导员不是没有理由的，好为人师，您以为您是谁啊？？？\n\n笑死了
140069,2922,杨亮,2021-08-24 14:19:45,0,1,1,不讲人性！
140071,2922,杨亮,2021-08-24 14:26:31,2,2,0,阴阳怪气……
140072,2922,杨亮,2021-08-24 14:33:45,2,2,0,老师非常过分
140073,2922,杨亮,2021-08-24 14:39:24,3,4,1,军训直接醉了，就他事情多
140083,2922,杨亮,2021-08-25 07:54:47,1,2,1,太烂了。
140085,2922,杨亮,2021-08-25 07:56:40,2,2,0,很失望
140086,2922,杨亮,2021-08-25 08:00:35,2,2,0,什么鬼
140087,2922,杨亮,2021-08-25 08:06:47,1,2,1,很有道理
140089,2922,杨亮,2021-08-25 09:16:12,2,2,0,不喜欢
140090,2922,杨亮,2021-08-25 09:16:12,2,2,0,好为人师
140091,2922,杨亮,2021-08-25 09:21:32,1,2,1,就是一个字 6
140092,2922,杨亮,2021-08-25 09:22:55,2,2,0,不太行
140093,2922,杨亮,2021-08-25 09:54:41,1,1,0,。。。
140094,2922,杨亮,2021-08-25 10:01:35,3,3,0,不行，
140097,2922,杨亮,2021-08-25 13:28:33,6,7,1,如果我面前坐着希特勒、杨亮、慈禧太后，而我有一把手枪两颗子弹，我会选择给杨两枪
140099,2922,杨亮,2021-08-25 13:55:18,3,3,0,不是我说 蛮搞笑的
140102,2922,杨亮,2021-08-25 15:57:40,2,2,0,好为人师
140107,2922,杨亮,2021-08-26 02:58:57,5,6,1,声名远扬
140108,2922,杨亮,2021-08-26 02:59:39,22,22,0,我高中同学让我来打，仅凭聊天记录可见一斑，臭名昭著
140112,2922,杨亮,2021-08-26 09:45:56,5,5,0,在他的管理下，不能说是政通人和，可以称得上是丧尽天良
140113,2922,杨亮,2021-08-26 10:07:13,21,21,0,如果我面前坐着杨亮和马里奥，我手里有一把枪，2发子弹，我会打死自己2次
140116,2922,杨亮,2021-08-26 13:31:11,7,8,1,连续讲半小时废话真的不累吗
140117,2922,杨亮,2021-08-26 13:50:40,8,8,0,伞兵，废话贼多，臭名昭著，被他当辅导员倒霉，听他讲话记着拿好尿壶
140118,2922,杨亮,2021-08-26 14:00:06,2,2,0,公交卡
140119,2922,杨亮,2021-08-26 14:12:19,9,9,0,废话贼多，上他讲座得带尿壶
140120,2922,杨亮,2021-08-26 14:39:09,0,1,1,雀氏不错
140121,2922,杨亮,2021-09-14 11:46:20,4,4,0,我没想到到了大学会有这种人
140124,2922,杨亮,2021-09-07 13:57:20,21,21,0,伊丽莎白
140126,2922,杨亮,2021-09-07 13:29:19,44,44,0,多少有点大病吧 5分钟的话说了43分11秒
140127,2922,杨亮,2021-08-27 11:17:50,4,4,0,爬爬爬
140128,2922,杨亮,2021-08-27 11:39:07,10,10,0,伞兵老师，自己唱歌音不准还教
140129,2922,杨亮,2021-09-10 05:15:52,21,21,0,真的有人很想听吗
140130,2922,杨亮,2021-08-27 13:21:59,4,4,0,杨老师负责的军训真是恶心到天际，不说啥了
140134,2922,杨亮,2021-08-28 10:40:27,-6,0,6,好厉害的老师🤔
140136,2922,杨亮,2021-08-28 13:38:00,-9,2,11,好老师 为什么分这么低
140137,2922,杨亮,2021-08-28 23:08:11,5,5,0,狠欲狂
140139,2922,杨亮,2021-08-28 15:18:25,3,3,0,控制系老师
140140,2922,杨亮,2021-08-28 23:40:55,-6,0,6,srds，很负责任是真的，废话连篇也是真的…每天回去得很晚，差点想打低分，看到查老师上他分又掉了还是收手了。且行且珍惜
140144,2922,杨亮,2021-08-29 11:36:44,2,2,0,NBNB
140147,2922,杨亮,2021-08-29 16:15:50,-15,3,18,我们思政辅导员。很多同学都对他抱有非议，觉得他墨迹，自以为是什么的。但是我觉得，老师是一个知识广（看他文章写的好），说话直，紧跟时代（什么流行语啊新闻啊都有了解），也比较懂学生，有自己理念的老师。虽然他说的不可能全对，但是还是比混子老师强很多的，至少杨老师还是有很多想法的。而这些教育等方面的理念，（从个人角度看）对于高中刚毕业的志得意满的我们大一学生来说，是比较犀利，严格的（这种意思），所以难免会冲突一些。要真的论他的想法理念好坏，我觉得我现在还不够，不过有这样的思想交流碰撞对我的成长以及适应大学还是有帮助的。再加上现在军训还没结束，出分（嘿嘿），我还是客观一些的~
140149,2922,杨亮,2021-09-07 13:47:27,12,12,0,最差的老师，没有之一
140156,2922,杨亮,2021-08-31 14:26:37,3,4,1,每天晚上求求不要长篇大论可以吗？\n\n真的没人想听，让我早点回去比什么都强
140158,2922,杨亮,2021-09-12 03:31:01,8,8,0,对他的容忍度每天在合格线附近徘徊
140160,2922,杨亮,2021-09-01 04:31:35,4,4,0,鼓励恶竞，给分主观偏激。
140162,2922,杨亮,2021-09-01 11:33:13,5,5,0,他妈的一边开空调一边开窗户是什么骚操作，这是人脑子想出来的事吗？\n\n杭州这天气你热死我好了，和伞兵一样\n\n大中午的不让吃饭在西区练合唱？每天晚上拖堂这么久？？？脑子被门挤了
140195,2922,杨亮,2021-09-04 10:13:23,4,4,0,。。。
140199,2922,杨亮,2021-09-04 13:10:47,6,6,0,sb没话说，人废话还多，自以为是，好为人师，刻板的歧视狗
140207,2922,杨亮,2021-09-05 02:39:15,5,6,1,🌶🐔一个
140208,2922,杨亮,2021-09-07 13:49:42,26,27,1,这辈子遇到最好的老师了，十分好评，分期付款
140222,2922,杨亮,2021-09-07 14:26:53,-15,2,17,好老师！
140226,2922,杨亮,2021-09-06 04:45:37,8,8,0,事儿逼
140236,2922,杨亮,2021-09-06 11:01:00,8,8,0,就这？
140239,2922,杨亮,2021-09-07 13:28:17,15,15,0,亮狗真的恶心
140242,2922,杨亮,2021-09-06 14:35:09,12,15,3,不多说了，有一点自负，觉得自己有经验。天天讲美国，讲以色列，关心国家大事。有很明显的集体主义思想，甚至过头，而他自己也知道。对学生态度不怎么好。我说严格归严格，但是确实也该给学生态度。不过，对工作很关心，也确实比较有经验，这可能是他为数不多的优点。
140243,2922,杨亮,2021-09-06 14:50:58,6,6,0,大晚上跑来看评论，忍不住留名\n\n军训晚上会讲奇怪的话、拖长长的堂……\n\n竟然还会指导军训队列怎么走，真是多才多艺(狗头\n\n只能说每个人都是独特的、有自己想法的吧……可惜我们三观好像不太合\n\n没打一分，祈祷绩点不要太炸
140252,2922,杨亮,2021-09-07 03:20:59,12,12,0,垃圾狗
140260,2922,杨亮,2021-09-07 13:44:54,72,72,0,生活寡淡无味，牛马指点人类
140261,2922,杨亮,2021-09-07 13:45:13,15,15,0,很难更sb，真是倒了八辈子霉碰上这么个玩意，除了会显摆自己和挑动班级内部矛盾以外一无是处
140262,2922,杨亮,2021-09-07 13:46:36,26,26,0,太脑瘫了，什么sb互评
140263,2922,杨亮,2021-09-07 13:46:00,6,6,0,。。。。。。
140264,2922,杨亮,2021-09-07 13:47:40,12,12,0,伊丽莎白
140265,2922,杨亮,2021-09-07 13:47:52,7,7,0,茫茫人海，风吹草低现牛马
140266,2922,杨亮,2021-09-07 13:47:56,10,10,0,伊丽莎白
140267,2922,杨亮,2021-09-07 13:48:08,3,3,0,不太行
140268,2922,杨亮,2021-09-07 13:48:12,4,4,0,不能接受
140269,2922,杨亮,2021-09-07 16:12:32,17,20,3,很好的一个老师 👨‍🏫 \n\n真的\n\n如果我说假话我一夜暴富
140270,2922,杨亮,2021-09-07 14:15:38,12,14,2,杨亮老师🤤🤤🤤杨亮老师🤤🤤🤤嘿嘿🤤🤤🤤我的杨亮老师 嘿嘿🤤🤤🤤杨亮老师🤤🤤🤤嘿嘿🤤🤤🤤我的杨亮老师 嘿嘿🤤🤤🤤杨亮老师🤤🤤🤤嘿嘿🤤🤤🤤我的杨亮老师 🤤🤤🤤\n\n杨亮老师你在看吗，在看的话就。。。就。。。就。。。嘿嘿🤤🤤🤤杨亮老师🤤🤤🤤🤤\n\n欸？怎么会是😱我怎么了😰我不能。。。嘿嘿。。。杨亮老师🤤🤤🤤杨亮老师🤤🤤🤤🤤🤤​
140271,2922,杨亮,2021-09-07 13:48:28,6,6,0,伊丽莎白
140272,2922,杨亮,2021-09-07 13:48:38,4,4,0,命不久矣
140273,2922,杨亮,2021-09-07 13:50:05,7,7,0,他曾经尝试“劝导”同学们要理性评论老师，不过个人觉得他破防了。\n\n伊丽莎白！
140274,2922,杨亮,2021-09-07 13:59:53,2,4,2,同学们不喜欢，非常不喜欢
140275,2922,杨亮,2021-09-07 13:50:37,17,17,0,军训拖课王，天天军训吃鸡（最后一个走）。\n\n还每天强调啥都和绩点无关，自相矛盾，长篇大论，屁话成吨，指点江山。
140276,2922,杨亮,2021-09-07 13:51:29,5,5,0,反省一下自己吧，找找自己的问题
140277,2922,杨亮,2021-09-07 13:54:16,1,1,0,sb一个
140278,2922,杨亮,2021-09-07 13:55:22,1,1,0,伊丽莎白
140279,2922,杨亮,2021-09-07 13:56:15,1,1,0,唉 一言难尽好吧
140280,2922,杨亮,2021-09-07 14:12:57,7,8,1,杨亮老师🤤🤤🤤杨亮老师🤤🤤🤤杨亮老师🤤🤤🤤我的杨亮老师 嘿嘿🤤🤤🤤杨亮老师🤤🤤🤤杨亮老师🤤🤤🤤我的杨亮老师 嘿嘿🤤🤤🤤杨亮老师🤤🤤🤤嘿嘿🤤🤤🤤我的然杨亮老师🤤🤤🤤\n\n杨亮老师你在看吗，在看的话就。。。就。。。就。。。嘿嘿🤤🤤🤤杨亮老师🤤🤤🤤🤤\n\n欸？怎么会是😱我怎么了😰我不能。。。嘿嘿。。。杨亮老师🤤🤤🤤杨亮老师🤤🤤🤤🤤🤤​
140281,2922,杨亮,2021-09-07 13:57:21,1,1,0,因果报应啊，懂得都懂
140282,2922,杨亮,2021-09-07 14:20:07,4,4,0,看到大家都骂他，我就放心了
140283,2922,杨亮,2021-09-07 13:59:20,6,6,0,亚硫酸钡
140284,2922,杨亮,2021-09-07 14:00:35,5,5,0,自己评分为什么低心里没点数吗，把这个当ppt去课堂上解释？可真是那个啊
140285,2922,杨亮,2021-09-07 14:01:56,6,6,0,离谱至极 官僚主义和形式主义作风严重 zjuer苦不堪言
140286,2922,杨亮,2021-09-07 14:02:52,26,26,0,楊 喨 ， 鉨 j ι υ 惿 個 寄 δ 巴 ！ \n\n楊 湸 ， 尓 勼 寔 個 寄 妑 ！ \n\nγ á η ɡ 亮 ， γ o υ 就 四 個 寄 紦 ！ \n\n楊 亮 ， 伱 噈 寔 箇 寄 o 巴 ！
140287,2922,杨亮,2021-09-07 14:04:08,1,1,0,脑瘫老师一个
140288,2922,杨亮,2021-09-07 14:04:36,5,5,0,小荷才露尖尖角，越是牛马越是屌
140289,2922,杨亮,2021-09-07 14:06:36,8,10,2,亮亮🤤嘿嘿🤤我的亮亮🤤嘿嘿🤤我的亮亮🤤嘿嘿🤤你们不准骂他😭👊😭你知道他有多努力吗👊😭你们不准骂他👊😭你们不准骂他👊😭你们不准骂他👊😭你们不准骂他
140290,2922,杨亮,2021-09-07 14:07:32,1,1,0,…..
140291,2922,杨亮,2021-09-07 14:15:42,1,1,0,爪巴。
140292,2922,杨亮,2021-09-07 14:20:36,0,0,0,大伞兵
140293,2922,杨亮,2021-09-07 14:24:37,-1,0,1,加油哦，继续努力
140294,2922,杨亮,2021-09-07 14:23:48,1,1,0,伊丽莎白
140295,2922,杨亮,2021-09-07 14:30:25,1,1,0,呵呵呵
140296,2922,杨亮,2021-09-07 14:31:26,7,7,0,很烂的老师，防止以后误人子弟，这个评分很中肯，有零就给零了，欺负我一个新生，真受不了，本来就背井离乡的上大学，到这还被剥削，有辱学校名声
140297,2922,杨亮,2021-09-07 14:34:26,1,2,1,他搞事情
140298,2922,杨亮,2021-09-07 14:39:21,7,7,0,给的绩点低，整天还让大家搞恶性竞争，让团队没有凝聚力，很不喜欢这样的老师，没有从正面积极引导大家，作为一名做思想工作的辅导员很让人失望。
140300,2922,杨亮,2021-09-07 14:49:11,1,1,0,不咋地
140301,2922,杨亮,2021-09-07 14:52:40,3,3,0,。。。
140302,2922,杨亮,2021-09-07 15:01:13,4,4,0,你好像有那个大🧊​
140303,2922,杨亮,2021-09-07 15:02:09,-1,0,1,无话可说！
140304,2922,杨亮,2021-09-07 15:08:02,16,22,6,要守规矩，踏实勤勉，话可以说但不能多，也不要吞吞吐吐，否则除了军训，以后还会有挫折，比如说40多岁还是个辅导员，日子可能不会太顺。。。要大气，要正气，阳光健康。.。（老师留）
140305,2922,杨亮,2021-09-07 15:18:37,1,1,0,就nm离谱
140306,2922,杨亮,2021-09-07 16:53:26,2,3,1,好老师，可惜是浙大的老师
140310,2922,杨亮,2021-09-08 05:06:33,12,12,0,互评真恶心
140313,2922,杨亮,2021-09-08 09:38:08,5,5,0,伊丽莎白
140314,2922,杨亮,2021-09-08 09:42:00,4,4,0,伊丽莎白
140315,2922,杨亮,2021-09-08 09:43:14,1,2,1,呵呵呵
140319,2922,杨亮,2021-09-10 01:57:20,25,25,0,伊丽莎白在游乐设备上因为亚硫酸钡中毒被送进医疗设备
140321,2922,杨亮,2021-09-08 16:02:17,6,7,1,离校居然要他审批，第一次听说
140322,2922,杨亮,2021-09-18 07:05:15,8,8,0,伊丽莎白
140323,2922,杨亮,2021-09-09 01:37:59,-26,4,30,好老师，三观巨正
140328,2922,杨亮,2021-09-09 04:24:21,2,2,0,rnm
140333,2922,杨亮,2021-09-10 05:47:58,4,4,0,三个字
140334,2922,杨亮,2021-10-23 03:25:43,-10,8,18,按照自己内心想法去评论的话，其实挺好的，不要跟风，新生们
140335,2922,杨亮,2021-09-09 11:54:02,5,5,0,恶性竞争
140337,2922,杨亮,2021-09-09 14:44:17,3,3,0,。。。
140343,2922,杨亮,2021-09-10 01:46:14,30,31,1,杨亮老师你好，我是浙江省精神病医院主任，我院领导通过对你们的课堂与学生多方了解后，对你们的病情相当重视，并要求我与你们尽快取得联系，精神障碍指的是大脑功能活动发生紊乱，导致认知、情感、行为和意志等精神活动不同程度障碍的总称。表现为妄想、幻觉、错觉、情绪障碍、哭笑无常、自言自语、行为怪异、意志减退，只要你们积极配合我院治疗是有可能完全治愈的，最后希望你们树立信心战胜病魔，祝你们早日康复!
140360,2922,杨亮,2021-09-10 04:50:26,0,1,1,qnmmmh
140361,2922,杨亮,2021-09-10 04:55:25,0,0,0,淦。淦。淦。
140365,2922,杨亮,2021-09-10 05:42:01,0,0,0,三个字
140367,2922,杨亮,2021-09-10 05:50:35,7,7,0,给了我78分。是我不配啊。
140368,2922,杨亮,2022-01-25 06:49:26,29,32,3,感谢杨亮老师给新生上的第一课：即使是浙大，也有很多老师跟傻逼一样
140370,2922,杨亮,2021-09-10 06:20:01,2,2,0,伊丽莎白
140371,2922,杨亮,2021-09-10 06:35:02,-4,3,7,给分其实很公正 我低我也认了
140409,2922,杨亮,2021-09-10 23:24:26,2,2,0,伊丽莎白
140449,2922,杨亮,2021-09-12 04:57:28,-11,1,12,其实老师也不是不好。。。就是说话奇怪了一点。。。给分还是按算法来的。。。要正态是没办法的，据说本来80分以下人数不到，不得不把几个人降下去。。。还是怪自己活干少了吧（捂脸
140450,2922,杨亮,2021-09-12 04:07:22,-10,1,11,其实老师也不是不好。。。就是说话奇怪了一点。。。给分还是按算法来的。。。要正态是没办法的，据说本来80分以下人数不到，不得不把几个人降下去。。。还是怪自己活干少了吧（捂脸
140463,2922,杨亮,2021-09-24 06:43:53,9,9,0,确实有好为人师的毛病，作为文职人员喜欢插手教官的事务。在我看来，拿过教官的话筒当着教官的面指导学生动作非常欠妥。有很多自己的想法，有些干扰教官教学。说话有些时候阴阳怪气，会有一些高高在上所谓对新生的指点评论，但总得看来只是有些缺点的普通老师，一个要看领导脸色的中年老师。你要说他坏透了，到也不是，就像总会遇到的比较讨厌的老师。大部分时间板着张脸会有些严厉的样子。积极参加各项活动，每个都不落下绩点不会很差，但通讯稿评定等级在评分中占了很大的比例，文采不好会很难受。评分也是几位副连副指一起参与的，你参加的项目比较少，通讯稿等级好绩点也不会差。写不好文章就努力参加各项活动。
140466,2922,杨亮,2021-09-12 14:58:24,11,12,1,人嘴碎，偶有幽默，但是多数是以讽刺人的形式。\n\n事多，不太讲道理。\n\n很自大，但其实挺沙白的，能扯能吹。\n\n啥事都要掺和，唱歌上不去硬唱，正步踢不好还非得示范。\n\n军训就硬讲国际形势大拖堂，比别的连晚回寝室半小时。\n\n还有憨批的互评活动，无聊至极。\n\n最主要的还是分数瞎给，除非你做了那些只有极少数人参加的活动，不然得分会很低。军训期间活一个没少干，和一些同学比他干的我也干了，我还多点职务，但就是分更低。\n\n总而言之，伊丽莎白。
140608,2922,杨亮,2021-09-14 08:58:44,1,1,0,牛马老师
140725,2922,杨亮,2021-09-15 10:59:09,1,1,0,牛子。
140751,2922,杨亮,2021-09-15 16:12:10,1,3,2,新婚快乐
140811,2922,杨亮,2021-09-16 09:43:44,0,0,0,傻逼一个
140896,2922,杨亮,2021-09-17 10:46:30,1,1,0,叶绿素b
140897,2922,杨亮,2021-09-17 11:07:42,5,6,1,没有很好的才艺就得评低分吗？
140979,2922,杨亮,2021-09-19 04:33:58,1,1,0,臭  傻  逼
140980,2922,杨亮,2021-09-19 04:33:42,0,1,1,臭  傻  逼
140981,2922,杨亮,2021-09-19 04:55:29,1,1,0,叶良树👃
140982,2922,杨亮,2021-09-19 05:00:18,3,3,0,叶绿素b
140983,2922,杨亮,2021-09-19 05:05:58,-2,0,2,负责…
140986,2922,杨亮,2021-09-19 09:15:28,0,0,0,臭煞笔
141021,2922,杨亮,2021-09-22 00:37:09,1,2,1,集体主义，小事喜欢上纲上线，反正我不喜欢
141070,2922,杨亮,2021-09-22 16:26:36,5,5,0,教的什么课，枉为人师表，4分多实在是便宜您咯 您是什么_____ 脏话省略因为我还不愿意像您一样将低质量低智商发言外露：）
141139,2922,杨亮,2021-09-24 08:54:19,1,2,1,伊丽莎白
141140,2922,杨亮,2021-09-24 09:58:27,0,2,2,伊丽莎白！qnmd
141233,2922,杨亮,2021-09-27 03:42:08,12,13,1,军训给分完全就无脑，没缺过一次训练，给个3.3
141253,2922,杨亮,2021-09-27 13:28:29,6,6,0,伊丽莎白，医疗设备，游乐设备亚硫酸钡英联赛杯
141255,2922,杨亮,2021-09-27 13:48:34,2,2,0,无话可说
141332,2922,杨亮,2021-09-30 01:29:19,8,8,0,事多脑子还有病
141385,2922,杨亮,2021-10-05 04:11:36,4,4,0,。。。
141507,2922,杨亮,2021-10-12 13:14:43,6,6,0,伊丽莎白
141589,2922,杨亮,2021-10-16 04:15:58,-14,5,19,亮亮新婚快乐！
141728,2922,杨亮,2021-10-23 03:26:30,-11,2,13,挺好的，我感觉
141899,2922,杨亮,2021-10-30 16:00:53,12,15,3,打卡率低于75%直接把你蓝码关了，就离谱
141902,2922,杨亮,2021-10-31 03:55:13,6,8,2,你妈啥时候没啊
142186,2922,杨亮,2021-11-08 10:36:28,6,7,1,跟放屁一样，自以为是的蠢货
142324,2922,杨亮,2021-11-10 07:23:28,13,15,2,室友是班团干，经常开会，开长~会、、好惨。感觉是事情最多的辅导员（之一）……军训和平时事情都不是一般的多，军训期间每天比别的团晚好久才回寝室，累死累活什么事情都参加了还要被绩杀……不排斥他好为人师，可以多讲点干货最好，只是说话的语气神态什么的实在喜欢不起来
142596,2922,杨亮,2021-11-14 05:07:56,8,9,1,😅他妈的阴阳怪气是吧 傻逼
142646,2922,杨亮,2021-11-15 01:55:16,5,6,1,伊丽莎白医疗设备游乐设备
142763,2922,杨亮,2021-11-16 03:20:03,5,6,1,sb。
143167,2922,杨亮,2021-11-20 11:26:06,5,6,1,伊丽莎白
143232,2922,杨亮,2021-11-22 02:04:55,9,10,1,自以为是的sb
143321,2922,杨亮,2021-11-23 09:32:02,-10,5,15,真的好
143331,2922,杨亮,2021-11-23 11:46:27,-24,7,31,我觉得挺好的，刷ylsb的都是啥成分 奋青吗？杨亮老师三观很正，很有君子风度
143341,2922,杨亮,2021-11-23 16:38:27,13,15,2,楼下那两位要么是yl自评，要么是舔狗抖m，总之伊丽莎白
143640,2922,杨亮,2021-11-29 16:16:23,5,5,0,无语子
143699,2922,杨亮,2021-12-02 03:39:44,-2,6,8,挺好的。。
143803,2922,杨亮,2021-12-07 07:19:00,-9,9,18,人言可畏，而评判随心。自己体验，勿随波逐流。
143815,2922,杨亮,2021-12-07 11:14:21,-13,9,22,单论辅导员一职，老师做的挺好，挺负责的。切勿随波逐流。
143842,2922,杨亮,2021-12-08 08:30:47,7,8,1,自以为是
144064,2922,杨亮,2021-12-17 07:34:38,4,5,1,呵呵打卡打卡
144443,2922,杨亮,2021-12-21 13:38:06,12,12,0,你觉得我不配，我觉得你不配
144737,2922,杨亮,2021-12-23 11:12:07,4,5,1,垃圾..
144819,2922,杨亮,2021-12-24 15:50:33,6,7,1,垃圾中的垃圾
144945,2922,杨亮,2021-12-26 04:22:12,5,6,1,很牛马
145132,2922,杨亮,2021-12-27 15:04:14,-7,4,11,好老师，不多说
145412,2922,杨亮,2021-12-29 12:33:09,6,7,1,伊朗扇贝
145545,2922,杨亮,2021-12-30 08:08:34,5,5,0,恨之入骨
145618,2922,杨亮,2021-12-30 16:32:48,0,4,4,帮我的室友发的：杨亮......🤤🤤嘿嘿.......🤤🤤杨亮......嘿嘿🤤🤤
145700,2922,杨亮,2021-12-31 09:37:52,2,2,0,…。…。
145732,2922,杨亮,2022-01-01 05:44:38,-40,7,47,看了杨亮老师的新年寄语，感受颇深。 虽然老师不是完美的，但老师的分真的不至于这么低，当大家都无脑的在这里进行人身攻击的时候，我觉得这个评分已经没有意义了。杨亮老师是一个非常善于思考与总结的辅导员，具有丰富的经验。如果有不了解老师的可以看看他的公众号，了解一下他的思考。以及希望那些沉默的大多数，不要跟风，发一些从内心出发客观的声音。
145735,2922,杨亮,2022-01-01 06:36:17,19,20,1,1.极度的自命不凡，旁人看了可笑，他却浑然不觉\n\n2.没事找事，随心所欲定标准，做事有失公允\n\n3.说话阴阳怪气，喜欢讽刺别人\n\nnmsl\n\nnmsl\n\nnmsl
146073,2922,杨亮,2022-01-05 11:08:26,1,3,2,最底下一条是老师发的嘛Σ(っ °Д °;)っ
146508,2922,杨亮,2022-01-06 18:14:20,6,7,1,伊丽莎白
146537,2922,杨亮,2022-01-07 01:32:06,7,8,1,shit.  you know?
146634,2922,杨亮,2022-01-07 06:34:30,20,21,1,希望您能明白，所谓道德律令，是用来约束自己的，不是用来压榨他人的。每个人都有自己的价值观念，希望您能尊重。\n\n修人先修己，您的评分低肯定不单是因为给分差，希望您能好好反思。
146638,2922,杨亮,2022-01-07 06:29:58,6,7,1,辣鸡。
147010,2922,杨亮,2022-01-08 12:03:11,6,6,0,渣🀄️ 纯纱布
147011,2922,杨亮,2022-01-08 12:05:25,11,11,0,大学是权威主义压制地还是独立精神的培育所？
147012,2922,杨亮,2022-01-08 12:11:21,11,12,1,也许他更适合去当一个批判家 而不是去当一个辅导员 更不配去成为学校领导 \n\n（我倒是希望他成为大领导 这样就不会来管学生的烂账）
147187,2922,杨亮,2022-01-09 04:33:29,9,11,2,。。。。。。
147532,2922,杨亮,2022-01-10 07:25:24,24,24,0,杨老师这个人，有一个特点是总喜欢摆出一副高高在上的姿态，似乎辅导员对学生只有权利，批判指责，阴阳怪气的攻击权，以及利用学生来彰显自己“学识”的权利。\n\n总让人有一种臆想：突发情况，钉钉上第一句不是关怀而是“你怎么敢三天不打卡，写个检讨给我”。虽然这可能与老师的出发点不同，但是老师的言行所传达给学生的形象就是这样的。\n\n再加之此人喜欢阴阳怪气，我认为老师的情商方面是极为缺失的，很难想象堂堂所谓top3学校的辅导员，能够做出当着一百多人的面揶揄某个或某几个同学的举动，希望老师今后能够放下自己的架子，好好做辅导员，否则就风评变化来看，今后的日子不会太顺。。。。。\n\n当然就约谈时您对我个人的否定以及军训时的一些不愉快，这些属于个人问题，就不必谈了。
148419,2922,杨亮,2022-01-12 11:52:31,-16,5,21,其实杨亮还好吧。。。除了发消息老是用句号阴阳怪气。。。求是园里的寂静之声 这个公众号里的文章真的对我挺有启发的。军训期间，就是太太太啰嗦了。。。
148691,2922,杨亮,2022-01-13 08:31:08,10,12,2,突然发现 在很久之前yl的查老师评价居然全是好评哎
148900,2922,杨亮,2022-01-14 02:20:20,5,6,1,还不出分吗。。。
149246,2922,杨亮,2022-01-15 01:13:07,-12,2,14,讲一下我作为小组长的感受：刚开始我们分组是要组长自己去找组员，工程浩大，我一度因为厘不清老师关于组员的要求快急哭了；作为小组长，组内调研分工很重要，最好参考一下其他组是怎么分的，不然有可能会一个人扛下巨锅；每节课的发言一般是组长总结或者想发言的同学来发言，老师不会给太多评价（关于这一点总是让人不知道讲得对不对(･_･;\n\n顺便提一下，可能因为组长的活比较多一点，所以最后给分会好一点。但我们班整体平均分也不低，要不要去拼这个组长，还是看自己意愿
149256,2922,杨亮,2022-01-15 01:30:50,-30,2,32,上课划水绩点还挺高\n\n高中学的政治还是很有用的\n\n我好爱yl老师
149264,2922,杨亮,2022-01-15 02:01:06,21,21,0,医疗设备
149283,2922,杨亮,2022-01-15 03:37:30,22,22,0,呵呵了，这绩点。上课就废话呗，假大空地宣传自己的观念：我们凭什么有资格很快买上房子......
149344,2922,杨亮,2022-01-15 06:40:32,-16,1,17,中肯的评价，还好的
149607,2922,杨亮,2022-01-16 07:43:31,13,14,1,杨亮老师，您真的好棒棒哟！😋😅😇😄😇😇😅😅
149611,2922,杨亮,2022-01-16 07:56:26,22,23,1,军训分不能给这么低啊，现在想来还生气
149625,2922,杨亮,2022-01-16 09:00:14,30,31,1,寒假作业完成情况清单还要公示😓我高中班主任都不这样，我身边其他学园的同学的辅导员也没有这样。不过，这种高效的方式总是符合我们对杨指导的预期呢🤗🤗想摸鱼的同学，只能怪你们觉悟不高喽🤗🤗\n\n  一轮分流时装死耽误别人选专业，偏偏爱在没人在乎的鸡毛蒜皮上生事🤗🤗🤗🤗\n\n  之前的评论被删掉了呜呜呜，我知道小仙女喜欢的是猫，可是我是一只老鼠，只要能恶心到小仙女，我也死而无憾了🤗🤗🤗
149648,2922,杨亮,2022-01-17 06:32:17,36,37,1,军训是当着所有人的面嘲讽一个背包的男生很娘......这种爱指点别人的人是谁给你的自信😥😓
149815,2922,杨亮,2022-01-17 06:34:43,32,32,0,军训时当着所有人的面嘲讽一个背包的男生很娘......\n\n你咋不照照你自个儿
150276,2922,杨亮,2022-01-21 08:47:16,8,8,0,伊丽莎白
150298,2922,杨亮,2022-01-22 00:23:06,-23,0,23,没有想得那么不堪，最后给分也还算行，就是会否定学生。
150489,2922,杨亮,2022-01-26 15:21:50,23,23,0,一位自恋的老师，只关注自己的观点是不是被接受，显得不尊重他人。一位故作高深的老师，其实并不能真正聚焦问题跟人讨论明白，而是换一套虚无缥缈的概念来掩盖问题本身，以显得自己有深度会思考。好为人师，故作高深，居高临下，是不错的形容词。
150633,2922,杨亮,2022-02-06 08:56:00,40,40,0,哟，被两次骂上十大还破防了？还不准把你说的话发到朵朵98，你怕什么呢？不想想为什么这么多的学生这么多的辅导员只有你一个被骂，反而还写什么牛马的小作文？我看您真是傻逼他妈给傻逼开门，傻逼到家了。
150747,2922,杨亮,2022-02-16 16:00:36,23,24,1,真就学生都当个屁呗，一个返校通知自己搞不清楚朝令夕改的有意思吗，还信誓旦旦的说对每一句话负责，最后就是一个层层加加加码，和所有通知都不一样，机票改签三次。不多说，还就是那个伊丽莎白。
150749,2922,杨亮,2022-02-16 16:12:04,13,13,0,伊丽莎白，在他的管理下卷的厉害，固然对成绩有正面影响，但是营造内卷环境就是他的全部功用了。
151081,2922,杨亮,2022-02-23 01:01:59,4,4,0,。。。
151138,2922,杨亮,2022-02-23 10:19:47,5,5,0,ylsb
151321,2922,杨亮,2022-02-28 11:31:57,3,3,0,真的呆瓜这个人
151354,2922,杨亮,2022-03-01 06:37:48,4,4,0,哈哈哈
151480,2922,杨亮,2022-03-04 08:52:49,8,8,0,😅😅😅
151554,2922,杨亮,2022-03-07 11:05:07,10,10,0,怎么还有二点几的
151964,2922,杨亮,2022-03-22 03:13:08,17,17,0,祝早日收敛为1
151989,2922,杨亮,2022-03-22 13:09:56,16,16,0,就你TM 的SB  想改造自行车库为活动室吗？  怎么不把自己的车改造成机器人啊？脑瘫
152036,2922,杨亮,2022-04-08 10:44:39,9,9,0,唱歌水平一言难尽
152333,2922,杨亮,2022-04-04 12:55:17,8,9,1,爱死你了，特地开了个虚拟机来评一分
152358,2922,杨亮,2022-04-06 11:44:41,14,14,0,🐗的检讨收到了吗
152361,2922,杨亮,2022-04-06 15:01:37,11,11,0,你是什么纯种的sand B，什么时候去世呢
152403,2922,杨亮,2022-04-08 10:06:46,21,21,0,如果球员是gay需要调到女队吗😅
152411,2922,杨亮,2022-04-09 09:21:59,8,9,1,😅😅😅
152422,2922,杨亮,2022-04-10 14:58:24,11,11,0,ylsb
153312,2922,杨亮,2022-04-28 01:55:47,10,10,0,伊丽莎白，辅导员中的垃圾中的垃圾，总是摆着一副高高在上洞悉一切的态度，选上他的课真的是倒了大霉
153356,2922,杨亮,2022-04-28 10:42:49,6,6,0,。。。
153381,2922,杨亮,2022-04-29 00:59:51,9,9,0,已有的评论说了很多，我就不多说了
153459,2922,杨亮,2022-04-30 11:08:02,18,18,0,发一大堆废话把有用信息顶掉了\n\n刚学会的一个新词：赤佬，形容你很合适\n\n两位上单的话放你身上太合适了
153501,2922,杨亮,2022-05-02 09:23:10,13,13,0,这离校报备咋比你还sand B啊？！
153508,2922,杨亮,2022-05-03 02:03:55,-16,2,18,杨老师的思修课讲的蛮好的，给分也不错呀
153518,2922,杨亮,2022-05-03 10:49:53,12,12,0,早日到1
153668,2922,杨亮,2022-05-07 11:09:28,12,12,0,伊丽莎白
153736,2922,杨亮,2022-05-10 01:02:46,-35,3,38,9分吧\n\n作为一个挑老师眼光蛮苛刻的人\n\n我觉得杨亮老师总体来讲\n\n就创新创业课程来说\n\n至少是不错的\n\n因为创业类课程本来就比较虚\n\n我觉得也讲不出什么干货\n\n\n\n他对学生还是蛮宽容友好的\n\n虽然我最后得分不是那么好\n\n\n\n但是我觉得他值得8-9分的评价\n\n这评分给低了
153747,2922,杨亮,2022-05-10 04:24:48,-27,3,30,好老师，学弟学妹们快冲
153865,2922,杨亮,2022-05-14 01:17:10,14,14,0,他有一种很特殊的能力\n\n让人本能的感到讨厌\n\n说话真的是一门艺术
153947,2922,杨亮,2022-05-17 15:07:52,9,9,0,伊丽莎白😅 差不多得了
153962,2922,杨亮,2022-05-18 05:35:15,18,18,0,装什么高尚呢😅
153966,2922,杨亮,2022-05-18 06:50:00,14,14,0,不老实
153970,2922,杨亮,2022-05-18 07:43:23,33,33,0,亮啊，爹爹还是要告诫你，不会说话就少说点，这这这又给骂上十大了，为父脸上无光啊
153972,2922,杨亮,2022-05-18 08:31:33,18,19,1,只有一个就是少数人试图用科学和公正的外壳掩饰以自我中心的利益态度
153973,2922,杨亮,2022-05-18 08:31:13,17,17,0,只有一个就是少数人试图用科学和公正的外壳掩饰以自我中心的利益态度
153975,2922,杨亮,2022-05-18 09:39:11,22,22,0,亚硫酸钡（老师留）
153985,2922,杨亮,2022-05-18 12:24:25,29,29,0,我宣布yl凭借全局最优解与局部最优解的新理论当选为中国工程院院士（逃
153987,2922,杨亮,2022-05-18 12:29:51,23,23,0,“认为做核酸打卡是浪费时间的这种人，大家少和他接触”
153990,2922,杨亮,2022-05-18 13:24:23,14,15,1,fudiaoyuan
153997,2922,杨亮,2022-05-18 15:29:19,14,14,0,被骂上98十大力😅
153999,2922,杨亮,2022-05-18 15:50:03,21,21,0,这下云峰之光了捏🤗🤗🤗🤗
154000,2922,杨亮,2022-05-18 15:52:09,14,14,0,杨氏最优控制原理😅
154001,2922,杨亮,2022-05-18 16:27:51,14,14,0,我自98而来，只为一睹奇妙
154005,2922,杨亮,2022-05-19 01:44:27,44,44,0,别他妈了隔壁\n\n搞你那孤立\n\n伊丽莎白\n\n能不能做个人啊\n\n赤佬
154063,2922,杨亮,2022-05-31 09:08:23,29,29,0,脱离群众太远\n\n浙大远离哥\n\n自以为是\n\n好为人师出洋相\n\n杨亮
154226,2922,杨亮,2022-05-26 11:41:35,6,6,0,不太想解释
154329,2922,杨亮,2022-05-30 10:00:50,15,15,0,叶绿素b
154349,2922,杨亮,2022-05-30 16:17:57,8,8,0,园林设备不解释
154661,2922,杨亮,2022-06-03 03:37:21,7,10,3,没上过杨亮老师的课和没来浙大上学一样。10分不解释【doge】
154783,2922,杨亮,2022-06-05 08:57:46,8,8,0,98观光
154997,2922,杨亮,2022-06-07 09:19:35,7,7,0,马上远离他了来个一分
155159,2922,杨亮,2022-06-09 02:39:48,17,17,0,饮料，柠檬什么时候酸啊？\n\n叔叔都要自愧不如
155848,2922,杨亮,2022-06-16 09:39:35,15,15,0,祝杨指导早日收敛
156070,2922,杨亮,2022-06-17 10:23:46,9,9,0,一天到晚在十大看见他
156924,2922,杨亮,2022-06-21 10:42:28,11,11,0,终于要摆脱伊丽莎白的魔爪了，特地过来打个1分庆祝一下。
157228,2922,杨亮,2022-06-22 12:30:08,11,12,1,这个老师是一个自以为是的sb罢了（老师留）
157398,2922,杨亮,2022-06-23 06:26:46,9,10,1,雅力士悲
157417,2922,杨亮,2022-06-23 07:25:06,8,9,1,终于要摆脱这个叼叼了\n\n一年下来仍然用军训保持着我的最低绩点（没有之一）
157509,2922,杨亮,2022-06-23 13:25:54,16,16,0,伊丽莎白今日金句：\n\n“整天叽叽哇哇动辄渴求自由意志的如果未来面对现实的生活，恐怕反而不会有太多的自由选择的余地。”🤗
158450,2922,杨亮,2022-06-29 10:30:20,41,41,0,给分厚道徐小洲 制度合理林建华\n\n尊重学生孙大雁 亲切友善祝秀香 \n\n从不绩杀陈昆福 分多事少陈素珊 \n\n知识广博看沈燎 讲话生动吴朝晖 \n\n声音洪亮陶虹向 人生导师是杨亮
158759,2922,杨亮,2022-07-02 02:03:34,9,10,1,就是个傻逼，新生碰到这个傻逼自求多福吧
159416,2922,杨亮,2022-07-18 07:34:23,8,9,1,你就是歌姬吧
159418,2922,杨亮,2022-07-18 10:07:35,12,12,0,“总有一个人，懂得你的好”😋😋😋
159455,2922,杨亮,2022-07-21 07:28:44,26,26,0,一年下来了，终于要摆脱了，再来刷一个伊丽莎白
159474,2922,杨亮,2022-07-23 13:39:57,16,16,0,有了手臂
159805,2922,杨亮,2022-09-01 04:49:32,20,22,2,墙倒众人推，伊丽莎白真不是没有道理的\n\n一年过去终于要远离这个傻逼了，拜拜，自以为是的人生导师，实际上狗屁不通的胡说八道
159945,2922,杨亮,2022-09-09 11:35:26,24,24,0,伊丽莎白医疗设备亚硫酸钡叶绿素b
161876,2922,杨亮,2022-11-14 16:14:13,8,8,0,不多评价
161904,2922,杨亮,2022-11-15 02:14:58,7,7,0,你真6
162327,2922,杨亮,2022-11-20 06:20:24,16,17,1,我真的很害怕自己将来活成杨亮的样子
162631,2922,杨亮,2022-11-30 05:45:00,8,8,0,呵呵。
164559,2922,杨亮,2022-12-22 01:50:50,10,11,1,他真的，我哭死。\n\n德法上的比什么都痛苦，最后一节课都不放松，想尽办法确认学生是否在线，不在线就认定为缺勤。\n\n只要当天没上课，哪怕是因为集体做核酸（当时在隔离），就要算缺勤。作业也多的要死，恨不得每节课都有，给分也真的很恶心。
167420,2922,杨亮,2023-01-16 07:16:01,9,9,0,给分真的很依赖期末考试，平时作业做的再认真都没有用，给分垃圾，真就伊丽莎白
167447,2922,杨亮,2023-01-16 10:39:13,-11,1,12,事特别多，但是今年思修给分特别好
167449,2922,杨亮,2023-01-16 10:41:31,-7,1,8,今年给分超赞
168793,2922,杨亮,2023-02-22 09:06:05,-20,0,20,很负责的老师，10分
169058,2922,杨亮,2023-02-24 07:16:56,9,10,1,笑发财了，看到大家都在骂伊丽莎白我就放心了
169333,2922,杨亮,2023-02-25 12:31:35,-12,1,13,个人感觉也没有特别差，但是给分也不是特别好，中等吧，让人有点失望却又不至于难过
170809,2922,杨亮,2023-03-10 03:26:04,16,16,0,pua的集大成者\n\n双标艺术的教科书\n\n伟大的辅导员
172195,2922,杨亮,2023-04-21 14:09:50,23,23,0,您也配拿周总理当钉钉头像？
174314,2922,杨亮,2023-06-09 08:09:52,12,13,1,忍一年了，來骂一句伊丽莎白不过分吧
175025,2922,杨亮,2023-06-21 06:37:32,-19,4,23,我给满分
179677,2922,杨亮,2023-09-19 07:55:59,10,10,0,md天天拖堂，我后面还有课！！
181226,2922,杨亮,2023-10-17 07:49:27,9,9,0,天天吹牛，自大，拖堂，无聊，还感觉自己很有文化是吧？你这有拖堂的必要吗？简直就是一个废话机器，作业调研啥的p事贼多…要不是有0分，我还会打1分？
185540,2922,杨亮,2024-01-02 04:47:44,11,11,0,作业多到爆炸，老师极其自恋，看把你能的
189246,2922,杨亮,2024-01-22 15:09:36,8,8,0,给分很烂，很自恋，浙大最sb的老混蛋呵呵，赶紧逃吧
189269,2922,杨亮,2024-01-22 17:16:56,7,7,0,ylsb伊丽莎白这话可不是乱叫的。思政给分这么迷你是觉得我思想道德有问题吗呵呵^_^每个人接触过他的人都是一致的反感甚至辱骂。选到课的自求多福。
189956,2922,杨亮,2024-02-03 16:14:01,9,9,0,思修给分和狗屎没区别，选上的快逃！！这个男的简直让我刷新对于浙大的看法，极度自恋，强调自己的优越感，还有我一点也不关心你的老婆和女儿呵呵，我希望你女儿最终别活成你自己的模样，天天被骂还不知羞耻
190104,2922,杨亮,2024-02-21 16:55:02,4,4,0,思修避雷。p事特别多，想尽办法给你扣分，还自恋自大，伊丽莎白！
190961,2922,杨亮,2024-03-26 00:52:36,3,3,0,思修给分极差，天天莫名其妙扣分，这个sb就是一坨💩
192067,2922,杨亮,2024-05-08 12:13:20,3,5,2,赶紧跑吧。这个老师简直令人无语窒息。。呵呵。自恋，捧男，以为自己有多牛吗？呵呵。头像赶紧换了不尊重总理
198094,2922,杨亮,2024-08-30 10:00:21,2,2,0,事情太多了……我恨你。。。
198740,2922,杨亮,2024-09-11 07:45:45,6,7,1,我是历史学家，这就是史
199545,2922,杨亮,2024-09-25 07:16:10,3,3,0,伊丽莎白，上了三节课布置了八个作业，真无语
199762,2922,杨亮,2024-09-29 06:46:20,1,1,0,伊丽莎白名不虚传，事是真多，还没用，浪费我时间
199775,2922,杨亮,2024-09-29 14:27:31,5,5,0,私人老师，这种人在top3教书，还有车有房，家庭美满，生活幸福。\n\n这个世界真的癫了。
200162,2922,杨亮,2024-10-14 08:20:12,1,1,0,dsb
212895,2922,杨亮,2025-01-15 07:49:56,-8,0,8,杨亮，我为你举大旗！！！谁敢说他思政给分不高！！！理科生基本没听过，不是组长，没有发言，4.8！！！！
213758,2922,杨亮,2025-01-19 13:23:26,2,2,0,上的思修。还是比较正常的老师，说话中肯，通情达理，没有查老师上那么逆天，虽然我也没学到什么。平平淡淡，给分一般，慎选。
215632,2922,杨亮,2025-03-03 05:49:58,1,1,0,伊丽莎白
216448,2922,杨亮,2025-03-16 14:35:57,1,1,0,pua
216653,2922,杨亮,2025-03-20 06:22:03,1,1,0,说一堆废话
126235,2990,冯冬芹,2020-09-20 11:17:23,32,35,3,活的人渣。狗屁新生之友，自己儿子都没教育好何德何能教育我们？！相当的地域歧视，不说这人学术水平咋样，人品是差到极致。
137214,2990,冯冬芹,2021-07-02 10:07:43,23,23,0,就TM喜欢教训人，呵呵，盛气凌人的样子
218838,2990,冯冬芹,2025-05-08 02:43:40,12,12,0,避雷，完全不备课，教学水平离谱。上课最喜欢让同学自己查资料去了解他突然想到的东西，时常不知所云，发表逆天评论观点，教学安排想一出是一出，非常混乱。让学生自己讲课，然后挑刺一整节课，上大学以来体验最差的一门课。
219121,2990,冯冬芹,2025-05-22 02:01:53,10,10,0,上课以自己不备课为傲，整节课都在让学生搜他忽然想到的专业术语，教学没有安排，时常不知所云，对学生不尊重，没有一点耐心，盛气凌人，要求标准和分配任务也是随时在变，专业能力完全没在课堂上提现，不配当老师
219178,2990,冯冬芹,2025-06-03 00:32:20,8,9,1,乱开屏的老孔雀，不知道是不是读书期间舔狗当惯了，是个女的就送温暖
219326,2990,冯冬芹,2025-05-25 08:43:26,8,8,0,上课从不备课，绝大部分时间让同学作名词解释的ppt展示，展示完会进行一番盛气凌人的批判，打分纯看个人主观，100分到30分都有；实验课要求写攻击脚本，但自己什么都不讲，问他也只会让你自己查，要么就扯到人生大道理上。这课上下来不知道到底要干什么，最后的考核任务也一直在变，不明所以。上大学以来最讨厌的一个老师，毫无教书育人精神
219413,2990,冯冬芹,2025-05-27 01:02:28,5,5,0,持续更新，今日fdq自称一直思考ai内容，继续发表ai高见：神经网络训练的梯度下降法，不需要求梯度。追问展示同学，为什么要用sigmoid函数？同学回答：容易导。冯大怒，反复追问，这里需要求导吗？梯度下降需要求梯度吗？最终长叹，认为梯度下降法求梯度方向，不需要求梯度，不需要求导。同学皆感概其数学功力。至于其他ai高论不再赘述
220209,2990,冯冬芹,2025-06-16 09:39:46,2,2,0,一坨狗shi，上课不知道在讲什么，不对，他就没有上课过，平时理论课全是学生在讲，实验课他就跟个大爷一样坐着，毫无指导，全是助教在指导，问他问题就是让你自己琢磨，我要是啥都会，我还来上课干啥（他自己说他不招收研究生，原因是被投诉怕了，乐！！！！）别选他的课真的！！！！现在期末周进行中，都在准备着考试，他还让各种改报告，上交的ppt和实验报告就是一直让修改，为什么他的评分不是1.几？？
221209,2990,冯冬芹,2025-06-22 03:55:42,0,0,0,错怪你了fdq，虽然上课是真差，给分到是莫名其妙的好
221795,2990,冯冬芹,2025-06-26 09:34:49,0,0,0,虽然是很逆天的老师，但是最后出分还挺不错，原谅一下你吧。而且大家上课因为老师不讲，来的人很少，我就没有几次来过，老师也认识我知道我不咋来，最后都没怎么扣分。
70036,3066,曹峥,2018-01-26 04:43:07,0,0,0,给分还好，就是上课的时候啥都不说，让我们一通乱做
158996,3066,曹峥,2022-07-04 10:24:04,0,0,0,实验技能训练上课对着教程念
174638,3066,曹峥,2023-06-15 02:25:03,0,0,0,好老师，很有耐心，讲解实验也很清晰
195950,3066,曹峥,2024-07-01 02:34:28,0,0,0,很温和
4045,3165,刘兴高,2015-06-17 15:23:29,34,48,14,棒
8755,3165,刘兴高,2015-09-25 11:12:04,23,28,5,感觉很好，人很和蔼也没有架子，喜欢吃辣
8770,3165,刘兴高,2015-09-26 01:57:08,18,20,2,蛮和蔼的老师～
10661,3165,刘兴高,2015-11-21 23:46:37,11,16,5,非常赞
17635,3165,刘兴高,2016-01-20 14:06:35,19,24,5,老师超和蔼，经常问同学们的看法，会调查上课速度快不快。
19484,3165,刘兴高,2016-01-24 10:54:42,10,14,4,好。9分。
20476,3165,刘兴高,2016-01-27 17:01:26,-16,10,26,学不到东西 瞎比比
23920,3165,刘兴高,2016-04-21 04:05:28,18,21,3,浓浓师生情！
27444,3165,刘兴高,2016-06-26 09:22:02,5,10,5,非常能说会道的工科老师，课程内容把软件工程、数据结构、数据库杂糅在了一起，没什么深度，拿来刷个个性学分还是很不错的
30293,3165,刘兴高,2016-07-01 07:58:39,-11,6,17,呵呵 教你吃人参
40727,3165,刘兴高,2017-01-05 07:05:35,-10,7,17,听刘老师侃大仙，上传作业一言不发，真·啥也学不到
45851,3165,刘兴高,2017-01-20 07:27:58,18,19,1,棒棒哒\n\n
61829,3165,刘兴高,2017-11-21 07:03:33,17,18,1,超级棒的老师，给分也很好
63757,3165,刘兴高,2017-12-14 05:27:53,-10,4,14,呵呵呵，教你读论语
64994,3165,刘兴高,2017-12-28 06:49:14,20,21,1,老师挺棒的 感觉学到挺多东西
64996,3165,刘兴高,2017-12-28 06:53:48,16,17,1,老师挺平易近人的，上课也有意思
65045,3165,刘兴高,2017-12-28 10:54:07,12,14,2,感觉超有收获，老师上课很认真、很敬业，感觉每堂课都精心准备过，收获满满
65188,3165,刘兴高,2017-12-30 09:41:53,12,16,4,听刘老师一席话，胜读十年书。 刘老师博闻强识，上课风趣幽默，针砭时弊，发人深省，收获颇丰～
65197,3165,刘兴高,2017-12-30 14:48:39,11,18,7,以前听学长谈起控制届的大牛，现在如此真切，刘老师对国际控制方向、流派，不经意谈来也如数家珍，而且超级和蔼、真心关心我们的发展，打听了一下，老师带的硕博果真厉害，能成为刘老师的学生的确幸福。
65214,3165,刘兴高,2018-01-09 03:03:16,8,12,4,很好的一位老师
65496,3165,刘兴高,2018-01-04 15:07:45,13,15,2,觉得还是不错的老师。学术成就高。态度很和蔼。而且是在教学生一些为人处事的道理的。\n\n老师自己定位是把软基当基础课的。所以教的内容比较简单。加上闲话比较多。所以有人觉得学不到太多东西吧。。。
66232,3165,刘兴高,2018-01-13 16:56:10,16,19,3,学术大牛。学术大牛。学术大牛。绝对的学术大牛。不过放心刘老师是把软基定位成基础课开的，因此很容易拿高分，课程本身没有太大难度。本科阶段能接触到这种学术大牛的机会可千万要珍惜啊。刘老师人很好，课后可以去请教本科生做科研的事情。刘老师有时还喜欢讲一些国际上的研究动态，热门争议问题和论语。。。我感觉刘老师是真的把学生当自己孩子，希望传授给学生各方面的知识，不过当然了总体还是围绕课程本身授课。总之感觉自己很幸运能在这个学期选到刘老师的课
69275,3165,刘兴高,2018-01-24 11:49:00,10,10,0,背好PPT，考试拿高分
78870,3165,刘兴高,2018-05-16 03:29:09,10,10,0,很有收获，绩点也高
84489,3165,刘兴高,2018-07-13 03:35:34,9,10,1,刘老师蛮忙的，作为主攻科研的老师还能认真上本科生的课实属不易。课下试着联系过刘老师，希望暑期能进实验室学习，被拒了，可能他确实是太忙了吧。
91348,3165,刘兴高,2018-12-06 06:45:45,6,7,1,刘老师科研超级忙，假期想进实验室被拒，唉可能因为我太菜了吧
92906,3165,刘兴高,2019-01-05 12:57:00,5,5,0,刘老师最精华的其实是足球踢的超级好啊，跟他练球进步神速\n\n
93190,3165,刘兴高,2019-01-08 05:17:45,9,9,0,没想到是个足球高手！颠球小能手
94791,3165,刘兴高,2019-01-18 07:04:32,5,5,0,考完了，求一份师生情
95478,3165,刘兴高,2019-01-19 12:43:49,6,6,0,脾气超好从不点名，但是心甘情愿听完每一节课。收获很大。去球场有惊喜?
98026,3165,刘兴高,2019-01-23 04:26:57,-96,3,99,呜呜呜说好的水课呢结果只有卡绩4.5凉了啊
98048,3165,刘兴高,2019-01-23 04:23:57,8,8,0,老师学识渊博，上课挺认真的，上课内容也不难，签到也只要一次就够了，虽说最后卡绩了，但确实是一位好老师。
98062,3165,刘兴高,2019-01-23 04:38:31,4,6,2,讲课非常清楚，内容略水（当然与这门课的定位有关），最后老师真的好，是我见过的最有耐心，最负责的老师之一！\n\n最后给点老师的忠告，要想考得好，考前一定要认真复习ppt！
98532,3165,刘兴高,2019-01-23 14:34:04,0,1,1,这课竟然算主修…
102491,3165,刘兴高,2019-02-03 11:55:39,2,3,1,真的很好的老师，只刚开始点一次名，持续到最后一节课。讲课很细致严谨，回答问题会被追问到很细的细节。温润如玉，却还会踢球。助教也很耐心，会回答群里每一位同学的问题。唯一的缺点可能就是，有时会吹一下自己，总是说起帝国理工和清华，透露出对浙大一些方面的不满。（可能是体质原因我觉得属于缺点，不满的地方也确实是存在，而且老师确实有实力）。\n\n三次作业加期末考试。有干货也可水。最后给分很好。
117648,3165,刘兴高,2019-09-27 12:50:34,0,1,1,四个字，振聋发聩
120776,3165,刘兴高,2020-01-16 23:56:08,-5,1,6,老师超级正义！助教超级耐心，本学期将期末考改成了大作业，虽然起初对大作业一无所知无从下手，但炼丹炼出来的感觉真的不要太开心！
120788,3165,刘兴高,2020-01-17 02:57:54,-2,2,4,还行，考试取消改成大作业压力小了不少
128261,3165,刘兴高,2020-12-15 10:57:07,2,5,3,不太好
147364,3165,刘兴高,2022-01-09 17:44:50,3,3,0,不多说了 一学期划水 大作业瞎搞 感谢老师给过 必须给10分
147391,3165,刘兴高,2022-01-10 02:18:20,2,4,2,什么鬼，大作业写了八百多行，程序设计演练也七八百行，最后来个惊喜？隔壁孙志峰给分都比你好
166224,3165,刘兴高,2023-01-11 12:55:06,0,1,1,记得第一次课点名，大作业报告认真写分不会低，总之神中神
187453,3165,刘兴高,2024-01-16 07:55:39,0,0,0,好课！
217609,3165,刘兴高,2025-04-14 05:46:12,0,0,0,好课，大作业水一水给分也很好
4881,3177,张涛,2015-06-30 06:41:05,14,24,10,老师很和善，乐呵呵的，但是课比较乏味
13695,3177,张涛,2015-12-30 11:01:48,-2,2,4,我上的现代科学仪器通识课，一次展示，一篇论文。给分还未知，感觉老师还行
16050,3177,张涛,2016-01-17 05:16:21,2,3,1,好厉害的样子，知道的都是我们不知道的
16810,3177,张涛,2016-01-19 04:16:45,0,3,3,不开心\n\n
18011,3177,张涛,2016-01-21 05:57:06,2,4,2,也是学的通识课，老师讲得很好，虽然最后得分比我预计的稍低一点但总体真的是个很不错的老师。
30181,3177,张涛,2016-07-01 04:48:25,3,3,0,讲课风格挺喜欢。。。
30191,3177,张涛,2016-07-01 05:00:30,2,4,2,不知道给分的依据是不是只有展示和论文。给分是通识课中的最低，早知道应该不好好学才对得起这个分数。
30766,3177,张涛,2016-07-02 12:19:04,3,5,2,给分太低了……上课小班很尴尬。每节课都要小组展示。是所有通识课里分数最低的...辛亏k类选完了……
34054,3177,张涛,2016-09-26 07:06:58,-1,0,1,hhhh
35564,3177,张涛,2016-11-10 07:27:52,4,4,0,上的是通识，张老师很可爱
35669,3177,张涛,2016-11-10 07:41:47,-1,1,2,有兴趣的话一定要选！
35733,3177,张涛,2016-11-10 07:55:39,0,3,3,课上想做啥做啥，展示和论文认真写一下就好，分低的人品确实差了点
37117,3177,张涛,2016-11-17 12:51:26,0,0,0,老师人很好，平易近人。就是晚课又有点无聊，容易犯困。
37971,3177,张涛,2016-11-22 12:10:12,-1,1,2,老师讲的很好，很有启发性
70754,3177,张涛,2018-01-27 13:14:21,0,3,3,上的张老师的现代科学仪器，对于理工科学生来说非常有意义的一门课，借机了解很多科学仪器的原理。张老师非常和蔼可亲，乐于和同学交流，认真上课会有很多收获。为期中展示很细致的做了准备，也拿到了理想的分数，非常感谢张老师！
90112,3177,张涛,2018-11-22 06:43:31,2,4,2,评分奇怪
90180,3177,张涛,2018-11-22 10:47:05,0,2,2,蛮不错的，尤其讲到自己研究方面的时候特别有激情
90185,3177,张涛,2018-11-22 11:02:49,4,6,2,快乐查资料，快乐做展示。老师超棒，很有趣～（除了眼睛有点小，导致不知道他在看谁，就总是觉得他在看你）是难忘的晚课u
90266,3177,张涛,2018-11-23 01:37:02,5,6,1,老师的通识课具有很强的适用性，不论是理工科还是文科的学生，在这堂课上都能收获到很多。另外，老师人也很好，给分很实在，对我们展示的评价也很中肯。老师加油！
90289,3177,张涛,2018-11-23 03:27:15,2,3,1,老师真的人很好 我一个文科生去上这个课都表示很好 虽然老师最后会正态 但这是学校的要求 怪不得老师
90290,3177,张涛,2018-11-23 03:29:37,3,4,1,老师人很好，分低怪我自己没有认真学
90786,3177,张涛,2018-11-26 04:53:34,-4,3,7,老师人很和善，现代科学仪器属于事少分多的通识课，我满了_(:з」∠)_
91287,3177,张涛,2018-12-05 04:34:14,2,2,0,上的是通识课，有五次小组展示，一次小论文，没有考试。文科生表示除了老师的全英文ppt，别的还是能听得懂的，干货满满。最后的给分也很实在，事应该不算少的，但分挺不错，老师人也超可爱ԅ(¯﹃¯ԅ)\n\nps老师女儿跟他长的一模一样特别是眼睛哈哈哈哈哈哈哈哈哈哈哈
91891,3177,张涛,2019-02-23 09:09:09,-12,4,16,现代科学仪器，五次小组展示，一次论文，没有考试，不点名，给分相当实在，这门课上下来对拓展视野有不小的帮助。5.0默默飘过...
92443,3177,张涛,2018-12-29 00:19:44,6,6,0,现代科学仪器，两节课后前排空空荡荡了，小组展示里可能有人是轮不到的，比如说我，所以这门课唯一的作业就是最后的小论文，怪我太草率【扶额】，当人家还在问论文里怎么附图之类的时候，我意识到我根本没有图并且早交了，，，3.3哈哈哈心很凉但是，怪我自己，老师挺亲和的，看得出是真的希望我们了解一些仪器。
93174,3177,张涛,2019-01-08 03:08:46,0,1,1,没意思
97903,3177,张涛,2019-01-23 01:27:28,0,0,0,。。。
102725,3177,张涛,2019-02-22 03:54:50,2,2,0,现代科学仪器这门通识还是很有意思的，给分也不错。但是要做的展示太多太辛苦了。
109708,3177,张涛,2019-06-18 15:14:22,3,3,0,现代科学仪器是特别好的一门课（我至今上过的自认为最好的一门通识，不过比较硬核），学到了很多知识，老师也挺好，是真的希望我们掌握一些基本仪器的原理的。
110698,3177,张涛,2019-06-28 04:50:43,0,3,3,强推张老师的现代科学仪器，真的能学到很多知识而且平常事情也不是很多。给分还挺好的
113441,3177,张涛,2019-07-06 17:21:28,2,3,1,挺不错的 开阔视野 认真准备了分还不错 期末论文改成做PPT觉得是很好的变动 减轻负担也考验理解提炼 赞
120074,3177,张涛,2019-11-17 10:23:54,-1,0,1,很棒很好
120373,3177,张涛,2019-12-01 07:47:10,-1,1,2,现代科学仪器，总的来说还是一门非常不错的课，老师很和蔼，然后能让我们了解到不同领域的科学仪器，课程的任务还是比较轻松的，一次报告加期末大作业做一个ppt，给分还行
123036,3177,张涛,2020-05-04 02:41:15,4,4,0,感觉课程比较硬核，作为一个高中没有选物理(约等于毫无物理基础）的学生，上课就很迷茫，搞明白原理太难了，完成讲原理的ppt也好难，真的怎么都搞不懂。老师确实很希望我们了解科学仪器，可是没有兴趣的确实极度枯燥无味。确实已经尽力了，逼着自己尴尬发言，给分一般，对此不感兴趣的慎选，文科生慎选
124469,3177,张涛,2020-07-01 16:06:28,0,2,2,微流控，事少，东西好，给分好！
127205,3177,张涛,2020-11-13 04:34:14,3,5,2,必须要给10分！上的现代科学仪器，平常没啥压力，唯一的作业是一次课题展示（要卷的话可以参加多次，反正取平均或者最高），期末作业是一个PPT介绍一种仪器。\n\n老师人超级好，性格很和善，非常照顾学生，即使学生做的很不好也不会生气（他会苦笑emmmmmm）\n\n老师上课也很有趣，虽然后期大部分时间是交给学生进行课题展示，老师讲的就相对较少了。\n\n真的学到了很多\n\n不过还是要说一句：文科生可能接受有困难，涉及到比较多的数理化知识，理科生的话上课感觉灰常不戳\n\n难度大概是高中学理科的孩子认真听完全能听懂，真的只涉及高中知识，也不难\n\n很好的大一入门通识课。\n\n最后还是要来一句：张涛老师NB!
127607,3177,张涛,2020-11-25 03:25:44,-3,1,4,老师人很好，学的东西也挺多的，文科生也能听得懂，只要认真完成展示和期末PPT分数就不会差。
127620,3177,张涛,2020-11-25 05:22:55,0,1,1,硬核，可以学到很多知识
128885,3177,张涛,2020-12-26 11:22:36,4,6,2,很庆幸能在大一刚进入校园时上张涛老师的现代科学仪器。这课是小班教学，后面几周小组展示（多次取平均分，不强求小组所有人参与），期末交个PPT就好，没有恶竞。做展示前找资料的过程中确实很拓宽知识面。\n\n张涛老师人也很好，是真的很想让大家了解现代科学仪器，同学讲不好他会帮忙补充。上课时也很有亲和力，会耐心的和同学们讨论，就是他眼睛确实很小hhh\n\n很推荐选，在大学应该感受一下这种和老师一起小班讨论学习的氛围\n\nPS：课上讨论也很随意，社恐完全不用慌
133350,3177,张涛,2021-02-26 06:05:56,0,1,1,呵呵。
142788,3177,张涛,2021-11-16 06:31:44,3,4,1,展示认真准备，作业有认真做，3.3\n\n是不是绩杀你们自己看看吧
142896,3177,张涛,2021-11-17 06:49:35,-2,1,3,老师挺好的 给了4.5 但是卡绩了呜呜\n\n选这个课挺好的 事情不是很多\n\n不用考试
148047,3177,张涛,2022-01-11 11:58:13,0,0,0,传感与检测 讲的很详细很耐心
153547,3177,张涛,2022-05-04 11:51:23,0,0,0,微流控事少给分好，这种比较前沿的东西老师还是很希望大家能多接触和了解的
176648,3177,张涛,2023-06-29 14:31:10,0,0,0,太好了
182570,3177,张涛,2023-11-17 14:38:24,2,2,0,和黄平捷俩人教一门课，评分加起来刚够十分
182829,3177,张涛,2023-11-20 13:18:44,3,3,0,老师人很不错，讲课听起来也很舒服，而且很幽默。不过现代科学仪器这门课没有理科基础的慎选，后面小组展示要讲科学仪器如果是文科生很难做到花费大量时间把仪器的原理弄明白然后上去讲来加分。不过这门课没有考试只有小测，可以背一背课上内容就好。
182908,3177,张涛,2023-11-21 05:09:03,0,0,0,老师很好，备课充分，内容很多，可以学到很多\n\n现代科学仪器课程喜欢做ppt的无脑入
183034,3177,张涛,2023-11-21 16:05:28,0,0,0,现代科学仪器\n\n事情不算特别多，上课氛围很好，有很牛的大佬每节课都能跟老师讨论很多，但是我是文科生，其实感觉有点点格格不入\n\n期末是做一个ppt介绍扫描电子显微镜\n\n小组作业好好准备，期末ppt多查查资料，弄懂了之后做得详细一些，会有好的结果的。
183123,3177,张涛,2023-11-22 10:16:50,0,0,0,老师超级好，特别和蔼，讲课也很仔细，特别照顾学生
185263,3177,张涛,2023-12-27 12:08:26,1,1,0,基本是小组展示，除了刚开始那一次，后面三次全在划，抱紧队友大腿，最后的期末作业PPT也是随便缝合了一下，结果4.2，还不错。\n\n老师上课会告诉你不要拿手机（虽然没什么效用），而且在别的组介绍完一种科学仪器之后会让随机找人问问题（或者让你问问题），但本人运气好，一路躺到底
208639,3177,张涛,2024-12-30 10:08:32,0,0,0,传感与检测会点名，偶尔课上让我们做一道习题。课讲的挺好的，作业ddl也很宽松。
37867,3206,仲玉芳,2016-11-21 12:32:04,3,3,0,yyyyyyy
52990,3206,仲玉芳,2017-06-24 13:37:19,7,9,2,居然没人 给仲老师赞一番 讲课求是认真，每次回答问题都极为耐心，不折不扣的好老师，而且给分好！
115463,3206,仲玉芳,2019-07-25 14:21:59,2,2,0,控制院网上发的通知小学期19号正常结课，20.21号没做完的同学可继续，到第一天就通知要到25号，太随便了，之前报名了22号的托福课程开始后就黄龙紫金港两边跑，把学生当宝耍，询问之后回答说最新的通知就是25号结课，但是院网上也没找到，只有一个3月的通知模糊地写了两门课加起来是从5号到25号，但是5月的通知里还是最迟到21号，没有更新的通知，那我之后就不知道应该是以最新的通知为准还是以时间范围最广的通知为准了。
126175,3206,仲玉芳,2020-09-18 12:14:26,25,26,1,已毕业来怀念一波。\n\n虽然在老楼实验有时候从早熬到晚，拿到的数据往往也不尽人意（必须diss中控辣鸡设备），还有PLC/DCS的大实验，接线、编程、采数据、写报告焦头烂额，但总有一位老师在那里细心讲解实验步骤，耐心回答我们的问题。\n\n每一名控制学院同学都在仲玉芳老师指导下进行过实验，实验中心的教学内容每一届都如出一辙，就这样培养了一届又一届，送走了一届又一届学生。为这样一位细心、耐心、负责的好老师点赞。
158995,3206,仲玉芳,2022-07-04 10:23:11,0,2,2,实验技能训练上课内容属实有点无聊
164308,3206,仲玉芳,2022-12-20 08:27:12,7,7,0,作为实验老师，是很耐心细致。记得我当时实验技能训练训练画pcb有一个错死活找不到，然后仲老师也不知道就搞了半小时，然后解决了，真的很好~~
197402,3206,仲玉芳,2024-07-13 01:41:58,3,3,0,实验技能训练。芯片出了奇怪的bug，帮我焊接了四个小时，真的太有耐心了，技术也过硬👍
207328,3206,仲玉芳,2024-12-20 13:00:30,0,0,0,坐标实验技能训练。老师很有耐心，实验指导很详细。讲理论的时候会有点无聊，因为那些传感器的内容自身就是无聊的。焊好的板子不正常工作老师还会帮我们查bug，本人最后几个走的，老师也一直陪我们到很晚。这门课给分也不错。很好的实验老师！！
217155,3206,仲玉芳,2025-04-02 16:34:39,3,3,0,我觉得仲老师这样兢兢业业，尽职辛苦的教学老师和那些狂发paper的学术大佬一样重要。学院的树人品德在日复一日年复一年的孜孜不倦中体现
218160,3206,仲玉芳,2025-04-21 15:14:38,2,2,0,虽然很不喜欢计算机控制系统设计与实践这门课，但是还是要来给仲老师一个10分。老师对实验的指导可谓是详细到“手把手指导”。控制学院其他老师真的应该好好向仲老师学习一下对待教学的态度。
218593,3206,仲玉芳,2025-04-25 15:17:23,1,1,0,太好的老师！仲老师真的给人一种谦谦君子的感觉，虽然实验很头疼，但是确实有一种如沐春风的感觉（感动www）
78407,3221,王宁,2018-05-11 11:26:49,0,0,0,很无聊
100292,3221,王宁,2019-01-26 02:14:06,0,0,0,意外催眠，内容很浅，重点是给分低还卡绩点
139998,3221,王宁,2021-08-23 02:11:25,0,0,0,上课态度：严谨\n\n内容：念PPT，声音小，没有什么含金量\n\n给分：偏低\n\n点名：是的，差不多每节课都点名\n\n10分的话，给个5分差不多。。。。。
40315,3264,冯毅萍,2017-01-02 10:27:09,1,1,0,mmm
109332,3264,冯毅萍,2019-06-13 06:44:41,1,2,1,人比较温柔 但理解力较差 和学生沟通有困难
126178,3264,冯毅萍,2020-09-18 12:28:10,4,4,0,传感与检测实验课第一节就点名回答问题，说实话被吓到了（菜鸡路过），后面做实验才发现老师人很好，讲解也很清晰。自动化综合实验鸡肋课程，还总要当面汇报进度，尴尬死。不过老师很关心每一名学生，会理解我们实际情况（主要就是考研），也就不要求什么工作量了。
209389,3264,冯毅萍,2025-01-06 01:13:21,2,2,0,自动化创新实验来的，老师很难评。不知道为啥，看到一些评论都说这个课对于考研的友好，但我完全没感受到。老师的答辩或者类似答辩的环节，比毕设还多1个小组讨论（基本就是向老师汇报当前情况），每周还要写每周的情况汇报。考研也没见哪一部分工作量能直接不做的，只能说选题选简单点，降低整体工作量吧。\n\n今天课程答辩，老师还在想要有的组做出论文发表或是专利，说是暑假前有时间都可以做做，不知道为啥她把这门课的定位看得奇高，一些要求定的也是特别形式化，除开能做出成品的工作量，一些材料书写的工作量也是奇高。\n\n慎选
215103,3264,冯毅萍,2025-02-21 07:21:05,3,3,0,大道理连篇，不按时下课，没有考虑过同学上自动化竞赛实训想听的是货真价实的指导，而不是创造力内涵云云，🤦‍♂️
219929,3264,冯毅萍,2025-06-11 10:07:42,0,0,0,我很少用**来形容一个老师，除非忍不住。
117176,3291,周洪亮,2019-09-20 04:04:24,0,0,0,感觉像通识课
133172,3291,周洪亮,2021-02-13 00:57:45,-1,0,1,传感给分太好，赞～
171138,3291,周洪亮,2023-03-17 01:39:00,5,6,1,老师讲的很好，给分也挺不错的。就是上课回答问题有加分（但没有具体的加多少），就一堆人抢着发言，课堂体验下降了一点。
200976,3291,周洪亮,2024-10-26 01:54:27,0,0,0,应该是只有这两个老师是上课先讨论40分钟。之后会讲一点东西，然后让同学回答问题，反正相比于其他老师应该更水，不过传感本身就很水，不好评价。小测是闭卷的，其他大多是开卷或者当作业。别的不清楚，到期末再看
213641,3291,周洪亮,2025-01-18 16:05:27,4,4,0,感觉给分不太好ww
213919,3291,周洪亮,2025-01-21 10:03:36,3,3,0,不好。。
219932,3291,周洪亮,2025-06-11 10:23:15,0,0,0,老师平时分实验平均80左右，算下来总评平均已经扣8分了。相比于隔壁的jhf和hpj老师，人家至少平时分是基本给满的，平时作业做的好加分。上课特别喜欢叫学生回答问题水时长，讲课时间基本只占课时的一半。反正不建议选
59959,3331,陈超,2017-09-29 03:06:03,1,1,0,有趣，总是举一些案例，比较活跃。
69529,3331,陈超,2018-01-25 02:46:20,0,1,1,思修，给分好低，不过讲的不错
69530,3331,陈超,2018-01-25 02:51:04,-1,0,1,无聊，给分又低
69732,3331,陈超,2018-01-25 09:33:17,-1,0,1,无语。。
69978,3331,陈超,2018-01-26 01:16:10,0,1,1,这个老师是个绩杀...
123839,3331,陈超,2020-06-15 01:56:36,0,1,1,思修: 老师很爱笑，发言和展示很重要，作业不要水，否则分数不好。
146529,3331,陈超,2022-01-07 00:57:02,1,2,1,老师人很好 讲课很活泼 然后给分真的不好看 我们组的读书报告 研究性学习 小组展示分数都挺高的 结果出成绩大家还是不够理想....xs
146724,3331,陈超,2022-01-07 09:32:42,0,0,0,思修能3.3。。
146760,3331,陈超,2022-01-07 11:22:02,1,1,0,陈超老师讲课很有趣，给分也好，5.8的评分确实低了。
146967,3331,陈超,2022-01-08 08:17:04,0,0,0,给分确实差点意思
148944,3331,陈超,2022-01-14 04:04:26,0,0,0,肝了很多锅，最后被绩杀了
2330,3366,自动化外聘1,2015-04-22 16:19:04,0,0,0,听不懂
36803,3366,自动化外聘1,2016-11-16 05:59:54,0,0,0,一般般
100097,3366,自动化外聘1,2019-01-25 14:45:30,0,0,0,这个人是谁
60073,3654,李颖,2017-10-09 12:52:02,-15,11,26,女性生理与健康的老师嘛 哇超萌超可爱的 很温柔也学了很多知识 一本正经地开车～分数就是 到课率占40 每节课测验十道判断题一题一分 共六次课！大概听听都会但是一定要一直听…
61394,3654,李颖,2017-11-22 09:36:49,7,11,4,老师是好老师，上课干货很多，平时温温柔柔，没作业没考试没论文。。。但是真的被绩点伤到了。。本来以为我的3.5已经是非常低了，这么看还算是高的？？？
61490,3654,李颖,2017-11-17 14:58:26,18,20,2,老师虽然温柔，但是绩点给的超级低，无厘头，平时的课没意思，尽量避开……
61505,3654,李颖,2017-11-18 14:29:46,7,9,2,给分真的很低 上到现在最低的一门课 平时真的很水 但是我课后题也是认真做了 上课也听了的 真的很难过
61506,3654,李颖,2017-11-18 03:23:33,12,14,2,老师虽然很温柔，但上课无聊，我从不缺勤，课后题认真做，给她的建议也写了满满一张纸，结果给分呵呵
61523,3654,李颖,2017-11-18 08:48:24,5,7,2,上课挺好且没有考试没有作业。´_>`但是给分真滴很低。真滴很低。很低。
61546,3654,李颖,2017-11-18 12:25:33,6,7,1,这个分数让人奔溃\n\n。但上课真的轻松。没论文\n\n
61564,3654,李颖,2017-11-18 14:43:26,8,9,1,老师很温柔上课也很认真，但是我真的被我的绩点伤到了……
61589,3654,李颖,2017-11-19 03:55:13,28,33,5,每次课都到，认真听讲完成判断题，最后2.5。。。?
61598,3654,李颖,2017-11-19 05:03:38,7,7,0,第一次知道通识课还有3-的绩点？？ 呵呵
61611,3654,李颖,2017-11-19 06:54:23,9,10,1,老师很温柔  事情少 上课按PPT来一直听真的很累  每次出勤算分每节课后十个判断题 期末没有考试  但是最后的绩点好迷啊 好像也不是按百分制来的
61612,3654,李颖,2017-11-19 07:16:49,6,6,0,老师人很好....但是给分低，是真的低啊555555
61630,3654,李颖,2017-11-19 11:36:46,-6,6,12,事特别少，上课认真听，当堂检测好好做，3没问题
61636,3654,李颖,2017-11-19 12:20:05,7,7,0,课后判断题不太好做。每次到课，但是绩点超级低
61751,3654,李颖,2017-11-20 14:31:12,8,8,0,随堂考试作为考核，不点名，不写论文，不考试，绩点贼低（我＜3）
61843,3654,李颖,2017-11-21 08:02:28,7,9,2,任务不重，每次课后小测验十道题，收上来顺带就当点名了。讲得一般，给分超差！给分超差！给分超差！（重要的事情说三遍）1.5的绩点也不知道是怎么给的。。。。。。老师是歧视男生吗？绝对不要选，绩杀！
61999,3654,李颖,2017-11-22 06:02:10,10,11,1,很认真，原以为3.5的绩点低了，结果比较一下还算好的。。。。。。
62002,3654,李颖,2017-11-22 06:05:43,7,10,3,不要抱着水课的态度，要到PPT真正为以后的自己或爱人了解一点知识以备不时之需。我2.5，但我不后悔
62065,3654,李颖,2017-11-22 12:37:27,4,5,1,这个课太无聊了? 要不是学分太低了我就退課了
62102,3654,李颖,2017-11-22 11:36:52,6,8,2,不下课  \n\n课很无聊  声音催眠\n\n第一节课说的上这课没什么要求，出席听课就好\n\n每节课都到  认真做判断题\n\n结果绩点科科\n\n如果这还不叫绩杀...
62123,3654,李颖,2017-11-22 12:30:16,3,4,1,老师上课很小声。。。
62858,3654,李颖,2017-11-27 07:15:50,6,6,0,老师不点名，不考试，不写论文，每堂课有小测，都是判断题，但是给分2.5，简直不能接受
62884,3654,李颖,2017-11-27 08:41:49,-6,7,13,我觉得老师超温柔啊 给分也好4.5emmn
62887,3654,李颖,2017-11-27 08:49:27,-3,5,8,老师给分就看判断题的答题情况吧 认真答就会好的
63201,3654,李颖,2017-11-29 06:40:49,5,5,0,怎么说，老师讲课不错，人也很好。可能成绩评定以后还是百分制比较好，直接五级制有点伤人了。
63231,3654,李颖,2017-11-29 10:35:06,5,6,1,真的希望老师改一下打分方式 五级太狠了【而且发邮件申诉成绩一直没有收到回复】
63323,3654,李颖,2017-11-30 14:46:26,4,4,0,给分低，怀疑人生，绩点一夜回到解放前
66080,3654,李颖,2018-01-11 11:50:53,-3,0,3,昨天结课今天就出成绩，速度倒是快\n\n不过真的很气了，说好这学期用以0.3为差的评分制了，又按原来的了了?\n\n早知道退课了，绩点不是重点，重点是被骗的感觉实在是……差劲到极点
66081,3654,李颖,2018-01-11 12:17:43,1,1,0,我觉得认真听还是有收获的，一些疾病的判断方法可以了解到呀，挺长见识的。老师很温柔，虽然问同学问题的时候没有人主动回答也不会生气，脾气很好。
66082,3654,李颖,2018-01-11 12:34:34,2,4,2,老师超温柔的，不过声音有点小，最好坐在前排。认真听收获很大的，能学到很多实用的知识，课后小测都是上课讲过的内容，只要认真听就没问题。感谢老师，第一个满绩
66124,3654,李颖,2018-01-12 03:16:39,2,4,2,老师很很很温柔，在我们上课的时候改了评分的标准，不再是以前的1.5  2.5  3.5 4.5那种了，这个课真的很不水，每节课的最后都有十道题的考核一共六次，作为平时出勤的分数和最终分数，没有期末考，全程一定要拍好照片，题目认真对待，最后给分会好的。
66218,3654,李颖,2018-01-13 11:11:56,4,5,1,课后小测当做点名和考核。开课时候说是五级制我差点想退课，出成绩后看了下是等级制，我是A-，4.2。\n\n老师上课声音太小了，而且没有语气变化，大部分时候就是在讲ppt，坐后排完全听不清楚，会感觉很无聊。好好听的话，还是能学到不少东西。\n\n事情是真的少，只有课后10道选择题，没有论文和期末考。\n\n看了以前的评论说是大绩杀，也不知道这次的给分怎么样……\n\n总而言之对于像我这种只为了水一水拿学分的人来说，可以选下这个课吧。
66231,3654,李颖,2018-01-13 15:38:46,3,3,0,老师人挺好的，这门课事情也不多，但真的是绩杀啊，现在我只出了两门成绩，一看均绩真心绝望
66247,3654,李颖,2018-11-07 11:38:44,2,3,1,你也许需要一个帮你一起查判断题的神队友
66258,3654,李颖,2018-01-14 08:26:53,1,1,0,认真听会收获知识，也可以水一水
66290,3654,李颖,2018-01-15 02:09:01,-1,1,2,整体比较水吧 但一些知识还是很有用哒对于女生来说 但是一定要拍所有ppt 答题查资料 不然大概会死得很惨？老师打分制度后来改得合理了变成百分制 还是很开心滴
66310,3654,李颖,2018-01-15 04:06:38,3,3,0,念ppt不解释，给分超级差不解释。为了学分也千万别选这门课，分数下来想杀人的心都有。
66319,3654,李颖,2018-01-15 04:26:00,4,4,0,老师很温柔……给分有点迷……尝试需谨慎……一切看人品……
66320,3654,李颖,2018-01-15 04:43:10,0,0,0,Emmmmm分两个来讲，内容上有些知识的确有用；得分上，有点烦要一直拍屁屁踢而且给分就看课后的判断题小测，所以平时不太好水。反正就很烦，综合来讲不建议选
66323,3654,李颖,2018-01-15 05:04:44,3,3,0,不解释，选了就是为了拉低均绩的
66667,3654,李颖,2018-01-18 05:38:06,1,1,0,呵呵呵
66768,3654,李颖,2019-06-18 03:24:34,-9,5,14,分数改成另一种算法（五档）后好了很多，我满了?考核制度很合理，上课好好听，判断题好好做，成绩不会差的，当然，正态分布还是要的。老师讲课偏无聊，但老师很温柔～
67096,3654,李颖,2018-01-20 09:20:55,2,3,1,老师说话很温柔。但是给分真的很迷。每节课不说很认真听了吧，至少是听了，每节到课，课后的判断题也做了，但是绩点3-。光靠课后判断题评价和五级制的评分不合理吧。
69453,3654,李颖,2018-01-24 16:45:00,1,1,0,最最轻松的一门通识了 没论文没考试 一共六次小测 每次十道判断题  挺好的
69953,3654,李颖,2018-01-25 23:47:46,0,0,0,想打0分。\n\n
77233,3654,李颖,2018-05-04 05:05:01,0,0,0,老师人很好，认真听认真做小测分不会低啊
87704,3654,李颖,2018-10-10 11:18:22,1,1,0,医学生听着为什么感觉这么多槽点……而且老师讲课水平真的有待提高……至少话讲流畅一点吧求求了……
88761,3654,李颖,2018-11-07 11:37:49,1,2,1,老师比较软弱  作弊同学很多  恶心
90401,3654,李颖,2018-11-23 11:35:38,0,0,0,讲课不行，给分也不行?
90552,3654,李颖,2018-11-24 03:55:13,2,2,0,感觉老师很温柔，课程结束让我们给出建议，也在积极改进自己的教学方式。作为一个非医学女生我觉得还是有很多医学方面的干货的。
90613,3654,李颖,2018-11-24 14:37:29,1,1,0,给分真的低……
118849,3654,李颖,2019-11-07 03:53:00,0,1,1,对于我这种通识课不想写论文不想在考试周考试的人来说还可以，课堂测试认真做，3+还有的
118860,3654,李颖,2019-11-07 05:55:04,0,0,0,h h h
128628,3654,李颖,2020-12-25 01:13:01,8,8,0,“女人不生孩子，就是去了一半的价值”\n\n“不是你说不生就不生，繁衍是你的责任”\n\n我是上课的，不是上女德班的，觉得没有得到女性应有的尊重
131027,3654,李颖,2021-01-25 15:06:47,1,2,1,老师是个超级温柔的人，没有出分之前听说是绩杀挺担心的，但是教务网的评分还是全部拉满了，因为老师真的超级好！结果出来4.8哈哈哈哈哈哈哈，我爱了。
131037,3654,李颖,2021-01-25 15:44:54,1,2,1,每节都到课 前排3.3气死了
131045,3654,李颖,2021-01-25 16:26:12,-2,0,2,老师很棒，很温柔，给分也很好，没怎么复习，最后4.5，就是老师有点太温柔了，考试作弊的很多，让人很不开心
146011,3654,李颖,2022-01-05 04:01:58,1,2,1,事少，但小测多，给分是真的很很很不行（除非你本身懂很多女性生理知识小测能拿高分那种）
146130,3654,李颖,2022-01-05 14:17:21,1,1,0,绩杀，真的绩杀\n\n逃吧，赶紧逃
154536,3654,李颖,2022-06-02 05:12:26,2,2,0,我是秋冬学期上的课，突然觉得应该来评论一下。老师人挺好的，说话也很温柔。\n\n不点名但是有当堂小测，小测内容全都是上课讲过并且老师强调的，不算很难。期末是随堂测试（都是客观题）+小论文（包括一道简答题+课程感受），对于我这种不爱写论文卷字数和额外复习备考的人来说还挺友好，最后的绩点得分也还可以。\n\n希望大家客观看待吧，没有像之前的评论说得那么糟糕，上课讲的知识也挺有用的，干货不少。
161612,3654,李颖,2022-11-09 11:51:44,0,2,2,没论文，不点名，知识对于我来说很有用，特别是生理上的一些。ppt有点老了，会怀疑数据准确度的程度emm。老师很温柔，为了防止线上作弊也做了一些措施。一学期大概随堂小测3、4次，都是选择题，上课看两眼简单记一下完全没问题。没论文。课程难度小。
48896,3722,谢依玲,2017-03-16 02:26:10,6,6,0,本科生办工作人员，对学生态度不好
80096,3722,谢依玲,2018-06-20 03:10:00,3,3,0,没什么体验...
103704,3722,谢依玲,2019-03-04 10:39:48,3,4,1,有点凶，从来没有人可以加的上她的微信_(´ཀ`」 ∠)__ ，但是可以理解因为确实有太多人问她奇奇怪怪的问题了
104342,3722,谢依玲,2019-03-18 07:08:00,10,10,0,托长调，毫无体验，问她事情不看你一眼。小领导果然牛批
104984,3722,谢依玲,2019-04-01 17:26:11,5,5,0,更年期，屁事多
108043,3722,谢依玲,2019-05-14 00:39:13,5,5,0,脾气真的大啊，根本不会和你好好说话
108093,3722,谢依玲,2019-05-14 23:11:01,6,6,0,态度挺不好的，爱理不理，自以为是
116199,3722,谢依玲,2019-09-06 03:53:45,-5,0,5,很好嗯
163362,3722,谢依玲,2022-12-13 18:45:45,2,2,0,太差了
152670,3832,赵久强,2022-04-18 03:18:54,9,9,0,新生之友，带我入门机器人和ROS，带我参观实验室，鼓励我参加竞赛，真的是好老师
181340,3832,赵久强,2023-10-15 10:13:37,2,3,1,非常认真友善的年轻老师，我的SRTP和竞赛都是在老师那里搞的，老师同时还带着几门实验课，肯在学生上面花时间
219088,3832,赵久强,2025-05-21 08:52:56,0,0,0,预置了赵老师的自动化实训，10分mark一下，
87832,3978,刘之涛,2018-10-15 07:23:44,2,3,1,人很皮很逗，但是上数字信号处理真的上得不如自学，刘之涛小朋友感觉自己都没太拎清楚，基本和大一小朋友展示念ppt差不多。大家好好看书吧，上课听写玩玩就行。
102827,3978,刘之涛,2019-02-24 02:08:10,0,0,0,老师上课比较随意，去了可以不听，但是要去，讲课速度比较快，主要靠自己课后学，最后给分一般。
108886,3978,刘之涛,2019-06-03 15:22:49,-3,0,3,数字信号处理怎么样啊？
114281,3978,刘之涛,2019-07-09 17:15:17,1,2,1,口才还是可以的
114374,3978,刘之涛,2019-07-10 00:09:00,0,4,4,网络空间安全，最恶心的一门通识，没有之一
123006,3978,刘之涛,2020-04-29 13:04:38,1,3,2,真心不错，给分很好！
123138,3978,刘之涛,2020-05-12 04:23:08,14,18,4,机器人导论课，机器学习部分，不知所云，听课简直浪费时间！
125648,3978,刘之涛,2020-09-12 14:12:36,3,3,0,安全计算机系统。这课纯属浪费时间……大水课。上课科普，就一个project。
126856,3978,刘之涛,2020-10-25 06:48:22,3,3,0,感觉刘老师是无辜的，但是内容太多真的听不懂鸭，epa什么的就吹了一节课懂也没懂，全靠实验助教小哥哥全程carry……感谢小哥哥555
135058,3978,刘之涛,2021-04-28 11:34:01,0,0,0,机器人导论 讲的稀里糊涂 听是听不懂的 考前反复强调不会考代码 可是连他课件里的东西都没搞明白哈
139353,3978,刘之涛,2021-07-14 15:57:22,7,7,0,安全计算机大水课，涛涛讲课水平让这门课水上加水，三节课嘴皮子没闲着，一点干货没有。虽然课程质量差，但是不影响涛涛给分不好啊。大无语。
165773,3978,刘之涛,2023-01-09 15:39:02,10,12,2,不是针对谁，不行控院就别开人工智能这课了吧。
207177,3978,刘之涛,2024-12-19 14:57:47,4,5,1,24夏信息物理系统安全，另一个老师只上两周的课。没有小测，有时候会早八中间点名，然后实验课很无聊。给分比隔壁班好特别多，不知道为什么下一届选的人还是少
78408,3984,赵春晖,2018-05-11 11:27:20,-2,3,5,很棒的老师
78413,3984,赵春晖,2018-05-11 12:05:54,1,13,12,老师人非常好，给分也非常好！
78416,3984,赵春晖,2018-05-11 12:09:47,1,6,5,给分很高，老师很可爱
78429,3984,赵春晖,2018-05-11 16:11:13,-1,3,4,hin好
78535,3984,赵春晖,2018-05-12 16:28:07,0,3,3,...
78949,3984,赵春晖,2018-05-17 10:15:53,0,4,4,很好的老师，给分也非常好
88596,3984,赵春晖,2018-11-02 15:39:50,-3,3,6,这个老师是天使吧。
95089,3984,赵春晖,2019-01-18 18:54:34,-1,3,4,。。。
102630,3984,赵春晖,2019-02-15 05:41:28,3,6,3,老师自己很厉害，课程收获很大，但是讲课一般，除非自己有基础，否则不容易听懂，也不容易得高分
102831,3984,赵春晖,2019-02-24 02:16:30,1,7,6,老师非常努力的讲，但是有时候讲的让人一头雾水……老师很有水平，所以要求比较严格
107142,3984,赵春晖,2019-05-02 02:08:44,-2,3,5,事少给分好，期末展示也不怼人，最重要是讲话萌萌哒特别可爱
140694,3984,赵春晖,2021-09-15 06:37:04,9,14,5,讲课水平不错，但上课第一堂课公开评分标准有一条是印象分，鼓励同学内卷发言刷存在感混脸熟，专业课弄成思政那样真没必要。而且不要参考那个给分，由于老师之前给分太好被学院找了，现在会有些压分。另外大作业事情不少
142798,3984,赵春晖,2021-11-16 08:27:37,2,6,4,好可爱的老师～\n\n第一堂课我还以为老师才三十出头
142799,3984,赵春晖,2021-11-16 08:27:37,-3,1,4,好可爱的老师～\n\n第一堂课我还以为老师才三十出头
144952,3984,赵春晖,2021-12-26 04:36:15,1,3,2,。。。
144953,3984,赵春晖,2021-12-26 04:36:13,0,2,2,。。。
150968,3984,赵春晖,2022-02-21 11:44:48,1,2,1,有意思
157975,3984,赵春晖,2022-06-26 01:40:02,2,3,1,今年好像第一次开大数据的通识课，个人感觉对文科生很友好，没有特别深奥的内容，感兴趣的话可以当大数据应用的科普讲座来听。讨论课会以辩论赛的形式开展。另外赵老师很可爱，讲课很有趣，还没上科技创新通识的文科生可以冲！！
157977,3984,赵春晖,2022-06-26 01:57:09,1,2,1,赵老师人很好，今年新开的通识课对文科生真的很友好，讲课内容也比较好懂，老师会考虑到一些同学是文科生的，课堂形式也较为多样，有上课和讨论课，反正很不错！
157989,3984,赵春晖,2022-06-26 03:25:07,1,3,2,喜提通识最高分哈哈，超级nice的老师，只要你认真去，认真听，好好展示，一切都会超级棒
158058,3984,赵春晖,2022-06-26 13:33:58,0,1,1,大数据通识课有点无聊，但给分很好
159181,3984,赵春晖,2022-07-07 11:23:12,0,1,1,赵老师的大数据知识很丰富，边听课边写作业挺有收获，小组展示和平时作业量适中，老师给分挺好的
161274,3984,赵春晖,2022-11-03 07:32:46,37,44,7,关于自动化大数据课 老师鼓励内卷 上课疯狂想互动 莫名其妙小测 课程mooc极其浪费时间和精力 补选曾说不收电院的自动化。 上这课就挺折磨的，还不如去kaggle打场比赛
172965,3984,赵春晖,2023-05-10 12:27:12,0,1,1,真的无聊
173280,3984,赵春晖,2023-05-17 13:28:04,2,2,0,感觉老师水平不怎么够还喜欢评价，经常不仔细听同学发言。\n\n但是不怎么点名，慎选吧。
175481,3984,赵春晖,2023-06-25 07:26:57,0,1,1,大数据改变世界。事少，给分应该还行，我满了。这学期点了两次还是三次名，第一次小测算作点名。我平时去上课，就偶尔抬头看看ppt，对基本概念有点印象，小测不难。期末有个个人展示或者组队辩论赛，建议选组队辩论赛，任务量小还有意思。辩论赛我提前一个下午开始准备，基本就是写好稿子照着念，因为另两个同学也不给我发挥的空间哈哈他们太能说了。期末还有个大数据科普视频要做，五分钟。不难，我照着老师的ppt写文案，配上音乐和视频甚至还掺了好几张图片。要是实在不会做视频，专业的事找专业的人。
175828,3984,赵春晖,2023-06-27 01:35:03,0,0,0,上课一般，会有一点无聊，但是给分挺好的。
181462,3984,赵春晖,2023-10-18 07:35:52,19,20,1,莫名其妙小测，题目都听不清楚，搞个巨大教室，后面根本听不清，只能说逆天
181526,3984,赵春晖,2023-10-21 06:13:01,22,25,3,大数据解析与应用导论，专业课，快跑。\n\n节节课小测。\n\n上课几个人不听，可能是学生的问题。但大部分人不听（或者想听都听不太懂），我觉得是老师的问题。
181533,3984,赵春晖,2023-10-21 13:57:55,9,11,2,老师专业水平很好，讲课也不错。但感觉考核比如上课小测不规范，莫名其妙的不知道问的什么。而且最后的个人展示也只有6个人
181576,3984,赵春晖,2023-10-23 08:19:02,13,14,1,小测多就算了，就是希望能麻烦您把小测的题目打在ppt上，口述题目真的很绝望
181915,3984,赵春晖,2023-11-05 03:08:05,1,7,6,先预留一个8分，看看后面出分我再作更改\n\n单论大数据应用与导论这门课\n\n教室大，老师不带麦\n\n经常小测，小测题目口述，听不清\n\n期末只有6组展示，但不展示的也要做ppt\n\n还有线上mooc，还要写评论，写互评，纯浪费时间\n\n期末还有最后一次小测作为给分参考（算是期末考吧）\n\n老师整体较为亲和，但是偶尔有装x瞧不起学生的感觉\n\n总结：目前来看这课干货多，不硬但是事多不水。还是期待一下最后给分怎么样吧。要是给分也不行我只能说这课一无是处。
182137,3984,赵春晖,2023-11-10 13:02:52,4,4,0,我的评价是不行，隔壁英文班比我们班好多了，
182240,3984,赵春晖,2023-11-14 06:12:48,8,9,1,这老师太逆天了\n\n上的大数据导论，后期几乎每节课都小测……\n\n不是说反对小测，也不反对你想给大家拉开差距，但是你能不能整点让大家信服的评价准则……\n\n每节课课后5min口述小测题目都说不明白，还“什么是什么的什么”，这样的小测真的有意义吗？还nm倒计时321，真的666……\n\n你要是真的想拉开差距，大可认认真真小测一次，认认真真出个题目，谁知道你每天课后最后5min的小测在bb什么，话都说不明白，题也出不明白，评价方式过于主观随意……\n\n上课喜欢阴阳怪气，站在学生对立面，展示的时候疯狂diss同学，展示变成了吵架，还不给同学开口的机会，真的无语……\n\n蹲一下给分，如果给分也不行的话，那我对这课真的就无话可说了
182241,3984,赵春晖,2023-11-13 07:04:47,13,17,4,她能训好大小各种模型\n\n唯独训不好自己的脑子
182259,3984,赵春晖,2023-11-13 12:19:46,3,3,0,楼上骂得好，不知道这九点多的评分怎么来的，纯纯无语
182395,3984,赵春晖,2023-11-15 12:40:40,2,3,1,评分肯定是到不了9分的 不知为何这么高\n\n至少这学期的大数据课 体验并不好\n\n教室巨大 讲课还不用话筒 听不清 \n\n甚至在这种情况下还几乎每节课都突然小测 愣是口述题目不愿意把题目放在ppt上 说题目都不愿意用话筒 题都听不清 时间还特别紧 一到时间就走人 没交上的就不收了当0分处理\n\n题目设置的也怪 应该有些是自己出的 部分问题很模糊可能根本没什么标准答案 怎么判分估计得看她怎么想\n\n最后展示也不是很合理 只有6个小组可以 \n\n最后一节课还有个大的“小测”  \n\n还有声称“自主学习”的mooc  10个测试 10个作业 一个期末测试 还得自评互评  然而最后是要把mooc得分计入线上部分的成绩的 没好好弄的就寄 不过助教人太好了 会给你宽松一些\n\n还没出分 不好下结论 就这样吧
182824,3984,赵春晖,2023-11-20 13:08:23,1,3,2,给分还行，课上都是公式推导有点无聊，大作业对熟悉python和机器学习的方法有帮助，然后小测逆天，不过还是值得上的
182841,3984,赵春晖,2023-11-21 01:22:41,6,10,4,毫无评价体系，最后一节小组展示是在干什么啊？怼人大会？一学期教我们的课程知识不如最后一节课教给我们的怼人手段……\n\n小测又是什么东西？出的都是什么题啊，还搁这口述，讲也讲不清楚，就这些小测还要有区分度？还不如把大作业多弄点区分度。。。
182844,3984,赵春晖,2023-11-20 14:35:35,1,2,1,出分了，之前评价过，再回来评价一条。\n\n上课讲的内容确实是可以，能看出来赵老师自己确实是很擅长这方面的（毕竟就是做这方面的），但讲课技术确实有待提升。\n\n给分很不错，因为这学期不能做到全部展示，所以为了给分能有依据，搞了几次小测。\n\n但小测频率确实是高，仅口述题目也确实是多少沾点。
184873,3984,赵春晖,2023-12-24 01:32:17,-7,4,11,大数据如何改变世界。老师给分很好，给我满绩了，而且上课几乎不点名。考试也是用一节课开卷，内容都是ppt上的东西，你只要考前看一遍不要裸考就行。平时事情也不是很多，会有主动报名展示，但是我一次都没有展示过。我ppt准备的比较认真，展示主题也不是那种专业性很强的东西，都是和生活有关的，对文科生很友好。我是可能上上学期选的这课，时间有点久了，有点记不得了。这次选课又看到这门课，发现80个的容量只有20个人选，有点替好老师不值。虽然不知道她专业性上的如何，但是这门通识课个人认为大家还是可以冲一下。
192214,3984,赵春晖,2024-05-12 07:09:35,9,10,1,太push
192221,3984,赵春晖,2024-05-12 11:14:29,6,6,0,dinner
193091,3984,赵春晖,2024-06-03 11:16:04,7,9,2,嘴太毒 事还多\n\n被下面好评坑了
195254,3984,赵春晖,2024-06-27 12:45:54,1,5,4,大数据如何改变世界这门通识课挺不错的，能学到东西但也不是那么硬核，想上水课的请走开，或者不要乱评价。\n\n是长学期的课程，有几周不用去教室，完成mooc即可，事情也不是很多，中间需要交一个PPT，最后会抽几个人（或者自愿）进行展示，还有一次辩论赛（也是自愿，人不够随机抽），是可以加分的。不会点名，但会有两次（好像是）小测，假如你上课一点都不听的话，活该你一个字都写不出来……期末大作业是一个科普小视频，很早就会布置，有充足的时间准备，不过这门课不会教你怎么做视频，不过老师说可以借助ai工具，但需要自己改编、创作，给分应该挺好的\n\nPPT展示的话多说一句，赵老师是抱着学习的态度听大家的展示的，所以有些人的展示明显就是随便糊弄糊弄，让人听了跟听了一样，老师可能就会有些不满意\n\n赵老师是非常厉害的，她获得的荣誉一般人是难以想像的，但老师并没有架子，很平易近人的
201853,3984,赵春晖,2024-11-07 02:56:15,0,0,0,老师应该是会看查老师的，24秋上的大数据解析与应用，上课讲的很清晰（可以说是你控讲的最有逻辑的几门课程之一了），对于大作业好好做的话确实可以对机器学习和数据处理有一定认识，老师虽然会批判一些同学的展示，但总体还行，最后成绩超级好，特来刷个满分
201874,3984,赵春晖,2024-11-07 05:29:53,2,2,0,坐标24-25秋学期《大数据解析与应用导论》，今年和去年完全是两门课吧（笑）今年加上最后一次梳理学过的算法总共只有两次小测，而且题目都是放在PPT上的，没有口述。讲课确实很清晰，虽然不用话筒，但是总共选课人数只有40人，不影响听感。课上没有阴阳怪气，只是努力想跟我们互动，不过大家都上大三了确实互动的意愿不太强，老师真的就以为我们是不会才不互动的，然后进行一些调侃。最后展示确实是有点火力全开，第一个组的点评了很久，剩下三组都还好，没有很挑刺。最后给分给得很高。
202344,3984,赵春晖,2024-11-12 02:04:37,0,0,0,老师虽然嘴有点损，但人还是挺好的，给分挺不错的
219610,3984,赵春晖,2025-06-01 02:58:23,0,0,0,害   事情特别多   MOOC极其消耗时间   有辩论  还要制作视频等  想学东西的可以来   想水的还是选别的课吧
82702,4143,谢磊,2018-07-09 03:39:53,2,3,1,上课差 给分差
88056,4143,谢磊,2018-10-21 07:00:03,2,6,4,控制学院谢磊。ppt和shit一样，讲课的时候还觉得自己很聪明。真的佛了。
102466,4143,谢磊,2019-02-03 03:36:04,0,0,0,…………
128998,4143,谢磊,2020-12-28 07:06:32,2,2,0,ppt乱七八糟，讲的也乱七八糟，给分低
133055,4143,谢磊,2021-02-07 08:48:46,3,6,3,控制工程1，浓浓师生情，出分之后群里都举着小花谢谢老师。但这课从讲授到考试，确实存在着不少问题，课时少，电机部分极其浓缩导致学习效果差，考试涉及上课未涉及内容（但隔壁班讲过），考试的时候最后两道共计40分的大题基本处于不会写状态，只能多少写一些填满了事，这个考试差点让我当场心态崩溃。
133128,4143,谢磊,2021-02-09 05:47:52,0,3,3,老师人不错，不至于这么低分
133143,4143,谢磊,2021-02-10 09:25:11,0,1,1,老师上课还好吧，也没有之前评论里的读ppt情况。考试挺难的，但感觉老师和助教有在捞了
133970,4143,谢磊,2021-03-11 02:35:33,6,6,0,讲课水平较差
135365,4143,谢磊,2021-05-08 12:20:15,3,6,3,这门课删了吧好吗？好吗？
171166,4143,谢磊,2023-03-17 08:16:33,1,1,0,人工智能与机器学习，老师上课一般，反正我是从来没听过，对他的印象只剩下无糖可乐了（bushi），主要是这课的安排实在是依托答辩。不过他上课的时候也不太来管你。期末给分还行。\n\n但是人机这课如果谢老师还是和zjg老师搭班的话，建议快逃（
172907,4143,谢磊,2023-05-10 00:34:38,10,10,0,自己上的啥比课自己心里没数吗？给分给的一坨屎，上课更是答辩，最重要的是还很喜欢点名，还有哪个老师会第一节课就点名小测的？在我心中是控院倒数第一的老师。
172908,4143,谢磊,2023-05-10 00:34:02,24,26,2,谢磊老师特色课程\n\n简称谢特课程
173319,4143,谢磊,2023-05-19 01:36:55,3,3,0,系统辨识与滤波的课，都不知道在讲什么东西，这边 扯一点，那边扯一点.一遇到问题就是你们自己想
175194,4143,谢磊,2023-06-22 08:54:35,25,30,5,点名线下不到，不行；但是老师出差线上上课，行。\n\n你线上上课也可以，能不能把下A片的窗口关了，呕了。
175217,4143,谢磊,2023-06-22 12:47:44,3,3,0,这位更是重量级，上课依托答辩
175238,4143,谢磊,2023-06-22 15:53:01,1,1,0,我cnm，煞笔玩意
178753,4143,谢磊,2023-07-22 02:20:00,3,3,0,每节课纸质签到 出分慢得要死 一坨答辩
178754,4143,谢磊,2023-07-22 02:30:18,2,3,1,不管刮风下雨，次次纸质点名，答辩不在现场，给分简直鲨逼
184113,4143,谢磊,2023-12-09 16:26:12,5,5,0,以下主要针对课程：\n\n\n\n艹死你妈了，垃圾过控课，怎么这么多仿真作业和又臭又长的实验
186531,4143,谢磊,2024-01-11 13:42:29,5,5,0,可乐哥永远零昏
190918,4143,谢磊,2024-03-24 09:26:24,0,0,0,自动化导论讲得稀烂
193613,4143,谢磊,2024-06-14 02:32:24,1,1,0,你真的会上课，会和学生相处，纯纯辣鸡
193627,4143,谢磊,2024-06-14 05:05:46,0,1,1,大作业展示的时候，问东问西，一句话一打断。有个同学上台，标题都没念，他问人家PPT模板哪来的。向他展示大作业就是shit。
219837,4143,谢磊,2025-06-08 12:03:22,0,0,0,智能制造次次点名，不推荐。
79721,4250,喻洁,2018-06-13 04:56:54,0,1,1,老拖堂
134788,4250,喻洁,2021-04-15 06:43:27,0,4,4,差劲，差劲，差劲，布置作业一点数都没有，截止时间迷得很，中午的ddl，下午还有课，选了就要准备好不吃饭
136413,4250,喻洁,2021-06-17 15:41:17,0,2,2,快逃（
136720,4250,喻洁,2021-06-23 11:11:42,1,5,4,张光新的点名提问工具人。
139229,4250,喻洁,2021-07-13 11:26:23,0,1,1,课程内容完全配得上10分前面这个“1”，就是配不上后面那个“0”。
159374,4250,喻洁,2022-07-15 04:28:04,1,2,1,挺好的老师，可能是之前给zgx当工具人把风评搞坏了吧
170738,4250,喻洁,2023-03-09 02:24:19,0,1,1,sb666
174636,4250,喻洁,2023-06-15 02:23:25,0,2,2,纯纯nt，讲课一坨垃圾，还对学生有偏见，高高在上
174637,4250,喻洁,2023-06-15 02:23:34,0,1,1,离大谱，老师自己身为女性，对女学生的偏见还那么大😅😅😅
178472,4250,喻洁,2023-07-12 06:29:35,2,2,0,还可以吧，cmc班事情略多，给分一般性，也不算是特别差的老师
178477,4250,喻洁,2023-07-12 06:45:48,0,2,2,中规中矩吧，平时基本不点名也很少提问。给分的话感觉略求是，计控期末考完不难，但感觉身边人最后总评都很一般。
178781,4250,喻洁,2023-07-22 13:02:10,3,3,0,老师讲的也还行，事情一般般（比隔壁副院长班要少一些），就这课安排怪怪的，给分也还行
179403,4250,喻洁,2023-09-14 12:00:47,0,5,5,想打电话咨询一下，结果她超级不耐烦，5秒之内给挂了，无语，很难评！！！
197755,4250,喻洁,2024-08-09 15:39:59,3,3,0,个人感觉是计控的几个平行班内事情最少的，平常上课也基本上是放的最早的，给分个人感觉还凑合，对于计控这门课来说是推荐选的
143094,4252,张宏建,2021-11-19 02:24:44,3,4,1,什么玩意
143095,4252,张宏建,2021-11-19 02:29:40,0,2,2,上课点人回答思考题：我觉得你声音不够洪亮；我觉得你准备的挺好，为啥不脱稿…
159471,4252,张宏建,2022-07-22 08:38:52,0,1,1,上他的课很难发现他就是学校副校长，平易近人，不过他基本只上几节课，分也不是他给的
198930,4252,张宏建,2024-09-13 04:07:40,5,5,0,鼓励发言内卷 这种课有什么好发言的我请问
81273,4381,潘宇,2018-07-04 13:51:53,0,4,4,非常为学生着想的老师
82854,4381,潘宇,2018-07-09 08:28:31,1,2,1,不太会讲课
84033,4381,潘宇,2018-07-12 01:27:14,0,4,4,c++喜极而泣。
123115,4381,潘宇,2020-05-11 02:15:51,3,4,1,真的不会讲课。人脾气还是很好地。
124447,4381,潘宇,2020-07-01 10:22:41,0,3,3,课程难度和作业量不大，属于C++简单入门\n\n老师也挺和善的，不过讲课水平一言难尽\n\n这课坑点在于大作业（50%）老师是强制分组的，所以说如果被分到的组差劲的话，老师扣分是非常狠的，建议组队谨慎，队长不负责的话及时独立山头\n\n——一个因大作业队友划水而惨遭绩杀的菜鸡
124491,4381,潘宇,2020-07-02 02:25:26,1,5,4,讲课水平很低。大作业扣的分数是平时所有作业+期末作业总和的6倍，占比还是50%，惨遭绩杀。
124580,4381,潘宇,2020-07-03 07:56:56,0,3,3,讲课水平确实不行。楼下说老师强制分组是什么意思？老师人还是不错的，组队可以自由组队，你想单干的话分组的时候一人成队老师也是允许的，组队人数并没有要求
149898,4381,潘宇,2022-01-17 15:34:52,0,1,1,讲课一般，但要点都能够讲到，会亲自指导作业，人很不错，考试成绩不好是我自己的问题。
161028,4381,潘宇,2022-10-24 09:01:08,-3,0,3,先打分后上课
165622,4381,潘宇,2023-01-09 04:38:09,1,1,0,oop讲课一般给分一般比较水
165668,4381,潘宇,2023-01-09 07:49:42,2,2,0,感觉可能会比较看重报告？给分很一般
165988,4381,潘宇,2023-01-10 15:15:07,1,1,0,讲课水平有待提高，不过人蛮好，给分也就那样吧
188496,4381,潘宇,2024-01-19 05:45:47,0,0,0,给分一般般
211385,4381,潘宇,2025-01-11 09:54:19,1,1,0,傻逼东西我操你妈，小朋友们记得壁垒\n\n\n\n给分非常烂，调分随便调，大作业95，平时作业扣10分，总评扣3分，然后调完之后只有92，真你妈会调哈\n\n\n\n哦原来是所有人考勤都扣分，并且只要过了教务能提交就行，学生多少分关他p事啊，反正班上最高分94是吧哈哈哈哈，好像同学们分高了跟要了他命一样
78542,4543,朱秋国,2018-06-11 03:47:45,2,3,1,老师很棒
79241,4543,朱秋国,2018-05-28 10:55:47,5,7,2,好听嘻嘻不错
87114,4543,朱秋国,2018-09-20 12:13:42,8,8,0,十分享受
105302,4543,朱秋国,2019-04-09 12:21:26,4,6,2,好老师呀
106558,4543,朱秋国,2019-04-28 06:30:58,4,4,0,很好啊
118167,4543,朱秋国,2019-10-22 03:06:08,5,5,0,很好啊
128915,4543,朱秋国,2020-12-26 17:29:19,4,4,0,挺好的，讲课还行
152597,4543,朱秋国,2022-04-15 12:18:05,1,1,0,很好的老师
153775,4543,朱秋国,2022-05-10 13:39:14,1,1,0,挺好的哦
76448,4604,朱豫才,2018-04-09 12:25:52,1,2,1,听不懂啊啊啊啊啊啊啊啊啊啊
77762,4604,朱豫才,2018-05-07 15:06:51,4,4,0,听不懂 作业难 给分差
87253,4604,朱豫才,2018-09-26 06:35:59,1,2,1,听不懂的体验
87577,4604,朱豫才,2018-10-07 14:24:16,1,2,1,感觉很不妙啊
89623,4604,朱豫才,2018-11-20 04:31:05,-3,3,6,老师是从荷兰回来的老教授，在系统辨识界也是比较厉害的大牛。人很不错，除了上课还喜欢给我们讲他求学和开公司期间的故事。唯一的“不足”可能是他的汉语有点遗忘了哈哈。另外这门课给分还是不错的，在专选里难度也比较小，可以选选看。
89741,4604,朱豫才,2018-11-20 13:17:25,0,2,2,讲的东西很深，入水需谨慎\n\n
103125,4604,朱豫才,2019-02-26 05:40:01,-1,2,3,作业没有那么难，书上有例程的，给分也不错的，平时听了期末不会差，而且期末考很简单
108975,4604,朱豫才,2019-06-05 02:38:09,-5,0,5,把很深的东西讲得比较浅，很容易产生兴趣，本身实力很强的老师。
118227,4604,朱豫才,2019-11-13 14:15:29,2,3,1,豫才司马
118555,4604,朱豫才,2019-10-28 12:26:15,3,4,1,给你加一分
118667,4604,朱豫才,2019-10-30 08:16:48,2,2,0,给你减一分
118827,4604,朱豫才,2019-11-06 15:37:22,0,1,1,朱老师其实挺好的，上课不点名，就两次作业，也不难，这课总体比较轻松。但是迷的是很可能不知道他在讲些什么，他的教材比较偏工业届，对于本科生稍显有点前沿。另外系统辨识也是比较冷门的领域了。总之如果水一门选修课还是不错。
119991,4604,朱豫才,2019-11-17 03:53:46,4,4,0,其实讲的还行。课挺硬核。给分一言难尽
119993,4604,朱豫才,2019-11-17 03:54:18,0,2,2,上课不用去也学不会，如果为了加五分课堂发言可以去， 靠大作业预习课程知识体系，靠考前突击掌握课程知识体系，其实课堂发言很重要，要是能加五分就能满了==
119996,4604,朱豫才,2019-11-17 03:59:03,6,6,0,老师不坏，但很蠢；给分玄学：不要选。上他的课你会感觉被强奸……
120113,4604,朱豫才,2019-11-17 13:35:04,4,5,1,垃圾室友跟我做的差不多，咋就分数差这么多呢？难道因为字比我好看？玄学，垃圾室友，还要过来给我点踩，过分！
181565,4657,张宇,2023-10-23 03:43:46,10,14,4,一言难尽
88223,4822,吴争光,2018-10-24 08:20:09,0,0,0,垃圾至极
88663,4822,吴争光,2018-11-05 06:33:10,-1,0,1,读ppt，完全听不懂
144770,4822,吴争光,2021-12-23 13:34:03,1,1,0,急急急
153221,4822,吴争光,2022-04-27 00:41:57,0,1,1,除了念ppt就是叫人上去，完完全全靠自学，nt老师，
155027,4822,吴争光,2022-06-07 15:09:55,10,10,0,虽然他的上课水平确实很烂，我不好评价。但是从来不点名，事情很少（相较于何衍和梁军），何衍的上机作业很多，梁军竟然还有思政讨论课。。。\n\n总之我感觉整个运筹学这门课设计都很有问题，专业基础课的2学分配置，学分少，课时少，讲课也不深入，都是一带而过。想要真正学习到深入知识的建议选 数院的数学建模\n\n或者妓院的应用运筹学；想要稍微了解一下，时间比较多，认真好学的可以尝试一下何衍；比较摆烂，想要水课的，课时比较忙的，建议选吴争光。至少事情少，很舒服
159149,4822,吴争光,2022-07-07 00:17:21,0,0,0,真的差劲，讲的稀烂，不负责任，给分巨差
109047,4981,倪东,2019-06-06 06:40:47,5,6,1,自娱自乐
122644,4981,倪东,2020-03-11 04:10:08,14,15,1,形式主义的东西很多。虽然网课也有一定影响，但是上课水平确实不怎么样，而且内容本就很枯燥的一门课，他又是一种棒读的方式讲课，真的让人把持不住。
122698,4981,倪东,2020-05-16 06:19:27,32,36,4,讲得什么玩意儿？书上本来就抽象，宁就跟着抽象吧，除了书上的例子，一道例题都举不出来，在下佩服这位英特尔主任工程师！为什么期末平均分不及格？这问题应该问问宁自己吧
122805,4981,倪东,2020-04-08 06:52:55,13,13,0,不知道在讲啥，有点懵，可能这里本身就很抽象
122853,4981,倪东,2020-05-19 16:12:57,15,15,0,本来课还能听个大概，就是作业完全懵掉，现在连上课都是完全听天书了，，还要线上考。。。
123054,4981,倪东,2020-05-06 16:14:23,21,23,2,听不明白作业不会小测不会QAQ真是一个刻骨铭心的春天
123222,4981,倪东,2020-05-21 08:32:14,12,12,0,这就是控制专业两个方向其中之一的必修基础课过程建模吗，爱了爱了。
123234,4981,倪东,2020-05-22 13:54:01,11,12,1,看不出来过程建模这个课程的逻辑，东讲一点西讲一点。前面化工原理部分还能听懂，就是作业跟上课内容脱节，后面就越讲越玄，完全不知道自己要学什么。ppt也会复制粘贴教材内容，讲课就是把英文教材翻译一遍，各种意见在课题反馈里面提了大半学期，一点效果也没有。谁让过程建模是必修课呢，只能硬着头皮学
123266,4981,倪东,2020-07-29 14:45:54,11,12,1,感谢老师调分...虽然不知道学到了什么
123324,4981,倪东,2020-06-03 08:04:42,7,7,0,反馈了，有用吗？
123558,4981,倪东,2020-06-10 02:19:21,13,13,0,别的不说了，听了他一学期的湍（chuai 三声）流（liu），很想笑，笑着笑着就哭了
123746,4981,倪东,2020-06-13 09:11:55,11,11,0,讲课逻辑？么有的\n\n例题？么有的\n\n小测？每节课都有的
123999,4981,倪东,2020-06-20 02:19:17,10,10,0,听学长说，这课学的以后没用...\n\n那我就放心了！
124024,4981,倪东,2020-06-20 16:10:17,10,10,0,湍tuan流，湍tuan流，湍tuan流，湍tuan流，湍tuan流，湍tuan流，湍tuan流，湍tuan流，湍tuan流，湍tuan流，湍tuan流，湍tuan流，湍tuan流，湍tuan流，湍tuan流，湍tuan流。
127112,4981,倪东,2020-11-09 03:10:02,17,22,5,对不起倪东老师。。。\n\n原来觉得过程建模学不懂，觉得这课烂\n\n等我到了大三我才发现，原来相比起来，过程建模还不是那么烂
134361,4981,倪东,2021-03-25 01:31:33,4,4,0,讲的迷迷糊糊
134367,4981,倪东,2021-03-25 02:17:10,9,9,0,讲课讲不完，小测考的难，作业抄答案，绩点真难看
134620,4981,倪东,2021-04-06 05:40:57,7,7,0,AMD Yes！
134650,4981,倪东,2021-04-07 14:28:58,19,20,1,他会读湍（tuan）流了！！
134657,4981,倪东,2021-04-08 01:35:46,2,2,0,讲的一塌糊涂，没人能听懂他在讲什么
134659,4981,倪东,2021-04-08 02:06:58,10,10,0,我不知道是不是系统建模与仿真(据说之前叫过程建模)的问题，实验课一个半钟头，一小时多讲理论，二十来分钟用MATLAB建模。但问题来了，老师讲的理论好比书的目录，我要怎么通过学目录建模。如果要预习自学，也不知道预习哪里。整个班都不知道有没有人把实验写出来。太绝望了。
134673,4981,倪东,2021-04-08 07:54:50,10,10,0,快逃，选信号分析吧别选这个了
134774,4981,倪东,2021-04-14 13:28:18,-5,3,8,楼下那位，实验课有大佬写出来了。但是他上课没听而且从上课就开始做了hhhhhh
134966,4981,倪东,2021-04-25 09:23:28,2,2,0,纯理论，啥也听不懂，建议别选
134986,4981,倪东,2021-04-26 02:09:54,-34,5,39,给能源开的课给分好，讲课好，作业也不算太麻烦。\n\n重要的是，倪东太帅了！！！每次上课班里女生都要开心
135890,4981,倪东,2021-06-01 05:29:42,12,12,0,妈的，绝不出来了！\n\n这学期的课上到现在，唯一一次没有小测的原因是——测验本忘带过来了
136587,4981,倪东,2021-06-21 11:20:33,1,1,0,烂死，千万别选
136855,4981,倪东,2021-06-26 03:16:58,0,0,0,太差了
137791,4981,倪东,2021-07-06 06:52:57,0,0,0,快逃，别选
138066,4981,倪东,2021-07-07 08:42:16,4,4,0,退钱！
139586,4981,倪东,2021-07-17 15:44:30,10,10,0,最后奖品竟然是哈根达斯！
141525,4981,倪东,2021-10-13 07:35:57,2,3,1,倪东老师挺好的，主要助教们很帅很负责！学到很多知识！
144754,4981,倪东,2021-12-23 12:42:26,0,0,0,大概还有
145595,4981,倪东,2021-12-30 11:39:43,3,3,0,老师人是很好的，也很和蔼，应该是课的原因吧。
146418,4981,倪东,2022-01-06 14:19:20,9,10,1,对不起倪东老师，原来觉得系统建模与仿真学不懂，教材也抽象，觉得这课烂。\n\n等我到了大三我才发现，原来相比于大部分专业课来，系统建模真是好得太多，给分也好。都是我没见识，只上过别的学院开的课和自控，错怪了老师。\n\n不过感觉讲得还是没有后面的过程控制明白。
147748,4981,倪东,2022-01-10 16:09:48,19,21,2,对不起倪东老师，之前给你打低分觉得你不行，课听不懂还天天小测。到了大三才明白，什么才是真正的屎课……给倪东老师道歉，真心希望倪东老师越来越好！
150473,4981,倪东,2022-01-26 04:56:05,8,10,2,人工智能给分最良心的老师了吧，其实倪东老师给分一直很好哒！
162360,4981,倪东,2022-11-21 02:24:55,3,4,1,人工智能课讲课清晰，不拖进度，每节课数字点名，体验较好
165845,4981,倪东,2023-01-10 05:36:25,1,1,0,是个好老师，希望给分好点
168146,4981,倪东,2023-01-30 07:06:34,-7,2,9,跑！快跑！
170415,4981,倪东,2023-03-04 07:30:46,8,8,0,人机课最好的老师，逼事少，上课体验不错，给分也还不错
170517,4981,倪东,2023-03-06 04:55:01,13,14,1,老师讲的比较清晰，其实给分也很不错（就是出分的时候出了一点乌龙导致一开始大家看到的分比较低，后来老师又把分加上去了），课程体验挺不错的，但这课的考试真的一言难尽
189882,4981,倪东,2024-02-01 05:37:11,2,3,1,每节课点名，给分不错，叶琦老师上的好\n\n就是课逆天。。
190001,4981,倪东,2024-02-07 14:17:56,0,0,0,感觉给分不太好，平时分给了88（占60%），问了老师说主要是四个mo平台作业分数低，但个人感觉完成的并不差，都认真做了而且平台测试结果也可以，之前问过助教，助教说这部分作业只要做了就给分不低的，但看最后分数组成好像并非如此，感觉没有达到预期吧。
86510,5157,任沁源,2018-09-17 02:59:52,15,17,2,老师真的很不错
88098,5157,任沁源,2018-10-22 07:08:42,6,6,0,非常好的老师
104431,5157,任沁源,2019-03-20 07:02:03,6,6,0,非常棒的老师
107838,5157,任沁源,2019-05-10 10:40:50,6,6,0,好老师。
107839,5157,任沁源,2019-05-10 10:40:50,6,7,1,好老师。
111689,5157,任沁源,2019-07-02 14:15:31,1,4,3,老师人非常好?
129346,5157,任沁源,2021-01-04 11:36:01,0,3,3,老师挺好的，考试也比较基础
135545,5157,任沁源,2021-05-13 06:39:33,1,2,1,任老师给分很好的，实验好好做，很收获到很多东西
160048,5157,任沁源,2022-09-12 09:44:00,2,2,0,老师很好
162553,5157,任沁源,2022-11-25 07:02:12,0,0,0,是个好老师
163657,5157,任沁源,2022-12-16 02:10:25,3,3,0,信号班里是一堆机器人大佬，每次老师：“是这样”（手指比个一）“变成这样”（空中画个三角形），“懂了吧”；台下就会有大佬们点点头，然后就下一页PPT了。。。WHAT... 不过老师人是挺好的，只是教学班同学实力太强，外专业被带飞，喜提最低绩点:)
173398,5157,任沁源,2023-05-23 05:45:51,0,1,1,空中机器人出分来评论一下\n\n给分还行，但没有别人说的那么好，实验的给分有点迷，没有什么明确的标准，感觉主观性极大。
174374,5157,任沁源,2023-06-11 07:27:08,1,2,1,上了任老师三门课，三门课都没怎么听，给分倒是出奇地一致，说不上好坏吧\n\n总体来说是好老师，但机建英文班有点顶
192365,5157,任沁源,2024-05-16 18:36:19,8,25,17,在此立誓：我22机器人wyr要去任老师实验室读研究生！
193404,5157,任沁源,2024-06-09 14:46:11,8,11,3,楼下哥们加油
196738,5157,任沁源,2024-07-05 02:50:18,7,9,2,老师人挺好的，但是短学期参观企业的时候比较拖延，废话比较多没有时间观念
207406,5157,任沁源,2024-12-21 09:41:40,3,3,0,感谢任老师捞我
214374,5157,任沁源,2025-02-02 12:22:04,1,1,0,是好老师
218898,5157,任沁源,2025-05-12 06:03:40,2,2,0,感谢捞捞✋😭🤚
218906,5157,任沁源,2025-05-12 13:19:30,1,1,0,机器人导论给分还不错，上课挺水的，但是闭卷考试，如果大作业也要认真完成的话，任务量其实并不小。另外，有专业上的问题可以勇敢向任老师请教hh，老师人很nice
218948,5157,任沁源,2025-05-14 16:04:02,0,0,0,机建\n\n课上的很好，可惜我英语太菜了\n\n很负责任的老师\n\n海底捞的神
219060,5157,任沁源,2025-05-20 06:19:35,0,0,0,机器人导论： 可能还是以基础理论知识为主， 组队机器人设计 + 闭卷考试。 跨专业感觉并没有真正学到什么东西， 不过老师都挺好
171700,5234,孙优贤,2023-04-02 12:02:48,3,4,1,久仰孙院士大名
151824,5256,徐巍华,2022-03-17 02:12:09,1,1,0,听不懂
153707,5256,徐巍华,2022-05-09 02:54:42,0,0,0,呵呵呵
157642,5256,徐巍华,2022-06-24 07:38:03,3,5,2,老师人挺好的，可能刚开始讲自控，不大熟练，感觉得出来老师在努力讲
160840,5256,徐巍华,2022-10-17 02:44:55,1,2,1,老师讲课水平确实有待提高，但是态度很好，讲课很努力很认真，对同学也很好，平日里偶尔课堂练习当点名，也会告诉答案。习惯自学的话选她的课估计挺好hhh
192433,5256,徐巍华,2024-05-19 14:58:47,1,8,7,讲课稀烂，萎得要死。天天惦记那个B点名？我得评价是，靠点名维持到课率的课都是史。讲的不好还要逼人来上课，呕~
192781,5256,徐巍华,2024-05-30 10:35:39,0,5,5,讲课不行，喜欢点名，人还不错，不过不建议听她的课
192933,5256,徐巍华,2024-05-31 16:48:12,0,3,3,讲课确实很差，上她的课建议自学。\n\n另外，经常点名、小测。我已经基本放弃签到的平时分了。\n\n不过课程本身有难度，建议用功学学。
196212,5256,徐巍华,2024-07-02 08:43:47,1,6,5,底下说点名的还要脸不？五十个人的课，每次八点到了教室里的人都是个位数，再说很多次都是同学起哄要点名
208585,5256,徐巍华,2024-12-29 16:34:32,2,2,0,爱点名的老师就是史，五十个人只到个位数不想想自己的原因？两个老师轮流上课就你点名，是不是觉得自己好不容易来上课了得赶紧点个名才舒服啊
173461,5265,贺诗波,2023-05-25 08:36:55,4,5,1,口音很重，讲课听不懂，说话有时候也听不太懂，上课会点名叫人回答问题，快逃！
173582,5265,贺诗波,2023-05-29 11:06:42,1,2,1,依托答辩
218616,5265,贺诗波,2025-04-27 03:44:31,0,0,0,纸质点名+花大量时间叫人回答问题……难评
126540,5358,王文海,2020-09-30 02:37:11,8,12,4,研究生课，老师人真的很厉害 融汇贯通，知识海纳百川
156131,6099,阮伟,2022-06-17 19:00:33,1,2,1,挺好的~~~
161783,6099,阮伟,2022-11-13 08:44:36,2,6,4,工程管理专题讲座事少（只有一次简单的期末作业和最后的项目方案展示）给分狠好！！阮伟老师感觉也是个挺有人格魅力的人~上课的内容也是可以得到一定启发的
177329,6099,阮伟,2023-07-03 02:30:12,2,4,2,阮老师一身正气，挺具有人格魅力的
181615,6099,阮伟,2023-10-24 09:46:05,5,6,1,“十六个小时你能记住我讲的一句话就够了，只要有一句话触动到你就够了”\n\n大赞
204019,6099,阮伟,2024-11-23 06:00:21,0,1,1,课是真水，分高事少，89/4.5
124947,6177,周成伟,2020-07-25 08:10:09,0,6,6,棒棒哒嘻嘻
125524,6177,周成伟,2020-09-11 03:10:21,-2,9,11,人超可爱 长得像个学长 很活泼 hohohoho 爱了爱了
141947,6177,周成伟,2021-11-01 23:55:23,15,29,14,脾气很差
153086,6177,周成伟,2022-04-25 06:11:58,3,12,9,上了老师的信电导，备课很认真，而且很关心同学们成绩和未来规划。平常也没有额外的负担。是个好老师！
153288,6177,周成伟,2022-04-27 13:37:16,0,8,8,周老师yyds!就课程内容而言，非常适合工信大类的大一新生了解专业，也对之后电子电路类专业课入个门 老师讲的很细致 作业不是太多，最后搭加法器的大作业有点累人，需要有两个靠谱的队友 我的话全程到课，考前一天过了一遍ppt和学在浙大上的题目，最后满了，祝学弟学妹们也能取得好成绩！
153303,6177,周成伟,2022-04-28 00:53:46,-8,4,12,很难不给满分
153307,6177,周成伟,2022-04-28 01:33:36,1,11,10,从性格来讲，当之无愧的好老师；从讲课水平而看，有趣，上他的课不会有压力；从给分来讲，一半以上的90分；最后，这门课考试难度远远小于上课难度，所以上课听不懂完全不用担心。对了，老师很年轻，喜欢笑，卡哇伊哈哈哈。
156192,6177,周成伟,2022-06-18 06:21:57,-10,4,14,老师特别棒，强推
156485,6177,周成伟,2022-06-20 03:20:47,-11,2,13,老师超级棒！！爱了爱了
162739,6177,周成伟,2022-12-05 11:42:25,11,16,5,课还不错，情商是真的不行
166012,6177,周成伟,2023-01-10 17:34:50,1,9,8,信电导，好课！\n\n老师讲得很好，上课经常讲书上没有的知识的，会强调考试的易错题，但是信电导终归是导论课，内容很杂很广，虽然期末开卷还是要对书本内容有一丢理解，这些都是后面的课的最基础内容，只恨当初大一没有选啊。\n\n楼下有说老师脾气不好的，个人不是很赞同，我和老师交流过几次，老师很友善，有问必答。而且线上课老师提问很少有人回答，我都替他尴尬，但是他从来没有生气。
168342,6177,周成伟,2023-02-13 01:06:31,5,12,7,情商太低了😂
177652,6177,周成伟,2023-07-04 05:23:57,0,4,4,IT直接选zcw就完事了，突出一个事少给分好（至少20级是这样的）
185225,6177,周成伟,2023-12-27 07:14:06,3,6,3,很活泼开朗的老师，很喜欢他的课
185895,6177,周成伟,2024-01-05 14:17:17,3,8,5,考试前先给老师打个10分，上课非常幽默课堂气氛很好，老师人也很温柔细心一直在笑，没搞懂上面说老师脾气不好的点（？）最后验收大作业的时候和我们说要加油可以拿满绩哦，很好的老师信电 导必选！!
196155,6177,周成伟,2024-07-02 01:50:27,9,10,1,IT真的是信电的垃圾课。什么东西都学不到，尽在课上讲一些废话。\n\n老师人看起来倒是蛮和善的。\n\n给分也是真的差82/3.6\n\n成绩组成也逆天\n\n5%慕课\n\n10%课后作业\n\n10%点名（以随机小测的形式进行，点了两次）\n\n上面这些还好\n\n真正逆天的是下面\n\n课程研讨20%。就是做展示两次。然后需要互评，根本就没人会去听你讲的好不好，因为同学之间在展示之前全部互相说好了关系好的互相打高分\n\n以及55%的期末开卷考。在超级多的PPT内翻题目。单选题20个，多选题10个，判断题10个，主观题好几个。纯纯逆天课程根本来不及翻\n\n给分很差。垃圾信电，马上大四了还开这种bird课
210956,6177,周成伟,2025-01-11 14:47:09,2,3,1,信电导 老师人很友善，答疑也很热心，给分很捞www
134831,6349,郑华荣,2021-04-17 12:28:59,13,15,2,歧视学生
152276,6349,郑华荣,2022-04-01 06:57:55,18,20,2,信号与系统实验课几乎什么都不讲。。。
152278,6349,郑华荣,2022-04-01 07:35:42,12,12,0,实验课就没怎么讲，就是让自己做题，啥也不会😅
171141,6349,郑华荣,2023-03-17 02:27:25,18,18,0,无语了，是不是不知道自己课讲得很烂啊。。。上课非点人回答问题，逼着学生听课。。。\n\n另，海院的信号与系统，全都照搬mit，连ppt都懒得翻译是吧，搁着让学生听英文，平白制造点学习障碍。。。
171156,6349,郑华荣,2023-03-17 06:07:06,8,8,0,伞兵海院信号与系统😅
172116,6349,郑华荣,2023-04-20 02:18:12,10,11,1,用依托答辩来形容她的课真是再合适不过
216877,6349,郑华荣,2025-03-28 01:18:07,0,0,0,两节实验课八成时间就干坐着让学生在下面自己写，那我特么还不如不来
189923,6479,孙铭阳,2024-02-02 10:49:48,0,0,0,好好好，信安导给分真好啊
124951,6486,邓瑞龙,2020-07-26 00:59:30,-2,9,11,非常好！
124952,6486,邓瑞龙,2020-07-26 00:59:51,-4,7,11,邓老师是男神 上课认真负责
152033,6486,邓瑞龙,2022-03-23 14:32:51,-7,2,9,给班主任一个大大的十！
154902,6486,邓瑞龙,2022-06-06 15:30:49,-7,1,8,邓老师，我的邓老师，嘿嘿🤭
154903,6486,邓瑞龙,2022-06-06 15:35:19,-4,3,7,好老师 事少 给分还不知道 自动化的ai*big data的课只能说懂得都懂 是自动化的锅 顺便心疼一下邓老师cps顶着可怜的到课率依然保持上课热情（虽然我也翘了） 向老师道个歉 但是这个狗屁专业的课程设置真的太不友好了
155745,6486,邓瑞龙,2022-06-15 13:04:17,-8,0,8,老师挺好的
157042,6486,邓瑞龙,2022-06-21 17:10:37,-12,1,13,老师给分好好
197485,6486,邓瑞龙,2024-07-16 17:42:16,7,7,0,23-24春夏上的，等了一个月终于出分，简单评价一下吧。\n\n1.点名：首先本学期开始加入了点名，点名方式非常抽象，对着名单报名字点，每次点名只点1/5的同学（第一次点点名册上序号除以5余0的同学，第二次点余1的同学，以此类推，本学期应该总共点了4次，也就是说最后有一部分同学没被点到？），迟到的同学允许补签，但会标识“迟”（无论是迟了几分钟还是一节课都一样）。\n\n2.课程内容：课程内容是本课程最为逆天的部分，感觉要么完全听不懂，要么完全没干货（纯通识性质），导致上课学不到任何东西，小测过后班上每节课都是10人左右的到课率（总共70+人）。加上没有任何作业反馈，上课内容又和大作业没有关系，导致你想学东西都难以学进去。。\n\n3.小测：第四次课上会有小测，内容为密码学的相关内容，小测14题，占比总评14%，学在浙大上完成，开卷。题目每一届都一样，相当于送分。\n\n4.实验课：最后本学期开始加入了所谓的“实验课”，实验课从第三周开始，内容是老师和助教在紫金港机房，啥也不讲，负责答疑。一点讲解不给也就算了，还会在实验课上点名！\n\n5.附加题：附加题是一道简单的反汇编的问题，也是我个人认为我在本课程上唯一学到的东西，不知道能加多少分。\n\n6.大作业：老师给了很多题目，有的是综述类（分析安全事件等），还有一些实践类（实际上有些实践类也跟综述类差不了多少）。\n\n关于给分的话，个人感觉比较随机，由于大作业2页A4纸，并不能完全体现所做的工作。我本人只拿到了4.2（认真完成大作业+报告+附加题正确），身边有同学拿到了满绩，不知道是扣在哪里。\n\n关于改进意见的话，个人觉得应该给一些非常详细的实验指导文档（而不是仅仅丢一个github代码链接），或是多设置几个类似附加题这样的平时小作业加深知识理解，而不是仅仅主观地按照一个占比巨大的大作业来评分。\n\n总结来说，这门课目前就内容上来看绝对是门烂课，但想水学分可以选。
197489,6486,邓瑞龙,2024-07-17 02:17:20,17,17,0,根据身边统计学，只能说隔壁班给分要好得多……不知道之前为什么会有那么多鼓吹。快逃！！
197505,6486,邓瑞龙,2024-07-17 17:16:08,6,7,1,小测你要按一空一分计入总评，那你就监考，你就别测得水水的让作弊丛生。总之对你这小测很有意见。点名抽象的事楼下已经说了。隔壁班没有小测，楼下说小测送分的让人伤心：（\n\n\n\n本班的两个大作业，根据平均分来看平均扣了十几总评（代码查看的），加上小测，只能说显然不是给分好的那批。也不懂为什么一个个人大作业能有人给满分有人直接总评去了20分（最低分），一门专业课讲得极水啥也学不到，给分又迷惑又狠，真不知道开了是干什么的，专业课就没拿过这么低的分。对比之下本学期学的另一门选修计网课程质量比这门课高太多了。\n\n\n\n附加题反汇编，也没人讲，自己去做倒是不难，附加题只有一分，约等于没有了。
202182,6486,邓瑞龙,2024-11-10 12:19:53,5,5,0,难评。
214042,6486,邓瑞龙,2025-02-11 07:55:09,15,15,0,哥们你啥时候出分啊……讲课倒是没讲但是课程挂你名下 那分也是你来打的吧 大作业截止已经13天了老师你在干啥……\n\n信安导大作业1.10截止，2.11才出分，给分还差……不愧是你
214231,6486,邓瑞龙,2025-01-30 02:32:58,8,8,0,死活不出分
214232,6486,邓瑞龙,2025-01-30 02:47:56,8,8,0,能不能出分啊
214430,6486,邓瑞龙,2025-02-03 03:40:57,7,8,1,是在和上课的老师商量谁来打分吗拖这么久还不出
214526,6486,邓瑞龙,2025-02-11 08:25:33,6,6,0,出分慢，给分差
214527,6486,邓瑞龙,2025-02-11 08:46:51,4,5,1,《信息安全导论》\n\n1、出分极慢，1.10截止的大作业，2.11才出分😅。\n\n2、考核是百分之40的大作业和百分之60的平时分。百分之60的平时分不知道咋给的😅（本学期实际上1，2，3，6周由王聪老师负责，每次课必学在浙大二维码点名，课上有少量发言加分；4，5周由赵成成老师负责，不点名没有互动。最后两周为大作业展示，第7周王聪老师打分，第8周邓瑞龙老师打分，也是本次课程邓老师唯一出场的地方😂）\n\n3、课程内容是控院经典的大作业和上课内容完全没有半点关系，连王聪老师自己都吐槽这个ppt是十几年前的老古董。不需要听，大作业需要纯自学，助教不会给任何有用的指导，问他他就说自己想办法解决，我可真的谢谢你（不过感觉可以参考历年展示智云回放）。感觉上课内容和信息物理系统安全比较重复，完全不理解控院开这些课干啥，上完这个和信息物理系统安全总共4.5学分其实啥也没学到（真不如开一门有点干货的课程，隔壁计网就很不错，能学到很多的东西，给分也很公平）\n\n4、给分的话个人感觉非常主观随机，王聪老师说给分会参考选题难度，但感觉实际执行起来并不是很客观。我有同学选了第四题（CTF），可以说是难度非常大（甚至题目描述中第二题都是做出结果即可），和上课内容完全无关需要自学大量内容，他最后第一小问用了6种不同方法，第二小问正确做出结果，最后却只拿到了86/4.2，不知道给分的标准何在。\n\n5、总结就是水学分可以，工作量的话选中等难度的题目也不算很大，想真的学到知识的慎重选课（记得想办法应付点名）。
214530,6486,邓瑞龙,2025-02-11 09:15:16,-10,0,10,事少给分好
214546,6486,邓瑞龙,2025-02-12 04:51:02,6,6,0,居然还记得在开学前出分……\n\n\n\n信息安全导论，一门比信息物理安全系统更水的课。分数构成为平时+小组大作业。但是平时无作业，只有点名，不知道怎么给的。小组大作业是六个给定的题目自选，难度不太一样。\n\n\n\n课程挂在邓瑞龙老师名下，1-6周上课，7-8周大作业展示。实际上授课主要由王聪老师负责，有点过时，很水。第七周王聪老师看展示，第八周邓瑞龙老师，不确定二人有没有统一打分标准。\n\n\n\n给分有点迷
214903,6486,邓瑞龙,2025-02-19 03:51:28,0,0,0,确实是出分慢给分差，上课也学不到东西，还很喜欢点名，用来水学分倒是可以（但是信息物理系统安全似乎另一个班fdxlzt给分明显好得多，信安导今年赵成成班没人选两个班合并了所以也不知道她给分啥情况）
215607,6486,邓瑞龙,2025-03-02 15:40:35,2,2,0,信息物理系统安全记得不要选邓瑞龙的班！信息安全导论大概没得选了。信息物理系统安全小测不公平也不正规，个人论文和大作业给分也很低（以上是用插件查看成绩的结果）不知道的还以为故意压分呢。信安导给分很迷，明明说大作业成绩与选题难度相关，但是最后选最难的题反而分数不高？？？
137657,6676,徐金明,2021-07-05 13:28:08,20,21,1,新老师，讲课非常认真，每节课会带着回顾上节课的知识，虽然有些地方也没太明白但是至少他明白的能把我也讲明白，比隔壁强不少
139835,6676,徐金明,2021-07-30 16:57:57,13,13,0,新来的控院老师，人非常耐心，讲课大多数都非常清楚，给分也非常非常好，新老师第一次讲课，难免有时会卡壳，进度稍慢，但是我觉得老师愿意每节课下课留到很晚解答同学疑惑，还在考试周专门借教室给同学们答疑，真的很好，建议学弟学妹自控选他
154054,6676,徐金明,2022-06-14 07:55:29,10,11,1,帅哥贴贴，菜菜捞捞
154420,6676,徐金明,2022-06-01 06:53:45,10,10,0,宝藏老师，一定要选，非选不可。上课像是学长在给你聊天，而不是教授在给你上课，非常知道大家会什么，不会什么，讲的内容只要你认真听，都能带回家。有史以来第一次见到即使不是讨论课，在老师的启发下，大家也会主动提出问题，留下来讨论问题。授课充满激情，有时候大家突然提出一个问题，老师可能浪费半节课跟大家一起讨论对于公式不同的理解方式对在哪，错在哪，可能在课时紧张的时候也是个缺点吧~~~
157945,6676,徐金明,2022-06-25 17:09:28,2,2,0,老师很好，课后愿意留很久回答同学的问题，给分也超级好
158056,6676,徐金明,2022-06-26 13:30:27,1,1,0,老师很可爱，自控讲得不错，人非常好
159997,6676,徐金明,2022-09-11 09:23:09,8,8,0,控院老师中的颜值top
192983,6676,徐金明,2024-06-01 16:11:46,2,2,0,老师超帅！\n\n讲课方面，非常关心学生，总是担心学生听不懂，在课前会带同学们复习一段时间，下课会来问同学们的感受。\n\n个人感觉老师的讲课逻辑还是清晰的，不过可能对程度相对OK的同学们来说，讲课进度可能慢了些，复习有时似乎有些不必要\n\n\n\n但不妨碍我觉得徐老师是一个好老师，AND老师超帅！超帅!超帅！hhh
193492,6676,徐金明,2024-06-11 15:24:08,-4,3,7,怎么说呢，感觉讲课水平一般般
197670,6676,徐金明,2024-07-26 07:22:09,1,1,0,老师负责自控后半部分，年轻老师比较关心学生，经常询问我们听没听懂，节奏怎么样。我个人觉得讲得不是特别清晰，可以结合ppt听。老师人还是很好的。
127146,6713,唐晓宇,2020-11-10 15:23:21,5,7,2,唐姐超可爱！大家上课穿艳丽颜色的衣服有惊喜哦~（手动狗头
127147,6713,唐晓宇,2020-11-10 15:24:35,4,6,2,emoji
127256,6713,唐晓宇,2020-11-17 12:04:34,10,12,2,唐姐人超nice！
140020,6713,唐晓宇,2021-08-23 12:00:07,12,15,3,人美心善
141040,6713,唐晓宇,2021-09-22 06:42:02,5,6,1,人不错，很尊重别人不同的idea，很耐心，并能给出专业意见
141046,6713,唐晓宇,2021-09-22 06:57:00,4,5,1,全世界最好的老师呜呜呜\n\n老师上课真的超棒，你的一点点小优点也会指出来表扬！\n\n呜呜呜虽然作业有点点难，但是收获满满！还想再上一次！！
141571,6713,唐晓宇,2021-10-15 03:31:52,1,3,2,唐姐真是太可爱了，每节课都会讲段子，然后自己先笑，然后奇怪我们为什么接不住
141723,6713,唐晓宇,2021-10-22 11:28:29,2,4,2,唐老师yyds
180865,6713,唐晓宇,2023-09-27 09:11:01,1,2,1,非常好老师，爱来自控院。
181519,6713,唐晓宇,2023-10-21 02:31:59,0,1,1,老师人超级好！！！！
190567,7383,孟文超,2024-03-08 15:38:31,1,1,0,给分吓人……真的给分非常好，可能唯一限制给分的是教务处优秀率的硬性要求了
214010,7383,孟文超,2025-01-23 02:10:41,0,0,0,孟老师还蛮可爱的
198459,7578,赵成成,2024-09-09 05:26:11,1,1,0,讲课思路非常清晰，朴素易懂
133892,7669,李超,2021-03-09 06:48:25,0,3,3,带我飞[滑稽]
181098,7669,李超,2023-10-08 11:02:38,0,1,1,带我飞！~
180497,7962,姜燕丹,2023-09-22 03:39:05,-1,3,4,怎么说呢，老师很年轻。自尊心很强，有时候甚至有点歇斯底里的。上课水平不评价，比较喜欢卖弄自己学生时代交流经历。
213692,7962,姜燕丹,2025-01-19 07:17:12,7,7,0,老师挺好的，感觉现在比较佛系了。上课发言给加分。给分可以。
186659,7996,张新民,2024-01-12 11:19:40,2,3,1,人机这课不点名+作业少就已经足够了，这门课不要求老师讲的咋样，而是尽量少恶心/不恶心同学就行，从这点来看张老师还是很值得选的（doge
188280,7996,张新民,2024-01-18 14:26:54,7,8,1,老师和lhj老师一起上的人机，讲的不清楚是这门课的通病吧，老师给分真的很好！！！
205753,7996,张新民,2024-12-12 02:21:19,3,4,1,上课也就那样，毕竟这门课没啥能学到的东西。\n\n但是为什么会突击点名啊
207142,7996,张新民,2024-12-19 11:33:25,2,2,0,看到楼上说突击点名 其实也还好 课后去补也行的 那次之后还提前说点名了 应该是kpi
213691,7996,张新民,2025-01-19 07:14:31,1,2,1,和lhj老师一起上的人机，平时基本没作业。只有前半学期小测，后半学期最后几节课连续点名当小测。人机这课不用听，最后看课程组统一的ppt就行，不用担心不留作业学不会，因为这课期末根本不考留的那些东西。看看历年卷会几个关键算法就好，小测也是祖传的。推荐选课
214026,7996,张新民,2025-01-23 04:13:16,2,3,1,人机真得选zxm吧！除了应付kpi之外都不点名，而且没点上的后来上讲台补签直接给签，除了mo平台之外也没有乱七八糟的作业。在他的课上随便做自己的事情，甚至不去都行（）这样的史课和这么摆的老师真是相得益彰啊
215929,7996,张新民,2025-03-07 13:21:59,0,0,0,我爱你我的导
221732,7996,张新民,2025-06-25 15:17:53,0,0,0,老师有点呆萌，监考直接在板凳上睡着了（）平时点名也会提前说。但是期末考怎么这么难啊。。。没上4很难过\n\n虽然老师不错但是人基这门课就是史
150794,8014,陆豪健,2022-02-18 15:31:07,-3,8,11,陆宝真的是控院之光，年轻一代最好，没有之一！满分十分，我给陆宝100分
173602,8014,陆豪健,2023-05-30 01:02:51,-6,4,10,非常好老师，爱来自机器人
175320,8014,陆豪健,2023-06-23 16:01:49,7,10,3,他知道自己在教什么吗？4学分的课比学生还摆？他会的真没wqs多
178922,8014,陆豪健,2023-08-01 05:42:58,8,9,1,嵌入式完全念PPT，但其实这课也没什么好学的。\n\n这个学期和mwj老师一起上，四次实验事情少（STM32的实验有点恶心），点名和小测提前通知。\n\n考试的话，A4参考前辈的和隔壁wy老师的复习课最后努力几个小时就够了，最后给分还行。
186156,8014,陆豪健,2024-01-09 06:14:25,13,14,1,人机这课不点名+作业少就已经足够了，这门课不要求老师讲的咋样，而是尽量少恶心/不恶心同学就行，从这点来看陆老师还是很值得选的
188282,8014,陆豪健,2024-01-18 14:27:36,6,8,2,人机给分真的很好
213490,8014,陆豪健,2025-01-18 00:38:18,-3,1,4,人机不点名，没作业，给分的神
213533,8014,陆豪健,2025-01-18 05:41:42,-3,0,3,人机不点名，没作业，班上只有一次小测还是统一要求的。给分很好。称得上是这个烂课下顶好的老师。不过复习的时候最好参考一下别的班的作业。
213541,8014,陆豪健,2025-01-18 06:21:04,-1,0,1,纠正一下，张新民/陆豪健人机班级24-25秋冬共点名四次，小测两次。其中陆老师是2次点名和小测放一起并且提前通知；张老师在冬6周突击点名并且通知冬7周点名，但是允许课间补签。平时没有任何作业。上课的话确实完全没有必要听，两位老师都是纯读ppt，但可以看得出来老师已经在尽量不恶心/少恶心同学了。给分的话个人感觉并没有特别好，也可能是由于期末考考的卷面不高所导致（毕竟复习这玩意犹如吃史）。因为期末考卷出现了其他班级作业题的原题，所以如果没做过会很吃亏（一定要看98上的回忆卷和小测题作业题！！！！）。
213923,8014,陆豪健,2025-01-21 11:51:17,4,4,0,老师确实挺佛的，事情很少。但是平时分还是扣很多的，应该主要集中在mo平台实验上，不知道这部分是谁在把握。总之张、陆老师的教学班还算是人机这个烂课的比较好的选择吧。
214027,8014,陆豪健,2025-01-23 04:14:33,0,1,1,可乐哥，只能说不点名作业少上课摆yyds，人机就选他和zxm没错了
205547,8018,王竟亦,2024-12-09 05:03:23,1,1,0,事少分低
206308,8018,王竟亦,2024-12-13 17:13:43,0,0,0,事少分不低
207256,8018,王竟亦,2024-12-20 03:41:01,0,0,0,确实事少分低，老师自己说了4.2在班上算高的
218002,8018,王竟亦,2025-04-19 04:59:31,0,0,0,非常好老师
218005,8018,王竟亦,2025-04-19 05:03:05,3,3,0,形式化是新加坡老师上，使用软件PAT写大作业，只有一个大作业，很简单。事少分高，强推！！！！！！
152009,8030,姚乐,2022-03-23 03:31:51,1,1,0,无语了，很次
205546,8205,王东霞,2024-12-09 05:03:02,-1,0,1,事少分低
206307,8205,王东霞,2024-12-13 17:13:28,2,2,0,事少分不低
207257,8205,王东霞,2024-12-20 03:41:45,2,2,0,确实事少分低，老师自己说了4.2在班上算高的。不过国际化+事情确实少，差学分还是值得选
209895,8205,王东霞,2025-01-07 10:42:13,1,2,1,相信我真的人美心善，认真负责，事少分不低还不点名
212855,8205,王东霞,2025-01-15 05:20:56,0,0,0,老师人很好，很乐于和同学沟通，上课也比较有热情。不过全英文加上有点无聊所以听得少。给分的问题私下了解了，问题可能出在作业。作业不是老师给分而是助教，助教似乎不清楚老师的作业要求，对只简单提交了代码和结果展示的同学给分很一般。老师说下一年会仔细说明作业部分。我的组是周一大作业得分最高的组，但是也就是4.5这样子，想得分好一点可以在作业上堆量堆排版。\n\n\n\n另外老师上课提问好像不回答，是拿不满这部分表现分的，会扣一到两分
170416,8213,叶琦,2023-03-04 07:33:14,3,9,6,人机课讲课清晰，节奏较快但不难跟上（也很好看
181108,8313,Rongxing Lu,2023-10-09 01:35:00,0,0,0,跨专业好课，想学想水都可以
140216,8314,王越,2021-09-05 14:22:00,1,10,9,非常nice的老师，推荐推荐！！！
141129,8314,王越,2021-09-24 06:53:30,5,22,17,呵呵，宵小之徒罢了
168417,8314,王越,2023-02-15 15:25:17,-20,2,22,是一个很好的导师，跟照顾自己的学生
170260,8314,王越,2023-03-02 09:48:10,10,17,7,讲课非常非常非常棒，所以说人工智能与机器学习能不能让wy老师来上啊
182543,8314,王越,2023-11-17 09:57:21,2,4,2,机器视觉，wy老师思路真的特别清晰，我是傻子都能给我讲懂，能不能让wy老师负责机器人所有专业课啊
182572,8314,王越,2023-11-17 14:41:52,-1,3,4,就讲课水平而言下九分实在过于侮辱
191993,8314,王越,2024-05-07 03:53:01,1,4,3,智能移动技术 讲课不错，给分个人感觉一般（虽然可能也并不是王越老师负责给分
198212,8314,王越,2024-09-05 06:54:24,18,19,1,本科生和研究生两个态度
198710,8314,王越,2024-09-11 05:15:00,27,31,4,给本科生的忠告：选课可以，报研究生一定要慎重再慎重！！！\n\n熊蓉手下最差的小导，跪舔上级和甲方，对学生粗暴不尊重，阴阳怪气不讲逻辑！！！\n\n给本科生的友善都是装出来的！！！讲课讲十年前的东西条理清晰，前沿的科研全凭主观臆断！！！
200566,8314,王越,2024-10-19 06:29:08,16,16,0,谗上欺下之人而已。
216228,8314,王越,2025-03-12 14:47:13,4,4,0,长袖善舞伪君子，欺下媚上真小人。
216713,8314,王越,2025-03-22 07:15:37,3,3,0,厌烦到懒得评论。
219241,8655,刘泓,2025-05-23 09:28:03,0,0,0,循循善诱是个好老师
179032,9179,朱阳,2023-08-23 09:15:18,1,1,0,111
195247,9179,朱阳,2024-06-27 12:09:29,8,8,0,朱老师上课超级认真，是为数不多的还在坚持用板书教学的老师，数学推导极其详细，而且还穿插实例，能学到很多东西。
195902,9179,朱阳,2024-06-30 15:58:23,0,2,2,感谢朱阳，他硬是把恶评满满的《系统建模与仿真》改造成了一门能听的课。同时因为选的人不多，课上交流活跃程度比别的课高了不少，对我这种喜欢插科打诨的人是个利好
219938,9179,朱阳,2025-06-11 12:58:06,0,0,0,好老师！
220018,9179,朱阳,2025-06-13 13:27:46,3,3,0,《系统建模与仿真》，zy老师注重内容推导和讲解，虽然课程内容不是特别深入，但是老师并没有因此疏忽教学，把这门课的知识点讲的很透彻。往年这课改动之前没什么人选，但是就这学期上课体验和考试结果来看，这简直是纯纯的好课。
139939,9188,朱强远,2021-08-22 06:18:09,10,14,4,很好的班主任～
153968,9188,朱强远,2022-05-18 07:17:20,9,11,2,和蔼又有点憨憨的老师
183378,9188,朱强远,2023-11-24 12:51:44,2,4,2,上的生物进化与设计，朱老师是特别好的老师，很会教学生创新，很好滴把生物知识融进了各个学科！给分超级好！很可爱的老师！
183403,9188,朱强远,2023-11-25 04:15:56,5,8,3,上过强远老师的生物进化与设计，老师非常注重对同学们思维的培养，课程给分非常好，而且事情不多（完成一个进化设计的PPT和小论文就可以了），非常推荐大家选择强远老师的课！！！
183404,9188,朱强远,2023-11-25 04:13:52,12,17,5,朱老师上课生动有趣，老师很幽默人也很好，他把生物进化的原理和其他内容联系在一块，讲的深入浅出。生物进化与设计这堂课也给我提供了很多看问题的新思路，很多生活的现象都可以被归结为进化过程。另外，同学们的pre也有很多干货，内容很多元也很丰富~平时要多找老师交流，而且和朱老师交流你可以得到很多有用的建议，老师很和蔼。最后给分也很好，好课快选！（生物进化与设计）
183849,9188,朱强远,2023-12-01 06:26:00,2,4,2,非常好老师，平易近人，幽默风趣，对思维有很大提升，爱来自紫色的云
184367,9188,朱强远,2023-12-18 08:46:58,2,3,1,老师很讲究的事情都会沟通好，能学到很多东西
185809,9188,朱强远,2024-01-04 13:33:00,0,2,2,老师超级好 很温柔很平易近人 虽然还没出成绩 但是不管怎么样都很喜欢这位老师！！！快选块选！
186713,9188,朱强远,2024-01-12 15:19:17,0,4,4,挺好的课
189857,9188,朱强远,2024-01-31 09:42:46,8,8,0,生物进化与设计，上的是冬天的课。觉得这个课实际上有点名过其实了，给分的话中规中矩，没有说的那么好。老师上课喜欢点名，几乎是次次都会点，然后中途的话，有时候是不下课要连着讲的。最后会有一个论文和ppt展示，这个相对于其他要考试的通识课来说算是比较好的。但是很奇怪的一点是他又说这个ppt展示是不算入总评当中的，最后给分就很奇怪（？），以及ppt展示会出现同学拖堂的现象。老师在课上是不允许你玩手机的，写作业也是不被允许的，会下来巡视，有时还会阴阳你。在知识方面的话，我觉得应该算是比较没有用的一门通识课，感觉一个学期学下来没有什么收获（也有可能是我自己没有好好认真学）如果给建议的话，就是选上这门课的同学，要尽早的去准备ppt和论文，早一点发言的话，可能会给分好一点吧。
190757,9188,朱强远,2024-03-18 03:26:38,0,2,2,课太水了
192362,9188,朱强远,2024-05-16 12:54:54,4,4,0,生物进化与设计，课程内容有些古老，老师看得出来很想教大家一些什么，但是想教的有点太多了，上课像在说脱口秀，有时候会有点好笑但大部分时间让我有些听不进去。天马行空的课程听起来很累，我个人不太喜欢。老师喜欢和下面做其他事情的同学互动开玩笑，虽然不会很阴阳怪气但有些影响做自己的事情。总而言之，个人认为课程听起来没什么意思，不听坐着也不太能干别的，并且点名花样很多，翘不了。慎选。喜欢听闲龙门阵的可以来
193603,9188,朱强远,2024-06-13 12:58:05,-2,1,3,每个人都要pre 整整两次半课都在听pre，真的很没意思啊..
199204,9188,朱强远,2024-09-19 03:56:22,2,2,0,给分很好
201324,9188,朱强远,2024-10-31 16:38:04,2,2,0,老师人很好，讲的东西也很有趣
202449,9188,朱强远,2024-11-12 23:47:27,2,2,0,还行 课的事情不多
202474,9188,朱强远,2024-11-13 01:11:06,4,4,0,老师给分特别好，喜提满绩，谢谢老师
203246,9188,朱强远,2024-11-18 10:44:50,4,4,0,满绩了，谢谢老师
205759,9188,朱强远,2024-12-12 02:40:48,6,6,0,老师人很好，上课基本会点名，讲的知识对近三年没有学生物的文科生也很友好，生物进化与设计课程期末有一个论文和pre要做，其他就还挺轻松的，上课如果不是打游戏啥的老师也不会阴阳的，推荐推荐
208274,9188,朱强远,2024-12-26 12:39:42,0,0,0,没有太多内容
208281,9188,朱强远,2024-12-26 13:00:44,-7,0,7,生物进化与设计，实话实说我觉得这课毫无意义，没学到什么东西，建议课程改名为“进化和发展”。\n\n我这个学期老师学生比较多，每个人都要展示，老师鼓励我们主要讲自己的想法和思考，这一点很重要！！！由于老师没有时间要求，前面的人时间充裕，后面每个同学pre都会遭到疯狂push……老师似乎比较倾向于有趣味性的pre……反正我不懂其评分标准，点名是“手动”的，迷幻……还没出分，给分就不评价了。
208291,9188,朱强远,2024-12-26 13:27:51,3,3,0,多多和老师交流，老师挺好的
214005,9188,朱强远,2025-01-26 06:04:08,4,4,0,生物进化与设计课还是挺有意思的，给分也不错~就是出分实在是慢了点~
219342,9188,朱强远,2025-05-25 13:36:18,1,1,0,坐标生物进化与设计，老师上课的内容确实有一点无聊，但是你在下面写作业他也不大会管你，但是打游戏被发现很有可能会被骂。老师点名比较严，几乎没有水过去的可能。这门课事情还是比较少的，只有一个pre和一篇论文。个人建议以后想选这门课的同学们pre的主题不用太高大上，毕竟我们不可能比老师专业，可以选择一些自己感兴趣且比较了解的方向（比如本柳州人介绍了螺蛳粉）最后擦线满绩！感谢老师！
171012,9258,曹云琦,2023-03-14 05:42:20,7,12,5,曹老师YYDS！很严谨很负责很亲和的一位老师！
213690,9258,曹云琦,2025-01-19 07:15:42,2,2,0,传感课，点名会提前通知，纸质签名，事情少，给分还行。这课平时不用听，把作业写好，期中测试和期末之前看看书和作业里面出现的计算题就行。
176467,9259,赵斐,2023-06-29 04:12:10,-1,5,6,给分纯傻逼，还是个教授分不清楚谁做的大作业难度大吗
176469,9259,赵斐,2023-06-29 04:33:38,0,3,3,老师人挺好的但好像给分不是很好？
176653,9259,赵斐,2023-06-29 15:00:59,-11,5,16,运筹学课很好，事少给分高
193122,9259,赵斐,2024-06-04 00:12:05,6,8,2,快跑！
194885,9259,赵斐,2024-06-26 00:24:30,-6,4,10,好吧，我承认给分蛮好的。平时认真学一下，大作业认真做就满了
195137,9259,赵斐,2024-06-27 02:43:48,2,5,3,运筹学：老师人不错，讲课还行，平时作业一坨...真是一场酣畅淋漓的行行变变又换换啊...这个课最难受的是占两节早八，好像点过一两次名，还专门挑下大雨早八这种阴间时间点名，但是老师亲口说不计入总成绩，估计是为了提醒大家到课。大作业5个人一组，自由选题，难度不大（其实人手有点过于充足了）但是小测又是一坨...还占总评20%，和期末也没啥区别了，唯一的区别就是复习时间少很多，然后今年考的十几道题还全是概念证明...哪怕你考我两道计算呢...给分还行吧最后上4了，就我小测答的那一坨估计还是有小捞的。参考我身边的大佬，如果能把概念推导完全理解的话拿满绩应该不难，可惜本人太菜了T_T
195290,9259,赵斐,2024-06-27 15:34:43,2,3,1,说很水，其实感觉认真学并不水。作业据说能找到答案直接抄，老师也不在意你学没学，但真自己做还挺耗时间。\n\n大作业有点抽象，实际建模未免复杂，感觉有卷的趋势。这种卷和本学期另一门选修课一样，很讨厌，上必修课的时候可没觉得大家这么爱钻研。\n\n\n\n最后的测试比隔壁班难度高了挺多？好多证明，题量爆炸。\n\n感觉老师对我小组的大作业不是很满意，最后总评中规中矩。\n\n\n\n助教非常认真负责，人很好，还会答疑\n\n\n\n呃呃楼上的我怎么没感觉满绩不难，甚至还有一段距离呢。好吧追求高分的同学大作业得好好卷一卷，要看起来包装得像模像样，没有模型也要强行设置个应用条件。我小测做得应该算很好的，或许这也就是这种课和期末考的必修课最大的区别了？
195435,9259,赵斐,2024-06-28 04:32:15,2,3,1,下限高，不太容易挂科
217494,9259,赵斐,2025-04-11 11:14:54,2,3,1,oyg说轻松满绩
217495,9259,赵斐,2025-04-11 11:13:41,1,2,1,oyg诗人我吃
218875,9259,赵斐,2025-05-10 07:50:39,2,2,0,教材那本实用运筹学非常的腊鸡，什么东西都没有，最重要的对偶单纯形一页过，真的很扫码。\n\n上课讲的也不是很清楚，教材和ppt都有一定的防自学设计，听不懂。\n\n不如看清华的运筹学
221321,9259,赵斐,2025-06-23 02:50:27,5,5,0,事多给分差，md早知道跑路了
197940,9260,周海峰,2024-08-21 08:04:14,0,18,18,你说呢
198266,9260,周海峰,2024-09-06 03:28:49,14,20,6,先打满分，将来再改，请叫我盲盒仙人
198716,9260,周海峰,2024-09-11 05:58:51,0,5,5,先打着10分看看表现
198738,9260,周海峰,2024-09-11 07:36:40,20,24,4,老师上课态度挺好的 非常认真！\n\n第一节课扯了很多政治经济国情有关的东西 课程内容讲得很少\n\n然后从最基础的计算机原理开始讲 很细很慢 适合计算机小白\n\n人长得憨憨的 一直在笑 非常和蔼
198743,9260,周海峰,2024-09-11 07:51:37,0,3,3,自己看吧
198749,9260,周海峰,2024-09-15 10:46:29,16,26,10,水水水
198765,9260,周海峰,2024-09-11 12:25:23,0,3,3,先打个满分
198766,9260,周海峰,2024-09-11 12:58:02,0,3,3,先打个满分，感觉很适合小白
199105,9260,周海峰,2024-09-19 06:55:31,1,2,1,还不错
199260,9260,周海峰,2024-09-20 05:18:07,10,12,2,先给9分，他真的很可亲和蔼（），然后上课非常耐心细心，还全自费多请一个助教来帮忙解决问题。还有，助教zx满昏！）半夜会回我消息而且很贴近学生，负责认真
199382,9260,周海峰,2024-09-22 14:09:25,5,9,4,周海峰老师的内容很生动，会做很多拓展，就是讲的太慢，课后需要很多时间练习。不过他很大的激发了学习兴趣，先给个十分！
200014,9260,周海峰,2024-11-03 11:20:53,1,4,3,老师应该是好的吧
200153,9260,周海峰,2024-10-14 05:29:51,3,5,2,吹爆周老师
200343,9260,周海峰,2024-10-16 06:32:21,6,11,5,水炸了，平时分计算方式抽象（随机请同学发言再加分），上课巨慢无比，作业又考后面内容完全要自学\n\n\n\n在他课上待2个小时不如自己看10分钟书
200840,9260,周海峰,2024-10-23 07:53:10,4,6,2,他真的好和蔼，也有在努力上课，给分分布有点抽象，建议GitHub自学
201127,9260,周海峰,2024-10-29 06:08:59,0,1,1,还行吧
201615,9260,周海峰,2024-11-05 02:47:36,3,4,1,好好好
205080,9260,周海峰,2024-12-01 05:52:19,4,7,3,讲的好慢好乱，昏昏欲睡不如自学\n感觉没咋备课，建议讲课之前组织一下语言
206405,9260,周海峰,2024-12-15 03:26:05,6,7,1,上机考竟然过了！平时每次编程都很困难，上机做出来太激动了感谢助教zxgg考前帮我查各种低级错误，他太有耐心了我的天，我直接哭死
206875,9260,周海峰,2024-12-18 06:09:33,4,4,0,包不后悔的
208032,9260,周海峰,2024-12-25 08:59:07,6,6,0,罪不至8开头，老师是好老师，但毕竟是第一次上这门课，有些不足自然是正常的。等老师经验丰富了，后来的学弟学妹就有福了
208286,9260,周海峰,2024-12-26 13:18:29,3,3,0,体恤学生，上课点名只有数字点名，上机课貌似每月第一节点一次，教的很基础适合小白，人很好
208774,9260,周海峰,2025-01-01 15:27:36,1,1,0,老师经验可能还不是很足，但人很好，是好老师
208916,9260,周海峰,2025-01-03 11:04:47,6,6,0,老师太好了，很和蔼，很关心学生
209342,9260,周海峰,2025-01-05 12:53:40,3,3,0,老师太好了，很和蔼
209744,9260,周海峰,2025-01-07 03:02:10,5,5,0,老师助教真的都太好了
211579,9260,周海峰,2025-01-12 02:56:18,15,15,0,助教和老师两个周哥都是我的神🥹🥹🥹\n吹爆
211813,9260,周海峰,2025-01-12 14:21:19,4,4,0,老师人真的很好很好 助教也非常非常好
211818,9260,周海峰,2025-01-12 14:55:58,10,10,0,人生的路还很长 小作文看枯了
211825,9260,周海峰,2025-01-12 15:19:41,23,24,1,以下是周海峰原文 就想问哪里还有这样的好老师！😭😭😭😭\n\n@所有人同学们大家好！咱们这门课程的成绩已经出来了，后天应该就可以查询了。下午助教对平时分加分未满5分的同学进行了确认，以防止有未被统计的加分情况\n\n第一点，课程组根据整个年级考试成绩情况划定了期末卷面考成绩及格线为45分，也就是低于45分的话，直接判为不及格，哪怕平时分再高，最终成绩也只能最高59分。咱们班平时分都不错的，所以我们自己计算的成绩里是没有不及格的同学的，但因为有课程组下达的45分及格线这一要求，所以我们班还是有4位同学出现了最终成绩不及格的情况。原来其实是有6位的，但我和助教这几天复查大家的试卷，发现其中2位44、43的同学试卷批改中存在争议点，通过跟课程组老师反复争取，最终还是成功地将这2位同学拉了出来（包括还有3位及格的同学也把错判的分数给你们加上了），希望咱们这2位同学以后一定要加倍努力，这次实在惊险，实在来之不易。不及格的4位同学，老师有帮你们反复核查试卷，但确实没有发现错判的地方，十分遗憾[鞠躬]，希望你们能够及时调整好自己的心态、学习方法，后面努力追赶上来，相信这也是一次考验，通过以后持续的努力，老师相信你们一定也能到达自己的人生彼岸，不要灰心，人生路上难免有些波折，关键是要有不屈的奋斗精神，不被眼前的挫折所打倒。
211987,9260,周海峰,2025-01-13 03:46:05,7,7,0,周老师的课讲的很细，十分适合小白，并且对于我们的机考，理论考都很上心，机考前十天每天都会让我们做两套模拟卷，事实证明，这个班的机考未通过率是全校最低的班级，而且老师和助教老师都很会捞，看你分数比较低时，会与你私聊看看还能不能加加平时分
211988,9260,周海峰,2025-01-13 03:50:58,7,7,0,感恩感激感动，这是目前遇到最好的老师，助教负责，老师真诚，尽全力让每一个学生都能有所收获
211989,9260,周海峰,2025-01-13 04:00:17,6,7,1,捞人的神，大胆冲就完了
211990,9260,周海峰,2025-01-13 04:00:34,6,6,0,老师和助教都非常好，海底捞
211998,9260,周海峰,2025-01-13 04:13:07,3,3,0,真的好，平时分给满了，奈何我期末考太烂，最后只拿了3.9
212001,9260,周海峰,2025-01-13 04:17:21,5,5,0,老师太棒了😁
212018,9260,周海峰,2025-01-13 04:37:27,6,6,0,上课讲解比较循规蹈矩 照着ppt和书讲（苯人课上上到链表和文件就已经快跟不上了 但是其实这门课最好先自学一下 不是老师的问题）但是老师最好的一点是认真负责的态度 尤其是实验考前让助教zxgg给我们安排模拟考 成功让我们班实验考通过率达到年级最好水平 还有从出分之后的小作文可以看得出来老师真的很想把我们带好 好评 快来选 无脑冲！
212145,9260,周海峰,2025-01-13 09:17:01,4,4,0,期末考的有点烂，但是老师还是捞的很高，周老师和助教老师都是很认真负责，是努力讲细节提升大家c程水平的好老师，强推！
212192,9260,周海峰,2025-01-13 10:46:23,3,3,0,伟大，无需多言，培养了我对编程的兴趣，给分超级无敌好，还会解释正态和卡绩，第一次从大学老师身上感受到了对学生们的关怀，选就对了！（小tips：建议自学）
212211,9260,周海峰,2025-01-13 11:46:38,2,2,0,特别温柔和蔼啊一直一直笑 然后真的海底捞！给分特别好！！！
212212,9260,周海峰,2025-01-13 11:46:51,3,3,0,超级无敌好的老师，是新老师，人特别好，周老师和助教都很积极地解答同学的问题，最后给分也是巨高，爱死了！！！
212256,9260,周海峰,2025-01-13 14:49:30,0,0,0,老师上的课说实话本人没有非常认真的听，更多的是看配套网课和看书。这位老师布置的作业相对而言是比较少的，有很多的可支配时间，个人认为这门课主要就是要投入一定量的时间（像本人这种0基础的话），多写多练。此外，这位老师的助教非常非常好，本人一开始特别怕这门课，每次上机课感觉都是去坐牢，后来有问题去询问助教，助教每次都很贴心地回复，让我一点点弄懂这门课。最后的捞分也是真的捞，不管你是哪一个分段都特别特别捞，大爱助教！！！！！！！
212908,9260,周海峰,2025-01-15 08:19:40,4,4,0,老师真的真的特别负责，助教哥哥也巨好，平时分发言了也会给满，不过第一年上课还有较大的进步空间，但是给分真的好，特别负责
214463,9260,周海峰,2025-02-05 15:29:09,4,5,1,新老师，讲课特别细致，认真听确实能有所收获，虽然这门课确实可以自学。钉钉回复消息也很及时，回应我们的诉求。助教哥哥解答问题耐心也给个好评！最后竟然给了我这个c语言小白满绩，真的太捞了！能看出来老师是尽力想给每个同学高分的，只是囿于正态分布。
216566,9260,周海峰,2025-03-18 13:55:44,6,6,0,我发誓这是我来浙大以后遇到过最好的老师，没有之一，助教哥哥也贼好
221720,9260,周海峰,2025-06-25 12:36:38,0,0,0,我的妈耶，发现查老师上更新大一上学期C尖的均绩了，排名第一欸！！
168626,9513,顾超杰,2023-02-20 11:17:09,10,13,3,杰哥我爱你
173499,9513,顾超杰,2023-05-26 10:15:10,2,3,1,智联网yyds！！！
179058,9513,顾超杰,2023-08-26 13:26:38,0,0,0,顾老师好啊
179143,9513,顾超杰,2023-08-28 12:51:42,1,1,0,杰哥超级帅！
182141,9513,顾超杰,2023-11-10 13:57:15,0,0,0,！！！
193291,9513,顾超杰,2024-06-05 17:03:31,0,1,1,智联网事情很少，给分也还可以
193320,9513,顾超杰,2024-06-06 08:21:32,2,3,1,智联网事情挺少的，但是感觉给分一般，适合不在意绩点的人当水课混学分
196713,9513,顾超杰,2024-07-05 01:36:08,0,2,2,nice
193528,9556,曹雨齐,2024-06-12 09:18:49,0,4,4,学士孟伟师妹
196069,9556,曹雨齐,2024-07-01 12:00:03,3,4,1,数字图像处理与机器视觉，老师讲课蛮清晰的，给分最后也还行
213694,9556,曹雨齐,2025-01-19 07:28:47,2,4,2,和xl老师一起上过控。有小测，会提前说，但是xl老师会在来下半学期第一节课直接小测，注意准备，考的双交叉比值还有一个过控系统设计，想要保证做出来要前半个学期下点功夫。过控课件只有图片，解释很少，但是不听课看教材也能看懂。实验有点累，但是因为改成长学期课程，轻松了许多，大作业量也没有之前离谱了，可以直接看之前的智云里面上一届做的。跟隔壁运控比还是能学到一些知识的，这学期期末改成闭卷了，但是也挺好背的。根据上运控室友反馈来看，课程体验总体比运控好，就是还没出分，有待观望。
190619,9560,柴利,2024-03-12 02:39:28,16,20,4,信号分析与处理，讲课比较抽象。。。
192969,9560,柴利,2024-06-01 09:50:33,11,11,0,讲课真不行，老师人还可以，建议看看张健老师的课吧
197042,9560,柴利,2024-07-07 01:50:42,5,7,2,讲课情况就和楼下差不多。。。。。后面的课基本没怎么听。给分的话算了一下平时分差不多扣了两分（老师还说我们大作业做的不错），扣分不知道是不是作业分扣的，助教打的作业分确实一般
197044,9560,柴利,2024-07-07 02:05:37,4,4,0,老师人不错，但是讲课一般，给分也不是太好
219647,9560,柴利,2025-06-03 04:53:25,2,2,0,优点是跟王智比，他各方面都更好；\n\n缺点是他跟王智搭班
175302,9577,李亮,2023-06-23 12:39:14,6,8,2,好好好
197641,9577,李亮,2024-07-23 11:51:35,3,4,1,好老师！
201315,9822,舒元超,2024-10-31 12:47:10,3,4,1,无敌好导师
216222,9822,舒元超,2025-03-12 14:14:48,2,2,0,宇宙无敌好导师
196068,9844,蔡声泽,2024-07-01 11:59:22,-3,2,5,dip，和曹老师一起开的课，上课比较清晰，给分也还不错
203832,9894,李高峰,2024-11-21 10:35:49,2,3,1,控院的现代机器人学研究生课体系紊乱，李老师讲课还是认真负责的，但是没有平时分，期末一百分，然后出的题也难。这门课四五个老师都讲，其他老师讲的很烂，上课就在吹牛逼
216488,10230,郭秀珍,2025-03-17 08:59:37,0,1,1,给郭老师打call!
197881,10239,王聪,2024-08-19 01:02:22,4,8,4,葱哥无敌！
199645,10239,王聪,2024-09-26 16:00:33,-1,2,3,给分超级好
201896,10239,王聪,2024-11-08 06:10:14,3,3,0,感觉讲课挺认真的，不过信息安全导论这课怎么节节课点名。。
214529,10239,王聪,2025-02-11 08:51:06,-1,1,2,仅针对信息安全导论课程。\n\n这位老师上的信息安全导论课程每节课都会在学在浙大上进行扫二维码点名，挂名在邓瑞龙老师的课程下（实际上正课邓老师一节课没来，王聪老师上了4周，赵成成老师上了2周）。对上课内容不做评价，只能说和大作业基本没有半点关系，不需要听，记得点到就好（实在没点上课间也可以补签）。给分个人感觉比较随机不知道是谁打的。
214902,10239,王聪,2025-02-19 03:48:19,1,2,1,真的很搞笑我真的服了为什么总有同学莫名其妙踩踩踩啊？我是写2月11号那条评论的同学，就问你上课每次点名是不是事实？上课内容过时是不是事实？我有同学认真完成了最难的第四题（CTF）最后大作业被他打了70分，给分真的莫名其妙。\n\n要是真的不认同我的说法你可以评论反驳啊，不要在这里莫名其妙的点踩误导选课同学。
