评论id,老师id,老师姓名,发表时间,点赞减去点踩数量,点赞量,点踩量,内容
27736,3672,王贵国,2016-06-27 10:22:31,0,13,13,呵呵呵呵
155425,3672,王贵国,2022-06-12 14:12:45,3,12,9,真正的大佬！！！学术和做人都是！！！国经的启蒙老师（尽管本科时已经学过一遍，死记硬背得了高分！但经过老师一讲，就懂了好多）...
159365,3672,王贵国,2022-07-14 16:50:07,0,4,4,好！！大牛！！！
159718,3672,王贵国,2022-08-24 14:39:04,-1,1,2,超级好！！
159770,3672,王贵国,2022-08-28 16:31:08,-2,1,3,超级超级好乘以10086
161740,3672,王贵国,2022-11-11 18:09:38,-3,1,4,好好好
171598,3672,王贵国,2023-03-30 00:32:56,1,5,4,挺一般的
183830,3672,王贵国,2023-11-30 15:33:08,-3,0,3,好好好
17481,3678,章程,2016-01-20 09:34:28,5,19,14,听不懂
18482,3678,章程,2019-10-31 10:27:43,48,138,90,很有情怀
19267,3678,章程,2016-01-23 16:50:53,22,44,22,其实上课认真听了还是能听懂的呀，而且给分已经有进步了
20401,3678,章程,2016-01-27 13:16:00,0,7,7,有情怀的老师，可惜宝宝我听不懂
20553,3678,章程,2016-01-28 10:00:34,0,8,8,物权法被坑耿耿于怀，不过据说现在好很多
21315,3678,章程,2016-02-28 03:55:21,28,56,28,真正的大学启蒙老师
21321,3678,章程,2016-02-28 04:16:43,28,78,50,棒的一塌糊涂
21897,3678,章程,2019-10-31 10:28:22,33,76,43,民法的大半江山都是他的课。最开始物权法并听不懂而且分数也不高，但是静下心来再学合同法发现很多东西可以疏通开了。老师很有情怀，可以看到很多法学以外的世界
22116,3678,章程,2016-03-02 11:32:34,18,32,14,全心全意为学生的老师，对于学术的认真和自身人格魅力都让人心折，大学老师该有的风骨。
23040,3678,章程,2016-03-16 11:03:28,1,8,7,牛逼，可惜我听不懂
25718,3678,章程,2016-06-04 17:10:38,30,67,37,真正的大学老师，却有着邻家哥哥的感觉～
27775,3678,章程,2019-10-31 10:27:37,194,422,228,老师在公邮里有段话   “还是重复一遍第一讲时奉劝大家的话，诸位可以远离民法、远离法学，但请对自己年轻时认定值得投入之物务必尽心尽力，你一定能进入其后非凡的世界，形成自己的判断力。这是我所理解的大学的本义。”   给老师比心
27895,3678,章程,2019-10-31 10:28:00,32,107,75,真的不知道怎么评价 因为章程老师实在是太棒了\n\n大家觉得他上课讲的内容难 听不大明白 老师自己也知道这个难 所以在课上会极其耐心一点点地疏导 也会告诉我们很多东西没捷径 就要一个问题一个问题弄清楚\n\n记得程宝有一次说 不强求我们一定要对物权法感兴趣 也不一定要对法学感兴趣 只要你自己认定一个方向自己去努力 可以看到一个世界就好\n\n程宝上一门课 不单单是讲那些知识 他还会告诉我们 民法要讲体系容量和体系思维 所以讲课体系性理论性强一点对训练思维肯定有好处\n\n遇到这样的老师我等之幸运啊
28124,3678,章程,2016-06-28 08:08:01,3,6,3,听不懂
29683,3678,章程,2016-06-30 07:37:30,30,62,32,不点名，不签到，考试除了本科生院不让带的啥都让带，还说只要学校不禁止，开讨论组讨论都ok，只要不怕群里的都挂，\n\n非常喜欢，讲课很有趣，讲的很透，作为一个辅修生认真听也能听懂，还会带领大家纵观法学发展，横观世界法学，非常有情怀，年轻有为，认真负责，希望多开课！
30320,3678,章程,2019-10-31 10:28:39,29,58,29,“君子之交，不言其它。只期望你自己努力，不负天资。”谢谢老师。
32134,3678,章程,2016-07-05 17:05:53,17,33,16,上课超级好，自己也很吊但是有资本吊。超级喜欢他！
32174,3678,章程,2016-07-06 00:49:08,15,27,12,帅帅的老师，年轻的老师，有情怀的老师，会把很多问题讲得很细很深入，因此上课时常出现听不懂的情形。但是那种思维训练真的让我受益良多，改变了我很多思考方式，让我学会探究知识背后的原理。感觉给分挺好的了。
32817,3678,章程,2016-07-15 11:33:06,44,133,89,虽然老师给了我51分，但是我还是要打满分~\n\n\n\n
33852,3678,章程,2016-09-22 06:03:33,26,75,49,我要被老师迷倒了救救我
33874,3678,章程,2016-09-22 07:50:09,20,33,13,老师都这么帅了我还能说什么呢
39288,3678,章程,2016-12-22 03:03:37,0,6,6,老师是好老师，学识渊博又有耐心，然而听不懂.......
39553,3678,章程,2019-11-10 10:58:54,43,113,70,偶尔回首，那一个学期的债法，竟无意间渲染了我精神的底色
42467,3678,章程,2017-01-14 09:11:02,5,12,7,老师是好老师，可惜我不是一个好学生
42622,3678,章程,2017-01-14 15:27:36,9,20,11,满分！！
43501,3678,章程,2019-11-08 11:14:00,26,63,37,“我负担终身的瑕疵担保责任”爱老师爱的一塌糊涂！
43531,3678,章程,2017-01-16 13:26:47,6,18,12,不仅仅是学术上的好老师，同时也是人生路上的指明灯。
43636,3678,章程,2017-01-16 16:12:23,27,53,26,程宝帅在学识与情怀，这才是大学老师，法学学者应有之风骨，选了吾师章程的课，幸甚至哉。
43715,3678,章程,2017-01-17 01:09:09,22,47,25,程宝是有情怀有理想，真正传道授业解惑的老师，博学多识、正直严谨、年轻有为而且平易近人，所教授的绝对不仅仅是专业课知识，更是一种作为法律人、作为一个人应该有的态度。程宝会在课上谈及自己的所见所闻和所思所感，每次都会给我很大的触动。感谢老师让我有那么多的收获。爱您！
44396,3678,章程,2017-01-17 17:31:19,9,19,10,非常负责的老师，会全身心地投入课堂，因此课堂效率非常高，课后老师会花大量时间在为学生答疑上。同时也是非常有情怀的老师，富有人格魅力，重塑了我的法学观。又过去了小半年，各位明年之江再会～
45548,3678,章程,2019-10-31 10:28:10,36,86,50,“在我看来，大学的法学教育唯一的目的，就在于架构柔软而坚韧的体系、传承思考的方法与理性，让这些在法律人的大脑中蔓延伸展开来，去支援而不是磨灭我们对知识对社会的热情。”程宝在债法公邮里面放了一封信，感动至极！每学期都会遇见一个很好很好很好的老师，真是幸运！
45645,3678,章程,2017-01-20 01:56:28,32,67,35,有一种学不好会有辱师门的感觉
45666,3678,章程,2017-01-20 02:21:11,8,13,5,终身承担瑕疵担保责任~
47717,3678,章程,2017-02-21 07:17:11,3,6,3,负责！
51804,3678,章程,2019-10-31 12:09:33,23,46,23,?最最最喜欢的老师。旁听了一年（债法、民法下）。和其他老师相比，程宝总会有一种“剑走偏锋”“独辟蹊径”之感，也会你顿悟知识、体系之间是如何打通的。课堂之外，老师真的很活宝，常常会在朋友圈评论，很风趣，也特别关心同学，很nice。给老师比心❤️，下学期合同法约〰
53462,3678,章程,2017-06-26 16:30:07,2,6,4,很棒啊
53471,3678,章程,2017-06-26 17:25:38,9,14,5,老师真的很棒，教辅修班的方法与众不同 受益颇丰，不仅专业知识教的很好，也很有情怀
53484,3678,章程,2017-06-26 22:45:10,13,22,9,章程者，君子也
53488,3678,章程,2017-06-27 00:37:44,5,12,7,看他的PPT都是享受。
53518,3678,章程,2017-06-27 01:43:10,0,4,4,老师有情怀，上课讲的很仔细～
53690,3678,章程,2017-06-27 10:06:54,0,4,4,出了给分，真是挑不出毛病啊
54452,3678,章程,2017-06-29 10:28:06,1,7,6,太有情怀的老师。男神。
57148,3678,章程,2017-07-05 22:26:46,10,21,11,这学期本来是陆帅的物权法辅修班，程宝给代过三次课，真的是法学院人才辈出的感觉，程宝懂很多很多，（还经常拿黑社会黑吃黑来说明问题），很有风度，简直男神啊！加上同样出色的陆帅，有这样的老师，绩点什么的根本不考虑了好吗！
58080,3678,章程,2017-07-28 21:28:46,21,100,79,好想嫁给老师
60655,3678,章程,2017-10-26 04:56:19,0,8,8,讲课清晰程度棒得一塌糊涂～
60940,3678,章程,2017-11-03 14:29:20,4,9,5,就两个字！男神！！！
64461,3678,章程,2017-12-24 06:58:01,0,4,4,男神无疑了。
65216,3678,章程,2018-01-01 05:20:26,0,4,4,强无敌
67475,3678,章程,2018-01-21 09:38:34,21,48,27,想嫁。
69922,3678,章程,2018-01-25 16:11:14,0,6,6,“无问西东”
69959,3678,章程,2018-01-26 00:21:18,4,10,6,感谢老师一记敲打。
70460,3678,章程,2018-01-26 16:00:23,1,10,9,债法合同法都是程宝的，但是最喜欢听老师扯法学无关的话题。嗷老师给分很好！是我遇见过的给分最好的老师了，笔芯！上次问老师问题老师直接打电话过来了，超级超级超级超级超级超级感动，虽然这学期和老师联系很少，难过自我检讨。乱七八糟扯了很多，但感情不假。
71105,3678,章程,2018-01-28 03:02:50,2,9,7,其实感觉老师讲课虽有条理但是听来却有点乱，因为经常会扯到其他的地方去。不过老师的高水准是在那的，需要课下自己多加努力。老师是很有情怀的学者，两年来受教颇多。感谢老师。
72822,3678,章程,2018-01-31 06:36:24,4,9,5,老师教得很好，答疑非常认真，可惜我不是个好学生，看到分数第一反应是真的有辱师门。不过这分数让我重新开始反思所学，日后必定更加努力。
72972,3678,章程,2018-01-31 13:05:26,9,15,6,老师真的非常非常非常暖，不仅是他对待学术的态度，对待我们这些学生，也是非常非常的好，考试完以后要挂的同学会先电话通知给申辩机会，作为渣渣各种瑟瑟发抖怕自己挂科，老师还特地私聊了分数，并且给了鼓励，说要对自己自信，真的是男神，太暖了，打call?('ᴗ' )و
74957,3678,章程,2018-03-07 00:50:49,3,9,6,不点名，超有情怀和学识，印象最深的是白底黑字的简洁ppt和两次不讲正课的时候，心驰神往。能遇到这样的老师绝对是幸运。寒假微信问老师期末考试的问题，还打回电话来给我解答，真的又惶恐又感激。
75036,3678,章程,2018-03-07 05:46:54,-21,15,36,给分差
75425,3678,章程,2018-03-11 16:23:34,1,5,4,我爱程宝嘤嘤嘤
75536,3678,章程,2018-03-13 05:21:04,2,7,5,大爱啊
79003,3678,章程,2018-05-20 03:30:36,0,4,4,超爱章老师，男神！！！！
79093,3678,章程,2018-05-22 15:03:54,18,35,17,老师对民主自由的理解真的是入木三分。感觉，在这块土地上已经容不下思想如此有深度的人。
79672,3678,章程,2018-06-12 14:37:35,2,8,6,理想中的老师模样
80304,3678,章程,2018-06-25 01:46:03,8,14,6,我爱他……
80309,3678,章程,2018-06-25 03:41:03,31,88,57,天呐！怎么会有明明又瘦又驼背还黑却这么帅的男人！
81179,3678,章程,2018-07-04 08:18:24,20,32,12,老师，我不想吃小龙虾(Ｔ▽Ｔ)
81313,3678,章程,2018-07-04 15:46:15,5,10,5,没什么话好说的了 梦中情人
81359,3678,章程,2018-07-05 02:07:40,7,13,6,恰似从民国时代翩翩走来，遇上这样有着家国情怀的老师是三生有幸
83388,3678,章程,2018-07-10 07:53:39,22,38,16,虽然老师爱diss我们这些渣渣 会直播批卷和我们皮一天 会潜水在朋友圈暗戳戳地给我们留言 嘲讽力max 逻辑力max 会毫不留情地给我们挂科…但是我爱他！！！！！对程宝的爱始于言辞 陷于学养 沉迷于有趣的灵魂！！！
83564,3678,章程,2018-07-10 15:13:05,0,3,3,非常入迷。
83591,3678,章程,2018-07-10 16:42:09,1,6,5,选吧。不会后悔的。
83634,3678,章程,2018-07-11 01:03:50,0,5,5,…老师还是挺不错的叭
83707,3678,章程,2018-07-11 04:54:17,7,12,5,老师是唯一一个让我觉得大学老师是值得考虑的工作\n\n分数还没有出
84169,3678,章程,2018-07-12 07:18:28,10,15,5,老师：天地良心，我这辈子最恨点名，我从来不点名，你们居然在查老师上说我点名？？？\n\n笑死我了，老师真的从来不点名，而且每节课都要抢座位的。
84191,3678,章程,2018-07-12 07:53:57,1,7,6,一种传统，一种传承
84723,3678,章程,2018-07-13 15:36:32,12,25,13,慕名而来\n\n得了满绩 比结婚还开心
84733,3678,章程,2018-07-13 16:18:57,-2,4,6,我觉得很受启迪。\n\n
84743,3678,章程,2018-07-13 16:52:33,0,4,4,记住了麻小记住了江湖记住了法的灵魂
84844,3678,章程,2018-07-14 04:44:40,22,56,34,刚刚结束章师的民法（下），巨怂的我直到老师退群了也没敢加老师的微信，有些话不匿名也不好意思说出口，所以觉得在这里留言，也是一个很妙的办法。\n\n据我所察，章程老师是一位学问与人格皆优的好老师，也像是一个从民国走来的江南才子，这是学生之幸，也是浙大之幸。有时候会感叹，身边有这样闪闪发光的灵魂，是一件何其幸运的事情。\n\n章老师是很好的老师，可惜我不是一个很好的学生，常常会忘记自己到底要往哪里走，要做一个怎样的人，有时也会为了那些内心觉得不值得的东西去异化自己，陷入虚幻之中。不过，总感觉在走一条漫长而孤独的、充满自我挣扎的不归路的我，能够在途中遇见老师，就已经是一件非常值得感激和铭记的事情了。\n\n最后，（超小声）老师长得真的好像木村拓哉啊_(:зゝ∠)_
84866,3678,章程,2018-07-14 06:14:07,14,29,15,我是个男的 我爱上老师了
87256,3678,章程,2018-09-26 06:51:37,1,10,9,民国遗风，大家风范。大学最喜欢的老师，没有之一。
87437,3678,章程,2018-09-29 02:44:58,-2,5,7,非常享受，可惜，后期自己不给力，不配老师的教授之道，希望，合同法能再次见面。
87574,3678,章程,2018-10-07 11:53:33,1,7,6,我会永远喜欢老师
94760,3678,章程,2019-01-18 05:20:59,-19,31,50,偏爱提问女学生 不信可以问\n\n有点不是很注意男老师与女学生之间的界限\n\n思维很棒但是很散不成体系\n\n题难
97969,3678,章程,2019-01-23 02:53:35,0,7,7,………
98294,3678,章程,2019-01-23 09:30:00,-9,37,46,上面的评价太委婉了\n\n我直说了吧，老师您还是注意点男老师和女学生之间的界限比较好
98608,3678,章程,2019-01-23 15:43:29,12,36,24,老师和学生之间需要什么界限？一个是授人渔者，一个是习如何渔者，传道授业，界限为何？若男老师和女学生需要界限，请问女老师与男学生呢？甚至于男老师与男学生，女老师与女学生之间是否也应该有所分寸？法学的男女比不均，显而易见。章老师上课也是希望通过互动来了解各位的掌握情况。若是认为只提问女生不妥，想要被提问者如果向老师提出，我认为老师没有任何理由会拒绝好学者。老师从不点名，脸和名字联系的起来的同学也很有限，所以叫来叫去的可能就那么几个。但我认为老师是超脱、无所碍性格的人，纵然你们在这说什么，他也未必置意，也绝不会有奇怪的想法。不管如何，我很敬重他的为人，也很感激他愿意以平等的学长身份来与我们交流。
99179,3678,章程,2019-01-24 11:19:05,9,20,11,法学本身就是女多男少，楼上某些评论怕不是大清穿越过来的
99555,3678,章程,2019-01-25 02:49:29,-29,18,47,很偏心，不知道判断人的依据是什么，不愿意鼓励别人。
99598,3678,章程,2019-01-25 04:00:14,13,27,14,说老师偏心的我也服了，老师还不能有自己欣赏的学生了???  努力优秀善于表达的孩子在哪里都会引人注目。平常要去问问题，只要问，老师谁的问题都认真解答，对我们一视同仁，不知道哪里偏心了，别太酸了。
99741,3678,章程,2019-01-25 06:14:16,12,26,14,我不明白物权法出分之后为什么评论突然变得有点歪？老师一直是一位尊重学生也愿意和学生沟通交流的人，正是因为他和我们之间的年纪差别不大，所以和学生之间自然也更亲切一些。偏心女生这个结论？他明明对积极表现自己，学习认真努力的男孩子也很看重，在给我们的长文里面都有写到。老师对这学期我们的学习成果非常不满意的原因，还不是大家没有好好学？扪心自问一下，你对物权和民总究竟认真学过了多少？花了多少时间？程宝和陆帅用两种风格表达了他们的恨铁不成钢，为什么不先反省自身，而是先想着怪老师呢？学法学静心踏实，去掉一些浮躁吧。
99771,3678,章程,2019-01-29 13:13:07,7,14,7,楼下的?精是生活过的多不好才会说出这种话？
100723,3678,章程,2019-01-26 15:35:17,-17,9,26,呵呵呵
101594,3678,章程,2019-01-29 13:33:19,-37,29,66,某些人只是有好皮囊好家世就性格张狂，根本算不上勤奋努力，亲近这种人却忽略默默勤恳低调的同学，让人很难受好不好？
101884,3678,章程,2019-01-29 12:26:08,5,13,8,你可快酸死了吧，明明是自己不起眼反过来怨同学怨老师，你柠檬化精还是酸醋成人？嫉妒人家这嫉妒人家那的，喝点水稀释稀释吧别自己融化了
101892,3678,章程,2019-01-29 13:16:38,0,10,10,好好的评论区撕什么逼？真是看不下去，老师人很好，同学也很好，有空在这撕逼不如多看看书，好好想想自己考试为什么考不好。
101895,3678,章程,2019-01-29 13:58:10,7,15,8,自己不好不要怪老师忽略，你以为老师的精力是无限的吗，你知道私下这些所谓被偏爱的学生有多好学，多热爱思考吗？不要凡事从别人身上找问题，扪心自问一下，你真的努力了吗？
101897,3678,章程,2019-01-29 14:22:10,19,34,15,行有不得，反求诸己， 这个道理都二十岁的人了难道还不明白 ?某些评论除了显示出自己的胸襟和格局很小之外，再无其他用处。
102557,3678,章程,2019-02-08 08:09:08,0,7,7,。。。
102558,3678,章程,2019-02-08 07:56:19,0,14,14,好皮囊好家世说的是哪位同学啊...安心上课的同学表示怎么感觉这一学期完全没发生评论里提到的事情...真的是表面和平内里一团糟，害怕了，一门专业课有必要这样吗，还扯到了家世样貌什么的，我也没感觉课上出现了什么大美人大富豪啊
103640,3678,章程,2019-03-03 14:36:12,9,13,4,很好的老师
103649,3678,章程,2019-03-03 15:14:13,24,37,13,老师是给予我启蒙的人，我永远不会忘记他在第一节课给我的启迪与震撼。很少有法学老师会带你讲历史，讲民国风物、台北烟云，讲一切的一切和未来的未来。我深深遗憾自己的年轻、幼稚与浅薄，始终无法与老师进行深入的交流。但我也深深庆幸自己的年轻、幼稚和热情，让我能好好地、认真地、专注听老师讲课。我的大一是老师，大二也是老师，大三、大四，也还是会去听课。老师曾经说过，大学里风云际散，老师与同学，能做成朋友的很少，但他会认真对待每一分，每一秒。就是这样的热忱我永远不会忘记，就是这样的真诚我永远都会珍视。感谢让我遇见老师。感谢那两年民法的课，为我灵魂渲染的底色。
103696,3678,章程,2019-04-29 03:26:02,5,24,19,老师是很认真的，但讲的emmmm
103718,3678,章程,2019-11-15 04:53:26,8,27,19,这么帅讲课这么好的老师不管给我几分我只能给10
104010,3678,章程,2019-03-09 11:50:30,24,44,20,非法学专业男生但是上了章程老师的物权法以及听了老师给陆帅的债法代课。对老师印象很深刻的一句话是“你们都还是宝宝吗？”都是成年人了，老师不哄你你就学不了了？某些从小被老师夸到大的天之骄子可能接受不了自己的平庸，但很抱歉，老师不鼓励你是因为你真的学的很差。事实上，任何人也没有鼓励你的义务，要对你负责的只有你自己。至于觉得老师优待谁漠视谁，阴谋论之前先想想人家比你多做了什么。遇到点事就觉得全世界都对你不公平，你是遭了天妒还是有皇位继承啊？
105225,3678,章程,2019-04-08 00:39:44,23,37,14,对于一个人来讲，对于一个教师来讲，他的很多东西都是终将要化为灰烬的，师者心有时是烈士心，谭嗣同讲“我愿将身化明月，照君车马渡关河”，月只是因日而明，当车马过河，见到真正红日之光后，彻夜而亮的月明，它的使命也即告完成——所谓“我”，不过是知识和热情在这个身体上流过，所谓“我”，不过“你”和“他”相识的一个过程而已。\n\n\n\n读到这里，各位应该知道，我写这封信的真正目的，并不是为我的课程试验的可能致损而道歉，而是想请大家认真再问问自己——在进入这个国家倾心注力、社会寄予厚望的大学之后，在学习这门具有千年正义历史的学问之后——各位到浙大做什么？将来毕业后，要做什么样的人？\n\n\n\n祝福各位的未来！
105350,3678,章程,2019-04-10 10:07:29,23,45,22,师者心纵然是烈士心，谁又忍此心终化灰烬？长夜里如有人拾得火炬，点火者就不必永怀悲情。很感谢老师是启发我的人，很抱歉老师不是启发我的人。很高兴老师是陪伴我的人，很遗憾老师不是陪伴我的人。在老师这里我看到了理想，在老师这里我又放弃了理想。这一切的路感谢老师为我照亮，而后又以沉默告知我无人会抱着你去远方。太阳在地平线沉下的山谷，太阳还会升起。月亮在地平线围拢的苍穹，月亮永不熄灭。此夜有黎明将至，而若其竟终归于无，曾闪耀的都将闪耀，曾留存的终究留存。\n\n也祝老师一切都好，转身之际，有山南山北雪晴，千里万里月明。\n\n
107453,3678,章程,2019-05-05 09:11:43,39,69,30,听了两个长学期他的课，说实话老师的讲课方式不易令人接受，太容易沉迷于自己的那一套了，学术探讨可以，对初学者来说还是太难。题目也是一样，要求非常高，不重视基础，所谓法律思维其实就是他自己的逻辑。外人看来很有意思，真的听课者却不一定接受。
107914,3678,章程,2019-05-11 11:07:54,9,13,4,我会永远喜欢老师！
108301,3678,章程,2019-05-20 14:32:24,9,13,4,课喜欢，最喜欢的还是第一节课hhh。这种个性的老师浙大不多了，且珍惜
108868,3678,章程,2019-06-03 11:44:53,18,27,9,不计利害 只问是非
109149,3678,章程,2019-06-10 07:03:11,14,21,7,打了十分，是感恩。但是有句话不得不说，你可以喜欢，我也可以不喜欢。界限是个好东西，希望大家明白。
109434,3678,章程,2019-06-14 12:09:29,10,17,7,平常可乐，生气可怕，哈哈哈哈，很可爱的程少(⁎⁍̴̛ᴗ⁍̴̛⁎)！不打十分怎么能行（如果我说老师点名会不会被群骂，开玩笑，老师最不喜欢的就是点名了，课堂根本就不需要点名～(｡ì _ í｡)～因为没人缺席）
109659,3678,章程,2019-06-18 07:39:15,7,13,6,啊啊啊啊啊啊我爱程宝
109709,3678,章程,2019-06-18 15:34:12,2,14,12,有妻有女 为人师表
109824,3678,章程,2019-06-19 13:20:38,11,19,8,有幸能上“浙江大学空前绝后的”最后一届民法下～虽然还没有期末考试，而且能预料到期末会不简单…但是还是要说，章程老师给大家带来的精神内涵远不仅仅是一门民法课这么简单。\n\n\n\n印象最深的就是老师说的，被藏在zjg图书馆楼梯角落里竺老的话：“只问是非，不问利害”。希望有一天我也能成为精神自由的人吧！
109914,3678,章程,2019-06-20 06:48:40,7,13,6,难得的好老师！
109926,3678,章程,2019-06-20 08:11:01,11,18,7,看到章老师写的关于国爸爸的文章特意来刷个10?
110028,3678,章程,2019-06-21 12:41:04,10,17,7,老师很好 是我太菜了
110496,3678,章程,2019-06-27 07:09:37,10,15,5,复习累了刷个分，民法本来就是要下功夫的课，老师上课上的已经很明白了，会讲到立法背后的考量，上课没听懂的部分下课看一遍ppt也差不多能明白，实在不会还有很多答疑的机会，这么负责的老师必须10分
111101,3678,章程,2019-06-29 16:02:13,8,13,5,少一些凌厉，多一些自由。永远记得老师的话，三年后见。?
111327,3678,章程,2019-07-01 02:51:16,10,16,6,我之前觉得老师上课不知所云，直到我期末复习好好把书看了一遍再听录音，感觉老师讲的挺好的其实……感觉老师对自主的学习要求比较高，要提前做大量的预习上课才能跟的上，平时有两篇读书报告和小测，不能水，水了平时分真的很难看……
111339,3678,章程,2019-07-01 03:34:42,12,20,8,zcgg我不想吃小龙虾? ? ?
113374,3678,章程,2019-07-06 12:05:59,7,12,5,能听老师的课是我的幸运
113392,3678,章程,2019-07-06 16:00:23,10,17,7,zcgg真是一个温暖的人，这就是我们都爱他的原因\n\n真的很感动。一个学期的民总课程，听得很认真也很享受。这短短一个学期的接触中让我对民法学习对法学充满了兴趣与期待。\n\n老师在课上好像说过的，他站在台上教书对我们的影响是有限而短暂的。我现在再回忆一下，具体的知识内容可能不太记得了，感动的瞬间是为何感动也不太记得了，但我似乎慢慢了解到如何进入并学习法学这门学科、如何过好自己的生活、未来该怎么走去往什么方向……尽管只是似懂非懂，不论如何真的非常感谢老师！
113588,3678,章程,2019-07-07 00:35:18,11,16,5,何其有幸
114129,3678,章程,2019-07-09 00:36:57,12,20,8,我发现，这就是我想要成为的人呐。
114676,3678,章程,2019-07-11 03:33:36,5,15,10,zcgg就是我想要成为的人，唉，可惜结婚了，想嫁!
114920,3678,章程,2019-07-12 17:32:48,10,21,11,他博学，独立，风度翩翩，观点犀利而真实。说实话因为自己听的不是很仔细，上课走神了就听不懂他讲到哪，也不知道怎么复习…但知道好好听一定有收获。给分没想象的那么严吧，zcgg捞人还是感人的。
114922,3678,章程,2019-07-12 17:35:49,10,17,7,是满分老师，暑假快乐，也祝《民法》下辅修课程销号快乐。
115280,3678,章程,2019-11-13 04:18:34,10,24,14,对时代有诠释，对个人有启迪。满分老师，这是我期望在大学课堂听到的。虽然老师的思维有时候太发散了，偶尔跑偏，但是还是因此听到了很多不一样的鼓点。
115663,3678,章程,2019-08-17 03:02:39,7,28,21,空有理想情怀，教学经验缺乏
116359,3678,章程,2019-09-09 12:28:27,12,20,8,老师上课不仅仅注重“技工”的培养，还重视通识博雅教育，私以为，度把握得很好。尽管我上学期民总挂在及格边缘，但这不影响我的判断，老师的课真的很棒嗷，悄咪咪请求能够补选上物权法！
116537,3678,章程,2019-09-11 08:36:51,8,21,13,老师真的太棒了
118270,3678,章程,2019-10-24 07:02:09,14,46,32,作为一个法学院老师，个人认为把浙大和校外人士的关系和香港排大陆的事情相类比，不妥
118271,3678,章程,2019-10-24 23:38:22,-28,28,56,哈哈，八嘎
118275,3678,章程,2019-10-24 15:49:00,29,107,78,在此记录章程老师言行，无论有多少人踩也绝不任怂，这条评论当成为耻辱柱记录此人荒唐言论。\n\n2019.10.23日，浙大玉泉食堂出现严重食品安全问题。结合之前食堂定价奇高，餐补从未落到学生之手，校外人士与学生抢饭导致学生无饭可吃、无座可坐等诸多问题引发学生舆论爆点。\n\n此人在朋友圈转发学生对食堂问题的控诉下评论：\n\n“高贵的浙大学子们，一口一个‘校外人士’，如果标题改成‘香港社会乱象几则’，你们一定很能理解今日的港人。”\n\n试问：你用乱港叛乱的暴徒，类比诸多合理争取自身权益的学生，是何居心？试问学校最基本的，难道不是保障学生有的足够的饮食空间和安全的食物？学校连最起码的事情都保障不了，还在宣传欢迎校外人士前来没有问题？你在维护什么？你的风骨何在？
118277,3678,章程,2019-10-24 07:18:23,-5,41,46,逻辑思维混乱，把浙大因为食堂问题的学生比做港独，是真的很无耻了
118279,3678,章程,2019-10-27 05:55:27,6,31,25,....
118280,3678,章程,2019-10-24 07:55:25,-30,26,56,没选课，专程赶来打一分，求仕创薪的浙大只是你们的浙大。我们学生心中的浙大，则是竺校长领导下的浙大，公忠坚毅、担当大任，主持风气、转移国运，在每一个渴望公平、正义、自由、民主的浙大人的心中。
118281,3678,章程,2019-10-25 07:53:45,-18,27,45,。\n\n。\n\n。\n\n.\n\n。\n\n。\n\n。\n\n。\n\n。\n\n\n\n\n\n..
118282,3678,章程,2019-10-24 08:13:30,27,57,30,“南大当年也是如此。\n\n学校当然应该管理，被侵占资源、甚至受了委屈同学有戾气也正常，但是标题化地强调校外人士，甚至渲染扩散这种戾气，于事或有济，其伤亦多且远，让人遗憾。\n\n作为应当有知识有能力的人，年轻时的热情本可以是更有力量的。”\n\n10.24老师朋友圈的评论语，作为对引起争论的言谈的补充，又有多少人看到呢？\n\n作为台湾第一个陆生，老师在太阳花学运中写数文批判，在岛内引发极大关注反响。相比于在查老师对zc老师提出不满，试问各位的所谓热情对于解决事情又有多大力量呢？
118285,3678,章程,2019-10-24 08:45:02,23,48,25,老师所忧虑是制造对立、偏激与宣泄戾气，何来所谓政治恶意，又何来所谓揣测？他自己的评论已经说明，有知识有力量的年轻人们的热情应当是更有力的。所以这份有力难道就是排除异己，一言不合群起而攻之？难道只有附和声声、暴怒讨伐、顺学生发表檄文，才堪称师表？转移风气，在激愤之时保存冷静，在躁动之时提醒勿极端，不过是对更平和、柔韧态度的希冀，何必招来攻击？老师著过文、发过声、做过事，某些学生与其只知在匿名平台讨伐异己，不如审视一下自身，做了什么，求得什么，是什么？
118298,3678,章程,2019-10-24 11:56:45,2,27,25,我们所忧虑的是食品安全、就餐位置和就餐环境，何来所谓“浙大乱象”？为人师表有丰富的生活经验和社会阅历，能够在学生们对食堂政策的批判中保持冷静，确实令人佩服。但这份冷静就是将学生比作乱徒吗？学生食堂本就是为了师生服务，在校内有如此大的争议也不考虑存在了哪些问题，如何改正，而是希望同学们温和态度，这与劝你大度有何区别？老师以前有过著文发声做事，那么这件事情上就一定是正确的了？就一定站在最客观的角度？这是什么逻辑。某些学生只知道在匿名平台反对批评，而杜绝真正有意见和建议的人发生，难道不能反思一下自己做了什么，求到了什么，是什么行为？
118301,3678,章程,2019-10-24 23:49:12,-28,34,62,心术不正，枉为人师！
118302,3678,章程,2019-10-24 15:50:14,-21,41,62,法学院学生，1分送上，不爽很久了
118304,3678,章程,2019-10-24 15:50:00,2,51,49,章程老师发言令人心寒，希望您能了解情况后再来评论此事，否则，与那些为废青黄尸张目的西方媒体有何区别？
118306,3678,章程,2019-10-27 00:23:49,23,68,45,诸位对老师的质疑，主要集中在以下几点：不爱国、求仕、脱离群众。仅讲几点事实，希望说这些话的同学自己反思。\n\n1.章老师在专业宣讲会上，以“浮沉再聚首，忠孝犹许国”为题；\n\n2.章老师一心放在教学上，这次也因直言而卷入许多无端的攻击中，是求是还是求仕，诸位自己考虑；\n\n3.在之江食堂，经常可以见到老师的身影，和同学们一同排队、打饭、寻找座位。\n\n切勿以小人之心度君子之腹。
118307,3678,章程,2019-10-24 14:44:50,26,48,22,整理几个被误解的点：（1）老师是就大家对食堂外来人士多的发言发表观点，而非食品中毒事件，当时食品中毒事件还没出来。（2）以香港作比确有不妥之处，但老师的用以类比的点是“港人对于大量游客赴港，影响正常生活存在不满”，这个社会现象在废青乱港事件前已经存在，与本次香港风波无关。（3）老师的发言点在于呼吁消除戾气，以更理性的方式解决问题。
118308,3678,章程,2019-10-24 15:02:59,20,38,18,老师只是希望大家冷静下来思考罢了，也希望大家能够足够理性。
118310,3678,章程,2019-10-24 15:07:25,51,114,63,对程师朋友圈评论的个人看法：\n\n1.最重要的一点，先确定政治立场（前提）：显然程师之评论对于学生和香港废青的行为都是持不赞成态度，所以其反对港独分子这点毋庸置疑（虽然明显但还是先说明以免出现政治立场问题）\n\n2.关于校外人士问题与食物中毒事件（背景兼题外话）:校外人士就餐问题是浙大各校区的顽疾，但是这与此次食物中毒事件关联并不大，难道疑似诺如病毒是校外人士带进菜里的？这种可能性有点可笑。那么为何会从食物中毒转变为集体攻击校外人士就餐问题？实际上只是食物中毒引爆了学生情绪，对食堂的不满积累后集中爆发，问题最大的当然就是校外人士就餐问题，所以首当其冲。但目前的舆论导向有一小半在攻击校外人士这并不十分可取，因为其问题的根本在于学校对于食堂就餐的管理制度。而这一点其实也是与食物中毒事件最大的联系，两者都是学校管理不当导致的问题。所以舆论导向的绝大部分在攻击学校。\n\n3.关于类比（重点）：学生与废青的类比是否恰当？言语可能过分了，毕竟废青暴力破坏无恶不作，而浙大同学远没有这么恶劣。但是很多同学仗着网络法外之地就一味辱骂攻击难道与废青就没有可类比性吗？作为理性的受高等教育的成年人，应该清楚的认知到，谩骂解决不了问题，学校食堂管理有问题这点我作为浙大学生十分同意，但不应该一味只知道攻击校外人士，攻击学校，这和香港废青攻击香港政府以及大陆恶性程度虽不同，但无疑也是有其相似性的。香港废青拒绝和政府沟通，一味加剧矛盾对立对于局势只是有害无益，浙大食堂问题虽然没香港问题严重，但网络攻击加剧矛盾对立并非解决问题的有效手段，沟通协商才是，借助网络营造舆论引起重视也无不可，但别因为网络而蒙蔽理智，失去初衷，这才是程师评论最想提醒大家的。
118313,3678,章程,2019-10-24 15:35:23,10,31,21,先生有风骨。诸君真是要养一养宽大之气，扫一扫自身的戾气。
118315,3678,章程,2019-10-24 15:52:36,5,26,21,很好的老师，很有文人气质
118320,3678,章程,2019-10-24 16:56:27,5,41,36,老师您那几个字写的是什么气？\n\n怕不是阴阳怪气
118321,3678,章程,2019-10-24 18:22:21,9,17,8,会好好学物权法的
118322,3678,章程,2019-10-25 01:52:40,8,37,29,不明白网暴群攻、禁止异见是什么正当行为，老师又得了哪些既得利益。对别人进行人身攻击之前，先听听自己说的是不是人话。
118323,3678,章程,2019-10-24 23:48:35,46,86,40,"呼吁理性可以，不过对于废青的比较和""鸡毛蒜皮""的解释可真不敢苟同。自己的文字就有失偏颇，显露戾气，结果不少人还洗他呼吁理性，浙大fan圈化真的厉害哈哈哈。那你们也别埋怨学校什么了，先看看自己嗷，谢谢啦！"
118325,3678,章程,2019-10-25 00:32:00,25,43,18,2008.4-2011.3 日本国北海道大学法学研究科，法学硕士\n\n2011.9-2015.1 台湾政治大学法学院，法学博士
118326,3678,章程,2019-10-25 01:20:06,23,65,42,本来口碑很好的老师，说了这么些先入为主、以偏概全、不务实不求是的话，令人寒心。
118327,3678,章程,2019-10-26 10:05:52,8,47,39,典型公知，学生正当行为伤害了其既得利益就开始狗吠
118329,3678,章程,2019-10-26 06:52:49,12,46,34,“哈哈  就这?”\n\n“鸡毛蒜皮。”
118337,3678,章程,2019-10-25 05:11:11,19,36,17,各位同学如果盲目相信自己的“正义”，抗拒一切其他的声音，那这个正义就没有讨论的意义啊。
118340,3678,章程,2019-10-25 05:49:12,12,38,26,不求是，瞎对比。
118341,3678,章程,2019-10-25 05:49:39,12,32,20,课是好课，人是好人
118342,3678,章程,2019-10-25 06:09:51,9,36,27,从公众号来的。老师是可以被我称为先生的。
118344,3678,章程,2019-10-25 07:41:35,4,16,12,对不起
118346,3678,章程,2019-10-25 08:08:09,2,35,33,请您到群众中去
118351,3678,章程,2019-10-25 09:13:34,-1,40,41,听朋友说过这位老师，口碑一直很好。然而近来的一些高高在上指责学生的发言，实在有点何不食肉糜的味道。毕竟老师又不用在玉泉的食堂和非校内师生一起挤食堂呢。寒心。
118352,3678,章程,2019-10-25 09:15:16,-6,30,36,不值9分，查老师评分嘛，鸡毛蒜皮小事，就这？
118355,3678,章程,2019-10-25 10:33:08,-13,22,35,鸡毛蒜皮，不值一提
118356,3678,章程,2019-10-26 02:42:23,-18,26,44,站着说话不腰疼的臭弟弟
118357,3678,章程,2019-10-25 12:21:42,-14,21,35,典型公知
118358,3678,章程,2019-10-25 12:42:14,-15,20,35,鸡毛蒜皮
118362,3678,章程,2019-10-25 14:45:35,-16,13,29,哈哈哈哈
118367,3678,章程,2019-10-26 02:44:01,-23,20,43,垃圾老师，思想已经跑偏了
118371,3678,章程,2019-10-27 03:04:32,17,46,29,上过课的都知道，毫无疑问的好老师。希望大家就事论事，停止无端攻击。否则与你们口中的“饭圈风气”有什么区别。如果真的要笔战，站出来堂堂正正打一场。没上过课也不认识人，不能客观评价只是在匿名平台上发泄怨气，算什么本事。
118373,3678,章程,2019-10-26 04:25:34,10,24,14,一位很认真的老师
118374,3678,章程,2019-10-31 12:09:18,15,31,16,老师文采逻辑格局都令人佩服
118375,3678,章程,2019-10-30 06:13:35,-3,45,48,是的，食堂事件根本不是重点。这个人的龌龊行径罄竹难书，只是外部人不知道罢了
118377,3678,章程,2019-11-15 04:53:54,6,32,26,这是我的老师，我为他感到骄傲
118379,3678,章程,2019-10-26 06:01:40,-8,29,37,没饭吃的高贵浙大学子不配听他的课
118381,3678,章程,2019-10-26 06:08:26,2,11,9,暂无哦
118390,3678,章程,2019-10-26 08:08:04,-14,15,29,哈哈 就这？\n\n
118392,3678,章程,2019-10-26 08:43:44,4,24,20,我想拉一下分 我心中老师9.9
118394,3678,章程,2019-10-31 12:04:21,1,25,24,老师真的很好！我爱老师?‍?
118397,3678,章程,2019-10-26 10:47:32,-7,18,25,脱离群众
118401,3678,章程,2019-10-26 13:37:59,-10,24,34,害 表面挺好的老师 却说了一些恶心的话
118407,3678,章程,2019-10-26 14:59:00,4,13,9,很大收货
118410,3678,章程,2019-10-26 16:18:46,-17,22,39,姿态比鼻子还高\n\n说句sb还是我过分了？
118417,3678,章程,2019-10-31 10:53:28,11,21,10,很好的老师
118418,3678,章程,2019-10-31 10:53:15,10,21,11,很棒的好吗
118419,3678,章程,2019-10-27 02:09:46,9,20,11,学姐说超棒，希望以后能听程宝的课～\n\n也希望大家不要因为场外言论恶意刷分啦
118424,3678,章程,2019-10-27 02:53:03,14,25,11,有些人恶意刷分刷评论并不能解决问题吧？建议你们先端正笔战的态度
118425,3678,章程,2019-10-27 14:38:25,6,19,13,对不起
118430,3678,章程,2019-10-27 04:27:03,-18,12,30,求仕创薪
118456,3678,章程,2019-10-30 06:13:45,8,44,36,了解了一些内幕消息，这是我人生中三观受到过的最大冲击。食堂事件根本就不是重点，表面风度的掩盖之下，唯一的真相被淹没在评论的谷底。衣冠禽兽，斯文败类。
118461,3678,章程,2019-10-30 06:25:48,1,39,38,之前朵朵上发过在教超有自称教授的男子勾搭女同学的事，大家都在骂。但为什么到了章程老师这里，在他有这么多和女学生的不当言论和举止时，仍在跟风无脑吹。课不评价，但所做之事，真令人恶心。
118466,3678,章程,2019-10-31 10:27:24,7,18,11,老师让我知道了读书的重要性，告诉了我什么是当代青年的责任。特立独行的风格，time will tell.
118467,3678,章程,2019-10-30 05:36:35,6,17,11,………
118474,3678,章程,2019-10-27 11:52:00,19,32,13,希望我们的同学都可以就事论事，如果不同意老师就食堂事件发表的言论，那可以理性讨论，反对或者批判都可以。但恳求大家不要做键盘侠，你一句“龌龊行径罄竹难书”“内部消息外人不知”说来容易，但它带来的伤害是无法衡量的。上升到人身攻击这一步就太寒心了，我们不是从来都反对网络暴力的吗，为什么现在自己却要捅出那把尖刀呢？如果大家是秉持求是创新的浙大人，那么请冷静下来，想想什么事情是真正应该做的。
118483,3678,章程,2019-10-31 10:27:17,9,18,9,听老师的课，看他的文字让人有安定感。“找到你想要的方向，然后沉下心来钻进去。”希望不辱师门。
118509,3678,章程,2019-10-30 06:42:09,6,17,11,好老师，课堂很有启发性，也很关心学生。请大家就事论事，不要毫无根据地张口造谣，如果真的想辩论，大家站出来实打实地论。都是明眼人，当喷子就没意思了。
118523,3678,章程,2019-10-28 04:42:00,-9,12,21,有点失望
118529,3678,章程,2019-10-28 06:30:08,-7,13,20,脱离群众太久了
118579,3678,章程,2019-10-31 10:27:33,10,17,7,老师讲得很好呀，课程有点难但是会很耐心地带着学生一点点梳理，课后解答问题也非常认真负责。可以感觉到是一个尽力想对得起自己对得起学生的老师，努力大家都看在眼里，也真的是非常善良也很关心人。课上有很多拓展知识，老师自己也是很博学很有才华的一个人。
118623,3678,章程,2019-10-30 06:41:35,7,16,9,老师非常爱学生，对于万般指摘他的学生仍然宽容以待。有些无凭无据空口造谣的人是不是该自惭形秽？
118634,3678,章程,2019-10-30 06:42:00,7,19,12,望诸君说话前先扫一扫戾气，自省一番
118655,3678,章程,2019-10-30 06:14:19,3,21,18,指责老师的作风和人品问题的同学，麻烦拿出具体的证据，真的存在问题必然要严肃处理，但是仅以“内部情况你们不了解”“他过去的龌龊事情多了去了”这类话语就对老师进行攻击，实在令人怀疑用心。
118656,3678,章程,2019-10-31 10:27:10,8,15,7,好老师，翩翩风度，博学强识，最难得的是对学生还有很深厚的关心。体系承苏永钦老师，格局很宽阔，想真正地悟透需要勤下功夫，也需要天分，所幸老师自己非常耐心，愿意一点一点地带着学生去梳理，在大学专业课堂上遇见如此真诚的老师是我们的幸运。顺便一提，某些小人的中伤行径差不多快人尽皆知了，只说一句，造谣犯法，望谨记。
118679,3678,章程,2019-10-30 14:37:32,1,9,8,还行吧
118688,3678,章程,2019-10-30 14:35:31,0,4,4,…………
118699,3678,章程,2019-10-31 11:55:47,3,13,10,很好的老师
119105,3678,章程,2019-11-10 10:59:42,2,10,8,超棒的老师
119479,3678,章程,2019-11-13 04:15:15,0,9,9,讲得很好，很有耐心的老师，答疑会长篇回答，讲不清楚还会打电话。非常负责。
119489,3678,章程,2019-11-13 04:50:43,-4,8,12,听说老师很久了，上学期上了老师的民法总论，才发现应该大学初入来听老师的课的。不仅仅是情怀什么的，各种案例分析和讲解也深化了我对民法的理解。
119617,3678,章程,2019-11-14 06:58:48,1,11,10,很有情怀，学识很渊博，专业课讲得也很好。
119683,3678,章程,2019-11-15 00:28:23,4,14,10,少有的在这个时代还带有知识分子气质的人
119733,3678,章程,2019-11-15 04:50:43,1,11,10,是能让人落泪的真正赤诚的好老师。
119809,3678,章程,2019-11-16 01:48:51,-7,8,15,大学最喜欢的老师
119873,3678,章程,2019-11-16 12:24:52,-7,10,17,很难评价，因为老师给人的影响实在是太深也太好了。教会人独立思考也教会人冷静，永远感谢老师。
120056,3678,章程,2019-11-17 08:31:39,-8,7,15,满分老师
120214,3678,章程,2019-11-24 05:07:22,-15,5,20,很荣幸，章程老师是我的老师。
121509,3678,章程,2020-01-23 10:07:31,15,38,23,腊鸡老师
121550,3678,章程,2019-12-12 13:02:14,-12,6,18,非常遗憾到了大三才见到老师，小小座谈会上老师真的惊艳到我了。如果能早一两年知道老师就好了
121845,3678,章程,2020-01-22 11:27:04,-14,5,19,zcgg 特别好 给分也很好
122298,3678,章程,2020-02-23 06:59:27,-13,8,21,我永远爱章程哥哥！！
122304,3678,章程,2020-02-23 19:37:34,-15,4,19,想问一下哪里可以检索老师在报纸上发表的文章～
122351,3678,章程,2020-02-25 03:03:46,-13,10,23,老师是一个精神明亮的人，每一次课都能够感染到我，尽管课程有些难，但是程师思辨的精神和对法学的洞见，是超越课程自身的收获，知识不是目的也不是唯一，此路漫漫，吾愿往矣！
122527,3678,章程,2020-04-02 16:53:39,-22,11,33,想写些什么，话到嘴边却什么都讲不出来，默默留下十分，三年后来当你的研究生
122704,3678,章程,2020-03-22 03:27:10,-46,10,56,真的好想好想嫁
122814,3678,章程,2020-04-09 13:52:02,-8,5,13,是你吗？
122951,3678,章程,2020-04-25 13:02:34,-1,7,8,…………………
123868,3678,章程,2020-06-15 11:27:29,-18,6,24,请问老师物权法给分怎么样
123924,3678,章程,2020-06-16 11:19:46,-18,11,29,满分老师
126302,3678,章程,2020-09-22 04:17:30,-22,13,35,学问人品俱佳，虽然有时直男和作壁上观到让我想锤他，但是是我这一年最喜欢的老师，没有之一，打十分是因为只有十分。当然，客观来讲，ppt要是内容更丰富一点，上课少提问多讲我觉得会更好。
130130,3678,章程,2021-01-17 16:24:51,-30,11,41,我觉得在章程老师身上能看到大学老师的风骨
131758,3678,章程,2021-01-28 17:57:22,-36,10,46,zcgg是那种让人觉得浙大法学院中国顶尖的神仙老师！知识、思维、为人、眼界，言传身教。要勇敢！
132267,3678,章程,2021-01-31 12:16:31,-29,7,36,是时听时新的课程，是超前完备的体系，巧妙地在课堂上平衡了我国现行法体系同法律人理想化法体系间的关系。\n\n强推
133483,3678,章程,2021-03-01 06:30:11,239,301,62,真诚地建议漂亮的女孩子退课，或者是不要加他的微信，否则大概率收到包括但不限于凌晨谈心、莫名其妙的请吃饭、没有边界感的奇怪聊天等一系列会给你的大学之初带来大量困扰的东西。一个会在研究生课上讲出自己的婚姻只有责任没有爱情的男性老师有可能是个学术不错的老师，但绝不会是个师德不错的老师。人品堪忧。
133600,3678,章程,2021-03-02 14:21:36,22,28,6,主要是教学态度不认真，不讲课
133782,3678,章程,2021-03-05 07:41:05,-2,2,4,123
134078,3678,章程,2021-03-15 07:30:39,110,117,7,学术水平优良，教学能力欠佳 民国文人风骨，笔墨尖刻有力 但缺少成熟的处事水准 章老师受台式政治学术影响颇深 有些问题，建议还是睁开眼看看大陆，看看学校 补充：个人偏见太重 自大 还叫学生送饭到办公室 和女学生纠缠不清。本科学生确实是戴着滤镜看的章程吧
134195,3678,章程,2021-03-18 14:23:20,98,104,6,本科一二年级觉得这老师真好，三四年级完全幻灭。远离吧，他不值得学生的敬爱与付出。
134227,3678,章程,2021-03-27 13:43:27,187,215,28,本人明确知道这个老师肢体骚扰过女生，并且聊天涉及性挑逗。但直到受害者毕业并明确同意之前都不会放锤。你们的维护与不相信只不过是为他继续当衣冠禽兽添加方便，毕竟这种事举报犹如螳臂当车。就像前面的人说的，回头看不过是一重又一重的漩涡。
134247,3678,章程,2021-03-21 08:43:52,165,186,21,看到突然那么多人来刷低分感动非常欣慰，终于有大批人认识到这个老师的恶心了。以前一堆人来刷什么“师德学问俱佳”看得我生理性反胃，奉劝各位女学生离她越远越好，抛开学问水平不谈，你以为的翩翩君子实际上不过是“骗骗”初涉大学的小姑娘的“伪君子”。没有空穴来风的言论，此人骚扰女生有目共睹。
134265,3678,章程,2021-03-22 03:56:25,1,14,13,有具体事例嘛
134282,3678,章程,2021-03-23 01:06:20,31,38,7,前排骑墙吃🍉
134285,3678,章程,2021-03-23 01:18:40,-58,17,75,我希望大家作为法学院的学生，理智发言，没有实锤不要当成实锤来传递，因为之前也有爆出是学生造谣……
134286,3678,章程,2021-03-23 01:26:37,98,105,7,人面兽心
134287,3678,章程,2021-03-23 01:32:32,58,72,14,风暴中心，囼弯野鸡大学博士，可惜了那些天真的女生
134288,3678,章程,2021-03-23 01:48:47,-46,17,63,请法学院的诸位先有证据意识！
134297,3678,章程,2021-03-23 09:54:09,101,106,5,请远离。
134300,3678,章程,2021-03-23 04:08:10,56,67,11,某位大佬教授爆出来的……如果真是他爆出来的话，我宁愿直接相信
134301,3678,章程,2021-03-23 04:12:49,-41,15,56,有实锤能不能打个码之类的放出来，或者是侧面证据，哪怕就一两句话的也好，让大家能够确认的确有这种情况发生了。索要实锤并不是想要让相关同学受到二次伤害，但是一直没有实体证据，仅靠口口相传和各种“据说”，其他人也无从判断事件的真实性，整个事件就会一直陷在“存在与否”的争执中，最后云里雾里的，这样大抵也不能起到警醒其他同学的作用……
134303,3678,章程,2021-04-22 09:26:05,142,157,15,回楼上所说的，锤是给吃瓜群众津津乐道的，如果真的放锤的话，一定会对受害者造成二次伤害。因为你不知道一旦放锤，会有多少人来找你的麻烦。至于事情真实与否，亲历者心中一定所有答案；没有经历过的，相信这些传闻就足以让你们生畏。不要去试图挑战，回头看不过是一重又一重的漩涡。
134304,3678,章程,2021-03-23 05:44:13,-31,4,35,很好奇是怎么纠缠不清？方便讲一下类似例子吗（其他人的、已经公之于众方便查阅的）？
134305,3678,章程,2021-03-23 06:01:40,-35,12,47,在没有任何实质性证据的情况下，要怎么让人相信确有其事？更何况去年有人造谣是实锤，相似的传言实在难以令人信服。不可避免，的确有人求锤只是为了津津乐道，但是想了解真相的同学，难道就真的要仅凭道听途说和风言风语就下结论？谁能通过毫无根据的流言就对一个人的品质做出判断？
134307,3678,章程,2021-03-23 06:47:39,4,8,4,挠头子，看了评论一脸懵逼
134333,3678,章程,2021-03-24 04:03:27,39,49,10,不评价性骚扰的事，但是玉泉食堂诺如病毒事件、紫金港泰和路事件这位老师评价学生运动的推文可都是实锤哈哈哈。SB一个
134340,3678,章程,2021-03-25 05:43:35,50,51,1,。。。傻逼
134350,3678,章程,2021-03-24 13:44:07,25,25,0,慎重选
134364,3678,章程,2021-03-25 07:04:58,128,132,4,一个老师，对学生说出“如果我年轻十岁肯定追你”这种话，无论如何是严重的失范，在国外恐怕能不能保住教职都是问题。女生前男友因此举报他，我也不认为就是你们所说的“造谣”。频繁与女生聊天、课程结束前请吃饭、开车载女生回寝室、在朋友圈下品评女生身材外貌衣着，这些事情选课学生与法学院学生有目共睹，真有人要盘他，拍个照截个图都不是难事。哪怕涉事女生并不觉得冒犯，不认为自己是受害者（甚至甘之如饴），但一来不排除有评论提到的大一大二学生涉世未深，更重要的是这些言行已经破坏到学校的教研秩序和师生关系公平纯洁，师德有亏四个字一点不过分。师生关系这块在国内校内确实没有明确的规范，但一个口口声声大学精神、教学热情、学问之道、公平正义的人，你们对他为师的要求难道就是没有实锤性骚扰？希望他本人和维护他的同学能认识到问题的严重性吧。
134368,3678,章程,2021-03-25 16:27:30,119,122,3,1.和大二女生说“你是求是园第一小可爱，不舍得不跟你讲话”2.跟自己班女生说“年轻十岁我肯定娶你”，并邀请她一起出去玩3.深夜给崇拜他的女学生发信息聊和学习无关的话题，不止一个，发言包括“婚姻没有意义”“我和妻子没有爱情只有责任”4.主动开车送女生回宿舍，不止一个5.在女学生朋友圈下评论“最喜欢你了”6.评论女学生腿粗，脸大，腰细不细 先列到这里每一项都有人见证这个老师口碑从很好到很差会是没有理由吗，很会装真的恶心女孩还是小心点吧
134380,3678,章程,2021-03-25 10:21:14,27,30,3,呵呵，恶心玩样
134385,3678,章程,2021-03-26 00:42:06,90,94,4,感觉楼上的那些话有些熟悉，原来是对我也说过…“如果我年轻十岁肯定来追你”，所以他是不是对每个女生都会这么说，都不换套话术。
134408,3678,章程,2021-03-27 04:59:03,-88,12,100,只见男女授受不清，何知仅是愿与学生交好，何见与男生的交往亦同碗水端平。\n\n女孩子多多保护自己没错，但实锤之前，这更像是女权盛行当下的过度敏感。
134414,3678,章程,2021-03-27 13:27:38,149,157,8,本来不想在这件事里发声，但楼上的评论看得我窝火。什么叫“只是想与学生交好”？三更半夜找女学生聊他的情史，表示对自己婚姻的不喜爱；主动问学生给她送零食，并表示“喂你”；在女学生进办公室的时候故意手抚她的背部；当面对女学生说“你的腿不错”……如果恶心人也能叫做“只是想做好朋友”，那动手动脚是不是也只是“想拉近师生的距离”噢？还女权盛行的过度敏感？你知道学校论坛帖子发一个删一个吗？你知道已经有知道内情的人被叫删评吗？好老师很多，怎么只黑他一个啊？现在是什么权的过度敏感看不出来吗？？？？？
134415,3678,章程,2021-03-27 13:55:13,82,82,0,性骚扰事件并非虚构，受害者不止一位，可以说是惯犯，甚至可以说成了某种套路，同样的话对不同的受害者或潜在目标都来一遍，女学生快跑。
134762,3678,章程,2021-04-14 04:17:17,25,25,0,没有零分很可惜。
134801,3678,章程,2021-04-15 12:00:08,77,79,2,章程给研究生上课那叫上课吗？居高临下的批判指责 压迫式的教学 学不到任何一点东西 还在课上大放厥词：你们的评分对我而言没有任何影响。欣赏有傲骨的文人 但前提是自己人品过关吧
134944,3678,章程,2021-04-24 09:22:21,24,26,2,此乃控评？\n\n之前的评论都被删了？
135215,3678,章程,2021-05-06 05:29:25,13,14,1,删除评论？这波操作服了
135832,3678,章程,2021-05-28 07:45:12,6,7,1,....
135938,3678,章程,2021-06-04 03:16:14,10,14,4,啥b玩意
136051,3678,章程,2021-06-10 09:37:01,44,51,7,又当又立，自以为是。章程如果是和他的学生同期的同学，也不一定能排到前面。不知道为什么凭借着一点年龄阅历的差距觉得自己高高在上。真清高就算了，背后还热衷于搞女学生。真的恶心，衷心希望下一次看到他是讣告。
136295,3678,章程,2021-06-16 01:09:40,13,16,3,不谈人品，只谈课堂教学。民总差强人意，亲继是真的有些乱……
136381,3678,章程,2021-06-17 08:18:14,46,50,4,不懂就问：为什么有那么多zc的舔狗？是他的渊博的学识、高尚的人品令你们折服吗？\n\n出了这档子事情还有个别女同学在pyq和他互动来互动去的，也是佩服。
136756,3678,章程,2021-06-24 05:01:43,4,11,7,单纯评价课程。财产法、尤其是物权讲得很好。亲继可能是第一年开课的原因，整体脉络还是比较清晰的，但具体授课过程中有点乱...看出来老师想把法条背后的人类学、社会学、历史学背景介绍好但因为课时和备课原因没有协调的很好，建议结合隔壁班的ppt学习效果更佳
137147,3678,章程,2021-07-01 12:58:42,24,29,5,女同学们快跑
138414,3678,章程,2021-07-09 04:09:35,-10,5,15,感觉老师还可以
139697,3678,章程,2021-07-20 08:05:26,24,28,4,你好，不配做老师可以不做
139789,3678,章程,2021-07-27 00:08:14,7,8,1,亲继怎么还不出分
139897,3678,章程,2021-08-13 12:13:31,7,10,3,给爷爪巴
140164,3678,章程,2021-09-01 12:12:53,4,6,2,这个系统还能用吗
140171,3678,章程,2021-09-02 06:44:09,7,9,2,风暴中心[ac5025]
140193,3678,章程,2021-09-04 07:58:13,35,43,8,章程性骚扰女学生在浙大已经不是新闻了
140951,3678,章程,2021-09-18 07:03:33,0,1,1,23333
141540,3678,章程,2021-10-13 23:37:22,-4,19,23,不能理解为什么那么多喷子。至少今年秋冬学期章老师讲课密度很大，很有收获。学术水平真的非常高，人也很幽默。
141715,3678,章程,2021-10-21 12:06:02,-18,8,26,差评滚
143733,3678,章程,2021-12-03 08:45:43,-18,11,29,喷子滚 老师好
143831,3678,章程,2021-12-08 03:17:43,20,25,5,师德师风问题比较突出
143936,3678,章程,2021-12-13 10:53:17,17,25,8,好nm，楼上是什么牛马，你觉得zc好就和他搞呗，sb
144983,3678,章程,2021-12-26 07:50:41,6,30,24,什么b老师，上网课yygq学生，还特别记仇，物权法讲的无聊死了，拿着话筒在后排都听不到声音，好好地发个历年卷还非要搞个什么总结，来搞学生心态，物权法只有他开真是见了鬼了，倒八辈子血霉，气死了气死了，还有，补课可以，把握好时间可以吗，三个半小时坐尼玛，六点半上课十点钟下课，您可真行
145127,3678,章程,2021-12-27 14:29:22,18,30,12,就事论事来说，这学期章老师物权法课讲的很清楚，已经尽可能地把学理+实体法+例子进行结合了，我觉得学到了很多。楼上的，物权法的难度摆在这里，换个老师你就学明白了？老师星期天晚上自己拿出时间来补课，知足吧，不想听可以不听，老师也说了受不了的可以回去。\n\n可能以往老师确实出过师德问题，就这学期的表现来看，没有迹象表明他在刻意亲近女学生，或许是前人的抗议换来了他的谨慎吧。
147382,3678,章程,2022-01-10 01:31:44,-4,10,14,老师讲课知识点很多很细致，是真正的“研读”法条，除此之外还会拓展很多立法司法层面的思考，涉及经济文化政治各个领域，可以感受到其学问研究之深度与广度。上课压力很大，是我这学期学的最累的一门课了，但也是收获最多的一门。虽然我太菜，没记住什么，但起码感受到很多知识流经了我的脑海。\n\n两位助教老师也很好，回答问题好清楚好详细，真的很感激！
147650,3678,章程,2022-01-10 10:57:45,5,10,5,老师很有意思，仔细听讲得确实不错\n\n虽然就记住了这个法条不好那个也不好/笑哭
149300,3678,章程,2022-02-02 07:45:37,0,0,0,我来看看大家的评论
149552,3678,章程,2022-01-16 02:42:07,-14,7,21,zc，我的男神
149553,3678,章程,2022-01-16 02:42:06,-17,5,22,zc，我的男神
149593,3678,章程,2022-01-16 06:10:58,-18,8,26,不能理解的问题个人认为源自知识本身，老师已经穿插了足够多的案例讲解；初学时接触多种观点确实会比较懵，但老师在继受法学方法论上的观点弥足珍贵；总的来说就是，zc是男神！！！
149925,3678,章程,2022-01-17 23:40:13,-10,4,14,zcnb，wtsb
150090,3678,章程,2022-01-19 03:07:24,1,1,0,。。。
150387,3678,章程,2022-01-24 02:31:13,4,4,0,物权不会给我挂了吧
150432,3678,章程,2022-01-25 07:44:38,9,13,4,女生慎选
150452,3678,章程,2022-01-25 13:17:08,2,2,0,怎么还不出分
150985,3678,章程,2022-02-21 14:59:21,33,38,5,希望各位说“zc是男神”的大二的学弟学妹到了大三大四不会为自己曾经的言论和行为感到耻辱和恶心，以上。
151075,3678,章程,2022-02-23 00:11:30,6,7,1,。。。
151077,3678,章程,2022-02-23 00:37:13,14,18,4,可算是出分了，好与坏都是不论了，毕竟我知道自己学艺不精。没有见到骚扰学生的情况，可能是我爱坐后面，也不爱和老师交流，全程没有和老师说过一句话。但是课上的是引人入胜的，内容充实的。这学期来了看他好像变丑了点，不知道为什么
151078,3678,章程,2022-02-23 00:37:49,7,8,1,没想到分数这么差，真的备受打击，民法课里给分最差的一门，原本以为自己学得很好的……害……
151105,3678,章程,2022-02-23 05:31:00,14,17,3,师德不太行。
151322,3678,章程,2022-02-28 11:44:41,0,13,13,听多了习惯了讲课风格后发现真的讲得挺好的，给分也还行吧
152082,3678,章程,2022-03-25 04:20:14,27,33,6,没什么想说的，虚假的人文情怀
152122,3678,章程,2022-03-28 00:00:48,28,33,5,居高临下的批判学生并不是多么了不起的事情
153510,3678,章程,2022-05-03 02:15:30,10,19,9,垃圾中的垃圾
155164,3678,章程,2022-06-09 03:24:10,7,13,6,SB一个
155916,3678,章程,2022-06-16 13:57:28,-1,0,1,。。。
155949,3678,章程,2022-06-16 16:27:25,2,13,11,这位老师很有自己的一套教学风格，但无论前排的瓜也好教学方式也好真心不建议选他的课。如果选了就需要自己充分提前预习好课程内容，要是等期末再补天根本补不完。这学期合同法ppt很多好几百张一定要平时认真看，另外他的考试难度和别的老师比不止难一倍（详情物权法）。建议平时上课配合慕课b站的老师先了解课程内容和定义（尤其名词注释）。如果遇到不会不懂的内容事先查好实在不会了再去问。以上是连续两个学期选了他课程的法学院大二本科生的真实感受，也衷心祝愿看到这里的同学他的课不挂科。
156080,3678,章程,2022-06-17 11:46:38,7,11,4,期末我本以为自己复习得很好，认真听课上课记了厚厚的笔记，考试虽然很难自认为是答得不错，结果出分2.7，均绩一下子跌了0.2。打击其实挺大的，感觉自己的努力没有得到回报吧，毕竟物权法花了我一大半的心力去复习。从此以后我可能没有信心再去听他的课了。就这样。
159114,3678,章程,2022-07-06 11:11:21,-22,11,33,至少目前来看是没有所谓骚扰女学生的问题的（当然也不排除之前曾经有过）\n\n老师授课自有自己的一套逻辑体系，初听可能会觉不适应，但是两个学期下来是可以有所收获的。
159160,3678,章程,2022-07-07 07:39:26,-58,25,83,有实锤就放实锤，没有真凭实据就不要在这匿名摸黑。女生向老师讨高分（法学院保研奖学金基本都是一群心机女明里暗里竞争，实力不够，各种舔任课老师来凑），没有达到目的就开始编造骚扰情节各种开黑带节奏，看到高分同学就开始开黑学生和老师有什么问题，心理太阴暗了吧，不达目的不休，持续不断地到处刷恶评，一位好老师被黑成这样满意了吗。迫害妄想症这么重，心理这么扭曲，报复心这么重，去读女校吧
159184,3678,章程,2022-07-07 12:22:05,0,0,0,看看有没有
159185,3678,章程,2022-07-08 12:11:27,-41,12,53,一些事有的没的谁都不知道是否是真实的或是造谣的，所以各位看官还是不要乱说了。怎么没人提醒下老师，提防某些女生呢，难道就不存在女生目的未遂就污蔑啊，难道老师就不能是受害者吗。。。
159283,3678,章程,2022-07-10 15:29:08,-42,7,49,真的人性之恶喷涌。有锤放，没锤支持老师去告。
159347,3678,章程,2022-07-23 12:52:14,50,59,9,毕业生吃王超的瓜来到这里。最新的洗地评论真让人大跌眼镜！章程骚扰女生是有目共睹的事，最早在查老师揭露的就是男生，那时还被一些不明就里的女生说成是嫉妒中伤。后来女生们也慢慢觉醒，转而揭露他的事迹。几届学长学姐共同顶住校方院方的压力，不断抗议，章程这两年才不得不顾忌收敛，没想到换来优秀的后浪在校生这样评价，加害人反倒成了受害人白莲花。合着我们以后也不要对母校的教师有什么要求，也不必关心母校发展，浙大学生就不配拥有学术人品俱佳的老师呗。
159476,3678,章程,2022-07-23 15:46:08,-42,6,48,请不要把这里当成是个人恩怨的发泄地 更不要所谓代表他人发声
159487,3678,章程,2022-07-25 08:25:07,6,12,6,爱斯碧
159556,3678,章程,2022-08-09 03:44:07,34,42,8,楼下那些新的洗地评论真是看的人作呕，还什么“有锤就放，没锤闭嘴”，你tm以为人人都和你一样弱智啊，纯纯的nt。现在大一大二的本科生怎么都这么sb，坐享前几届的抗争成果不说，还一个劲喷之前受害的学长姐，将“污蔑”一词颠倒至极。没毕业之前，没有和光华法学院彻底say goodbye之前，绝对不会放锤。（实在忍不住激情开麦）
159675,3678,章程,2022-08-23 05:11:22,12,16,4,😅😅😅🤢🤢🤢🤮🤮🤮
159977,3678,章程,2022-09-12 05:58:56,14,18,4,呵呵，洗啥呢
160483,3678,章程,2022-09-24 04:29:27,6,11,5,pua
161756,3678,章程,2022-11-12 08:53:55,11,16,5,课上得很烂，自己却以为自己很高深
165048,3678,章程,2022-12-28 17:11:33,-3,2,5,蒽，，，
166731,3678,章程,2023-01-13 10:46:22,-43,5,48,匿名激情开骂的，你有诉求那就通过正当途径去维权，天天气急败坏地骂人有用吗，乌烟瘴气
167102,3678,章程,2023-01-15 03:25:30,23,28,5,叽里咕噜听不清也很无聊，直接导致丧失了对物权这门课的兴趣，可为什么张谷老师的课我能听得很开心呢
167361,3678,章程,2023-01-15 15:39:38,45,47,2,摁。就是想骂坏老师，凭什么不能骂。正当渠道维权？你觉得会有什么结果吗？不过是辅导员一通通的电话。乌烟瘴气？是谁的过错？我怎么不见xjy、zg等其他老师的评论区乌烟瘴气了。到底是谁的问题？大学生了，有这么愚蠢的发言我真的会笑死ok？
168037,3678,章程,2023-01-23 12:34:33,1,6,5,.
169583,3678,章程,2023-02-27 04:10:45,-96,11,107,法学院的学生是这样的，一点破事都要把老师批斗一下
173371,3678,章程,2023-05-22 02:46:58,0,5,5,嗯————————————————————————————————————
174721,3678,章程,2023-06-16 07:30:44,53,60,7,此人上课教学，就是他站在教室中心，而他那飞速膨胀的自我把周围一圈学生统统挤扁
174796,3678,章程,2023-06-30 09:26:33,34,42,8,喜欢pua外专业的和线上班的，说我们大概率要挂科
178169,3678,章程,2023-07-07 11:54:31,29,36,7,谢谢您，我挂了
178351,3678,章程,2023-07-10 14:48:16,1,15,14,我真心觉得老师上课挺不错的，尽可能讲的清楚明白，但有时候可能有一种文人的傲气，人品问题不了解不做评价
178378,3678,章程,2023-07-11 07:39:20,-24,9,33,人品不论 讲课不错 给分满绩 甚至是总评100 确实给分不错 也不点名 但是上课说话确实比较含糊
178687,3678,章程,2023-07-17 13:30:41,-14,4,18,修改一下我的评论 给分不错 讲课❓ ❓
178695,3678,章程,2023-07-18 12:12:05,-12,11,23,给分不错，讲课不错，人品问题没发现
178815,3678,章程,2023-07-24 07:41:57,11,22,11,性骚扰
178885,3678,章程,2023-07-28 05:24:02,6,18,12,太烂了
178890,3678,章程,2023-07-28 07:50:09,-44,9,53,实在看不下去了，说性骚扰的这位同学，你是直接受害者，还是你道听途说？自己都不知道有没有这回事，信口雌黄一位老师，你觉得合适吗？
178907,3678,章程,2023-07-30 08:23:03,40,55,15,不懂就问，这么多人都指出这个老师有过性骚扰，为什么还有这么多人给他洗？为什么还有这么多人喷揭发他的？\n\n如果真没有这回事，为什么矛头都对准他？浙大学子都闲的没事干吗？？？\n\n究竟是什么让他的舔狗这么多？？？？为啥啊？？为啥啊？？？
179245,3678,章程,2023-09-03 09:10:13,30,42,12,告诉你们一个小秘密，他会给59分挂科的。\n\n没事虽然我是56分挂的
181052,3678,章程,2023-10-07 02:50:29,-8,13,21,非常辣鸡，讲课不知所云，民法物权法都是他，无语
181721,3678,章程,2023-10-30 01:11:44,15,31,16,理性评价，上学期外专业线上班的民总，因为课程冲突平时根本没听过课，考试前花了5天把一学期的课从头听一遍，最后总评75。客观来说，一学期只学了5天拿这个分数我也没意见。我一个外专业的人只学5天都挂不了，说给分差的多想想自己有没有认真学。
184013,3678,章程,2023-12-06 06:54:44,-9,11,20,为啥没有零分
186315,3678,章程,2024-01-10 13:18:20,-12,18,30,外专业见识过贵学院学生的厉害，戾气太重
189017,3678,章程,2024-01-21 09:01:12,22,25,3,这学期上了他的物权，平时2次小测【20分*2次】+期末考试【60分】，如果求是地给分可能会很差，但是这次zc很捞。
189082,3678,章程,2024-01-21 15:26:46,22,25,3,2023年秋冬上的程师的物权法，两次小测＋期末考，上课从不点名，甚至小测也可以不到现场做，准时送达教师邮箱即可。仅论课程方面，老师确实逻辑清晰，体系完备，在备课答疑等方面都非常用心，白底黑字的PPT十分赏心悦目，还会给我们发他自己的讲义大纲，有时候12:25下课回答学生问题到下午第一节上课前。但是老师上课说话偶尔会有些含糊，加上他的思维很快，所以最好提前预习并且坐前排听课，这样效果会比较好（但是要做好可能会被老师点到提问的准备，答不上来可能会被老师呛两句，不过问题也不大）。一学期课上下来体验感还是非常好的，而且因为有小测，相当于变相push我们平时复习+整理笔记，所以期末考的时候也没有很多压力，我自己考前过了两遍笔记和小测内容，最后拿满了，感谢老师~！
189129,3678,章程,2024-01-22 05:28:43,24,28,4,上完了章程老师的物权法，还是非常推荐的。首先是讲课上，大概是因为章程老师喜欢删繁就简，老师课上的PPT大多删去了不必要的概念，并形成了一套有他特色的助于理解的概念体系，总的来说收获真的很大，有助于将难点理解清楚；在课程考核方面，因为章程老师比较注重难点的教学，他的课程考核往往都是偏难的，需要平时多下功夫；最后是给分上，这次给分真的相当捞了，真的感谢老师不杀之恩。
190258,3678,章程,2024-02-26 15:04:24,18,20,2,很不错的老师！
190369,3678,章程,2024-02-28 13:33:14,-14,13,27,前面的评论说毕业要锤老师的人呢，现在都24年了，你不会还没毕业吧
190381,3678,章程,2024-02-29 04:06:38,17,21,4,被他的知识霸凌得心甘情愿。也愿意和学生交流，收获很大，给分也好，喜欢zc都是仙品
190658,3678,章程,2024-03-13 12:44:13,14,16,2,这学期上的物权，老师物权法讲的很好，体系梳理的很清晰，有两次小测，变相促进我们复习，最后给分也很好，感谢老师！
190670,3678,章程,2024-03-14 03:21:49,19,21,2,不知情的事情不作评价。就课程而言，收获非常大。老师长了一张沉默寡言、郁郁寡欢的脸，但课程真的非常有意思！体系性很强，开始可能会有“为什么讲这个又讲这个？”但某一节课会突然有醍醐灌顶的感觉。\n\n而且有时候不能不感叹，老师本人真的蛮有个人魅力的。。。。
190748,3678,章程,2024-03-17 08:37:30,12,15,3,老师讲的很好，物权法民法请大胆选他！给分也很好！
192646,3678,章程,2024-05-26 14:29:49,4,8,4,大善人！
192647,3678,章程,2024-05-26 14:32:55,7,10,3,老师太善良了，给分超好，不用肉身到课，小测都可以线上提交，老师翩翩君子，风趣幽默
192766,3678,章程,2024-05-30 05:58:58,-13,14,27,这么好的老师，幽默风趣，平时分体谅学生，不知道有同学为什么会造黄谣，做人最基本的底线都没有
193127,3678,章程,2024-06-04 02:00:23,1,6,5,很好的老师，上课很幽默风趣
193424,3678,章程,2024-06-10 12:09:37,2,7,5,我导人真的超好
196251,3678,章程,2024-07-02 15:04:08,8,12,4,非常可惜没能上过章程老师的民总，在物权的时候狠狠体验了一把真正的“讲课的神”，从讲课水平上来说真的非常引人入胜，非常建议大家去听章程老师的物权法（zc哥研究方向也是公私交界，物权很对口，讲课水平也很高）。
197030,3678,章程,2024-07-06 23:10:36,13,17,4,本人所在民总课堂没有出现高点赞相关事件，但老师上课容易让人云里雾里(常说我们上山就懂了)，但是因为没有听过其他老师的课不能判断是否是民法本就如此。给老师发邮件老师会及时回复，回答问题时很认真，表达比上课清晰很多，所以听不懂有疑惑的非常建议给老师发邮件。最后，老师给分很好，卷面答案涵盖了很多种学生可能出现的情况，只要合理都会给一定分数。
197634,3678,章程,2024-07-23 04:35:01,11,14,3,奠定了我精神的底色
198530,3678,章程,2024-09-09 13:48:39,3,11,8,章程完全男神啊 民总满了太爱了😭 物权法男神我来了
199197,3678,章程,2024-09-19 02:44:51,6,9,3,老师水平很高，人很好，但是怎么总感觉物权听不进去，似乎有点混乱？
200422,3678,章程,2024-10-17 02:17:09,3,13,10,这么快就洗白了？
202936,3678,章程,2024-11-15 09:05:25,-9,17,26,浙大男老师职业危险，一不小心就是性骚扰女生，师德有问题，反正张口就可来，不需要任何证据，捕风捉影以讹传讹，甚至以此造谣有竞争关系的相关女生，说的人敢实名留名吗？？
205742,3678,章程,2024-12-12 01:55:22,3,11,8,他讲课真的有体系吗我说……就是乱，纯乱……东一榔头西一棒槌的方法很难说能从思维上把知识串联起来
206130,3678,章程,2024-12-13 05:57:37,8,11,3,zc的物权讲得真的非常好，和很多通说观点不同，提出的批判也很有见地，可以先了解一下基本通说观点再做学习。也会对法条做一些批判性的解读，认真听收获很多。
208546,3678,章程,2024-12-31 12:48:54,19,22,3,极其精通物权，老师的角色扮演的挺好的。千万不能因为他的黑料恨屋及乌，忽视对民法的学习。
213721,3678,章程,2025-01-19 09:07:36,-6,1,7,老师讲的有时候可能会有点混乱，搭配法考的视频一起复习会更清晰，但是给分很不错
213740,3678,章程,2025-01-19 11:30:03,-4,0,4,给分很求是……
213892,3678,章程,2025-01-21 04:47:18,9,13,4,之前各种贬低网络法，听说开始研究数据交易了？
219269,3678,章程,2025-05-23 14:59:34,1,1,0,重学术多于重形式主义的成绩构成
173869,4000,赵骏,2023-06-04 02:54:26,2,2,0,很不错
106699,4062,王晖,2019-04-29 03:29:31,1,2,1,还好吧hhhhhh
114942,4062,王晖,2019-07-13 01:26:23,3,5,2,知识零散
116676,4062,王晖,2019-09-13 02:32:17,0,0,0,课讲的比较慢，老师人很棒，就是给分好迷
124640,4062,王晖,2020-07-04 15:52:19,6,9,3,法理学。王晖老师真的好好。人美心善。事少分高。每一组讨论发言都会认真听，会鼓励。上课也比较有趣，虽然讲得好慢😂
124642,4062,王晖,2020-07-04 16:01:16,7,9,2,给分超好，上课氛围很棒，不会拘泥于课堂，讨论课五人小组轮流发言压力也不会很大，而且真的上她的课不会有很多来自老师的压力（可能更多是来自组员的督促或者其他组同学的精彩发言），总之很好的一个老师。最后再强调一遍，给分超好！
126047,4062,王晖,2020-09-17 02:50:48,6,7,1,因为她的课堂讨论，使得法理学是我在疫情期间唯二坚持听完每节课的课程，老师组织的课堂讨论都很有意思，给分也超好。法理学是我大一一年唯一拿到的满绩！！！
134268,4062,王晖,2021-03-22 06:29:01,2,3,1,人温柔，有雅量，学识颇深
136631,4062,王晖,2021-06-26 07:24:42,2,3,1,很好的
136834,4062,王晖,2021-06-25 10:31:31,0,2,2,法理学还是挺有趣的，总能听老师讲奇奇怪怪的案子，讨论也很轻松自由，但老师好像有点佛系哈哈哈，适合我这种比较懒的学生。
137170,4062,王晖,2021-07-01 16:24:12,2,2,0,很不错
138817,4062,王晖,2021-07-11 04:28:43,2,7,5,绩点好低啊，大家怎么样啊？
139889,4062,王晖,2021-08-10 07:27:46,4,4,0,不错哦
141358,4062,王晖,2021-09-30 14:20:56,1,1,0,国庆前最后一节课点名😷 😷 😷
151455,4062,王晖,2022-03-03 17:02:22,4,4,0,上课很有趣
152246,4062,王晖,2022-03-31 07:00:37,4,4,0,还不错
153869,4062,王晖,2022-05-14 12:58:18,5,5,0,就是个温柔的老师，从德国回来的真材实料的老师这是
156159,4062,王晖,2022-06-18 03:44:42,4,6,2,老师的法理开卷嘛？开卷就顶顶我让我知道
158724,4062,王晖,2022-07-01 14:36:55,0,1,1,法理学给分一般
163825,4062,王晖,2022-12-16 07:40:16,0,0,0,确实不错。
177146,4062,王晖,2023-07-02 01:52:08,3,3,0,感觉老师上课体系确实不太好，比较零碎，而且今年是不是给分普遍比较差啊，我自己分就不高，还听到好多同学说甚至创了他们的历史新低，冲着老师给分好来的同学真的要慎重考虑
177175,4062,王晖,2023-07-02 03:59:26,2,2,0,点过一次名，给分很迷，因为卷子比较简单，我几乎大部分题目都很有把握，但是最后分数很低，唉:-(
177812,4062,王晖,2023-07-05 02:39:07,5,5,0,分好低。。虽然平时也是水过来的，但是也不至于这么低吧。平时发言也有好好准备。今年有不少被薄纱了的。
179053,4062,王晖,2023-08-26 10:04:35,5,5,0,我们这学期给分确实不行，而且讲得比较散，备考很难抓住重点……课堂讨论比较有意思，老师也比较温柔，别的就……
179674,4062,王晖,2023-09-19 07:40:31,4,4,0,平时人很好，卷子不难。但给分意料之外的低
191425,4062,王晖,2024-04-22 00:10:26,0,0,0,老师讲课比较深入浅出
197453,4062,王晖,2024-07-15 11:57:16,0,0,0,王晖老师还是不错的，法理学四节课的大课，前两节课我基本都会认真听知识点，老师讲的比较的深入浅出，听起来没有压力，还是比较有意思的。后两节课的讨论课小组轮流发言，我基本没听过（还是可以听听同学的意见的）。总之，王晖老师个人觉得是很好的，比较适合我，不卷轻松~
117510,4163,聂原,2019-09-25 08:07:48,0,0,0,思想得到升华
144968,4179,夏立安,2021-12-26 06:01:48,10,13,3,夏老师讲课很有意思，很有个性（虽然一些观点略有偏激，但是毕竟是学术探讨可以接受），条理清晰，尤其是能把抽象晦涩的法理学的知识讲明白，能把知识讲进同学们的心坎里，在授课水平方面远超法学院老师的平均水平。\n\n但是提醒一下各位女同学，尤其是那种小家碧玉柔柔弱弱类型的女孩子，保持一点警惕心，不要被夏老师立的一身正气的人设唬住，尽量不要和他走得过于近了，有可能会被他提出一些超出师生关系的非常过分的要求。
74130,4208,李世阳,2018-02-05 13:37:08,1,2,1,老师上课很认真，而且给分好好啊～
74139,4208,李世阳,2018-02-05 15:22:53,4,4,0,李博士上课超有意思，试题超强?给分超好！
74143,4208,李世阳,2018-02-05 15:38:25,3,4,1,上课不点名，期末开卷，考的都是上课讲过的理论、知识点。上课认真做笔记，期末会省很多时间复习。 最后，李博士的给分真的太好了吧！！
74146,4208,李世阳,2018-02-05 17:19:29,3,4,1,人好，课程有趣，给分好=李世阳老师刑总。
74148,4208,李世阳,2018-02-05 18:34:51,7,10,3,给分好到无法理解自己怎么能拿到这个绩点
74156,4208,李世阳,2018-02-06 01:24:47,1,2,1,老师给分超好啊，上课内容很丰富也很有趣，最好能带支录音笔方便整理笔记，考试开卷（虽然不知道以后还是不是这个形式）
74225,4208,李世阳,2018-02-07 07:27:48,6,8,2,给分超好超好，上课很有趣，会介绍很多种观点，每次都拿自己举例，同学们我现在嗑药了陷入了一种很嗨的状态hhh
74329,4208,李世阳,2018-02-11 06:29:48,31,35,4,一位被法学耽误的编剧
74405,4208,李世阳,2018-02-19 16:02:57,1,2,1,还不错
74948,4208,李世阳,2018-03-07 00:14:50,3,5,2,给分超好
75398,4208,李世阳,2018-03-10 11:30:37,3,6,3,老师人很好呀，给分很nice，讲课也很有趣，就是少了一点体系性。讲课不好做笔记，很跳跃。
75598,4208,李世阳,2018-03-14 01:31:32,10,13,3,李博士其实体系很清楚，就是每次都会因为我们不回应觉得我们没听懂然后翻来覆去换方法讲一个概念很多遍，给分超级好！！！！顺便真的好想念他为什么不来上刑分?
75795,4208,李世阳,2018-03-18 14:27:33,5,6,1,真的太太太喜欢李博士了！！如果刑分还是他来上该多好啊！！
80478,4208,李世阳,2018-06-27 03:17:15,3,4,1,老师很可爱！
91013,4208,李世阳,2018-11-29 03:03:59,1,1,0,请问比较刑法是论文还是考试呢
91722,4208,李世阳,2018-12-19 01:06:52,-32,10,42,我觉得起码一个人要懂得尊重他人吧，李博士每节课重复一遍类似上课时间太少（本学期李博士教授半学期的刑分）你们没有接受先进刑法教育的言论，至少在我看来是对前一位刑法老师的不尊重，更何况我觉得前一位老师教得很好。李博士滔滔不绝地讲着他曾经接受到的刑法理论同时主观觉得我们从来不曾接触过这些是总论教学的失败，但事实上在总论的教学中已有涉及只是我们无法像他一样口若悬河。真的受够了某些留学回来的老师每节课不接地气“掉书袋”般地搬弄自己的学问且不尊重他人。
102350,4208,李世阳,2019-02-01 05:39:32,9,11,2,老师讲的超好
102455,4208,李世阳,2019-05-06 10:59:28,-22,11,33,我觉得起码一个人要懂得尊重他人吧，李博士每节课重复一遍类似上课时间太少（本学期李博士教授半学期的刑分）你们没有接受先进刑法教育的言论，至少在我看来是对前一位刑法老师的不尊重，更何况我觉得前一位老师教得很好。李博士滔滔不绝地讲着他曾经接受到的刑法理论同时主观觉得我们从来不曾接触过这些是总论教学的失败，但事实上在总论的教学中已有涉及只是我们无法像他一样口若悬河。真的受够了某些留学回来的老师每节课不接地气“掉书袋”般地搬弄自己的学问且不尊重他人。
103711,4208,李世阳,2019-03-04 11:30:46,6,6,0,好，喜欢！
105479,4208,李世阳,2019-04-15 06:06:17,5,7,2,赞赞赞
106698,4208,李世阳,2019-04-29 03:28:06,7,7,0,超喜欢李老师，刑法深入浅出，笔芯！
107522,4208,李世阳,2019-07-04 15:07:27,72,89,17,大二有幸得上李世阳老师的刑法总论，大三重回刑事案例研习的课堂，李老师开口讲课的那一刻，我险些没有控制住自己的眼泪，我已经太久太久太久没有听到这样的讲课了！到了山上的这半年多里，曾让我一度怀疑自己，怀疑自己的学习状态和学习态度—— 一台复读机？一百多台复读机？精彩的个人表演？水分十足的分数？我们迎合着老师的自我感动？更有甚者语出惊人，让学生们不得不质疑其师德人品，有时我也会恍惚间以为自己在上大一的通识课……这样说或许是大不敬，但我还是忍不住想问一问，借用一位同学的话，到底是一些老师们放弃了假装在教学，还是我真正放弃了学习…\n\n    我们学院有很多优秀的年轻老师，陆帅，程宝，李博士，春燕女神，诚然跟谷神，章老师这样德高望重的前辈们相比，他们的讲课还有一些不足，或许没有那么凝练老道，对课程时间安排的掌握不够精准，但是相比于一些事业编制下得过且过的老员工们，他们的课堂是实实在在地能让你感受到一种活力，一种学术的生命力，让你得以窥见法学这个庞大的知识体系深沉又磅礴的魅力，从物权，债法，行政法，到合同法，刑法，每一堂课都有同学早早来占座，每一堂课大家都聚精会神地听课，思考，对法学的感情是在一点一滴知识的积累，框架的搭建，思维的培养中渐渐发酵，是在日复一日的求学与教学的过程中越发深刻。\n\n    能再次坐在李博士的课堂里，我满怀感激也觉得难受，我只希望学弟学妹们千万千万要珍惜紫金港这些基础课程的学习，我们要庆幸，起码我们有最好的启蒙老师，让你在往后的求学生涯中，不至于成为被“误”的子弟…\n\n    为什么学习法律？为什么学习法律？不管当初为何选择它，在成为法学生之后，我们就需要承担起这份责任——不管你今后遭遇了怎样的“教诲”，法律人的信仰不可灭，作为健全的法律人的人格不可侵犯——因为我们是什么样，中国法学的未来就是什么样。
107541,4208,李世阳,2019-05-06 10:56:03,-10,7,17,我觉得起码一个人要懂得尊重他人吧，李博士每节课重复一遍类似上课时间太少（本学期李博士教授半学期的刑分）你们没有接受先进刑法教育的言论，至少在我看来是对前一位刑法老师的不尊重，更何况我觉得前一位老师教得很好。李博士滔滔不绝地讲着他曾经接受到的刑法理论同时主观觉得我们从来不曾接触过这些是总论教学的失败，但事实上在总论的教学中已有涉及只是我们无法像他一样口若悬河。真的受够了某些留学回来的老师每节课不接地气“掉书袋”般地搬弄自己的学问且不尊重他人。
108261,4208,李世阳,2019-06-12 09:49:24,25,26,1,李博士对于“民法帝国主义”的???让人记忆犹新。说起来，确实对李博士问心有愧啊。喜欢zcgg也喜欢李博士，我很庆幸初入法门就遇到了这么好的引路人。好了我合上民法去学习刑法了～
108501,4208,李世阳,2019-05-27 05:36:44,-11,5,16,能不能别重复讲东西了\n\n背个课吧
108837,4208,李世阳,2019-06-03 05:36:51,-11,4,15,求求老师别翻过来覆过去讲东西了
111390,4208,李世阳,2019-07-01 05:54:26,4,4,0,李博士啥都好，就是别考试周还没过完就发答案?
111602,4208,李世阳,2019-07-02 06:16:44,-3,1,4,上课真的欢乐，也干货满满，上课一定要好好记笔记。ppt 会比较复杂，期末考好好看平时笔记还有ppt 上一些理论和解释之类的，一定要看往年的卷子和答案，考点不会差太大，但是重在分析（李博士说结论和他完全一样是不可能的，所以不重视结论，但也别太扯），找全案情基本考点按答题套路来   上4了
111640,4208,李世阳,2019-07-02 09:36:45,5,5,0,大爱李博士！！！上课超级欢乐！虽然上课内容和ppt有点不一样，然后刑法体系真的超级庞大，但是李博士会把刑法一点一点抽丝剥茧讲给你看，好好记笔记，期末考没有标准答案，主要看重思路分析，一定要看往年卷子！！！考点重复率很高！！！
112548,4208,李世阳,2019-07-04 17:30:12,2,2,0,谢老师不挂之恩
112550,4208,李世阳,2019-07-04 17:32:17,0,1,1,刚出分4.2 我爱李博士！\n\n
112562,4208,李世阳,2019-07-04 17:53:48,3,3,0,考试的时候没有分析完人物，只分析了三个人，最后李博士给了3.9，感谢李博士!给分超好!
112609,4208,李世阳,2019-07-04 22:27:23,1,6,5,4.8!\n\n希望能选上李博士的刑分~
112613,4208,李世阳,2019-07-04 22:34:33,1,2,1,很好啊啊啊啊
112655,4208,李世阳,2019-07-04 23:45:31,8,8,0,虽然只有3.6，但是这并不妨碍我继续爱李老师！！！情怀与知识面前，只能说我是不够努力了！明年刑分再接再厉~
113103,4208,李世阳,2019-07-05 23:28:10,0,1,1,老师真的认真博学，事少给分好，希望下学期刑分再接再厉，共同努力！
114385,4208,李世阳,2019-07-10 00:32:06,1,2,1,李博士是刑法的启蒙老师。超级认真，认真给我吗梳理每一个知识点，虽然刑总内容很多没上完，但把刑总里最重要的部分都讲得很透彻。大爱李博士！
114677,4208,李世阳,2019-07-11 03:34:05,2,3,1,大爱李博士!不解释!
122133,4208,李世阳,2020-02-16 05:55:31,8,14,6,老师好是好，但是这给分真的烂了（跟隔壁ylf相比），好好学了一学期2.7我真的佛了....而且明明在群里说了对分数有质疑的可以联系他，加了四五遍好友都不通过...老师你说话像放屁诶
124940,4208,李世阳,2020-07-22 16:33:52,4,6,2,刑法总论。老师学识人品俱佳。但打分方式稍显随意。相比隔壁班成绩也低了不少。
131347,4208,李世阳,2021-01-27 07:08:00,2,3,1,。。。
133682,4208,李世阳,2021-03-03 16:00:33,1,4,3,我从未杀过这么多人
133707,4208,李世阳,2021-03-04 04:31:03,9,14,5,李世阳老师真的非常仁慈了。既然老师都说了“我这次不杀你们”，相信老师一定尽力不让我们挂科了。不知道其他人怎么样，就我所知而言，两个4.2，一个3.9，其他人也都70+。\n\n确实相比叶良芳班，成绩会有一定差距；但既然不同出卷，成绩有差异就是难免的；大家都知道李博士刑总给分比较一般，还是选了他的刑分，被害人自陷风险也不能全怪老师。在我看来，卷面分低的主要原因在李华老师的40分选择题和纯闭卷的背诵考试形式，结果却是李世阳老师替她挨骂。卷面分数成了那个样子，老师想捞都很难；所谓开根号再乘十的方法，老师原话“系统里不存在这种算法”，起码法学院是如此。p.s.如果去看以前的访谈，会发现李世阳老师之前是很反对闭卷考试的形式的，不知道近两年为什么态度有如此大的转变。\n\n就讲课而言，做纵向的比较，老师的分论确实不如总论讲得好，或许是不再有手写提纲的原因，感觉凌乱了好多；又受到课时限制，很多知识点不能展开，老师的学术观点也不太好理解；还因为有事找徐万龙老师代课了两次。做横向的比较，确实不如车浩、柏浪涛和罗翔等学术或法考大牛，但远胜李华老师了，在学院里肯定也是排名相当靠前的，至少堪当九分的评价。平时抄了人身财产罪的法条、一次小作业、几次随堂的鉴定式案例分析，事情也不算很多。虽然朋友圈和朵朵铺天盖地，还是希望学弟学妹们敢选李世阳老师的课。\n\n以前不太明白为什么有时老师上着课突然闹脾气，突然说“你们不要所有时间都去学民法，也学一学刑法”，现在稍微能理解一点了；平心而论，我对刑法的投入和努力确实远远不够，老师的批评是中肯的。我无心再上刑案，抛开法考和考研，刑法之路到此已告一段落，感谢李世阳老师的启蒙和一路陪伴！
133757,4208,李世阳,2021-03-04 12:48:09,3,5,2,感觉至少我所见的查老师评论，部分人评判一个老师好、一个课程班好多以“事少课水给分好”为要旨。但上过李老师刑总课的难道不能体会到老师的良苦用心吗？老师在春夏学期网课的时候手写笔记，每次几乎到一两点发送出来（虽然这个可能也有老师自己在准备出版的原因？），老师大可不必这样做，甚至也可以打字，但无疑这样的手写笔记在我们（至少我自己）的刑法学习道路上起到了非常大的帮助作用。虽然这学期上老师的刑分，明显也感觉到课堂上的氛围似乎不如春夏学期的刑总那样好，甚至有时可能有些沉闷（其实也多数是因为老师提问，同学们回答积极性不高的缘故），但无疑老师的教学方式和教学风格都很有其特色，不是念PPT，不是对各种案例简单地蜻蜓点水，也不是单纯掉书袋，刑法那么多理论和学派，老师能够纵横捭阖地引申讲来而且厘清，已经很难能可贵了。\n\n总而言之，非常庆幸能够在最初接触刑法时遇到李老师。平时和他没有什么交流，对刑法目前也没有很大的偏好，但对于这样的我来说老师也已经很好了。后来者请不要被一面之词蒙蔽……
151420,4208,李世阳,2022-03-03 02:28:37,0,2,2,老师上课思路真的好清楚！
151796,4208,李世阳,2022-03-16 03:44:12,3,7,4,听不懂。。。
152140,4208,李世阳,2022-03-28 15:21:20,1,3,2,能这么用心和同学交流这么用心备课这么用心给同学找资料的还有谁！！
152448,4208,李世阳,2022-04-11 14:35:48,20,23,3,老师很好呜呜呜\n\n只是在鼓励同学们认真做作业的同时，能不能扼制一下鹅颈哇…\n\n完全不觉得五千字的作业写一万七是在体现对一门课的重视，即使是，又是不是过度了呢\n\n这样对在相对合理字数内认真完成作业的同学打击很大呜呜
154258,4208,李世阳,2022-05-27 09:29:54,4,6,2,李老师真的很不错，真的设身处地为学生考虑。
154899,4208,李世阳,2022-06-06 15:16:21,7,9,2,闭卷的形式对我构成了具体紧迫的风险！但还是给老师打9分，李博士萌萌哒
155040,4208,李世阳,2022-06-08 00:47:02,-34,10,44,sb 情绪不稳定 疯子
155243,4208,李世阳,2022-06-09 16:33:35,17,21,4,李世阳老师是目前唯一一位让我感受到了对法律的热情的法学院老师。
155349,4208,李世阳,2022-06-11 09:24:52,-20,10,30,别的老师都开卷，你闭卷，一大半的复习时间都被一门刑法占用掉了。你认为绩点不重要，拿学生的绩点当儿戏，我不认可。绩杀李世阳绩杀绩杀绩杀
155490,4208,李世阳,2022-06-13 13:48:54,22,23,1,刑总，大一下学期最喜欢的课。大家一定要好好学。李老师对刑法真的有很深厚的热爱和非常深厚的钻研。另外我认为按时到课是学生应该做的事情。闭卷实际上也没有太难为学生，都是应该会的。有没有一种可能，学习，本来就不应是为了绩点。
155770,4208,李世阳,2022-06-16 00:03:12,16,27,11,怎么着要求到课期末闭卷考试还不行了？平常不好好背天天睡大觉打游戏没见你怎么反思自己！就不应该惯你那些臭毛病！你到这来是学习的，不是干别的来的，学习就是你的天职！
156058,4208,李世阳,2022-06-17 09:05:59,-5,10,15,很喜欢阴阳怪气的一个人
159130,4208,李世阳,2022-07-06 13:48:21,4,6,2,高分高评，低分低评，不喜欢就信手捏来一顿骂，做个善人吧
161061,4208,李世阳,2022-10-25 10:16:00,20,24,4,认真听了李博士一学期的刑总，最后成绩很一般，但这是我第一次在大学中有一门课完全不在乎成绩会怎么样。期末一遍一遍梳理上课笔记的时候，我知道刑法的大概框架我搭起来了，这就足够了。而这也让我在这学期的刑分学习里依然受益匪浅。\n\n回想学习刑总的半年，每个7:55等着李博士抱着1L装椰子水走进教室的时刻、窝在床上看老师推荐的一部部电影的时刻、一点点敲案例分析和观后感的时刻、翻来覆去听共犯论一节的智云的时刻……我觉得这会是我法学学习生涯里最初、也最珍贵和快乐的记忆。李博士是第一个让我领略到法学体系的奇妙和庞大的老师，他最好地教会了我法律人应当有所敬畏。\n\n“事后来看，一切都是必然的。但从事前来看，一切却是偶然的。\n\n我希望同学们要记住，刑法总论的学习它不限于是对刑法本身的学习，更多的其实是一个法律人的思维的训练。所以我特别希望同学们能把刑法总论扎实地学好，并且把它扩散到其他法学学科的学习。\n\n法律人的素养是最重要的。\n\n所以从这个意义上而言，你哪怕去牺牲一点绩点，让你自己平时有更多的收获，去看更多的书，我觉得这都是值得的。然后呢，在学有余力的情况之下，最好去学一门外语，在能旅行的情况下，要多去旅行。好，下课。”
165413,4208,李世阳,2023-01-04 13:56:46,2,4,2,很棒好老师
170993,4208,李世阳,2023-03-14 01:22:24,1,4,3,一位真正在准备课堂内容，给学生讲课的老师；一位切实给予学生获得感的老师。
173117,4208,李世阳,2023-05-13 17:38:12,1,3,2,超好的老师
173258,4208,李世阳,2023-06-28 05:04:12,5,16,11,跟xwl相比真的差很多，讲课给人带来一种疲惫和混乱感，虽然很努力，但是讲课什么的还是很一般
173509,4208,李世阳,2023-05-27 02:49:17,15,19,4,为什么我觉得李老师的刑总非常混乱，感觉有点东拉西扯，想到哪里讲哪里，感觉体系性不是那么强？而且感觉一些主要内容都没有写在PPT上，纯靠嘴讲？？到现在感觉课上不完了。。
174548,4208,李世阳,2023-06-14 03:39:25,6,14,8,讲课很混乱，有的知识点自己也讲不清楚，ppt也不是很清晰，还是推荐xwl
176085,4208,李世阳,2023-06-27 15:22:15,1,2,1,考试前求放过，李博士很厉害，但是我就是听不懂，啊啊啊啊啊
176144,4208,李世阳,2023-06-28 02:54:07,4,6,2,非常好的老师！！其实我之前上课的时候也会觉得有点混乱，但后来全部上完梳理的时候觉得其实是非常有条理的！三阶层很清晰，老师会在重点的地方扩充一些知识。如果自己在课后多花一些时间整理会觉得收获非常大！
178967,4208,李世阳,2023-08-08 04:57:38,12,13,1,老师挺好的 但是成绩难以置信地低 心碎了 感觉自己写的差不多啊
178969,4208,李世阳,2023-08-09 02:47:46,-6,2,8,挺好的，讲的很有深度，也调分了，改的松+卷面分加了5分这样，所以给分也在变好ing
184298,4208,李世阳,2023-12-15 17:24:32,0,3,3,底层逻辑讲得很清晰，个人觉得比xwl好很多
184999,4208,李世阳,2023-12-25 09:23:05,1,4,3,给分巨烂。。目前最低
190834,4208,李世阳,2024-03-20 16:09:10,1,4,3,很难评
190840,4208,李世阳,2024-03-21 06:46:42,3,6,3,给分巨烂无比，跟所有人欠他一样，辛辛苦苦花这么多时间写了这么多就这点分数，也不知道李博士到底多高水平呵呵呵
193279,4208,李世阳,2024-06-05 14:05:26,1,5,4,年少无知刑法总论选了李老师，但是肉眼可见老师上课时的状态并不好，可能是因为同时也在写书比较累的原因。上课总是很疲惫，最后也没有讲完，上课讲的很慢很拖沓，常常前面讲了一大段，后面又开始重复地讲。ppt跟口述内容相差很大，上课的思路很发散，课下整理笔记很困难。\n\n考试内容考的还是比较常规，但是给分很差，据我所知很多人都获得了很低的分数。\n\n谷神说他年轻的时候听付老师的课一下子激起了对民法学的兴趣，希望老师能认真对待课堂，为之后的法律人点亮对刑法的兴趣吧。
194835,4208,李世阳,2024-06-25 15:12:58,0,3,3,乐，看评价挺好的，但也只是评价吧
195683,4208,李世阳,2024-06-29 14:08:43,0,3,3,老师讲课蛮有趣的！看得出来老师花了很大的力气来上这门课，课上有很多理论拓展和案例讲解。不过比较可惜的是老师后面不开课了（他说不开课了的时候脸上浮现出社畜的疲惫感。。。）\n\n期末考完之后本来满绝望的，但是被老师表扬和鼓励了真的特别特别感动！\n\n总之是入股不亏的好老师！
196117,4208,李世阳,2024-07-01 17:11:33,4,5,1,给老师打10分，闭卷考考前背得确实有点点崩溃，但出的题目都是上课强调过的，不偏，好好准备都能够答上来。最后班级的优秀率远超出学校规定但是老师说他“拒绝修改”，谁懂，我真的感动落泪🥹虽然上课的时候总是会说“你们肯定不回去复习”“知道你们肯定没提前看过ppt”，但是老师真的有在努力想办法把我们教会，三阶层的框架给的特别清晰，闭卷的形式也确实督促我们再把知识系统地复习了一边，这学期学到很多，最后也拿到了很满意的绩点，特别感谢老师～
196132,4208,李世阳,2024-07-01 22:26:30,1,2,1,阳阳老师真的好好~😭😭
196343,4208,李世阳,2024-07-03 03:58:54,-6,7,13,没去过一次课堂 最后4.5 满分不解释啊
196387,4208,李世阳,2024-07-03 08:03:23,1,2,1,今年给分感觉比去年好了不少，对刑法有兴趣的请一定要认真学，虽然平时到教室听课挺痛苦的，但是好好学真的有收获（不局限于绩点
197514,4208,李世阳,2024-07-18 03:07:12,0,1,1,9分老师，授课和给分都很好
197640,4208,李世阳,2024-07-23 09:36:21,2,3,1,虽然卡机，但是爱你
198329,4208,李世阳,2024-09-07 06:34:30,3,3,0,李博士真的特别好，给人一种学者的风范。虽然李博士可能平时比较严肃，但其实感觉内心还是很可爱的哈哈哈哈。解答问题都很详细有耐心，讲课刚开始可能会有一点不适应，但是如果认真听讲的话真的会发现李博士的内在思路还是很清晰的。期末出分比隔壁快很多哈哈哈哈，出成绩前还会私信报喜好可爱
198486,4208,李世阳,2024-09-09 07:49:45,19,19,0,本来觉得一般的，上了gyd的刑法分论之后，深感牵李世阳博士一个满分💯
201937,4208,李世阳,2024-11-07 13:11:12,8,8,0,你怎么能不讲分论呢？这怎么能允许呢？再不来讲分论就把你浙刑法所炸了
215238,4208,李世阳,2025-02-25 02:12:36,3,3,0,人好好啊啊啊啊啊 补选刑案失败了 给他说了一声 他就说他扩容了💕💕💕💕💕
220627,4208,李世阳,2025-06-19 03:45:30,0,0,0,刑案给分超好QAQ
86871,4237,李永明,2018-09-19 06:39:21,0,0,0,选了老师的课虽然只上了第一节但就是莫名的喜欢这位老师，很有想法很有趣❤️
101477,4378,巩固,2019-01-28 09:24:45,0,0,0,大四的课，安排座位表，每节课都要布置课后作业，上课会抽查几名同学上一次写的作业，最后所有的作业要上交作为平时成绩。国庆假期让我们观看指定电影然后写1000字的影评……另一个班开卷我们闭卷，没有重点……给分很一般……吐血……如果能重来～～～
105799,4378,巩固,2019-04-20 15:39:46,0,0,0,背不完了啊[大哭]
76698,4421,毕莹,2018-04-18 13:35:17,3,4,1,超nice非常温柔！！！！就是上课念ppt有点点无聊
76745,4421,毕莹,2018-04-20 08:09:04,4,5,1,老师性格超级好，在学术上也很细心，和她更像是交朋友
78769,4421,毕莹,2018-05-15 06:14:48,10,11,1,老师人超好，很喜欢她
90445,4421,毕莹,2018-11-23 13:28:07,24,27,3,老师超萌超可爱！！很注重细节，很愿意和学生分享，是非常非常好的老师~
91888,4421,毕莹,2018-12-24 10:27:40,16,16,0,老师好温柔～
104828,4421,毕莹,2019-03-28 11:27:09,8,10,2,很nice 老是!
107372,4421,毕莹,2019-05-04 11:39:57,5,5,0,赞赞赞
118761,4421,毕莹,2019-10-31 13:42:07,3,4,1,老师对学生很好！
131500,4421,毕莹,2021-01-27 18:42:51,5,6,1,毕莹老师超级超级好 很亲切很喜欢 邱文弦老师也很可爱很温柔 总之超级好的课 给分也好5555
136017,4421,毕莹,2021-06-09 11:15:28,12,13,1,全之江最好的导师，导师的天花板，真的自己何德何能能当她的学生啊，哭了
142810,4421,毕莹,2021-11-16 10:35:59,10,10,0,是大学中仍然对教学怀有热忱的那类老师。满分。
142818,4421,毕莹,2021-11-16 12:21:16,9,9,0,好老师 不多说
146048,4421,毕莹,2022-01-05 08:53:30,5,5,0,毕妈妈我爱你
147732,4421,毕莹,2022-01-10 14:48:02,3,4,1,是个扎实做学问的好老师
150257,4421,毕莹,2022-01-21 03:46:03,-4,3,7,国际争端解决理论与实务 正态的通识课，给分超烂，快逃...暴拉均绩\n\n老师本身超级好的，很温柔又很有趣，专业课给分也是很好的，家可以放心选！\n\n但是通识课快逃！
151047,4421,毕莹,2022-02-22 08:03:31,3,3,0,喜欢老师
153438,4421,毕莹,2022-04-29 14:20:31,3,3,0,能感觉他对教学的热爱
153566,4421,毕莹,2022-05-05 01:58:11,2,3,1,老师太好了太好了，上课非常热忱，就像我在课程感想里说的，很有活力很热情。希望接下来的学弟学妹们多多参与老师的课堂互动，不要让她太难过~
153652,4421,毕莹,2022-05-07 04:10:19,2,2,0,老师是女菩萨😭
155424,4421,毕莹,2022-06-12 14:07:35,4,5,1,当代优秀女性！！！人好业务扎实！！非常非常非常好的老师！！！
159544,4421,毕莹,2022-08-08 08:24:37,2,3,1,毕老师是我学生生涯中遇到过最好最亲切的老师了，真的很为学生考虑，也会因地制宜挖掘不同学生的能力，上毕老师一节课真的胜读十年书！给分也很nice！
159719,4421,毕莹,2022-08-24 14:45:45,5,5,0,超级好！！研究方向有点冷门，有点掩盖了老师的实力和扎实的学术品格。
161742,4421,毕莹,2022-11-12 01:42:10,10,10,0,老师的部分快讲完了，来评价一下。老师积极和学生互动，温柔是真的，特别喜欢提到她的两个宝宝。讲课方面语速挺快，除了她的笑话2/3的时候只能逗笑她自己，有点尬之外，讲的挺好的。不过看这门课的均绩。。。分还没出，现在很慌。
165240,4421,毕莹,2022-12-30 12:37:01,8,9,1,我从未后悔成为这个老师的学生。今天是这样，以后也是这样。\n\n我的未来由她改变。
172262,4421,毕莹,2023-04-24 03:11:57,4,4,0,老师真的好好55555人超级可爱，超级温柔！而且学术水平也好高！
173273,4421,毕莹,2023-05-17 09:56:29,7,7,0,从不点名，哪怕人来的很少。很值得
174493,4421,毕莹,2023-06-13 06:01:41,4,4,0,毕老师不给法硕非法本上课真的是太遗憾了...有一种宝藏老师没能被更多人看到的感觉\n\n老师学术水平超级高，对学生也非常好，会认真看给她发的内容并且给出超级超级详细的反馈\n\n毕老师真的好可爱555555
180811,4421,毕莹,2023-09-26 13:43:49,4,4,0,毕老师尊嘟超好超好，上大学以来第一次感受到的温暖是毕老师给的。点亮生活的那种，冲就完了
182473,4421,毕莹,2023-11-16 09:14:51,4,4,0,温柔可爱知识渊博
189962,4421,毕莹,2024-02-04 00:04:02,2,2,0,绝绝子
190124,4421,毕莹,2024-02-23 07:40:14,3,4,1,【国际争端解决理论与实务｜通识】2023～2024年秋冬学期，秋学期是毕老师授课，冬学期是钱旭老师授课，作业是期中期末各一篇2000～3000字的论文。毕老师上课挺有趣的，给分也很好。唯一的槽点是出分很迟，2月26号春学期开学，2月22号出的分数😂不过也是因为期末论文提交时间晚，钱旭老师考虑我们考试周要复习，把期末论文的提交时间延迟到考试周结束的后一周周日了（感恩.jpg）
197599,4421,毕莹,2024-07-21 01:49:02,4,5,1,清华高材生，有教学热情，也很有幽默感，强推
198650,4421,毕莹,2024-09-10 11:20:44,3,3,0,真无敌
198651,4421,毕莹,2024-09-10 11:25:04,3,3,0,上课爽死了
199964,4421,毕莹,2024-10-09 15:54:38,4,4,0,还没上完课先来评价一下，国际争端解决感觉上课就像回家了一样，老师太好了，氛围轻松活泼，和我们分享八卦，不管绩点怎么样都很值得呜呜呜
200290,4421,毕莹,2024-10-15 11:41:38,3,3,0,老师可爱，喜欢讲八卦，就是我不知道国际争端这门课讲了啥知识……
202165,4421,毕莹,2024-11-10 08:07:29,3,3,0,上课氛围很轻松，会跟我们分享八卦。上这门课更像是在听故事
214188,4421,毕莹,2025-01-27 11:13:05,5,5,0,老师讲的不错，但是国际争端解决作为一门通识课，给分真的有点烂
214209,4421,毕莹,2025-01-28 10:39:02,3,3,0,汗流浃背了，国际争端解决只拿到3.6……大概这就是没注意看误选到双语课程的下场吧
217206,4421,毕莹,2025-04-04 08:58:21,3,3,0,后半部分上课全是小组展示，上课学不到什么东西
217979,4421,毕莹,2025-04-18 15:49:16,0,0,0,国际争端解决作为通识课来说比较硬，不过就个人而言还是很喜欢的，也能学到比较多的东西。但是给分不好，在我投入了较大精力的情况下比我另一门没怎么用心的通识课绩点低了好多……但是事情很少，两位老师也从不点名。两位老师人都很好，不过毕莹老师的部分中文比较多，所以接受起来比较容易。
219075,4421,毕莹,2025-05-20 16:15:20,-1,0,1,国际争端解决专业课：我们小组虽然问答组有比较好的表现，但是展示相对一般，所以一开始对最终绩点没有太高的期待，毕竟小组成绩占了百分之七十；最后课程感想还是有认真花了心思对待（虽然也只花了大概半个下午加一个晚上哈哈）；最后出分很高，所以期末个人课程感想还是很重要的，不要因为觉得小组表现一般就不管了，毕竟毕莹老师多次提到个人课程感想是“沉默的点名”，会进行区分；综上，听课+兢兢业业地做好小组作业+非常认真地完成个人感想，这门课应该还是能拿高分的
123536,4462,郑磊,2020-06-09 13:32:46,1,2,1,
74404,4470,周淳,2018-02-19 16:01:42,-11,13,24,课上得好，给分好
75935,4470,周淳,2018-03-22 07:09:29,-18,8,26,思路清晰，女神～
77282,4470,周淳,2018-05-04 10:19:21,-11,12,23,超级超级好哇，我女神。
86058,4470,周淳,2018-09-01 05:50:42,-11,11,22,很厉害 人很亲和 讲课也很有逻辑很有干货 是想要成为的人
105006,4470,周淳,2019-04-02 06:24:47,-10,12,22,太好了！
114585,4470,周淳,2019-07-10 23:00:51,-11,12,23,讲的很好，十分。
124249,4470,周淳,2020-06-28 05:20:51,-5,20,25,老师水平高，给分绝好，而且很注重给分的公平性。和yfgg的商法是又学到了东西又收获了好绩点和好心情！
124251,4470,周淳,2020-06-28 05:24:42,0,22,22,女神啊www上课思路清晰，讲得十分清楚。而且课后还会专门开设答疑，回答问题也很有耐心~\n\n另外，老师给的是十分公正的分数，一份付出一分收获，并且真的给分超好！！！爱了爱了
134354,4470,周淳,2021-03-24 14:52:35,-20,6,26,女神～
135293,4470,周淳,2021-05-07 15:52:44,-14,13,27,巨喜欢的一个老师，学历无敌，人也贼善良，很有智慧
139414,4470,周淳,2021-07-15 08:52:28,-14,11,25,老师人好且巨可爱，商总和公司法还没出分，但是考试没有写完，希望老师捞捞
139645,4470,周淳,2021-07-19 05:03:50,-9,12,21,女神！！！
150238,4470,周淳,2022-01-21 00:10:59,-16,10,26,无论是公司法还是商案，都讲课很棒，耐心细致，给分超级好！！！
150245,4470,周淳,2022-01-21 01:18:57,-12,10,22,优秀的青年教师
150252,4470,周淳,2022-01-21 03:09:39,-14,12,26,女神老师！超级有亲和力！讲课清晰细致，给分也很好
154446,4470,周淳,2022-06-01 13:19:59,-8,13,21,能感觉到老师自己的逻辑非常清楚，但是可否把ppt内容再充实些呢？有些内容比较有难度，课上完全靠口述的话听起来蛮有压力的。已充分利用智云资源，但商法内容真的很多，可以考虑ppt上再多点内容。
156970,4470,周淳,2022-06-21 12:52:49,-15,14,29,讲课巨好，声音好听，人可爱！北大和哥伦比亚的神仙！就是公司法的考题真的有点点坑，救。\n\nps：老师的故事可以在她的著作《商事领域受信制度原理研究》中她在北大的导师所作序言里面找到。
158324,4470,周淳,2022-06-28 09:39:11,-12,19,31,女神，不接受反驳😍
159117,4470,周淳,2022-07-06 13:34:44,-35,25,60,周老师这么快就升任副教授了，好多老师科研成果更厉害的还没上，一定程度上说明周老师还是有能耐的人啊。潜规则说不清。。
159284,4470,周淳,2022-07-10 15:52:56,9,34,25,能说说谁科研更牛没上吗？上来就黑人家潜规则？？？？？这戾气真的惊了
159302,4470,周淳,2022-07-11 11:06:55,25,45,20,感觉没那么好啊…
159558,4470,周淳,2022-08-09 08:32:02,15,46,31,发生了什么…为什么突然那么多踩淳姐的。说潜规则的那个同学，咱啥也不知道，别造谣哈；不过如果你有证据可以放出来给大家看看，让大家评评理，是哪位神仙科研成果多还没上副教授的。个人经历来说，在与淳姐有限的交流中，可以看出她是一个严谨认真负责的好老师，愿意悉心指导学生。暑假在之江山上也经常可以看到淳姐在工作，是非常勤奋、优秀的青年女教师。ps：女儿很可爱～
161667,4470,周淳,2022-11-10 07:40:16,-12,14,26,周老师上课讲的公司法还可以，但是上课的口述内容很多，要写很多笔记，我个人是把文件打印下来，自己上课边听边用手记。老师平时不点名，也很愿意和同学们交流，就上课这一部分来说还可以。最后期末是合卷考试，可以带法条但是不能在法条上写字，考试题型是三个案例，三选二，一个老师出一道，其实郑观老师出题还挺简单的，只是我当时没来得及看直接选了石周两位老师的题，最后给分还可以，据说是郑老师商量两个班调分过的，最后说一句，石一峰老师真的很有气质，爱了爱了。
168177,4470,周淳,2023-01-31 15:37:43,-13,12,25,很认真
176678,4470,周淳,2023-06-29 16:35:43,-11,9,20,淳姐很可爱很善良^_^
177724,4470,周淳,2023-07-04 14:06:33,16,28,12,一般般
178105,4470,周淳,2023-07-07 02:53:35,18,32,14,浙大副教授很好当啊
178287,4470,周淳,2023-07-09 13:37:44,-10,17,27,特别好！不清楚为啥被其他人踩、、、、
178447,4470,周淳,2023-07-12 01:01:40,13,29,16,人还行 水平一般
178457,4470,周淳,2023-07-12 03:15:38,-32,8,40,女拳师
178756,4470,周淳,2023-07-22 02:27:03,14,30,16,水平一般，浙大副教授评这么容易的吗
178871,4470,周淳,2023-07-27 01:23:52,15,26,11,泯然众人
179296,4470,周淳,2023-09-08 02:54:08,15,31,16,淳姐明明是非常好、非常nice、非常有趣的美女老师！所有上过淳姐课的同学都能感受到淳姐的魅力！到底是谁在无缘无故黑她啊……
179479,4470,周淳,2023-09-17 03:03:26,28,51,23,老师只是说了几句鼓励女生的话，小线头男拳师又开始跳脚高潮了是吧，阴沟里的烂蛆请爬
181732,4470,周淳,2023-10-30 06:38:38,23,34,11,最近发生了什么...口碑如此之好的淳姐都会被连环打低分吗，未免太离谱了...
182172,4470,周淳,2023-11-11 11:04:28,2,15,13,咋这么多打低分的，越来越不理解了
184075,4470,周淳,2023-12-08 02:19:28,0,16,16,民商法绿茶
191003,4470,周淳,2024-03-28 01:04:56,-1,9,10,一般般，不够尊重学生
194016,4470,周淳,2024-06-21 11:39:25,3,7,4,正在准备公司法期末考试ing 淳姐真的很好，虽然公司法每一次上课都听不懂，需要课后重听智云，不过这也是我没仔细预习的原因，加上公司法课时数太少太少，要在这么短的时间内讲一门法律真的很难，淳姐能够平衡基础概念讲解以及立法理念、学理争议，真的很不容易。听老师上课也觉得：啊要是我也有这么清晰的思路、对法条娓娓道来就好了
194756,4470,周淳,2024-06-25 09:18:47,8,13,5,因为身体吃不消申请缓考，淳姐跟我说不要着急，休息好最要紧，还说负担太重，要养好身体。这么好的老师去哪里找啊[大哭]
195694,4470,周淳,2024-06-29 15:41:14,3,9,6,我没看出来老师哪里不尊重学生
197192,4470,周淳,2024-07-09 01:56:20,2,8,6,老师真的很好，会耐心回答小菜鸡本人的问题，爱淳姐
197197,4470,周淳,2024-07-09 02:30:04,1,7,6,姐。。。我唯一的姐。。。🥺🥺
197250,4470,周淳,2024-07-10 02:31:33,-1,5,6,老师讲的很好～给分也好～
197543,4470,周淳,2024-07-20 01:35:21,1,9,8,水平很一般 徒有其名
200925,4470,周淳,2024-10-25 01:47:58,3,7,4,绿茶啊绿茶
202069,4470,周淳,2024-11-09 03:10:43,1,6,5,真恶心
202120,4470,周淳,2024-11-09 15:23:29,12,14,2,1分送给法律谈判
205264,4470,周淳,2024-12-03 12:28:51,-1,8,9,虚荣婊
207355,4470,周淳,2024-12-21 01:23:55,4,9,5,领导身边的女人
208584,4470,周淳,2024-12-31 08:28:13,-3,2,5,嘻嘻嘻
214708,4470,周淳,2025-02-17 02:43:36,-4,1,5,研究生上的商事案例研习，感觉老师水平很高就是我听不懂……老师人很好很温柔，打低分的看不懂……
215163,4470,周淳,2025-02-23 09:14:42,4,6,2,低分看不懂，是因为你不知道她多表
215985,4470,周淳,2025-03-08 20:09:48,8,10,2,在微信群里当众发癫🤪
217280,4470,周淳,2025-04-07 11:27:05,-4,1,5,咋了？去年上的淳姐公司法，很好啊，我问蠢问题也耐心回答我
218445,4470,周淳,2025-04-23 14:18:23,9,11,2,少造黄谣欺负老实人，真是大佬的女人这学历背景快四十了不是博导？
218614,4470,周淳,2025-04-27 03:03:45,4,5,1,就这发表水平，凭啥能当所长?
75690,4526,金敏,2018-03-15 07:05:32,34,54,20,很难受，只想让她好好讲课，我想学知识，不想听炫技和扯淡
75818,4526,金敏,2018-03-19 06:21:22,19,34,15,不知所云
79236,4526,金敏,2018-05-28 07:10:23,24,43,19,老师看了很多书，但让人有点觉得在掉书袋。\n\n总是说，我来不及讲巴拉巴拉，然后再花半小时讲自己准备讲什么然而因为时间原因讲不了。。。拜托有这个时间为什么不能开始讲呢？不想听她讲来不及讲了巴拉巴拉，三节课真正在讲的部分可能仅有三分之一。
79394,4526,金敏,2018-06-03 08:09:09,3,18,15,shit
91247,4526,金敏,2018-12-04 06:46:14,-14,26,40,老师很好啊，本科是北大的，知识的广度和深度都到了大佬的程度，以至于每次上课都我觉得自己是文盲。总之选了这门课十分值得！
103669,4526,金敏,2019-03-04 03:39:05,30,47,17,或许真的有知识吧，但是上课讲的太杂乱，漫天扯，想到哪讲到哪，还废话有点多。希望能正儿八经上课，学点知识吧！人生哲理讲得够多了。。。
103695,4526,金敏,2019-04-29 03:20:37,60,107,47,bullshit
104054,4526,金敏,2019-03-11 06:24:04,36,71,35,简直无语死=_=上课扯来扯去就是不讲知识，上着课难受死了，能不能好好讲课(>_<)为什么这门课只有这一个老师??简直不知所云，，，太痛苦了，无法理解老师的思维
104323,4526,金敏,2019-03-18 02:28:36,5,20,15,bullshit
104953,4526,金敏,2019-04-01 02:09:28,37,60,23,老师你能让我们把话说完不打断吗，人与人之间最起码的尊重能有吗
105193,4526,金敏,2019-04-07 08:52:27,48,84,36,老师讲课清楚明白，每一个知识点都认真分析，把重点全部告诉我们，上课的逻辑清晰，层次分明，上她的课从不会感到任何不适应，简直是享受。好的，我实在编不下去了，你们把40米的大刀收回去吧
106688,4526,金敏,2019-04-29 02:53:25,10,23,13,我真的不知道她上课都在讲什么，听得好难受，要读的书特别多，而且她真的好喜欢打断学生讲话还一定要辩倒你抓住回答的一个小小的点就咄咄逼人……算了我不吐槽了毕竟这是一门必修还只有她一个老师
107512,4526,金敏,2019-05-06 06:02:59,8,26,18,灵魂有香气的女子
109456,4526,金敏,2019-06-15 06:58:08,18,41,23,对不起，我还是很喜欢她。事实上，我之前并未意识到自己的视域狭隘如此。尽管她不知所云，尽管她总是跑题，尽管我总是逃课，但我还是很喜欢她。我喜欢这般认真好学而有趣的人，大概我也想成为这样的人。\n\n
109499,4526,金敏,2019-06-16 03:55:12,10,21,11,老师还是很好的吧，这样的中法史全国唯一。
109582,4526,金敏,2019-06-17 08:03:07,-42,2,44,金老师给我的分从没下过95，大物实验选满他
111461,4526,金敏,2019-07-01 15:16:46,9,15,6,虽然老师上课真的挺迷的，有时候觉得她不知所云。但是在复习的时候加上看了她的书，才发现老师的思想如此博大精深，整个大一，她对我应当是影响大的一位老师了
111576,4526,金敏,2019-07-02 04:13:07,27,36,9,19年6月考试题（回忆版不一定准确）：两道题各五十分\n\n一、探探你对“叙述方法和角度决定叙述内容”的认识\n\n二、（拉兹的一段原话）是什么意思？他所说的internal structure是什么？中法史结构是？为什么？
111790,4526,金敏,2019-07-02 23:08:05,20,35,15,上面的人在搞笑吧，经常翘课还喜欢老师，那你听了多少东西？恐怕是尬吹罢了。
113003,4526,金敏,2019-07-05 17:23:31,3,13,10,猝不及防出了分，觉得已经很出乎意料了！其实我很喜欢老师，也许是表达的问题，上课确实会让人觉得有些迷，但我依然认为老师的思想很棒，也给了我很大的启发和改变。但愿我能在未来法学的学习中有所取，有所得。
113090,4526,金敏,2019-07-05 23:10:13,6,14,8,是真的学者，奶奶很有文化，人也很好，非常渊博，注重思维上的引导，别说没干货，那些东西自己看看书就会了，所谓教育，本来就应是思维教育。给分也挺好(✪▽✪)
113097,4526,金敏,2019-07-05 23:20:53,8,15,7,上完才明白，她的话虽然有些啰嗦，但却提醒了我生活中一些最简单最普通但是又最重要的事情。谢谢您。
113137,4526,金敏,2019-07-06 00:09:04,4,14,10,先生之风，山高水长
113189,4526,金敏,2019-07-06 01:21:47,-3,11,14,很喜欢金敏老师 大家之风！
113211,4526,金敏,2019-07-06 01:41:42,-4,11,15,老师超有思想，超喜欢。
113324,4526,金敏,2019-07-06 06:18:12,5,13,8,第一次上查老师评分，老师学问很渊博，是真正的学者，让我学到很多。明年还想去蹭课。
113333,4526,金敏,2019-07-06 07:40:24,7,15,8,其实最后一节课还蛮舍不得的，感觉金敏老师是个对待知识很认真的人，这种认真带着一些“风骨”，喜欢她的语言风格，喜欢她的表达方式。并不同意有人说她上课很混乱，她上课是在自己的主题上的，只是太多人没有耐心对待课上“非实用”以及“非应试化”的知识。\n\n很有意思的是，金敏老师亲身实践了一学期的许多道理，许多人到最后还是不懂。
113343,4526,金敏,2019-07-06 09:02:47,7,17,10,说老师讲课没逻辑的同学大概课下功夫太少，老师深入浅出，带给学生的是对整个法学学习的思维方式，在一所理工科见长的学校能有机会感受老北大人的格局真的很难得，希望学弟学妹们珍惜！
113693,4526,金敏,2019-07-07 04:06:01,56,71,15,笑死了，期末出分后老师的评价怎么高了这么多。\n\n金奶奶是个读书人，她上课的方式更适合用来开研讨会而不是上大课。\n\n一个长学期也就反反复复讲视阈范式，总论讲来讲去就是不同学者的视角，分论部分实在讲的太少，有点坐而论道。\n\n希望金奶奶能更好的安排一下课程，毕竟像您自己说的，没有分论的总论，是空谈。\n\n最后，书单真心不错，尤其是绘事后素，对自己的思维和视野帮助很大。
114182,4526,金敏,2019-07-09 03:21:34,-1,10,11,很好的法学启蒙课。\n\n
114680,4526,金敏,2019-07-11 03:37:08,12,24,12,除了zcgg，教会我最多人生哲理的老师，不要只看金奶奶的干货，重要的是思想、风骨和品格!
114930,4526,金敏,2019-07-12 23:15:18,3,10,7,我一直在疑问，大学学的是什么，金敏老师的课告诉了我。\n\n前面其实我也评论过，被质疑是尬吹。我解释一下，是分论的时候，我指的经常是八节课里面的1节，因为平时并不经常，所以在我看来是经常，抱歉了。
114938,4526,金敏,2019-07-13 00:48:33,11,16,5,给分创造历史新低，不知道是不是在随便打分
115449,4526,金敏,2019-07-24 12:38:51,5,8,3,玄之又玄
116209,4526,金敏,2019-09-06 08:43:10,7,12,5,不知所云，给分差到怀疑人生，感觉像是随便打的分
116536,4526,金敏,2019-09-11 07:56:53,10,12,2,不知道在说些啥，剑走偏锋
117472,4526,金敏,2019-09-25 01:07:28,-3,6,9,渐入佳境
120490,4526,金敏,2019-12-09 08:23:03,14,17,3,挂科了。。。
122329,4526,金敏,2020-02-24 07:04:04,0,7,7,感觉老师学识很渊博。
122392,4526,金敏,2020-02-26 05:41:51,7,13,6,大家风范，民国遗风
124567,4526,金敏,2020-07-03 04:29:25,26,36,10,很遗憾疫情原因一个学期都没有听到金老师给我们讲课，但是从老师的讲义上我读到了真真正正的大家风范，老师很认真地会把微信群里每一个同学的回答进行回复评价，有问题会和同学们一起探讨。老师是一个严谨治学的学者，认认真真读了我们的读书报告，不像是很多老师让助教看看论文评评分就好。为了纠正我文章中的表述错误还特意来加我微信，课上的小透明真的深受感动了。之前听很多学长姐说要多回答问题刷脸刷印象分，但是我一直以来都不太喜欢在课堂上发言，就算是微信群里也没有讲几句话，更谈不上印象分了，但是最后还是拿了一个很好的成绩。实际上，老师并不是一个看发言看印象打分的“糊涂老师”。只要认真研读老师的讲义，好好写读书报告，金老师看得到你的付出的！ps：金老师的讲义真的写得很好啊，思想见解也很独到，真的有一种打开了我对历史的视野的感觉，推荐的书目也是很不错的书，中法史并没有大家说得那么不堪，是一门很有情怀的课程。以上都是“一家之言”，望以后修读这门课的同学可以对查老师上的评价“多闻阙疑”！（逃）
124639,4526,金敏,2020-07-04 15:49:31,4,9,5,金奶奶，人真的好棒，虽然没搞清楚为什么一学期不上课orz 而且感觉金奶奶的观点有点套娃😂
124641,4526,金敏,2020-07-04 15:56:29,5,8,3,。。。
125061,4526,金敏,2020-08-23 10:31:44,22,31,9,上课不知所云，浪费时间，给分奇低。
126487,4526,金敏,2020-09-28 07:29:52,-6,7,13,本科时影响我很深的好老师！
128712,4526,金敏,2020-12-25 05:22:02,6,18,12,觉得金奶奶讲课很混乱的，其实真的可能是自己的问题，刚开始我也是这么觉得的，直到我第二遍听录音，才发现前后讲课不是断层，而是连贯的。老师是一个看上去非常佛，实际上要求很高的人，第一节课就发了压缩包，课后有很多的文章要去读。还有觉得金奶奶给分乱给的，是因为觉得给你低就判断她是乱给的吗？金奶奶上课一直有讲她想见到什么样的作业，希望大家能明白一切历史都是当代史，希望我们能给通过学习历史更好的了解当下，你真的做到这些，分数是不会低的。我是觉得浙大的学生，不应该以老师给分高不高来作为评判老师的标准。
133488,4526,金敏,2021-03-01 07:37:09,1,25,24,这个老师所有的“批判性思维”都是建立在她的思维独裁上的。没有知识的批判性有什么用？你啥也不懂，就教你批判性，这就是XG的FQ们的典型思维，为了批判而批判。自以为是的“清高”，实际啥也不是。
133599,4526,金敏,2021-03-02 14:18:58,10,18,8,金老师的学识和人品是毋庸置疑的，当上课许久再回顾这许多课，竟然是法制史的视域，范式最印象深刻。
135067,4526,金敏,2021-04-28 15:30:33,5,9,4,真正的大师
137356,4526,金敏,2021-07-03 11:47:37,19,42,23,金奶奶是真正让我在大学中体验我是在上一堂大学应有的课\n\n文学素养之高，知识涵养之广，每一句话都让我感觉我自己见识的浅薄和干涸\n\n相比于你能想象到的中法史，在这门课里面你一个都见不到\n\n这也是金奶奶所一直想告诉给大家的，不想传授一些大家死读课本就能学到的东西\n\n这也就导致了我身边很多人觉得金奶奶过于注重形而上的道，忽视了一些形而下的内容，虽然这正是金奶奶所想表达的，但放在本科生阶段确实会让大部分人觉得云里雾里\n\n只能说仁者见仁智者见智，对金奶奶的评价也必然会两极分化\n\n但我相信时间会一点点证明金奶奶不只是光靠评分就能妄下结论的一个老师\n\n法学院不能没有金奶奶，就像西方不能失去耶路撒冷
137484,4526,金敏,2021-07-04 11:47:46,15,21,6,讲真，一开始我无法理解这位老师和她所坚信的，但是当我第三遍读她的书和讲义的时候，才有点“得其门而入”的感觉。\n\n谢谢老师
139115,4526,金敏,2021-07-13 02:09:17,-5,6,11,超级棒！有大师风范
139241,4526,金敏,2021-07-13 16:20:46,5,8,3,…….
139267,4526,金敏,2021-07-14 02:23:41,-11,3,14,给分比想象中好！
139303,4526,金敏,2021-07-14 06:30:49,6,9,3,老师很有水平，只是可能不太适合大一学生。。。但认真学还是能收获很多，即使当时似懂非懂。
139871,4526,金敏,2021-08-05 10:22:47,12,15,3,金奶奶的水平自然是很高的，但是参考文献推荐了三次共六节课是不是有点太浪费时间了呢？第二，这种教学方法真的适合基础知识都尚未学扎实的初学者吗？
143362,4526,金敏,2021-11-24 06:15:14,2,11,9,完全不知道上课在上什么
150785,4526,金敏,2022-02-18 13:33:19,24,32,8,法硕学生评价：\n\n我想金敏老师是一个有争议的老师，就是说喜欢她的学生喜欢得不得了，不喜欢她的老师可能烦闷的很，我是很喜欢的，我的其他室友也都很喜欢金老师。\n\n金老师不点名，但是她会按照学号来点同学起来回答问题，被点到的是一种荣幸（如果你回答得好的好的话，因为她会记住你，作为平时分）；如果没有被点到，老师不知道你的存在，那就把读书报告写得专业些，老师也会给很高的分数，否则很有可能无法通过考试（据我所知至少有4人）。\n\n中法史的课程，老师教的是总论，侧重方法论，侧重为什么要学中法史以及怎么学，侧重培养锻炼质疑批判的精神，希望学生拓宽视域，boundaries become wider，让“前见”得以改变，everybody would have some prejudices， the more importance things is the prejudices could be changed after studying， or it will be called deep-rooted prejudice.\n\n老师阅读非常广泛深奥，法理学夏立安老师说金老师是法学院少有的能读懂伟大思想家作品的少数人之一，她的阅读量让我惊讶，知识太丰富了。\n\n金老师推荐的书籍我都很喜欢，老师说是“打底阅读”，打底很重要，especially to law students. you cannot study law well enough without knowing other fields or without any knowledge about other subjects. \n\n给金老师点赞~~
151393,4526,金敏,2022-03-02 07:22:38,3,7,4,根本听不懂啊……上课坐立不安不知道能干嘛，只好去找老师以前发表的论文读\n\n老师开始讲课了 太好了终于能听懂了 快乐了
151605,4526,金敏,2022-03-16 05:45:31,12,20,8,心比天高，课比海水，乱七八糟，不知所云
152205,4526,金敏,2022-07-15 05:02:41,33,46,13,第六节课，醍醐灌顶，恍然大悟，感谢金老师赠予我们捕捉蝴蝶的网。\n\n\n\n补充：\n\n学弟学妹们听这门课，务必认真用心听。\n\n老师会在前几讲就讲出自己对读书报告的判准——其对教材的甄别是在比较下进行的，是有理据的，并非空穴来风。【关于某社交平台上几次不小的风波大家看在眼里，明白在心里——外专业的同学若想知晓原貌，请先完整听完老师的课】\n\n\n\n如果确实觉得这门课没有用的…那就没有用吧\n\n\n\n\n\nTo 评论区某些同学：\n\n\n\n有的同学一直恶意刷恶评，在这里诅咒老师的，希望你们明白“业力”的道理。
152351,4526,金敏,2022-04-06 04:38:53,8,10,2,老师的授课方式be like\n\n\n\n一项主张（thesis）在被论述的过程中将会迎来与其相对立的反/相对主张（anti-thesis），这两者在交互的过程中将催生新的主张（synthetic thesis），而新的主张也将重复最初主张的演变过程，与新的反/相对主张催生另一轮观念的互动……这项循环无休止的过程即是辨证。将辨证的思维运用到对问题的解构之上，面对自己提出的问题，以更细致的子问题带动思考的过程，在不断“问问题”的过程当中打磨出答案的轮廓，但从不揭露一个稳定的、最终的答案\n\n\n\n那么我能听懂吗？答案是不能……
152453,4526,金敏,2022-04-12 02:47:34,22,23,1,中国法律史，aka哲学通论，又名 anti-paradigm---比较视域下中西文史哲思想精粹（北大法律人的前世今生）
152810,4526,金敏,2022-04-20 05:45:25,-6,1,7,哈哈哈哈哈哈
152811,4526,金敏,2022-04-20 05:45:23,-6,2,8,哈哈哈哈哈哈
154056,4526,金敏,2022-05-21 09:23:32,12,14,2,西方不能没有耶路撒冷，正如中法史不能没有读书报告的折磨
154093,4526,金敏,2022-05-23 05:29:13,4,9,5,好老师，喜欢
154574,4526,金敏,2022-06-02 07:37:58,9,11,2,金奶奶的课真的打破了我的旧的学习模式，感觉对于我接下来几年的学习帮助会很大，花了很多时间让你明白、真正醒悟了“不要不求甚解”的道理
155145,4526,金敏,2022-06-17 16:13:08,17,24,7,金老师水平很高，讲义里面的内容真的都是精华。这才是大学真正应该讲的内容。虽然上课的时候有些枯燥，有时很发散，但无论如何无法遮挡住思想闪烁的光芒。尤其是邓光裕堂案的讲解，可以看出来老师的实力。诸位，如果你觉得无法接受这种上课方法，不妨思考。究竟大学是应该像高中一样教你背诵的内容，还是应当教你如何看待你要背的内容。如果真的按教材讲下来，试问诸位这门课又能听得多少呢？一年后又记得多少呢？（补充：金老师的《眼睛就是一切》力荐）
155196,4526,金敏,2022-06-09 07:58:46,15,31,16,洗脑与教育的区别在于是否屏蔽异见。金敏推荐文章的标题，同样还给她本人——如此自以为是而又对持异议者刻薄鄙夷。
155291,4526,金敏,2022-06-10 08:42:24,19,23,4,金奶奶一直跟我们强调“绘事后素”，底子打好才能站得更高望得更远（这也与她本人所说的“视域融合”相联系），但法学界也有很著名的学者强调要“以法学书籍为主要阅读对象，当涉及到不甚知之的法律制度、法律与社会的关系、法律与经济的关系再可以去阅读相关书籍”或者进行“法学书籍—其他学科书籍—法学书籍……”的以自身需求和兴趣为标准的循环往复。这二者看似矛盾其实不是，背后都有“以通驭专”的道理支撑。举例言之：你想要了解为什么我国很大程度上承认物债二分（负担行为和处分行为二分）的体系（当然各派学说争议不断）而英美等国家以合同（contract）构建法律基础而对于物权、债权的观念则很模糊，就不能仅仅只关注法律，毕竟想要理解XX就要从理解XX如何发展而来着手，这就不得不和历史学和社会学扯上关系，就要去了解“欧陆法系”与“盎格鲁-撒克逊法系”两者的发展历史和其间产生的殊异，也就可能难以回避不同法律的形式性格的形成因素（政治统治类型、经济交易、宗教等）及各种因素形成的结构、结构下的各种机制，但是考虑到这么多，要能拴住“心猿”和“意马”，要能回到现有两大法系的区别上并最终落脚到法律的规定上（例如：关于“转让”在不同法系下的理解，关于债权转让的规定），然后对于本国的法律和学说继受（不同于比较法研究）既有所认识理解又能用其来解决实际问题\n\n总而言之，中法史还是蛮有趣的，希望能渐渐从“无知的确定”到“有知的混沌”，然后通过视域的融合、判断力的精进、可能运用的证伪不断逼近“有知的确定”
156379,4526,金敏,2022-06-19 09:48:42,5,28,23,高傲且离谱，看不起别人还要装出一副自己很广开言路的样子
156381,4526,金敏,2022-06-19 10:57:12,12,17,5,视域与范式竟是印象最深刻的。课比较硬，但作为一个外专业的好好学，按老师的方法来写读书报告、考试，给分不会差。
156384,4526,金敏,2022-06-19 10:04:44,18,24,6,金奶奶是我大一下遇到最有学者风范的老师。很遗憾的是在课堂并不是很能顺利跟上节奏，于是欠了不少课，但最后写读书报告和期末补天的时候补智云在二倍速下慢慢感受到了中法史的魅力，还是很庆幸。
156385,4526,金敏,2022-06-21 13:31:10,-33,20,53,bullshit
156398,4526,金敏,2022-06-19 10:58:10,10,30,20,可惜没有零分，自以为水平很高实际上自以为是、对学生极不负责，甚至有点疯魔，希望学校早点处理这种人
156400,4526,金敏,2022-06-19 11:15:26,4,7,3,上金老师的课真的很受启发，用心去听才能体会到老师的用心之处
156402,4526,金敏,2022-06-19 11:34:41,9,16,7,陈版教材就是好，就是好呀就是好，就是好
156419,4526,金敏,2022-06-19 13:55:10,3,6,3,这个老师是真的会给学生1.5的...一定要好好学她的课
156437,4526,金敏,2022-06-19 15:46:07,8,15,7,期末考试卷面给了0分。不知道应该如何评价这样的老师。
156453,4526,金敏,2022-06-19 23:11:25,3,4,1,emmmmmmmm
156514,4526,金敏,2022-06-21 15:15:43,-2,29,31,达不到境界是能力态度问题，但是不顺从个性而被予以批判则是个人的傲慢。如果视域真的开放，为什么中国法制史只容得下jm一个人的视域，自成的范式就一文不值？
156558,4526,金敏,2022-06-20 09:03:41,21,38,17,老师人很好，但是给分很求是、课程也硬核，想要水学分的就别来了。老师不会捞人，所以对于那种写得密密麻麻、自我感动但没有实际输出的人，老师并不会给所谓的努力分、鼓励分数之类的。那些因为自己期末成绩34分而叫嚣的人，倒不如先反观下自己的实力、想想自己为这门课投入了多少、平常上课在做什么。我平常有好好听（虽然大多听不懂）、课外也看了老师发的很多资料，写读书报告和期末考试时都觉得自己有所长进、能言之有物，最后拿了4.5。以上供参考
156637,4526,金敏,2022-06-20 13:15:09,62,80,18,如果同学们认真看过中法史的某些教材，包括其他部门法涉及到中法史内容的教材（比如《法理学》教材中对于“法”的论述），你会真正感悟到金敏老师对“礼、理、灋、制”、对于“法”的原初记忆的追寻和名词源流辨析的这些研究的重要性。现在的教材，不知是受何影响，普遍认为所谓“礼法结合”就是“道德教化”和“法律治理”结合——认为古代的“灋”和现代的“法”、“法律”含义一样，而认为古代的“礼”就是想现如今弘扬的“德治”一样是一种教化方式。大谬也！听完金老师的课，再去回看市场上的教材，不禁会感慨老师对法的澄清的必要性。否则我们真的会被禁锢在在一种狭窄的“视域”里，带着高中历史课上“礼法结合”“德主刑辅”“严刑峻法”（只会熟练背诵、不知其真正涵义）的“先见”来进行大学的学习——这是需要自我警醒的。\n\n  另外，老师学术造诣极深，旁征博引。金老师可能真的认为大学本科教育之用在于启发思维。她可能觉得部门法学得太深太细以后工作也会忘记、要重新自学起。为此，她极力主张思维的培养——即“捕捉蝴蝶的网”。老师很严格，如果没有认真听课、没有真正掌握老师上课所授，你的得分会很难看。但是你把握住了，得分依旧会很好。\n\n  希望同学们能珍惜金老师上课的时光。等到金老师从教坛离开，作为“打底”学科的中法史只开始教授“纯知识”时，未可知是否是浙大法学的损失。
156734,4526,金敏,2022-06-21 00:28:04,7,11,4,非常好，我过了但是我还想听（如果她明年还开课教本科生的话）
157040,4526,金敏,2022-06-21 17:05:34,3,29,26,真的无语，我没看来哪里有魅力，字里行间只看出来两个字“学阀”\n\n必须要变成她的学阀的一部分，才能高升，不然就给你挂科打压
157048,4526,金敏,2022-06-21 18:06:48,-73,12,85,迟早被车撞死！撞死了开香槟！
157055,4526,金敏,2022-06-21 18:25:15,8,11,3,凡取人之术，苟不得圣人、君子而与之，与其得小人，不若得愚人。何则?君子挟才以为善，小人挟才以为恶，换才以为善者，善无不至矣；挟才以为恶者，恶亦无不至矣。
157060,4526,金敏,2022-06-21 19:45:07,5,7,2,观光团到此一游~
157078,4526,金敏,2022-06-22 00:09:54,15,17,2,是会有收获的课，但取决于学生自己。
157081,4526,金敏,2022-06-22 00:35:15,4,7,3,值得尊敬的学者
157082,4526,金敏,2022-06-22 00:58:25,-12,14,26,做学问可以，做人emmm……
157083,4526,金敏,2022-06-22 01:11:31,28,35,7,打击报复金敏的最好方法就是让她讲xfg，要用魔法打败魔法
157105,4526,金敏,2022-06-22 02:44:09,8,10,2,金老师是一位很有学术风度的老师🥺🥺🥺
157207,4526,金敏,2022-06-22 09:40:53,7,7,0,上完金敏老师的课程，才感悟到何为“大学”，而非单单是一个学技术、拿文凭的地方。
157530,4526,金敏,2022-06-23 15:17:07,3,5,2,十大吃瓜人到此一游
157568,4526,金敏,2022-06-23 18:09:17,0,2,2,观光。
157729,4526,金敏,2022-06-24 13:03:12,1,3,2,啾啾啾啾啾啾
157888,4526,金敏,2022-06-25 10:32:48,6,9,3,一学期下来 认真听了老师的课 感觉自己的大脑被狠狠打开了 眼界拓宽 四维提高 金老师真的太厉害了 崇拜
159118,4526,金敏,2022-07-06 12:55:15,0,6,6,因为匿名，这里成了某些同学个人原因的泄愤地，部分人或许仅仅是给分低了，就上升到对老师无端的人身攻击，有些字眼诅咒谩骂不堪入耳，这就是浙大学子的素质吗...
160437,4526,金敏,2022-09-22 07:52:48,-8,5,13,首先，老师讲的视域和范式其实大可不必花两周的时间来讲，还引用道家文化。其实对于研究生来说一句话就可以概括为：不要局限于自己狭隘的视野，多看书即可。我们想学的是更多的知识，而不是一些通俗易懂的大白话道理。其次，个人觉得老师有学历偏见，觉得学自然科学的讨论法理哲就没有本身学哲学的厉害。在某些情况下不尊重学生，也不尊重说明的话题和观点，那这是她所谓的批判性思维吗？老师很优秀，但优秀不等于会教书育人，还是要互相尊重吧。
161302,4526,金敏,2022-11-04 02:58:10,9,12,3,法硕学生表示，金老师的课是真的在教我写读书报告，是真的打开我以前被考研束缚的视域！
161522,4526,金敏,2022-11-08 06:23:56,12,13,1,好像学到了什么，又好像没学到什么。这或许是最好的状态。
161923,4526,金敏,2022-11-15 04:52:50,13,15,2,金奶奶挺好的，只要认真听课，给分不会差的
161931,4526,金敏,2022-11-15 06:05:58,7,9,2,收获很多！只要好好听讲好好写论文分数就不错~
167505,4526,金敏,2023-01-16 22:20:31,9,12,3,永远感谢金敏老师推荐的文章
168378,4526,金敏,2023-02-15 06:49:32,0,8,8,不要选
169585,4526,金敏,2023-04-06 10:34:13,14,21,7,如果不是专业必修课这辈子也不可能会上
170606,4526,金敏,2023-03-07 05:50:12,3,12,9,自视甚高
171226,4526,金敏,2023-03-19 12:45:47,-4,5,9,拖堂很严重
171271,4526,金敏,2023-03-20 09:16:14,9,21,12,天天陈版教材朱版教材balabala，上课上的依托答辩，讲不出一点东西，天天视域天天范式，真不知道她除了这个就不知道别的了
171777,4526,金敏,2023-04-05 02:59:50,2,5,3,听不懂啊，不知道在讲啥
172054,4526,金敏,2023-04-18 07:23:17,7,16,9,我只想说真的：\n\nyou deserve it\n\n任何所谓的赞赏，争议还是无数细究文字表达的邮件，又或者上课有人“敏感”的提问，都是您应得的。
172060,4526,金敏,2023-04-18 09:07:57,-2,5,7,😅😅😅
172692,4526,金敏,2023-05-04 11:56:15,-14,6,20,只能说，如果在国外估计早就被突突了
174035,4526,金敏,2023-06-05 16:08:50,10,12,2,独立之精神
174061,4526,金敏,2023-06-06 03:38:23,-5,8,13,讲的什么玩意
174540,4526,金敏,2023-06-14 02:09:40,-10,10,20,只能说，您对主流范式这般大肆批判甚至抹黑，又要我们交作业的时候闭口不提马工程担心引火上身，？建议您早点离开大陆
175314,4526,金敏,2023-06-23 15:06:03,3,10,7,感觉虽然是个有学问的老师，但是有的时候对自己的看法太独断了，也不允许有异议。
176224,4526,金敏,2023-06-28 06:15:38,2,13,11,讲课太发散，强加自己的意志于学生，不允许有异议。给分也凶猛，真的有卷面 0 分的存在。还有就是不遏制一下读书报告的鹅颈吗？
176393,4526,金敏,2023-06-28 16:27:35,2,10,8,真的听不懂…考前复习得好b溃
176568,4526,金敏,2023-06-29 09:29:26,-4,6,10,无法理解
176786,4526,金敏,2023-06-30 06:40:43,18,19,1,金敏老师的讲课确实晦涩，但是是有迹可循的，从秋水的视域范式到历史观，中法史观，是一种“从共相到殊相”的进入，而这一条线的发散确实可以给人很深入的思考。确实，老师有时候会强调同一种思路，但是这只是一个梯子吧，顺流而东行，展示了从范式到例子一整套的思路，打下思维的基础……总之，很有意义的课，很有趣的老师。
177499,4526,金敏,2023-07-03 13:12:13,13,14,1,今天金奶奶出分，给分超乎自己的意料。想来这一学期的经历，又看到许多前辈的留言，只是觉得这里的很多追求学到“具体的知识”的评论者还是没有走出金奶奶希望我们走出的“前见”，当然并不是说自己对金奶奶教授的内容完全理解了，只是觉得金奶奶的课堂更多地给了我们一些思考和看视事物上的不同观点吧。\n\n从我自己的感受来说，中法史这门课带给我的焦虑是实实在在的，直到期末考试前的整个学期都陷入在金奶奶教学方式、课堂内容和考核方式的焦虑当中。那种每一节课好像什么都没有学到的不踏实感和以及与之相对的读书报告和期末考试的高要求真的让我整个学期都处在一种不安中。但是我第一次觉得有所改变的是在写读书报告时，发现自己比原先想象的能够更加自如地运用老师上课所学到的方式去分析阅读的书目，以及随后在期末考试时觉得每一道试题都在老师的上课内容中有迹可循，才觉得自己这一学期确实是有所收获的。\n\n但是可能每个人的感受都有所不同吧，金奶奶对我们在一个学期内所期望达到的提升也许确实和她课程安排的进度和讲课的发散程度有些脱节，未免有些“着急”的感觉在。金奶奶是欢迎交流的，我认为她对于学生的观点也是以交流和引导为主。但是对于“为什么会有金老师这样的老师在”等类似评论以及在这一学期中朵朵上看到的对攻击金奶奶个人的不太尊敬的言论，个人不能苟同；反而我更对于几年后只剩下“编年史”的浙大中法史感到惋惜。\n\n具体感受自然会因人而异，这是肯定的。但金奶奶是一位值得尊敬的学者。
177502,4526,金敏,2023-07-03 13:25:45,0,14,14,反动学术权威
177626,4526,金敏,2023-07-04 03:11:39,10,12,2,金老师真的很好！是很博学的学者！也是很负责的老师！如果想水课的话不建议选这门课，因为你的付出和成绩绝对是成正比的。上课的时候认真听老师讲是真的会有收获的，虽然大部分时间可能就是云里雾里的状态，但是这门课的魅力就在于，收获是在之后的法学学习之中出现的。老师推荐的书也都很好！值得细细品读！
177819,4526,金敏,2023-07-05 02:51:50,11,12,1,很认真的学者，很有见解的教授，好好听、记笔记，期末考试都会覆盖，这一学期经常处于听不懂的状态，但是也开卷把金奶奶上课提到的资料带全，基本就没有问题，给分也是我的专业课里第二好。特别可爱的金奶奶，还是不能因为过去的一件事就先入为主，一学期相处下来，奶奶还是很宽容的。
177872,4526,金敏,2023-07-05 07:06:14,11,11,0,爱的很爱，恨的很恨。我只能说，我在上课之前也听到了很多种不同的评价，但我自己体验下来，如果你真的有认认真真的听课和读书，是可以把握老师的讲课脉络和想表达的重点的，期末考试老师真的是给听了课的同学“暗暗放水的”，金奶奶就是个不会也不屑于拐弯抹角的老师，而且以老师的见识和能力也的确允许她做自己想做的。\n\n  金奶奶上课时推荐过《十三邀》邀请陈嘉映先生那一期，陈先生曾说：“我们几乎是在享受这种光荣孤立。”可能不是很准确，但是我很爱这样的金奶奶。我会说，可能会焦虑地反复修改读书报告，可能会上课战战兢兢地回答问题，可能会担心地发邮件交流，但是这门课，如果不上会很遗憾。
178793,4526,金敏,2023-07-23 06:12:57,16,16,0,说实话，在刚开始的时候，一直觉得金敏老师讲的东西非常形而上，也很散，不会像另一个班级按照课本讲各个朝代的法史，会让人产生一种云里雾里感觉进而产生摸鱼甚至抵触心理，感觉金敏老师似乎更应该去给高年级乃至法硕上课而不是来教授我们大一学生。但是，之后在写读书报告时认真读了几本书，后来也认真听了老师的上课，发现真的上课很愉悦，就像一种漫谈，一种阅读，大家可以想象一下自己的阅读体验，可能拿起一本书很困难，读了前面几页也总会有种心烦意乱，好像有些丧失阅读兴趣和能力，但其实度过前面几页往后看时你会沉浸其中心灵是放松的，尤其是针对并非课程要求的书籍即非功利性的阅读，那么听金敏老师的课程就会像阅读一般。在法学越来越注重绩点的氛围下，我们难免会感受焦虑，对中法史的课堂总有种说不清的复杂，可能是有些期待收到金奶奶的滋养，又有些恐慌，有时又是说不明的烦躁，实际上想要学好金敏老师的课堂，真正get金奶奶，只需要阅读，去阅读金奶奶给的材料，希望读几篇就读几篇，就会发现自己好像更舒展了，也更懂得怎么学习。
179055,4526,金敏,2023-08-26 10:13:48,17,21,4,是一个好学者，但不尽然是一个好老师。很认真地上了一学期，期末考试的问题也在上课时认真听了，但得分真的很惨淡。这门课的确让我学到了很多思维方法，也大大拓展了我的视域，这一点很感谢金奶奶。我不会为自己开脱找理由，但把一门法学专业课的核心要义偏向是否真正理解了老师自己的学术思想，这样的做法我始终有权质疑。
180793,4526,金敏,2023-09-26 09:10:18,15,24,9,这个老师最让人难受的是，车轱辘话来回说，偏偏还有那么一两句是有用的，不听不行。给我的感觉，这是一个很想装逼，然而其知识结构已经不足以支撑其装逼的老师。装的远不如谷神那么自然，偏偏比谷神还装，是其原罪。像这样的人有个常见毛病，那就是喜欢跟一句英语，连布鲁诺死前说的话也成英语了，颇有些“我读过托尔斯泰英文原著”的滑稽感。我建议金老师，好好读点认知语言学的教材，更新一下知识结构，讲点二十一世纪的东西，意大利语不会说就说中文。
181538,4526,金敏,2023-10-22 03:35:28,4,15,11,就那几个关键词来回倒腾，这里引那里引显得自己才高八斗，实则山间芦苇，中法史硬是上成了语文课，思维方法真是没学到
181991,4526,金敏,2023-11-07 12:39:12,15,16,1,期末作业写的很想死，但真的能从这门课中学到很多
182411,4526,金敏,2023-11-15 16:12:48,18,22,4,好好听课按照老师的要求写论文分数不会低的，金奶奶退休以后可能浙大法学院的法制史课程要回到编年史状态了……
182451,4526,金敏,2023-11-16 06:38:27,14,25,11,希望有新老师来接班，别让一位这样的老师再折磨学生了，以给学生挂科为荣誉么，说别人写的东西是bullshit之前，检查一下自己是不是bullshit
183584,4526,金敏,2023-11-27 12:55:13,1,4,3,太无语了
183838,4526,金敏,2023-12-01 02:51:30,12,14,2,好好听课按照老师的要求写论文分数确实不会低，课程作业（我甚至不敢称自己写的是读书报告）主要就是详细写范式的不同，以及上课以后知识的更新。不如这课就上一节其他时间给学生读书。。闲言碎语太多，很难切中要点，每天都说自己讲不完，少说几句这种抱怨话，可能就能多讲一点。
189608,4526,金敏,2024-01-26 00:29:15,5,9,4,回过头来看老师说的很多话我是不太认同的...一股公知味
190871,4526,金敏,2024-03-23 05:30:45,1,9,8,不知所云，讲的知识感觉不论是考研还是实务都完全用不上，建议去带研究生吧，别来折磨本科生
192540,4526,金敏,2024-05-23 09:34:12,23,23,0,下面写的每一条好评和差评都顶了。因为都赞同。\n\n这大概就是金奶奶给我留下的印象
192806,4526,金敏,2024-05-30 15:17:31,9,10,1,不同人自然会有不同思想，但是希望大家都能对学问持一份尊重。浙大法学院这样的老师现在不多，未来估计也不会多。
193058,4526,金敏,2024-06-03 07:20:17,7,8,1,为之前对老师说过的话抱歉
195371,4526,金敏,2024-06-28 01:32:08,6,6,0,我属于每天上课到场但不听的那种，期末花了很长时间补天。虽然我一直在吐槽我们的中法史太像法哲学学不懂，但是期末复习才感受到这份方法论的魅力，也感叹为什不早一点好好听讲。未来读书会一直应用金奶奶教的方法。\n\n给分挺好的，期末考有的都是上课讲到的，不过要注意时间分配，差点没写完…谢谢金奶奶捞捞。
195416,4526,金敏,2024-06-28 03:53:44,7,7,0,很有深度，让人不安又让人沉迷
195453,4526,金敏,2024-06-28 06:13:58,3,3,0,金老师并不是什么都没有教我们，而是在教我们今后从哪些地方开始学
195685,4526,金敏,2024-06-29 14:15:59,4,4,0,老师是真的很有个性。光听课会觉得她有点难搞，但是如果有多一点点的接触就会发现老师其实是很谦逊同时极为敏锐的学者。在复习补天的时候读她的著作，后知后觉地感到一种被叩问的震撼。\n\n虽然当初听课只道是寻常，但是想必在后面读书时还会时时温习老师的教诲。
196133,4526,金敏,2024-07-01 22:47:44,6,7,1,上完金敏奶奶的课之后才感受到大学教育应有的魅力🥺🥺
196379,4526,金敏,2024-07-03 07:28:10,12,12,0,学弟学妹们写读书报告的时候还是小心点（注意一些雷点，写之前朵朵上多搜一下）。这两届挂的人不多了，但是每一年都还有。
196389,4526,金敏,2024-07-03 08:08:37,7,7,0,金奶奶很好啊，学到很多，尽管有“不安”，但是因此学到的也最多
197513,4526,金敏,2024-07-18 05:58:01,8,9,1,大学毕业，金奶奶是对我影响很大的老师了。或许当年大一中法史课堂很多内容都记不清了，但金奶奶对我思维的锤炼是让我受益一生的。现在想来，大一下的中法史无意间渲染了我精神的底色。
199102,4526,金敏,2024-09-17 13:42:52,8,8,0,唉，我只能说金老师或许在课程安排上确实是不合理的，车轱辘话来回讲，有点装，这些都是有的。但是我想给它打高分，只有一个原因，就是他曾经提到过的，当你毕业时你或许遗忘了那些知识，但你的思维方式会一直陪着你（大概是这个意思）。他的课或许有缺陷，但是我在这里雀食获得了一些思考方式，这在其他的课上我未必能获得。
201887,4526,金敏,2024-11-07 08:12:58,6,7,1,给分巨差
202015,4526,金敏,2024-11-08 07:33:45,5,7,2,喜欢装b
202071,4526,金敏,2024-11-09 03:29:11,3,6,3,令人作呕
202078,4526,金敏,2024-11-09 04:54:11,1,4,3,这睫毛心眼儿小得跟针一样，但魅力却大得像宇宙！早日和偶像团聚，发射偶像同款光芒！🌟👀✨
202154,4526,金敏,2024-11-12 03:43:51,0,2,2,很难评价…给分是个迷 不如让gpt来写
207059,4526,金敏,2024-12-19 06:10:14,7,10,3,金敏是一坨法学生不得不吃的shi，只能说今年终于退休了……
207815,4526,金敏,2024-12-24 11:22:37,15,15,0,你是一走了之了，我的陈版叶版公主之死是砸手里了
103698,4591,叶勇飞,2019-03-04 08:43:07,0,2,2,哈哈哈哈
74243,4633,范良聪,2018-02-07 18:03:14,9,12,3,超级温柔超级好啊老师！
74630,4633,范良聪,2018-03-05 07:13:48,3,6,3,挺好的啊
76265,4633,范良聪,2018-04-01 06:27:13,9,13,4,有思想的男士
76696,4633,范良聪,2018-04-18 13:33:03,4,8,4,有很多新的启发 经济学入门很棒 就是语速有点点快
76729,4633,范良聪,2018-04-19 09:09:11,7,12,5,老师很不错！上课会一个一个轮流回答问题 耐心帮助修改课程论文～^ ^
76986,4633,范良聪,2018-04-27 06:44:23,4,8,4,老师讲课很有趣哇！
77060,4633,范良聪,2018-04-30 13:12:56,14,28,14,对不起我可能要拉绩点了，希望大佬们继续往前飞吧，没有经济学的思维大概是很难写论文了。老师很耐心很认真讲课也蛮有趣没错嘞！
78320,4633,范良聪,2018-05-11 01:38:57,2,6,4,改论文超级认真，不过短学期写论文的时间真的太短了有点吃不消。人超级好。讲课挺有趣的吧，但是会以开火车的方式回答问题。
78376,4633,范良聪,2018-05-11 07:49:23,14,25,11,老师上课很有趣，可以见识到法学以外不一样的思维。老师也是法学院为数不多的教学和学生放首位的人了，经济学人都是计较利弊的，在教学质量不纳入职称评比的情况下，还能对教学，学生论文投入这么多的心思，可以说是很有情怀了吧。有一点意见就是，老师的假设数字很刻意，没有说清楚来源，最后得出来的结果就不太让人信服。差一分满绩，改了2次论文，还是很推荐这门课的。
78652,4633,范良聪,2018-05-14 07:20:02,3,7,4,老师真的超好哇，上课很用心，虽然语速稍微有点快，但是感觉思路被拓展了，满分～
80425,4633,范良聪,2018-06-26 10:47:40,0,4,4,他就自己讲，从来不点名
81293,4633,范良聪,2018-07-04 14:57:08,13,18,5,不好意思，老师太太优秀了
82387,4633,范良聪,2018-07-08 04:58:38,7,13,6,老师真的超级棒 不进讲课讲的很好 而且真的很仁慈 很爱护学生 会一遍又一遍帮助修改论文 真的超级耐心和细致
83031,4633,范良聪,2018-07-09 13:51:39,-1,6,7,天哪这么多人满绩的嘛？
83061,4633,范良聪,2018-07-09 14:47:42,-2,3,5,写好论文不是那么轻松的，但是老师很耐心
83601,4633,范良聪,2018-07-10 20:20:47,-1,5,6,同学论文写得认真，修改的好；老师肯给满绩，为什么满绩多还有人有意见？
86467,4633,范良聪,2018-09-16 14:58:13,6,10,4,遇到一个用思想用专业水平用心上课的好老师 一万个手动点赞? ? ?
86742,4633,范良聪,2018-09-18 08:41:37,-2,2,4,很棒哦，思维启迪
91014,4633,范良聪,2018-11-29 03:04:57,-1,2,3,请问法律定量研究方法是论文还是考试呢
92937,4633,范良聪,2019-01-06 02:55:48,-1,3,4,老师人真的很好，讲课非常好，鞭辟入里，从经济学表象摸索到根本的哲学源头与经济学理念，然后联系到法学的各种条例与社会现象及现象下的底层规则。上课体验极佳。
102528,4633,范良聪,2019-02-05 03:55:43,-1,2,3,老师上课很生动，法律经济学的课程也很有趣，课程论文的写作能很好锻炼人的逻辑和思维，让我对经济学知识有了初步的了解。课后老师也对学生特别耐心，特别愿意帮助学习，很感激老师。
103342,4633,范良聪,2019-02-27 11:09:38,-2,1,3,真有趣涨知识
104174,4633,范良聪,2019-03-13 11:07:05,7,13,6,老师屡次提起查老师，是暗示我们进来评分么？\n\n呜呜呜，我好善良，10分！
109950,4633,范良聪,2019-06-20 12:46:58,0,5,5,所有因机缘巧合右转的学子，都应该了解一些经济学来作为智性的启蒙。9102年，让我们再想一想，市场失灵了吗？如果失灵，是因为市场本身的缘故，还是因为现实中市场发育不完全？如果是前者，表现在哪？如果是后者，原因是什么？在其中，政府与法律分别扮演了什么角色？如果要解决问题，政府与法律应该扮演什么角色？在如今的现实面前，任何赞美都已变成嘲讽。
111247,4633,范良聪,2019-06-30 18:03:06,0,3,3,4.5知足了 谢谢老师╰|･ิД･ิ |靓仔路过\n\n写了同人文学商业行为侵权，最后也没有什么有效结论，但是很高兴做了这次研究
111277,4633,范良聪,2019-06-30 23:59:08,1,2,1,啊 感谢老师 感谢感谢
111281,4633,范良聪,2019-07-01 00:09:18,0,15,15,撑死5分
111285,4633,范良聪,2019-07-01 00:21:01,1,5,4,害 老师是真的是个好老师 但是我实在是没有任何经济学的天分和充足的问题意识 论文写得不好 在这门人均4.5的课上拖后腿了。但是还是感谢老师给我带来了不一样的思维启迪
114539,4633,范良聪,2019-07-10 12:32:53,-1,2,3,好老师，好课堂，给分也很好
117367,4633,范良聪,2019-09-23 11:19:31,-1,2,3,非常好
121029,4633,范良聪,2020-01-19 09:38:56,0,2,2,呜呜呜吹爆老师！！老师很有学识给分也很好！！
122850,4633,范良聪,2020-04-14 13:42:15,1,2,1,自己听就知道了
134829,4633,范良聪,2021-04-17 11:12:44,0,4,4,还没结课但是真的 非常喜欢老师感谢老师 对菜鸡太友好了5555 强推！课跟人一样有趣！谁听谁知道！
135523,4633,范良聪,2021-05-12 11:03:42,0,5,5,真正把学生、学术放在首位的好老师！读书时的榜样，心目中完美大学老师就是范老师这样的人，博学聪慧，凡事都有自己独特的见解，更重要的是没有因为麻烦、利益等各种问题忘记初心。
136350,4633,范良聪,2021-06-17 01:04:13,-1,1,2,挺好哦
136641,4633,范良聪,2021-06-22 10:19:21,2,5,3,没有结课没有出分，写完论文来客观评价下老师。\n\n经济学出身的老师给一直处于法教义学下的法学院同学开辟了一个新的视野。\n\n期末论文老师会提修改意见，不多但是一针见血，一个班近百人一份一份作业看下，老师真的很负责。\n\n再次感谢老师。
136892,4633,范良聪,2021-06-27 15:37:39,0,4,4,范老师超棒！！聪哥勇敢飞，葱丝永相随！
138074,4633,范良聪,2021-07-07 09:14:35,2,5,3,法律经济学真的为我打开一片新天地！老师不点名，讲课特别快，但很有意思，稍微有点福建口音，会认真看每个人的论文提意见又叫我们修改，给分也不错。很幸运能遇见老师！
138996,4633,范良聪,2021-07-12 06:38:20,1,5,4,范老师人很好，用经济分析的方式解决法律问题，上课生动有趣，就是语速有点快。
139211,4633,范良聪,2021-07-13 08:37:47,2,7,5,法学通论，逻辑严密，只是有些经济法逻辑看似很酣畅淋漓其实经不起进一步敲打。瑕不掩瑜。给了十分。
141220,4633,范良聪,2021-09-26 17:07:44,-1,6,7,良聪，yyds！
142247,4633,范良聪,2021-11-09 08:38:51,1,8,7,10没什么异议吧
142278,4633,范良聪,2021-11-09 19:49:42,-19,10,29,三观不正就是说
151674,4633,范良聪,2022-03-11 09:05:35,-9,17,26,如果不点名是好老师的标准，那范老师确实是一位好老师。如果讲话温柔是优点，范老师也确实温文尔雅。但问题在于，他的课同学们什么收获都没有！只有一些听上去很唬人的东西。听着高大上，实际上一头雾水，估计老师都不知道他讲了什么吧。哦对了，真不知道从没接受过正规法学学术教育的范老师怎么能胜任光华法学院的教职？法学院的门槛这么低了吗，无语到家···经济法、法学的经济分析自己都没搞懂就不要误人子弟、不懂装懂了吧。不懂经济学，真想听听经济学同侪对于范老师的学术水平作何评价
152022,4633,范良聪,2022-03-23 08:50:08,6,11,5,经济学帝国主义
153669,4633,范良聪,2022-05-17 08:29:33,-7,9,16,讲的很好
153671,4633,范良聪,2022-05-07 12:09:28,4,13,9,老师给分还可 不点名 讲的有点点虚 因为听过范老师的讲座才选的课 有点失望 初听惊艳 再听无用 浪费时间
155223,4633,范良聪,2022-06-09 12:39:11,5,21,16,垃圾中的垃圾
155378,4633,范良聪,2022-06-12 02:02:45,-8,5,13,非常好的老师，非常好的青年学者
158055,4633,范良聪,2022-06-26 13:10:23,8,15,7,对老师水平不作评价 但经济法这门课是真的哈哈 学不会什么不说 给分迷的一批
161755,4633,范良聪,2022-11-12 08:49:34,20,28,8,很独裁，很自以为是，跟老师有过的几次交流发现他其实不懂公司法证券法，没有法学学位却成为了法学院教授博导，真的荒诞
172024,4633,范良聪,2023-04-17 16:06:08,7,8,1,本科生要求博士生论文水平？
172405,4633,范良聪,2023-04-26 07:09:07,15,16,1,或许是本法科生缺失太多经济基础知识，感觉老师的讲课节奏有点奇葩，内容跳跃让人头晕目眩，各种概念无限堆砌，所有知识点都是零零散散。上课感觉像是在看知乎的公知科普，表面上是故事汇，实则是个人价值观的不断输出。\n\n要真想完全了解法经济学的内容，还是得课下花费精力去阅读文章和书籍，这里推荐人大冯玉军的法经教科书，框架完整，简单易懂\n\n这次的考核方式是研究计划书+论文，没有期末考试，压力不算太大
172535,4633,范良聪,2023-04-29 02:15:15,23,26,3,我很疑惑为什么有那么多人吹捧范老师。范老师学术上或许是过得去，但我作为一名法学生，真的无法忍受范老师在学术上的专治和经济学帝国主义。\n\n法经课上的“同学们，你们听懂了吗”“能明白吗，嗯？”每每只能让人一头雾水。或许范老师经济学实力确实非常强，但是对于法学生的授课，我个人是比较希望能从基础的经济原理概念出发进行讲解，而不是扯来扯去，两三分钟说一个小故事小栗子，浅尝辄止 又没法讲透原理。\n\n范老师确实发了非常多的阅读材料供参考，但坦白而言，没有经济学基础的法学学生看到这些莫名其妙的生涩翻译只能是满眼问号。
173946,4633,范良聪,2023-06-05 05:53:16,4,8,4,只能说一个毫无法律基础的老师在法学院当了教授，是相当讽刺的一件事情。\n\n上课毫无章法，完全不知道在讲什么，靠着自己学习过的一些经济学基础在法学课堂上吹个不停。
174143,4633,范良聪,2023-06-06 15:09:30,13,13,0,讲课不行
174291,4633,范良聪,2023-06-09 03:50:00,4,5,1,不行吧
174473,4633,范良聪,2023-06-13 01:09:53,3,10,7,非常的自以为是，骗骗外行人可以，实际上很多东西他自己压根不懂，就是很能装，课外问他问题给人感觉很差，自以为是、假清高和没有素质
174517,4633,范良聪,2023-06-13 13:48:57,8,11,3,趁着出分前来评价一波~\n\n本人是对对法律经济学有着浓厚兴趣的，以前阅读过相关的教科书和他人的文章，抱着期待的心态来上范老师的法律经济学，但是范老师的授课过程确实让人失望。零散的概念和有待证实的举例漫天飞，让人有一种刷抖音的奇妙感觉，但后果就是脑中毫无重点！片段化的内容可能适用于讲座，但并不适合长学期的授课，要真想学点“法律经济学”，还是自己多读多看……要想听个乐呵，尽管来
176673,4633,范良聪,2023-06-29 16:20:21,7,7,0,给分挺差的……
177521,4633,范良聪,2023-07-03 14:45:17,-1,3,4,感觉到良聪还是蛮喜欢张五常和阿尔钦的那种，从现象出发的经济解释路径，以及讲课方式的哈哈哈。
177585,4633,范良聪,2023-07-04 00:40:30,6,7,1,上过他的竞争法，第一节课听得云里雾里，后面就再也没去了……
177974,4633,范良聪,2023-07-06 02:05:15,-3,8,11,傻der
178014,4633,范良聪,2023-07-06 07:46:34,2,7,5,老师的课堂还是挺自由开放的，并且交上去的论文也会认真看，还会回邮件反馈，法经最后给分也不错的。
178021,4633,范良聪,2023-07-06 09:20:55,2,7,5,给分差
178060,4633,范良聪,2023-07-06 13:09:04,10,10,0,完全听不懂，给分也挺迷
178073,4633,范良聪,2023-07-06 15:00:45,8,21,13,上课或许值9分，但是人品最多最多1分，十分独裁，且心胸狭隘，之前因为一些不太重要的小事和他起了点矛盾，我全程保持着礼貌一直给他道歉，并没有说任何重的话和攻击性的语言，我以为这个事情就这么过去了，然后期末论文被他打了一个接近挂科的分数，可问题是论文我是让我叔叔给我看过的（我叔叔是别的学校的经济学副教授），再怎么样也不可能是一个差不多挂科的分数，不得不说这样的人很聪明，给一个挂科边缘但又不挂，如果挂我我绝对找人去法学院门口举大字报举他个半个月，反正觉得是个烂人
185444,4633,范良聪,2023-12-29 11:00:09,-2,5,7,傻diao
185836,4633,范良聪,2024-01-04 19:43:39,-6,9,15,一直留在城市学院好了，请万万不要再在浙大法学院开什么课了。。\n\n课上反复强调中医迷信美国好，举的例子张口就来，纯粹的资 本 主 义 walk dog！\n\n论文发的再多再好不过是台精致的机器罢了，没有灵魂
185893,4633,范良聪,2024-01-05 13:59:19,0,3,3,这个经济法给分好差
185896,4633,范良聪,2024-01-05 20:41:46,-4,7,11,麻烦楼下的同学嘴下留情，同样作为上过范老师课的同学，我认为范老师的授课方式确实很不一样，但你自己扪心自问你有认真的听讲吗？你有去阅读过包括但不限于范老师推荐的书籍吗？我以为大学基础的法律学习，一在学习概念，二在学习分析思考，三在学习探究问题的本质。敢问同学你有做到哪一点？基础不牢，地动山摇，这位同学自己也应该反思一下自己的言行，究竟是你想获得科普型的知识讲解呢？还是想获得启蒙式的知识教育？如果你想获得前者，那么不妨去哔哩哔哩看法考的课程，那个课程全面且方便你系统性的学习。如果你想获得后者，那么建议你多读多看多思考，有了一定知识储备去听范老师的课或许会好很多。
186916,4633,范良聪,2024-01-13 13:53:30,3,7,4,排挤异见，难有师者风范
194436,4633,范良聪,2024-06-24 02:45:36,4,4,0,去年77，今年重修78，可能我确实不太会这方面的东西。写数据交易也从老师说的错误的出发点阿罗信息悖论谈起，但这确实是我查了很多核心期刊论文后提炼出来，我也没想到今年写得还挺努力了结果还是这个成绩。
194457,4633,范良聪,2024-06-24 04:55:56,2,3,1,上课有意思、但给分真有点不留情面、、、认真写了很久很久，作为一个文科生也极尽努力运用数学模型进行分析，但是最后只给了3.3、、、可能在老师眼里我努力的痕迹仍然是托答辩吧，只能说慎选
194498,4633,范良聪,2024-06-24 11:41:46,2,2,0,上课真的很迷，给分也很差，吐了。
196253,4633,范良聪,2024-07-02 15:08:10,2,2,0,法经\n\n已老实求放过。
200486,4633,范良聪,2024-10-17 14:08:17,2,3,1,从没学过法的人为什么能当上法学教授。世界就是一个草台。
216182,4633,范良聪,2025-03-12 00:50:45,1,1,0,不能容忍别人的不同意见和反驳，不知道是刚愎自用，还是水平不行，包容度不高，建议大家请教问题降低预期
76120,4636,王冠玺,2018-03-27 08:53:16,-1,0,1,冠玺见闻录，你值得拥有！
78636,4636,王冠玺,2018-05-14 05:40:55,-1,0,1,为什么大长腿男神的评价这么少呢？
126303,4636,王冠玺,2020-09-22 04:22:01,1,1,0,有点无语，上课完全就是念王泽鉴老师的书。请求权基础基本都是债法内容，放在民总讲吧打好基础固然不错，但期末50分考这而且是原题算咋回事？并且感觉章老师独自带的班比合班分要高不少，看前面评论合理怀疑是被王老师杀了
73964,4715,金彭年,2018-02-04 02:22:55,1,1,0,有口音，听不懂，出题偏，给分差，还给挂！
70664,4844,王超,2018-01-27 10:44:31,-11,11,22,很可爱的老师！虽然上课有点念ppt，不过仔细听有收获！
71335,4844,王超,2019-03-01 03:54:42,-14,13,27,老师经历超丰富，但是特低调！期末考试难度也很不高，很照顾同学！但是平常讲课…有点闷…
71459,4844,王超,2018-01-28 13:16:28,-12,10,22,刚开始觉得有点无聊，后面才开始觉得老师其实讲得挺好的，老师人也很nice
73952,4844,王超,2018-02-03 22:13:02,-12,8,20,好好好
74095,4844,王超,2018-02-05 05:23:12,-10,9,19,讲课无聊，给分不错
92799,4844,王超,2019-01-04 13:11:15,-14,2,16,考试开卷吗
98790,4844,王超,2019-01-24 02:41:36,-15,11,26,上课认真听我觉得也很不错啊，老师有自己的情怀，有时候也很萌。开卷考试，老师很善良，考得都很基础
99262,4844,王超,2019-01-24 13:55:42,-10,20,30,老师真的好可爱哦！人生经历超级丰富但是很低调，讲课很认真，念ppt和拓展都有吧，说话语调是有点闷，但是越听越能发现老师的阅历真的很丰富，重点是真的真的很可爱555
100864,4844,王超,2019-01-27 03:26:12,12,28,16,不会上课，给分不如隔壁，建议选马光
101047,4844,王超,2019-01-27 10:28:55,-14,10,24,老师人很萌很和善，讲课也比较认真，考试、给分都很为学生考虑。虽然我分数比自己预期低了一些，但可能因为自己案例题分析得不好吧，总之还是很喜欢老师的。但建议以后很多比较琐碎的知识点没有必要面面俱到，倒是希望老师多分享一些案例分析和时事研讨嘻嘻嘻
101551,4844,王超,2019-01-28 12:00:07,-14,9,23,感觉老师真的很萌很可爱 特别是最后一节课给大家看他之前在PCA工作的照片 要被老师萌翻了  前面几节课没听进去感觉还挺无聊的  但是后来就觉得老师讲课也有他独特的可爱之处  就能听进去了 最后考试也比较简单的  老师说不会为难我们真的没有为难 开心?
114205,4844,王超,2019-07-09 04:21:00,-14,9,23,王超老师超级棒，课讲的好，给分也高，很可爱哈哈哈
146281,4844,王超,2022-01-06 06:30:04,-13,9,22,好喜欢老师😭虽然好多课要么划水要么没认真听 但是越到后面越觉得老师很可爱很萌～
147711,4844,王超,2022-01-10 13:56:12,-13,9,22,老师人很好，平时做一次小组展示，期末开卷难度不大，给分也很高
148403,4844,王超,2022-01-12 10:56:05,-12,11,23,平时很轻松，老师很可爱总是笑呵呵的还有点小帅，考试很简单，老师给分也超好 打9分是因为强制小组分组有点无语，容易碰到无语队友，以后可以考虑自由分组吗
149861,4844,王超,2022-01-17 10:27:01,-9,14,23,国际法。老师PPT上内容很少，一直听他讲就感觉有点闷，到了期末复习的时候才发现就是按王铁崖教材讲的，以后学弟学妹可以直接上课对着王铁崖看。划重点很准，给分绝好！！！
159111,4844,王超,2022-07-06 10:25:24,37,49,12,博士论文抄袭…
159115,4844,王超,2022-07-06 12:33:11,31,44,13,师生恋........
159132,4844,王超,2022-07-06 13:52:11,53,72,19,据信该老师博士期间涉嫌抄袭同学论文并抢先发表。该案于2022年6月由上海知识产权法院作出二审判决，驳回上诉维持原判（王超构成侵犯他人著作权，判决其停止侵权、赔礼道歉、赔偿损失等）。\n\n相关链接及判决书图片如下：\n\nhttps://www.cc98.org/topic/5368813\n\nhttps://mp.weixin.qq.com/s/n9NpgtiDYgf4NQ7BEhLSSQ\n\n若学术不端为真，愧为浙大老师，愧对求是校风！
159172,4844,王超,2022-07-07 09:20:54,-47,24,71,说师生恋的你没事吧？别人男未婚女未嫁，自由恋爱，合法结婚有什么问题吗？2022了，大清早就亡了，若是想落井下石提这梗真心没必要。\n\n      再说“博士论文抄袭”一事，据判决书内容显示，城大特别委员会判定黄某提出若干控诉均未成立，仅支持其中一项控诉中的部分内容成立。若特别委员会认定为博士论文抄袭或严重学术不端，为何不取消王某博士学位？既然已裁定不撤销学位则代表城大特别委员会就此事早已有所定调。黄某仅抓住特别委员会支持其的一项控诉中的部分内容，再次向法院提起诉讼，是何用意？且看公众号文章首部时间线条理具体而清晰，均是有利于黄某的“事实”，并是判决书中完全显示不出来的内容，除了事件当事人，还有谁能对此事如此了解？\n\n      始终相信兼听则明，仅听一方意见无法得出最终论断。若为黄某因私人恩怨泄愤泼脏水，且组织好有利于自己的内容投到公众号毁坏我校教师声誉，则此时忙着落井下石为时尚早。以上！
159187,4844,王超,2022-07-07 14:12:09,39,53,14,哈哈哈那个替wc辩解的 你就是本人吧 这么急干什么 \n\n首先，二审判决书不是说的明明白白嘛 “两者都…，并不正常，除非存在抄袭”“上诉人（王某)就此部分内容与被上诉人（黄某）相应内容构成实质性相似”。一二审法院均认定王某侵犯了黄某的著作权。怎么，难道法院也是黄某开的，法院作此判决就是为了诬陷王某吗\n\n其次，你说港城大未取消王某学位，以此得出黄某向法院起诉是“泄愤泼脏水”这就更搞笑了！你不知道诉权是一项宪法权利吗。港城大为何在认定王某构成剽窃的前提下没有取消其学位那是它的事 又如何能得出黄某就不能提出诉讼的结论了呢\n\n最后 我寻思着也没人在批判师生恋啊 那个评论只有师生恋三个字 哪里像你说的“在玩梗” 究竟为何要如此激动？况且你不知道美国高校是严禁师生恋的吗？怎么 找你的说法  美国也生活在大清的统治下吗\n\n王老师消消气 按学院领导的尿性 肯定不会开除你的 这么多人举报zc，他不是也还升副教授了嘛
159197,4844,王超,2022-07-07 15:55:48,-28,12,40,1. 你也是搞笑，你是怎么得出的为王某说两句话就是王老师本人的呢？照这个逻辑你是就是黄律师本人对吗？只有你的看法是真理，不同意见就不能评论了？\n\n2. 不必劳烦复制那么多判决书的内容。判决也显示，多年前港城大特别委员会已就此有所论断，黄某提出的若干项被特别委员会驳回的控诉不在本案审理范围之内。按照你的逻辑港城大特别委员会是为了王某开的，其驳回黄某前大部分请求并裁定不取消王某博士学位就是为了防止王某多年后被浙大开除？\n\n3. 本人完全尊重法院判决，只是质疑黄某针对多年前委员会仅有利于自己的部分裁判再次提起诉讼，并很可能是自己缕出时间线投给公众号是否有报恩怨之嫌，你又如何得出我否认提诉是一项宪法权利的呢？\n\n4. 这个时候带节奏师生恋三个字却又说不是为了落井下石，掩耳盗铃没必要吧？所以你是活在美国校园对吗？那么喜欢西方文化自由美利坚欢迎你啊！实在看不惯你也可以去法院起诉要求他们离婚，毕竟诉权是一项宪法权利咯。
159198,4844,王超,2022-07-08 03:03:59,41,52,11,为什么禁止师生恋，因为对其他人不公平。如，王夫人当年一研究生混入本科生队伍参加贸仲杯，没上场成员却得团队贡献奖（wc带队老师），申博期间wc亲自陪同赴港，浙大博后期间论文挂名，接下来大概是职称了吧。。按理这教育背景和科研成果怎么会浙大留不住去城院呢？
159199,4844,王超,2022-07-07 17:47:56,-35,10,45,堪比女校了，一听道听途说的八卦就gc，成天举报这个抹黑那个，学院搞得乌烟瘴气。属实下头
159239,4844,王超,2022-07-17 15:58:14,14,29,15,执迷不悟，悲凉无边
159301,4844,王超,2022-07-11 11:05:16,17,18,1,法学博士论文被同学剽窃抢先发表，历经十余年终于维权成功\n\n看完推文，论文抄袭，学术不端实锤了…..
159329,4844,王超,2022-07-13 07:17:38,26,26,0,王夫人现在浙大城院法学院任教，去年刚进的，貌似也是这两年生的孩子。从香港读博回来在浙大又当了国际法所的博士后，联系王的经历，还有现在法学院著名的贵国教授之前也是港城大的，自行脑补。王夫人长得倒是挺好看，和wc还一起在之江食堂出现过。。而且王那主页一堆title没有一点具体的东西，看起来就怪怪的
159331,4844,王超,2022-07-13 07:45:02,19,20,1,死妈狗东西，浙大招这种剽窃狗真是体现了光华法学院的优秀水平
159333,4844,王超,2022-07-13 09:42:30,22,22,0,你可知，学术不端是红线，红线意味着，一旦越过，便不可翻身
159336,4844,王超,2022-07-13 17:04:38,19,20,1,剽窃论文，玷污法学院名声，浙大之耻
159338,4844,王超,2022-07-13 18:42:28,22,22,0,剽窃？威胁？不愧是国际法老师，您是有点settlement of dispute在身上的。
159340,4844,王超,2022-07-14 01:00:06,10,11,1,7.7评论“去法院起诉请他们离婚”是诉权 看笑了
159385,4844,王超,2022-07-15 12:34:10,5,6,1,围观一下
175074,4844,王超,2023-06-21 11:23:17,12,12,0,最后处理结果如何？只是停课？
177013,4844,王超,2023-07-01 05:02:15,5,5,0,可气可笑可怜可叹可惜
178759,4844,王超,2023-07-22 02:40:22,6,6,0,王夫人的论文都是谁写的？
183946,4844,王超,2023-12-04 12:32:49,3,3,0,怎么还在浙大？
190819,4844,王超,2024-03-20 04:36:32,2,2,0,我院之耻
197897,4844,王超,2024-08-20 06:39:06,1,1,0,考古 扫墓
199074,4844,王超,2024-09-15 10:48:22,1,1,0,何必呢
116177,4878,李有星,2019-09-05 13:54:14,0,0,0,
74544,4917,王书剑,2018-03-03 09:53:15,-8,2,10,还好吧
76412,4917,王书剑,2018-04-08 07:57:01,-10,2,12,老师人很好啊，反正目前来说很好
77829,4917,王书剑,2018-05-10 09:27:26,10,13,3,事情多给分极差，不要选这个老师的职规课，选其他老师的去吧。别问我是怎么知道的。
78058,4917,王书剑,2018-05-09 07:34:41,-6,3,9,事情不算太多，做规划书和其他作业一定要用心，成绩不会太差。但是这种课吧，确实挺水的，真正能不能有所提升，还是得看个人了。
78076,4917,王书剑,2018-05-09 08:57:26,-12,4,16,老师有丶小帅
78094,4917,王书剑,2018-05-09 10:14:28,-10,1,11,挺好的哈
78196,4917,王书剑,2018-05-10 02:38:16,-14,4,18,王老师很好啊，平易近人，颜值很高，阳光大哥哥的感觉。就是每节课要签到，事情还算不多吧，职规课的一般情况。会找学姐以及校外和人资有关的专业人员分享经验，给分也挺好的，10分，强推！
78306,4917,王书剑,2018-05-10 16:06:44,-12,0,12,老师还行
78395,4917,王书剑,2018-05-11 09:22:11,-15,6,21,阳光大哥哥，职规很有趣，每节课都还挺欢乐的。职规书认真做，给分能上4吧。
79135,4917,王书剑,2018-05-24 02:00:37,-16,1,17,只要每次都签到 作业用心写 给分超好啊\n\n老师长的帅低音炮 还有很多有经验的人的分享 超棒了\n\n
108562,4917,王书剑,2019-05-28 15:14:04,29,30,1,混日子的。
134463,4917,王书剑,2021-03-29 10:39:54,16,19,3,事多，喜欢搞形式主义，随意使唤学生。学院勤助的工资发放很迟，人家找他他说：给你们这个机会是来锻炼你们的（口区）
137379,4917,王书剑,2021-07-03 14:58:07,-16,3,19,职规气氛轻松，要求也不严格，重点是给分好，目前最高的绩点get
140316,4917,王书剑,2021-09-08 10:16:50,24,26,2,经典混日子的，群里只会@别的老师，当面只会推脱。\n\n不要说一些小事，就连本校保研的同学申请宿舍，由他负责的事那是一点也不做。\n\n\n\n法学院那么多行政老师，这家伙是最有问题的，眼里是只有他自己。
148199,4917,王书剑,2022-01-12 00:56:20,11,16,5,诸位，学院领导才不会来管各位的心声，人家已经升官了。链接如下：\n\nhttp://www.ghls.zju.edu.cn/ghlsbg/2022/0111/c13820a2474717/page.htm
153323,4917,王书剑,2022-04-28 04:00:49,10,11,1,挺油腻的
153447,4917,王书剑,2022-04-30 03:52:28,2,5,3,💦💦💦💦
159725,4917,王书剑,2022-08-25 10:41:22,27,32,5,他和骆笑简直就是法学院的卧龙凤雏…一个懒一个坏
159965,4917,王书剑,2022-09-10 09:04:16,-23,1,24,阳光大哥哥
161065,4917,王书剑,2022-10-25 12:03:04,9,13,4,问他点事情，他就觉得被冒犯，回答了也会让你自己觉得好傻，不配问他问题！
162196,4917,王书剑,2022-11-17 13:36:44,13,14,1,大混子
164525,4917,王书剑,2022-12-21 12:29:52,-22,1,23,非常好的一位老师！
171366,4917,王书剑,2023-03-22 12:46:27,6,7,1,难伺候
171367,4917,王书剑,2023-03-22 13:15:10,23,34,11,给大家说一件事（真实的），越想越气：\n\n我是外专业想转法学的，去年十月法学院有个宣讲会，完了之后我去问他（我自认为问了个很正常的问题），就是说我想转法学，有没有一些建议。然后他直接给我来了一句（进面试7个人，最后进去是5个人）：\n\n你觉得这7个人里面能有你吗。\n\n是，我知道转法要的绩点很高很高，而我第一学期均绩确实巨拉胯（没上4，因为大英大计基没上3把我害死了）。是，我知道我确实很菜，比不上有些大佬。但是，你他妈知道我是谁啊，你他妈知道我是啥水平啊，你直接张口就来这句话，我不知道你是存何居心。“这7个人里面能有我吗”，你他妈啥意思，那为什么就不能有我呢？你又不知道我是啥水平，何况当时第一学期绩点还没出，凭什么这7个人里面就不能有我？你知道我问你这个问题的背后，是一个转专业学子一直以来学法的理想，谁他妈给你的资格来浇灭我的理想？你他妈是个什么高高在上的大人物，站在制高点上嘲讽我？\n\n不多说了，一分送上。(你妈的为啥没有0分）就这件事情，我觉得这个老师人品不是一般的有问题。傻逼，纯傻逼，真你妈恶心人。\n\n这个是我的故事，大家自己斟酌，觉得冤枉他的踩也可以，觉得没有冤枉他的就顶我上前排，谢谢。
173883,4917,王书剑,2023-06-04 05:56:04,5,5,0,垃圾垃圾
174533,4917,王书剑,2023-06-14 00:33:57,5,6,1,油腻，只想偷活，不配称为老师。
178776,4917,王书剑,2023-07-22 07:37:06,1,12,11,那位写小作文恶评的同学，太玻璃心了吧，一句话耿耿于怀这么久，也许老师也并不是有意，有这个必要吗？至少老师还告诉你了一些信息，是不是最好直接和你说，不知道最好。真是可怕，在现实中心理得多扭曲，搞不好哪天报复社会了，做人善良宽容一点吧
180891,4917,王书剑,2023-09-28 02:00:27,6,13,7,1.那位“一句话”的同学，王书剑说话就是这样的，你也别太往心里去。如果是骆笑，她根本不会告诉你最后有多少人会进面试，有多少人会被录取，因为这与她本人的绩效和晋升无关，王书剑虽然说话确实不怎么好听，情商也堪忧，至少告诉了你有效信息。\n\n2.而且客观的、理性的讲，你的绩点确实不够进面试，或许他只是让你别浪费时间填材料罢了。\n\n3.另外，如果真的对法学热爱，之后可以考虑辅修或第二学位，或者研究生就读法律（非法学），之后照样可以考法考，从事法律职业。加油，你的理想不是他的一句话就能浇灭的，相反，你自己的脆弱、敏感和玻璃心可能会。\n\n4.最后我想说，对不忿的事情满嘴脏话地辱骂是没用的，他的这么一句话不至于让你用满篇“你他妈”“真你妈”“傻逼”“纯傻逼”来匿名写小作文，这些字眼让我完全无法对你共情，这也绝不是一个理性的法律人应有的品格。
194548,4917,王书剑,2024-06-24 10:07:31,9,9,0,不多说，细节见真章。小炒窗口大摇大摆插队到最前面，对自觉排队的校内外人士毫无内疚之心，应与谴责。
208631,4917,王书剑,2024-12-31 06:13:23,-4,0,4,王书剑虽然喜欢一句话回复，但是追问的话还是会回的。这人在法学院行政里已经算中上了，连他都受不了的话，别的行政会让你飞起来。
164715,4960,陆青,2022-12-24 05:37:47,1,1,0,好老师，很负责很认真
71566,4964,李冬雪,2018-01-28 15:30:42,-7,4,11,人很好
74394,4964,李冬雪,2018-02-18 08:48:07,17,25,8,绩杀 辣鸡
75073,4964,李冬雪,2018-03-07 08:09:02,-4,6,10,人很好\n\n 但是思修会卡绩
77850,4964,李冬雪,2018-05-08 06:51:10,-3,3,6,虽然职规作业多，但是是好老师
77863,4964,李冬雪,2018-05-08 08:44:33,-2,3,5,老师人很好很温柔，给分也很好
77876,4964,李冬雪,2018-05-08 10:06:17,0,6,6,人很好，很漂亮，说话也温柔。作业并不觉得多，平时作业可以稍微水一下，最后职规书和展示要努力做，基本就没问题了。
77888,4964,李冬雪,2018-05-08 10:56:05,-1,4,5,给分好呀，不过每节课都会点名，讲课也不错，可以学到一些东西的！
78415,4964,李冬雪,2018-05-11 12:09:13,-2,3,5,平时作业都有吧，主要看职业规划书
78607,4964,李冬雪,2018-05-14 00:11:26,-2,6,8,事情很多，讲课很差！慎选她的职规！
100397,4964,李冬雪,2019-01-26 05:06:43,4,6,2,给分很迷
102446,4964,李冬雪,2019-02-02 10:00:32,-3,2,5,给分还行，人不错
102515,4964,李冬雪,2019-02-04 06:03:23,-3,9,12,思修课：\n\n老师人很好，但是上课，嗯…有丶无聊，感觉都在念ppt，所以水手机的人更多了，课上互动性不太强，但是微信群大家还是一直在水，最后被正态了，3.3。但是老师挺着个大肚子还在上课，人还是很可爱的。最印象深刻的事模拟法庭，很好玩！
120887,4964,李冬雪,2020-01-18 08:55:13,-7,1,8,老师处理事情很尽心很及时\n\n课堂听不进去，但无妨\n\n找了个好玩的志愿者活动乐了一把
132595,4964,李冬雪,2021-02-02 13:56:04,8,9,1,思修是什么sb课程
150251,4964,李冬雪,2022-01-21 03:06:29,-3,1,4,老师 社会调查成绩还出吗
171595,4964,李冬雪,2023-03-29 15:52:35,22,29,7,点名某d委书记，表面很和善，背地里坏的很，学生敢维权，会用各种方法搞死你，呵呵，就这还是法学院
181344,4964,李冬雪,2023-10-15 11:38:38,2,4,2,有点无聊
207481,4964,李冬雪,2024-12-22 09:27:28,-11,1,12,学院为数不多有担当，愿意解决问题的老师
211055,4964,李冬雪,2025-01-22 09:33:04,7,8,1,比起解决问题更喜欢解决提出问题的人\n\n我反应奖学金评选情况有问题直接把我的所有信息捅给负责的行政，解决问题的手段是非常高明的
220480,4964,李冬雪,2025-06-18 06:54:20,0,0,0,感觉还可以， 蹲一个给分情况
78473,4990,肖燕,2018-05-12 08:28:06,0,0,0,sb。
103323,5120,王钰,2019-02-27 10:02:50,0,0,0,啦啦啦
115482,5138,王敏远,2019-07-27 17:13:44,3,6,3,好喜欢听老师讲课
151519,5138,王敏远,2022-03-08 16:13:21,28,29,1,法律类某网红的亲导师， 看同哥的面子也得给王老师10分。    感谢老师给我们送来了同工，正直的法律人，国男的拯救者。    提起浙大不再只有bobo了
151709,5138,王敏远,2022-03-13 08:22:10,15,15,0,这是法律人同哥的导师！ 满分！
151820,5138,王敏远,2022-03-16 16:25:08,23,24,1,介绍下 这是同哥的导师………满分💯
154031,5138,王敏远,2022-05-19 21:36:21,26,26,0,这是同哥的导师，打10分，是因为最高分是10分，respect ！\n\n\n\n当年我网聊时怼了__（你们懂的）然后被ta们诬告挂到微博，濒临崩溃，\n\n\n\n最后是同哥救的我….…
158289,5138,王敏远,2022-06-28 08:30:59,12,12,0,同哥 yyds\n\n\n\n王老师能安排我们见同哥嘛
159348,5138,王敏远,2022-07-15 04:20:29,9,9,0,老师 能安排我们见同工嘛..... 来自粉丝打卡
159497,5138,王敏远,2022-07-26 09:11:39,4,4,0,YYDS
159540,5138,王敏远,2022-08-07 19:32:21,9,9,0,同哥粉丝打call 留念！ 10分点赞！
159569,5138,王敏远,2022-08-14 09:04:23,8,8,0,同哥yyds
159784,5138,王敏远,2022-08-29 17:16:58,10,10,0,老师要保护好同工！！（浙大那个假冒的表白墙就是被同工辟谣的）\n\n\n\n同哥yyds ，希望同工能经常上98答疑~~
159817,5138,王敏远,2022-09-26 12:07:01,9,9,0,同哥已经上 98 暑假版答疑了 ，98保得住！没问题！
161669,5138,王敏远,2022-11-10 07:44:29,4,4,0,老师真的好可爱啊，越看越可爱。
161988,5138,王敏远,2022-11-15 17:20:18,8,8,0,恭喜同工法师 打赢98保卫战
183888,5138,王敏远,2023-12-02 15:46:44,3,3,0,敏远老师为人正直，受人尊敬，上课会结合学生情况、刑诉法重难点问题进行讲解，课堂上会耐心引导学生发言、讨论并进行点评，是超级超级好且亲切的一位老师！
184061,5138,王敏远,2023-12-07 12:01:44,0,0,0,原来感觉老师是大佬，很有距离感，但上了他的课才发现他实际上特别平易近人，很可爱~
190817,5138,王敏远,2024-03-20 04:29:50,1,1,0,和老师面对面交流过，满分
197751,5138,王敏远,2024-08-08 18:25:28,9,9,0,这是cc98 肥猪法师（同工）的老师———不需要多说了吧。\n\n\n\n打10分是因为满分是10分，实际应该打500分。
199283,5138,王敏远,2024-09-20 10:53:47,2,2,0,学术泰斗！\n\n身正典范！\n\n\n\n\n\n100分
199309,5138,王敏远,2024-09-20 16:33:39,5,5,0,中华法学泰斗
202098,5138,王敏远,2024-11-09 17:29:21,4,4,0,中华法系泰斗
208860,5138,王敏远,2025-01-02 15:23:18,2,2,0,我导真的是好，就像安西教练那种的
218925,5138,王敏远,2025-05-13 12:20:49,2,2,0,明哲保自身
73170,5194,石毕凡,2018-02-01 05:48:06,0,0,0,想再选老师的课，不点名
149865,5767,胡敏洁,2022-01-17 10:40:43,11,13,2,行诉。胡老师讲课有些跳跃，可能不是很好理解，但感觉老师人还是很好的……
150334,5767,胡敏洁,2022-01-22 16:13:54,15,18,3,行诉。讲的真的好emm…课件做得也很散…听他的课好累…经常在智云课堂上以为是自己走神所以才听得不连贯，仔仔细细倒回去听之后发现是她好像没讲连贯。很多时候提出问题之后扯一大堆和本问题不太相关的，然后就没有下文了，也可能是我太菜
164442,5767,胡敏洁,2022-12-21 04:01:06,5,8,3,好无聊，只念叨表面，与前两位老师形成鲜明对比
192465,5767,胡敏洁,2024-05-21 05:32:54,4,4,0,讲课水平一般，一直在念word，没有章剑生和查云飞老师讲的流畅，唉，不喜欢上拼盘课
193281,5767,胡敏洁,2024-06-05 14:14:31,1,1,0,老师讲课有点稀稀碎碎的…
193454,5767,胡敏洁,2024-06-11 05:51:38,1,2,1,求断更求退订求行诉不拼盘课教程。\n\n每天都坐第一排依然不知道她在讲什么，颇有一种想到什么说什么的omakase感。
197060,5767,胡敏洁,2024-07-07 04:18:04,0,1,1,行诉，上课的时候很认真听但很多时候依旧听不懂她想表达什么，一开始以为是我的问题，回去听了智云以及和同学们沟通之后发现周边人都听不明白，才发现是胡敏洁自己表达有问题。。。尤其是跟在章剑生和查云飞后面讲，这个对比简直不要太明显，老师到底是没备课还是咋的，为什么表达这么跳跃这么稀碎这么迷糊。。。
197575,5767,胡敏洁,2024-07-20 01:40:22,4,4,0,仔细听 老师讲课还是很清晰有逻辑的
200242,5767,胡敏洁,2024-10-15 06:04:46,3,3,0,老师人挺好的
202405,5767,胡敏洁,2024-11-12 11:38:02,4,4,0,课讲得怎么样见仁见智，但是老师人真的很好很好，行政法事情比其他班少很多，而且哪怕班上只来了一半人也只是让大家相互叫一下，不方便到课的话跟她说听智云她也会允许，超级温柔和善，每次课早八都来得很早，每个同学的作业都会仔细看呜呜呜呜
205054,5767,胡敏洁,2024-11-30 11:34:34,1,1,0,讲课其实有逻辑性，建议多听几遍，多记笔记
205747,5767,胡敏洁,2024-12-12 02:03:09,3,3,0,讲得稀碎但人还挺好的……
208735,5767,胡敏洁,2025-01-01 05:45:36,2,2,0,课讲的确实不太行，但老师人真的很好！
217437,5767,胡敏洁,2025-04-10 11:00:00,0,0,0,老师超级温柔超级好www
122796,5768,张文显,2020-04-07 13:50:44,1,2,1,老师的书。。。。
156251,5768,张文显,2022-06-18 13:22:50,2,2,0,习法概总编，呵呵
141784,5793,郭喨,2021-10-25 14:20:00,15,30,15,这老师是个天坑，告知如下\n\n1.直到倒数一周还没说清楚怎么考核，钉钉群禁言，私聊老师结果已读不回。\n\n2.有同学问他是否需要写论文，他回答要写。但是并未发布任何群公告通知学生，要求最后一节课完成近10组的10分钟课程展示，他还把开卷考试也安排在最后一节课，时间管理令人惊奇。\n\n3.每节课钉钉签到，上课不准使用任何电子设备，否则就会要求回答问题，压迫感强。\n\n4.不按照PPT授课，想到啥说啥，提一个问题要求同学们讨论，自主讨论时间近一节课。总之，每天都在刷新我对中特课的认知。
142861,5793,郭喨,2021-11-17 03:09:55,12,18,6,一共八次课 三次点名    点名是课前五分钟 网络不好的在现场都签不上 不过课后找老师可以补签 缺勤一次总分扣10分\n\n考核方式是出勤+小组作业+论文+期末考试 老师上课讲的东西不多 大部分时间在小组讨论\n\n期末给分比其他班低很多 搞不懂 \n\n老师第一节课说 想让大家真正学到什么，而不是水过去就结束了 但是很显然 失败了
142956,5793,郭喨,2021-11-18 00:27:15,5,9,4,希望老师可以给分友善一点哦！！
143693,5793,郭喨,2022-01-26 09:12:21,8,18,10,最后给分很迷，想水可以来，不用展示，不出去玩
143972,5793,郭喨,2021-12-15 00:19:26,0,4,4,水课大师
144114,5793,郭喨,2021-12-18 06:05:22,-5,3,8,哼，哼，哼，啊啊啊啊啊啊啊啊啊啊啊，啊啊啊啊啊啊啊啊啊啊啊，啊，啊啊啊啊，啊。
144501,5793,郭喨,2021-12-22 02:09:37,-1,4,5,非常的好！郭老师的课是有思维含量的！
144606,5793,郭喨,2021-12-22 15:13:42,9,10,1,刚开学的时候老师上课好像，emmmmm，讲话有点完美主义？主要是老师说话停顿比较多才会给人这种感觉哈哈。\n\n\n\n不过课的内容还是很有意思的，准备得也很用心。开学的时候小组讨论特别多，后来老师上课熟练了以后，讲的内容变多了，能很直观地感受到老师的进步。钉钉群里老师特别可爱！\n\n\n\n本科生也不知道中特课是什么情况，我学的是思修。思修的话，最大的感觉就是除了点名没啥压力。\n\n\n\n老师反对鹅颈，读书报告下限3000字上限4000字，交打印稿。超过4000字要求写一份字数为（论文字数-4000）字的检讨，说明为什么超了这么多字，没到3000字要求写一份字数为（3000字-论文字数）的说明，说明为什么能在这么精简的范围内把事情说清楚。\n\n\n\n志愿服务报告要求不准超过两页纸，不过印象特别深刻的就是有课友问字体要求，老师来了一句“法无禁止皆可为”……哈哈哈哈当时真的笑翻了！！\n\n\n\n理想信念那节课，老师搜集了每个人的志向，说要保存三十年。那就，三十年以后见吧！
144632,5793,郭喨,2021-12-23 02:31:33,-1,3,4,还好吧
144652,5793,郭喨,2021-12-23 03:39:05,0,2,2,1.第一节课会交代各种任务，然后之后就不管了，上课PPT也不会上传一下，钉钉上回消息特别慢，课堂展示什么的也不通知一下。\n\n2.老师学识渊博，教学一般，经常在课上让学生讨论奇葩问题，也就锻炼锻炼一下思维，上课拓宽一下眼界。\n\n3.提醒：第一节课布置的任务一定要用手机拍下来（要不然找不到），尽早完成任务（要不然期末很忙），期末一定要自己找题找资料复习（文印店，学解）。
144653,5793,郭喨,2021-12-23 03:39:05,4,6,2,1.第一节课会交代各种任务，然后之后就不管了，上课PPT也不会上传一下，钉钉上回消息特别慢，课堂展示什么的也不通知一下。\n\n2.老师学识渊博，教学一般，经常在课上让学生讨论奇葩问题，也就锻炼锻炼一下思维，上课拓宽一下眼界。\n\n3.提醒：第一节课布置的任务一定要用手机拍下来（要不然找不到），尽早完成任务（要不然期末很忙），期末一定要自己找题找资料复习（文印店，学解）。
144813,5793,郭喨,2022-01-14 02:52:22,6,15,9,事情真的少，不过老师应该是不太愿意特意给学生一个个调高一点的，思修是倒数第四门出的课，前面已经有22.5个学分的4.5了。\n\n\n\n结果这一门课期末考68，总评82，绩点3.6，把我均绩从4.5拖到了4.4...ㅍ_ㅍ\n\n\n\n总之郭老师给分基本上照着期末考试打，因为平时事情太少了，没啥参考标准。。。而且他只保证你不会不及格，思政课想拿高绩点还是得选高分老师，嗯，就这样。
145474,5793,郭喨,2021-12-30 02:18:57,-1,5,6,老师好帅
145490,5793,郭喨,2021-12-30 03:40:04,4,10,6,没想到大家居然这么想吗。提供另一个视角吧。老师人很好，虽然会下来转看大家是不是在水但也不会说什么。作业第一节课就已经布置了，最后两节课收纸质版，中间的时间非常充裕。上网课的时候说懒得同学可以继续躺着上了。我觉得老师是一个比较有理想的人，所以他讲一些例子的时候强调一些不是知识的东西，我觉得这才是重点所在。大家会觉得课水，我承认有时候讨论很奇葩，也不太照着课本，但是每次讨论老师都有在鼓励每个同学的观点吧？大体思路是没问题的吧？思修课学什么只能说见仁见智。我发消息问老师，钉钉会回复。期末还会给一些资料。虽然还不知道期末给分怎么样，但我觉得这一学期思修课很快乐。仅供参考。
145596,5793,郭喨,2021-12-30 11:53:52,-3,4,7,还挺好的
145829,5793,郭喨,2022-01-03 05:04:53,1,6,5,讲的很随性但挺有逻辑和内涵的，比较接地气的思修老师，就是考核有点不清不楚
148379,5793,郭喨,2022-01-12 09:47:20,0,4,4,事少人好
148842,5793,郭喨,2022-01-13 17:11:15,-8,7,15,事很少，给分不清吃怎么样，反正我自己作业完成的中规中矩➕期末考考前复习了一下下➕上课全到就4.5，老师上课会经常让大家讨论，有的地方思维确实比较深刻，算是还不错的老师(不过给分的标准有些模糊是真事)
148870,5793,郭喨,2022-01-14 00:24:22,-12,4,16,还阔以吧
148894,5793,郭喨,2022-01-14 01:50:24,9,19,10,上课不知道在bb什么，课堂无趣又无用。最后给分虾jb给，真的不知道zju要这种老师有什么用。不如请他扫厕所来的好
148904,5793,郭喨,2022-01-14 02:28:29,4,7,3,老师人很好，可能讲课有待提高，不过这类思政课也不用指望学到太多东西，不过给分有点迷，平时全勤，小组作业也非常用心的完成了，可能是期末考的不太好？总之最后的给分远低预期。
148917,5793,郭喨,2022-01-14 03:03:32,2,5,3,老师挺好的，我绩点不好
148921,5793,郭喨,2022-01-14 03:17:11,-1,5,6,究极好老师，人帅心善幽默有趣，极其反对无意义的内卷，很体谅大家，作业不多就要求你好好读一本书写一篇读书报告，并且志愿者服务报告格式没有要求但至少写上学号、姓名(手动滑稽)，男神说重要的不是这个报告结果而是走出校园服务社会的过程。而且对大家说期末考他能捞就捞，因为他觉得成绩没有必要看太重，真正重要的是在课堂和讨论中学到真东西，懂得用批判的思维看世界、实事求是、学会看清事物本质和内在规律，简直不要太好！给分也究极好，只要不缺勤，积极参与讨论，期末考不要太惨最终成绩都会不错的。
148938,5793,郭喨,2022-01-14 03:58:27,0,3,3,老师挺好哒～
148947,5793,郭喨,2022-01-14 04:09:19,8,10,2,给分差
149194,5793,郭喨,2022-01-14 17:13:03,7,13,6,考完试十几天不出分，我以为调分呢，结果……给分基本全看期末，小组作业读书报告什么基本不管，无语
149201,5793,郭喨,2022-01-14 17:43:01,2,5,3,期末考试分数八十多，作业不卷但是全都认真写，为何绩杀我？但是老师人太好了，我没办法说什么，还是愿意被你再绩杀一次。💗
149328,5793,郭喨,2022-01-15 05:53:31,20,28,8,郭老师是新老师，看得出来是想打破思修课的教条，给同学们一点收获的，但实际上课程效果可能没有达到他的预期……希望郭老师以后把课程设计得更合理，更系统一点，不要过于频繁得讨论，回答问题……还有可以增加法律的模块。总之希望老师的课越上越好！
149330,5793,郭喨,2022-01-15 05:55:55,35,49,14,事少但给分真的很不好，想拿高绩的还是不要选
150017,5793,郭喨,2022-01-18 09:44:50,4,8,4,事儿少，作业不多。点名。期末应该是不捞人的。
150051,5793,郭喨,2022-01-18 13:45:18,7,10,3,老师您不如改名叫郭不捞算了
150265,5793,郭喨,2022-01-21 04:40:26,-3,5,8,思修上课挺水的，老师有些观点挺有意思，三观也很正，绩点嘛……主要看考试吧，最后成绩公示我考的还挺好的，所以绩点也挺高，感觉不太看平时作业
150753,5793,郭喨,2022-02-17 08:38:54,-13,4,17,老师对教学很有野心 但很显然，至少在这学期失败了。但老师人还是很好的，给分不错
152188,5793,郭喨,2022-03-30 00:20:39,1,3,2,老师水平很低，不会讲课，让同学讨论又没多少人配合，学不到知识给分又低，快逃
154741,5793,郭喨,2022-06-04 12:33:44,1,2,1,怎么没有0分的选项
155407,5793,郭喨,2022-06-12 08:31:43,1,2,1,不会讲课。整节课都让学生讨论又没人配合，考试考得跟平时没有任何关系。
155408,5793,郭喨,2022-06-12 08:33:39,2,3,1,讲课没节奏，只是叫人讨论，课堂死气沉沉，事多且在临近交付作业的时候才公布d d l
156212,5793,郭喨,2022-06-18 08:36:22,11,15,4,半年过去给老师思修打个分，只能说大一同学对老师实在太宽容了，选他的时候你先去朵朵上查一查gl吧，我就没见到我们班上得分有比3.6高的。选他你不如大二再上思修，最起码不会让你的微积分白考
160011,5793,郭喨,2022-09-11 14:31:47,0,0,0,公告都能发到21级学生的课程上，22级学生不知道收到没收到，我怀疑这老师是不是工作能力有问题
160636,5793,郭喨,2022-09-29 02:38:06,8,9,1,真的不会上课，我初中没编制的老师都比他行。\n\n\n\n很有野心，但是才华跟不上野心，空有一个大格局，讲求是精神，但是根本落实不下去。\n\n\n\n课很水，因为上课什么也不会教（主观他想教，奈何水平太低），总是让同学讨论，基本摸鱼（他估计还以为这很西方教学吧）\n\n\n\n一些中规中矩的东西反而不明确。没有评分标准，没有ddl，自以为是创新课堂。但这不是我们想要的创新课堂。
160637,5793,郭喨,2022-09-29 02:36:16,0,0,0,不过上课
160709,5793,郭喨,2022-10-03 08:20:48,0,1,1,上课不知所云，毫无收获，光叫人讨论又没人配合，考试考的和平时上课一点关系没有。\n\n我在zju遇到最傻逼的老师没有之一
161294,5793,郭喨,2022-11-04 02:05:12,-1,0,1,太无聊了，不会上课的一个人，一个半小时的课他一个小时在讨论。动不动还下来走来走去的，无聊念PPT。每次上课都觉得浪费时间
161547,5793,郭喨,2022-11-08 14:48:52,1,1,0,垃圾。上课又水，给分又差，考核标准也讲不清楚，考试考的和上课讲得没有一点关系。
162401,5793,郭喨,2022-11-21 16:03:34,2,2,0,快逃吧
164736,5793,郭喨,2022-12-24 12:27:25,4,10,6,太差了真的\n\n避开吧\n\n老师有在努力让学生喜欢\n\n效果不敢苟同\n\n给1是因为给不了0
165101,5793,郭喨,2022-12-29 06:48:09,1,5,4,傻逼老师，别选，选了就坤
165460,5793,郭喨,2023-01-06 10:46:36,7,9,2,查老师上的评价只能说是仅供参考，我个人的感觉是老师上课可能会偏无聊说话有停顿，然后会时不时走到同学中间来cue问答，这让想水课的我很困扰，但是平心而论我觉得我的作业质量不好期末考试也没怎么准备，但是老师给到了我比较满意的分数，当时考前也帮我们准备了每章的考题，还是比较感谢老师的！一切以你自己的上课体验为准哦！希望后面的同学不要被查老师的分数吓到～
166223,5793,郭喨,2023-01-11 12:55:00,-1,2,3,能感受到老师是有志于课程改革的，也希望课堂能越来越好。其实比较负面的评价有点学科特色的感觉，老师人挺好的，私下沟通也非常善解人意，希望给分能更好一点。
166927,5793,郭喨,2023-01-14 08:56:02,-3,0,3,123
167520,5793,郭喨,2023-01-17 03:33:29,1,1,0,(￣(エ)￣)
167559,5793,郭喨,2023-01-23 03:28:26,-6,2,8,给分好，有想法的老师
167565,5793,郭喨,2023-01-17 10:46:22,3,4,1,上课比较枯燥和催眠，但是给分还不错。
167571,5793,郭喨,2023-01-17 11:45:24,1,1,0,给分还行 主要看期末考吧 上课很水 emmm应该学不到啥
167577,5793,郭喨,2023-01-17 12:07:37,1,1,0,个人觉得上课很水，给分主要看期末，今年应该是因为线上考试全是简答题，分数不错
167579,5793,郭喨,2023-01-17 12:23:38,6,8,2,老师尽力让思修课不一样，事也挺少。但要点名，今年给分还可以。除了喜欢下来转圈之外，其他都可以。一次都没有发言，最后绩点还可以。现在也较为及时回复信息。
167580,5793,郭喨,2023-01-17 12:25:31,3,5,2,老师很好的，很负责任，尽量给学生减轻压力，课堂氛围也蛮好
167622,5793,郭喨,2023-01-17 18:13:00,2,2,0,今年统一给分高很多，老师平时也会经常收集大家对思修课的新期待，挺想改变的，不过思修课都挺水学不到什么，期末比较重要
167635,5793,郭喨,2023-01-18 02:16:03,-2,1,3,今年真的还好，给分也还行
167658,5793,郭喨,2023-01-18 06:17:07,5,6,1,老师人还好但是给分真的太差，真心难绷
167668,5793,郭喨,2023-01-18 07:43:40,2,3,1,可能因为期末考试形式改变了所以最后出分还算满意。求是来说老师上课讨论很多但是问题问的意义不大，不知道别的班是怎样，但是事情应该不算多也不算少
167903,5793,郭喨,2023-01-20 04:33:09,2,4,2,老师人挺亲切的，钉钉消息都会回复，任务不重，这个学期给分整体也很好，课基本都在水，但是偶尔会有小组讨论任务要发言，而且会问一些奇葩的问题，就当做开开眼了
167919,5793,郭喨,2023-01-20 09:00:06,1,3,2,老师人还挺好的，蛮幽默的，给分比较求是，今年是线上开卷分数挺好的，以后就不知道了。
168330,5793,郭喨,2023-02-12 04:25:21,0,1,1,真的还好，上课可能比较水，但事也比较少，给分今年不能说好但感觉还可以。
169708,5793,郭喨,2023-02-27 12:58:26,0,4,4,老师还是很好的！！！上课很幽默嘿嘿嘿，感觉有改头换面，还是觉得评价一个老师的好坏不能只看查老师上的评分！
170238,5793,郭喨,2023-03-02 06:32:35,4,5,1,老师上课没有规划\n\n作业全部堆到最后，还要同学催他什么时候交作业，拖拖拉拉才说。布置了小组作业准备了很久，结果一个组都没展示。最后大家交的三个作业应该老师都没时间看（在改考研试卷），就按照期末考试成绩随便打了个分。\n\n上课没啥意思，全让同学们讨论浪费时间。\n\n还要走来走去看同学们在干啥。\n\n快逃吧～
170719,5793,郭喨,2023-03-08 11:41:56,0,4,4,好老师，确实是好老师
170972,5793,郭喨,2023-03-13 12:56:39,7,7,0,新中特总共两个半小时的课，除去小组展示的时间，剩下时间就在那讲之前课堂上其他小组的ppt，把其他同学的ppt的内容从头到尾讲了一遍，就问这跟这课有啥关系？关键讲的还巨差，全是一些浅显和漏洞百出的论断，不能说感受不到他的努力吧，但是就是水平不行，这老师是怎么留在法学院这种极需批判性思维的地方的？
171445,5793,郭喨,2023-04-02 11:22:27,1,2,1,这次会不会也卡绩呢
180336,5793,郭喨,2023-09-21 06:43:45,0,1,1,22年上的老师的课，觉得有点无聊哈哈哈，但是可能这种课就这样子。感觉老师人很好~可以做自己的事情，给分嘛，感觉看运气
188555,5793,郭喨,2024-01-19 08:38:32,2,2,0,本学期上了他的德法课。上课管得不多，六次点名会点满。偶尔会有小组讨论环节的点名回答问题环节。给分上看本人89分，整体给分情况未知。从个人角度上看还是好的。
189094,5793,郭喨,2024-01-22 00:19:28,7,8,1,德法\n\n老师讲课挺幽默的，也会联系实际生活，小组作业会认真给出建议（真的会比我们自己弄格局打开好多）\n\n总体来说事不多，他会规定作业字数上线防止内卷i了i了\n\n给分也还好
189095,5793,郭喨,2024-01-22 00:46:15,-1,5,6,真就给分看运气呗\n\n每节课都到课，作业做得很认真，期末考写满了，3.9。。。？。。。
189099,5793,郭喨,2024-01-22 01:43:35,2,4,2,老师人很好，上课氛围比较轻松，也会经常提一些引人思考或者诙谐有趣的问题。虽然老师喜欢在教室里转悠，但基本上不会管你在做什么。只是至少还是要拿半边耳朵听课，否则被点到回答问题回答不上就有些尴尬了（虽然老师也不追究）。\n\n最后成绩92喜提绩点4.8，不知道整体情况是不是这样。之前看到学长说老师卡绩的，或许老师也在改变，给分慢慢变好了也说不定。\n\n就我个人而言，给老师10分。
189128,5793,郭喨,2024-01-22 05:24:50,1,3,2,老师上课很有意思，听了很受启发，给分还不错
189178,5793,郭喨,2024-01-22 09:14:44,5,5,0,会点名 课水水的 事情不多不少\n\n会给小组研究性学习给出一些建议\n\n给分还可以 可能是因为期末考改成论述题了
189207,5793,郭喨,2024-01-22 10:20:15,4,5,1,点名点得比较勤\n\n虽然是数字但是不一定是在什么时候点\n\n给分还行 没有评论里说得那么吓人\n\n事情比较少 总体来说还行
189217,5793,郭喨,2024-01-22 11:40:30,-3,2,5,垃圾垃圾 卡绩 不负责 屁事多
189303,5793,郭喨,2024-01-23 03:36:00,8,11,3,上了老师的思修课，感觉老师明明值得更高的分数。上课点名很多次，只要按时到问题不大。氛围很好，会讲一些笑话，也会引导思考。事情不是很多，老师会提前和我们协商各种报告的字数，上下限都是同学们说出来的，避免无效内卷。个人来说给分不错，期末写了满满两张A3纸，最后喜提4.8。非常感谢老师！\n\n我印象最深的是，郭老师说志愿服务报告可以不提交照片，也可以不写那么多字，写出自己的感受就好。他是真的想让我们认真参与志愿活动。
189374,5793,郭喨,2024-01-23 13:18:19,2,4,2,本学期拿到的最高绩点，工科生泪目了😭老师特别儒雅特别帅，不多说了必须给老师打十分
190447,5793,郭喨,2024-03-04 11:29:47,2,3,1,给分低
191086,5793,郭喨,2024-04-02 00:18:28,4,6,2,老师改过自新了 给分好
193456,5793,郭喨,2024-06-11 06:30:07,5,5,0,会有数字点名大概3节课差不多点一次？\n\n上课反正就是水水的 没什么事情，可以做自己的事情\n\n给分挺不错的 期末裸考4.8\n\n老师也是那种很和蔼的\n\n小组作业读书报告什么的都很早就公布内容了
193885,5793,郭喨,2024-06-20 12:06:48,-9,4,13,给分巨差
199942,5793,郭喨,2024-10-09 03:13:34,1,3,2,上课上到一半忍不住了来打个2分，几乎没有任何属于自己的思想，最常见的就是ppt放一句马克思读一遍再读一遍边上教条式的解读（比如此时此刻正在放的“一切以天地为目标…”），几乎没有任何逻辑论证和拓展举例，除了一些毫无意义的例子（什么自己去汉江大桥发现一个洞和市政部门反映）。回答问题离不开什么什么“性”，头脑死板的典型，仿佛是“某某性”的奴隶，一旦把事物归类到某一个性之中就获得了肯首和安全再也不用任何论证。可以看出想要让思政课不一样，但他的才华只会弄巧成拙。
202047,5793,郭喨,2024-11-08 15:06:38,3,3,0,在思政课上学不到马克思的任何东西，浅表程度甚至甚于高中政治，学学法律体系差不多了，要学马克思还得自己看著作
205657,5793,郭喨,2024-12-11 02:20:25,6,7,1,郭踉的思政课已经进化到next level了全程AI视频自己像个保安在教室里转来转去巡逻，不如让一位保安为我上课
206426,5793,郭喨,2024-12-15 05:50:26,0,1,1,讲课僵化，事多要求苛刻，消息不回，逃吧
207981,5793,郭喨,2024-12-26 03:24:46,2,2,0,无语啊，在教室里播放AI虚拟老师视频，老师不说话，看得我们一脸蒙，傻坐着啊，
211394,5793,郭喨,2025-01-11 10:18:04,1,1,0,虽然课不是很动听但是也很努力在长进了。\n\n不卡绩，人很好
211484,5793,郭喨,2025-01-11 15:14:36,0,0,0,看了眼期末成绩，感觉平时分给的应该还好。
211516,5793,郭喨,2025-01-12 00:57:37,4,4,0,一学期点名七次且毫无规律（缺勤一次平时分扣三分），上课也比较枯燥，不过老师人还不错，迟到了点名没点上也给补签了，也不会故意为难学生。给分还不错，不缺勤+期末多写点应该可以拿到一个不错的成绩。
211575,5793,郭喨,2025-01-12 02:57:50,-2,0,2,第一节课会讲往届的研究性学习，后面基本是PPT教学。这学期共签到7次，平时分按签到给，最好不要缺勤。期末是开卷论述题，多写就有分。建议要选这节课的同学做好拿不到高绩点的准备。
211587,5793,郭喨,2025-01-12 03:19:23,0,0,0,上课无聊，给分差，一节课没翘，结果总评还没期末成绩高
211611,5793,郭喨,2025-01-12 04:15:30,0,0,0,点名无规律，建议不要逃课，课前课中课后签到都有可能。平时上课当自习课就好了，期末开卷努力抄书，读书报告好好写，给分感觉还可以。
212098,5793,郭喨,2025-01-13 07:30:37,0,0,0,讲案例的时候挺有意思的，就是讲课本内容的时候挺无聊的，一开口就睡着了。线下教学去了良渚博物馆（听室友说他们就在学校逛逛），最后一节课才小组展示，没留够时间。给分中规中矩。
212479,5793,郭喨,2025-01-14 05:10:41,0,0,0,事情不多，给分还行
214656,5793,郭喨,2025-02-16 02:58:17,0,0,0,很难评，老师态度很好，但讲课水平，课程设置和pre的要求上都比较糟糕
215664,5793,郭喨,2025-03-04 00:12:35,1,1,0,老师可能有点严于律己，对教学有点强烈的自我想法并且强加于学生，虽然可能合理但没必要。一共八次课，废话居多，没看出来跟新中特有什么关系，可能是我水平有限，逮着案例研究一絮叨就是几周，追求事少拿分的尽量不要选
217196,5793,郭喨,2025-04-03 17:49:16,0,0,0,没有灵魂的书呆子
220844,5793,郭喨,2025-06-20 05:54:33,4,4,0,出生老师，AI安全与伦理课，一门计算机学生的必修课，道德伦理就占40%还能被这个牲口一个论文分拉差40多分，直接 5.0 干到 3.6，评分细则不公示，问就是装死，邮件不回，完全不是人
220863,5793,郭喨,2025-06-20 07:35:22,5,5,0,神人一个，任何人都不应该以任何理由选择这位我都不知道该不该叫老师的人开出的任何课\n\n就25年春夏此人的人工智能安全与伦理课程来讲：\n\n此人的课完全是在扯淡，上课内容空无一物，讨论的问题听着更像是物理学院门口贴海报的民科，面对着人工智能的学生，大谈着错误的人工智能的错误理论，希望马院的教学科好好看看此人的智云，决定一下是不是合适当一个老师再让他继续开课，而讨论的内容就是往群内发一篇“郭老师”自己写的百家号文章，让我们阅读后给出自己的观点。\n\n此外，此课程伦理部分的论文占据40%的分数，由于安全部分的论文同一个小组内论文分数是相同的，因此差距只能来自伦理部分的论文，而同一个小组内竟然出现了11/40的分差（也就是说，a拿到36分的论文分数，而b只拿了25分，直接扣除了15分的总评），询问助教，给出的答复如下：“是由于系统中显示的格式错乱，形成的文稿不全，内容和参考格式混乱，才形成了低分”，竟然是pdf格式错乱了？？你听听这说的还是中文吗，我们堂堂图灵班的学生，学计算机好歹也学了整整3年了，拿markdown， typst， latex代码导出的pdf居然你告诉我能乱码，真的颠覆了我这么多年对计算机的理解，那如果pdf会乱码我们还导出交pdf干啥？？拿bib导出的参考文献你告诉我格式错误？？那我们这些顶会的参考文献引用用的bib也全都是笑话呗？？在一再的追问和向助教询问到底哪里乱码了，哪里混乱了之后，助教表示：“那个乱码不是乱码，内容缺失也没有内容缺失”，这句话具体是不是中文，应不应该是中文，我们不得而知\n\n此外，仅有助教进行了回复，郭“老师”由于“有事”直到“25号”才能“联系上”，我们理解是说此人大概是去高考判卷或者中考出卷了，期待后续...
221872,5793,郭喨,2025-06-27 04:12:31,0,0,0,给分很一般，有种不太在意学生的感觉
134767,5872,黄韬,2021-04-14 09:34:14,-67,11,78,在法学院三年以来见过最能拖堂的老师，每节课必拖堂10分钟以上，上课也多次迟到，整个人随意至极，不知道为什么会有这么没有时间观念的老师。上课内容水且空洞，语气词过多，还有不通知时间的临时小测，很无语。金融法课程慎选。
135073,5872,黄韬,2021-04-29 06:39:43,19,23,4,上课其实挺好的 速度不快 很适合小白入门金融法知识 相关重点也都讲得很透彻~小测和考试都是老师上课讲的东西 认真记笔记即可~给分也很nice~很可爱很有趣的老师~
135079,5872,黄韬,2021-04-29 08:38:04,27,33,6,老师特别好说话，平易近人，金融法上课好好听还是有干货的，给分也不错子～
135463,5872,黄韬,2021-05-11 03:45:24,15,20,5,黄老师幽默风趣，平易近人，上课内容非常有思想深度，而且只要认真学了，得分一定会非常不错的！yyds！
135464,5872,黄韬,2021-05-11 03:58:08,8,14,6,认真负责和蔼
135465,5872,黄韬,2021-05-11 04:05:05,11,15,4,黄老师讲课很生动，教学态度非常端正，是大学期间接触的老师中少有的不会让同学们上课犯困的老师。黄老师好就好在同学们有任何课程上或者课程外的问题，老师都会尽心解答。而且接触多了会发现黄老师是一个非常幽默有趣的人，强推！
135469,5872,黄韬,2021-05-11 04:26:49,11,15,4,金融法，会有两次随堂小测，但是老师人很好，还可以补交。内容也是由浅入深，是很好的金融法启蒙课。评论区那位高踩回答也太不负责任了哈
140227,5872,黄韬,2021-09-06 04:38:17,6,10,4,可以 很不错
140444,5872,黄韬,2021-09-11 21:10:48,7,11,4,亦师亦友，亦庄亦谐
151032,5872,黄韬,2022-02-22 05:45:52,7,12,5,感觉很不错！
161283,5872,黄韬,2022-11-03 12:22:10,10,14,4,大学最喜欢的老师之一
162484,5872,黄韬,2022-11-23 07:29:32,-11,5,16,。。。。。。
176816,5872,黄韬,2023-06-30 08:44:23,10,13,3,老师上课挺好的，划重点更是一绝，给分也好！！！感恩黄老师！！！
177492,5872,黄韬,2023-07-03 12:32:52,9,12,3,老师侧重于对于经济法理论思维的讲解，而不局限于法条，开拓了视野，很喜欢黄韬老师
177684,5872,黄韬,2023-07-04 08:29:14,12,16,4,老师讲的很好！很有意思，对思维的帮助很大！而且不鼓励卷，学弟学妹快冲！！ps考前划重点全都考了，给分也很好
180556,5872,黄韬,2023-09-22 23:13:10,-1,2,3,语速比较快，有点硬核
184233,5872,黄韬,2023-12-13 12:54:36,4,7,3,老师上课深入浅出，上课风格也比较有趣，介绍的知识不仅是书本上的，更是联系我国证券市场和银行业的实际以佐观点。黄副教授本人也颇具知识人情怀，自己运营的公众号的文章不仅有硬核的金融法文章，还有自己的随笔评论，以法律人的眼光看社会。
184369,5872,黄韬,2023-12-18 10:03:31,3,8,5,光华法学院最好的老师没有之一，见到老师的课速冲！！
193228,5872,黄韬,2024-06-04 17:20:59,1,9,8,挺和蔼的\n\n教科书式的右派，自由市场的拥护者，某些观点有点像古墓派经济学家，比如说拉美经济不行是因为左翼思潮泛滥（我也是醉了，咋不问问人家的左翼思潮哪来的，天上掉下来的吗），政府加强监管检测蛋白质含量，所以三鹿奶粉造假\n\n总的来说经济法名不副实，改名法律经济学比较好
193769,5872,黄韬,2024-06-17 19:53:09,-6,4,10,经济法介绍经济相关的比较多\n\n问题是感觉不出来经济学水平有多高。。法律经济学本来也早被经济学主流抛弃了
196822,5872,黄韬,2024-07-05 10:19:01,6,10,4,经济法：老师上课不点名，有期中作业，期末考试是真的划重点（划什么就考什么），一点不考非重点，背的东西不算多，给分也不错
197254,5872,黄韬,2024-07-10 02:33:57,1,4,3,老师很好！
199008,5872,黄韬,2024-09-14 02:48:29,2,5,3,韬子神中神！对学生很好很尊重 呜呜
205407,5872,黄韬,2024-12-06 02:18:45,-3,6,9,罗里吧嗦废话太多，没有感觉多少好多少干货，比较水
127872,5887,牟绿叶,2020-11-29 12:53:48,37,42,5,老师真的好帅啊，声音好好听
131217,5887,牟绿叶,2021-01-26 14:32:08,18,18,0,点名提前会告知\n\n讲课很好\n\n老师真的很帅\n\n超温柔！
132149,5887,牟绿叶,2021-01-30 14:01:41,7,8,1,本科最喜欢的老师！没有之一
133186,5887,牟绿叶,2021-02-15 06:28:14,7,7,0,特别好
134219,5887,牟绿叶,2021-03-19 14:26:13,3,3,0,好喜欢老师o(^o^)o
134537,5887,牟绿叶,2021-04-01 00:58:39,4,4,0,男神！
134649,5887,牟绿叶,2021-04-07 13:40:45,3,3,0,不错！好温柔的老师！讲的也清楚！
134747,5887,牟绿叶,2021-04-13 07:57:14,13,13,0,我特别讨厌刑诉，但是我爱牟绿叶😭
134830,5887,牟绿叶,2021-04-17 11:31:22,10,10,0,又帅又温柔给分又好，老师学术能力还特别强，简直yyds，我是永远的叶绿素！
135021,5887,牟绿叶,2021-04-27 08:22:22,5,5,0,想嫁(*/ω＼*)
135065,5887,牟绿叶,2021-04-28 15:35:57,5,5,0,爱老师
135893,5887,牟绿叶,2021-06-01 07:35:35,7,7,0,好想嫁
138065,5887,牟绿叶,2021-07-07 08:40:52,5,5,0,老师好帅，我好爱，想嫁（我是男生也想）上课好，温柔，给分好
139467,5887,牟绿叶,2021-07-16 08:14:43,0,1,1,吹爆绿叶大帅哥！！！！！
139483,5887,牟绿叶,2021-07-16 10:56:19,2,2,0,期末好好背一定能高分的
139879,5887,牟绿叶,2021-08-07 15:51:44,0,1,1,牟老师太棒了，羽毛球也打得超级好！
139885,5887,牟绿叶,2021-08-09 07:00:27,1,1,0,好喜欢😭😭😭😭😭😭😭
142246,5887,牟绿叶,2021-11-09 08:33:57,2,2,0,这还不10吗
145447,5887,牟绿叶,2021-12-29 15:45:07,3,3,0,我宣布绿叶是我男神，谁支持谁反对
150642,5887,牟绿叶,2022-02-08 01:58:20,0,1,1,班主任!特别喜欢的老师!完美
151126,5887,牟绿叶,2022-02-23 09:13:27,3,4,1,讲的太好了 输出量很大 知识渊博 真的爱了
152062,5887,牟绿叶,2022-03-24 11:35:40,0,1,1,喜欢！
154282,5887,牟绿叶,2022-05-28 08:06:17,1,1,0,老师真的太好了😿 ，上他的课就是很有收获，事儿也少，人也温柔
155090,5887,牟绿叶,2022-06-08 07:04:27,4,4,0,在被期末摧残的时候特别怀念春学期的刑诉课，来给牟老师评个分。不得不说，上牟老师的刑诉课是种享受，讲课方式是春风化雨般的，讲课内容也很丰富。性格也非常nice~虽然脸盲的我经常把老师跟一个博士师兄认错，但也可能说明牟老师心态好，显年轻~打满分~~
155426,5887,牟绿叶,2022-06-12 14:20:27,4,4,0,法学院最好最好的人之一！！
155642,5887,牟绿叶,2022-06-15 02:51:43,27,27,0,晚上要考了，现在来有感而发。\n\n绿叶真的好温柔又强大，和老师交流如沐春风，细小琐碎的刑诉知识也就好像春风化雨般流入心中（虽然不知道我记住了多少orz。\n\n我觉得法学院的老师很多都有很明显的自己的气质，人如其名，绿叶就像南方小城的春风，谷神就像巍峨厚重的高山深谷，周院（和他的PPT）则像大海一样宽广慈悲（多）……不论成绩如何，非常感谢这一路有这么多可爱的老师们陪我们走来，希望大家都生活愉快，一切顺利。
155911,5887,牟绿叶,2022-06-16 13:48:42,1,1,0,完美老师
158596,5887,牟绿叶,2022-06-30 13:36:51,11,11,0,绿叶就是男菩萨！！！！！想嫁！！！！！
158606,5887,牟绿叶,2022-06-30 15:46:48,7,7,0,男菩萨！！\n\n讲课真的讲得很好，课件做的也很好\n\n辅修线上班。因为没法点名就写了500－800的小论文当做30％平时成绩。\n\n复习的时候按照重点使劲背，因为涉及到程序就自己顺了好几遍\n\n期末考试个人觉得难，考完感觉天塌地陷，生怕挂科\n\n看到成绩之后只想大喊，牟老师，你是我的神
158608,5887,牟绿叶,2022-06-30 15:52:20,3,3,0,我爱绿叶老师！！！讲课特别清楚、强调重点、助力复习，好好学给分都超好的！完完全全的付出多少就能得到多少的刑诉！
159140,5887,牟绿叶,2022-07-06 16:12:47,-60,13,73,给分高就一顿吹捧，这舔分的模样真难看啊。一心只想要个好绩点，给高绩点就是你爸爸了啊
170374,5887,牟绿叶,2023-03-03 08:16:34,1,1,0,超喜欢牟老师！！
171198,5887,牟绿叶,2023-03-18 05:41:33,1,1,0,不多说
171915,5887,牟绿叶,2023-04-12 12:24:01,3,3,0,特别特别有人格魅力的一个老师
172263,5887,牟绿叶,2023-04-24 03:19:07,0,0,0,好老师！！！
172508,5887,牟绿叶,2023-04-28 06:17:26,2,2,0,牟老师温文尔雅，讲课的难度深度也很会从学生们的角度出发，毕设开题也有幸受到绿叶老师的悉心指导，非常喜欢他！
173311,5887,牟绿叶,2023-05-18 09:01:00,18,18,0,老师好\n\n我好爱\n\n想嫁\n\n我是男生\n\n上课好\n\n温柔\n\n给分好
174236,5887,牟绿叶,2023-06-08 05:13:45,9,9,0,好喜欢绿叶，人的一生就是反复爱上绿叶的一生
175720,5887,牟绿叶,2023-06-26 10:06:35,1,2,1,老师人超好～
177946,5887,牟绿叶,2023-07-05 16:33:15,4,5,1,好老师快选
216346,5887,牟绿叶,2025-03-14 01:03:07,13,15,2,不知道是老师要鼓励恶竞还是比刑的课上有些人已经疯了呢（笑）
216370,5887,牟绿叶,2025-03-14 12:55:03,11,13,2,牟老师有学识也很善良，但有些人是不是滥用了老师的善良，视规则于无物，破坏良好的课程交流与竞争环境呢～
216438,5887,牟绿叶,2025-03-16 13:25:03,0,5,5,我觉得老师您开学自己制定的规则，就要贯彻落实，如果有人破坏规则，至少制止一下吧？
217305,5887,牟绿叶,2025-04-08 06:24:59,2,2,0,re楼下 比刑发生什么了
217465,5887,牟绿叶,2025-04-11 00:40:58,4,4,0,老师真的人很好很善良很温柔很温良很有学识也很谦虚TTTTTTTTTTTTTT我要哭了哦不他真的是很好的老师TTTTT虽然还没有出分但是还是来怒打满分TTTTT老师真的很好呜呜呜呜呜呜特别善良的一位特别和颜悦色特别善解人意.....老师人好到因为有事没去一节课会特别愧疚啊啊啊啊啊.... 最后一节课老师还给发了巧克力....绿叶酱我们真的要爱你一辈子了TTTTT
135566,6112,何香柏,2021-05-14 09:53:59,3,9,6,老师人很好
142323,6112,何香柏,2021-11-10 07:18:17,9,11,2,何老师人很好，对学生负责，愿意和学生交流。
150784,6112,何香柏,2022-02-18 13:22:25,2,4,2,法硕学生评价：\n\n说实话，我第一次上课就很喜欢何老师，认真、严谨、有逻辑、有梦想；\n\n当老师告诉我们要好好珍惜在校时光时，我深感认同；\n\n老师教环境法，讲得很细很全面，实务经验也比较丰富，写论文做研究都很认真，是一个很务实又很有情怀的人。\n\n考试开卷考试，题目很多很多，但基本上都是小问组成，是老师讲过的内容，如果上课认真听了，基本上都能回答出。最关键的是，老师说我是教环境法的，看到你们到了期末时打出厚厚的考试资料，我真的很心疼，所以我的考试可以带电脑（和其他电子产品），当然手机不让用。刚开始，我想会不会有人作弊呢？据我所知，应该是没有的，因为题目真的很多，如果你想抄别人的，身边的人也没有时间向你提供答案，大家都拼了命地认真答题。\n\n何老师是之江的“环境卫士”，是环境法的独苗，很喜欢她的认真，给老师点赞~~
153095,6112,何香柏,2022-04-25 11:24:44,0,2,2,是个好老师
153640,6112,何香柏,2022-05-07 01:14:50,3,5,2,学术功底深厚+有情怀，好老师！
159281,6112,何香柏,2022-07-10 15:00:44,0,2,2,很好的姐姐
178771,6112,何香柏,2023-07-22 14:26:24,0,1,1,也就那样吧
181873,6112,何香柏,2023-11-03 03:06:38,11,11,0,“平时分啊，这个也不用太担心。我自己的想法是说，如果学生来得少，就只有老师的问题，肯定是老师讲得不够好。如果老师讲得足够好，那学生肯定都会来啊。”\n\n\n\n“所以我自己是什么想法呢？其实学习是自由的。到了大学里面，尽量不要为了考试去感到恐惧，或者有压力什么的。”\n\n\n\n“命运本身就有一种很强的不确定性，其实有很多的事情，有更多更重要的事情是需要我们更在意的。在人生的历史长河中，环境法的考试的分数或者民法的考试分数真的是非常微不足道的事情啊。”
190246,6112,何香柏,2024-02-26 11:50:02,1,2,1,大绩杀
192168,6112,何香柏,2024-05-10 13:59:13,3,3,0,是很真诚的好老师，会永远记得老师的寄语“保守你的心胜过保守一切”
216367,6112,何香柏,2025-03-14 12:59:18,0,0,0,老师人很好，讲课有理有据且会带动大家一起思考，很真诚的老师。
218723,6112,何香柏,2025-04-29 13:39:58,0,0,0,绩杀了，，大三没惹
219073,6112,何香柏,2025-05-20 16:02:34,0,0,0,老师讲课很好，平时认真听课，最后好好复习，考试范围莫出其外，甚至都是老师上课时重点强调过的部分比如环评制度等，因此是能拿到高分的；非常典型的一分耕耘一分收获的课，有付出就有回报，在大三阶段如果想要提绩点或者百分制成绩都是性价比挺高的；而且老师很有人格魅力的，会带着我们思考问题，我每节课都去了教室所以被提问了两次，虽然我不爱主动回答问题但是也觉得课堂上的思考和提问很有趣且没有压力（毕竟不和考核挂钩）；综上，老师的环境资源法很值得上
124012,6142,焦宝乾,2020-06-20 07:46:07,0,2,2,老师挺可爱的
127097,6142,焦宝乾,2020-11-07 03:06:46,0,4,4,有幸上了焦老师半天课，实在是不知所云。跑到隔壁去上夏老师的法理课，夏老师每次上课虽然内容不多，但是真的是基于一个知识点在拓展。夏老师的课，你能感受到正义、自由、平等这些价值取向之间的冲突。\n\n\n\n我去，但是焦老师在讲的东西，真的是莫名其妙。全程在扯《法律方法论》（虽说，法律方法论是从法理学当中衍生出来的。可这个已经独立成一门课了呀）既然这么喜欢说法律方法论，为什么不去开课法律方法论呢？\n\n\n\n说了这些槽点，焦老师人还是不错的，和气。做朋友相处应该不错，但是作为老师，那还真的差蛮多的。\n\n
130379,6142,焦宝乾,2021-01-21 13:17:30,4,7,3,老师对学生很用心，也很和蔼亲切
131852,6142,焦宝乾,2021-01-29 06:31:27,0,1,1,法理学均绩还可以
152779,6142,焦宝乾,2022-04-19 14:30:48,1,2,1,满了谢谢老师，课件多看看还是能学到东西的，要自己结合案例多思考
152805,6142,焦宝乾,2022-04-20 04:30:08,0,2,2,老师好好上课认真听能学到挺多东西的，而且事少分多，出成绩也快，我好爱！！！
154390,6142,焦宝乾,2022-05-31 12:54:15,2,3,1,因为面向非法学院的缘故课程内容有些浅显，但把法理学的知识梗概讲得很清楚。
155372,6142,焦宝乾,2022-06-11 17:53:34,0,2,2,老师很好 事情算少 给分还行 推荐滴
155373,6142,焦宝乾,2022-06-12 01:06:16,-1,1,2,焦老师蛮和蔼的也很幽默，会换着花样查到课情况。焦老师上课我会觉得有一点听不懂其中的逻辑，但课堂中会有很多法律上的例子，课后也会有很多的课外阅读材料，总的说来还是蛮认真负责的。我是属于课上一边听课一边干自己事情的那种，考核基本就是一篇论文和全开卷期末考。我最后的论文写的挺认真的，也从头到尾认真读了法理学著作。课堂发言虽然有加分，但实际上我没发过言。期末考前疯狂补天和自己整理了一个word文档重点方便考试时查找，经过考试老师狂捞，最后的绩点挺好的，感谢焦老师！！！
155375,6142,焦宝乾,2022-06-12 01:29:13,0,2,2,很可爱的老师，事情也不多，很认真写了读书报告，考试以为会很差，但出乎意料的绩点还不错。
155481,6142,焦宝乾,2022-06-13 11:26:27,0,2,2,有学识，有情怀
174907,6142,焦宝乾,2023-06-19 13:33:28,2,3,1,焦老师案例给的很多很具体，平时上课的内容很全面，知识也都在ppt里啦，框架是很清晰的。焦老师为人很好相处，对待学生也十分关爱与理解，给分也很好，十分！
179655,6142,焦宝乾,2023-09-19 06:05:05,4,5,1,只要你稍微认真一点然后上课不缺课给分真的很好考试完全开卷
183835,6142,焦宝乾,2023-12-01 02:38:34,2,2,0,会有点名但老师人真的好，读书报告认真写，最后期末考试是开卷的，可以带手机电脑的那种，给分也真的好
185789,6142,焦宝乾,2024-01-04 11:43:39,3,3,0,老师是真的关心学生
191529,6142,焦宝乾,2024-04-24 10:32:02,2,2,0,事少分高
217607,6142,焦宝乾,2025-04-14 05:12:38,1,3,2,只能说慎选
129309,6161,霍海红,2021-01-04 04:54:58,13,13,0,霍老师普通话贼好哈哈哈哈
133151,6161,霍海红,2021-02-10 12:15:01,15,15,0,老师给分也太好了吧 菜鸡落泪了
133712,6161,霍海红,2021-03-04 06:02:31,4,6,2,课件超细致有逻辑，讲课很有活力！一开始以为是刻板高中教法，但是学下来发现，把无聊枯燥的民诉理得也太好了。不点名，划水课程感受，期末纯记忆选择题部分不大，主要考法条变动。一定要好好记笔记，给分很和谐！
140363,6161,霍海红,2021-09-10 05:13:48,25,27,2,老师是民诉大佬，从吉大挖过来的，学术能力很强（从发文章数量上就能看出来），在学界声誉和地位都颇高。到浙大一年多以来带来了好多好多的讲座，都是霍老师邀请来的，学弟学妹们都可以多多参与讲座。\n\n民诉课堂上老师讲的很全面，深入和基础的都有，值得一选，给分也很棒。
143858,6161,霍海红,2021-12-09 05:25:45,-1,0,1,(⁎⁍̴̛ᴗ⁍̴̛⁎)
144996,6161,霍海红,2021-12-26 10:36:33,157,160,3,突然发现一个很有趣的事情，“海红”的反义词是“陆青”
146828,6161,霍海红,2022-01-26 16:56:08,3,4,1,好老师讲课非常好 平时作业是一篇1000字小论文 考试内容死记硬背部分不多 虽然给分不如我的预期 但还是推荐大家选他～
146927,6161,霍海红,2022-01-08 05:23:09,1,2,1,考前来打一个10分
147160,6161,霍海红,2022-01-09 02:43:40,5,7,2,老师，太细了，真的考太细了，不是说有案例的吗
150431,6161,霍海红,2022-01-25 06:26:54,-7,8,15,给分非常非常差
150443,6161,霍海红,2022-01-25 09:30:14,3,7,4,老师，你听到我的心碎声了吗💔
150477,6161,霍海红,2022-01-26 05:32:31,1,3,2,给分非常非常好
150510,6161,霍海红,2022-01-28 02:18:56,-4,0,4,老师上课真的没话说，讲的很棒，上课一定要认真听，有些理解性的内容可以记下笔记，考试偏理解，光死记硬背ppt是没有什么用的。给分不如预期，可能是我的小论文写的比较着急或者考试大题写的还不够全面吧。
150511,6161,霍海红,2022-01-28 02:16:27,3,4,1,老师上课真的没话说，讲的很棒，上课一定要认真听，有些理解性的内容可以记下笔记，考试偏理解，光死记硬背ppt是没有什么用的。给分不如预期，可能是我的小论文写的比较着急或者考试大题写的还不够全面吧。
152663,6161,霍海红,2022-04-17 18:02:03,18,19,1,民诉期末考有不定项选择、法条评述、论述题。不定项选择考民诉法的理解与适用，管辖部分需要自己自学（听法考就好，纯记忆的内容）。法条评述最好有框架，比如从立法原因、司法实践、法条评价等角度分别作答，然后需要结合上课他反复强调的理解处（包含一些比较法理论，如果一次听不懂可以听智云）。最后的论述题，尽可能多答多角度吧。
154053,6161,霍海红,2022-05-21 07:31:52,2,3,1,哦的克哦的克霍老师太好了，上他的课就是一种享受，每学期我都能选到一两门“只要想到一会儿要去上ta的课就很开心”的课程，那个秋冬学期霍老师的民诉就是这样子!!!太丝滑太美妙了！
155359,6161,霍海红,2022-06-11 13:39:41,1,2,1,平时没怎么听课，期末补智云才发现霍老师的课逻辑性、说理性都十分地强，学弟学妹们认真听！
160748,6161,霍海红,2022-10-09 08:46:25,1,2,1,谦谦君子
160898,6161,霍海红,2022-10-19 01:36:50,3,4,1,老师是研究生期间的最爱～上课逻辑与内容兼具，谦谦君子
166795,6161,霍海红,2023-01-13 15:21:53,20,21,1,没听过老师的课，但为法学院带来的改变有目共睹；另外，老师是个特别实在的人。
169661,6161,霍海红,2023-02-27 09:38:09,0,2,2,认真听课，考试好好写，最后不会差
171029,6161,霍海红,2023-03-14 11:20:56,4,5,1,霍老师的民诉考试重视制度背后的学理，看法考书可以说是完全没用的，不如上课一字一句把老师讲的记下来，只要能做到这样4.5不会少
171750,6161,霍海红,2023-04-04 02:59:51,0,2,2,狠狠爱了！！条理清晰，逻辑自洽，语言流畅！！！！没有口音！！
175580,6161,霍海红,2023-06-25 15:13:47,0,0,0,...
182211,6161,霍海红,2023-11-12 16:06:55,11,11,0,证据法全是干货，条理清晰，论述充分，不点名，最后只有一篇两千字案例分析。老师行政做得好，人也随性，不争不抢
186123,6161,霍海红,2024-01-08 16:52:50,9,10,1,霍老师人缘也太好了吧，邀请了好多大牛开讲座
197107,6161,霍海红,2024-07-07 18:13:13,5,7,2,老师讲课真的很好，最后考试觉得也还好但为什么给分这么低啊
197611,6161,霍海红,2024-07-22 03:26:32,2,2,0,老师上课很好！一学期下来也学到不少，就是考试闭卷背诵压力有点大。老师人也很好，令人如沐春风。给分不做评价，中规中矩吧。
204757,6161,霍海红,2024-11-27 15:55:52,21,21,0,霍老师19年来浙大以后，尽管经历特殊三年，但仍坚持办院内活动，增进院内青年老师交流。放开以后，山上除了几个学科点办的零星活动，讲座论坛霍老师办的占八九成，而且以民诉为主题的很少，基本覆盖各个部门法，编辑也来的不少，学生不仅受益，老师受益的也不少。\n\n当然了，办活动要钱，大家可以夸浙大豪气，但问题是原来也有钱，为什么不办活动呢？\n\n归根结底，办活动除了要学院的钱，还要组织者自己的时间、精力和钱。嘉宾来了不是就参个会，前前后后都要花费时间精力，再加上酒钱自付，除嘉宾酒店住宿吃饭以外的开销都要自掏腰包。各位，稍微参与过学术活动的都知道，不是动动嘴使唤人就能组织个会的。\n\n别的不说，单就自我付出组织活动这一项，这就是一位值得尊敬的老师。\n\n扪心自问，等我们到了这个地步，还能弯下腰来操劳，发公心做那么多考核外的事情吗？\n\n别人不知道，我大概率做不到。\n\n山上一个老人说几句真心话。
205873,6161,霍海红,2024-12-12 11:44:05,2,2,0,好老师，人真的很好
208590,6161,霍海红,2024-12-29 16:52:48,3,4,1,体谅学生的好老师。本来说法硕学习成绩差要点名的，后来又没有真的点。除了他只有谷神能叫到大牛开讲座了，法学院人脉担当。讲课也很好，不仅仅是民诉，对于整个法学体系都会有很大帮助。这样的老师多了法学院就有希望了。
217672,6161,霍海红,2025-04-15 04:25:36,2,2,0,感觉霍老师的民诉课程堪称规范与法理结合的典范，真的是深入浅出，对之后民诉的进一步学习大有益处，而且hhh老师人是真的好，太爱老师了！！
121903,6178,石一峰,2020-01-23 10:08:53,75,104,29,yfgg这么有趣，不给高分没天理
124190,6178,石一峰,2020-06-26 17:48:57,69,95,26,出分前评一波，怕自己出分后失去理智。老师真的太好了，ppt细到几乎不用做笔记，为数不多的大段大段打字给你答疑的老师（目前法学院我知道会这样做的老师只有他），最后因为网卡了卷子没交上去，还专门私戳提醒我55555555最后一次答疑，本来是周老师的工作，yfgg居然也出现了55555yfgg太好了真的
124254,6178,石一峰,2020-06-28 05:27:31,63,88,25,yfgg真的太努力了ppt可以看出来十分十分用心在备课（作为学生真的会很感动）！而且专门开设课后答疑，特别耐心地回答大家的问题。给分也很棒！！还会继续上yfgg的课的~~
124304,6178,石一峰,2020-06-29 03:23:13,67,97,30,其实，石一峰老师，是我最爱的老师，\n\n我并不喜欢民法那堆老师，他们自视甚高，乌烟瘴气。\n\n一峰的物权细致入微，稳；商法只要听着他的声音就高兴。\n\n最爱的老师，像个温柔的雄狮（监考时候）；私下问问题认真温柔，是在难以言尽的浙大法学院的白月光。
124913,6178,石一峰,2020-07-19 23:12:38,54,81,27,水平很高
132656,6178,石一峰,2021-02-03 07:05:13,34,58,24,最后一节课只来了15个人左右老师也没有生气……真的很温柔了！一学期的破产法很认真用心！爱老师❤️
134308,6178,石一峰,2021-03-23 06:52:17,23,46,23,认真负责
134573,6178,石一峰,2021-04-02 10:28:33,31,56,25,石老师的破产法真的讲的很好很有深度，能感受到商法的那种极强的技术性和interest balance，学弟学妹们真的要好好珍惜，虽然老师声音有点平，但是输出的都是你在司法考试复习等应试上根本不可能学到的，实务中却可能用上的东西。很多同学在后排不听课翘课真的太可惜了！珍惜这样的老师！浙大好的商法老师真的不多！
139646,6178,石一峰,2021-07-19 05:09:15,19,40,21,一峰哥哥像一头温柔的雄狮，个头很高，但说话轻声细语😂讲课飞快，很多时事前沿还没想明白就讲过去了。商总讲到最后就记得六个维度了23333
143551,6178,石一峰,2021-11-26 11:10:28,10,28,18,一峰哥哥超帅！！！
154560,6178,石一峰,2022-06-02 06:35:55,19,26,7,经济新闻
155039,6178,石一峰,2022-06-07 18:13:57,1,19,18,yfgg超可爱🥰
155451,6178,石一峰,2022-06-13 04:40:46,26,38,12,请问大家商法总论与公司法考啥，如何复习啊，搜不到资源啊啊啊啊
156969,6178,石一峰,2022-06-21 12:49:01,4,21,17,ppt真的太细致了，讲的也很好，学术水平绝了，人还温柔，10分！
161668,6178,石一峰,2022-11-10 07:42:20,-2,20,22,老师真的很帅很有气质，就算不点名，爬我也要爬到教室上课，看着就赏心悦目，能多吃两碗饭。最后还会给同学们答疑，真的很nice。
171518,6178,石一峰,2023-03-27 08:21:31,-7,15,22,yfggyyds！ “温柔的雄狮”，平和而深刻，儒雅而有力量
173103,6178,石一峰,2023-05-13 12:09:18,12,25,13,明里暗里歧视双非本科…
174353,6178,石一峰,2023-06-10 10:15:50,16,26,10,语调好平…
175067,6178,石一峰,2023-06-21 10:47:07,-8,15,23,老师法律解释的水平很高，以案释法的能力极强，制作的课件丝毫不比教材差，期待有一天能汇总出版
175190,6178,石一峰,2023-06-22 08:36:52,6,16,10,老师很用心，就是我不知道怎么分析案例啊啊啊啊，感觉上课是哲学，复习阶段好痛苦，没有头绪
177132,6178,石一峰,2023-07-02 01:04:24,18,34,16,过于神化，实则一般
177725,6178,石一峰,2023-07-15 05:30:37,20,31,11,很一般
178104,6178,石一峰,2023-07-11 02:45:18,16,29,13,先远离民法，又远离了商法
178446,6178,石一峰,2023-07-12 00:58:40,16,29,13,浙大缺商法
178757,6178,石一峰,2023-07-23 13:20:20,11,24,13,上课人少也没事，真的是负责好老师？上课很一般
178835,6178,石一峰,2023-07-24 22:57:21,15,26,11,催眠效果贼好
178870,6178,石一峰,2023-07-27 01:22:23,11,23,12,如听一席话~
191004,6178,石一峰,2024-03-28 01:05:58,3,4,1,很可爱很可敬的yfgg，
193301,6178,石一峰,2024-06-06 04:30:21,8,10,2,你很好，但是我真的听不懂商法，jt老师的课我都能听懂，真的不懂你
194607,6178,石一峰,2024-06-24 14:31:17,8,9,1,上课听不懂，PPT够多，复习不完，只能带法条真的太痛了
196493,6178,石一峰,2024-07-03 18:40:13,16,17,1,讲课糊给分也不善良，服了
196650,6178,石一峰,2024-07-04 13:46:06,13,14,1,考试题出得很偏而且给分非常非常非常不好（我真的很认真的学了来着，看了一遍法考课 自己把ppt从头到尾过了一遍 还做思维导图 结果出分人都傻了）
196819,6178,石一峰,2024-07-05 10:08:06,10,11,1,给分也太差了。。。
196821,6178,石一峰,2024-07-05 10:17:34,7,9,2,商法与公司法：老师不点名，上课节奏比较慢，爱拖堂（有时都快半小时）。PPT很详细，但是期末只能带法条，而且并没有过多案例分析的知识点（但期末考试完全是案例分析）\n\n这一届老师给分好像比往届要差一些，期末考试建议看看前几年考察的知识点（可以在法条上做折角），老师貌似连续几年考过同一个知识点。
197012,6178,石一峰,2024-07-06 15:27:46,13,14,1,想知道今年的平均给分状况到底是怎么样的，更想知道两个班会不会统一一下给分比例。。。
197183,6178,石一峰,2024-07-09 00:58:56,25,28,3,隔壁班分数出了，隔壁班给分很好。\n\n这次大家这么难过，绝不仅仅是因为一个分数。行诉zjs给分也很狠，但大家为什么没有说人家？因为行诉课堂的体验感很好，zjs讲课很好，zyf讲课很好。\n\n而石老师呢？别说zjs了，连隔壁zg、zc都完全比不上。\n\n平时任务上呢？隔壁班没有平时任务，行诉zjs只有一份期中作业，石老师需要问题清单、法条整理以及上课问答。\n\n结果给分，远远不及隔壁班。你跟我来说我们也就会这么多啊拿这么多分是正常的，那我隔壁班的朋友们很多出来胆战心惊懵懵懂懂，结果呢？你平时上课差大家听课痛苦还学不到啥，期末又狠狠杀一顿，怪我们只会这么多？隔壁班人家教的好学的多，还海底捞呢。\n\n石老师说不要在意成绩，但是成绩确实是我们现阶段最在意甚至是一定程度上最重要乃至关系我们未来的，石老师是真的不把我们的命当命啊，这下我们班人均要比隔壁班少多少分？\n\n但凡你上课好，你任务多给分差我们也不至于如此；或者你上课、平时任务、给分至少有一个可取之处，我们也不至于如此。
197557,6178,石一峰,2024-07-19 02:06:53,15,16,1,事情极多，要求也很多，小组作业，提问完全没有固定时间，做不到守约，h助教也很事儿，ppt每次几百页，考试只能带法条，考前说是只能带有非常少量批注的法条，结果考前一两个小时又说大家如果没有简洁版法条，评注版也可以，把其他根据要求买简洁版法条同学的利益放到哪里了？除此之外，考核方式让大家提意见，结果大家反馈意见，然后没有一条采纳的，“随机是社会的本质”原话，把我们的很多命运就确定下来了😏
208507,6178,石一峰,2024-12-30 07:19:57,-1,1,2,石老师确实人很好。不过确实有点迷糊，很多事情规定了然后又虎头蛇尾，是一个超级随性的人。
213864,6178,石一峰,2025-01-20 14:24:34,3,3,0,物权不知道是石老师还是ly老师给的分，给分不好
213978,6178,石一峰,2025-01-22 10:11:36,1,1,0,快跑物权给分真的很差 认认真真一学期结果爆拉均绩0.4 查老师的均绩是真的快跑吧
215335,6178,石一峰,2025-02-25 07:43:07,4,4,0,真是困啊，他讲课真的有逻辑么。。。可能是我水平太低了吧
215692,6178,石一峰,2025-03-04 07:07:36,2,2,0,讲课没有逻辑，只是一味列法条。总之想听课的学妹学弟们快跑。
216442,6178,石一峰,2025-03-16 14:12:00,2,2,0,yfgg我求你这学期期末和隔壁班一起调一下分 拜托~
159135,6400,张晓晗,2022-07-07 16:47:22,0,3,3,。。。
159136,6400,张晓晗,2022-07-08 02:41:19,13,14,1,实力和教育背景不匹配啊
159360,6400,张晓晗,2022-07-14 12:05:07,8,8,0,论文是自己写的吗。。。
205643,6400,张晓晗,2024-12-10 11:52:53,0,0,0,挂名作者
123409,6488,冯洋,2020-06-08 09:13:09,2,10,8,老师太棒了！
130897,6488,冯洋,2021-01-25 07:36:38,3,10,7,冯洋老师真的不要太好，体验是事少分多，期末考试一份付出绝对有一份收获。每节课上课之前就有一些讨论和感想，真的有些话对人生都有启发，上课内容也很有趣，穿插很多案例，一点都不枯燥的。（老师笑起来真的好阳光好治愈
131858,6488,冯洋,2021-01-29 06:53:20,6,11,5,讲的真的不错，优秀的青年教师，自己虽然没够上均绩（均绩逼近4.5？）但是还是觉得老师是不错的。
139036,6488,冯洋,2021-07-12 08:38:55,1,7,6,冯洋老师不错的！人超帅！即使平时课堂参与不多给分依然不错
140448,6488,冯洋,2021-09-12 02:37:16,-19,13,32,装逼一人
144705,6488,冯洋,2021-12-23 08:33:35,1,7,6,年轻有为
158628,6488,冯洋,2022-07-01 01:30:05,11,12,1,裂开了
158792,6488,冯洋,2022-07-02 08:37:33,7,9,2,上课比较轻松，平时作业只有一次展示。但是宪法学期末考主要是另外两个老师出的试卷，和fy上课讲的没有太大关系，期末考爆炸......
159174,6488,冯洋,2022-07-07 09:17:43,14,21,7,上的宪法学，课感觉比较水，考试是真的硬……
161801,6488,冯洋,2022-11-13 15:25:01,3,7,4,关心学生的好老师
171594,6488,冯洋,2023-03-29 15:51:49,-1,12,13,上课没有一点干货，纯纯废话，听他上课就是坐牢
174855,6488,冯洋,2023-06-19 05:42:04,0,3,3,很好的老师！延伸挺多的
177721,6488,冯洋,2023-07-04 11:58:18,0,1,1,打满了，求fygg一定要捞捞我，海底捞的那种🥹
178203,6488,冯洋,2023-07-08 02:21:37,-1,4,5,给分好好呜呜我好感动
178214,6488,冯洋,2023-07-08 06:33:30,4,7,3,上课会提问但是不在场或者不会问题不大，老师不会因此扣平时分的。考核方式就是论文+考试，上课拓展的比较多，可以不用听，期末闭卷，要背的很多，可以参照余军老师的重点背，给分比余军要好很多
181170,6488,冯洋,2023-10-11 02:41:00,1,3,2,上课怎么样没听过，平时也没有接触
181319,6488,冯洋,2023-10-14 06:19:56,4,6,2,鉴定完毕 确实水
181840,6488,冯洋,2023-11-02 04:28:03,5,7,2,法学院男老师的颜值担当\n\n人很好\n\n宪法课听着有点犯困（应该是我自己的问题
192167,6488,冯洋,2024-05-10 13:41:39,0,0,0,非常好的老师，学识渊博，为人亲和
195708,6488,冯洋,2024-06-29 17:15:04,0,0,0,上的隐私保护与数据安全法，老师给分太好了！！！上课不点名，讲的内容也很有趣TT，都去选好吗！！！
195739,6488,冯洋,2024-06-29 23:15:14,2,2,0,给分好，为人和蔼，建议有用有意义，上课以实际作用为主，是个很好的老师
196210,6488,冯洋,2024-07-02 08:18:14,-1,1,2,冯老师是一个对学生宽容、对自己push的老师哈哈哈，很有青年学者的风范，上课比较慢条斯理~~隐私法本学期上的还是有些小小的枯燥，但是讲的很清楚，也学到了很多啦！
197439,6488,冯洋,2024-07-15 08:36:02,3,4,1,外专业这学期选了宪法学，课基本没怎么听（因为比较催眠），老师不点名人很和蔼，最后极限背ppt补天拿了4.5，感谢老师捞捞！！
199982,6488,冯洋,2024-10-10 06:16:13,2,2,0,无敌给分好
204506,6488,冯洋,2024-11-26 09:52:01,0,1,1,非常非常非常好
208588,6488,冯洋,2024-12-30 15:21:32,0,3,3,有实力的哥，宪法学未来之星。因为国内期刊发的少所以不是教授，其实早就有教授水平了。
126463,6674,雷彤,2020-09-27 14:32:04,41,56,15,给下几届的忠告：快逃
126464,6674,雷彤,2020-09-27 14:32:08,29,40,11,下一届孩子快逃啊！
126639,6674,雷彤,2020-10-10 11:50:22,-15,19,34,老师很好的，知错就改，考虑同学，老师在钉钉上主动听同学们的意见，真的不错
126909,6674,雷彤,2020-10-27 22:51:42,-4,22,26,老师很认真
127113,6674,雷彤,2020-11-09 03:37:38,22,33,11,学弟学妹们快跑吧 不如听戴鹏讲民诉
128702,6674,雷彤,2020-12-25 04:52:19,18,23,5,。。。
131031,6674,雷彤,2021-01-25 15:30:34,-14,9,23,还可以
131211,6674,雷彤,2021-01-26 16:45:17,14,21,7,假如生活欺骗了我，不要悲伤，不要心急，忧郁的日子总会过去，快乐的日子即将到来………
131215,6674,雷彤,2021-01-26 14:30:44,-2,18,20,我觉得老师真的是很认真 也有在努力备课\n\n思考自己的问题 但是可能有一点点费劲反馈不是很好 希望老师也可以更自信一点 \n\n（ps : 希望能十二点十五按时下课！最后几次拖到十二点半真的很饿食堂已经没有饭了 而且下午还有一点半要上课的同学
131342,6674,雷彤,2021-01-27 06:55:06,-11,11,22,老师很认真，讲的也很不错，也特别贴地气！希望老师可以更自信点吼！
131916,6674,雷彤,2021-01-29 09:56:13,31,44,13,学期末了来评一条，认真听完了一学期的课，不是因为她讲得好，是因为这么多年来对学习的尊重。总结来说上课质量一颗星，PPT又多又丑，重点飘忽，自以为很高大上其实连基本的理论也讲不清楚。待人接物半颗星，截图学生朋友圈发到钉钉群里骂人，在课程群里自说自话发脾气吓得没人敢说话，一颗玻璃心总觉得所有人都在得罪她。张口清华闭口清华，仿佛清华是她再生父母。拉踩浙大，想不通这么不喜欢回来做什么？不就是因为没能力留清华吗？不尊重学生，不知道为什么要骂上一届考高分的学生说他们不听课，不听课还能考高分又不是学生的错，正面反应老师菜好吧。后期稍微有一点改善，平时作业做了修改，但是整体太drama。给下一届的忠告就是：快逃。
132153,6674,雷彤,2021-01-30 15:39:59,-6,13,19,老师很努力，我是傻逼。
132572,6674,雷彤,2021-02-02 11:23:36,25,35,10,唉不知该说些什么……真的除了无语就是无语，多大的人了还呢么幼稚，在钉钉群里说什么自己的情怀都喂了狗?公然在钉钉群里骂学生是狗?想必老师自己也有问题吧，不然怎么会呢么多学生不能理解老师呢？老师还在群里发誓再看查老师评价是/:pig ……我就不明白了，为什么还有这种玻璃心的老师?张口闭口清华，还说浙大学生看起来无忧无虑，我就呵呵了，搞的我们浙大学生都不爱学习没有压力吗？还无忧无虑……也不知道哪只眼睛看到的无忧无虑……真的别选这个老师了求求了，除非你能忍受老师刷屏几十条的消息和片面偏激的语言……
132577,6674,雷彤,2021-02-02 12:04:32,-9,19,28,我觉得老师还是很认真负责的，可能上课水平还比较一般，但能感觉到是有努力想上好课且答疑也很细致。虽然在第一节课提出的考核方式很drama，但后续也有听取同学们的意见修改。大部分同学不去听课会反思自己的教学水平，会因为大三学业压力大而适当限缩考试范围等让我觉得老师也有一直考虑同学们的感受（虽然好像不太能和我们共情，一直说不强求其实有点站着说话不腰疼，但也确实有点被安慰到）。老师一直刷屏应该也是觉得那些资料对我们有帮助，而且在结课后才刷也不会觉得被打扰到，真的觉得老师挺有情怀的，可能只是还未找到最适合她的教学方式而已。希望老师能一直保持她的情怀，然后不断提升教学水平。
132681,6674,雷彤,2021-02-03 09:47:14,27,35,8,巨婴，受不了，快逃
133048,6674,雷彤,2021-02-07 05:23:39,23,33,10,除了不点名 别的都是缺点
133144,6674,雷彤,2021-02-10 09:58:10,-26,20,46,【1】\n\n评论区信息量很大，但诸多观点实在不敢苟同。在查老师写那么长的评论确实有些夸张，但我总觉得针对其他评论提及的事件提供另一种视角，对学弟学妹来说还是有一定价值的。\n\n \n\n老师目前教学水平确实不能与民诉领域顶尖的学者比肩，但的确在授课的全过程中时时反思自己的教学方式和授课内容安排。诚然，授课水平存在客观局限，这可以说是某种程度上的硬伤；但我以为，现在抱有这样态度从事教学的老师并非多数，这种教学态度是值得鼓励与珍视的。\n\n \n\n某些同学评价说老师授课重点飘忽。这究竟是老师上得差，还是这位同学自己没有把握诉讼法的学科特点？至少在我的理解中，诉讼法不是单纯依靠法感情就能掌握的课程，没有大量的背诵内容作基础，不可能形成学科的知识体系，也不可能透彻理解老师说到的重点。而且老师多次提及同学们最好能够自学重点讲义。我虽然未能通读教材，但确实认真拜读了大部分章节并做了详细笔记。在我看来，这本教材是深入浅出、言之有物的，虽然部分内容确实艰深，但若能尽力吸收自己可以理解的部分，受益不可谓不多。虽然本学期课业极重，老师布置这样的学习任务是较难落实的（这也是老师确实应当反思改进的地方），但请分清应然层面和实然层面的讨论。按照老师说的方法去做，不可能学不扎实民诉。\n\n \n\n老师在讲解某些基本知识点时确实讲得不清楚。扪心自问，我也只是模糊地理解了一个大概。但学界在这些议题上本就分歧颇大。我以为，这些知识点讲不清楚更多是因为相关的观点本就众多且复杂，而不是因为老师本人的思维混乱，没有必要把这些问题都归咎于老师的授课能力上。虽然老师确实应当认真考虑如何讲解这部分知识才更能帮助初学者学习。
133147,6674,雷彤,2021-02-10 09:52:56,-15,23,38,【2】\n\n可能每个人对“骂人”和“发脾气”的定义不同，反正我不觉得老师在骂人或发脾气。在我的理解中，老师自始至终苛刻以待、极力反思的只有自己的行为举止。一位具有教学理想、努力想要拉近与学生距离的老师，在第一次正式独立授课时战战兢兢，生怕自己不恰当的表达方式伤害到学生，又真诚地、尽量多地袒露自己的想法，希望能与同学们交心，我觉得是可以理解的。虽然老师可能确实有些敏感，因而在交往时显得有些用力、紧张，但我依然觉得老师是在真诚、善意地与同学们交流。同时，希望某些同学能读读清楚老师说的话再来评论，不要张口就来。老师说的是“觉得自己的情怀被狗吃了”，不是骂你是狗。另外，“理解老师的人少”什么时候能成为“老师本身有问题”的理由了？究竟是大家现在评价老师的标准变成了单纯的“事少给分好”，还是大家对某类与自己性格较有差异的人根本失去了同理心与宽容，抑或是这个人本身就有问题？希望各位对这些可能性有自己的思考与评价。\n\n \n\n无论他人是否承认，反正我是认为从客观上来说，清华民诉领域的实力就是比浙大强。老师不过是分享自己在清华的经历与见闻，毕竟这是她生活、学习了七八年的地方，已经成为了她人生不可分割的一部分。我认为，一个人分享自己的人生经历，这没有什么值得诟病的。表象上都是在描述清华是如何如何，但动机既可以是炫耀自己曾经在清华读书，也可以是希望为同学们提供一种新的学习思路，提供更广阔的视野。结合老师上课时分享的其他内容，我确信老师的动机是后者。\n\n \n\n老师上课时说过，离开北京坚持回浙大是她的执念，因为她一直觉得浙大的学生非常优秀、非常值得培养，当初也因此与家里发生了激烈的冲突。不知为何，这在某些同学口中就变成了“不就是因为没能力留清华”。
133148,6674,雷彤,2021-02-10 09:58:25,-20,18,38,【3】\n\n老师直言不喜欢上一届不听课但拿高分的学生，但最后不是还是因为那位同学卷面分极高而给满了吗？老师不认可这种不听课只学法考视频的方式，只是想表明自己的教学观罢了。老师认为学习应当学知识、学方法，同学们应该具有批判性意识，并且形成个体对问题的独立思考。这难道有什么问题吗？她批判的不是那位同学，是一种教学模式罢了。\n\n \n\n“浙大学生无忧无虑”这件事。我只想提醒一下，中国大学生不是自始至终都那么卷的，浙大法学院也不是自始至终都那么卷的。虽然也是道听途说，但据我所知，哪怕是16级的学长学姐，也尚且未曾卷起来。老师是好多年前毕业的浙大学生了，她不自觉地将彼时的印象直接搬运到现下，也无可厚非吧。何况她作为一名新老师，也刚刚来到现下的浙大法学院啊，人对环境的熟知总要有个过程吧。\n\n \n\n的确，老师很多话断章取义地来看，可以挑刺的地方多了去了。但诸位如此积极主动解读出来的内容确实是老师的真意吗？没有评价是不带偏见的，本评论亦复如是。只希望读到本评论的诸位不要偏信某些主观性过强的片面评论，亲自用心去感受与交往。
133721,6674,雷彤,2021-03-04 08:02:08,-20,10,30,很耐心，对待教学很认真，给分也很不错
134123,6674,雷彤,2021-03-16 13:13:42,18,22,4,给你1分是因为只有1分，上课又烂性格又拉跨，无语至极，各位散了吧，隔壁霍海红老师是以前是吉大最厉害的民诉教授之一，比这货从人品到授课能力都强了几千倍，别浪费时间了
134926,6674,雷彤,2021-04-26 01:46:17,6,9,3,。。。
137096,6674,雷彤,2021-07-01 13:40:25,11,14,3,所以，为了这个老师的健康，同学们要保重自己的健康，保重自己的健康就是保重老师的健康。成绩随缘，到课率佛系，但健康，最重要。另外，学会躺平，就是学会健康。
137124,6674,雷彤,2021-07-01 10:22:39,21,23,2,这个老师（生理意义上的）精神有些问题。比较可怕，最好别靠近
137393,6674,雷彤,2021-07-03 17:32:28,12,15,3,性格很奇怪 有点问题
137411,6674,雷彤,2021-07-04 03:42:02,16,19,3,上课的负面情绪也太多了，你骂得似乎是不来听课的学生，影响的确实来听课同学的心情。好好调整下心态吧。
137426,6674,雷彤,2021-07-04 05:56:12,16,18,2,如果做不到的承诺，可以不用说…比如不拖课，比如如果忍受不了没人来上课人少心情就会很差甚至影响到课同学的体验，可以不用在第一节课说大家可以用智云听课…感觉到老师很努力了，备课也很认真，推荐的书也挺好的，但是其实不用这么用力，大家都情绪放松点不好吗。想在体贴的学姐和懂得避嫌的老师之间切换是挺难的，没必要强求兼备，而且感觉大家也没有很想去刷脸，个人觉得没必要对加不加好友还有各种那么敏感啊，有点矫枉过正了，也容易影响老师自己的心情…
137600,6674,雷彤,2021-07-05 08:56:19,13,15,2,老师克制一下自己情绪吧……这样真的挺不好的……对自己对别人都不好
141259,6674,雷彤,2021-09-27 15:07:34,9,11,2,真的很无语……
151430,6674,雷彤,2022-03-03 06:00:38,14,14,0,老师您的脸皮可真厚，怎么做到明知有督导坐在下面，还一如既往地毫无起伏地读PPT的
151433,6674,雷彤,2022-03-03 06:49:31,13,13,0,有督导坐在下面，还一如既往地毫无起伏地读PPT·····\n\n真的有点受不了，今天要签到，几乎全员到齐了，but老师语速很快地在读密密麻麻的ppt，不知道为什么要在这里，很无语，既然读ppt的话我们完全可以自己学
151444,6674,雷彤,2022-03-03 09:40:15,11,12,1,毫无感情的念ppt机器
151445,6674,雷彤,2022-03-03 10:03:18,15,15,0,看了全是快逃的评论，可是没得选啊！职业伦理课必修，好在是个拼盘课，只上3节，一分钟也受不了，全程低头读ppt，ppt上全是法条，一个字一个字念，是觉得我们不认字还是咋滴？\n\n现在上课似乎不提清华了，确实，您配吗？实在想不通这样性格的人为什么可以当老师？就别祸害下一届了吧。\n\n\n\n另外 评论中的长文【1】【2】【3】不会是。。一个用户只能评1条，看来真是难为ta用3个账户了，这样看，还有5分的评分也是有迹可循了。\n\n\n\n那个评论中说回浙大是其执念，觉得浙大学生值得被培养，嗯。。就是这样培养的。。
151446,6674,雷彤,2022-03-03 09:47:31,14,14,0,照着PPT念法条！我们都是文盲，不认识中国字，需要她来念！妈的，今天血压都上去了！要把浙大法学院弄成一个笑话吗?！
151447,6674,雷彤,2022-03-03 09:49:25,13,13,0,哇这课真是大开眼界，挺有意思的涨知识了，第一次知道这样也能当老师。
151564,6674,雷彤,2022-03-08 02:04:56,7,8,1,念PPT简称念老师
151596,6674,雷彤,2022-03-24 21:57:14,20,21,1,这个老师在群聊时 “安利”学生，让学生去退学，真是震碎三观。  \n\n\n\n（聊天记录  校长邮箱走起！！）\n\n\n\n校办的联系电话：0571-88981581传真：0571-88981358电子邮箱：zdlb@zju.edu.cn
151640,6674,雷彤,2022-03-10 06:36:56,8,9,1,除了会读PPT你还会干啥？
178798,6674,雷彤,2023-07-23 13:19:36,-9,6,15,浙大学生如此素质，对老师毫无尊重，给老师打1分，试问自己又做到几分？
170732,7111,彭巍,2023-03-09 01:45:58,-3,9,12,男神，彭巍我的男神嘿嘿，手好看嘿嘿，腿也好长😍嘿嘿嘿…彭巍…嘿嘿嘿😋
170749,7111,彭巍,2023-03-09 05:10:28,7,18,11,彭老师😍 😍 \n\n很帅气\n\n很敬业\n\n很博学\n\n很害羞\n\n很可爱\n\n(｡･ω･｡)ﾉ♡
170911,7111,彭巍,2023-03-12 10:52:40,-4,10,14,就要男妈妈🥰🥰🥰\n\n嘿嘿嘿这腿，这手谁看了不发疯prpr\n\n🙏🙏🙏彭门
170912,7111,彭巍,2023-03-12 10:53:10,-3,11,14,彭巍……嘿嘿……老师……嘿嘿……西装老师……嘿嘿……西装男神……人夫感帅哥……嘿嘿……愿意为他疯为他狂为他哐哐撞大墙！
170915,7111,彭巍,2023-03-12 10:57:19,4,14,10,彭巍gg我的男神！男神下凡怎么不提前说一声😲 😲 怎么会有颜值和才华这样子并存的法学老师哇哇哇！嘿嘿……嘿嘿……😍 😍 这手……这腿😭 啊啊啊我要疯了（爬来爬去）上课每次邪魅奇怪的一笑☺️ 嘿嘿……好爱中法史😻 😻 😻 我愿称之为青年教师之最！嘿嘿……
170918,7111,彭巍,2023-03-12 11:16:53,-4,9,13,💕゜❤️゜老婆，我命中注定的老婆哎嘿💗Ｏ○。❤️○゜。💕Ｏ°❤️嘴一个○。💗ｏ。○么么么哒💕Ｏ
170929,7111,彭巍,2023-03-12 14:28:24,-3,8,11,彭巍老师嘿嘿...嘿嘿...一本正经地讲课，害羞地不敢看同学....但是声音温柔，手指细长.....嘿嘿...嘿嘿...
170930,7111,彭巍,2023-03-12 14:28:46,-8,4,12,「◦㉨◦」不会吧，不会吧，不会吧，你们没有上彭老师的课content://com.baidu.input_huawei/external/cache/image_cache/73771748019fc50d5d2d6136bd0fb4b70e2fcc1eb16aebfd85157afbb4ac2454.0?publicFilePath=L3N0b3JhZ2UvZW11bGF0ZWQvMC9BbmRyb2lkL2RhdGEvY29tLmJhaWR1LmlucHV0X2h1YXdlaS9jYWNoZS9pbWFnZV9jYWNoZS83Mzc3MTc0ODAxOWZjNTBkNWQyZDYxMzZiZDBmYjRiNzBlMmZjYzFlYjE2YWViZmQ4NTE1N2FmYmI0YWMyNDU0LjA%3D
170931,7111,彭巍,2023-03-12 14:53:54,-5,7,12,要素齐全！嘿，老婆😍😍
171286,7111,彭巍,2023-03-21 02:15:05,-6,6,12,没什么可说了 斯哈斯哈斯哈斯哈😍😍😍😍😍😍😍😍😍😍😍😍😍
171640,7111,彭巍,2023-03-30 11:34:05,-9,2,11,好喜欢彭巍老师啊啊啊啊，认真负责，还很好相处。男神啊啊啊啊
172886,7111,彭巍,2023-05-09 06:15:04,-11,3,14,😍pwgg！
175282,7111,彭巍,2023-06-23 07:41:48,-11,3,14,pwgg！！！太帅了！！声音好听有磁性！！爱了！！啊啊啊啊啊啊啊啊啊好爱好爱 斯哈斯哈
177783,7111,彭巍,2023-07-05 00:23:30,2,6,4,老师人确实很好 上课讲得也不错 但是 给分有点点伤人 目前专业课里面最低的一门
179356,7111,彭巍,2023-09-14 08:02:25,4,7,3,。。。
180061,7111,彭巍,2023-09-20 08:13:13,4,8,4,❌其实真的没想象的好
188745,7111,彭巍,2024-01-19 20:45:24,7,10,3,评论区能不能收收味
189902,7111,彭巍,2024-02-01 19:12:42,16,18,2,评论区也太性压抑了吧
192234,7111,彭巍,2024-05-12 17:02:42,4,5,1,彭老师讲课很敬业，看得出是认真准备的；期末论文2500字即可，无需灌水，非常友好。
196665,7111,彭巍,2024-07-04 17:18:43,4,5,1,事少给分好，而且认真听也能学到知识。真的是好老师，不知道说不好的怎么想的。。
214719,7111,彭巍,2025-02-17 04:53:24,0,0,0,评论区在干啥 完全没有正经评论
216073,7111,彭巍,2025-03-10 07:23:44,0,3,3,并没有很帅呀。我觉得讲课太慢，语气没有起伏，声音低且有点含糊，人很容易走神，听不下去。
216735,7111,彭巍,2025-03-23 13:20:37,1,1,0,老师人真的蛮好的，给分也不错
136300,7493,魏斌,2021-06-16 02:57:26,2,8,6,老师很平易近人也很关心同学，法逻讲得很好，最后一节课提醒我们理性与温度。
136669,7493,魏斌,2021-06-22 17:30:45,-1,4,5,法律逻辑学，老师很好的，很关心同学，讲课也非常耐心，从来不点名，作业很少有时没有，上课认真学也能学到很多知识
136885,7493,魏斌,2021-06-27 13:31:57,2,7,5,老师讲课挺认真的，每节课内容都很充实，能学到真东西，推荐！！
138353,7493,魏斌,2021-07-08 15:30:12,6,14,8,很不错的老师，很温和，讲课也很细致，就是最开始几节课鼓励发言哪怕答的乱七八糟都算加分感觉不太合理，点名方式就是在群里接龙早上好，蛮好玩的(∂ω∂)
149035,7493,魏斌,2022-01-14 07:40:04,-1,4,5,好老师！
155262,7493,魏斌,2022-06-10 02:24:55,-2,4,6,很负责任的老师
174304,7493,魏斌,2023-06-09 06:47:59,-2,1,3,很负责的好老师！
175533,7493,魏斌,2023-06-25 11:16:43,-1,0,1,很好很可爱的老师，给分巨好，讲的很清楚也学到了很多啊啊啊强推！！！！！
175536,7493,魏斌,2023-06-25 11:50:32,-1,2,3,老师讲的还是比较生动有趣的，基本没有点过名，平时有一些简单的作业，最后期末复习也很到位，给分超级好！一个班大概有57%的人在90分以上，推荐外专业的同学来选！对法学知识要求不高，主要能学一些逻辑类的知识！给老师10分！
175552,7493,魏斌,2023-06-25 12:54:44,-2,0,2,老师超级棒，上课认真听能学到东西的，期末稍微复习一下就好
176313,7493,魏斌,2023-06-28 10:45:48,0,2,2,跨专业满绩~\n\n重点在逻辑学，法学要求不高，有硬核内容但不会很多，可以掌握。\n\n开卷考试，最后一节课讲了一套模拟卷，基本和期末卷形式一模一样，所以只要比较认真，成绩没问题的！
176567,7493,魏斌,2023-06-29 09:27:23,-2,0,2,老师上课准备的很充分，讲课特别好，期末的给分也超级超级好！！
177131,7493,魏斌,2023-07-02 00:58:09,-3,1,4,超级好！！！！！
177817,7493,魏斌,2023-07-05 02:46:59,-3,1,4,特别好！
196682,7493,魏斌,2024-07-04 17:41:28,1,2,1,不得不说考试太难了
196739,7493,魏斌,2024-07-05 02:51:20,4,5,1,硬碰硬的课，没有正态，全看成绩
196761,7493,魏斌,2024-07-05 03:42:52,8,9,1,大一下学期的法学生都壁垒吧，专业课本来就多，法律逻辑学这种课又不是专业必修甚至不是专业选修，考核也特别硬
196774,7493,魏斌,2024-07-05 05:26:40,7,8,1,给分并没有前几年说的这么好，期末考的很多很难。我还每节课都去上课…说签到加平时分也不知道加在哪了（也有可能是我考试太菜了）。反正不推荐法学生把这门课当个性化，太硬核了，而且给分感觉很求是。
197019,7493,魏斌,2024-07-06 17:17:17,0,0,0,确实认真听了，感觉得到老师也在认真讲，期末写卷子的时候感觉也没有很糟糕，不过看到绩点的时候确实心情很复杂，大概是我菜吧
206504,7493,魏斌,2024-12-15 14:57:25,6,6,0,你是真抽象吧……上课还好意思在那里说自己这门课就是给同学提升成绩，结果呢？每节早八都去上了，作业认真写了，喜提大一下最低绩点，不虚伪吗？考试前跟你说病了要缓考已读不回更是让人胃酸反流……别立人设了吧哥
208332,7493,魏斌,2024-12-27 02:12:45,3,5,2,破wb，屁事一大堆，期末考试占比70%，呵呵，一门跨专业喜提最低绩点3.6，呵呵，滚。
211837,7493,魏斌,2025-01-12 16:15:19,0,1,1,不理解开法律逻辑学这门课的意义，法学生学起来又累给分又低，还没用，一点获得感也没有
215624,7493,魏斌,2025-03-06 19:07:16,1,2,1,烂完了，强制数字法学学生给你免费干私活，甚至连非全也要干，还要脸吗
216467,7493,魏斌,2025-03-17 03:44:12,0,1,1,烂人一个
216652,7493,魏斌,2025-03-20 06:18:09,1,1,0,烂。上课没有水平，拉学生干私活。说着自己不爱点名从不点名接着就是数人头要求学生记录到课人数。又当又立大可不必。
218941,7493,魏斌,2025-05-14 03:06:28,0,0,0,听说压榨自己学生
135564,7722,查云飞,2021-05-14 02:08:37,4,24,20,很可爱的老师
142697,7722,查云飞,2021-11-15 07:53:41,8,14,6,老师很不错，就是行政法有几位大姐特能卷，醉了
144197,7722,查云飞,2021-12-20 08:36:12,8,11,3,特别好，讲课很清楚，很亲和，很温柔
144491,7722,查云飞,2021-12-27 03:51:06,26,28,2,温柔可爱
144896,7722,查云飞,2021-12-25 14:35:51,6,8,2,老师真的很不错，会很耐心帮同学回复问题
145932,7722,查云飞,2022-01-04 12:36:31,8,9,1,老师人很好 给分好 事情少
145946,7722,查云飞,2022-01-04 14:05:36,10,11,1,老师人很好，很温柔，会和学生打成一片，辅修班的行政法可以学到一些基本的法律知识，而且老师给分好，问问题也会耐心解答，总之选就对了。另，点名其实都是期末最后几节课老师让手动签到的，甚至可以补签。
148498,7722,查云飞,2022-02-18 09:58:04,9,10,1,老师讲课很清晰，超喜欢，是行诉三位老师中讲课最好的！
148979,7722,查云飞,2022-01-14 05:37:11,1,2,1,唉唉唉
149864,7722,查云飞,2022-01-17 10:39:36,8,9,1,行诉。个人觉得查老师是三位老师中讲课最好的，很可爱！
150850,7722,查云飞,2022-02-19 15:30:17,19,20,1,查老师行政法上课班级很小，十几二十个人。但是这样的班级好就好在能有更多的交流互动，上课的氛围也很轻松。可能因为班级大部分同学不是法本科班出身的缘故，老师讲的不难，并且很清晰很清晰。感觉是继周黎明老师以来第二个让我燃起法律兴趣的老师了。\n\n最后一节行政法课老师一直在问我们，像这样的，面向非法本学生或者辅修学生的专业课小班还有没有必要开。我个人认为，极有必要，这样的小班课甚至给我一种风乎舞雩的既视感。给查老师打call
153810,7722,查云飞,2022-05-12 00:20:55,10,11,1,饭垄堆
154541,7722,查云飞,2022-06-02 05:39:45,5,9,4,人超级超级好，事少分高，上课有趣，通俗易懂！
158438,7722,查云飞,2022-06-29 09:18:18,7,10,3,老师讲课很认真 准备得很充分 期末案例还提前给我们讲解了 给分也很nice 查老师值得
162610,7722,查云飞,2022-11-28 16:35:21,10,12,2,非常不错！讲课认真，逻辑性强，帮助初学者搭建知识框架，幽默风趣！给分也好！
164205,7722,查云飞,2022-12-19 07:41:38,13,15,2,老师的行案体验感很好，强推！是用心、耐心的好老师！
168334,7722,查云飞,2023-02-12 08:12:31,9,12,3,我为查查举大旗！上课的体系性和框架性是行诉三位老师中最明显的，听下来毫不费力！
171804,7722,查云飞,2023-04-06 05:58:44,7,9,2,选查老师做导师要做好写读书报告的心理准备
171951,7722,查云飞,2023-04-13 11:06:05,12,14,2,世界上最好的老师
174368,7722,查云飞,2023-06-12 02:23:12,14,16,2,法学院最好的老师之一！授课清晰，逻辑严密，体察入微，将法教义学和社科法学圆融地结合在一起，让我们一窥公法学的包容与博大
182065,7722,查云飞,2023-11-09 10:14:18,0,5,5,信赖利益保护？
182304,7722,查云飞,2023-11-14 09:54:12,-32,12,44,查老师与他这个年龄段的其他法学院老师一样，不理解学生、共情能力低下、享受把学生逼到墙角并看其不知所措无能为力的窘状。建议老师看看桑德尔的“正义”这门公开课，学习一下什么时候需要进行“苏格拉底诘问”以及如何正确地进行诘问，逐渐减少同学们的不适。（在于纠正同学们的思考而不是让同学们为没记忆住概念、知识点而尴尬）
183457,7722,查云飞,2023-11-26 12:15:41,19,19,0,上了查老师的案例课，才觉得刚入行政法的法门。而且觉得老师很公平，是我这学期最喜欢的一位老师！
184632,7722,查云飞,2023-12-22 04:19:32,11,11,0,如沐春风！
185654,7722,查云飞,2024-01-03 09:34:54,18,18,0,本学期最喜欢的一位老师，必须十分！不是法学院的学生，但是也了解过其他几位同开行政法的老师，相比之下，查老师事情很少（一次案例分析➕一次读书报告➕期末开卷考，给分不详，但相比之下给分已经是次要的了），不逼迫，很中正平和，重在知识传授，有自己的讲义，课上有很多案例分析，把行政法讲得很清楚！虽然四节课连上，但每次听查老师的课都觉得时间过得特别快。感谢查老师又一次点燃了我对法律的热爱，也让非法学的学生能够以专业的视角看待这个世界！
190128,7722,查云飞,2024-02-23 09:46:44,11,11,0,给查老师点赞，身边人都觉得老师讲课讲得很好！
191001,7722,查云飞,2024-03-28 01:02:53,8,8,0,最好的老师之一，我爱查查
191778,7722,查云飞,2024-04-30 06:02:39,21,21,0,云飞你能不能讲行诉后面全部课程。。。。。求你了求你了。。。。不要讲完一章就离开555.。。。。。。云飞我舍不得你啊云飞。。。。。。。
191784,7722,查云飞,2024-04-30 07:05:31,8,9,1,太幽默了，上他的课欢乐不断
192747,7722,查云飞,2024-05-30 04:19:46,8,8,0,老师超级好，上课能见到的资料也很丰富，可以在上课过程中逐渐摸索到法学学习的方法。总之，是我在进入法学专业学习的这一年以来，最喜欢的老师！
197600,7722,查云飞,2024-07-21 01:53:10,7,7,0,最喜欢的老师之一！ 我亲爱的恩师和论文导师查查！
201527,7722,查云飞,2024-11-11 06:43:29,3,5,2,行政法案例不要来选！问就是不要选！人太多了（
205730,7722,查云飞,2024-12-11 13:21:30,6,6,0,期末考之前来给老师打个分～查老师很认真！每节课前都会给大家发课件（是word！做笔记超级方便！）希望查老师保佑我行政法期末！！！
212882,7722,查云飞,2025-01-15 06:57:36,4,4,0,老师上课很细致，仔细听真的很有收获，老师爆好
214165,7722,查云飞,2025-01-26 09:51:19,2,5,3,讲课很好，给分不高
214167,7722,查云飞,2025-01-26 12:28:04,1,3,2,老师讲得好，确实能学到知识，人也不错，给分给我还是不错的（拿了94），不过可能其他同学反映给分不太好，因人而异了
129384,7800,孙晓红,2021-01-05 02:15:14,0,5,5,好极了
142052,7800,孙晓红,2021-11-04 18:15:11,3,7,4,就想问问司法实习的钱什么时候给？据说从来没给过？
129238,7810,Maziyar Shokrani,2021-01-02 06:23:49,4,6,2,在自习室碰到的老师，交流了一会，感觉人很好啊
130257,7810,Maziyar Shokrani,2021-01-20 09:14:02,4,5,1,很负责很热情的老师
132758,7810,Maziyar Shokrani,2021-02-03 12:42:35,6,7,1,good！
143864,7810,Maziyar Shokrani,2021-12-09 07:26:04,10,11,1,在钉钉上聊过很久，被Maz的人格魅力折服，特别好的老师
151586,7810,Maziyar Shokrani,2022-03-08 11:18:13,8,9,1,好老师，上课略水，但是一直和我们在交流
167414,7810,Maziyar Shokrani,2023-01-16 06:52:25,4,5,1,感觉上课好想学了些啥 又好像没学到啥 但老师人很负责 给分很好
168719,7810,Maziyar Shokrani,2023-02-21 11:15:37,9,10,1,联可发~基本每节课点名，没有考试，课程任务不多。但很难听懂，因为都是外教以及连线的国外教授在上，世界各地的口音都有，所以对我这个英语渣来说不太友好，但是给分很很很好，本来以为这么一门很难的课加上自己没发言会绩点很难看...所以还是感谢maz~
174604,7810,Maziyar Shokrani,2023-06-14 12:39:39,7,7,0,maz老师真的很可爱很可爱很可爱！是天使！上课轻松也会发材料阅读。人很认真，经常跟我们讨论。给分超级好！人很热情，经验也很丰富。宝藏老师好吧
174605,7810,Maziyar Shokrani,2023-06-14 12:39:51,4,4,0,老师真的好可爱！！！狠狠爱了。人特别好，上课很认真，总之就是天使一般的存在！！
174694,7810,Maziyar Shokrani,2023-06-15 16:27:51,18,19,1,把Maz的课从大二上到了大四，这就是他的吸引力❤️
184706,7810,Maziyar Shokrani,2023-12-22 09:12:14,11,12,1,“Dear colleagues， as we changed the ‘final exam’ requirement to ‘paper submission’ in the system， you will not be required to appear for on-site exam on January 11， 2024. Instead， everyone will submit an 800-word paper based on instructions that will be uploaded on next Thursday.”\n\nThank you， Sir! I love you! God bless you!
190072,7810,Maziyar Shokrani,2024-02-19 06:11:12,9,9,0,不会强迫你发言，不想说绝对不会点你起来回答。说什么maz都会觉得你说的很好，鼓励教育。能学到多少主要看自己，因为上课还是有些内容，但是形式很水，或者说只是点到为止。并且需要课前预习估计才能跟上他说什么。但是没跟上也没关系，因为maz不考试，考试也很简单，给分非常好。如果你跟着他好好学，自己课前课后找资料问问题，上课参与讨论，可以学到很多。但如果你听不懂不想学，分数也不难看，不过确实自己会感觉一学期之后学不到什么。老师很可爱很和蔼，政治立场有点偏，就看你选课是图什么了。
192407,7810,Maziyar Shokrani,2024-05-18 07:00:59,13,13,0,撺掇他讲自己生平经历很有趣：伊朗人、留学印度、尼泊尔国际组织实习、战乱时期自己也成为过idp（境内流离失所者）。总之他本人的经历就很国际，让很多国际议题显得没有那么假大空，甚至还能充满情感色彩。
193170,7810,Maziyar Shokrani,2024-06-04 07:09:00,11,11,0,好精彩的人生！与其听无聊的理论，还不如听他讲：小时候战争时期没钱买口罩，怎么躲生物化学武器；去塔吉克斯坦、新西兰等各地找工作，发现塔吉克斯坦人都去俄罗斯搬砖零下40-50度冻死。他的人生经历可以对应每个SDG。
194972,7810,Maziyar Shokrani,2024-06-26 06:32:42,7,7,0,今年给分一般般，或许是严格了
198388,7810,Maziyar Shokrani,2024-09-08 12:09:39,3,3,0,海纳百川、追求卓越、开明睿智、大气谦和。
199422,7810,Maziyar Shokrani,2024-09-23 08:28:09,6,6,0,老师不会强制让你回答问题，除非你想表达，给分还不知道但Maz老师就是我心目当中大学老师的形象
201305,7810,Maziyar Shokrani,2024-10-31 10:45:00,4,4,0,口音重，每周布置一个pre，水课max的maz...
209457,7810,Maziyar Shokrani,2025-01-06 04:07:32,3,3,0,水课max
133765,8180,徐万龙,2021-03-05 01:03:41,51,62,11,很年轻的老师。没有老教授的迂腐气，上课水平很不错而且能让人听得懂。
133781,8180,徐万龙,2021-03-05 07:24:16,67,81,14,"虽然老师明确说不点名，但我想我一定会去的，不知道为甚么，听他的课总有种津津有味的感觉，另外老师自己说他普通话不标准，会把""住在船上""说成""住在床上""，但我觉得听起来“有内味”，连上四节课都不会倦的那种，应该不是我一个人有这种感觉吧。"
133818,8180,徐万龙,2021-03-06 13:01:19,34,42,8,老师上课很有意思，案例分析很到位，上课干货很多，讲授很多对法学生受益终身的知识，真的很负责，想教给学生最有用的知识！虽然是新老师，但是真的很好！
134080,8180,徐万龙,2021-03-26 02:02:50,10,17,7,超级棒！
134103,8180,徐万龙,2021-03-16 04:28:36,1,8,7,很不错
134328,8180,徐万龙,2021-03-24 02:34:32,3,8,5,老师好 就是不知道给分如何
134391,8180,徐万龙,2021-03-26 05:19:30,-5,10,15,讲课很好，就是建议提高一下速度，有时候也不用面面俱到，按照目前这个速度，刑总肯定是讲不完的
134560,8180,徐万龙,2021-04-01 11:39:06,9,14,5,上得很认真也很有趣，感觉收获良多。老师人也很温和！只是不知道给分怎么样
134789,8180,徐万龙,2021-04-15 06:55:03,6,12,6,最爱的老师！
135950,8180,徐万龙,2021-06-04 12:01:11,2,7,5,老师人特别可爱，而且上课也很有条理，是很有魅力的一位老师
136419,8180,徐万龙,2021-06-18 00:03:15,2,8,6,老师很可爱
136430,8180,徐万龙,2021-06-18 02:10:19,14,21,7,我永远给龙酱满分
136431,8180,徐万龙,2021-06-18 02:11:07,2,7,5,特别好的老师！可爱负责水平高
136469,8180,徐万龙,2021-07-05 04:57:38,28,33,5,没有词语和句子能表达出我对龙宝的爱
136471,8180,徐万龙,2021-06-18 10:28:02,15,20,5,为龙酱疯狂打call！！！课讲的很细致，为了把课讲完自己去加课时，一天上八节课，也不会点名，呜呜遇见这样的好老师真是太幸运了
136559,8180,徐万龙,2021-06-21 04:33:34,2,8,6,老师上课干货满满，讲得也特别详细
136785,8180,徐万龙,2021-06-24 12:31:12,8,13,5,龙酱yyds!真的很可爱的老师！！
136801,8180,徐万龙,2021-06-25 01:02:19,14,21,7,小徐人超好，讲的很清楚，各种搞笑，可惜不带刑分
136833,8180,徐万龙,2021-06-25 10:27:30,24,31,7,讲完这个我们就下课\n\n每次龙哥拖课我都想着能不能早点下课，到了最后一堂课却发现，我好像爱上龙哥爱上了刑总这门课，真的永远不想下课。
136841,8180,徐万龙,2021-06-25 12:53:06,2,8,6,龙酱yyds！\n\n人好事少，上课认真，满满干货！\n\n龙酱的课值得100分！
136848,8180,徐万龙,2021-06-25 17:06:50,0,7,7,我太爱龙酱了呜呜呜一定要pick他，啊啊啊
136868,8180,徐万龙,2021-06-26 15:43:55,9,15,6,龙龙真的超棒！上课超多干货而且很喜欢纵向联系很多知识点，体系性思维很强！而且下课后问题目也会很认真地回答，性格特别可爱！而对我来说最重要的是老师有时会引导我们去深入思考，不是简单的学法条还有去了解背后的内涵。虽然老师很喜欢拖堂，但尽管这样我们还是很喜欢他，可见龙龙人格魅力之强了哈哈
137737,8180,徐万龙,2021-07-06 02:43:32,-65,12,77,一个不能把控课时，拖堂的时间比正常上课时间还长的老师讲得再好我也不喜欢，甚至出一个考试的题目都不能把控好时间吗，两个小时考试还有延考这种迷惑操作，牛！
138015,8180,徐万龙,2021-07-07 05:17:30,16,23,7,龙宝真的太好了，后来的课我甚至都不敢去了，生怕自己控制不住爱上他！！龙宝是真的在努力地教刑法，他是未来的刑法之光！！
139735,8180,徐万龙,2021-07-22 06:38:15,1,6,5,龙酱！龙酱！
139736,8180,徐万龙,2021-07-22 07:26:56,0,6,6,给分好好好！！
139856,8180,徐万龙,2021-08-03 06:58:01,0,5,5,老师上课的内容安排干货很多，很有条理（虽然PPT真的很emmmm“平铺直叙”），会讲一些学界比较前沿的理论，各种观点的都会有所涉及，也会辅之以案例，不致过于空泛。看得出来有用心准备。上课风格也很幽默风趣，只是刑总课程安排就是连上四节，确实比较折磨人。期末考试开卷考，就是写一篇巨巨巨长的刑事案例分析。总的来说，虽然我最后绩点没有特别特别高，但这门课确实为我的法学学习开了个非常好的头，非常感谢徐老师！
139876,8180,徐万龙,2021-08-06 07:32:47,2,7,5,选他选他！
140506,8180,徐万龙,2021-09-13 06:24:30,0,6,6,非常喜欢的老师！给分也很好
140891,8180,徐万龙,2021-09-17 08:38:29,0,6,6,选他！选他！龙酱yyds！
141281,8180,徐万龙,2021-09-28 06:31:28,0,6,6,我爱龙龙一万年
144017,8180,徐万龙,2021-12-16 02:47:45,0,6,6,龙酱认真负责!人超好 讲课也很有水平!
144854,8180,徐万龙,2021-12-25 07:19:53,0,5,5,永远的龙酱！
144865,8180,徐万龙,2021-12-25 09:03:02,0,6,6,龙酱yyds，希望以后还能上到龙酱的课！
145733,8180,徐万龙,2022-01-01 05:55:49,1,7,6,不点名，讲课讲的很深，这个老师有点东西，性格也可爱，打10分。
146676,8180,徐万龙,2022-01-07 07:40:01,3,8,5,年青一代最好！没有之一
147002,8180,徐万龙,2022-01-08 11:15:14,1,9,8,满分十分，我给龙酱100分！！
147307,8180,徐万龙,2022-01-09 12:40:07,12,18,6,本科四年听了这么多老师的课，说徐老师浙大刑法第一人我想是不过分的
150607,8180,徐万龙,2022-02-04 05:30:07,0,6,6,各种意义上的人生导师
150767,8180,徐万龙,2022-03-03 03:38:48,3,15,12,法硕学生评价\n\n\n\n理论加案例教学，注重理论的深度；PPT中有很丰富的案例；\n\n强调体系性思维的建构（虽然老师自己的PPT不怎么有体系）；\n\n会引入德国比较前沿的理论；\n\n课堂互动还不错，但会讲不完（刑总内容太多了）。\n\n\n\n有些观点有点不太认同，比如：\n\n对孕妇的手术，如果家属未签字的医生就不应该手术（其实民法中已经有规定）；\n\n批判给怀孕的妇女执行死刑的规定，认为现代女性的地位已经上升，这个法条的规定对男性不公平（老人、小孩、妇女是世界公认的弱势群体，中国的社会发展还没到女性已经不再是弱势群体的程度，对怀孕的妇女（即便已经流产或者已经生下小孩）都不再执行死刑，是基于全世界对女性群体的恤刑吧）；\n\n\n\n希望老师以后直接要求学生买《刑法一本通》，不必每次课都说，就跟劳动法许老师一样。\n\n\n\n第二学期ing，与其他刑法（包括刑诉）老师相比，徐老师真的是好太多，上课的互动以及上课的精彩程度都高于其他老师。\n\n\n\n哎，浙大的刑法感觉太弱了。
151026,8180,徐万龙,2022-02-22 04:21:11,1,10,9,日常给咱们龙宝刷满分！！！
151639,8180,徐万龙,2022-03-10 06:34:59,3,8,5,有教无类！对我们法硕很上心的，上课的态度简直没得说！水平也非常非常高！ 太喜欢龙酱了！
151730,8180,徐万龙,2022-03-14 04:10:40,0,5,5,龙酱yyds～
154504,8180,徐万龙,2022-06-02 02:41:24,0,3,3,龙哥yyds
154552,8180,徐万龙,2022-06-02 06:11:08,19,22,3,喜欢龙龙 龙龙会看这个吗 龙龙什么时候有婚姻生活啊就不会再被托尼老师嫌了 怎么没有早点认识龙龙呢 龙龙害怕之江的蛇吗 龙龙什么时候接管法学院 把我的小猫送到之江保护龙龙 \n\n上课坐在第一排的话 有可能会被捅死（口嗨
155093,8180,徐万龙,2022-06-08 07:26:26,0,1,1,龙酱yyds
155204,8180,徐万龙,2022-06-09 09:29:00,1,2,1,选他选他
155329,8180,徐万龙,2022-06-11 03:20:49,4,5,1,我爱龙酱！！！！可惜自己实力不好，在人才济济的这个班没办法让龙酱看到自己😭😭😭
155499,8180,徐万龙,2022-06-13 14:37:02,1,2,1,虽然考试没有写完，但是老师人真的好好
155574,8180,徐万龙,2022-06-14 11:06:19,8,9,1,真的很爱很爱龙酱！激起了我对法学发自内心的热爱！四节课上的津津有味收获满满！到现在为止最最最喜欢的老师！！！
156011,8180,徐万龙,2022-06-17 05:51:16,4,5,1,很好很好的老师\n\n第一次在査老师上评分\n\n算是刑法的启蒙人\n\n学到了超级多
156388,8180,徐万龙,2022-06-19 10:17:59,7,8,1,相对来说比较年轻的老师，上课很有激情，干货超级多，刑总是大一下感觉教的最好的一门课了，有知识有情怀，每次下课都会留下来给同学们解答问题，还没出分，先来给龙酱点个赞
157892,8180,徐万龙,2022-06-25 10:38:08,1,1,0,very有趣的老师 very有趣的课 富有激情 讲解深入浅出 爱了爱了
158153,8180,徐万龙,2022-06-27 08:17:49,2,3,1,校内刑法讲得最好的老师之一了hhh
159900,8180,徐万龙,2022-09-08 12:42:41,4,4,0,老师下次改卷快一点就好了哈哈
162318,8180,徐万龙,2022-11-20 03:53:34,2,2,0,巨好无比
164020,8180,徐万龙,2022-12-17 10:18:58,2,2,0,老师博学，上课细致，也很有趣，会一排排提问，答不出来也没关系。上刑总收获很多！选他选他选他。我恨刑分不是他上
170444,8180,徐万龙,2023-03-05 03:44:46,3,3,0,庆幸在大学遇到了人生导师
172509,8180,徐万龙,2023-04-28 06:21:04,9,9,0,因为龙酱喜欢上刑法的，光华法学院最喜欢的老师，没有之一！学术有追求，教学有热情，对学生的期待也很高，对中国的司法也充满希望，希望龙酱能多开课，真的很喜欢！\n\n\n\n除了每次约饭都鸽这一点，真的很想打9分，最后还是打个10，毕竟给了我刑法96
174303,8180,徐万龙,2023-06-09 06:47:32,20,21,1,外专业的选了刑法总论，讲得非常好，学到了很多东西，是个有真才实学，令人佩服的好老师。（就是这学期期末考改成闭卷让我好痛苦）
174315,8180,徐万龙,2023-06-09 08:14:33,6,6,0,龙酱是比较年轻的老师，但是对于上课节奏和知识结构的把控都很娴熟，上课会举很多有意思的例子，四节课也不会觉得无聊，特别推荐！！！
174613,8180,徐万龙,2023-06-14 13:24:54,6,8,2,超级超级好，最后还和我们一起合影了
178986,8180,徐万龙,2023-08-13 12:54:39,12,13,1,先打个10分，然后静待老师出分中
179054,8180,徐万龙,2023-08-26 10:06:25,13,14,1,美美满绩了，龙酱我的超人！！！讲课又有干货又有趣，虽然从不点名但还是一节不落地停下来了！可以说是大一下上得最开心最充实的一门专业课，龙门！！！（同时再次求求龙酱开点别的课吧！！
179495,8180,徐万龙,2023-09-17 13:59:31,16,17,1,大四老狗第一次评分献给龙酱！\n\n框架感极强（ESTJ爱死了），适当拓展，引人入胜，想把他上课讲的每一个字都记下来的程度\n\n一学期刑总学下来整个人都升华了，好想一直一直跟着龙酱学刑法，只恨他秋冬学期没有本科生课程 ：(\n\n我爱龙酱我爱龙酱我爱龙酱，给他打一千一万十万分都不够！
180343,8180,徐万龙,2023-09-21 07:15:59,6,7,1,好好好好
181747,8180,徐万龙,2023-10-30 15:41:03,9,10,1,from外专业（一转法失败er），上学期上的线上班刑总，上课非常精彩，感觉是我为数不多能坚持四节课从头听到尾的一门课。可惜案例分析做的太差，期末卷面50分，但老师把总评直接调到了85分，还鼓励我继续学习以后可以考虑法硕......真的感动，必须10分！！！
184108,8180,徐万龙,2023-12-09 11:59:11,0,8,8,好有压迫感
184208,8180,徐万龙,2023-12-13 04:34:10,-20,11,31,不觉得过于神话了吗..
184329,8180,徐万龙,2023-12-17 13:26:07,12,18,6,说压迫感过强的同学，老师已经说了上课不点名，尊重个人自由的选择，但是既然来上课，老师提问问题增加课堂互动就不可以？而且答不上来也没有任何后果，这样也是压迫感过强？
186238,8180,徐万龙,2024-01-10 03:53:27,8,9,1,龙宝！！！！我的超人！！很可爱的老师，学到很多 \n\n能不能让他开刑分啊我要闹了
190671,8180,徐万龙,2024-03-14 03:28:22,8,8,0,龙酱我要像鬼一样缠着你55555龙酱没有你我的刑法怎么活啊龙酱龙酱555555
191650,8180,徐万龙,2024-04-26 16:46:53,4,4,0,老师上课很幽默，讲的很好，而且明确说不点名。
192979,8180,徐万龙,2024-06-01 14:51:04,3,3,0,因为龙龙爱上刑法了、、、我要当龙龙的学生啊啊啊啊啊啊阿
195039,8180,徐万龙,2024-06-26 12:59:53,9,9,0,好喜欢他的框架，听课听得很舒服，我不想毕业我还想听他的课我要凑齐4届九溪往事系列，还想写那些炸裂的人物关系的刑事责任，林泉坏、张曲坏、张康坏、龙好🥹
196053,8180,徐万龙,2024-07-01 09:59:38,8,8,0,龙酱没有你的刑法我怎么活呀，龙酱！
196214,8180,徐万龙,2024-07-29 08:05:31,-19,7,26,有点张扬
198659,8180,徐万龙,2024-09-10 12:23:05,3,4,1,龙酱上课不点名，讲课讲义丰富，知识富有体系，算是我这个学期收获最多的课程之一了。虽然最后期末考试难度不低，时间较紧急，但是在开卷的情况下，只要你认真听课，完成每次小作业（不上交且不计入总评），再做思维导图梳理一下庞大的课程内容，最后基本可以做到看懂采分点，并有层次地作答了。最后，谢谢龙酱给了我总评满分。。。龙酱再开一门刑分吧。。。。。
198727,8180,徐万龙,2024-09-11 06:43:01,4,4,0,吹爆龙酱！没有全勤龙酱的刑总真是我的损失。老师上课容量很大，逻辑很清晰，语言也很风趣，有的时候还会掺杂很多自己的人生感悟和法治思想，给刚入法门的小朋友一些基本法治观念的启发。龙酱每节课都会有大量的互动，开始上课前也会带大家复习之前学习的内容。很后悔没有一直跟着龙酱的节奏
201938,8180,徐万龙,2024-11-07 13:13:29,3,3,0,给我来上刑分！！！
205867,8180,徐万龙,2024-12-12 11:26:16,2,3,1,又要选课了，赶紧来评论一下。可以说重塑我价值观的一门课，第一次整个学期连上四节课而完全不开小差，大爱龙酱！
206835,8180,徐万龙,2024-12-18 00:52:04,1,5,4,给分烂
215051,8180,徐万龙,2025-02-20 10:08:35,2,5,3,给分好烂反正。
216170,8180,徐万龙,2025-03-11 12:31:00,1,4,3,非常非常好的老师！讲课条理清晰幽默有深度有思考，遇到的第一个让我喜欢上法学的老师
216930,8180,徐万龙,2025-03-29 08:29:18,11,16,5,终难逃浙大和女学生谈恋爱的魔咒
219203,8180,徐万龙,2025-05-23 03:23:03,0,0,0,喜欢🥺🥺
202824,8192,陈思,2024-11-14 14:55:05,-4,0,4,挺好的。
127772,8361,林洹民,2020-11-27 00:30:56,39,56,17,林老师讲课非常认真，与同学交流互动也很热心，学弟学妹要注意的是，课前预习习、掌握基础知识，才能更好地理解与消化老师的课堂讲授内容。另：林老师给分确实不太好
128184,8361,林洹民,2020-12-10 16:53:47,64,87,23,不错的！
128287,8361,林洹民,2020-12-16 12:55:02,68,99,31,小林非常好！上课极其认真，课件硬核 如果认真学习能学到很多很多东西。老师也很谦逊温和，再傻的问题也会耐心细致解答，还会因为没有及时回复邮件给同学们道歉。能感受到老师是真正地把学生放在心上！ps老师不喜欢加微信，有事最好都发邮件噢
128302,8361,林洹民,2020-12-17 05:24:39,39,58,19,老师很厉害也很谦逊，无奈研究领域真的太前沿。每次的扩展都很难，不预习很难跟上，不复习也很难消化。归根结底还是自己菜吧。
128303,8361,林洹民,2020-12-17 05:45:26,-40,19,59,讲一个很简单的规则却要举半天例子，然后在讲台上自导自演，把学生都绕进去……好不容易绕出来了才发现：擦，这不是两句话就能说清楚的事情吗？？？
128334,8361,林洹民,2020-12-19 04:12:13,50,71,21,良心老师，入股不亏
129248,8361,林洹民,2021-01-02 09:14:13,77,101,24,复习物权法之余来评论一下。林老师是正牌德系出身，案例式教学很有实务色彩，虽然有时会用理论（和冷笑话）把大家绕懵，但整体还是清晰有条理的。老师性格非常温和，不会批评人，只会一脸困惑地说“我没有听懂你的问题”orz。对网络法的扩展非常非常非常多，查了下论文好像是研究这个方向的？总之挺前沿的，课程难度就像楼上说的需要复习预习，但只要认真就能获益很多。最后求一个过呜呜(´;︵;`)
129365,8361,林洹民,2021-01-04 15:23:51,42,63,21,硬核不水，想学东西可选，混分请远离
129450,8361,林洹民,2021-01-05 12:46:27,82,109,27,最感动的始终是第一次发邮件问300字的问题然后收到600字回复的时候。哦还有认真提了教学建议后在下节课上就看到改变了！是特别尊重学生想法、重视学生意见的老师xD\n\n补一句，踏踏实实学的分数都不低吧。。
129530,8361,林洹民,2021-01-07 00:44:21,44,65,21,本学期收获最大的一门课！侵权真的讲的很详细清楚，唯一不足的是理论有时候讲的有点绕，对一个问题不会给准确回复。学下来需要课堂好好跟和课后复习完善下，对思维展开、硬核知识补充、其他课课程作业都很有帮助。不点名、可以逃课、论文考核、课件丰富详实又不啰嗦、提供题目答案供期末考试参考，给分也非常和谐。老师好像说下一届不教侵权了，真可惜…总之入股不亏！
129640,8361,林洹民,2021-01-09 15:07:34,36,54,18,要结课了好舍不得，老师穿西装好帅啊！！
129664,8361,林洹民,2021-01-10 11:19:00,40,58,18,很友爱的老师，西装革履和手中的一杯奶茶，颇有反差萌
129670,8361,林洹民,2021-01-11 11:17:35,32,48,16,我爱老师！！！
129987,8361,林洹民,2021-01-14 15:42:20,36,51,15,超级可爱，没有一点架子
130067,8361,林洹民,2021-01-16 08:42:09,30,49,19,老师超和蔼超负责，每节课都穿全套西装，对待教学很认真
130105,8361,林洹民,2021-01-17 05:39:28,58,78,20,感觉像是装成老师样子的学长哈哈。幽默和蔼，每节课都喝奶茶
130168,8361,林洹民,2021-01-18 11:06:25,60,80,20,物权法结课撒花！老师非常尊重学生，谦逊有才华还幽默！虽然教得难但是值得！
130349,8361,林洹民,2021-01-21 08:00:48,36,58,22,针不戳！课程内容丰富，从讲授中也能看出老师自由主义的精神底色。
132682,8361,林洹民,2021-02-03 09:47:39,41,57,16,老师人非常好，讲课有难度但是会学到很多！总之是非常可爱的年轻老师，大家不要怕！
133168,8361,林洹民,2021-02-12 15:21:21,32,49,17,可可爱爱
133205,8361,林洹民,2021-02-17 07:41:56,36,49,13,有点难，但是很认真，会捞人
133214,8361,林洹民,2021-02-18 09:40:59,-39,12,51,民法下绩杀
133409,8361,林洹民,2021-03-04 13:44:21,43,61,18,民法总论很有趣
133551,8361,林洹民,2021-03-02 05:07:09,42,57,15,正统德系，像个大哥哥一样特别亲切⸜₍๑•⌔•๑ ₎⸝
133766,8361,林洹民,2021-03-05 02:04:40,42,58,16,不错的
133772,8361,林洹民,2021-03-05 02:47:09,43,60,17,神仙老师
133985,8361,林洹民,2021-03-11 07:45:02,47,64,17,真的好可爱啊……
134055,8361,林洹民,2021-03-14 12:54:30,44,61,17,好喜欢听老师讲哲学和法制史，信手拈来的从容感，又很温柔不会让人觉得在炫技
134296,8361,林洹民,2021-03-23 03:03:12,51,72,21,民商法所很少见的低调谦虚和温和
137000,8361,林洹民,2021-06-29 09:43:22,45,54,9,1.不点名\n\n2.老师能力是肯定有的，德国博士，我上的是研究生的民法下，说实话，个人信息保护部分因为是他研究的领域讲的特别好，但是传统民法部分，对于研究生来说，上的其实不太好，部分地方讲授甚至有些拉跨，但可以理解，毕竟教书没两年，教龄太低了\n\n3.人品非常好，温和谦逊
138072,8361,林洹民,2021-07-07 09:06:45,36,49,13,神仙老师，好喜欢，可是自己民法学的很差，对不起老师
138143,8361,林洹民,2021-07-07 13:29:14,30,50,20,理想型，可惜是老师（哭了）
138378,8361,林洹民,2021-07-08 23:23:50,32,53,21,表白林老师！第一门满绩！
139238,8361,林洹民,2021-07-13 14:03:17,41,57,16,神仙老师  有人品性格好愿意给学生交流解惑有学识  是理想型了555555555555
139364,8361,林洹民,2021-07-14 19:35:14,33,49,16,老师人品很棒，会耐心给同学们解答，日常也很温柔。不过教学水平还有一点点不足，会感到有些许混乱繁杂，但综合我看了其他民法老师回放，可能这也是民法这门课本身的特色？
140122,8361,林洹民,2021-08-26 16:53:56,-17,43,60,楼上觉得混乱是民法特色的建议去听听法大刘家安老师的课，那叫一个通透，b站就有，混乱是老师授课水平有限
140179,8361,林洹民,2021-09-03 13:39:22,30,62,32,老师不点名认真上课 也坦承教龄较低鼓励听其他老师的课 为什么还有人在这里批评？
147440,8361,林洹民,2022-01-10 03:44:41,40,63,23,小林真的超好！
151956,8361,林洹民,2022-03-21 15:52:32,-14,63,77,上了这位老师研究生的民案课程，也感受到了之前评价同学所说的混乱。这种混乱一是表现在体系混乱，整个请求权基础分析框架讲得乱七八糟，无论德国教科书还是中国教科书都不是如这位老师所讲的那么随意，没有预选不按顺序那还学什么请求权，不如直接历史分析方法就行了吗？二是表现在逻辑混乱，有自相矛盾难以自圆其说的情形。三是讲解混乱，老师想表达的意思可能是10分，但说出来的只有5分。这些混乱实在不是用教龄低年纪轻可以开脱的，但凡认真备过课整理好上课的发言提纲都不至于在学生面前是这种水平。当然，这位老师曾在课上说过读了博士后就鲜有阅读教科书，不知是否也有影响（可以去看看智云）。\n\n顺便再说一下，老师的职责就是讲好课，这一方面不因为你是年轻老师就该放松要求，何况光华法学院民商法所多的是讲得好的年轻老师，另一方面也不是你让学生去听别的老师的课/给学生不错的成绩就足以掩饰自己能力的不足的。从给分好坏/做人如何给老师打高分我尊重，但这种讲课水平我只能实事求是地给出低分。
158597,8361,林洹民,2022-06-30 14:45:47,-12,1,13,123
165034,8361,林洹民,2022-12-28 14:01:02,-18,14,32,很尊重学生也尊重自己事业，有想法也温柔\n\n但在我们理解这个法条之前就开始一通分析最后结论是这个法条“删掉就好了”属实是有点emmmm
165944,8361,林洹民,2023-01-10 12:52:03,49,51,2,老师很认真 很可爱~
167013,8361,林洹民,2023-01-14 15:21:00,-48,13,61,为什么物权法只开一个班，小林讲课水平实在有待提高啊
170649,8361,林洹民,2023-03-07 14:05:09,-11,14,25,给分很好，讲课态度很诚恳，这一点承认\n\n但是授课经验不足，讲课水平有待提高，这一点也不能忽略
170692,8361,林洹民,2023-03-08 07:40:02,58,58,0,被狠狠地捞了
170988,8361,林洹民,2023-03-14 00:26:30,63,64,1,非常谦逊，非常温和的一位老师，虽然在课堂上一时确实很难跟上他的思路，但是在回头智云能够暂停思考记录的时候会发现小林老师其实讲的东西还是很有意思的，加上他真的非常为学生考虑，真的非常非常好
172172,8361,林洹民,2023-04-21 06:36:41,-49,7,56,…讲课很一般
172341,8361,林洹民,2023-04-25 07:38:34,45,47,2,非常亲和 讲得知识书本上都没有 但要有一定的基础...
173618,8361,林洹民,2023-05-30 10:45:53,36,36,0,上合同法上地想念老师
178099,8361,林洹民,2023-07-07 02:35:56,32,33,1,奉行自由主义的学者
178445,8361,林洹民,2023-07-12 00:57:16,32,33,1,穿西装好帅
178709,8361,林洹民,2023-07-19 03:24:41,30,31,1,大三就没有小林的课了…哭
178872,8361,林洹民,2023-07-27 01:26:17,25,27,2,该死的温柔
180536,8361,林洹民,2023-09-22 12:41:20,13,16,3,物权法蛮有趣的
181443,8361,林洹民,2023-10-18 01:49:24,12,15,3,老师西装好帅
182398,8361,林洹民,2023-11-15 13:07:52,-4,6,10,去年秋冬上的物权法，今年开年过来考的试，满了，还是有点意外的\n\n不得不说老师给分确实好，但是缺乏体系化是老师的一个问题：往往讲一个问题讲着讲着就顾不上整体了，这方面zc确实比林强些，不得不承认
182465,8361,林洹民,2023-11-16 08:05:10,10,14,4,讲得蛮清楚的，就是觉得老师每次看起来都很累..
183890,8361,林洹民,2023-12-03 01:50:41,-16,5,21,老师人很好，但讲课思路可以用乱七八糟来形容……
184012,8361,林洹民,2023-12-06 06:53:33,16,17,1,舍不得老师 呜呜呜
184540,8361,林洹民,2023-12-21 13:40:44,19,20,1,听说老师是被逼走的 是真的吗
184993,8361,林洹民,2023-12-25 08:46:42,8,8,0,5555555
185596,8361,林洹民,2024-01-02 13:37:59,15,15,0,老师真的很有自己的情怀
185606,8361,林洹民,2024-01-02 17:36:52,0,4,4,给个十分，林老师为人很好 感觉学术上也很有造诣。\n\n题外话，老师上课的新自由主义味有点重，某些观点不能完全苟同。
185608,8361,林洹民,2024-01-03 00:07:55,10,10,0,好喜欢老师
185631,8361,林洹民,2024-01-03 06:42:31,8,8,0,我爱老师 55555
186004,8361,林洹民,2024-01-07 12:36:32,15,15,0,在复习的时候重温老师讲过的案例，发现真的有很多实务上的技巧，受益匪浅，但是我还是把握不了体系。私密马赛，小林酱！！！
186036,8361,林洹民,2024-01-08 03:21:23,21,21,0,因为上课节奏和自己的问题上课的时候几乎没怎么好好听这几天在一节一节补智云 真的很感动 感觉小林是一个很悲悯对司法实践和国家景况都有很多想法并且愿意讲出来的人 让我这个天真的法学生能窥见真实社会的一角吧 很真诚的老师 不舍得他走
186559,8361,林洹民,2024-01-11 18:18:40,18,19,1,外专业选课，这学期很多次没去，老师点名频频不在，我很愧疚，深夜补课的时候觉来林老师是一位真正非常好的学者！是真正很好的法律人，讲到自己今晚精神不好，和大家道歉，很有自己的法律情怀！讲课确实感觉有点混乱，有些事情喜欢让我们去发散思维去想！这么好的林老师要走了啊！（浙大法学院你怎么谁都留不住啊）
186880,8361,林洹民,2024-01-13 10:51:31,10,10,0,老师真的很好，还没出分，按照我的真实想法来评价，感觉在大二有老师让我们利用法律的时候，小林让我感受到了法律人的情怀，很喜欢发散思维，感觉老师其实逻辑感很强，补天的时候深有感触。
187088,8361,林洹民,2024-01-14 11:46:09,17,17,0,老师谢谢您，祝您今后顺利~有缘再会~
187113,8361,林洹民,2024-01-14 13:35:26,16,16,0,舍不得林老师，很温柔很为学生考虑，学生提的意见都会认真考虑，讲课思维拓展也很多，谢谢小林！
189937,8361,林洹民,2024-02-03 06:10:39,10,10,0,很棒很棒  我爱小林
190673,8361,林洹民,2024-03-14 03:44:21,11,11,0,不知道说些什么，唉。个人认为物权法课程上的一般，体系性不如隔壁的班级。但是案例分析给了很耐心的指导，最后考试给了重点，给分也很好。\n\n看得出老师志不在此，既然决定北上，也祝愿老师得偿所愿吧！
190999,8361,林洹民,2024-03-28 00:52:22,18,18,0,祝小林老师未来前途似锦
191131,8361,林洹民,2024-04-07 14:21:03,19,19,0,小林别走...
197524,8361,林洹民,2024-07-18 03:33:47,14,14,0,小林未来一切顺利
200423,8361,林洹民,2024-10-17 02:18:02,14,14,0,民商法所容不下真性情的人
204230,8361,林洹民,2024-11-25 04:09:48,17,17,0,朱庆育走了，小林也走了，来了曹士兵当教授，等谷神退了，民商法就彻底废了
207401,8361,林洹民,2024-12-21 09:02:10,15,15,0,上山后特别想念老师…
216042,8361,林洹民,2025-03-10 02:09:22,-14,3,17,一边骂山上数据法治一边在这里怀念他，你们认真的吗？\n\n看看他最近发的文章呢……我只能说蛇鼠一窝，属实是狗咬狗。
216385,8361,林洹民,2025-03-15 06:03:00,15,15,0,楼下肯定没看过林老师写的文章，也没在智云上听过林老师的课
216929,8361,林洹民,2025-03-29 08:28:38,17,17,0,祝林老师在上海交大一切顺利~
218995,8361,林洹民,2025-05-17 08:15:15,10,10,0,小林也把我带去交大吧...
134929,9043,钱旭,2021-04-23 01:12:52,3,21,18,特别好！！
138073,9043,钱旭,2021-07-07 09:08:11,2,23,21,美女老师，太好看了吧，上课又活泼，也能学到很多国际法知识，虽然自己上法律英语的时候大部分时间跟不上
142536,9043,钱旭,2021-11-12 17:49:01,2,23,21,必须顶
153276,9043,钱旭,2022-04-27 10:44:45,3,17,14,姐姐人美心肠好（包括但不限于给分）
153282,9043,钱旭,2022-04-29 16:33:09,4,21,17,老师很棒！
153285,9043,钱旭,2022-04-27 11:35:22,4,19,15,钱姐人美心善，我敢说，她甚至比你自己更担心你的绩点，她的课，什么都别说，选就完了！
153444,9043,钱旭,2022-04-29 16:30:31,-3,16,19,必须顶
153857,9043,钱旭,2022-05-13 11:15:27,14,34,20,上课点名 不止一次
154449,9043,钱旭,2022-06-01 13:52:53,-2,9,11,Head count，case briefing and essay.
154451,9043,钱旭,2022-06-01 14:01:35,7,18,11,钱老师人很好的，讲课很知道怎么调动学生，花式点名几乎让到课率第一。\n\n如果老师能够把essay的deadline在结课后15天，我们就更爱了。
160897,9043,钱旭,2022-10-19 06:24:55,-12,6,18,授课内容就是读award，给分就是看眼缘，认她做导师这门课基本可以高分，但是很遗憾，这学期法律英语不是她授课了
163127,9043,钱旭,2022-12-07 14:27:46,-9,13,22,必须顶
164690,9043,钱旭,2022-12-23 11:46:58,-11,3,14,讲课比较无趣，作为通识课来说有点太硬了
171813,9043,钱旭,2023-04-06 09:11:07,-2,15,17,说好了没有平时分又临时搞什么到课加五分是想干嘛？
171891,9043,钱旭,2023-05-06 13:56:17,-18,12,30,就一碧池
172143,9043,钱旭,2023-04-20 11:08:29,13,19,6,老师很可爱很认真，而且是真心为学生好，就像她自己说如果有学生打电话问她生命的意义是什么，她会马上说你在哪我去找你。最后复习课也反复强调一些重点，是很有人文关怀的老师，很多问题都会站在学生的视角去考虑。\n\n希望考试老师多捞捞我！
172144,9043,钱旭,2023-04-20 11:48:47,-5,6,11,做事反复无常，说话前后不一致。上课念ppt飞速。内核不在乎学生，还拿我们当小孩以为我们能被哄住
172771,9043,钱旭,2023-05-06 13:58:25,-7,9,16,太沙杯了。。。说好的不点名，某个下雨天人来的太少破防了就点了，之后一节课又说自己完全不care同学们出去实习而翘课。我完全不介意点名的老师，但是出尔反尔、之后又如此之茶的老师，我见一个骂一个！
172775,9043,钱旭,2023-05-06 14:24:52,-3,5,8,说不点名但是点名
172853,9043,钱旭,2023-05-08 12:15:16,3,14,11,老师上课干货非常多，一个知识点会链接到许多内容上，听课的收获非常大，就是需要提前预习好！
173000,9043,钱旭,2023-05-11 04:36:45,-5,7,12,头一堂课说不点名，充分理解大家；后来有一节课下大雨，来的人有点少，老师可能有点绷不住点了一次，点到名字期末加五分。\n\n期末给分emm，懂得都懂吧。\n\n快逃……
173226,9043,钱旭,2023-05-16 06:27:47,2,12,10,点不点名这种鬼话还是别信了，老老实实去吧
174442,9043,钱旭,2023-06-12 07:46:53,-3,8,11,呵呵呵
174492,9043,钱旭,2023-06-13 05:59:31,8,22,14,上课有点水...不知道是不是之前上得太努力要求到课和互动被吐槽了所以开始水了...基本就是读ppt...
178788,9043,钱旭,2023-07-22 15:47:34,1,34,33,靠大佬进的浙大 直接博导
178836,9043,钱旭,2023-07-24 23:05:07,3,14,11,呵呵～
179014,9043,钱旭,2023-08-21 03:22:55,-1,10,11,授课水平很一般，感觉就没教什么实质性的东西，感觉框架很散很无聊
183335,9043,钱旭,2023-11-24 02:29:04,-3,9,12,华而不实
187222,9043,钱旭,2024-01-15 12:32:07,-23,6,29,我以为的法律英语课是比较实务，包括合同英语，结果上课就是在读award，毫无技术内容。还请同学起来读ppt，不知道的我以为自己是初中生。\n\n另外，我以为的浙大老师靠的是智慧。呵呵呵，反正就是没见过如此谄媚男同学，还很享受男生的视奸
189614,9043,钱旭,2024-01-26 03:30:06,-21,3,24,bdbd
190310,9043,钱旭,2024-02-28 01:17:05,-5,6,11,一言难尽
191539,9043,钱旭,2024-04-24 11:13:07,-12,5,17,黑龙江大学报复社会
191938,9043,钱旭,2024-05-06 01:47:01,15,18,3,这学期在学期初就说明了点名的时间点，只要那个时候到就可以。平时发言可以加5分，一次就够。主要还是英文比较难，在课前预习一下的话就能跟上老师的上课速度了。PPT内容挺有体系而且挺好懂的，最后的考试只要把课上的关键法条弄懂就可以了。钱老师真的很关爱学生，爱老师！
191939,9043,钱旭,2024-05-06 01:52:39,14,16,2,钱老师很好，鼓励同学们开口说英语，课堂氛围很轻松。钱老师的课付出就有回报，每节课按时去认真听讲，期末考试就没问题的。有一次下大雨，老师还说回紫金港的同学可以坐她的车回去。总之，好老师推荐。
192153,9043,钱旭,2024-05-10 06:17:14,12,13,1,点名，但会提前说是哪几节课要点，基本就是念一遍名单。喊人回答问题的话，感觉是叫熟悉的学生比较多。还有就是举手回答问题的同学。不爱上课互动，问题也不是很大，可能就平时分少一点点。期末试卷答得好完全可以拿到比较高的绩点。
197618,9043,钱旭,2024-07-22 08:32:54,12,13,1,老师特别漂亮，女神
198372,9043,钱旭,2024-09-08 07:46:33,9,10,1,好老师，认真负责有水平。
198510,9043,钱旭,2024-09-10 04:26:46,9,11,2,代了三堂国际法的课，水平很高，上课很有收获也不无聊啊啊啊啊啊。。。钱老师什么时候开本科生的国际法。。呜呜呜呜
198571,9043,钱旭,2024-09-10 03:57:07,8,9,1,钱老师上课水平挺高的，课堂互动多，很有意思，也会讲究知识点的融会贯通
198574,9043,钱旭,2024-09-11 10:41:19,7,9,2,Good!Good
198639,9043,钱旭,2024-09-10 09:50:19,5,5,0,听钱老师讲课还是很有收获的
198887,9043,钱旭,2024-09-12 12:18:37,0,5,5,思路清晰，上课有激情，认真负责的好老师
200424,9043,钱旭,2024-10-17 02:18:51,-17,7,24,b-i-t-c-h
201091,9043,钱旭,2024-10-28 11:12:54,3,5,2,上课干货多！课堂气氛也很轻松！老师真的很棒
208592,9043,钱旭,2024-12-29 17:01:33,5,6,1,法硕不点名，有节课只来了四个人也没点名，给分极好。
214187,9043,钱旭,2025-01-27 11:10:33,0,5,5,国际争端解决给分也太烂了
214196,9043,钱旭,2025-01-27 14:33:22,3,3,0,个人感觉很好，老师人很和蔼，从不点名，平时没任何作业，靠大作业轻松拿了高绩
217459,9043,钱旭,2025-04-10 16:03:04,6,6,0,上课逻辑特别清晰，发了好多高水平刊物
217517,9043,钱旭,2025-04-23 12:24:07,15,16,1,24-25世贸。课题要求：点名两次，第一节课就说了哪节课点名，按时来就能四十分到手（最后甚至只点了一次）。考试占比60%。事情少，上课认真听能学到很多，考试也不难。讲课是这些英语授课的课程里最好的。\n\n再说人，老师人很好，很漂亮和善，完全看不出评论区说的什么不在意学生之类的。不知道为什么评论区对老师的恶意这么大，对女老师极尽荡妇羞辱之词。靠关系之类的说辞不知道有什么证据，我感受到的只有讲课水平确实不错。\n\n上课认真听，期末认真复习，轻松拿了98，爱
217518,9043,钱旭,2025-04-12 05:53:16,6,7,1,老师挺好的，点名会提前说，除了期末考也没有别的作业，上课也比较清晰易懂了，总体还是比较推荐的，在全英文里是很不错的课程了~
217664,9043,钱旭,2025-04-15 02:38:27,4,4,0,上课真的思路好清晰啊，法律英语和国际法从不点名，基本功真扎实！
217962,9043,钱旭,2025-04-18 11:48:41,5,5,0,点名会提前说，讲课好，给分好，发邮件问老师问题也会非常温柔非常耐心回复你还会鼓励你，好课好老师
217968,9043,钱旭,2025-04-18 12:47:09,5,5,0,老师人美心善，世贸这门课有努力在考虑学生，非常好！
217982,9043,钱旭,2025-04-18 21:44:15,4,5,1,虽然上课有点喜欢东读一句西读一句可能全程听都会不知道讲到哪里，但基本没有其他事情，给分也很好
218013,9043,钱旭,2025-04-19 07:03:51,4,4,0,课是真的上的好，认真负责，有激情，干货多，强推！
218211,9043,钱旭,2025-04-22 05:31:18,5,5,0,老师很好，虽然点名但是会提前通知，期末考试前会带做一道60分的大题，涉及到的知识点好好看看就没问题！
219074,9043,钱旭,2025-05-20 16:07:10,0,1,1,老师点名，但是会提前和我们说；讲课很好，比法学院不少老师都强；给分很好，认真听讲、最后一节课的期末模拟仔细琢磨，就能有高分；老师人美心善，课后发邮件问老师问题老师还会鼓励笔记做得好，让人很有学习的动力，而且尽可能地减少大家的负担，什么小组展示乱七八糟的都没有，只要努力了就会有收获
141240,9047,蒋成旭,2021-09-27 05:16:17,15,17,2,老师人真的非常好
144828,9047,蒋成旭,2021-12-25 04:19:52,20,22,2,老师很棒，是俺的班主任，非常温柔
159191,9047,蒋成旭,2022-07-07 15:09:49,-17,1,18,。。。
135448,9059,魏立舟,2021-05-10 17:46:44,18,21,3,法律文献检索课不错
135975,9059,魏立舟,2021-06-07 05:44:41,-33,13,46,事儿妈一男的
136029,9059,魏立舟,2021-06-09 16:45:07,29,37,8,我是上法律检索课的学生，我想回楼上某个没礼貌的同学一句。我不知道老师哪里事多了，不就是上课要点名，而且，开课前两周事情说的清清楚楚，你要是觉得事情多，大可以退选，这门课本来就是选修课，实践课里还有很多可以选，没人逼着你选这门课。作为浙大的学生，麻烦以授课水平和专业能力为标准，出口成脏除了显示你素质堪忧以外没有任何作用
136577,9059,魏立舟,2021-06-21 07:59:18,-31,7,38,老师每节课都点名。\n\n上课内容还是比较饱满的。\n\n上课很无聊，尤其是请其他数据库的工作人员讲课更是无聊的不行。\n\n因为每节课都点名，所以到的人比较多，老师可能对自己的讲课水平有一定的误解。如果不点名，到课率应该低的很难看。\n\n课件偶尔会很大声音的放歌，老师认为有助于我们下午不难么困。但是有些同学可能觉得这是在强奸自己的耳朵。\n\n希望老师能够让课程增加一点趣味性。\n\n老师课上的事情比较多。\n\n某次上课把同学发给他的邮件，指名道姓的公布在课堂上点评，有的表扬，有的批评，对同学的隐私没有很注重。\n\n老师在第一节课推荐了一些软件，后来某次课还推荐了一些搜索功能等等。作为本科工科的同学来看，比较常见，有些甚至是常识。其他专业的同学可能有收获。\n\n总体给1分。课程内容还凑合。老师也有认真上课。嫌上课事多的，不要选。
140808,9059,魏立舟,2021-09-16 08:57:26,-22,4,26,事多分低，每节课签到每节课都去了，满平时分好好写作业换来了本学期最低分，很失望。
143548,9059,魏立舟,2021-11-26 11:08:38,35,38,3,我爱舟舟
143549,9059,魏立舟,2021-11-26 11:08:57,13,16,3,老师真的很好！推荐！！！
143550,9059,魏立舟,2021-11-26 11:09:25,13,15,2,老师很好，推荐👍
145712,9059,魏立舟,2021-12-31 12:19:18,16,18,2,上的是知识产权的课，虽然趣味性不强，但是干货满满，层层深入。只要认真听进去了，是能感受到老师的用心的~好评~
151490,9059,魏立舟,2022-03-04 15:52:59,25,25,0,班主任，带我们团建玩狼人杀，高手：）
154547,9059,魏立舟,2022-06-02 06:00:36,3,4,1,肥肠面
163286,9059,魏立舟,2022-12-12 05:45:45,-7,4,11,事情真的很多
163587,9059,魏立舟,2022-12-15 12:23:32,15,16,1,用心对待教学的好老师
165328,9059,魏立舟,2023-01-01 03:28:35,7,9,2,我喜欢 舟舟
165356,9059,魏立舟,2023-01-02 12:05:32,10,11,1,老师上经济案很认真负责！
166805,9059,魏立舟,2023-01-13 15:54:06,30,32,2,这学期知产感觉收获最大，最后考试题目虽然是开卷，但感觉只有真理解了才能答好。老师666
171596,9059,魏立舟,2023-03-29 16:58:03,23,24,1,舟舟好好我好喜欢啊啊啊啊啊啊啊啊啊啊啊啊啊啊舟老师！
172118,9059,魏立舟,2023-04-20 02:34:46,62,64,2,课堂质量、人品都满分
179475,9059,魏立舟,2023-09-16 15:55:24,22,24,2,风趣幽默，理解学生
184260,9059,魏立舟,2023-12-14 06:35:06,-47,7,54,不如自己看书
185357,9059,魏立舟,2023-12-28 08:04:24,3,9,6,要是能按时下课，不拖堂就更好了。（永远赶不上校车）
189974,9059,魏立舟,2024-02-05 03:14:04,34,35,1,备课很认真很用心，这学期收获最大的课程。
189985,9059,魏立舟,2024-02-05 17:23:44,31,31,0,教学能力法学院前五，课堂干货满，逻辑清晰。点名会提前通知，总体上课体验舒适。开卷，知产期末考试难度较高，给分较客观。
199976,9059,魏立舟,2024-10-10 05:25:24,26,26,0,上的是知产，备课用心（和法学院某些老师对比鲜明），可以看出很用心在讲好课，内容饱满，逻辑清晰，为人温和幽默，且点名会提前告知，不会突击点名。但就算不点名，也想每节课都来的
208513,9059,魏立舟,2024-12-30 08:43:57,9,9,0,人好水平高，魏老师是硕博lmu，而且是马普所挂在lmu的，懂得人应该都知道含金量吧。跟这样的老师多多交流对法学学习和未来规划都是有极大帮助的。
209132,9059,魏立舟,2025-01-04 15:15:15,8,8,0,老师点名，会提前通知。\n\n知识产权法课程压力比较大，上课全部都是干货，期末背了一斤书去教室。而且这一届（至少我体感）期末答卷压力非常大，五道大题每个小问都有独立情景，考试延迟交卷10分钟还是有很多人没写完，希望老师能捞捞吧QAQ
212770,9059,魏立舟,2025-01-15 01:18:55,6,6,0,老师讲得很好！！上课水平一流的，跟着老师上课能跟着老师的思路把知识点串一遍，比自己盲目地看书效果是要好的。期末的题量有点多，虽然多给了10分钟也有点紧张的。不过老师应该算是捞了hhh谢谢活菩萨
212828,9059,魏立舟,2025-02-16 14:31:24,6,7,1,好老师，推荐，很幸运本科遇见
213259,9059,魏立舟,2025-01-16 13:21:19,8,11,3,备课非常认真，ppt贼精美，讲课全是干货。(与某Z姓老师形成鲜明对比。)\n\n课程压力较大，但能学到东西。\n\n期末考试有难度，但老师会捞人。\n\n为了知识的完整性会无偿加班补课，考完试怕我们理解的不对还给分析试卷，这样的老师不给10分我很难想象什么老师能拿到10分。
214139,9059,魏立舟,2025-01-25 08:16:00,4,5,1,无可指摘的好老师
214691,9059,魏立舟,2025-02-17 00:44:39,10,10,0,特别好的老师，讲课很清晰、知识量大而且很幽默、有意思，上课三年来老师做的PPT是最用心最清晰最好看的，哑着嗓子也要尽力给我们上课直到声音发不出来实在没办法上课了，课后发钉钉找老师老师也特别和蔼特别好；考试会比较难但是老师会深海打捞，只要把老师上课内容掌握好就能拿到不错的分数。可以感受到老师是一个学术造诣深厚的学者、一个热爱教学、教学能力突出且善良幽默的好老师，希望老师能多开几门课完全听不够啊啊啊啊啊（老师不是很想讲反不正当竞争法吗，能不能再开一门反不正当竞争法的课）
219077,9059,魏立舟,2025-05-20 16:32:27,4,4,0,又到有学弟学妹们来咨询选课的时候了，再来给魏老师打个广告，光华法学院顶级好老师，一年之后就毕业了，不选魏老师的知产真的是一件很令人遗憾的事
221740,9059,魏立舟,2025-06-25 22:27:27,2,2,0,老师的毕业致辞太走心了！给困顿者以力量，予迷茫者以希望。母校，再见啦！
151431,9077,周翔,2022-03-03 06:49:30,11,12,1,。。。
151843,9077,周翔,2022-03-17 08:00:57,15,16,1,挺烦的
151846,9077,周翔,2022-03-17 10:19:27,10,11,1,哎哎哎为什么要有这门课
152215,9077,周翔,2022-03-31 04:50:10,36,40,4,江湖术士，上课连衬衫都没塞好就出来吹逼
152239,9077,周翔,2022-03-31 05:59:52,57,61,4,不会教可以别教 也没见有多少学术水平还敢站在台上夸夸其谈 在座的学生确实没你脸皮厚
152240,9077,周翔,2022-03-31 06:07:41,25,27,2,讲课全是胡吹
152245,9077,周翔,2022-03-31 06:53:08,32,35,3,这老师真的知道职业伦理是什么吗？反正什么都讲，就是法律职业伦理不讲。
152258,9077,周翔,2022-03-31 14:31:13,25,27,2,属于是既不懂法律，也不懂法律职业，也不懂职业伦理
154550,9077,周翔,2022-06-02 06:06:54,-3,1,4,考试啊
160900,9077,周翔,2022-10-19 02:11:56,14,14,0,老师简直太有意思了。说了解大四同学的状态，点名会提前说。结果他提前说要点名的课都没有点名，连续三四节课均是如此。紧接着在三四节课后没说的下一节课上突然点名。不说法律职业伦理有没有，就是可能伦理就差一些。课长得也乱七八糟，属于是上思政课还是最不舒心的那种类型。老师歇歇吧。
161276,9077,周翔,2022-11-03 07:42:29,10,11,1,爱点名的老师一枚呀，尤其是点名的方式还莫名其妙，不得不赞叹一声绝绝子。
163272,9077,周翔,2022-12-12 02:23:59,11,11,0,爱点名，说理解大四学生但其实压根不理解，给分还特别差。
163296,9077,周翔,2022-12-12 08:22:08,-18,2,20,老师给分真的很好，课程任务很少，大三的可选
163297,9077,周翔,2022-12-12 08:27:42,-13,4,17,老师给分好好！！虽然上课比较无聊
163298,9077,周翔,2022-12-12 08:32:44,-12,4,16,给分很好！上课虽然有点无聊但法律文书这种内容也很难有趣的上来，能看得出来老师在努力提高课堂参与感（虽然效果有限），最近点名也可以理解毕竟没有考试，作业只有一篇文书
163353,9077,周翔,2022-12-13 12:11:40,10,10,0,魔幻点名，给分垃圾
170974,9077,周翔,2023-03-13 13:22:03,-16,4,20,给分高！老师人好大方
179583,9077,周翔,2023-09-18 11:49:39,8,8,0,啥彼～
179584,9077,周翔,2023-09-18 11:54:17,5,5,0,呵呵呵呵呵
180877,9077,周翔,2023-09-27 12:03:33,5,5,0,。。。
181387,9077,周翔,2023-10-16 09:35:43,13,13,0,就是一2货
181448,9077,周翔,2023-10-18 05:24:35,15,15,0,我想他一定是疯了，对大四同学的难处毫无体谅。。。
181482,9077,周翔,2023-10-19 01:36:44,25,25,0,极水…上课拿大数据模型写通讯稿，硬生生水到下课。法律文书上了半学期也没讲什么实质内容。以为会有说理分析，结果全是注水+扯+让学生读文书，可能这门课根本就不应该开吧……也或许是他真的不想上这个课
181649,9077,周翔,2023-10-25 08:02:31,14,14,0,你甚至不能自学，只因他喜欢突击点名
181958,9077,周翔,2023-11-06 12:25:56,34,34,0,严重损害了学生们的预期利益……我只剩三天时间写论文，所以也给你打三分吧（微笑）
182018,9077,周翔,2023-11-08 06:47:15,19,20,1,什么傻逼玩意，大四天天点名，傻逼傻逼傻逼
182024,9077,周翔,2023-11-08 09:04:17,18,18,0,烦他:(
182057,9077,周翔,2023-11-09 06:55:53,20,20,0,老师，你不适合教书
182162,9077,周翔,2023-11-11 05:28:25,21,22,1,挺好笑的，法律职业伦理和法律文书这两门法律职业核心课程是由一个既没有法学本科学位、也没有什么司法实务经验的老师来教的...天知道法学院怎么设计的课程啊，能不能用点心
183755,9077,周翔,2023-11-29 15:12:12,25,26,1,如果一个房间里有希特勒，墨索里尼和周翔，给我一把枪和两颗子弹，我会杀周翔两次。
184118,9077,周翔,2023-12-10 01:59:29,20,20,0,If Hitler， Mussolini and Zhou Xiang were in a room and I were given two bullets， I would shoot Zhou Xiang twice.
184972,9077,周翔,2023-12-25 02:49:37,13,13,0,法学院有自己的Mario Circelli
185370,9077,周翔,2023-12-28 12:06:35,11,11,0,煞笔*
189726,9077,周翔,2024-01-27 15:36:22,16,16,0,《法律文书》的课程体验用两个词形容，只能是文不对题和不知所云。老师课程伊始告诉同学不想讲授传统的文书格式、标点云云，希望在教学内容上标新立异，融入数字法学相关内容，这倒也可以理解，但令人咋舌的是，后续的课程完全靠全班同学轮流阅读文书内容来推进。每次同学阅读完收到的点评也往往无关痛痒（与其谓之点评，不如称之插科打诨或者牢骚），一学期上下来收获不大。\n\n23-24秋冬的课程作业为选取老师课上提到过的某个选题撰写研究报告（这一届会有同学在期末前整理汇总，作业要求有点为老师个人科研“推波助澜”的意思），最让人震撼的是这届出现了提前ddl20多天的惊世骇俗之举（详见本条之前评论），给分从身边同学感受看似乎也比较迷，建议学弟学妹谨慎选择。
190675,9077,周翔,2024-03-14 04:20:50,16,16,0,朗读者周翔
190813,9077,周翔,2024-03-20 04:15:15,28,28,0,If Hitler， Mussolini and Zhou Xiang were in a room and I were given two bullets， I would shoot Zhou Xiang twice.
190958,9077,周翔,2024-03-25 15:33:30,12,12,0,要是没有b站左宁大舅我刑诉就完蛋了
190976,9077,周翔,2024-03-27 04:09:50,22,22,0,教材或许写得不够周详，但你念的绝对周翔
190996,9077,周翔,2024-03-28 00:43:10,28,29,1,支持无限收敛于1的顶我上去
193300,9077,周翔,2024-06-06 04:20:26,9,10,1,法学院有您这种老师真是…不幸
194091,9077,周翔,2024-06-22 02:55:47,4,8,4,虽然但是，老师给分很好，也没有额外的作业负担
194122,9077,周翔,2024-06-22 14:07:51,5,7,2,5分，这学期刑诉给分挺好的，有一个简答题不会做最后上4了，而且没有作业，就这门课来说的话不至于壁垒\n\n\n\n讲课和发言是有点难评，不听就行了，刑诉的话纯背诵工程
194162,9077,周翔,2024-06-22 09:42:30,1,5,4,老师给分很好，虽然课确实上得比较发散，但是考前会给重点（基本可以在hm老师的教科书上找到），试卷的客观题和简答题非常简单，最后的论述题考前对照重点理一遍教科书的内容就可以了。ps：助教老师人很好，考前会带过一遍重点；pps：老师好像以后都不教法律职业伦理，会在刑诉常驻？
194466,9077,周翔,2024-06-24 05:12:00,2,7,5,刑诉好好背，给分挺好的，助教老师也很好，超级有耐心。
197566,9077,周翔,2024-07-29 13:40:42,14,14,0,If Hitler， Mussolini and Zhou Xiang were in a room and I were given two bullets， I would shoot Zhou Xiang twice！！！！！！！！！！\n\n人如其名，上课是“翔”一样的体验
197734,9077,周翔,2024-08-06 06:32:17,-9,2,11,给分确实好 助教gg也很好
201766,9077,周翔,2024-11-06 04:43:12,-10,4,14,这个老师小红书有号，讲了不少干货，本身是有能力又有机遇才来到浙大。讲课不予置评。
207399,9077,周翔,2024-12-21 08:59:17,11,11,0,聊骚1米8女学生反被鄙视，笑死
208422,9077,周翔,2025-01-01 15:43:36,8,10,2,谁拉讲台上了？
209980,9077,周翔,2025-01-07 17:41:22,3,6,3,一人得道，答辩升天。有个好老师叫胡铭
213734,9077,周翔,2025-01-19 10:38:08,2,4,2,虽然有些地方确实很难评，但还是忍不住说一句：法律文书在四门实践性课程里面，应该是断档最水最轻松的一门课了（其他那几门基本上是累到要骂人的程度）。如果想选事情少点的课的话这门课please don`t hesitate。给分中规中矩。
215737,9077,周翔,2025-03-05 03:26:52,6,6,0,听说要走？不送~
217901,9077,周翔,2025-04-17 18:07:00,2,4,2,搞数字法学的人里真的懂数字的就他和新老师吧
219763,9077,周翔,2025-06-05 08:33:12,3,3,0,垃圾中的垃圾
178816,9525,郭栋,2023-07-24 08:29:35,15,21,6,学品人品俱佳，爱护学生
178899,9525,郭栋,2023-07-30 02:47:10,2,8,6,学术能力可以，上课一般
179237,9525,郭栋,2023-09-01 02:49:25,11,15,4,老师很年轻，学养深厚，为人和善，上课很有激情，信息量很大
179344,9525,郭栋,2023-09-12 07:47:20,13,15,2,超级棒的老师。很有学术情怀和法治理想，力荐！很期待听到郭老师的法理学课
179345,9525,郭栋,2023-09-12 07:52:20,15,19,4,非常喜欢郭老师！学术超棒，讲课超棒，对学生超好
179347,9525,郭栋,2023-09-12 08:52:31,14,18,4,郭栋老师学识渊博、成果丰硕，上课旁征博引、引经据典，让我学到了很多，也对法理学产生了学术兴趣。郭老师也一直希望能开一门法理学的课。希望郭老师能多开课！
179357,9525,郭栋,2023-09-13 01:49:11,7,9,2,听老师上课能感受到老师非常有自己的想法，学识渊博，对学生也很好！
179358,9525,郭栋,2023-09-13 01:58:03,6,8,2,郭老师上课不仅有理论，还会给我们讲很多故事，用案例来吸引我们思考，并得出自己的结论。小班教学上互动比较多，但老师也不会强cue，对不同学生风格有比较大的包容力.
179359,9525,郭栋,2023-09-13 02:13:34,10,12,2,上过郭老师的法律职业伦理课，学术性和故事性兼备，非常引人入胜！对学术感兴趣的同学能从老师对这一概念的归纳整理中学习系统而非碎片的知识，并有一套比较完整的知识考古和理论脉络梳理，每一处都有引经据典和翔实的材料。对学术不感兴趣的同学也能在老师幽默风趣的故事中了解到条文规则以外的法学与法律，而不只是枯燥干瘪、大而空洞的理论。在法教义学、法哲学大行其道的法学院中，郭老师也是非常难得的社科法学派，理论之下全是切实发生在这片土地上的事，而不是与中国传统不那么兼容的西方法学。他会带我们看到不受规则注视的现象，以及在金规铁律夹缝中生存的群体。说郭老师的课是法学院最具人文关怀的课也不为过，他不止教授知识，还引人深思、助人成长。\n\n另，给分也很好啦～
179363,9525,郭栋,2023-09-13 03:50:21,11,13,2,法学院自己培养出来的年轻老师，思想非常的开放并包，这几年真正的青年大牛！上课非常好！马上要开法理学课啦
179369,9525,郭栋,2023-09-13 09:22:18,6,8,2,儒雅随和，知识渊博~
179434,9525,郭栋,2023-09-15 09:58:15,6,10,4,郭栋老师是学院新引进的百人研究员，也是最年轻的博导，水平很高。上课也很认真，法理学很有趣。
179435,9525,郭栋,2023-09-15 10:04:37,6,8,2,小硕第一次接触法理学就是郭老师的课，和我以前上过的法理学完全感受不一样。太喜欢法理学了
179440,9525,郭栋,2023-09-15 11:56:30,3,5,2,郭老师人很好，上课很有精神，对学生也很有耐心。
179447,9525,郭栋,2023-09-16 02:44:26,3,7,4,在老师的笔下和口中，法理学妙趣横生，刷新了我对法理学的刻板认知，期待老师开一门《法理学》的课，出一本《法理学的想象力》的书
179924,9525,郭栋,2023-09-20 03:51:42,1,5,4,法谚道：法理学是无用之学。这是一个伪命题，有没有一种可能，不是法理学无用，而是教法理学的某些人没用（心）？与其说是无用之学，不如说是无聊之学。郭老师让法理学无聊变得有话聊。法理学是关于法律和xx的学科，是研究部门法所不研究的学科，故而有无限可能。法理学当是z世代的学科，需要以郭老师为代表的年轻老师和学生们共同成就和创新。
180072,9525,郭栋,2023-09-20 13:33:48,0,4,4,栋栋老师YYDS
180509,9525,郭栋,2023-09-22 05:57:23,6,20,14,怎么九月初突然请了那么多水军刷分。。。
180680,9525,郭栋,2023-09-25 00:51:50,0,5,5,郭老师一直想独立开一门法理学课，希望他能遂愿
180900,9525,郭栋,2023-09-28 03:20:08,0,6,6,难得的一位好老师
180970,9525,郭栋,2023-09-30 02:00:41,1,6,5,将情怀和专业结合得如此之好，小郭老师非常棒~
181240,9525,郭栋,2023-10-12 03:50:31,2,8,6,政治立场居中，学术水平很高，对学生特别好~~~
181788,9525,郭栋,2023-10-31 17:49:50,0,5,5,希望多开一些课
182061,9525,郭栋,2023-11-09 07:37:36,5,9,4,听了郭老师“法治的基本原理与中国问题”主题的法理学课，我挺受触动的。课上老师讲了“宪政” “三权分立”的概念起源和发展，经过概念的剖析才会了解到我们的宏大叙事在对什么进行回应、在跟什么进行斗争。探求概念本身是一种研究方法，概念是一种表达，但是它又能够很深刻地影响到实质，影响到我们的制度；我算是开始破除一种迷思，比如之前也读过主张党政分开的文章，但只是简单地把结论记住了，没有思考“他真正在谈什么”，这种思想真的可行吗。从无意识到有意识，可能就是建立文化自信的开始吧。总之，还是很感慨，原来思政主题也是能讲得有意思的…
182080,9525,郭栋,2023-11-14 02:01:58,0,5,5,老师理论水平很高，对学生很随和，不爱点名，给学生充分的自由度，法理学界第一个90后博导，青年大佬
182471,9525,郭栋,2023-11-16 08:54:17,0,4,4,郭老师讲课很认真，对教学工作很投入，学到了很多
182605,9525,郭栋,2023-11-19 03:22:21,0,6,6,很好的老师
183824,9525,郭栋,2023-11-30 13:10:32,0,5,5,理解学生，老师学问和为人都很好，推荐
185479,9525,郭栋,2023-12-30 08:45:45,0,4,4,老师很不错，给分也好
190411,9525,郭栋,2024-03-01 09:05:06,0,4,4,郭老师教学认真细致，对待学生很宽厚
190799,9525,郭栋,2024-03-19 14:03:08,2,8,6,大二来旁听郭老师给大一新生上法理学【给本科生开法理学也是郭老师的“梦想”，如今梦想成真】，体验非常好，课上很多干货。感觉和其他的法理老师授课风格很不一样，可以说其他老师上的是“XX老师的法理学”，而郭老师上的是真正的“法理学”，它让初入法学大门的学生看到了属于法理的一片海洋，而且是非常宽阔的海洋，而且老师政治立场居中，具有很强的质疑和反思精神，经常会带着同学们一起探寻某种制度、学说的由来发展。课程好像是没有考勤，上课也不爱点同学起来回答问题；课后问问题、交流什么的人也很随和、平易近人。小声说一句，选他做本科导师srtp不用愁【笑】，而且他还会经常请带的学生吃饭。
190984,9525,郭栋,2024-03-27 11:08:09,-3,2,5,老师挺好的。我上的思政课，老师对zz和法律的讨论方式有点奇怪但很坦诚。不怎么认同老师的一些观点、
193860,9525,郭栋,2024-06-20 10:05:41,3,9,6,听郭老师的课，能够切身感受郭老师对中国法治现状和未来的希望以及担忧，是一种发自内心、源于热爱的牵挂和不安。但是又会被郭老师那种“一个真正的理想主义者首先应该认清现实”的坚定感动。这样年轻的老师，能有如此深厚的情怀，令人动容。
197105,9525,郭栋,2024-07-07 17:14:55,16,17,1,给分一般….会给你他给分很好的错觉….
197142,9525,郭栋,2024-07-08 05:55:35,13,15,2,给分烂….上课无聊…选到他法理的小心点
197159,9525,郭栋,2024-07-08 08:53:57,11,11,0,给分比起其他专业课真的一般，拼盘课只考自己讲的内容
197207,9525,郭栋,2024-07-09 06:15:47,11,15,4,习法概绩点二开头……虽然是水过来的但是罪不至此吧……不敢想象我的卷面发生了什么😇
197617,9525,郭栋,2024-07-22 08:08:10,-1,5,6,大师级的人物，前途不可限量
197816,9525,郭栋,2024-08-15 09:20:58,0,7,7,老师人很好，给分也超好
208535,9525,郭栋,2024-12-29 05:41:30,-3,4,7,好老师啊！第一，人非常好，私下问题非常热心回复；第二，教学方式上，上课不点名并且鼓励大家通过多种方式学习法理学，而且也会认真授课，没有很多小组展示；第三给分也很好，平时分不点名直接给满，最后绩点也很好。习法概也是他的，真的带PPT就可以，推荐选啊！
214963,9525,郭栋,2025-02-19 13:28:52,-5,5,10,看到评价里有一条造郭老师黄谣的，“听说什么什么”真的是流氓说法，要么你是当事人，要么你有证据，在无根无据的情况下信口诽谤让人感觉心理上很恶心，那我还听说你好像因为强奸被判过刑呢。在这种查老师公公共平台评价的是老师的课程水平，你在这边造黄谣不用承担任何责任嘛？
215772,9525,郭栋,2025-03-05 11:24:45,-5,2,7,虽然老师说习近平法治思想概论不只是一门思政课，但感觉是目前上过最好的思政课了，有很多收获
217142,9525,郭栋,2025-04-02 12:32:22,4,5,1,拖堂！！！！！！！！！！！
218454,9525,郭栋,2025-04-23 16:08:57,4,5,1,连郭老师这么好的人都被造黄谣，真的坚定了我这个老博不进高校不当老师的决心。
221307,9525,郭栋,2025-06-23 00:48:58,1,2,1,习法概\n\n优点：给分好（我自认为），平时没怎么听，最后凭借发的ppt是满绩，我课程论文选题是老师上课提到的重点，领导干部先守法；哪怕是思政课也是我上过最好的思政课，一些观点让我大开眼界，而且授课很认真。\n\n缺点：会拖堂，但没什么关系，老师不点名，听智云也可以；期末发的集合版ppt是图片类型，而且字很小，打印的时候很麻烦；期末的题目如果是郭老师自己讲过的内容会难一点，ppt上找不到答案，要自己提炼，别的老师讲过的内容可以直接在ppt上面找到。\n\n郭老师人还是很不错的，上课没什么架子，最后一节课也让大家提意见改进课堂，至于跟女学生的事我确实没听说过，这东西还是得小心求证吧（怎么感觉法学院老师有这么多人有类似传闻的）
221310,9525,郭栋,2025-06-23 01:26:35,1,1,0,习法概，从不点名。上课回答问题有加分，期末考试的话会捞，期末考试的题目是ppt上的，但是只找到题干找不到答案（笑），所以我推荐ppt+书一起带上，如果时间充裕可以稍微准备一下PPT里面的东西。\n\n25年春夏题型：一切纸质资料可带（开卷）简述题5，辨析题5（古今中外名人名言，不知道是不是），材料题2，拓展题1（考的是习近平法治思想的再发展），思辨题1，最重要的是十一个坚持（体系化整理解读）\n\n题量贼大，感觉写不太完，材料多，合理安排时间。
221392,9525,郭栋,2025-06-23 07:39:56,0,0,0,给分很好！
180718,9551,陆家豪,2023-09-25 09:19:29,5,16,11,我舍友导师 满分不解释
181992,9551,陆家豪,2023-11-07 12:54:36,6,23,17,王利明弟子。梁慧星在我校讲座时，扶着梁老入座。若干年后，或可传为佳话。
182195,9551,陆家豪,2023-11-12 09:14:29,3,11,8,陆老师讲课很好而且人品真的很好
182655,9551,陆家豪,2023-11-19 03:34:47,-4,5,9,还可以
184038,9551,陆家豪,2023-12-07 04:00:08,0,12,12,这都啥..
184148,9551,陆家豪,2023-12-11 06:15:26,17,35,18,这么好的老师哪里找，课件详细，体系完整，又有老师自己的观点讨论，这么好的老师真的很好
184149,9551,陆家豪,2023-12-11 06:24:18,0,6,6,很好的老师 讲课很易懂
184158,9551,陆家豪,2023-12-11 11:51:56,0,6,6,老师讲的很好，也很认真，水平也很高
184258,9551,陆家豪,2023-12-14 06:01:35,2,15,13,只有我觉得乱吗。。
184306,9551,陆家豪,2023-12-16 09:03:12,4,11,7,老师备课很认真！是很年轻的老师，有时问题没有讲清楚经过一个下课之后又会再讲一遍，感觉体系挺清楚的！人品很好，很可爱
184513,9551,陆家豪,2023-12-21 08:16:55,3,9,6,非常好老师 满分不解释
184541,9551,陆家豪,2024-01-10 03:59:33,-4,18,22,三本水平
184601,9551,陆家豪,2023-12-22 02:29:12,3,9,6,人超好，超有趣的老师，讲课比较呆但是能让人听得进去
184629,9551,陆家豪,2023-12-22 03:59:38,4,11,7,债总+一节民总代课。老师人真的很好，备课很认真，有理论案例有框架，也不点名，没有小测。答疑什么也很认真。可能理论性会比较器，民总基础没打好来听会有一些难，会讲很多比较法内容，可以结合zjh老师的体系整理，但是不妨碍老师是个好老师。
184732,9551,陆家豪,2023-12-26 12:33:52,7,29,22,哇 这么好的老师 谁打的低分 没品的东西们
185094,9551,陆家豪,2023-12-26 07:54:47,4,12,8,非常非常好 无论是讲课还是人品
185103,9551,陆家豪,2023-12-26 09:35:32,2,7,5,超级好老师！
185632,9551,陆家豪,2024-01-03 06:43:19,0,10,10,就是不喜欢
186223,9551,陆家豪,2024-01-09 16:11:31,1,5,4,可爱有趣的老师！回答问题特别耐心，人真的很好
186229,9551,陆家豪,2024-01-09 16:12:11,0,4,4,超好的老师！
187251,9551,陆家豪,2024-01-15 10:11:00,5,9,4,是年轻的新老师，但是讲的清晰多了！很适合本科生~ 我是隔壁班的债法，但是一节不落地听完了家豪老师的智云，圣诞节还有糖吃，馋哭了隔壁班小孩
187529,9551,陆家豪,2024-01-16 12:36:38,1,5,4,只上过一节债法原理+邮件\n\n老师很帅 声音很好听 讲课很有办法 循循善诱 很善良 邮件回复的很认真
189673,9551,陆家豪,2024-01-26 14:26:18,4,6,2,老师人很好   上课感觉也很捞   但是你给分真的可以好一点吗55555
189722,9551,陆家豪,2024-01-27 14:11:55,5,14,9,比起有的老师有平时作业什么的，或许平时没作业没签到啥事也没有的课，如果平时分不给大家一样的分数，甚至不给大家满分，都挺不合理的，\n\n\n\n老师您说大家平时分基本都给到了九十分以上，可是在平时没作业没签到的情况下，之前的专业课老师都是平时分给满的（好吧也有可能是之前的老师们人太好了，但是您既然没有提前告知平时分组成，平时也没有衡量的一个标准，凭啥子扣我们平时分呢？），而且没作业没小测没点名，“’基本上’都给到了90分以上”，您给出的同学之间的分差又到底是以什么标准给的呢？？？凭看谁的名字更舒服？？？还是什么？？？院长班可是有作业和小测的啊\n\n\n\n之前一门专业课的老师平时有多次小测和一次作业，但是最后平时分拿多少我们真的都心服口服，而且大部分同学凭借自己的努力平时分没扣分或者只扣了一分呢\n\n\n\n我倒是宁愿您有作业让我们平时做之类的，平时有个衡量的标准和同学之间对比的尺度，分数把握在自己手里，而不是空洞的“基本给九十以上”和“应捞尽捞”
189740,9551,陆家豪,2024-01-28 05:52:00,2,7,5,教学态度与专业能力均值得我们学生学习！感谢家豪老师认真备课积极答疑嘻嘻~
190416,9551,陆家豪,2024-03-02 06:18:18,7,9,2,通俗易懂，有深度也会讲解，比一些只会念书的所谓大佬好。说实话，学院里老师们上课水平和科研水平不能完全划等号
190506,9551,陆家豪,2024-03-06 11:06:43,1,3,2,超级细心的老师！会很认真地答疑！
190657,9551,陆家豪,2024-03-13 12:42:24,2,4,2,上课超级细心，讲解能力很好，起码上课能听懂hhh。课后答疑超级超级认真，老师人真的很好，感谢老师拯救了我的民总和债法！！！
190669,9551,陆家豪,2024-03-14 03:18:06,19,24,5,上完债法之后等了一个寒假才来写评语。感觉评论有点两极分化，有些同学写得也不是很求是。。。。\n\n无法否认陆老师年轻并且很有教学热情，备课也很认真，平时也很负责。但是认真实在不能代表上课水平，ppt做的很好，但这也不是你大部分时候都念ppt的理由；再者不知道是不是真是德国学派影响太深，无论是平时表述还是书面解释，用语都太过于繁琐。\n\n上课不是写文章、作汇报，陆老师看得出写作能力挺强，但课程实在不太能展现个人魅力。至于有些人说“不喜欢就是没品”，实在不能苟同。\n\n另外，评分上据说求是，但我拿到的成绩自己很满意，总不能自卖自夸地说“既然你们都觉得求是那就是我债法学的好咯”。债总本来内容多也抽象，认真学学（听课、复习、思考）还是有帮助的。
191059,9551,陆家豪,2024-03-31 10:47:31,0,6,6,没有人觉得老师好帅好有气质吗……虽然不影响我上课走神
191779,9551,陆家豪,2024-04-30 06:04:18,2,3,1,满分不解释
192912,9551,陆家豪,2024-05-31 13:22:05,2,3,1,我爱ljh！！！！
193005,9551,陆家豪,2024-06-02 11:14:26,8,8,0,老师不错但这周的课为什么这么发飙呢
193109,9551,陆家豪,2024-06-03 15:20:29,8,9,1,发飙的那一回真是“奶狗变狼狗了”（看到朵朵有人评论的）（笑哭）
193367,9551,陆家豪,2024-06-07 10:25:16,1,4,3,学弟学妹要好好珍惜，这样扎实、温柔、耐心的民法老师不可多得，讲课也很清楚
193415,9551,陆家豪,2024-06-10 06:25:29,1,3,2,老师人很好。
193539,9551,陆家豪,2024-06-12 14:58:02,11,11,0,之前听过韩家勇老师退休之前上的民总网课，现在再听陆家豪老师的民总，觉得陆老师似乎过于关注理论而非实务了，把民法当法理上，至少让我这个新手被绕的晕头转向（即使听过韩老师的课，因为他们俩的民总内容差别真的很大），很难把握那些理论争端（并且陆老师似乎无论是小测还是作业都很倾向于考察理论而非实务，这对初学者来说似乎不友好）
193699,9551,陆家豪,2024-06-15 13:36:24,5,8,3,人很好很有趣，但是可能是因为没什么讲课经验，听课理解起来有些困难，作业和小测也比较抽象。\n\n而且作业要求很奇怪，不交只是一次作业没分，写的不好（ai或案例堆砌）平时分直接零分（？）我理解老师希望独立思考，但是有没有可能这群刚接触法律的学生并没有什么独立思考并对法律争议问题发表看法的能力？有点太理想化了。
197157,9551,陆家豪,2024-07-08 08:36:20,1,7,6,非常好的老师，温柔耐心，上课清晰有条理，ppt详细干货多（甚至感觉自己也不怎么需要额外做笔记了）\n\n\n\n美中不足的是给分从近两次课（债法和民总）来看似乎不太好。其实老师也说自己有捞的，出成绩后问了下老师分数构成，平时分给的确实不低了，期末卷面略低于我的预期，感觉改的还是有一点点严的（虽然老师自己觉得他改的很松），以及这学期出现了一次突击点名发飙的事件hhh。但不妨碍我心目中他是一个好老师！\n\n\n\nps:就民总这门课而言他和zc讲课风格差异还是比较大的，大家选课前可以提前试听了解一下，选一个适合自己的。
197205,9551,陆家豪,2024-07-09 04:53:58,0,5,5,不错的老师
201042,9551,陆家豪,2024-10-28 01:39:32,6,9,3,废话好多..
202219,9551,陆家豪,2024-11-11 02:11:25,33,40,7,人家还真是三本的
205723,9551,陆家豪,2024-12-11 12:21:36,4,5,1,一般般
206783,9551,陆家豪,2024-12-17 14:05:21,1,5,4,能学到很多东西，老师人也超级好
207354,9551,陆家豪,2024-12-21 01:23:10,25,31,6,工作三年了靠导师才发出一篇
207561,9551,陆家豪,2024-12-23 05:22:57,27,34,7,本科在苏州城市学院读的（真三本）🤣
209982,9551,陆家豪,2025-01-07 17:45:22,2,5,3,浙大民商法的未来就靠你了小伙汁（怎么感觉有点靠不住啊）
210862,9551,陆家豪,2025-01-10 05:40:27,-6,2,8,陆老师10分献上，债法求捞
211512,9551,陆家豪,2025-01-12 00:46:25,-1,5,6,好会捞jhg
211542,9551,陆家豪,2025-01-12 01:44:54,-1,4,5,老师真的很捞了，虽然我债法成绩也不算太高，但是难以想象我跟一坨💩一样的卷面能有这个分数，❤️陆老师
211811,9551,陆家豪,2025-01-12 14:08:44,0,1,1,老师人挺好的，讲课也很清晰易懂。期末捞不捞感觉要混脸熟，，，
212814,9551,陆家豪,2025-01-15 03:22:01,-2,3,5,jhgg讲的很清晰，讲课很有体系，不会出现期末自己笔记都看不懂的情况，而且今年债法给分很不错，强推
213453,9551,陆家豪,2025-01-17 12:17:41,0,4,4,24年秋冬债法原理，陆老师的课件很详细，没有平时作业和小测，讲课水平也很好。陆老师本人很可爱，也很有风度！法学院白月光~~陆老师禁止私下变相要分，也许是因为债法这门课本来就不好学，分数没有别的专业课高，但是也是陆老师捞捞的结果！
213601,9551,陆家豪,2025-01-18 12:56:39,-1,4,5,讲课很清晰，抽象的理论会和案例结合在一起，民总和债法给分都很好，强推！
214886,9551,陆家豪,2025-02-19 01:03:13,-4,3,7,很喜欢陆家豪老师啊 大一下民总自己没认真学 最后3.3 这学期债法认真学了 虽然也不是特别高 4.2 但已经很满意了 老师人特别好 也很帅的  法学院最喜欢的老师之一
218927,9551,陆家豪,2025-05-13 12:48:30,0,0,0,邮件已读不回。。。
219276,9551,陆家豪,2025-05-24 01:51:55,1,1,0,大一下zc民总3.3，大二上了老师的债法，真的救回了我的民法，最后债法总评4.8
221843,9551,陆家豪,2025-06-26 18:35:13,1,1,0,讲得很清楚
171668,9615,吴佩乘,2023-03-31 12:08:56,13,20,7,我爱佩佩
185953,9615,吴佩乘,2024-01-06 12:09:22,1,2,1,课上得云里雾里，讲话倒是有几分底气，但愿给分好一些罢！
191631,9615,吴佩乘,2024-04-26 06:54:32,1,2,1,。。。
191632,9615,吴佩乘,2024-04-26 08:37:53,2,2,0,不了解 可能是最后的法学院开设的经济法了
191730,9615,吴佩乘,2024-04-29 06:18:46,7,9,2,两篇五千字以上的论文
194145,9615,吴佩乘,2024-06-22 08:21:56,6,7,1,【经管类经济法】老师上课还是很不错的！很有年轻老师的风格，开放友好！自由平等！作业就两篇5k大论文，仅从课程角度来讲还是很不错的，期待给分，希望给分能好一点吧！
194492,9615,吴佩乘,2024-06-24 06:45:19,7,7,0,吴老师讲课很不错，人也很有耐心，经管类的经济法对于非法学专业的同学增加法律常识真的很有用，喜欢！
196280,9615,吴佩乘,2024-07-02 20:07:31,4,5,1,不点名 讲课有意思，考试只考PPT里的，这三点超过一般老师了
196886,9615,吴佩乘,2024-07-05 18:04:55,1,3,2,作业是两篇5k+论文，一个月内写一篇时间比较充足，我写得不怎么样但是老师平时分捞捞的（应该没查重；不点名所以没怎么去上过课，期末把智云都过了一遍发现老师讲课还是蛮有意思的，法盲普法频道；虽然今年管院经济法改成闭卷了但是期末考试相对简单，给分很好，应该比去年好太多了，好好好老师
196897,9615,吴佩乘,2024-07-06 00:01:13,2,3,1,补智云的时候发现讲课很有意思，内容比较简单易懂，建议最后1.5倍速补智云，平时上课会觉得讲课很慢。然后平时作业是两篇五千字的论文，时限是一个月，考试为闭卷，但全部是他上课讲的重点内容（好评），PPT上的边角知识很少。个人感觉给分很好。
196905,9615,吴佩乘,2024-07-06 01:02:36,1,4,3,都说给分好，我没体会到啊……
196917,9615,吴佩乘,2024-07-06 01:55:38,0,1,1,喜欢老师，上课有意思，案例很有趣，给分很好
197066,9615,吴佩乘,2024-07-07 04:58:35,4,5,1,吴老师人很好，上课也比较有条理，比较体谅学生
197096,9615,吴佩乘,2024-07-07 15:10:06,4,4,0,给分好不点名
197502,9615,吴佩乘,2024-07-17 12:57:17,4,5,1,吴老师人非常好，讲课不点名，逻辑还算清晰，给分很好，经济法满了。期末考试的话，就是你把PPT完完整整地过一遍，把内容搞清楚就好了，老师只考课本上的东西
208117,9615,吴佩乘,2024-12-25 16:29:09,1,1,0,老师可爱捏
208703,9615,吴佩乘,2024-12-31 06:45:51,4,4,0,在某些事上很聪明，很能适应环境。
209707,9615,吴佩乘,2025-01-06 17:40:58,2,2,0,给分好，讲课清晰
217117,9615,吴佩乘,2025-04-02 05:30:52,1,1,0,老师人蛮好的
218057,9615,吴佩乘,2025-06-06 01:28:01,4,8,4,要卷发言 不知道不卷发言的给分如何\n\n\n\n这种整个学院一起上的课就很方便大家看，和你一个学院的人有哪些是装都不装一下的功利和自私，发言酌情给分没有次数上限就每节课往死里发言，我只能说你是这个👍
221297,9615,吴佩乘,2025-06-22 15:25:19,0,0,0,……学生的命也是命
221955,9615,吴佩乘,2025-06-28 00:46:35,1,1,0,讲课巨好，给分巨高，神中神，都给我去选😭
221957,9615,吴佩乘,2025-06-28 01:07:11,1,1,0,感觉给分还不错，今年的课程任务感觉不大的，btw老师怎么把群第一时间解散了qaq没来得及谢谢老师
189933,9830,许戈雷特,2024-02-03 04:39:14,2,2,0,破产法专家
168479,9967,梁健,2023-02-18 05:17:23,7,10,3,老师分给得很高，有一次被点名回答问题，结果平时成绩99，期末87。人很好
169180,9967,梁健,2023-02-24 14:05:21,4,8,4,老师人不错 就是讲课比较快 需要一些基础 分给得高 有次提问点没在场 最后分数也很不错
169182,9967,梁健,2023-02-24 14:09:50,7,11,4,将课程内容与实践案例相结合，可以学到很多书上没有的知识，而且期末给分非常好，宝藏老师！！！
169183,9967,梁健,2023-02-24 14:20:35,4,6,2,老师人超级好，上课不点名，课上内容充实，偶尔提问但不为难大家。期末考试简单，给分也很nice！
170620,9967,梁健,2023-03-07 08:18:51,8,16,8,老师出身显赫，实务经验丰富，但是，可能还不是很会讲大课，喜欢自顾自地输出。
171071,9967,梁健,2023-03-15 12:24:37,3,4,1,老师偶尔会点名，建议大家上课前要看看书，打一下基础。期末给分还是很不错的
186176,9967,梁健,2024-01-09 07:41:00,10,19,9,课件是张明楷太皇太后搬过来的，粗制滥造，讲课也就是念ppt，学下来毫无收获，体系乱七八糟
188364,9967,梁健,2024-01-18 18:53:15,3,7,4,我个人挺喜欢老师的。老师的特点是实务经验很丰富，课上会给我们讲到许多书上和其他课学不到的案例。虽然讲课水平确实和xwl没法比，但总体来说也还不错
190342,9967,梁健,2024-02-28 08:31:03,1,1,0,挺好的
191865,9967,梁健,2024-05-02 10:48:28,7,7,0,给分非常非常友好\n\n健哥可能从官场退隐历经了宦海沉浮，所以不想在成绩上卡我们，上课的时候也表达了希望我们能在课堂上学到点东西，将来走上自己喜欢的人生道路这样的意思
192804,9967,梁健,2024-05-30 14:18:16,4,4,0,见过最纯粹的老师，很喜欢
198291,9967,梁健,2024-09-06 07:06:40,2,2,0,老师人很好，从不为难学生，虽然课件不是很好，但是上课案例很多都是自己办过的案子，还很有笑点，总体来说老师给分真的很宽容。
204286,9967,梁健,2024-11-25 06:35:10,0,5,5,课讲的真不行，授课水平绝对配不上这个分数，不能只因为给分高就无脑打高分吧？
208273,9967,梁健,2024-12-26 12:38:57,-1,1,2,好老师，理解学生，会讲自己所办的案子，大家对法院有什么问题都可以去问梁老师！
208556,9967,梁健,2024-12-29 10:53:14,1,2,1,爱女儿的好老师，对学生也挺好的，虽然点名提问但是对给分的影响几乎没有。给分确实高的离谱…反正我从来没听过课，期末带了本太皇太后考了88。
212276,9967,梁健,2025-01-13 22:56:15,3,3,0,上课爱摸鱼，但是期末周认真学了一段时间，得了4.8，感谢梁大法官5555
213661,9967,梁健,2025-01-19 02:46:14,1,1,0,好像给分还行？但是也没有想象中那么高。而且听他讲课有点痛苦。。连上4节的大课，巨乱的PPT，难懂的口音，莫名其妙跳过的一些内容，让人摸不到头脑。而且平时作业的论文题目大到令人无从下手。但是老师人还是不错的，在教刑分的老师里面已经很好了。
214726,9967,梁健,2025-02-17 06:09:10,0,0,0,在线法庭给分不错
214885,9967,梁健,2025-02-19 00:59:38,0,0,0,平常一直摸鱼 最后考试前刷完了柏浪涛的刑分 最后4.5 还行吧 上课一般 但老师人很好的 去之江听讲座 老师会让我们坐他车一起去 很热情
215572,9967,梁健,2025-03-01 01:23:24,2,2,0,刑法学新任教授博导，虽然老梁是高铭暄弟子而且当法官期间就有很多成果，但是这也太坐火箭了吧。有待时间来证明一切
181971,10053,张伟君,2023-11-07 03:41:57,22,23,1,好老师，讲法条，偏学理学术
183598,10053,张伟君,2023-11-29 04:35:40,-9,17,26,非常古板，不体谅学生。另外，一条条讲法条的授课方式也与隔壁精心制作ppt、构建学科知识体系的做法形成鲜明对比。此外，口口声声说“没有规矩，不成方圆”，但他自己从来不按照学校规定时间上下课，充分说明他的规矩都是针对学生的，对自己形成例外。宽于律己、严以待人！
183706,10053,张伟君,2023-11-29 03:10:41,-4,13,17,老师人很热情\n\n但是对到课率有一种强烈的追求\n\n知产今天安排了固定座位，方便查缺勤\n\n根据他每节都拖堂的事实\n\n今天中午又有一波可怜的学生吃不上饭了\n\n一想到下午还有他的案例研习课我就浑身发抖
183711,10053,张伟君,2023-11-29 04:33:21,-8,10,18,老师好，我只想正常下课去吃个饭
184205,10053,张伟君,2023-12-13 03:53:18,28,30,2,老师是好老师，学术型的，很乐意解答学生的问题，也很关心学生。\n\n可能是刚来浙大，对学生到课率要求比较高（虽然知产的到课率和其他课程相比已然很高了）。此外上课方式像法条共读，需要比较高的专注度才能跟上，最近才用上ppt。\n\n瑕不掩瑜，老师教学态度还是认真的，给个8分。
184250,10053,张伟君,2023-12-14 03:17:03,2,15,13,讲课偏专题性，体系性不强
188031,10053,张伟君,2024-01-18 04:55:11,36,38,2,老师确实是热爱知识产权法这个学科，能从其言行中感受出来，并且对于学生提出的问题也是耐心回答，甚至愿意放弃了自己课间休息的时间，但坏处就是耽误最终的下课时间……但比起上课灌水、push学生自学、下课走得比学生还快的老师来说，简直是好太多了。如果有学生愿以知识产权法作为日后方向，zwj这种愿意与学生交流的老师，在法学院可谓是不可多得。
188042,10053,张伟君,2024-01-18 05:21:34,-23,3,26,无语……
190396,10053,张伟君,2024-03-01 00:47:53,20,20,0,表达的艺术
190717,10053,张伟君,2024-03-15 13:27:31,23,23,0,张老师的学术和教学水平对于浙大知产已经是天将猛男级别的了
190778,10053,张伟君,2024-03-18 13:59:21,19,20,1,爱伟君❤️
190839,10053,张伟君,2024-03-21 04:20:19,-15,4,19,今年这门课的考核让大家怨声载道，但与老师授课本身无关。老师是好老师，但两位老师在考核方面的设置和配合存在巨大问题，有失公平。
191748,10053,张伟君,2024-04-29 13:34:13,16,16,0,一个好老师
191921,10053,张伟君,2024-05-05 08:26:45,17,18,1,如果说谷神是一位吟游诗人，那么张老师大概是一位演说家，两人同属德系学者，对知识体系之追求均追求删繁就简、清通简要，就像老师微信签名所言，“越简单越好”。
192871,10053,张伟君,2024-05-31 06:50:37,13,13,0,很认真负责！
199536,10053,张伟君,2024-09-25 04:43:01,13,13,0,好老师！
200136,10053,张伟君,2024-10-13 19:28:52,12,13,1,游刃有余
200945,10053,张伟君,2024-10-25 06:41:52,12,13,1,特别喜欢张老师TTT 和蔼不傲慢，成为大三秋学期唯一一门喜欢去上课也会努力认真听的课TTTT 能够和老师平等交流而没有傲慢轻视之感对我来说真的太难得了TTTTTTT
209358,10053,张伟君,2025-01-05 15:00:00,18,19,1,毫不夸张地说，这两年张伟君老师和魏立舟老师的引进，对于山上的知产有开启之功，在此之前的浙大知产用“死气沉沉”来形容毫不过分。
210675,10053,张伟君,2025-01-09 15:40:29,9,9,0,特别好
211319,10053,张伟君,2025-01-11 07:44:51,6,7,1,瑕不掩瑜
219748,10053,张伟君,2025-06-05 06:11:00,2,2,0,看了一圈经济法所查老师的评论，顿觉张老师真是一股清流，也难怪老师怀念同济了。
197574,10183,刘绍宇,2024-07-20 01:37:22,11,11,0,慕尼黑大学高材生，学术水平非常高
214819,10183,刘绍宇,2025-02-18 05:33:52,1,1,0,不是慕大，是汉堡大学～
216164,10183,刘绍宇,2025-03-11 10:05:33,1,1,0,或许老师讲课不太熟练~行诉法听的比较难受，感觉都是在念课件~
218482,10183,刘绍宇,2025-04-24 03:31:13,0,0,0,老师这学期才开始上本科课，觉得老师人挺好，课下回答问题也很认真，就是确实不太会讲课。。。
219983,10183,刘绍宇,2025-06-13 05:31:52,0,0,0,上课好无聊 然后他讲题目的时候讲着讲着还要去查答案 不知道是没备课还是怎么了 可能学术很厉害吧
198444,10188,钭晓东,2024-09-09 03:12:15,15,17,2,快跑，学弟学妹们能选何香柏老师就选何香柏
198640,10188,钭晓东,2024-09-10 09:55:55,-18,0,18,老师授课很认真风趣，并且会有一个整体且逻辑的思路引导贯穿。积极努力和老师多交流，会有更多珍贵的理论和实践机会！
199860,10188,钭晓东,2024-10-05 05:13:56,20,21,1,爹味十足………..
204957,10188,钭晓东,2024-11-29 03:55:58,10,11,1,枫桥经验研究院的院长和副院长，本质上是一路人。没有半点学术味道的学术掮客。
208553,10188,钭晓东,2024-12-29 10:06:26,-14,2,16,虽然大家有很多吐槽，但是钭老师有一点还是很好的。钭老师的女儿在我们这一届，但是并没有受到特殊照顾，顶多就是一点信息上的优势，不像某位竺奖得主。而且钭老师一般不会为难学生，这个分属实有点低了，我给他打5分。
210104,10188,钭晓东,2025-01-08 07:05:20,8,10,2,有个好女儿
210168,10188,钭晓东,2025-01-08 09:38:55,3,4,1,爹味加官迷，不过现在法学院都是这样的人了，一声叹息
215152,10188,钭晓东,2025-02-23 04:42:17,3,4,1,人品和学术俱烂
215916,10188,钭晓东,2025-03-07 06:40:46,8,8,0,怎么说呢，搞数字法的那帮奇葩是被绝大多数老师同学都看不起的，钭晓东就是被数字法奇葩都看不起的鄙视链底端的存在
217044,10188,钭晓东,2025-04-01 01:09:11,2,2,0,感觉现在学校大大小小的活动，怎么十处敲锣九处有他…
217435,10188,钭晓东,2025-04-10 10:04:26,2,2,0,成天刷存在感的老登
197688,10191,胡建淼,2024-07-30 01:24:31,1,1,0,浙大的骄傲，法学界的骄傲
198079,10198,张占江,2024-08-28 20:02:30,25,25,0,有点抽象
198934,10198,张占江,2024-09-13 06:28:54,12,12,0,给分真的超级无敌差，差中差。
199724,10198,张占江,2024-09-28 07:34:04,-26,4,30,很喜欢张老师，上课的干货很多，有时也会分享自己的经历，个人感觉很有启发。听完这门课对经济法的基础知识有了一定理解，最后只要认真记下要点（特别是期末复习总结，会反复强调），考试应当是没啥大问题的~
199763,10198,张占江,2024-09-29 06:49:11,13,13,0,上课穿个大裤衩子，手插兜子里，时不时要拿出手机看一下，也时不时拿起水瓶喝一喝。总之不拿话筒。总之要插兜子。
200892,10198,张占江,2024-10-24 06:22:34,25,26,1,三节课时可以拿整整一节课来pua你，也是有点无敌了
201521,10198,张占江,2024-11-04 05:02:05,27,27,0,可以看看2024年5月17日的智云课堂张某人的课，讲反垄断法经营者集中的。张某人上课时间也就看了100多次手机吧，多次上课中断停下来回复微信｜短信，PPT显然不是张某人做的，读PPT都疙疙瘩瘩，自相矛盾，有头没尾。讲的真的很差，知识点非常单一重复，自我感觉良好，其实也就那么点东西。最喜欢随地大小爹，各种指责学生，但是自己上课水平也就那样。
202892,10198,张占江,2024-11-15 04:23:01,21,21,0,实在是逆天，从来没有见过这么逆天的老师，真绝了
205028,10198,张占江,2024-11-30 03:19:53,23,24,1,沙壁老登讲座人数不够硬拉学生去凑说算平均分\n\n死吗死罢死全家
205406,10198,张占江,2024-12-06 02:03:27,11,12,1,脑子有病
205422,10198,张占江,2024-12-06 04:32:21,9,9,0,非常非常抽象。
205437,10198,张占江,2024-12-06 09:11:14,14,14,0,真的很无语，在非正式的上课时间安排讲座，讲座还签到，以为我们都是闲的没事干吗，你想安排讲座就安排，你想串课就串课。要是正常的上课时间签到也就算了，讲座也签到，真是好东西
205477,10198,张占江,2024-12-07 10:56:27,10,11,1,煞笔）
205806,10198,张占江,2024-12-12 05:39:58,9,9,0,二货一个
206143,10198,张占江,2024-12-13 06:13:27,8,10,2,上课很烂，翻来覆去地讲，很喜欢随机点名，不到就会扣分。很喜欢pua学生，期末闭卷，要恶竞
208349,10198,张占江,2024-12-27 03:35:21,8,8,0,纯sb一个，最后一节课说要考所有讲座内容，每节课必pua学生
208511,10198,张占江,2024-12-28 15:21:31,7,7,0,我知道我们法硕学习态度很差，但是用得着这么搞我们吗，我们又不是小学生，什么课该上什么课不该上还是知道的
208736,10198,张占江,2025-01-01 05:47:22,6,6,0,还能更低
209805,10198,张占江,2025-01-07 06:49:35,2,3,1,真的服了 用自己邀请人开的讲座的签到作为我们的平时分 无语至极，本来事情很多还占用我们的下课时间
210153,10198,张占江,2025-01-08 09:17:17,11,11,0,前面说拉讲座凑平时分的，数字法学那边玩的更恶心，数字法学研究生必须要听数字法治研究院办的讲座12次，不然不给答辩。而且那个什么研究院的讲座就是一团狗屎，没人听才出这招。只能说入乡随俗了属于是，一群败类！
214724,10198,张占江,2025-02-17 06:08:20,-2,2,4,虽然PUA，但是给分不错
215030,10198,张占江,2025-02-20 06:56:35,4,5,1,怎么有2分，高了。张老师这个水平只能说生在一个好时代，上他的课像折磨，老登事情很多很狗，能不上就不上吧
215500,10198,张占江,2025-02-27 05:22:56,12,13,1,法学院最差的老师！最逆天的老师！最恶心的老师！\n\n1.老师虚伪至极，极爱面子，爱虚荣。自己主办的讲座，怕没有学生来听，扫了自己的面子，就把课外的讲座算成平时分，要签到强制学生参加。讲座结束时还当着学生的面撒谎，给嘉宾说：“我们的学生都是自愿来的，没有人要求他们来，没有签到”结果等嘉宾走了，偷偷签到。很难想象，一个大学的教授如此的爱虚荣和虚伪，为了面子，当着所有学生的面撒谎。\n\n2.课程考核方式频繁更改，课程考核成了他的一言堂。高情商：我的课程考核方式灵活多样。低情商：课程考核我说了算，我可以随便更改考核方式。学生到了快期末，甚至都不知道这个课程的总分的组成方式。\n\n3.对课程毫不上心，上课就是车轱辘话反复说，毫无内容可言，上他的课只感觉到了坐牢和痛苦，浪费时间。\n\n4.对教学考试非常不上心，竟然会出现来期末考试不带试卷的错误。到期末考试的那一天了，张老师都到教室了，突然才发现自己没有打印试卷，这才匆忙委托一个同学去打印卷子。任课老师筹备期末考试不准备试卷，到考场上了才临时打印，这难道不是教学事故吗？\n\n5.非常爱pua人，甚至会出现一整节课都在说教人的情况。\n\n6.私自加课时量，他甚至会说：“这一部分内容我在上课就不讲了，在讲座的时候再说”把上课内容强行加到课下的讲座中，强制学生去参加他的讲座，课时量完全不符合规定，他的课下讲座动辄两三小时，后期几乎每周都有。学生需要在上课时间上课之外，还需要抽出课下时间去参加他的讲座，这些都是会签到的哦。学生花了大量的课余时间去参加他的动辄两三小时的讲座，到了期末会加一分的高分。\n\n7.老师口头上说不点名，但实际上在期末交卷时，他让你一个人一个人去交，然后一一比对面熟程度，如果面熟，他就会在卷子上打上记号，证明常来，用面熟程度来点名签到，真的第一次见。\n\n以上是经案的上课体验。\n\n篇幅所限打不下了。\n\n学院的新老师上课，人品，就是这种水平，6了。
215516,10198,张占江,2025-02-27 10:06:08,3,4,1,狗狗🐶
216736,10198,张占江,2025-03-23 13:22:29,-3,2,5,没有那么差……给分也可以
216737,10198,张占江,2025-03-23 13:23:02,-5,2,7,张老师上课的内容其实很干货，好好停下来是很有收获的，而且老师也是真的关心学生，给分其实也是刀子嘴豆腐心，说的很严格其实打分不错的
217185,10198,张占江,2025-04-03 08:09:52,1,1,0,法学院这几年招的这几位老师真的是烂完了
217736,10198,张占江,2025-04-15 16:21:42,-6,0,6,老师讲课幽默风趣
218980,10198,张占江,2025-05-16 04:17:19,1,1,0,听课压力好大
219001,10198,张占江,2025-05-17 15:14:20,0,2,2,张老师备课很认真，讲课也很有趣！在课上可以发表自己的看法，与老师交流！上的是老师的经济法总论，但是也有机会交流分享实际案例。（虽然点名，但只有3次，而且老师会提前一周通知）真的是一个很好的老师
219851,10198,张占江,2025-06-09 02:44:52,0,0,0,老师挺好的，没那么差
219892,10198,张占江,2025-06-10 07:53:20,2,3,1,感觉老师讲课逻辑挺乱的，上课记笔记的时候没有一次完完整整地吸收知识超过三十分钟，相比其他老师干货比较少；个人感觉老师有点强装和蔼可亲的感觉，实际上mean到离谱哈哈哈哈哈，觉得老师还不错的同学真是被pua到没边了，法学院其实也是有干货+性格魅力的老师，大家还是擦亮双眼叭。
220991,10198,张占江,2025-06-20 15:07:00,1,1,0,老师最后一节课请我们喝奶茶了，老师上课感觉涉及总论和反垄断反不正当竞争法比较多，但是个人感觉不是特别成体系and不好记笔记，期末最后一节课给我们划重点了，明天就要考试了😭希望老师划的重点会考到😭最后一门考试了真的复习不下去了😭
197230,10234,陈明辉,2024-07-09 14:29:28,0,3,3,本专业的还是去yj班吧
198116,10234,陈明辉,2024-08-31 13:18:04,6,6,0,老师上课挺好玩的，最后期末也超级简单（yysy宪法学这门课都挺氵的）
199319,10234,陈明辉,2024-09-21 03:00:08,4,4,0,我觉得挺好的啊，虽然闭卷，但是考试简单给分也好，上课也很有意思。。。没有说的那么不堪吧。
200391,10234,陈明辉,2024-10-16 13:28:00,3,3,0,上课会点人回答问题，老师讲的是挺好的。
201540,10234,陈明辉,2024-11-04 07:03:59,4,4,0,感觉上课蛮有活力、新意的。
201990,10234,陈明辉,2024-11-08 03:23:43,3,3,0,老师讲的蛮好的，宪法学本身很枯燥但在他课上还不错的
205731,10234,陈明辉,2024-12-11 13:25:37,5,5,0,考试之前评一下哈哈，不管给分好不好都值得一个超高分。老师讲课很扎实、有条理，同时又很有深度有内容。人也很好，表达清晰，偶尔幽默，虽然会让人回答问题但不会用出勤要挟扣分，是为数不多不涉及点名、基本内容也已经在考研学过的情况下，我还愿意去上的课。而且能感觉到人也是认真严谨、又宽容有风度的、很好的老师。老师加油哇！！
205897,10234,陈明辉,2024-12-12 13:56:32,4,4,0,特别喜欢陈老师，人很随和，讲课认真又很幽默，不点名但还是会去上
207468,10234,陈明辉,2024-12-22 05:55:55,4,4,0,特别催眠..
217598,10234,陈明辉,2025-04-14 03:43:36,3,3,0,老师的科研成果相当好，人也很亲和，很有水平的一位老师
217735,10234,陈明辉,2025-04-15 16:19:17,-2,0,2,宪法懂哥
207883,10450,邵敏杰,2024-12-25 00:17:19,14,23,9,导师保送的
211827,10450,邵敏杰,2025-01-12 15:24:44,-16,4,20,邵老师学术功底扎实，为人也真诚
212985,10450,邵敏杰,2025-01-15 12:08:11,-14,4,18,能让谷神亲自带发论文，想必是极优秀的
214016,10450,邵敏杰,2025-01-23 02:42:43,-16,4,20,邵老师很好
214017,10450,邵敏杰,2025-01-23 02:45:09,-16,4,20,很好哦
214019,10450,邵敏杰,2025-01-23 02:46:29,-16,4,20,邵老师很好！
216757,10450,邵敏杰,2025-03-24 06:11:08,-13,1,14,评论区要求真高
216792,10450,邵敏杰,2025-03-25 17:21:44,13,14,1,不懂为什么可以留
217539,10450,邵敏杰,2025-04-12 21:35:58,4,8,4,。。。
217545,10450,邵敏杰,2025-04-12 23:55:26,-11,3,14,浙大本科，根正苗红，谷神开山博士。佛了几十年的谷神为他开始招博士（当年周翠老师也想招他为第一个博士，听说谷神要招立马作罢），在退休前亲自安排留校（据说谷神给学校的通牒是如果不能留他就走，显然是希望他做接班人）。作为非法大考生，初考江奖让法大感到危机，让那时刚刚加盟的朱庆育老师感到浙大本科还是有希望的，名次记录统治了整整十年，直到今年才被华政打破。邵老师很低调，低调到连自吹自擂的个人主页都没有，但这不代表不了解他为人的喷子能在这里匿名质疑为什么能留，攻击导师保送。就算导师保送又怎么样？他的导师是谷神，不是胡铭、王利明之流。
219062,10450,邵敏杰,2025-05-20 07:32:21,4,4,0,怎么还请上水军了...
219491,10450,邵敏杰,2025-05-28 14:08:04,0,0,0,为啥没有上课评价，评分这么低啊，有没有人说道说道。ljh不也是导师保送也没人黑，好奇
219498,10450,邵敏杰,2025-05-28 21:26:47,1,1,0,有待时间来证明谷神对他的期待，现在的成果确实有点单薄
222067,10450,邵敏杰,2025-06-29 11:05:51,1,1,0,这风评也太差了
204321,10730,张帆,2024-11-25 08:19:05,23,26,3,对学生貌似挺不错，但上课给人一种不备课的感觉。。。
204639,10730,张帆,2024-11-27 07:12:02,26,30,4,研究生的法理学上的是什么玩意儿
205353,10730,张帆,2024-12-05 02:30:32,26,28,2,讲课很烂。上的法律职业伦理，老师对荡妇羞辱的话题很感兴趣，上课的某些话让人很不适。上课很喜欢讲废话，鼓励恶竞，平时分都靠pre的次数来给。只能说大四了还在这恶心人，也确实让我学到法律职业的险恶了。
205966,10730,张帆,2024-12-13 02:14:04,28,33,5,大谈律师职业，自己如何赚钱，自己多有能力让家庭rich幸福。本来就是吃尽时代红利的人，各种打压学生，姑且认为是为了我们好，让我们认清市场形势，可是有用的建议一个不讲，只知道你很牛x……此外，师者，传道受业解惑也。可张老师的心可能在接了几个案子，要赚多少钱上了，和课程相关的内容是几乎一个不讲……
206893,10730,张帆,2024-12-18 07:51:12,23,23,0,上课不知所云，一学期下来毛都没学到，还不开智云，复习都没法复习。
206894,10730,张帆,2024-12-18 07:48:00,15,16,1,研究生的法理学每节课都讲废话。。
207382,10730,张帆,2024-12-21 05:35:22,-30,2,32,真心换真心吧，其实投入听也是能学到东西的；\n\n上课价值密度确实没有很高，也确实没有苦心备课的痕迹，但是肯定有设计过，因为整体是有逻辑的，不论是一节课的维度还是一学期的维度；\n\n一个学期整个思路跟下来会有收获（试过一样的知识点自己课上自己学和跟着老师学，确实是跟着老师效率更高，不过不能说“很”有收获）；\n\n因为是非本专业的法理学课程，深入浅出，也能提供一些特别的思考点
208601,10730,张帆,2024-12-30 02:19:33,20,22,2,总是喜欢在小红书上做互联网老师，但是极其男权，把地域歧视、性别歧视贯彻到底，在小红书上面是不在乎法本还是非法本的老师。但是上法理学课程的时候，讲的一团模糊，默默问一下，谁把他从山东大学挖过来的？为什么要此地无银三百两非要在官网简介上说自己因为学校“误诊”第一年没上研究生呢？笑死
208602,10730,张帆,2024-12-30 02:24:21,9,10,1,。。。
208604,10730,张帆,2024-12-31 13:09:52,22,23,1,讲课一团乱麻，小红书倒是很用心运营，跟周翔一个卧龙一个凤雏。
209814,10730,张帆,2025-01-07 07:16:03,16,17,1,研究生法理学完全不备课，每次上课都在水时长，一学期下来除了一点职业规划以外什么也没讲，期末都不知道从哪里开始复习。对教学没有敬畏心，也没有准备好承担一门课的教学任务。整天发小红书和营销自己对学生多么好的人设，其余不多言。
213261,10730,张帆,2025-01-16 13:37:15,7,7,0,上课很水，给1分是因为没有0分
214751,10730,张帆,2025-02-17 10:14:05,3,3,0,上课就是上赶着挨骂
215056,10730,张帆,2025-02-20 10:34:43,8,8,0,著名的“小红书”老师
216752,10730,张帆,2025-03-24 05:39:54,3,3,0,不要再讲白搭了好吗……
217720,10730,张帆,2025-04-15 12:48:42,2,2,0,但凡不是打不了0我都…
217721,10730,张帆,2025-04-15 12:54:11,2,2,0,什么时候能打负数
217879,10730,张帆,2025-04-17 11:11:38,4,4,0,在小红书上包装的很好，实则是一坨
218312,10730,张帆,2025-04-22 12:28:33,4,4,0,老逼登，心机狗，法律职业伦理这种水课都要点名，而且明明是自己要刁难学生，第二节课还暗示是另外一位老师要求他点名的，从未见过如此厚颜无耻之人！
218370,10730,张帆,2025-04-23 02:56:44,3,3,0,上课特意不开智云是为了。。
218423,10730,张帆,2025-04-23 10:17:25,4,4,0,嘶，纯纯的煞笔，脑浆是纯正的老北京豆汁。这种油腻的垃圾怎么引进的，浙大法学院喜欢刮地沟油吗？讲个课狗屁不通，脑子里全是废料，真是垃圾啊。
219004,10730,张帆,2025-05-18 03:18:10,2,2,0,结课一年后，张帆终于有专门的评分专栏。从山大转来的老师，讲课很发散，几乎不讲什么知识点，全在扯些有的没的，可能重心都在自己的律师工作上吧，市侩味很浓、、、给分，可能是刚来浙大，不明白浙大的评分标准，也是很差很差，有一种不顾学生死活的美感...总之别来！（最后感慨一句，法学院到底为什么要引进他？）
221554,10730,张帆,2025-06-24 12:12:02,0,1,1,去年3.6大派送 今年满绩大派送？
