评论id,老师id,老师姓名,发表时间,点赞减去点踩数量,点赞量,点踩量,内容
685,6,应群民,2015-03-15 11:57:47,12,15,3,挺好的，就是有时候讲得太快，听不懂
2771,6,应群民,2015-05-07 05:46:35,5,9,4,上课挺有收获的，老师人不错，给分也超好。
2943,6,应群民,2015-05-11 11:38:56,5,6,1,一种考5分可以过的体验\n\n\n\n
7575,6,应群民,2015-09-15 05:14:25,31,34,3,笑容很赞！
8480,6,应群民,2018-01-18 16:06:29,4,4,0,老师人挺好的
13099,6,应群民,2015-12-25 01:03:01,24,26,2,绝对好老师，虽然这课算是通识里的奇葩……难的一笔
16009,6,应群民,2016-01-17 03:21:33,1,2,1,绝对好老师，和蔼可亲而且讲课好玩。
16013,6,应群民,2016-01-17 04:00:12,7,10,3,老师人很好，上课挺有趣的。电工电子学概论有两章内容真是难的一比，但其实考试内容还是比较简单的，开卷考试，考前看看书，得分还是会很高的。
16107,6,应群民,2016-01-17 08:17:13,14,15,1,通识新低
16538,6,应群民,2016-01-18 10:32:24,6,7,1,电工学概论这门通识太难了。。。。。所以说考不好也没办法了。但是考试其实不算特别难，老实人很好，讲得也好，ppt做的也很仔细，就是这门课分数有点低了。。
16539,6,应群民,2016-01-18 10:35:29,2,2,0,老师讲的很不错，人也好，ppt做的也好，但是电工学概论这门通识太难了。。。所以给分不很高
16738,6,应群民,2016-01-19 01:27:33,1,3,2,电工电子概论确实有点难，当时选了第二周就后悔了，不过好好学真的能学到好多知识，老师讲的也挺好的，平时作业要好好做。考试前会给大家看看以前的卷子，题目都差不多。
21926,6,应群民,2016-03-01 23:53:58,1,1,0,电工电子学概论大坑
29220,6,应群民,2016-06-29 12:29:09,1,1,0,好老师！！！！！！！
30495,6,应群民,2016-07-01 17:56:33,1,1,0,挺和蔼的
32985,6,应群民,2016-09-09 07:59:54,2,3,1,和蔼可亲的老师，不过电工电子学太难了经常听不懂。给分还不错，考前刷了几天夜最后还是上4了。
33216,6,应群民,2017-01-17 23:49:48,1,6,5,这老师我是真服了，小组的时候每次成绩都是9.5，后面自己做的也差不到哪去，最后给了一个班里80%的分。。我实验报告真的认真写了好吗……可能是我用的蓝黑墨水钢笔而老师喜欢黑色中性笔吧……
40606,6,应群民,2017-01-04 09:15:20,1,1,0,没上过理论课听不懂
41668,6,应群民,2017-01-12 10:23:05,2,2,0,电工电子工程训练 前几节课实验挺好玩 后来的上机啥啥的太难了吧
43955,6,应群民,2017-01-17 07:03:40,1,1,0,好老师，讲课真的稳
51434,6,应群民,2017-06-05 11:42:48,2,3,1,当初没看清课程名称就选到了电工电子工程训练，当时是想选电工电子学的。老师教的不错，人也很好，有耐心，但是这堂课真的不轻松
52978,6,应群民,2017-06-24 09:57:53,1,1,0,讲得很好，也很和蔼
55736,6,应群民,2017-07-02 09:53:04,0,4,4,给分神特么差，说不考的内容考了一堆，本来是计算的课偏偏被搞成硬背的课，太差咯
56140,6,应群民,2017-07-03 06:44:05,1,2,1,应用电子学这门课真的是醉了，不过老师还是非常不错的
58120,6,应群民,2017-08-02 05:06:46,0,1,1,不错的，讲得还可以
59303,6,应群民,2017-09-20 15:14:34,1,1,0,老师给分很好，人也很温柔很细致!很好的老师!
63443,6,应群民,2017-12-04 07:12:51,4,4,0,听课挺懵逼的，不过主要不看听课，实验的时候线路接好（线要接的漂亮），实验报告写好，给分还是不错的。
66804,6,应群民,2018-01-19 06:36:27,1,1,0,老师人很好…我一个渣渣什么都不会，最后绩点4.5…学到很多东西嘻嘻
67023,6,应群民,2018-01-20 03:58:02,8,8,0,电工电子工程训练，课不轻松，节节课都要动手操作，老师讲的还挺快，动手的时候还有研究书上内容。但很好玩，老师也很有耐心，人很好，尤其是笑容非常灿烂。有兴趣的同学建议听听。给分不错
67038,6,应群民,2018-09-12 11:46:44,1,1,0,电工电子工程训练贼有趣的，体会焊电路的美妙，可以只有一块板给我焊。就是上机部分，没跟上就容易gg
70102,6,应群民,2018-01-26 06:08:03,3,3,0,老师很喜欢笑很认真
70124,6,应群民,2018-01-26 06:48:02,3,4,1,老师好温暖啊！学渣祝老师新年快乐~
70134,6,应群民,2018-01-26 07:06:00,9,10,1,老师人真的超好的…电工电子学没有小测…给分好…而且老师耐心特别好…问他什么蠢问题他都会很耐心的帮你理清思路！
70135,6,应群民,2018-01-26 07:06:51,1,1,0,给分好！没怎么听过课。还是过了。笑容很暖，就想跟着一起笑。经常坐在第二排玩手机QAQ抱歉
70159,6,应群民,2018-01-26 07:40:00,1,1,0,电工电子竟然过了 哇 开心得一批 老师是真得好 笑容超赞的
70167,6,应群民,2018-01-26 07:52:06,1,1,0,老师非常赞，主要是笑容让人很舒服，强推！
70278,6,应群民,2018-01-26 10:38:58,1,1,0,谢谢老师～电工电子学实验还是有些困难不过老师都会教你 有一次拖到了最后还是老师手把手来帮忙的 给分也挺公正的 本来就是要靠自己认真复习的学科 绩点3.6虽然不高但是也觉得还可以了 老师非常负责 辛苦了！
74118,6,应群民,2018-02-05 09:36:39,1,2,1,喜欢老师的微笑！
74385,6,应群民,2018-02-16 10:42:07,3,3,0,老师很有耐心，很爱笑
78207,6,应群民,2018-05-10 03:56:19,-3,0,3,。。。
78304,6,应群民,2018-05-10 15:47:00,-5,2,7,不负责任
83113,6,应群民,2018-07-09 17:00:54,3,4,1,最后给分超棒
86675,6,应群民,2018-09-18 02:25:23,0,0,0,老师人真的真的很好！只是我太辣鸡了......
87158,6,应群民,2018-09-21 03:23:49,5,8,3,电工电子实习I，本人接线一次成型，电表性能完好，对不起，3.5。室友电表崩了，接线一般，还被电过，对不起，4.5。
87165,6,应群民,2018-09-21 05:12:31,-1,1,2,自己的接线得分很一般，实验报告也没有恶竞，本来觉得自己要凉凉，但是成绩出了很惊喜，感谢老师！老师日常也特别负责，讲课很清楚，不像舍友的老师什么都不讲，大爱应老师！
88878,6,应群民,2018-11-11 10:42:46,2,2,0,给分太低了
88969,6,应群民,2018-11-13 02:42:54,1,1,0,老师人很和善，不懂的主动问他他会手把手教，\n\n但是电工电子工程训练这门课的确需要一定动手能力，手残党慎报.不然就是被正态了。
89051,6,应群民,2018-11-14 16:32:54,10,10,0,脸上时刻保持着高深莫测的微笑，电工电子工程训练这门课很难，但是很有趣，推荐动手能力，画图能力，写报告能力超强者，且愿意牺牲星期四的午饭的同学谨慎报选！
89350,6,应群民,2018-11-18 14:59:47,0,0,0,我敢保证这是浙大最不水的一门科，老师教的对做实验影响不大，是凭成绩说话，另外还有一点，这门课每节课都会有作业。
89487,6,应群民,2018-11-19 09:57:07,0,0,0,上课挺难的吧
89951,6,应群民,2018-11-21 11:11:58,2,2,0,老师上课讲的挺快的，课程时间也比较长，但做实验挺有意思的，实验报告主要是抄书，给分也还可以，需要一个好队友。
92298,6,应群民,2018-12-27 14:02:50,1,1,0,电子电工慎选
94000,6,应群民,2019-01-14 16:51:32,0,0,0,电工电子工程训练\n\n这门课对于有兴趣的人来说真的很棒\n\n老师好萌啊，笑容很赞\n\n给分也很合理
95149,6,应群民,2019-01-19 01:50:03,1,1,0,老师人挺不错，就是上机讲课略快。给分也不错，就是不知道为什么实验报告都是抄书，思考题都是百度翻书的，为什么我的实验报告分数就是低一些，个人觉得手写态度不错，可能是字不好看吧。
96848,6,应群民,2019-01-21 10:36:09,3,3,0,这门课挺有意思的\n\n但是老师上课讲的不清楚\n\n给分....\n\n需要靠队友
97623,6,应群民,2019-01-22 12:14:08,0,0,0,老师人很好，上课非常负责。同学有疑问也能及时解答！
106211,6,应群民,2019-04-25 14:35:45,1,1,0,不水的课，真正学到了东西，很值。\n\n老师挺好，有求必应，笑容很赞，话不多但大多很精要。
112243,6,应群民,2019-07-04 00:02:08,1,1,0,电工电子学成绩靠自己，老师确实是慈眉善目极其亲切了。
112271,6,应群民,2019-07-04 00:32:01,0,0,0,老师人超好，就是讲的跟考试的比较无关。
112298,6,应群民,2019-07-04 01:05:21,0,0,0,老师笑容满分！成绩啥的靠自己学啦…
113402,6,应群民,2019-07-06 16:56:36,1,1,0,老师人很好，就是电工电子学这门课有点坑
113436,6,应群民,2019-07-06 17:20:02,1,1,0,组队遇上连电路图都看不懂的队友好气哦(´-ω-`)
155919,6,应群民,2022-06-16 14:09:55,0,0,0,感谢老师捞我到4.5！
156049,6,应群民,2022-06-17 08:38:37,0,0,0,好好好好好！
156965,6,应群民,2022-06-21 12:43:22,0,1,1,感谢老师捞到4.8
102984,66,李兴根,2019-02-25 08:02:47,0,0,0,是吧…
102989,66,李兴根,2019-02-25 08:29:22,0,0,0,是伐.是伐.是伐....听得有点烦，上课枯燥。评分真的这么好吗？（80%期末诶）
103000,66,李兴根,2019-02-25 09:38:02,-3,1,4,拖堂
106215,66,李兴根,2019-04-25 15:20:30,0,0,0,好老师！\n\n
106290,66,李兴根,2019-04-26 07:08:04,0,1,1,还不错！
107211,66,李兴根,2019-05-02 09:08:48,1,1,0,根哥虽然上课有点略无聊，但是这老师真是可爱，他说自从学校出台了每年的试卷不能和前三年重复30%，所以今年他就一口气出了四套卷纸hhh!这个课还是很有收获的！
268,75,沈建新,2015-03-14 23:46:47,10,19,9,内容充实。绝对值自己为课程学分付的学费！
6794,75,沈建新,2015-07-23 03:33:04,7,13,6,最好的老师！
21460,75,沈建新,2016-02-29 02:19:44,5,8,3,非常好
25095,75,沈建新,2016-05-05 08:26:52,5,6,1,很有水平，教的很好
25809,75,沈建新,2016-06-08 14:41:09,15,20,5,怎么说呢，这是我本科三年听过最有收获的课。沈老师不光人帅，讲解非常有体系，全程板书。推荐大家学一下。
28819,75,沈建新,2016-06-28 16:26:28,12,13,1,满满的全是气质
49489,75,沈建新,2017-04-17 02:33:19,4,6,2,良心好老师！
49780,75,沈建新,2017-04-26 01:50:54,7,9,2,人帅，讲课方式很赞
49924,75,沈建新,2017-04-27 08:20:53,29,32,3,沈男神，不解释！
49932,75,沈建新,2017-04-27 09:32:20,5,7,2,听课简直享受~还有糖吃
50422,75,沈建新,2017-05-03 00:25:29,22,24,2,明明可以靠脸，偏偏要靠才华
77205,75,沈建新,2018-05-03 16:07:57,2,5,3,超级好
77535,75,沈建新,2018-05-06 10:15:04,3,5,2,男神！上课还有巧克力吃！上课也很有逻辑！
78294,75,沈建新,2018-05-10 13:10:42,3,6,3,没课本就很烦
78295,75,沈建新,2018-05-10 13:11:32,4,7,3,认真听能学到东西的课，给分也良心！
78297,75,沈建新,2018-05-10 13:29:38,4,6,2,男神老师不解释！
78311,75,沈建新,2018-05-11 00:30:51,2,3,1,考砸了。。。
78313,75,沈建新,2018-05-11 00:49:40,7,11,4,老师讲很好，收获很大，难得的好老师，但是最关键的一个，拿高分需要付出很大代价，如果你有时间足够多，选这么快边学东西边刷绩点，如果不是的话还是建议不要选，毕竟考试60分的判断题很多学再好还是要看运气，考试时间很紧张，从个人角度看这一次的考试非常适合搞学术但不适合普通的考试，题目太抠字眼了，说完了
103305,75,沈建新,2019-05-05 23:45:21,-7,2,9,嘻嘻mjl
107210,75,沈建新,2019-05-02 09:02:13,3,10,7,电机系统建模只有沈老师一个人开，但是讲的超级好啊！虽然第一堂课老师说这门课比四大天书还难，最后考试大部分人都是60多，但是我觉得你只要认真听课做笔记，考试挺简单的，考的都是平时讲过的，所以我满绩了hhh
107648,75,沈建新,2019-05-08 02:55:33,3,4,1,好老师！把这门枯燥的课讲的很透彻风趣，最后一节课还发巧克力hhh
108760,75,沈建新,2019-06-01 13:14:29,2,2,0,男神！
109447,75,沈建新,2019-06-14 12:42:41,4,9,5,全电气工程的学生都应该来修沈男神的课！
127166,75,沈建新,2020-11-11 12:22:50,2,4,2,嘻嘻满级咯
182500,75,沈建新,2023-11-16 15:13:31,0,0,0,不可多得的好老师
191348,75,沈建新,2024-04-18 06:40:32,2,2,0,我愿称sjx老师为电院专业课老师中的标杆、楷模
191671,75,沈建新,2024-04-27 11:34:10,2,2,0,高中想象中的大学老师belike：
192870,75,沈建新,2024-05-31 06:44:25,2,2,0,绝对的男神，毫不夸张电院教学质量最好的老师，人格魅力也一骑绝尘
220692,75,沈建新,2025-06-19 08:35:51,0,0,0,男神！大力推荐现代永磁电机理论与控制！对相关研究有兴趣的可以学到很多东西。这个学期是没有考试的（以后不知道是不是）想水也可以水过去，给分很不错
28907,134,吴建德,2016-06-29 03:08:50,5,5,0,吴老师超负责，从来见过一个老师愿意帮你debug程序，1000多行的代码诶。
28922,134,吴建德,2016-06-29 03:37:37,6,7,1,老师很有耐心，会坐在你的座位上帮你看代码。汇编高手。
35495,134,吴建德,2016-11-10 07:21:32,4,4,0,超级好，人很nice
36696,134,吴建德,2016-11-15 12:02:51,4,5,1,吴老师人很老实的感觉，考试也是开卷，但是内容实在是太多了，考试如果不是对课程内容很熟悉的话很容易翻不过来...
38177,134,吴建德,2016-11-25 09:05:04,18,22,4,计网课会点名，讲得好不好我不知道，因为没听过，但是给分比董树峰还好，实验水得不能再水了。期末还是全开卷，作业题都会做，过一遍PPT，妥妥上90。
52792,134,吴建德,2017-06-23 02:34:50,2,2,0,真的很厉害的老师
54118,134,吴建德,2017-06-28 13:32:58,5,5,0,老师水平很高? 希望我以后对自己的专业知识也能这么信手拈来。另外，师生情超浓  ❤
54168,134,吴建德,2017-06-28 14:57:41,-2,0,2,不想说话。。。
55210,134,吴建德,2018-09-18 00:44:24,3,5,2,很萌萌哒的老师，微机课虽然有点枯燥但讲的确实很仔细，也会明确考试范围。感觉还是汇编高手呀hhh，仰慕一下！
60693,134,吴建德,2017-10-27 01:26:21,4,6,2,五个实验诶，短学期的课都忙不过来qwq
61659,134,吴建德,2017-11-20 01:54:40,1,4,3,老师很好的呀~有什么问题都会很耐心地解答，而且实验内容也还算轻松，期末考试开卷，理解基本概念就没问题啦
63732,134,吴建德,2017-12-13 15:26:58,1,2,1,非常nice的老师，一丝不苟，对学生很好
75082,134,吴建德,2018-03-07 09:02:33,1,4,3,电院的课来看，计网真的是比较容易拿满绩的了，认真上课，认真复习，实验弄明白，差不多就满了嘻嘻。虽然吴老师上课也不算很有趣但是就是觉得一个很厉害的老师讲课呆萌呆萌的 就能学的很认真2333
89204,134,吴建德,2018-11-16 16:54:02,9,9,0,cdc粉丝来此报到\n\n
89323,134,吴建德,2018-11-18 12:33:33,3,4,1,计网满了，果然认真听真的很容易满
89326,134,吴建德,2018-11-18 12:45:55,2,2,0,困..........
89403,134,吴建德,2018-11-19 03:12:34,4,4,0,非常nice的老师
89553,134,吴建德,2018-11-19 13:19:38,1,1,0,虽然上课可能会有点枯燥，但的确是很好的老师了
89724,134,吴建德,2018-11-20 12:01:06,3,3,0,儒雅随和 很负责
90272,134,吴建德,2018-11-23 02:24:19,2,2,0,上的计网。老师很好哈哈哈，给分很棒，课程也不是很难，好好学也会有收获。考试开卷，但是平时也要好好学，不然考试找不到，涉及理解的题目也会很吃力
139979,134,吴建德,2021-08-22 16:56:32,4,4,0,编程高手，老师对学生一点没有架子，而且始终在科研一线。
140383,134,吴建德,2021-09-10 11:03:47,3,3,0,老师真的牛，一直坚持在实验一线，看重技术，很棒。
151829,134,吴建德,2022-03-17 02:51:12,7,8,1,院网上唯一一个正装照还带wink的老师，好可爱啊哈哈哈哈哈
155565,134,吴建德,2022-06-14 10:38:41,3,3,0,老师真的非常nice，实验课帮你一步步调硬件，有问必答，甚至亲自帮你焊芯片，吹爆
169902,134,吴建德,2023-02-28 09:18:05,3,4,1,老师很好 第一次可能理解不进去 反复听很有收获 给分也好
176733,134,吴建德,2023-06-30 02:31:30,2,2,0,必须满分一手呀
191236,134,吴建德,2024-04-14 11:27:44,4,4,0,吴老师每次实验必来现场帮大家调程序，让ch的抽象无处施展，凭这就对得起高风亮节四个字。
196813,134,吴建德,2024-07-05 08:56:17,1,1,0,感谢gender救我狗命
210418,134,吴建德,2025-01-09 06:41:40,1,1,0,实验课非常仔细的帮同学调程序，平时有问题也会很详细的解答，坚持在科研一线的好老师
211293,134,吴建德,2025-01-11 06:57:02,-1,1,2,给老师磕一个\n\n计网课虽然枯燥、知识量巨大，但吴老师人很好，很有耐心，讲课水平也不错，而且最后总评也是尽力给大家高分了，算了下吴老师不仅平时分给我满了，还额外再在总评里加了一分，如蒙大恩感激不尽！QAQ
221852,134,吴建德,2025-06-27 02:09:51,0,0,0,爹！太捞了
8363,177,孙晖,2015-09-19 11:49:23,56,62,6,蛮悠闲的人，但还是挺负责的。人还蛮帅的XD
14560,177,孙晖,2016-06-12 07:01:16,-18,12,30,模电实验坑的要死，最后的摔板子就是神奇，人家电科专门焊板子都没听说过焊好板子还有摔板子的说法。经常说赶紧做完晚上我还要看电影之类也是醉了
15247,177,孙晖,2016-01-13 03:28:50,35,38,3,虽然实验报告要手写最后要摔板子各种要求高，不过感觉老师不论水平讲课质量还是负责程度都超高，总之不后悔上了孙老师的模电实验~
17637,177,孙晖,2016-01-20 14:10:23,22,23,1,老师要求大概是几个老师里最高的，摔板子这件事确实不能忍o(￣ヘ￣o)。不过要求高，学到的也很多。
19585,177,孙晖,2016-01-24 23:47:12,-4,7,11,一门模电实验把均绩拉下来0.15，啥也不说了。
25163,177,孙晖,2016-05-06 13:46:12,3,4,1,666666\n\n
25379,177,孙晖,2016-05-16 10:39:22,12,12,0,老师好帅，也好认真
25746,177,孙晖,2016-06-06 07:54:58,13,14,1,幽默，讲课水平很高。这学期最满意的老师没有之一。
26634,177,孙晖,2016-07-02 04:18:53,9,10,1,很有意思哒\n\n
28045,177,孙晖,2016-06-28 08:01:47,12,12,0,幽默，帅，严谨\n\n要求高点不过学的多啊
30534,177,孙晖,2016-07-02 00:45:49,-8,6,14,这老师真心坑爹
40984,177,孙晖,2017-01-07 08:26:41,6,6,0,好老师，报告认真写就会给满！！
41040,177,孙晖,2017-01-21 07:02:23,9,10,1,老师人真好！
41251,177,孙晖,2017-01-10 08:38:36,10,10,0,真心好老师 对学生很好 要求也很严格 现在已经不摔板子了
44386,177,孙晖,2017-01-17 16:55:27,4,5,1,最后考试崩了??\n\n老师人很莱斯
44471,177,孙晖,2017-01-18 00:53:39,6,6,0,棒棒哒
45301,177,孙晖,2017-01-19 09:34:36,7,7,0,不知道说什么了，只能说感谢
47463,177,孙晖,2017-01-27 05:17:27,9,9,0,这门课的要求其实没有很大。虽然在学习的过程由于对实验内容掌握不清晰导致觉得实验很难，但到期末复习回想的时候会觉得其实不是很难的。孙老师对同学们的要求会逐步提高，但每次实验自己认真预习完成，一定能完成所有的挑战的。孙老师有可爱的一面，够认真负责，但也不能因此要求老师帮你解决遇到的所有的困难。\n\n______记模拟电子技术实验
47659,177,孙晖,2017-02-14 09:47:55,1,2,1,按时间排序
49071,177,孙晖,2017-03-23 05:28:44,-21,3,24,差到不行，完全没有大学老师的风骨
50591,177,孙晖,2017-05-03 17:38:02,16,18,2,孙老师人很好的，感觉是和学生走得最近的老师了。能恶意卖萌，还能和我们一起吐槽别的老师，超级喜欢！\n\n虽然信号靠得晖头土脸考完心晖意冷但是还是要说：孙晖爸爸保佑我信号大实验！Σ(´∀｀；)
50710,177,孙晖,2017-05-04 12:38:35,13,13,0,孙晖老师太棒了
50739,177,孙晖,2017-05-04 23:29:39,-17,2,19,给分差\n\n
71467,177,孙晖,2018-01-28 13:26:29,22,23,1,长得帅，要求高，手写一学期报告，次次要仿真，不过学的也多，真心好老师！
73726,177,孙晖,2018-02-03 04:24:53,-19,1,20,上课挺好的，就是最后给分很迷，实验报告基本都4.5+，最后只有3.5，也是醉了
78662,177,孙晖,2018-05-14 09:07:24,-9,4,13,非常不喜欢，对基础差的同学一点也不友好
85728,177,孙晖,2018-07-30 13:43:40,-13,4,17,呵，为了个人目的让学生做大量与课程无关的东西
88668,177,孙晖,2018-11-05 08:27:18,3,5,2,举报了，助教脑子出差了吗
91594,177,孙晖,2018-12-15 01:39:32,2,3,1,就觉得老师很搞笑〜(￣▽￣〜)
92706,177,孙晖,2019-01-04 02:17:11,6,8,2,老师讲课的样子帅炸，老师随手拿起一根导线，一根表笔，随便测测就发现问题的时候，老师就是我男神了。
92803,177,孙晖,2019-01-04 13:30:41,3,4,1,太搞笑了！跟学生没有距离感！实验的时候还会绕着教室转一转说怎么没人问我问题呢，而且感觉老师理论也超强！除了手写报告真的痛苦qwq 老师还是很棒！
93071,177,孙晖,2019-01-07 07:52:36,9,9,0,老师很好，但是要求很高，当然学到的东西也多。但是班里恶竞严重(老师鼓励报告手写，做仿真)，这门课又要正态，所以懂？顺便说一下，我们班每人每次实验报告平均4.4(满分5)以上，真的是又累，绩点又差，难过。
93668,177,孙晖,2019-01-11 10:22:20,0,2,2,实验凉了\n\n爱过
100229,177,孙晖,2019-01-25 23:57:05,3,4,1,太感人了，刚刚出分，老师要求很多，考试内容在于平时积累，比如怎样测是否谐振，应该用示波器观察相位而不是判断电压最大。\n\n老师提倡手写报告，我手写几次后发现太慢了，就换打印了助教会可以压制非手写实验报告的分数，我手写的4.5+，但是打印的都只有4.3，记得每次实验都要模拟 注意思考题要认真完成\n\n实验考试我连色环电阻都能看错真的没想到这么感人π_π\n\n谢谢孙老师，来自d1某同学
100319,177,孙晖,2019-01-26 02:55:02,1,4,3,男神 幽默 助教大大也很好
100791,177,孙晖,2019-01-27 00:34:26,2,3,1,老师是好老师，学到的很多，但事情也是真的多，手写报告真的太麻烦了，而且每次反馈下来基本都是支持恶竞，
101134,177,孙晖,2019-01-27 15:31:13,7,9,2,只有2.5 但肯定是要给老师打了10分的\n\n最后可能是考试。考崩了最后实操没出来 就是老师说的那种哭着走出去的吧\n\n这门课只有1.5学分 但是孙晖老师的班级是可以学出两倍学分的感受\n\n报告要求很高，同学们为了绩点也会恶竞，每周手写报告会花很多时间。但是我是真真切切学到了很多东西，甚至有些模电的理论知识是在实验里完全理解的，老师说的三斧头法记得很清楚。\n\n上课做实验绝不是无脑的体力操作是需要动脑子的，最好要预习一遍。我比较菜实验遇到故障，然后基本次次呼叫老师，老师都是给你一个假设然后一步步带着你去排查故障，让你自己思考到底是哪里出问题了。老师看着悠闲还会怼怼我们这些小菜鸡，但是无论是理论还是实操都是很有水平的。\n\n至于报告，比别的老师要求高不少，看别的班的同学轻松打印几页报告有时候也会真实地觉得老师是魔鬼，但我从一个数据处理的菜鸡 到最后熟练应用Excel各种功能 学会matlab拟合 熟练Multisim仿真，（导致大物实验的电学实验我觉得很简单 惠更斯电桥那个好像没花多久处理数据拿了98 建议学模电的小朋友去选电学实验鸭）\n\n老师在课前课后会和你唠唠嗑，很搞笑是真的啦。\n\n不过想要事少分高的人还是避开老师叭~\n\n写了这么多，很想念东三的模电实验室啦 希望下学期去东三还可以碰见老师打个招呼~
104962,177,孙晖,2019-04-01 04:26:45,-3,2,5,感觉讲的很乱
105097,177,孙晖,2019-04-03 13:43:28,3,3,0,课上听课云里雾里，课后回忆令人窒息
105359,177,孙晖,2019-04-10 13:02:35,1,1,0,课上的还行，就是手写实验报告事多
106143,177,孙晖,2019-04-25 08:07:05,1,3,2,被各种变换搞得晕头昏脑是一种什么感受？痛并快乐着。
106156,177,孙晖,2019-04-25 10:22:22,3,3,0,信号凉了，希望老师手下留情
106205,177,孙晖,2019-05-06 07:16:34,0,1,1,谢谢老师不杀之恩
113178,177,孙晖,2019-07-06 01:11:54,8,11,3,分数和付出差太多了，很不爽
113224,177,孙晖,2019-07-06 02:11:55,6,7,1,赞同楼上，信号实验花的时间多，分数不理想...
113319,177,孙晖,2019-07-06 05:55:33,6,8,2,感觉1学分的课上成了10学分，最后也没学到啥。成绩也
113831,177,孙晖,2019-07-07 17:18:01,0,2,2,谢谢老师！
116594,177,孙晖,2019-09-12 02:54:45,-9,4,13,1分还用说
118073,177,孙晖,2019-10-20 09:04:26,1,2,1,电工电子学好可爱啊
118544,177,孙晖,2019-10-28 10:29:39,5,5,0,所以可以打印了？
120604,177,孙晖,2020-01-13 19:24:06,5,8,3,我tm好好的板子就是被您摔坏了。摔坏了之后还让我重焊。。。都期末了谁有那时间啊？再见再见再见
120974,177,孙晖,2020-01-19 06:10:04,1,3,2,老师上课言简意赅，而且十分幽默。虽然实验报告存在一定恶竞，但是认真做一个学期下来真的能够学到挺多东西的。
121132,177,孙晖,2020-01-19 22:48:55,0,2,2,实验课也不好说啥，老师表面上看着严厉，但还是蛮负责的一个老师。对于不会的，老师会耐心指导，注重启发，虽然最后成绩一般，是自己菜的问题。
129561,177,孙晖,2021-01-07 08:25:49,3,5,2,老师人真的很幽默，然后上他的课也学到的挺多的，摔板子是很正常的啊又不是把电路板摔掉，他只是看看你焊的牢不牢，这也是对学生的负责啊，就是在桌上拍一下，老师真的很棒，讲课也很好。
130005,177,孙晖,2021-01-15 01:15:17,15,16,1,爱班同学快跑！
132167,177,孙晖,2021-01-30 21:02:53,4,9,5,孙晖老师人超级幽默，能力也很强，关键真的非常非常没有距离感。这学期模电实验课我基本次次会遇到一些大大小小的问题，每次呼叫老师都会过来指导(虽然经常怼怼我这个小菜鸡，但真的是很乐于和我们一起处理问题，没有不耐烦什么的)。但老师上课对理论讲解可能太概括，建议上课前自己把理论部分先预习一下。总之孙晖老师的模电实验课真的能学到很多东西，力荐!
141071,177,孙晖,2021-09-22 16:35:15,-13,7,20,不配为人师表
142007,177,孙晖,2021-11-03 16:37:34,11,14,3,太恶竞了！！！！！！！事情比起隔壁班不知多了多少，对实验报告的要求奇高，一口一个“建议学有余力的同学...”谁真的这么学有余力啊
143827,177,孙晖,2021-12-30 14:51:42,6,8,2,实验寄了呜呜呜呜，老师捞捞
145310,177,孙晖,2021-12-29 03:40:26,-3,2,5,老师人真的好，但是我学不会电工电子啊这门课对我这种高中没有技术基础且动手能力垃圾的省外孩子真的太难了我难哭了，还没期末考，先来拜拜孙老师，求给过吧
146414,177,孙晖,2022-01-06 13:54:57,0,3,3,虽然还没考试（明天考）哈哈，但是还是先来给老师打个满分！（也是一种祈福了？狗头）\n\n老师真的超可爱超有趣，很幽默，很耐心，实验课的话会下来帮我们检查问题～\n\n电工电子学一开始可能不是那么好懂，但是复习的时候多做做题，不要死记硬背，想清楚原理会觉得还挺有趣的！
152280,177,孙晖,2022-04-01 07:47:01,5,5,0,模电实验，平时报告篇幅要求比较高，格式要求高，有点费时间，但实验过程相对比较水而且报告只要不缺什么关键要素基本都是4.9或者5.0。老师比较耐心不会乱骂人，我提的很sb的问题都会认真回答，会帮检查电路排故障。最后随堂测试占比大，但我几乎全是蒙的最后也上了4.5。给分应该算好吧。
158525,177,孙晖,2022-06-30 03:50:30,1,2,1,人帅事少，课讲的好，负责幽默给分好。
158526,177,孙晖,2022-06-30 03:50:31,1,1,0,人帅事少，课讲的好，负责幽默给分好。
164337,177,孙晖,2022-12-20 10:19:42,0,0,0,孙老师捞捞我吧
168592,177,孙晖,2023-02-20 04:18:03,0,0,0,救人于水火之中，捞人是真海底捞
169312,177,孙晖,2023-02-25 11:05:59,0,0,0,人帅幽默给分好，平时实验报告可能要求会比较高，但是真能学到东西，这次到了期末事情也比其他班少，真神了。
169429,177,孙晖,2023-02-26 06:38:26,1,1,0,好温柔的孙哥。平时分给满
169448,177,孙晖,2023-02-26 07:58:37,1,1,0,很给力
169900,177,孙晖,2023-02-28 09:12:52,0,1,1,爱班信号理论+实验\n\nsun roam真的好好！\n\n平时分很好 课也讲很好\n\n一鸣助教小哥哥也超好！\n\n实验真的很能锻炼人 不要怕累 做一个小项目是很有成就感的事 而且那个课形式很有意思 当组长虽然忙也蛮有意思的
170958,177,孙晖,2023-03-13 09:11:40,1,1,0,很负责很有耐心
171030,177,孙晖,2023-03-14 12:07:30,0,0,0,负责有耐心，喜欢开玩笑讲笑话，模电实验课讲的清楚不拖沓，基础很差也能很好完成实验，也会亲自指导怎么做，满昏！！
174400,177,孙晖,2023-06-12 02:17:16,0,1,1,老师上课很幽默，人也很好，钉钉回消息很快，从考试前公布的分数看来给分也不错，只可惜我是废物
175083,177,孙晖,2023-06-21 12:20:21,6,6,0,电工电子学及实验，我隔壁bzh班的，期末复习来听了几节课，快要哭出来了\n\ntm原来这门课可以被上的这么好的
178047,177,孙晖,2023-07-06 11:14:24,0,0,0,上课认真听，电工电子学及实验轻松掌握。上课讲得好，给分给的好，人帅还幽默。还能有什么更高的要求呢？
178049,177,孙晖,2023-07-06 11:54:57,2,2,0,上课很有条理且清晰，还会来点冷笑话啥的哈哈，而且老师期末的时候钉钉答疑回复得很快，跟着期末复习课的思路复习，直接满了，开心
178568,177,孙晖,2023-07-15 02:28:13,0,0,0,上课无敌，给分无敌
197239,177,孙晖,2024-07-09 17:04:54,0,0,0,给分无敌!!!!
197273,177,孙晖,2024-07-10 06:02:38,3,4,1,1、从来不布置刁难学生的点名任务；\n\n2、水平高 学识扎实 讲课逻辑清晰 突出重点（虽然我一直跟不上 这门课还是内容较多难度较大的）；\n\n3、课后答疑特别耐心 每次钉钉上问老师问题老师都会及时解答 而且解答得很详细；\n\n4、给分特别特别特别特别特别好 。\n\n我是其他工科学院上电工电子学及实验的同学，单就电工电子学这一门课来说，真的希望孙老师的评分收敛于10！😭
205820,177,孙晖,2024-12-12 06:36:27,0,1,1,模电实验人很好~
212023,177,孙晖,2025-01-13 04:56:06,0,1,1,模电实验强烈推荐选孙晖老师的课，老师和助教人都超好，给分无敌，讲课和PPT也很好
218710,177,孙晖,2025-04-29 10:43:39,0,0,0,sunroam真是好人啊，上课幽默，给分无敌！
221007,177,孙晖,2025-06-20 16:04:03,0,1,1,好老师！！！！！
2997,205,朱晓雷,2015-05-12 12:10:36,4,4,0,课无聊 但是人真不错！
24449,205,朱晓雷,2016-04-30 14:12:02,0,0,0,人超级nice
48933,205,朱晓雷,2017-03-17 01:16:31,0,0,0,朱晓雷的神奇之处在于，只要他一张嘴，大家就想睡觉。
129626,205,朱晓雷,2021-01-09 07:04:01,0,0,0,一曲肝肠断，千军万马来相见
9924,209,杨强,2015-11-12 18:05:31,36,42,6,每次只点5个人
10716,209,杨强,2015-11-23 03:01:20,12,13,1,帅酷炫
10800,209,杨强,2015-11-23 05:38:42,0,1,1,666
10801,209,杨强,2015-11-23 05:39:23,2,4,2,6666
10802,209,杨强,2015-11-23 05:40:09,15,17,2,认识了杜亮
10803,209,杨强,2015-11-23 05:40:25,9,10,1,风趣幽默信星座
10813,209,杨强,2015-11-23 06:03:38,2,3,1,不错啊
10816,209,杨强,2015-11-23 06:10:57,4,5,1,酸爽的赶脚
11042,209,杨强,2015-11-24 03:43:59,6,7,1,1l最帅
12774,209,杨强,2015-12-24 03:38:44,5,5,0,麻辣教师
33069,209,杨强,2016-09-11 13:44:48,14,14,0,风趣上课满教室散步
43739,209,杨强,2017-01-17 01:59:52,3,4,1,真男神
59200,209,杨强,2017-09-20 07:18:51,5,7,2,非典型工科男神
116946,209,杨强,2019-09-17 13:14:37,1,3,2,给分很不好
131753,209,杨强,2021-01-28 17:26:05,2,4,2,爱了爱了！！！风趣幽默，考试也很人性化！！！开卷，给分好！！！
133790,209,杨强,2021-03-05 10:45:49,3,4,1,可以用糊弄来形容
137156,209,杨强,2021-07-01 14:37:17,0,1,1,有一种冷幽默，人很好
152573,209,杨强,2022-04-15 02:10:52,0,0,0,侍坐。
152614,209,杨强,2022-04-16 02:07:31,15,18,3,虽然你上课破防急眼到处摇人的样子很狼狈，但是你考试疯狂出原题的样子真的很靓仔
152615,209,杨强,2022-04-16 02:17:30,0,2,2,杨强，我的超人
170336,209,杨强,2023-03-03 02:47:25,4,5,1,很催眠啊，，，对我来说感觉声音很催眠，还喜欢来盯你玩手机啥的
173327,209,杨强,2023-05-19 06:37:30,0,2,2,杨强，我的超人
190612,209,杨强,2024-03-11 14:52:11,5,6,1,上课太能冷暴力了🥶🥶🥶
194598,209,杨强,2024-06-24 13:49:12,2,3,1,给分很迷...期末的开卷考试很简单，PPT和书上基本都有原题，在大家做的差不多的情况下，我和同组的一个同学居然总评能差3分，且我们的分工都是一样的。怀疑评分标准的合理性
194618,209,杨强,2024-06-24 15:32:17,2,2,0,给分真一般，没之前几年吹的那么狠。但事情确实是少
203793,209,杨强,2024-11-21 05:43:06,0,0,0,杨老师人超好!
216521,209,杨强,2025-04-19 08:29:56,9,9,0,挺帅的，水课就应该这么上，前几节课简单过一遍教材，后面就安排展示和交流，考试开卷。老师和学生一起水，又能学到课本外的前沿知识，这不是皆大欢喜么，点名传感和计控等一众又臭又长水课\n\n\n\n考完更新：不是哥们，演都不演了，四个计算题三个PPT原题，数据都不带改的，剩下一个纯送分。预计期末卷面平均分在95分以上。
218881,209,杨强,2025-05-10 14:59:09,-8,1,9,缺勤1次扣5分，本人缺勤1次总评91，考前补天三小时
23554,243,陈忠根,2016-04-06 02:43:11,6,6,0,挺喜欢这个老师的，很有热情，除了口音有时会听不懂
26867,243,陈忠根,2016-06-21 11:21:28,0,0,0,老师人很好呐！
32033,243,陈忠根,2016-07-05 12:25:43,2,2,0,老师我爱你！！！我要给你生猴子！！！！！！！！！
32035,243,陈忠根,2016-07-05 12:31:21,0,0,0,老师人很好，做实验指导得很耐心。期末考试的时候跟同学们借糖的情景让人觉得超级有爱。
32156,243,陈忠根,2016-07-06 00:11:38,0,0,0,老师口音有点重但是可以看出来他在很努力的让我们听懂，给分也很好。。。
32161,243,陈忠根,2016-07-06 00:14:32,0,0,0,好老师！
32451,243,陈忠根,2016-07-07 02:16:14,0,0,0,超级超级超级萌
32758,243,陈忠根,2016-07-12 09:58:00,0,0,0,萌萌哒，可惜退休了
545,263,童梅,2015-03-15 04:43:09,43,45,2,女神炒鸡好！讲课超级有趣！
771,263,童梅,2015-03-17 00:44:18,8,10,2,挺棒的
1385,263,童梅,2015-03-22 01:27:12,26,31,5,童梅姐姐果断女神！我没有满绩是我对不起她。。。
1465,263,童梅,2015-03-22 05:39:36,5,7,2,梅姐姐好好好！
2297,263,童梅,2015-04-17 03:24:49,3,5,2,讲题思路条理清晰，人又好！
2332,263,童梅,2015-04-23 05:27:12,4,6,2,超好
2743,263,童梅,2015-05-06 15:08:13,11,13,2,童女神啊，超级赞，上课比较好玩，不容易犯困
3816,263,童梅,2015-06-17 05:02:52,7,8,1,不错的
3991,263,童梅,2015-06-17 12:35:06,3,5,2,不错的老师
8273,263,童梅,2015-09-18 02:38:02,27,29,2,逗比女神，年轻时一定很有魅力..上课很有意思，各种故事..很有兴趣.
8274,263,童梅,2015-09-18 02:38:43,1,4,3,逗逗的女神 讲课很有趣啊~赞赞赞！
8556,263,童梅,2015-09-22 10:05:26,1,4,3,简直女神～还会讲一些有趣的事
9057,263,童梅,2015-10-12 02:06:55,6,7,1,女神~讲课超级棒~
10330,263,童梅,2015-11-18 05:54:52,18,21,3,老美的故事
12458,263,童梅,2015-12-23 10:27:00,2,4,2,超级棒
13198,263,童梅,2015-12-25 07:04:25,10,12,2,童梅老师是我见过的最有气质最有亲和力的老师！说是女神一点也不过分！上课条理很清晰，讲题也会详细地一步步讲，让我一个物理无能者也能懂电路的课！
14383,263,童梅,2016-01-06 15:52:33,2,5,3,讲的是清楚。但是没有启发性。
20040,263,童梅,2016-01-26 02:55:04,7,9,2,给分也太好了吧。。占50%的期中跪了，期末考得好居然能补回来！！
20230,263,童梅,2016-01-26 15:23:30,7,9,2,给分好到以为登错了
20611,263,童梅,2016-01-29 04:05:43,0,3,3,好老师！！！！！！\n\n
28938,263,童梅,2016-06-29 03:58:25,1,5,4,虽然我只有60，但是那是我的问题……梅女神真的是我见到最有气质的女老师
34108,263,童梅,2016-09-27 05:23:23,1,3,2,超级好
36269,263,童梅,2016-11-11 11:20:34,-5,2,7,?三个字
46895,263,童梅,2017-01-22 21:27:40,5,12,7,大二上，第一次上专业课电路和数电，秋学期电路，冬学期数电。电路真的全程蒙逼，没怎么听懂，不过真的是自己没有适应，但是感觉老师也没有理解我的心理，无法提出一些针对性结果秋学期就蒙逼过去了，结果占40％的期中考原地爆炸（没问成绩，但是感觉只有七十几分）。冬学期的数电比较简单，也有点适应专业课的节奏了，一周六节课也能咬下来，期末考也比较简单。 \n\n课上讲很多复杂的东西，最后都是了解性质，考试不考。\n\n学习电路数电最好的方法，应该是老师布置的题目认真完成，考前看课件和平时的作业题，刷题一到二套就够了。\n\n老师平时也会讲些段子，哦对老师会给各种加分，虽然期中考不好，最后给分很好，谢谢老师的辛勤付出。
46903,263,童梅,2017-01-23 00:43:52,-2,4,6,讲得的确是不错，但是她给分真的很好吗...被85分卡绩点的人欲哭无泪
46927,263,童梅,2017-01-23 02:52:07,3,6,3,女神超级棒，给分好好，有种愧对于这学期的学习状态
67195,263,童梅,2018-01-20 12:36:50,1,3,2,我上的电路实验课，非常棒，期末按排名给等级，人超好，我也表达不好，就十分吧！
73752,263,童梅,2018-02-03 05:06:25,3,5,2,刚接触电路课，感觉有点不适应，两次考试都崩掉了，但是老师讲得真的很好，赞
73768,263,童梅,2018-02-03 05:17:07,-4,5,9,机会都不给
73775,263,童梅,2018-02-03 05:25:39,3,7,4,有一种幽默叫童老师
73780,263,童梅,2018-02-03 05:30:56,2,6,4,老师讲的很细致，会建课程群平时可以答疑问作业，课后问再简单的问题都不会嫌弃还会耐心跟你讲都不怕耽搁吃饭qwq有时候上完课解答完问题吃了饼干就去开会了qwq期末问什么时候出分的时候老师说你们做了俩小时的卷子我花半小时看才对得起你们呀努力给大家找得分点尽量给多一点分真的超感动qwq大爱童妈
73883,263,童梅,2018-02-03 10:15:20,7,9,2,童姐姐上课很赞 事少 另外期中电路也没考好 但是数电简单些 期末考好点 最后结果也不会差 另外 有线上QQ答疑群 疑问都统一解答 很赞的 如果某些人得了差分 为什么不先想想是不是自己的问题？
73894,263,童梅,2018-02-03 11:08:32,1,3,2,三个字
78746,263,童梅,2018-05-15 03:17:25,7,8,1,绝了简直是标准的女神级别大学老师……满足我所有对大学老师的幻想，给分超好
82531,263,童梅,2018-07-08 12:12:43,0,1,1,老师上课超级认真，实验报告要求很详细，女神！
87953,263,童梅,2018-10-18 12:58:59,0,1,1,梅姐超级好的，真的好，炒鸡赞，还有趣。超爱
88249,263,童梅,2019-01-19 08:31:34,14,18,4,老师人很好，周二345第一排的傻逼同学，请你闭嘴好吗？
92274,263,童梅,2018-12-27 11:04:27,2,3,1,如果有留学生建议选她的课、有问题她很耐心跟你一步一步讲
93272,263,童梅,2019-01-08 14:51:37,3,4,1,很亲切\n\n真好！\n\n233有时候冷笑话还是很好笑的
100089,263,童梅,2019-01-25 14:38:19,5,6,1,出分之前先来说一句，老师真的好可爱啊
100106,263,童梅,2019-01-25 15:09:04,2,3,1,老师巨好，没出成绩前先来夸一波
100358,263,童梅,2019-01-26 03:44:26,21,23,2,老师太好了！！以后想找个老师这样的女朋友！
100386,263,童梅,2019-01-26 04:36:35,5,7,2,老师太好了呜呜呜，期中考试电路自己感觉极差也没敢问分数，但期末考试好好复习，最后结果也不会差！太感谢老师了！
100438,263,童梅,2019-01-26 06:33:43,4,6,2,女神嗷嗷嗷嗷！想成为像老师这样的人……讲课超级清楚并且讲课前还会带你回顾上节课学的东西～有时候课间还会讲一些有意思的东西，超爱老师！
104218,263,童梅,2019-04-11 11:33:52,2,2,0,老师还是不错的
107478,263,童梅,2019-05-05 14:08:20,2,2,0,电网络和数电都是老师的，讲课速度很合适，讲的很慢而且很清楚，对于我这种思维迟缓的学生来说非常友好。作业在考前会统一清查哪些人没交，然后提醒大家补交，会讲作业题。给分超好。
109524,263,童梅,2019-06-16 10:34:48,0,0,0,给分极好，老师人也极好，很可爱
118077,263,童梅,2019-10-20 13:20:11,0,0,0,童梅老师的助教是我见过最认真负责的助教 真的表示感谢
121682,263,童梅,2020-01-20 20:31:20,-4,1,5,有一说一，讲得太慢了。对基础差的学生可能比较友好，会讲习题，作业也可以补交，平时分不愁。老师人也很好，虽然不适合我，但还是给10分吧。
121726,263,童梅,2020-01-21 08:06:15,6,6,0,我要找个像老师一样的女票
121856,263,童梅,2020-01-22 15:43:51,0,0,0,老师炒鸡好
121871,263,童梅,2020-01-23 04:43:02,6,7,1,老师超级好！我电路与电子技术1期中考砸，前两道大题33分基本没怎么写。期末想扳回局势结果也没做完卷子。最后老师调了分给我85，卡绩也还算满意。
125935,263,童梅,2020-09-16 01:47:39,1,1,0,童老师我女神
132231,263,童梅,2021-01-31 06:59:01,1,1,0,童梅女神啊
133693,263,童梅,2021-03-04 02:14:34,2,2,0,童老师点名也不计分，上课好，长得又漂亮，还有什么好计较的呢？
140830,263,童梅,2021-09-16 14:29:54,0,0,0,童老师女神！
143683,263,童梅,2021-12-01 13:49:13,0,0,0,很好的老师！！
149717,263,童梅,2022-01-16 14:11:39,6,6,0,考试成绩出来了，感觉电路1的给分可以说是极好，出乎了我的意料。\n\n童老师真的是如女神般的老师，上电路课的节奏把控的非常好，讲课，习题，复习，井井有条\n\n但也有美中不足的地方，感觉一是数电课上，上到器件原理的地方完全找不到重点，于是只能靠自学\n\n二是教材，这个学期复习摸鱼时看了国外的教材，才深感国内外教材的差距，国外的教材编排真的合理，和我们教学的顺序可以说是几乎完全一致 知识点也有条有理。我们和国外的差距还比较大啊。\n\n但是课程的问题，和教材的问题，绝对不会妨碍女神在我心中的形象
151042,263,童梅,2022-02-22 06:53:36,2,2,0,好!!
162581,263,童梅,2022-11-26 10:38:08,3,3,0,超级好
168494,263,童梅,2023-02-26 07:49:20,13,13,0,数电齁必多，真假梅姐说\n\n…\n\n今天刚结束数电考试，过来拜拜童老师\n\n出分了来补几句\n\n整个电路教学组基本都比较求是\n\n相比之下童老师平时分是很好拿的，我凭着高中存下来的数电信仰考的还凑合
169435,263,童梅,2023-02-26 07:01:13,8,8,0,[电路与电子技术一]我真的哭死，期末最后倒数第二道大题做的迷迷糊糊，倒数第一道题看都没看，最后总评还有85;同时童老师上课特别有意思，经常跟我们聊天开玩笑，小测也是点名性质，平时分好好做作业就能满;老师人也很好说话，作业也可以补交，可惜老师不开电路二😞;另外电路期中和期末考试题目量都很大，平时练习要做得很熟练
169443,263,童梅,2023-02-26 07:39:26,2,2,0,女神YYDS
169482,263,童梅,2023-02-26 11:27:56,1,2,1,求是的一批 QAQ\n\n这次期末题量巨多，前面习惯性检查了一下，直接答不完卷了
169571,263,童梅,2023-02-27 03:31:45,12,12,0,老师真的好，可惜不开模电，不然直接无脑选了
169746,263,童梅,2023-02-27 15:28:22,3,4,1,神仙般的老师，对教学内容有着天才一样的理解，却有着十分亲和的烟火气和亲和力。说着不划重点，教学过程中却无时无刻不在划重点。\n\n\n\n讲下给分。自己寒假太摆了导致得分不是很理想。电路I的给分会分成三个部分，平时分30+期中30+期末40。童老师的平时分几乎都给满或接近给满。期中是流水改卷、各个老师自己找分，老师会反复强调期中给分的规则，我自己查了分数，发现比预期高了很多很多（老师和助教（不知道有没有）阅卷的时候是真的在贯彻自己给分的神仙规则！！）。期末是流水改卷、统一给分，这部分给分是课程组统一的，会和前60分分开输入，所以这部分会比较求是。建议大家期末好好准备，电路I得期末者得天下。\n\n\n\n电路I这门课给分实际上每个老师的差距都不大，童老师会尽力按规则给你找分，但是说实话重要的还是自己的理解。就从教学水平这方面看，选课的时候，无脑选童老师就对了。
170921,263,童梅,2023-03-12 12:21:08,4,4,0,上了几天模电戴维南做不明白，回来听电路课，很后悔老师引进门自己没好好学，提醒后面的学弟学妹们真的要好好学电路
171119,263,童梅,2023-03-16 07:17:32,1,1,0,特别特别喜欢
171892,263,童梅,2023-04-11 09:13:38,4,4,0,找nvpy就要找这样的女神呀
171971,263,童梅,2023-04-14 10:36:20,2,2,0,人美心善好老师
173211,263,童梅,2023-05-16 09:52:13,11,11,0,只能说算分看起来很求是，出成绩总是最慢，但给分却很好
181862,263,童梅,2023-11-02 13:44:39,5,5,0,每年秋学期的第一节课 老师应该都会放一张“老师，您教的都是没用的东西——我不许你这样说自己”的ppt\n\n谢谢老师 真的教了很多很有用的东西
184085,263,童梅,2023-12-08 08:35:53,0,0,0,2023年12月8日，老师发起了群签到……
187894,263,童梅,2024-01-17 17:05:54,3,3,0,虽然我不是童老师班上的同学，但是童老师每一节课我都智云上听了，最喜欢的老师之一，老师上课是我在浙大里上过的课的几乎所有老师里属于最好的一批，特别是电路原理，对于知识点融会贯通，还会带着大家做题，重现做题思路，有时候会教一些简便的算法，我只能说，跟着童老师上课，准没错！！跟着童老师（的智云）上了一学期，拿下满绩，老师上课还会讲段子，爱爱爱爱！！！
188783,263,童梅,2024-01-20 02:31:54,1,1,0,老师上课很好，平时分真的就是态度到了全部给满，小测不论对错。\n\n讲课很好很细致，人也很好很风趣。\n\n卷子改的不算特别严，有一次群签到但不计分（只有小测算点名）。\n\n老师很好，可惜要退休了。\n\n祝老师退休快乐！
190573,263,童梅,2024-03-09 11:15:32,3,3,0,满昏！\n\n老师退休快乐~
192382,263,童梅,2024-05-17 04:17:10,0,0,0,老师讲的非常好没的说还不怎么点名（电网络），平时作业只要不抄就是满分（电网络），唯一的缺点是实验部分给分扣扣搜搜
197226,263,童梅,2024-07-09 13:17:32,0,0,0,虽然数电课没学好没考好对不起童老师，但是童老师给我打下了比较好的电路分析基础，模电课考的还不错，谢谢童梅老师，教给了我有用的东西！
3182,264,张冶沁,2015-05-19 10:41:28,1,14,13,什么jb老师，作业多的要死给分超低，而且平常上课自己都讲不清楚，学生问她问题她一概回答：不知道。瞎jb扯蛋的
3428,264,张冶沁,2015-06-12 07:22:32,1,13,12,麻痹，上这个鬼老师的课也是醉了，平常事情一大堆不说，给分特别坑，而且期末要写3000字的实验心得，写个锤子啊！
6045,264,张冶沁,2015-07-10 12:33:17,16,26,10,张老师的课能教给我们很多有用的东西~而且给我们讲解起来也是很热心的哟~_~
6146,264,张冶沁,2015-07-11 09:05:59,-1,5,6,实验课作业比较多，但因为是等级制给分，要符合正态，分相对较低，但老师很好。
20815,264,张冶沁,2016-02-01 05:11:18,8,13,5,很好的老师，但学校的强制等级制实验课打分搞得老师也很无奈！
26064,264,张冶沁,2016-06-15 09:46:48,-2,3,5,很好的老师，热心！
29316,264,张冶沁,2016-06-29 15:05:00,0,5,5,好老师，挺和蔼滴
30559,264,张冶沁,2016-07-02 03:08:55,5,8,3, 莫名其妙
32903,264,张冶沁,2016-07-27 06:09:50,4,9,5,简直了 废话一堆 自己都讲不明白
32908,264,张冶沁,2016-07-28 06:23:20,4,9,5,讲什么东西
33066,264,张冶沁,2016-09-11 12:51:45,-5,1,6,大一暑期实验课蛮好的
33078,264,张冶沁,2016-09-12 05:43:12,-4,2,6,电工电子实习给分蛮好的～
42368,264,张冶沁,2017-01-14 05:35:02,2,6,4,给分不好
43976,264,张冶沁,2017-01-17 07:22:02,-6,0,6,不怪老师我自己没好好学
52662,264,张冶沁,2017-06-22 04:40:16,1,3,2,作业多
66062,264,张冶沁,2018-01-11 08:39:22,-6,2,8,老师是真的好，结果不管怎么样都要给老师10分，太好的老师。
66709,264,张冶沁,2018-01-18 12:13:23,-6,5,11,挺好啊，要求也比熊老师班少，完全没有恶竞，不用仿真，报告也比另一个班少写几次～(￣▽￣～)~
66734,264,张冶沁,2018-01-18 15:13:18,3,4,1,分有点低
69536,264,张冶沁,2018-01-25 03:07:36,-3,1,4,萌萌哒
75620,264,张冶沁,2018-03-14 06:18:20,4,8,4,不好啊。。。
85341,264,张冶沁,2018-07-17 05:50:49,3,8,5,给分怎么这么差啊，跟进了更年期似的，大吼大叫，实验课全班平均分没到80，坑货➕绩杀，和熊素铭老师差远了，也根本没法和潘丽萍老师比。
85596,264,张冶沁,2018-07-20 09:43:39,3,11,8,无责任感，无耐心，无师德！若有零分，不会给一分！
85668,264,张冶沁,2018-07-25 00:39:33,5,9,4,在讲什么东西啊……学生问问题基本都是答非所问，实在不行了就去找其他老师过来看……这水平呵呵了
85669,264,张冶沁,2018-07-25 01:05:44,6,13,7,完全不知道她在讲什么，什么东西也不会，只会找其它老师来帮忙，呵呵了。
85683,264,张冶沁,2018-07-25 13:36:46,10,20,10,整一个更年期妇女，开始的时候挺温柔的，后来越来越无法描述。讲东西讲不清，难的问她不知道，简单的呢回答几次就跟全班说她回答多了嗓子疼，自己去解决，她不管了（实际上是她讲课的时候没说清），说话全靠吼，成天“不知道，我怎么知道，你自己去弄”三连，同学真的自己弄不出来了问她，她又啥也不会，打电话发微信去找别的老师过来，别的老师说她弄错了她还要一直说这个就是这样的，其他老师纠正了半天看没用，也就走了，然后她连着好两天一直在念叨之前的那个错误，说就是她那样的，明明是之前的同学瞎搞这种。电子电工实习基本都靠自学+PPT+同学交流。听说还有模电的课，别吧……\n\n老师人大部分时候还是不错的，但水平呵呵……真的是无法描述……
87245,264,张冶沁,2018-09-26 05:30:36,4,6,2,上到第二节课的感受 ：完全不知道她在讲什么 看ppt也是懵圈的 怀疑自己是不是上这个课之前还要上其他预修课
87255,264,张冶沁,2018-09-26 06:43:05,4,8,4,我只能说，讲了个鸡儿
91365,264,张冶沁,2018-12-06 15:09:48,0,3,3,我感觉这是个好老师，讲课一开始觉得条理不清晰，但后来熟悉老师风格之后觉得很不错，该拓展的地方拓展，有的不讲，老师有自己的判断。跟她上课就感觉很好玩，很有趣，无论如何，我确实是从老师这里学到不少东西，老师的耐心是另一种耐心。
93374,264,张冶沁,2019-01-09 08:07:14,19,22,3,老师其实挺好的，这门课的问题在于很多时候理论还没上就做实验了，所以很多时候听不懂老师在讲什么。期末再看老师的ppt其实还是挺有条理的。
93531,264,张冶沁,2019-01-10 07:48:44,9,11,2,唔，刚考完试就来评价一波。\n\n首先报告是电子版+打印！\n\n电子版！\n\n电子版！\n\n重要的事说三遍，我已经不知道看着多少我认识的人上别人的实验课写到手断的了。\n\n然后就是这个老师，确实嗓门比较大。不过一般吼我的时候，都是我中午没睡觉上课没听，不知道怎么弄的时候。也不能说全怪老师吧，强调了三遍都不听，换我我也窝火。\n\n但其实老师人是很好的，属于刀子嘴豆腐心那种，一边吼你一边帮你找问题。\n\n老师有时候会在群里唠家常还有看着同学犯傻偷笑。。。(๑‾᷅^‾᷅๑) 嫌弃你  就这样\n\n最后，不管怎么样，确实是一个好老师，不过要是各位非要要求每个老师都像你妈一样温声细语的，那出门右拐盾妈。
94120,264,张冶沁,2019-01-15 08:18:58,-1,3,4,两个字，恐怖，学弟学妹们能不选就别选她的课
95999,264,张冶沁,2019-01-20 10:52:40,2,5,3,不要看评论里面说老师不想回答问题，我前几次实验课没预习好问了老师，她都很耐心地回答的。这是一门实验课，自己课前不好好预习遇到问题也不去思考就想着老师帮你解决？最后的作业是个电路板，前面的没学会你觉得电路板你做得好吗？后面的课我都没问过问题，自己仔细研究ppt，虽然很多次实验我都做到了4点半，但是收获很大的，我扩音机电路板第一次调试三级都正常，播放效果也不错。而且说实话，这是大学，很多东西得自己想办法，比如焊接，老师不会在上课教这个，你得自己去学习。现在成绩还没出，成绩方面不做评价。10分
96585,264,张冶沁,2019-01-21 06:58:43,0,2,2,还ok
96943,264,张冶沁,2019-01-21 14:15:22,-3,1,4,给绩点法则真的是我他妈，你们可以去上过她课的学长学姐们那里问问她怎么在给分~没有老师像她这样的吧
97134,264,张冶沁,2019-01-21 17:16:47,1,5,4,说实话，我觉得老师挺不错的不应该只是这个分数，平时问问题都是会耐心给你讲的。老师还在群里面吐槽教育孩子，，还会发红包什么的，有问题回答的也很及时。\n\n难受的一点就是模电实验这课是五级制给分要正态，不过老师第一节课就会说清楚，而且这本身是课程设置的锅，我就是吐槽一下哈哈，也不用太在意绩点啦，这门课也就1.5学分，课程内容的话我觉得还是挺有意思的，扩音机电路那个实验真的做完好有成就感的
98704,264,张冶沁,2019-01-23 23:50:20,0,3,3,差老师，不解释? 不在意绩点的话，可以选她的课
103107,264,张冶沁,2019-02-26 03:38:15,-1,8,9,好老师，给差评的都是学渣
112474,264,张冶沁,2019-07-04 10:08:05,0,3,3,老师人很好的，这有正态也没办法，又不能人人满，我觉老师讲的还可以，实验课需要的理论基础又不是很高，端午节学校给老师发了一箱饮料，上课时候给我们全分了，因为课上人少，还一人两瓶。
120211,264,张冶沁,2019-11-24 03:54:36,0,0,0,人不错，水平有限，给分不好
121745,264,张冶沁,2020-01-21 11:58:47,4,4,0,老师其实还行，但她的模电实验是等级制打分的…
129152,264,张冶沁,2020-12-30 14:53:33,5,6,1,老师人很好的呀！有什么不会的问题，老师都会热心回答，课件PPT也很清楚。
131406,264,张冶沁,2021-01-27 11:18:23,0,1,1,你所有任务都完成的不错，这老师非常高兴的给你说，你是良好哦，3.5，可能她认为满级是4
133108,264,张冶沁,2021-02-08 13:28:08,2,5,3,一份迟到的评价，其实老师总体上挺ok的，没有某些评论说的那么差，也可能是近些年好了一些（\n\n上课讲的挺细的，要点基本也都能覆盖到，我室友他们班每次都只讲十几二十分钟，我们班经常讲快一个小时。在要求上来讲，对比其他班级，我们班的要求绝对不算高，大多是一些比较基本的要求。从老师对学生的态度上来讲，总体可以说是比较尊重同学，我因为实验报告总是卷不成5单独问了老师两次，都帮我比较认真的看了报告，确实有一些问题，感觉没有乱打分，实验报告这种东西本来就是很卷嘛，卷的不够自然就得不到5.模电实验五级制，但这是课本身坑爹，最后老师也尽最大限度帮我们提高分数了。\n\n说了这么一大堆，就是想说预置到这里来的学弟学妹们，不用非换老师不可，没那么差，完全能上。我当时看了查老师的评价，没换成老师，感觉完蛋了，实际完全没有，而且体验还可。
139030,264,张冶沁,2021-07-12 08:26:20,1,3,2,老师的心是好的，只是有时候说话语气会让你觉得她好像咄咄逼人。上课讲的很细致，会改实验报告并且反馈到群里。平心而论已经做到了一般老师该做的。如果你预制了，也不必退了换，如果你没预制，倒也不必选，因为其他实验其他老师都是蛮好的
145672,264,张冶沁,2021-12-31 05:11:42,2,7,5,超好的老师！电路有问题老师会一点一点帮忙看着找问题，找到解决为止，讲课细节非常足，听老师的慢慢来就一定可以做出来，平时下课会有同学做不完，老师会留下来帮忙。这评分不上9.9我大迷惑咯。大家快冲，选到就是赚到。而且听说别的班也有报告比较麻烦的。咱这报告不麻烦，没多余的要求。
145689,264,张冶沁,2021-12-31 08:06:09,3,6,3,差点被评价吓退了，还好没换成功。呜呜呜呜呜我的宝藏张老师！首先模电实验本来课程设置就是五级制给分这能怪老师？每次做不出来她就像你妈一样一边嫌弃你一边告诉你该怎么接，看你不会还会直接边讲边给你接好，如果你被她嫌弃你的语气吓到还会反过来安慰你，真的就是刀子嘴豆腐心。最后一节模电实验考试大家做不出来老师比你还着急，在实验室里一边嫌弃大家太老实一边想尽办法给提示的老师太可爱了呜呜呜呜呜。张妈妈这么好怎么可以不选她！虽然讲课有点听不懂，不过学完之后发现是因为理论课还没学到那儿。（还没出分，模电实验正态给分和五级制都是所有老师一样的，因为这一点骂老师还不如想想是不是自己太菜）
146834,264,张冶沁,2022-01-07 14:22:29,-4,4,8,sb。
154115,264,张冶沁,2022-05-23 13:33:06,3,5,2,该老师事情比绝大多数模电实验老师事情多一倍，而且上课很多东西自己都搞不懂，预置的赶紧跑！
157292,264,张冶沁,2022-06-23 01:11:26,2,3,1,事情多的要死，班里人少的话不卷分数很难看
157589,264,张冶沁,2022-06-24 01:26:00,1,5,4,sb一个
158003,264,张冶沁,2022-06-26 05:58:26,5,6,1,脑子多少沾点
158084,264,张冶沁,2022-06-27 01:20:15,3,4,1,进入浙大以来从未见过如此尖酸刻薄没有人情味的女人
159249,264,张冶沁,2022-07-09 05:52:28,1,2,1,进入浙大遇到过的最垃圾的老师
160068,264,张冶沁,2022-09-12 23:58:35,2,2,0,选了后悔一辈子
184076,264,张冶沁,2023-12-08 02:26:41,1,1,0,事多给分差
185663,264,张冶沁,2024-01-03 11:00:14,0,0,0,老师挺好的，希望老师捞捞啊，保佑一波
188719,264,张冶沁,2024-01-19 16:40:07,1,1,0,客观评价：模电实验这门课本身就是依托答辩，事情很多，zyq老师的课事情会更多，老师感觉讲得也不太清楚明白，给分还非常不好，唯一的优点就是老师除去上课，人还算比较好，挺耐心的
193401,264,张冶沁,2024-06-09 13:04:03,6,6,0,预置的电路实验II\n\n有一说一，刚开始看评论以为很恐怖，但其实没那么离谱，你问她都会正常回答，也没有阴阳怪气什么的，甚至由于本人比较迷糊，有时问题非常离谱，但也没发生什么，可能是老师有改正\n\n虽然事情确实不算少，不过这好像是通病，电路实验II，wz老师的课都不算轻松吧
193526,264,张冶沁,2024-06-12 09:09:04,6,6,0,只要脸皮够厚，老师帮助挺大的。虽然老师讲课让人听不下去，但是真的会帮你操作帮你调试，只要你脸皮够厚多找她。\n\n考试适合背书清楚的同学，和王旃老师重视快速的操作不同，张老师的考试注重理论默写，操作反而基本每个人都过了。\n\n老师事情略多一点，主要是仿真。但是冲掉了一次课，也减负了，那更多的其实还是这门课的问题。\n\n电路与电子技术实验I I，选老师肯定是还可以的选择。
193540,264,张冶沁,2024-06-12 15:10:20,6,7,1,真心觉得老师刀子嘴豆腐心 虽然嘴上叨叨两句但问问题都会努力解答 也会上手帮忙操作 最后考试操作题给出电路图连线即可很简单 理论题需要一些思考 不过重点老师上课都讲过（但我没复习清楚） 事情多是课本身的问题 不是老师的问题 预置了老师也可以放心上 （还没出分先来评论一波
194958,264,张冶沁,2024-06-26 05:15:07,2,4,2,不会的多问问老师就行，总体来说上课体验挺不错\n\n不过心理敏感，害怕问老师问题的人还是慎选[doge]
195040,264,张冶沁,2024-06-26 13:00:33,2,3,1,电路与电子技术II\n\n还可以，虽然重视做仿真，写报告，但对课堂本身要求不高。\n\n且愿意去问老师还是很好的，虽然有时候她会忙？其实课后和老师聊天老师挺喜欢大家去问，虽然有时候她会几个反问让人茫然，但是也真的上手帮忙啊！
196107,264,张冶沁,2024-07-01 16:03:29,2,5,3,看到这则评论的同学，请不要看评分！因为张老师得差评的很大一部分原因在于模电实验这门课本身。模电实验和数电实验一样都是五级制的烂课，无论是理论计算、pspice仿真还是电路实操，都是电气教学科安排的，老师也没办法控制你什么时候下课。\n\n\n\n上电偶与电子技术II的感觉确实工作量特别大，无论是平时实验的仿真还是最后音频放大电路的焊接（四个小时不过分），他才一个学分啊（汗）。不过张老师你问她问题她是会回答的，也会确保每个人期末的调音都能做出来。不算优秀但也不差的一名老师，如果要追求绩点的话建议还是功在平时。
197245,264,张冶沁,2024-07-10 00:59:43,-3,2,5,💩💩💩
201021,264,张冶沁,2024-10-27 04:56:27,6,6,0,电II实验大家记得刷mooc，做测试题和考试题，最好挂完不要看倍速，这门课我不知道，其他课mooc时长是看实际播放时间的。老师说很多人mooc20分只有一点点分怀疑就是这个原因。\n\nmooc如果没做成绩算出来基本过不了的……\n\n其他方面老师仿真要求略多，讲课略不清楚，脾气略急，但指导很仔细，耐心，人还是不错的。
201612,264,张冶沁,2024-11-05 02:10:13,6,6,0,只能说是唐完了\n\n上课是讲不明白的，PPT默认在播放的时候隐藏鼠标，然后她会把鼠标放在某个东西上面然后鼠标就隐藏了，然后跟你说“这个这个”而不是元件的具体名字。学生有什么问题就是“我不知道，我也不会弄，你没有听课吗”，弄个MOOC连自己课程的密码都搞不清楚。\n\n任务是繁重的，要额外自学一个仿真软件，软件也不会挑，挑了个中国人做的但是操作界面没有中文的、教程指引一团乱麻的垃圾软件，真是没长脑子
203584,264,张冶沁,2024-11-20 06:02:37,1,3,2,💩💩💩
204612,264,张冶沁,2024-11-27 04:56:33,7,7,0,自顾自地讲了一堆没用的挤压做实验的时间，讲课也是非常之逆天，总之就是唐完了
204697,264,张冶沁,2024-11-27 11:47:51,1,4,3,活全家
205288,264,张冶沁,2024-12-04 02:31:12,1,2,1,💩💩💩🤓
207148,264,张冶沁,2024-12-19 12:22:59,-5,2,7,马冶沁，上课特别马，讲的不知道是啥没人听得懂，挤压实验时间，还要做cs的不行的慕课，慕课还有司马设计题，真的马，最马的老师
207189,264,张冶沁,2024-12-19 15:44:32,3,4,1,感觉评分虚低了，遂有此评\n\n\n\n评论仅代表个人感受，可以挑着看。\n\n\n\n老师正式实验前会讲很多东西是事实，这部分内容有没有用见仁见智。个人认为如果你模电课认真听且完全听懂会用了那前面的确实是废话，不然对理解实验原理是有帮助的。（当然考虑到模电课程逆天的进度安排事实上一定有几个实验做的时候理论还没学到就是另一码事了）\n\n\n\n老师本人是很好的，至少实验过程中有什么问题去问了她会试着帮你解决。当然因为电路实验里奇奇怪怪的问题很多，她也经常搞不定，这点确实让人比较失望😞\n\n其他方面有问题也回答的比较及时吧，我好像没遇到过已读不回的情况。\n\n给分比较求是，至少我看到的平时成绩是这样。写这个评论的时候还没期末考，这部分不多做评论了\n\n\n\n补充:很多其他评论针对的其实是模电（实验）课程本身不合理的地方，包括巨多课后和mooc作业和跟理论进度错开导致过量的原理讲解。就我上课和交流的情况看张老师似乎没有比别的老师多很多要求。当然，和“事少分高”这个理想型差距还是比较大的。
207236,264,张冶沁,2024-12-20 02:48:16,2,2,0,在zyq班上补做了几次实验，觉得评分起码要比gy高😅😅😅
207275,264,张冶沁,2024-12-20 04:58:26,0,2,2,挺好的，不应该这么低
207552,264,张冶沁,2024-12-23 04:20:32,3,3,0,从评论来看，\n\n老师的电II实验风评比电路模电风评好很多，可能的原因是模电部分基本每个老师都要求高，电路部分可能只有zyq老师要求仿真任务多一点。老师春夏学期电I I实验还是可以选的，电II我们当时很耐心。
208984,264,张冶沁,2025-01-04 06:45:22,5,5,0,模电实验：查老师评分低可能主要是只带实验的原因，模电实验任务重要求多五级制给分差是统一的。zyq老师还是非常不错的，总体来说适合比较认真的同学，动手能力不强也没关系。\n\n\n\n我认为的优点有：①老师对实验操作和实验速度没有要求，每次实验做到最后也没事，而如sd老师会记录最先做完的十个人加分。②报告评分标准比较清晰，数据错误扣分、重点强调的地方犯错（如“-”）扣分、无思考题扣分、思考题认真加分，我觉得主要是结果像样态度好字数够就行。③期末考试非常常规，操作题几乎每个人都能做出来，理论题有很多历年卷资源，也都是重点的内容、后几个实验的内容。④由于今年新换了仿真软件，仿真要求不多，小于或等于其他老师的要求。⑤不会要课前预习，实验报告交的时间没有限制，只要最后补齐就可以。\n\n\n\n缺点是实验任务比较多，如果认真写报告每次基本要花五六个小时以上，思考题也非常多，不过思考题对理论和实验的学习的确有帮助。至于上课讲得是否清晰，我觉得大部分老师可能都不太清晰，zyq老师会把一些操作细节和参数设置融入理论讲解的话语中，需要尽量记住以免自行推导。
211800,264,张冶沁,2025-01-12 13:28:27,2,2,0,老师可能有点唠唠叨叨，有时候还答非所问，但人挺好的，讲的也很详细，操作出问题的找她来看也会帮忙调好，对我这种动手能力不是很强的人特别友好！！打分的话也会提前说好怎么给分的，最后给了优秀，还是很满意的
219486,264,张冶沁,2025-05-28 11:01:36,0,0,0,最开始选上张老师的实验课的时还有一些担心，因为看到查老师的评分不高。但事实上张老师是个很好的老师，交实验报告的日期很宽容，也会很耐心地指导做实验，虽然有的时候有点刀子嘴，但实际是豆腐心的好老师！
219652,264,张冶沁,2025-06-03 08:38:27,0,0,0,电II实验，老师人很好，实验会耐心指导，但是不太会讲理论，基本上全靠自学了。老师平时实验报告内容是比较多的，最后一次音频放大的报告写了18页配30张图。不过好在期末考很简单，理论题复习了一个小时就能写的大差不差，操作题基本上仔细连线、提前做好元件检查都能做出来。6分实在有些冤枉好人了，推荐老师。
219789,264,张冶沁,2025-06-06 09:11:12,0,0,0,报告内容很多，但是上课体验很好，做不出老师会亲自帮忙调试，焊接之后过了验收也挺有成就感的，唯一不好的就是最后操作题折戟了。。。
220866,264,张冶沁,2025-06-20 07:50:23,0,0,0,感觉张老师还是不错的，实验接线图也都会告诉大家，照着接就没问题
6683,283,王旃,2019-05-31 06:29:10,-73,34,107,呵呵，对认识的学生很关心，不认识的你问个问题就批评你上课没好好听。报告要求高，不写个十几页还想拿很高的平时分？不是学霸还是别选了，选了做好70分的准备
8605,283,王旃,2015-09-23 05:25:31,-44,13,57,节奏太慢。。。。。睡着。。。。
9901,283,王旃,2015-11-12 12:44:01,1,22,21,连上两次课和考试周都没布置作业～\n\n
11834,283,王旃,2015-12-17 03:49:36,12,32,20,很认真负责讲的清
12756,283,王旃,2015-12-24 03:19:32,8,25,17,很好的老师。思路清晰，上课有启发性。很负责。很好
13206,283,王旃,2015-12-25 07:21:18,46,63,17,全5分好评，老师态度很好很认真，物流也很快，还送了芯片小礼物，以后还会来的
14512,283,王旃,2016-01-07 09:59:05,11,29,18,老师棒
17551,283,王旃,2016-01-20 11:38:34,1,19,18,老师特地等我们考试周结束再输入成绩哈哈，为了不影响我们考试～
19131,283,王旃,2016-01-23 10:14:22,11,29,18,认真负责的好老师，还很萌哦(･ิϖ･ิ)っ
41409,283,王旃,2017-01-11 10:51:52,4,20,16,亲身经历反对说实验报告不多写就不能拿高分的。老师人很好也很和蔼，跟着老师的节奏学没错的。成绩不理想要怪也是怪等级制。
41410,283,王旃,2017-01-11 10:54:39,1,18,17,老师人真的超级好，出去出差还给我们带糖吃。课堂节奏慢讲的很细，ppt也很详细。最后考试的内容ppt上基本都有，复习起来很有底。还有，实验报告布置的有意义，并不是每周都有，只挑重要的写。任务重的时候会发简易版实验报告的模板，感觉写实验报告都不浪费时间。整体能学到很多，虽然有可能实验会走的没那么早……
41444,283,王旃,2017-01-11 15:08:09,2,15,13,室友都羡慕我的模电实验老师系列，超级好的老师，实验报告没有其他班多，讲课很清楚，期末还会帮忙回顾重点(听说其他老师都没有)，感激涕零
41746,283,王旃,2017-01-12 13:31:05,1,14,13,老师很好，绩点不好看都是我自己不好好学的锅。
43062,283,王旃,2017-01-15 15:37:26,3,17,14,王老师人非常好，能当她的学生是一件幸福的事
44380,283,王旃,2017-01-17 16:46:42,3,16,13,老师讲课非常清楚，很爱护学生对学生很好，人也很温柔很萌，和你说着话自己还会被自己逗笑，老师第一次看到我名字说，你名字好萌啊，说完哈哈哈笑了起来         ∠( ᐛ 」∠)＿上课很文静在群里却像个孩子，负责真实友好，为学生的学习着想~很遗憾，没有给老师留下特别深的印象，但我会一直记得这位老师的。
44657,283,王旃,2017-03-03 15:12:41,3,14,11,挺好的 给分好
45378,283,王旃,2017-01-19 13:25:16,1,12,11,老师真心女神 对学生很亲切 经常在群里和大家交流 过年了一起发发红包 下学期没能选上她的模电实验 sad...
46074,283,王旃,2017-01-20 14:40:04,3,15,12,挺好的\n\n
48439,283,王旃,2017-03-03 15:15:41,3,16,13,超级棒的老师，讲课很优秀人也超好超萌，而且很体谅我们，实验报告很人性化
51884,283,王旃,2017-06-13 06:58:11,3,14,11,好老师，不解释\n\n
55140,283,王旃,2017-07-01 01:54:44,3,14,11,老师很有耐心，很温柔，能学到很多知识!
55171,283,王旃,2017-07-01 02:41:55,4,15,11,要求会比其他老师高，但是人很好，也能真的学到知识。
55668,283,王旃,2017-07-02 06:49:43,4,16,12,王老师很细心，讲课总是带有启发性，和同学们走的很近很亲和，尤其布置实验报告的时候还会常常帮我们减轻负担
57436,283,王旃,2017-07-07 17:33:12,4,19,15,老师气质特别好，人也特别好。实验报告要求有点高，但是比别人班实验报告少将近一半。大爱老师，班群好多人都叫老师女神
57531,283,王旃,2017-07-10 12:24:30,-11,26,37,讲真真的是不同学生不同对待，对有些同学，热情的恨不得帮你都把参数波形调出来，对有些同学，一问问题就爱答不理。其实还不如那些一视同仁的老师，即使没有小礼物也不那么会说话，但是起码是平等的。
60076,283,王旃,2017-10-10 00:12:26,1,16,15,萌萌哒老师，在QQ群里用颜文字真是不要太萌
60307,283,王旃,2017-10-17 04:50:39,5,18,13,真的女神
64338,283,王旃,2017-12-22 13:55:41,10,27,17,别的不多说，这个老师是天使
64387,283,王旃,2017-12-23 06:28:14,5,19,14,老师很棒，真女神\n\n
68581,283,王旃,2018-01-23 11:37:19,7,22,15,老师是真的好没话说，耐心细致带着学生思考，就是自己太菜大佬太多分数很难受，下学期还是老师的模电实验好好加油吧。
69546,283,王旃,2018-01-25 03:33:32,3,16,13,女神啊女神！作业不多，讲的超级细，对电路学习也很有帮助
69899,283,王旃,2018-08-26 12:09:22,-12,30,42,谢谢老师。上了老师的课，我才知道什么叫做“不平等”，什么叫做“有色眼镜”，什么叫做“歧视”。
70796,283,王旃,2018-06-16 08:11:40,-14,23,37,长得不好看的人慎选！别的老师给分看实力，这老师给分看脸！！
74207,283,王旃,2018-02-06 14:22:07,-14,18,32,为什么没有0分。。。
74238,283,王旃,2018-02-07 13:41:23,-15,19,34,给分哪里好了？挂了 
79453,283,王旃,2018-06-06 00:07:44,0,17,17,发抖.jpg
79645,283,王旃,2018-06-14 08:30:33,5,14,9,emm
82671,283,王旃,2018-07-09 02:41:32,-4,13,17,窒息。。。。
83631,283,王旃,2018-07-11 01:01:25,6,15,9,非常温柔的老师，很有童心，非常有收获的实验课
85145,283,王旃,2018-07-15 22:39:14,6,14,8,很好的老师。思路清晰，上课有启发性。很负责。很好
85563,283,王旃,2018-07-19 14:38:39,1,20,19,本来小学期的课就难，软件还没做好又要在不到一天时间内做ppt加展示?真tm没话说了。希望老师能花更多的时间教大家知识而不是想着把实验课变得更加“生动有趣?!”，呵呵了。
85626,283,王旃,2018-07-22 15:41:08,1,11,10,还行，老师声音好听
85729,283,王旃,2018-07-30 13:51:48,-17,15,32,假大空，不注重基础，还特别喜欢给学生脸色看
85784,283,王旃,2018-08-09 22:39:13,6,11,5,好老师，认真负责
85813,283,王旃,2019-05-31 06:29:10,-49,14,63,浙大还有这种垃圾老师，真的有辱浙大名声
86292,283,王旃,2018-09-12 08:45:57,0,6,6,棒棒棒
86295,283,王旃,2018-09-12 11:46:54,-18,11,29,下学期预置的她的课。。好怕会死在她手上。。
86399,283,王旃,2018-09-15 04:54:36,24,30,6,想知道评论里两极分化为什么那么严重。。。
86527,283,王旃,2018-09-17 04:53:16,11,14,3,excuse  me？？？？
90909,283,王旃,2018-11-27 09:21:37,-27,8,35,动不动就威胁给挂科。。
99500,283,王旃,2019-01-25 01:18:22,4,9,5,超级好的老师，平时上课教的都非常仔细，不会让人感觉很难。\n\n老师很体贴学生，一般实验报告都是让我们两周写一次，负担很小。\n\n最最最重要的是，老师真的超级可爱，选了不会后悔的，班上好多人退预制课想下学期还是这个老师，可是我没这个运气。
99589,283,王旃,2019-01-25 03:56:59,14,14,0,666666666666666666666
99627,283,王旃,2019-01-25 04:17:30,11,15,4,老师超级超级好呀！上了老师的课感觉无论自己拿多少分我都要给老师10分。大一暑假小学期第一次上实验课，搭档了一个残废队友，啥也不会，只能我一个人想办法，做的特别慢，甚至要补做。从那以后我对实验产生了恐惧。这学期王老师的电路实验，怀着忐忑不安的心情上，不懂的试着问老师，老师在QQ上特别耐心的一个一个回答，回我的表情包也超可爱(๑• . •๑)。后来做实验差不多能跟上去了。特别是数电实验，老师实行预习制，我前一天晚上预习，第二天上午基本半小时就做好，基本是班上前几个，让我重新相信自己，也对实验产生兴趣。谢谢老师这学期对我的鼓励与帮助，下学期希望还能选上老师的模电实验，就完美了！
99696,283,王旃,2019-01-25 05:14:47,1,5,4,老师作业超级少!!!绝对是最少的老师了!!!!今天出分，发现好多人都回来评论了哈哈哈
99749,283,王旃,2019-01-25 06:22:00,8,11,3,女神！只恨下学期选不上老师的实验课
100751,283,王旃,2019-01-26 16:58:50,8,15,7,理想女友
102554,283,王旃,2019-05-31 06:28:23,-46,6,52,王旃wqnmlgb
102884,283,王旃,2019-04-26 04:42:02,9,15,6,那些说老师不好的是认真的吗，我根本无法把你们的评语套在一个那么温柔耐心有气质的老师身上
104014,283,王旃,2019-03-09 15:20:03,5,12,7,王老师真的是超级好的老师了吧！！问她问题她也会及时地耐心地详细地回复，课程讲的也很透彻，虽然非常遗憾这学期不是她的实验课了，但还是念念不忘这么nice有气质的老师了！！那些说老师不好的同学，想想你们自己实验课有没有认真吧，上课迟到缺勤、实验报告也不好好写，还要老师敦促着、想着怎么让学生不挂，可有点进取心和羞耻心吧，I'm shame of you.
104940,283,王旃,2019-03-31 13:43:03,-25,8,33,温柔？耐心？我就呵呵了。
104941,283,王旃,2019-03-31 13:43:54,14,22,8,查老师评分更新了，成功被某些人拉低了，直接服了，自己没有付出还那么多事，恶意刷低分，请后来的人注意，这是一个评分9.7的老师！
108408,283,王旃,2019-05-23 04:52:08,13,13,0,超级喜欢这个老师的！全五分好评啦！芯片还会回购的！
108638,283,王旃,2019-05-30 07:00:32,-13,4,17,这到底是个怎么样的老师。。。。
108681,283,王旃,2019-05-31 06:09:58,5,7,2,最好的老师，很亲切、很认真、也很负责
108683,283,王旃,2019-05-31 06:26:15,8,15,7,我，2017级，老师是我大一新生之友，当时查过，分数还是九点多，不知道你们刷低分的什么心态。老师为人方面非常好我保证，包括室友和身边的同学都可以保证。我也不知道现在是什么时代，网络上的恶意总是存在，不满请理性发泄，但评论区不是你宣泄个人感情的地方，你的评论对后来选课的同学很重要，评论时也请礼貌一点，当然选课的同学也请自己辨别评论，说句实在的，怕就别选，也没人请你去选老师的课。老师也不缺选课的学生。
109275,283,王旃,2019-06-12 15:20:27,4,5,1,太好了，真的好
109373,283,王旃,2019-06-13 12:07:00,1,2,1,老师人不错
109585,283,王旃,2019-06-17 08:31:45,5,6,1,这个老师真的很棒啊 实验报告少 上课讲解仔细 解答问题也很耐心 特别理解学生的好老师
109586,283,王旃,2019-06-17 08:33:39,4,5,1,上课认真，给分好
113318,283,王旃,2019-07-06 05:49:04,2,5,3,王旃老师大爱！天使一点都不过分。模电实验有一组数据写错了，老师居然会主动联系我说不想给低分。我去重做的时候才发现老师不止是私戳了我一个人，老师会在群里面和大家互动聊得很热火，事情也贼少，两周一次报告，有好几次都不需要标准报告。最后期末考试会很照顾大家，会等大家考完所有考试再出分。也会很努力地捞人。考试全部看ppt就完事了，第七周的课会说考试范围和重点，我只用了一天复习期末考试。而且最后一道要用直流源的大题没做出来，可是后来还是4.5了（虽然对于我这个已经没有保研希望的人来说并没有什么用）
114631,283,王旃,2019-07-11 01:57:10,0,0,0,还行吧。
115595,283,王旃,2019-08-06 09:47:15,1,1,0,棒棒哒！
118575,283,王旃,2019-10-28 23:51:15,9,13,4,我只想说上老师的课十分轻松，上了七次实验课只写了三份实验报告，我舍友他们老师让他们写了六份。老师上课讲的很细，认真听的话肯定收获多多。最后成绩怎么样我不知道，但是我知道，评论区最底下那些喷老师的话，很明显是一个人说出来的，这种人即使包裹在匿名的躯壳下也难掩散发出来的分奴的恶臭。。。
120920,283,王旃,2020-01-18 17:57:04,3,3,0,事少，上课讲解详细，给分好
123939,283,王旃,2020-06-17 07:18:03,5,5,0,老师人超级好！！！前几天有个学弟来问我王老师教学的情况 因为看到了查老师上面两极分化的评论比较担心 这个学期我也还是王老师的课 老师人很耐心而且对同学超级友善 用五节课非常精炼概括地讲完了一学期的内容 实验报告的量也不多 强制做的内容也不多 非常体谅学生
124993,283,王旃,2020-08-03 14:23:10,1,2,1,事少讲课细，给分好，至少两学期电路实验下来没有遇到上面那些骂王老师的人说的那些情况
129713,283,王旃,2021-01-11 09:31:14,3,5,2,不用多说，我退了三门预置课就为了再选上她的电路实验2
129727,283,王旃,2021-01-11 13:26:23,6,9,3,想和她恋爱
134107,283,王旃,2021-03-16 06:13:08,4,4,0,宝藏老师，事情对比其他班是真的少，讲的也很细。至于给分，实验给分是五级制，主要看你在你们班的排名！
139101,283,王旃,2021-07-12 23:46:03,2,2,0,老师讲的很细致，认真上课的话会有不小的收获，人也很耐心，十分好评～
148877,283,王旃,2022-01-14 00:45:43,3,3,0,电路实验一，事情少老师好。不过实验课是五级制，必须按班里排名给分。
177165,283,王旃,2023-07-02 02:40:45,-3,0,3,讲的不错，但实验报告要求很多且模糊不清，分数也不公布，容易造成莫名其妙的低分。
178554,283,王旃,2023-07-14 10:30:57,-5,0,5,反正电工电子实习别选小车班，不然你会被这sb课搞崩溃
184156,283,王旃,2023-12-11 11:24:03,0,0,0,人好有气质，讲解比较仔细。严格求是但是辅导也很到位。
184787,283,王旃,2023-12-22 17:04:30,1,2,1,老师人很好，但是实验报告的成绩要自己询问，报告给分相当拉开，1次实验报告同时拿6，7，8，9，10的可能都存在，严格，求是却又温柔有气质。
189918,283,王旃,2024-02-02 10:39:06,1,1,0,老师的任务偏少，人很有气质，讲的很清晰！\n\n最后的期末考试很重要，尤其是实操！
196587,283,王旃,2024-07-04 06:36:57,1,1,0,坐标春夏模电实验\n\n老师是神，但课是史
197894,283,王旃,2024-08-20 03:50:47,1,1,0,选了不亏
204501,283,王旃,2024-11-26 09:05:54,-8,2,10,避雷......，适合大佬，不适合普通人，讲课还快，下课也不早，不如隔壁lyl
205326,283,王旃,2024-12-04 10:32:47,5,6,1,挺适合大家的啊？事在一众老师里已经很少了……为啥一定要比个最少？事情多的老师报告是这个翻倍。\n\n考试也不怎么需要复习，节省课后时间。数电预习一下很快的。\n\n女神老师满分！可惜老师如果不再接着干下去就快退休了……
211401,283,王旃,2025-01-14 07:32:25,3,4,1,电路与电子技术实验I      2.0学分     优秀/4.5\n\n老师上课体验：我感觉叫老师数电实验的女王真的不算过分。平时任务很少很少，老师虽然上课的时候比较求是严格但整体很温柔，期中周电路实验特地两次实验都不布置实验报告让我们安心复习理论课考试。冬学期开始数电实验只写了一次实验报告，很赞。考试的题目量也很少，可参见我发的回忆卷，然后而且为了让我们放心第一次采取了开卷。冬学期有一次课后要自己到实验室做的VHDL的四位全加器实验作业，整体冬学期除了做实验还是非常轻松的。如果接线接的快的话大概能提早一小时下课。然后王老师的助教人也很好，所有的mworks的仿真实验都是助教上的，平时和做实验有问题找他他也会积极回复。\n\n课程学习体验：秋学期的电路实验部分整体我做的还是比较糟糕的，整体有三方面原因，一是我很难将直观的电路图接成我桌子上的实物图，导致我经常连最基本的接线都接错了，二是刚开始对面包板理解不深刻，经常不注意将电源短路掉了，三是刚接触示波器练习不熟练，每次用示波器都要请教助教。然后这门课我学习时资源非常少，不像大物实验一样有这么多实验报告可以参考，98版面内几乎没有实验报告资源，而且每个老师的要求和实验内容也不一样。好在这门课的实验报告可以交电子版，我在这学期都是用overleaf的latex打完的，也算是稍微入门了一下latex。不过进入数电实验部分后，整体学习就很轻松愉快了，因为对于我个人来说，虽然接线多，但是不用再考虑短路这些我经常犯的错误，示波器的使用也日渐熟练，经常能提早一个小时就接完线验收。期末考可能老师还是比较注重操作，我个人实验报告自我感觉写的一般，期末的操作题是第一个验收的，所以最后拿了优秀。大家平时还是要多注意实验报告，然后期末也要对每个芯片尤其是161计数器芯片理解到位，要结合理论课讲的设计方法来复习。
211403,283,王旃,2025-01-11 10:34:29,1,1,0,我收回之前的话，王旃老师yyds，虽然感觉有点严厉，但是其实还是挺关心学生的，报告数量也很少，当然最开心的是老师给我最后打了优秀，感觉电路原理部分确实做的不够好，不过最后的数电像突然开窍了一样，考试也做出来了，所以还是yyds
220580,283,王旃,2025-06-18 15:13:13,2,2,0,老师巨好，真的不开玩笑，纯摆烂想混过去的话可能不是很好过，但是如果你希望实验来补充学习理论，那真的是非常好的课程，我数模电都是老师的，虽然我可能有一些考试的失误或者是平时实验的水，都不影响老师捞。这学期真没想到给我捞上来了，必须好评
11595,321,樊伟敏,2015-12-07 07:53:36,4,4,0,很好的老师，比隔壁nm不知道高哪去了
11651,321,樊伟敏,2015-12-09 09:58:33,4,4,0,听一节课就成了粉丝。老先生很有经验，教学也有一套，还驱逐了NM，只可惜老师马上要退休了。
15766,321,樊伟敏,2016-01-16 08:44:24,1,1,0,楼上驱逐两字惟妙惟肖
2841,327,汤巍松,2015-05-08 13:18:27,10,18,8,讲课讲不太清楚， \n\n，，，，绩点低，，，，
2862,327,汤巍松,2015-05-09 06:52:33,8,10,2,讲完根本听不懂他说了什么，给分太坑.....
5193,327,汤巍松,2015-07-05 16:37:51,-1,7,8,至少给我满绩了
7622,327,汤巍松,2015-09-15 06:41:57,5,5,0,讲不清，绩点低
9624,327,汤巍松,2015-11-03 06:47:04,0,0,0,讲不清楚
9786,327,汤巍松,2015-11-09 05:31:31,0,0,0,讲课超级不清楚
10001,327,汤巍松,2015-11-14 06:45:58,1,9,8,反正我满绩
10092,327,汤巍松,2015-11-15 15:38:11,0,0,0,讲的有点不清楚，不过照着他说的操作就行。
11320,327,汤巍松,2015-11-27 01:52:25,-1,0,1,其实老师挺好的，给分也高，讲话可能有些不清，但还是听得出来的
15584,327,汤巍松,2016-01-15 12:57:03,0,0,0,讲课马马虎虎吧  确实讲的不是很清楚\n\n给分可以接受
15621,327,汤巍松,2016-01-16 00:03:53,0,0,0,需要认真听，给分不错的，算高了
15881,327,汤巍松,2016-01-22 12:35:01,1,2,1,给分好
17920,327,汤巍松,2016-01-21 04:02:42,1,1,0,至少电工电子工程训练4.8\n\n虽然讲得很不好\n\n
23601,327,汤巍松,2016-04-08 13:48:08,1,1,0,后期讲AD的时候全程懵。
23977,327,汤巍松,2016-04-23 10:11:13,-2,0,2,上了电工电子学实验才发现这个老师真好
33062,327,汤巍松,2016-09-11 11:43:46,2,2,0,给分低
36584,327,汤巍松,2016-11-15 03:38:25,0,0,0,给分不错
36601,327,汤巍松,2016-11-15 04:33:24,0,0,0,讲ad一脸懵逼。。。
36672,327,汤巍松,2017-06-22 04:33:00,0,0,0,做实验很好玩
36691,327,汤巍松,2016-11-15 11:49:04,2,2,0,太难了，给分太低
38461,327,汤巍松,2016-12-06 01:50:33,0,0,0,被正态了，给分很低
38820,327,汤巍松,2016-12-19 08:27:25,0,0,0,瞎给分
41489,327,汤巍松,2017-01-12 03:19:55,0,0,0,给分挺好 讲得有点不清楚
41587,327,汤巍松,2017-01-12 08:24:37,0,0,0,老师人很好，不懂问他都会耐心讲解，实验报告很好写，认真点写绩点就给的好
43644,327,汤巍松,2017-01-16 16:31:15,0,0,0,老师很好
79833,327,汤巍松,2018-06-14 06:46:53,1,1,0,我上的电工电子工程训练\n\n老师讲课确实不是很好，我都是趴了半小时一小时他讲完了我起来和小伙伴接线。\n\n\n\n完成了接线可以实现目标就可以走了，据说接线好看他记录会写个优（反正我没有），我做的比较快，基本上15:20走。\n\n\n\n我每次走的最早，接线不好看，实验报告就写了目的，仪器，画了电路图。最后绩点4.8
50230,396,郭瑞鹏,2017-05-01 16:19:05,1,2,1,不要选运筹学，如果你不想被坑。只是想要学分，那当我没说！
51053,396,郭瑞鹏,2017-05-15 07:52:54,0,1,1,给分比较随机
101703,396,郭瑞鹏,2019-01-29 01:49:13,2,3,1,说一下电力系统稳态：课讲的非常不清楚，我整个学期是蹭的别的班的课才学下来。而且给分极其不好，同样水平在linzhenzhi老师那里3.9在这边3.3，真的不想说什么
127439,396,郭瑞鹏,2020-11-23 05:13:27,0,3,3,老师的逻辑是不太顺的…
139830,396,郭瑞鹏,2021-07-30 03:01:49,0,0,0,写三个字
147361,396,郭瑞鹏,2022-01-09 17:26:12,0,0,0,讲不清楚
161281,396,郭瑞鹏,2022-11-03 11:34:05,0,0,0,讲课完全讲不清楚，纯纯的dinner
161996,396,郭瑞鹏,2022-11-16 01:02:07,0,0,0,讲课基本听不清楚，给分也不怎么样，非常难受
161998,396,郭瑞鹏,2022-11-16 01:18:50,0,0,0,别选，期末考的东西他都不讲，到时候有你懵逼的
180857,396,郭瑞鹏,2023-09-27 07:52:35,1,1,0,逆天，一分不能再多了
181692,396,郭瑞鹏,2023-10-28 08:45:07,1,1,0,辣鸡 无需解释
183600,396,郭瑞鹏,2023-11-27 15:33:32,-2,1,3,郭瑞鹏上课讲的东西不能说完全不考，只能说他授课是以工程为导向，不是以考试为导向\n\n看到人太少会点名\n\n给分不清楚具体怎么样，如果真的像说的比别的班普遍低五分就是我的4.8变4.2了（悲\n\n面对郭瑞鹏上的稳态，你要做的唯一一件事就是带好能听智云的设备和耳机，然后在课上启动林真挚\n\n这门课还是非常难的，主要看书，看完之后思考，老师讲的作用最多40%，成事在人
183606,396,郭瑞鹏,2023-11-28 01:05:43,-2,1,3,建议听林振智的，给分其实还行
183819,396,郭瑞鹏,2023-11-30 11:43:55,0,0,0,什么shi给分……
183988,396,郭瑞鹏,2023-12-05 12:25:29,5,6,1,给分一般，说实话三个老师都讲的没有很好，建议直接上b站找网课听
185480,396,郭瑞鹏,2023-12-30 09:11:55,1,1,0,呵呵，讲的不考，考的不讲
202836,396,郭瑞鹏,2024-11-14 17:15:59,2,4,2,挺好的，给分还行
202837,396,郭瑞鹏,2024-11-14 17:17:51,-7,3,10,10分的好老师，不背刺，给分有人情味，浓浓师生情！！！
202838,396,郭瑞鹏,2024-11-14 17:26:29,6,7,1,讲课烂，给分比讲课还烂，我真绷不住了
38834,403,陶雪梅,2016-12-19 12:54:43,0,0,0,好！好！好！
8384,406,年珩,2015-09-20 18:08:49,17,18,1,羽毛球打得不错
15132,406,年珩,2016-01-12 07:05:30,1,4,3,好好好
25070,406,年珩,2016-05-05 06:34:58,14,17,3,很帅的老师！上课会给同学足够的时间来做题，很好！
26917,406,年珩,2016-06-21 15:04:51,10,10,0,很帅很男神，讲课稍微平了一点，但什么都不会给颜值减分的
30767,406,年珩,2016-07-02 12:23:30,1,2,1,讲的不错
32979,406,年珩,2016-09-08 07:09:58,1,2,1,老师人超级好
53821,406,年珩,2017-06-27 17:03:27,3,4,1,遇到过最和善的老师，很棒
54094,406,年珩,2017-06-28 12:27:50,2,3,1,老师上课很棒，效率也超级高
58006,406,年珩,2017-07-22 10:30:45,1,2,1,帅炸了
84087,406,年珩,2018-07-12 03:44:06,2,4,2,老师人很好，很年轻的副教授，长得也比较帅，平时分考试前公示，考完出分巨快。我就有一点想问问，电机控制的填空题呢？
86394,406,年珩,2018-09-15 00:31:43,2,3,1,年老师已经是正教授了，人品好科研劲头足
109367,406,年珩,2019-07-07 07:01:30,-27,9,36,hhh电机控制谢谢老师的100
113463,406,年珩,2019-07-06 17:35:58,1,4,3,老师好，给分emm
137858,406,年珩,2021-07-06 11:28:35,7,9,2,没有实验老师讲得好
177846,406,年珩,2023-07-05 04:14:52,2,3,1,年老师捞啊！我期末考只写了一半的分数就拿了一半的分数，我的超人！
191054,406,年珩,2024-03-31 04:09:48,-9,11,20,老师人很好～\n\n电气电子工程大赛选他做导师可以直接拿他的研究生项目去打\n\n十分送上！
197510,406,年珩,2024-07-18 00:58:08,-4,1,5,考试题出的很难很新颖
221704,406,年珩,2025-06-25 10:33:09,0,0,0,谢谢年老师，电机控制PPT写的很好
23542,407,张军明,2016-04-05 11:47:45,29,38,9,在治疗失眠上有不错的药用价值。
30229,407,张军明,2016-07-01 05:56:13,8,10,2,实在是 听不清楚他在说什么。。。
55277,407,张军明,2017-07-01 07:43:22,0,2,2,声音有点小\n\n上课好，给分好
57955,407,张军明,2017-07-18 10:34:26,1,4,3,老师上课还不错，回答问题很细心
58017,407,张军明,2017-07-23 02:38:10,0,4,4,给分好\n\n声音太小了太小了太小了太小了\n\n讲得蛮仔细的虽然讲得没有罗小华老师好
66281,407,张军明,2018-01-14 15:10:01,2,4,2,真的听不清他在说什么
85269,407,张军明,2018-07-16 16:04:21,-3,4,7,声音有点小，给分真心不错。
85270,407,张军明,2018-07-16 16:08:17,7,10,3,讲得真的差
85273,407,张军明,2018-07-16 16:15:01,5,8,3,讲课讲的是真的差。。。真的差。。。。。。\n\n真的是贼迷的一门课，慎选。。。。。。。
125204,407,张军明,2020-09-03 13:50:54,4,5,1,蹭课的，觉得老师憨憨的，讲的也不错，二倍速刷完了，谢谢老师！
125364,407,张军明,2020-09-07 12:47:26,0,4,4,老师人很好，讲课水平也很高，就是语调比较平缓，听着让人想睡觉hhh，不过微机这课的知识点本身就比较琐碎，换别的老师可能也差不多，网课期间2倍速刷还是很有收获的。今年卷子不太好做（可能是我太菜了），不过老师给分很好。
191767,407,张军明,2024-04-30 02:55:23,1,1,0,张军明老师一旦你懂进去，会发现他讲的是很有逻辑并且细心的，很好的老师
197102,407,张军明,2024-07-07 16:57:46,3,3,0,和陈敏比起来讲的好太多了，好老师，脾气很好
197146,407,张军明,2024-07-08 06:49:53,1,1,0,给分超好，考前通宵复习了一个晚上最后4.8了。。（虽然平时确实也有在学，老师讲课很好，同学们要集中精力呀，不懂的下课或者课间抓紧去问）
217267,407,张军明,2025-04-07 08:05:33,1,1,0,微机原理这门课一开始听的时候云里雾里，上课也特别困。但是后来学了一段时间，又做了一系列实验，对课程内容有了一定程度的理解，再慢慢回去看智云，会发现张老师和陈老师讲得还是很清晰很有条理的，在自己有了框架的基础上两位老师的讲解能够很好地帮助我们深入了解相关原理。\n\n所以这门课一开始学不懂不要焦虑，也不必怪老师讲得不明白，耐心一点，总会有所收获的。而且最终这门课的给分也普遍很好，学弟学妹们加油吧~
222016,407,张军明,2025-06-29 01:40:58,0,0,0,声音有点小，但是总体来讲讲课不错，特别是期末给分很好
4958,428,楼珍丽,2015-07-01 13:57:29,-7,9,16,老师人挺好
9032,428,楼珍丽,2015-10-11 04:28:44,25,28,3,讲得一点不懂就开始实验了...
10858,428,楼珍丽,2015-11-23 07:24:07,37,40,3,简直呵呵，什么都讲不明白，全靠学生自己摸索
11563,428,楼珍丽,2015-12-05 16:47:15,11,14,3,不知所云
11849,428,楼珍丽,2015-12-18 02:06:01,17,18,1,老师讲课逻辑有点乱，经常讲完之后不知道做什么
19377,428,楼珍丽,2016-01-24 03:50:04,-8,3,11,人很好
22278,428,楼珍丽,2016-03-03 07:30:59,11,11,0,不爽！
23315,428,楼珍丽,2016-03-24 07:05:14,2,5,3,讲的挺水。人不错。
34372,428,楼珍丽,2016-12-29 05:39:05,13,15,2,为什么礼拜四和礼拜五的同一个教室老师差距这么大？！讲不好就算了学生没办法解决问题就骂人？！事情巨多要求贼他妈高？！哈？？？不说了，又要睡去了。
34373,428,楼珍丽,2016-10-08 06:05:11,16,17,1,听她的课总觉得浪费了一个下午。。讲话没有逻辑，语调难以忍受，喜欢吓唬人说一些不好笑的东西。。提问题也不回跟没听见一样，为啥隔壁老师这么给力？？？
34822,428,楼珍丽,2016-11-21 07:31:34,7,7,0,呵呵哒  完全不明白
37015,428,楼珍丽,2016-11-17 06:30:08,9,9,0,辣鸡老师，上课毫无逻辑，也不知道在讲什么，每次上实验课都不知道自己要做什么
37816,428,楼珍丽,2016-11-21 07:33:30,6,6,0,救命啊
38439,428,楼珍丽,2016-12-05 06:42:55,1,2,1,绝对没备课
38451,428,楼珍丽,2016-12-05 10:35:16,1,2,1,就想知道最后会不会挂\n\n
38817,428,楼珍丽,2016-12-19 08:08:50,2,3,1,你得明白，听得懂话和明白意思是两码事
39719,428,楼珍丽,2016-12-27 07:08:52,7,7,0,简直无语。。我两年来一直以为自己的老师都是挺好的，虽然有些老师评价不好但是我还是觉得很好，直到我碰到了这个老师，，，
49577,428,楼珍丽,2017-04-19 05:23:37,7,7,0,一分都不想给\n\n
50966,428,楼珍丽,2017-05-10 10:25:41,4,5,1,每次她讲完大家第一句话就是ppt上传了么老师
60976,428,楼珍丽,2017-11-06 08:50:28,-10,3,13,号好！太好了！
65534,428,楼珍丽,2018-01-05 09:54:07,-6,2,8,模电实验 人还是挺好的
71507,428,楼珍丽,2018-01-28 14:29:20,9,12,3,上这种老师的课，你都不知道怎么死的，给分乱给
71624,428,楼珍丽,2018-01-28 17:53:57,-6,5,11,楼下那个你什么意思 你自己不会预习吗 给分比例说的很清楚 你自己什么水平心里没点数吗 绩点低了怪老师 可笑
71707,428,楼珍丽,2018-01-29 01:30:13,8,8,0,给分就不评论了，虽然我是不太理解一个开卷考试是怎么把我还算高的实验分数拉成这样的。就单论教学水平可以说是极差了，讲课讲不清楚，经常讲一句停几秒，感觉像不知道怎么表达，问她问题经常答非所问，完全就是靠自学。不过对学生要求比较低，上课负担比较小，大概是因为啥都教不了没法高要求吧
71997,428,楼珍丽,2018-01-29 07:39:10,-3,2,5,老师人很好，平时内容要求比较少。不过最终评分是分等级还是怎么回事？
72385,428,楼珍丽,2018-01-30 04:27:51,3,3,0,给分太低
79292,428,楼珍丽,2018-05-30 06:19:33,3,3,0,经常讲了一大堆以后都不知道要干什么，我之前实验课的老师好歹每次都跟我们讲清楚课上要测什么，可能会有什么问题，同样是浙大的老师差别不知道为什么会这么大，简直浪费时间浪费生命
83688,428,楼珍丽,2018-07-11 04:02:22,1,3,2,虽然上课常常不知道重点，讲的东西没有主次，不过还是值得一选的。首先任务轻，其次老师还是很守信用的，考前说过会尽量拔高大家分数，结果因为选课的人少，平时分又差不多，所以只要最后考试比其他4个人高一些评级就可以优秀了（别问我为什么知道( ᵒ̴̶̷̥́ωᵒ̴̶̷̣̥̀ )）。不过对想学东西的同学来说就另当别论了。
84285,428,楼珍丽,2019-09-11 07:30:39,7,14,7,别听前面那些人瞎说。这学期选了楼老师的模电实验，老师上课真的很用心。因为用的是新的实验交互系统，大家一开始不会用，老师上课讲得很仔细，而且老师还借我们工具做电路板实验。最后实验报告我有几份我没交，老师很好说话，让我最后考试周补交了。真的很感谢老师能教我这个学期的模电实验。
92547,428,楼珍丽,2019-01-02 11:07:36,6,11,5,不知道为什么这么多人黑老师。。\n\n说老师讲不清楚？我室友是另一个老师，比较下来很明显楼老师讲的细致的多；\n\n老师人也很好，你QQ私聊她，她很快就会回复你，然后认真的帮你解决问题。\n\n不过也可能是老师进步了？\n\nemmm，反正至少8分吧。\n\n不喜勿喷，自我感觉
100780,428,楼珍丽,2019-01-27 00:15:25,7,10,3,老师其实挺好的啊，模电实验课程设置就是实验严重超前于理论，理论考试都要好长时间才能讲完的知识我们不能苛求楼老师用一个小时讲完，老师其实很为学生着想，虽然有时候可能不太耐心，但是其实还是很负责的老师！好评！
100880,428,楼珍丽,2019-01-27 04:02:12,0,4,4,感觉还可以吧，虽然教学水平比较一般，但老师人还是很好的！实验要求相对不高，想水的可以选。
104632,428,楼珍丽,2019-03-25 13:13:01,2,3,1,呵呵呵\n\n
104956,428,楼珍丽,2019-04-14 17:26:40,5,8,3,是我见过事情最多的老师 讲课很烂事情贼多天天仿真\n\n
121334,428,楼珍丽,2019-12-19 10:27:05,-6,1,7,很好很好很有耐心的老师，超级棒，不知道为什么评分这么低
122355,428,楼珍丽,2020-02-25 06:34:22,0,1,1,我吐了
123511,428,楼珍丽,2020-06-09 08:37:22,1,1,0,一言难尽
124315,428,楼珍丽,2020-06-29 05:34:14,3,4,1,我最后悔的事就是看到这老师的评分还自以为老师都差不多而没有换掉她
136294,428,楼珍丽,2021-06-15 23:19:35,3,5,2,给9分，模电实验比起隔壁班的，事情已经算少的了；班级里人少，老师会很耐心的一个个帮大家调试，很温柔；只要平时认真完成作业了，老师能保证你不挂！扣的1分是因为有的东西确实讲不清楚。
141170,428,楼珍丽,2021-09-25 13:19:42,8,8,0,老师人挺好的，就是讲的真的梆臭，写实验报告的时候明明记得自己啥都完成了，就是不知道要怎么写实验内容，因为她教的时候就东一榔头西一棒槌的下达任务。
141335,428,楼珍丽,2021-09-30 02:11:49,6,7,1,给一分是因为只有一分 什么垃圾老师
143222,428,楼珍丽,2021-11-21 18:24:02,-1,2,3,讲的挺好的
143968,428,楼珍丽,2021-12-14 15:04:35,2,2,0,麻了麻了，讲的啥玩意
145263,428,楼珍丽,2021-12-28 14:33:23,2,3,1,老师你虽然有时候讲课思路会断 但你很温柔 很善良 但我相信成绩出来你不会让我失望😉
145446,428,楼珍丽,2021-12-29 15:28:31,5,5,0,讲的啥玩意儿我的天
145839,428,楼珍丽,2022-01-03 08:15:28,6,6,0,讲的是真不行，体验极差，给分希望能好点
147166,428,楼珍丽,2022-01-09 03:07:55,0,2,2,老师很温柔 希望给分能好点
149675,428,楼珍丽,2022-01-16 10:22:21,2,3,1,模电实验，数电实验，还有什么课用五级制评分？放马过来吧[麻了]
150464,428,楼珍丽,2022-01-26 02:41:16,4,5,1,垃圾老师 滚出浙大\n\n问问题就知道敷衍
150465,428,楼珍丽,2022-01-26 02:42:53,2,3,1,课太垃圾
150466,428,楼珍丽,2022-01-26 02:43:18,2,3,1,傻逼老师 毁我青春
150467,428,楼珍丽,2022-01-26 02:44:32,2,3,1,什么垃圾老师
153760,428,楼珍丽,2022-05-10 09:08:26,-1,3,4,根本没前面说的那么严重
161118,428,楼珍丽,2022-10-27 13:31:10,1,1,0,...
169748,428,楼珍丽,2023-02-27 15:37:49,6,8,2,我真是无语了，期末验收别的班都是两天，她说只有一天，那天我全是考试没法参加，她就让我晚上赶过去，过去的时候就剩一个小时了，剩下的时间根本不够，然后她过来就问我做到哪了，我说了之后直接就给我成绩登上去了，还把我板子给我剪了，结果第二天又在群里说没有验收的人中午十二点到教室验收，拜托你想应付我你就直接给我零分吧行吗。结果过了几天有同学又问能不能去焊电路板，结果她竟然让去焊了！！！？我现在就是一整个非常无语的状态，毁灭吧TMD。
171460,428,楼珍丽,2023-03-25 01:55:00,0,3,3,浙大怎么还有这般德不配位的人。①职业能力低：平常上课讲不清楚实验原理，稀里糊涂过去就让我们自己开始做②形式主义：实验报告要求一大堆（虽然确实应该忠实记录进行反馈总结，但是这乱七八糟的未免太多了点，还要课上提交学在浙大的记录，但是内容和报告一样，除了多此一举我没有其他评价）③答疑解惑的本职缺失：验收的时候只挑成功的学生看，其他出了问题想寻求帮助的几乎不管，只会要求做完的学生帮她去看（免费助教吗请问，学期初补课那次要求前十名完成者留下来答疑，我看他们欲走又止的都无语），我的元件出了问题也是充耳不闻（不是我一个人有问题，但是她根本没看我一眼。最后我的报告只能残缺。但是其他学生出了问题她还会去看，我不理解，这是什么随机对待）④语言表达能力差：每次班上同学（包括我）和她交流都十分费力，答非所问，自说自话。向她确认一个前提得不到回答，来来去去几个回合她才后知后觉地指出“不是那个，是这个”，极度浪费时间。\n\n我的实验报告均分大概是4.5/5，平常实践也是班内30%~50%提交，最后绩点2.5。只能猜测，您教书如此，生活大抵极少如意吧:)
173832,428,楼珍丽,2023-06-03 11:25:35,2,2,0,纯垃圾，上浙大最不想见到的老师了
174880,428,楼珍丽,2023-06-19 09:24:45,0,0,0,老师很贴心，考试前还帮我们念了一遍题目，怕我们不认识汉字。
175824,428,楼珍丽,2023-06-27 01:21:18,0,0,0,确实讲课不清楚，问问题好一些也解答不出来，但感觉没有说得这么糟糕，还是很和蔼的
177305,428,楼珍丽,2023-07-03 00:07:59,0,1,1,要是自己提前预习好的话这个老师还是不错的，可能有些问题她确实回不上来，但是出现问题她会亲自帮你调试，或者找同学帮你，完成实验内容还是很简单的。最后的成绩感觉个人考试成绩占大部分。
180677,428,楼珍丽,2023-09-25 00:17:39,0,0,0,电气专业电工电子实习\n\nlzl本身懂得不多，但会努力帮你调试\n\n最好不要依靠她，多问问同学\n\n因为她好像跟其他老师聊天的时候说做了选做才能拿优秀\n\n然后选做老师又不会去查你的程序是不是自己写的、有没有座位号\n\n所以就是你懂的，最好能让她看的一目了然，她也不管程序怎么样，如果老老实实的写仿真，她看不懂不给你分数就不好了\n\n10分因为我得分不错，扣1分因为选做做的不爽
181604,428,楼珍丽,2023-10-24 05:23:46,-1,0,1,SB去死吧
182001,428,楼珍丽,2023-11-07 15:44:03,0,0,0,烂。。
183060,428,楼珍丽,2023-11-22 03:00:51,0,0,0,为什么没有零分
184203,428,楼珍丽,2023-12-13 03:07:19,-1,0,1,烂中烂
188691,428,楼珍丽,2024-01-19 14:47:44,0,1,1,秋冬学期的模电实验，这次给分应该给大家的都挺好的，替老师挽回一下风评，老师讲课虽然很差，令人听不懂，但是会帮你调试，人不错，这次给分也有不少谢谢老师的，看来也是不错的。打个十分替老师挽回下风评吧，不过模电实验确实是一门烂课
189297,428,楼珍丽,2024-01-23 03:16:59,3,3,0,##电路与模拟电子技术实验##\n\n老师人挺好的，会记住大家的名字，比较耐心。但是讲课确实魔幻，而且这门课本身就恶心。\n\n评论区两极分化我认为十分正常，因为我个人对老师的评价也是存在巨大变化：\n\n前几节课不知其所云，从没遇到过讲课这么烂的老师，想打0分；后期慢慢适应，反正不听就行了😀最后给分感觉还行
191394,428,楼珍丽,2024-04-19 05:34:10,0,0,0,这几天听了下陈宏的事迹\n\n感觉老师比陈宏好\n\n打个5分帮老师拉一拉
192888,428,楼珍丽,2024-05-31 08:54:36,0,1,1,老师人真的还挺不错的，有什么问题问她她都会很耐心地跟你讲解。我的模电报告上传有两次都出现了问题，楼老师还特意在第二次课上给我另外开通了权限，让我补交报告。
193337,428,楼珍丽,2024-06-06 14:09:10,0,1,1,坐标去年秋冬学期模电实验，老师人挺好的，问老师问题老师会有积极回应，中规中矩吧 没几年的评论说的那么严重。这门课是五级制的可能会有部分同学绩点比较低，再加上这门实验课事情有点多，，我觉得这纯是这门课有病，，后面几节课实验如果前几个完成的话会有bonus，PPT还挺详细的，听老师讲听个大概然后和同学交流在照着PPT做就足够在这节课完美存活。（上一年老师的风评好像和再前几年有点差别 是老师改好了么hhh不是水军哈 虽然几个略微的好评都连一块有点像）
195296,428,楼珍丽,2024-06-27 16:04:38,0,1,1,有及格分。去年秋冬的模电实验，现在考试周结束了好无聊来评一下。\n\n\n\n最开始感觉不知所云，后来逐渐习惯，确实听也听不懂（实验超前于理论以及对电路真的缺点天分（？）导致的不会接线）。略过PPT上那一大堆，最后弄清楚实验要求，照着PPT接线图开始做，其实也能昨晚。电路实验还好，模电实验开始我每次都一点左右才做完……\n\n\n\n最后焊接音响放大电路，简直想死。焊接室周末不开门，时间卡很紧，得有空就去。我一开始二极管还焊反了，最后返修一次。\n\n\n\n有好几次实验我测的数据都比较离谱，但因为数据之间是一致的，老师也认可了我的测量结果。每次都做得很慢，感觉也没有很好，实验报告认真在写得分忽高忽低。大概是期末救了一把，实验做完了。存活
215267,428,楼珍丽,2025-02-25 02:52:13,-2,0,2,给分好，考试标准高，学到的很多
219348,428,楼珍丽,2025-05-25 14:35:36,0,0,0,讲得不清楚，问问题也经常不理，班里很多同学都觉得上这门课痛苦
153,538,卢琴芬,2015-03-14 16:13:45,24,35,11,我老板人还是不错的，对于学生问题能耐心答，给分也不错。\n\n欢迎学弟学妹加入我们实验室！
36311,538,卢琴芬,2016-11-15 12:03:54,2,4,2,讲的不错，但令人昏昏欲睡
36911,538,卢琴芬,2016-11-16 12:32:25,3,5,2,老师讲课节奏很快，没有废话，千万不要水手机，尤其是电拖。\n\n老师人超好，会在群里答疑，基本上秒回，晚上11点半都回复你，而且很耐心。
62415,538,卢琴芬,2017-11-25 04:08:18,0,0,0,很不错
88745,538,卢琴芬,2018-11-07 06:58:47,11,13,2,十分是肯定的，只是求老师按时下课哇
88823,538,卢琴芬,2018-11-09 02:51:35,5,6,1,求求老师复习课多讲点考点吧
89098,538,卢琴芬,2018-11-15 12:51:31,-2,2,4,老师很认真，讲的也很透彻，认真听的话收货很大，嘻嘻
89720,538,卢琴芬,2018-11-20 11:54:10,5,7,2,讲的很好，给分随缘......
119211,538,卢琴芬,2019-11-11 08:00:37,3,5,2,讲的很认真，但是给分真的.......
126361,538,卢琴芬,2020-09-24 01:00:13,-7,3,10,上课一堆废话，不知道讲得什么玩意
127425,538,卢琴芬,2020-11-23 02:41:35,0,2,2,讲课很好，问问题回复很快，不调分，出分很快！老师人很好很亲切随性。\n\n
136083,538,卢琴芬,2021-06-11 01:23:05,0,2,2,好老师。
140542,538,卢琴芬,2021-09-13 13:38:57,0,2,2,卢老师宝藏老师
168228,538,卢琴芬,2023-02-04 07:25:26,1,3,2,电机学，给老师打个十分，我们这届因为疫情原因，期末考试在下学期开学之前考，卢老师就在钉钉群里日更每日一题，非常有耐心。对我们提出的问题也能面面俱到地回答。\n\n然后，如果老师您能看到的话，我也提一点点小建议。就是，您那个PPT实在是有点一言难尽。所有的重点和易错点都是您上课口述，在PPT里什么都没有。比如交流电机不同绕组的电流流向问题，和它进而导致的并串联连接方法问题，如果不去找回放看，通过您的PPT，实在是很难理解。还有一点是，所有的相量图，画的都太集中了。我往往还没找到哪个是哪个，就全都过去了。就单论最简单的堵转的异步电机，单单凭您在相量附近错杂而繁乱的标注，我就完全不知道哪一个字母符号代表图上的哪一个向量了。更何况那些包含十多个变量，近十个对应关系的极度复杂的向量图，实在是完全看不懂。如果从教学效果上考虑，您看把这些向量图拆分一下各自讲解，最后再放到一起会不会更好一点。
170571,538,卢琴芬,2023-03-07 01:11:31,0,2,2,讲课很乱，同个章节的PPT上传很多份，里面多有重复不会整合。最后似乎不调分，实验也很混乱。上课好像无重点可言，慎选。
170578,538,卢琴芬,2023-03-07 01:49:09,1,2,1,课讲的很好 给分很求是 不调分\n\n上课会有小测 会点名
214674,538,卢琴芬,2025-02-16 11:23:44,0,1,1,讲得太烂了
35502,578,方攸同,2016-11-10 07:22:07,2,7,5,很水，但不知道给分怎么样
35549,578,方攸同,2016-11-15 08:24:13,-8,7,15,课很水..给分好..
36689,578,方攸同,2016-11-15 11:36:14,15,23,8,老师超级棒！水平特别高，给分还超级好！
60446,578,方攸同,2017-10-20 21:41:21,15,18,3,超级棒
61719,578,方攸同,2017-11-20 09:00:55,-1,8,9,给分好个屁啊，展示做了，试卷写满了才给个垃圾分数！
61730,578,方攸同,2017-11-20 10:20:01,17,19,2,老师讲得很有深度，给分还行的
61734,578,方攸同,2017-11-20 11:59:24,31,35,4,很有思想的老师，当被全世界抛弃还能执着向前，佩服这种精神！
61817,578,方攸同,2017-11-21 05:56:36,6,11,5,考试没有区分度，给分太水了，但不知道是按什么给的，同组人一次课没去过满绩了，自己认认真真学了一学期最后成绩一般，估计是因为我字不好看吧
65600,578,方攸同,2018-01-07 02:18:14,20,21,1,很有思想，没白选
73728,578,方攸同,2018-02-03 04:47:38,17,17,0,有思想，有情怀
75667,578,方攸同,2018-03-15 03:01:22,18,19,1,小组展示加开卷考!开卷考好好准备比较重要。老师很帅也很有风度!
87385,578,方攸同,2018-09-28 02:10:34,23,25,2,百家讲坛无疑了
88332,578,方攸同,2018-10-29 01:28:05,18,20,2,百家讲坛
88406,578,方攸同,2018-10-30 07:40:28,12,13,1,非常棒\n\n
88584,578,方攸同,2018-11-02 03:41:54,17,18,1,百家讲坛
88717,578,方攸同,2018-11-06 12:10:02,9,10,1,不点名，不需要点名，很棒
88744,578,方攸同,2018-11-07 06:57:06,11,12,1,棒棒哒！
89021,578,方攸同,2018-11-14 04:02:37,15,16,1,牛，电气学院超级大牛
90338,578,方攸同,2018-11-23 08:05:27,12,13,1,老师水平很高很有情怀，学到了很多知识和知识以外的
90351,578,方攸同,2018-11-23 08:48:15,15,15,0,娓娓道来，山河纳于胸。\n\n上课听着很舒服，很有意思。
90515,578,方攸同,2018-11-23 17:46:54,-2,9,11,4.5的赞我，我就想知道有多少人
90848,578,方攸同,2018-11-26 14:02:09,9,9,0,很有气质，讲课很好的老师。听了与否不影响考试，但是认真听会有很大收货的。最后考试开卷没什么区分度，可能平时多发言会分数好一点？
103241,578,方攸同,2019-02-27 03:01:53,14,14,0,没有人觉得老师长得像燕双鹰吗？
118416,578,方攸同,2019-10-29 15:20:13,6,7,1,很有收获
119417,578,方攸同,2019-11-13 00:21:46,2,6,4,谢谢老师
119451,578,方攸同,2019-11-13 01:53:21,-1,3,4,谢谢老师哈哈哈哈哈
119485,578,方攸同,2019-11-13 04:43:27,6,8,2,其实给分没那么好？  \n\n提问不登记  开卷考大家基本都差不多吧  可能和字迹有关   大概就看展示？ 3.9哭晕 我以为不正态的这种专业课怎么都不会下四
119620,578,方攸同,2019-11-14 07:39:40,5,6,1,老师很好，但是助教不太负责，提问都不知道有没有记录
141412,578,方攸同,2021-10-07 12:27:33,2,6,4,有思想，有水平，有情怀
142465,578,方攸同,2021-11-12 01:51:47,8,11,3,nmb
150727,578,方攸同,2022-02-16 06:20:25,-1,2,3,超级棒
151478,578,方攸同,2022-03-04 07:14:59,-1,2,3,太棒了
182361,578,方攸同,2023-11-15 06:42:18,1,4,3,强推现代电气化交通技术
182736,578,方攸同,2023-11-20 03:46:14,1,3,2,老师太棒了，讲的又好，给分又好
182737,578,方攸同,2023-11-20 03:50:07,3,6,3,优点如下：\n\n1、不点名\n\n2、事少（就一个展示）\n\n3、学分高\n\n4、考前会有复习题，几乎跟期末考试一模一样\n\n5、期末考试开卷且可以使用电子产品\n\n6、给分极好\n\n\n\n总结：大学的第三年，独一档的极品课程，选到就是赚到
202083,578,方攸同,2024-11-09 06:00:12,2,4,2,神中神，电气目前体验最佳的课程。老师业务能力强，课堂形式新颖，不点名很自由！老师人也很好，考卷写不下还给我拿A4纸
202437,578,方攸同,2024-11-12 17:23:31,8,9,1,其实给分没有想象的好
202766,578,方攸同,2024-11-14 08:21:12,3,4,1,自我感觉给分很差了
203058,578,方攸同,2024-11-16 07:13:36,-3,0,3,总体来说是门好课
215100,578,方攸同,2025-02-21 05:03:15,0,1,1,知识量很大，风格见仁见智，没有压力，收获满满
213,619,潘丽萍,2015-03-14 16:54:45,42,51,9,潘阿姨
5390,619,潘丽萍,2015-07-07 06:04:31,1,2,1,还可以
5852,619,潘丽萍,2015-07-09 15:20:11,0,1,1,吼吼
5853,619,潘丽萍,2015-07-09 15:21:24,3,4,1,潘阿姨+1
5961,619,潘丽萍,2015-07-10 04:37:55,22,24,2,不点名，作业交了就有平时分，讲课很好的！
7322,619,潘丽萍,2015-09-13 12:57:54,3,3,0,萌萌哒的老师挺好哒(≧∇≦)
8240,619,潘丽萍,2015-09-17 23:02:56,2,2,0,很享受
9536,619,潘丽萍,2015-10-29 08:47:16,7,9,2,挺好的，就是我做实验太差了
10412,619,潘丽萍,2015-11-18 13:29:02,0,1,1,感觉挺不错
13132,619,潘丽萍,2015-12-25 02:37:01,3,3,0,很好地班主任！
22935,619,潘丽萍,2016-03-15 03:08:25,6,7,1,亲切的潘阿姨
23837,619,潘丽萍,2016-04-18 12:38:33,5,6,1,潘女神
24444,619,潘丽萍,2016-04-30 14:11:58,0,1,1,萌萌哒潘阿姨
24793,619,潘丽萍,2016-05-03 15:48:05,3,3,0,讲课没有波澜，很细致，棒棒的。
25743,619,潘丽萍,2016-06-06 06:25:35,0,1,1,可以的
28122,619,潘丽萍,2016-06-28 08:07:57,11,13,2,短学期潘老师的电工电子实习，棒棒哒
30444,619,潘丽萍,2016-07-01 15:20:42,0,1,1,老师人女神，讲课也棒棒的～～
30600,619,潘丽萍,2016-07-02 04:41:16,7,7,0,老师很温柔讲得挺细致的，答疑也很热心。最后一节课务必认真听。
30679,619,潘丽萍,2016-07-02 07:53:39,5,5,0,老师很温柔，讲课很棒
30758,619,潘丽萍,2016-07-02 11:46:06,0,0,0,原谅我基本没听过课，但老师还是挺好的，讲课平平稳稳的
35574,619,潘丽萍,2016-11-10 07:28:32,0,0,0,这是一门自己动手的课   老师很好，关键还得靠自己
35884,619,潘丽萍,2016-11-10 08:41:19,3,3,0,真心好老师，超级耐心，不懂问。实验是最棒的真好玩，而且做完就可以提前下课(≧▽≦)
36122,619,潘丽萍,2016-11-10 13:00:30,0,1,1,很温柔，问她问题会认真解答
36148,619,潘丽萍,2016-11-10 15:01:54,0,0,0,老师人很好，这门课也很好。
36544,619,潘丽萍,2016-11-15 00:00:09,0,1,1,学到知识，还有实践
36586,619,潘丽萍,2016-11-15 03:47:09,3,3,0,潘老师人真的好好，电工电子实验课也挺好玩的最喜欢焊电路板，就是给分低我心痛痛，也可能是因为我实验做的太腊鸡，推荐选
36650,619,潘丽萍,2016-11-15 07:53:38,0,0,0,老师讲课非常详细，而且每次做实验的时候都会很耐心的讲解，实验也很有意思，有点遗憾不能跟着老师上课了，老师人真的超好，给的分也挺高的
37162,619,潘丽萍,2016-11-17 15:54:51,0,1,1,潘阿姨+1\n\n短学期的课 都是实验课 很有趣\n\n给分挺好的 感觉要想拿高分 有一个好的搭档也很重要
37190,619,潘丽萍,2016-11-18 00:59:47,0,0,0,老师人很好，喜欢动手实验的就来吧，挺有趣的
38514,619,潘丽萍,2016-12-07 10:29:32,0,0,0,这课很好玩，就是要是电路出现错误可能会“被”自己拖课    老师很好
38737,619,潘丽萍,2016-12-16 03:02:41,0,0,0,赞。。
40206,619,潘丽萍,2016-12-30 02:52:18,0,0,0,听讲的话一下就会了，不停的话老师再好也没啥用是吧
40869,619,潘丽萍,2017-01-06 04:12:19,0,0,0,温柔讲课棒
44445,619,潘丽萍,2017-01-18 00:06:15,0,1,1,超好的老师，我的唯一的4.5就是老师给的(>^ω^<)
46511,619,潘丽萍,2017-01-22 01:34:15,-12,3,15,老师讲课有时候讲不清楚，特别是软件操作那块，全自己瞎弄
48096,619,潘丽萍,2017-02-28 12:19:56,1,2,1,作业一定要写好，这里是绝对你分数的关键
52573,619,潘丽萍,2017-06-21 06:58:41,2,4,2,电工电子工程训练，你值得拥有！
54315,619,潘丽萍,2017-06-29 05:38:45,0,1,1,电工电子训练，潘老师很不错啊，平时实验认真做，绩点不会低，我可能报告写的不够好，拿了4.2。感觉学到了很多。
54450,619,潘丽萍,2017-06-29 10:26:00,4,5,1,实验做的也挺快的，不知不觉就只有3.0分，心痛，心痛
54599,619,潘丽萍,2017-06-30 00:33:08,3,3,0,最有气质的老师之一
57346,619,潘丽萍,2017-07-07 02:47:36,0,0,0,老师很棒，很温柔…最后考试的知识点划重点也是很好…老师真的超级棒
59002,619,潘丽萍,2017-09-19 05:20:09,1,1,0,耐心温柔，棒！
59128,619,潘丽萍,2017-09-20 00:59:49,3,3,0,棒， 棒棒棒
61826,619,潘丽萍,2017-11-21 06:48:37,16,17,1,选了电工电子工程训练，老师虽然讲时间到就实验做不完就算了，实际上陪着我这个手残到了5点多，好老师。
61919,619,潘丽萍,2017-11-21 17:01:22,0,1,1,秋学期建议不要选，八周课压成七周上结果就是最后一节课连做4个小时实验还要当堂赶出报告。。。给分还是很好的，但不得不说是个体力活。
62094,619,潘丽萍,2017-11-22 11:18:28,0,0,0,绝对好老师!绝对好通识课!表白潘女神\(//∇//)
66371,619,潘丽萍,2018-01-15 12:37:06,1,1,0,表白潘女神
66525,619,潘丽萍,2019-01-04 05:30:15,-16,7,23,差得一批
66625,619,潘丽萍,2018-01-17 15:04:59,1,1,0,讲课很亲切，给分很高
70841,619,潘丽萍,2018-01-27 15:24:38,1,1,0,老师讲课很详细  人也很好  表白表白
70964,619,潘丽萍,2018-01-28 01:05:53,1,1,0,耐心负责，有时会开小玩笑，不过3.5学分的电工电子理论＋实验一定不能忽视实验报告！！别问我怎么敢说的ToT
71080,619,潘丽萍,2018-01-28 02:32:02,0,0,0,亲切，讲课好的潘阿姨
72705,619,潘丽萍,2018-01-31 02:23:34,1,1,0,超级温柔的女神～
76601,619,潘丽萍,2018-04-16 06:25:06,0,0,0,电工电子学的潘女神
77235,619,潘丽萍,2018-05-04 05:23:16,6,6,0,好老师 就是plc课程略无聊 就是给一份ppt然后背下来...
77908,619,潘丽萍,2018-05-08 12:38:25,1,2,1,老师人很好，女神
81177,619,潘丽萍,2018-07-04 08:14:37,0,0,0,语气有气无力，像绵?一样，哈哈哈\n\n讲课细致，为人亲切，有点东西！\n\n上的电工电子学。好老师！好老师！\n\n
86103,619,潘丽萍,2018-09-07 10:29:02,1,1,0,超级棒的潘阿姨！表白表白
86441,619,潘丽萍,2018-09-16 07:23:15,0,0,0,虽然是今年变成五级制了但是还是轻松优秀给分太好啦，赞
86499,619,潘丽萍,2018-09-17 02:02:13,1,1,0,潘老师讲的很好，
88482,619,潘丽萍,2018-10-31 07:38:07,0,0,0,上潘老师的课非常舒服 讲的很好 很nice
89280,619,潘丽萍,2018-11-18 04:13:51,0,0,0,上的电工电子训练 很简单啦
89341,619,潘丽萍,2018-11-18 14:21:41,0,0,0,行程开关实验有一次没做出来，认真写报告，但最后4.2很高兴，表白潘女神
89343,619,潘丽萍,2018-11-18 14:27:28,0,0,0,爽，事少分高，电工电子工程训练也很有趣，强烈推荐
90569,619,潘丽萍,2018-11-24 06:49:00,1,1,0,实验做的好 分就高 但老师确实很好 是一门能学到东西的实验课
91282,619,潘丽萍,2018-12-05 02:20:02,-1,2,3,喜欢她说话懒懒的腔
92488,619,潘丽萍,2018-12-31 05:31:19,0,0,0,很有耐心的好老师
94060,619,潘丽萍,2019-01-15 05:18:16,2,2,0,完美的老师
94823,619,潘丽萍,2019-01-18 09:07:14,0,0,0,老师是好老师，虽然我考炸了刚及格，但是老师是好老师。
94858,619,潘丽萍,2019-01-18 10:57:47,6,7,1,在整个课程中，我最喜欢实验部分了，因为我的队友是一个超棒超温柔超好看的小姐姐٩(๑^o^๑)۶\n\n
95631,619,潘丽萍,2019-01-19 16:37:27,0,0,0,老师很好很负责，给分也很棒，不过电工电子工程训练这门课本身比较硬核，很看自己的操作能力和队友的水平，，，所以选课需要慎重
104886,619,潘丽萍,2019-03-29 14:02:05,14,15,1,不觉得老师有点像十元吗！！！
107408,619,潘丽萍,2019-05-05 02:42:31,0,2,2,PLC没有实验考试了！认真对待满绩挺容易的。
107418,619,潘丽萍,2019-05-05 04:06:27,0,1,1,PLC给分超级棒\n\n就是背的东西有点多，实验没有考试之后变简单了很多，老师上课的氛围也很轻松，实验不会的老师很热心的帮忙，建议选！
109314,619,潘丽萍,2019-06-27 08:30:45,1,1,0,人很好，很亲切，不过最后给分很玄学，感觉自己蛮认真的，?点还是很低
109444,619,潘丽萍,2019-06-14 12:38:46,3,3,0,plc还是不要选了...没什么干货
109506,619,潘丽萍,2019-06-16 05:34:59,1,1,0,老师很好，课有点硬核
110516,619,潘丽萍,2019-06-27 08:32:56,2,4,2,给分。。我想说我的分完全配不上我付出的时间，精力。用心完成，绩点挺低的3.6
110567,619,潘丽萍,2019-06-27 13:23:45,3,3,0,课真累
110631,619,潘丽萍,2019-06-27 23:46:46,0,1,1,上的电工电子工程训练，虽然我很菜，最后只有3.3，说不定还拖累队友了，但这门课真的蛮有意思的，也很有成就感。老师很棒。
111584,619,潘丽萍,2019-07-02 05:00:45,0,0,0,给分非常好，也很有耐心，即使是实验出问题，也会陪你，也帮助找时间补做，谢谢老师救我绩点。
118079,619,潘丽萍,2019-10-20 13:21:21,1,1,0,好好好
119124,619,潘丽萍,2019-11-10 14:57:53,2,2,0,电工电子学及实验 不管给分如何，反正老师个人以及讲课都非常赞
119933,619,潘丽萍,2019-11-17 01:18:30,0,0,0,单就老师来说很赞，讲课给我一种初中科学老师的感觉，有问必答，实验做不出来会一直等你做好，很和善的一个老师；但电工训这个博雅有点硬核...没有基础没有同组大腿的孩子真的太难了，全程懵逼脸...最后绩点挺低的，选择要慎重吧，但是真的很喜欢这个老师，还是给了10分哈哈
120792,619,潘丽萍,2020-01-17 03:31:10,0,0,0,给分不咋地，勉强没有被正太的水平\n\n也还好我这门课就是拿来休息的，专业课已经累得要死了
121331,619,潘丽萍,2019-12-19 10:47:09,1,1,0,老师绝对非常nice，给9分只是因为电工电子学及实验的助教，找细枝末节狠狠扣作业分有意思吗？
122992,619,潘丽萍,2020-04-28 03:24:37,0,1,1,非常好的老师，讲课清楚
124139,619,潘丽萍,2020-06-25 05:30:36,3,3,0,可编程逻辑控制器这门课不建议选……又是闭卷又是全英，上课讲的也很迷
125734,619,潘丽萍,2020-09-14 00:08:46,4,12,8,请问一下电工电子工程训练对不是本专业的，就比如说医学生难度大吗？
126502,619,潘丽萍,2020-09-28 14:24:25,32,32,0,潘丽萍麻麻好好看好好看好好看😱😱😱😱
127264,619,潘丽萍,2020-11-18 10:06:25,-15,0,15,挺好的 就是被正态到4.2了 实验报告一定要认真写
127278,619,潘丽萍,2020-11-19 12:45:04,-1,0,1,非常好的老师！！！！！\n\n很耐心地讲解（虽然大部分我听不懂）\n\n但是实验操作卖相好分就高，懂不懂没多大关系的哈哈哈哈~~~
127552,619,潘丽萍,2020-11-24 09:45:55,2,6,4,气死了，正态带师
130288,619,潘丽萍,2021-01-20 12:53:44,4,4,0,助教给分低（相对于另一位老师的助教而言），作业抠得很仔细\n\n老师好评，认真负责
133904,619,潘丽萍,2021-03-09 09:56:07,1,1,0,PLC怎么上啊，有没有前辈指教
135106,619,潘丽萍,2021-04-30 10:00:07,1,2,1,给分还可以吧，事情多而且任务布置晚，最后一周还去做实验，实在很难有时间干别的。这门课还开的话，建议选修的同学该学期其他课程不要安排太多
135121,619,潘丽萍,2021-05-01 10:08:55,12,12,0,PLC不要选哦
135208,619,潘丽萍,2021-05-06 03:13:39,7,7,0,别选PLC，快逃
135396,619,潘丽萍,2021-05-09 17:05:30,-3,1,4,真的很好很好，给分高，很理解学生
142498,619,潘丽萍,2021-11-12 09:13:30,1,3,2,好老师，没有什么解释，女神
142898,619,潘丽萍,2021-11-17 07:33:25,-4,1,5,电工电子课很好，可以学到很多干货，就是给分与实验完成速度关系很大…
144986,619,潘丽萍,2021-12-26 08:21:08,-2,8,10,电工压力大，分数捞不着，时间排满满，吃饭全家见
148950,619,潘丽萍,2022-01-14 04:11:59,1,1,0,老师很和蔼啊，讲的也很好
149359,619,潘丽萍,2022-01-15 07:15:13,4,4,0,老师讲课水平很高，不过不知道为啥我总感觉有点丧丧的感觉（bushi）\n\n希望老师之后的电工电子学及实验可以换一个小一点的教室，每次看到教室前排人那么少感觉老师挺难过的
161054,619,潘丽萍,2022-10-25 05:46:35,3,3,0,选了电工电子工程训练这门通识课，感觉很有意思！潘老师讲课也很细心！每次实验结束一篇实验报告就完事，事情真的不多！而且其实是做完实验就可以走了，并不用等到下课时间的
161292,619,潘丽萍,2022-11-03 16:53:23,0,0,0,选的是电工电子工程训练这门课。个人感觉这门课用一个词就能概括：连线！要做的很简单：照着给的图，把要连的东西连到一起。老师讲课感觉是挺到位的，认真听了之后做实验就行了，只要听得认真听进去了，做实验是绝对没问题的。
161399,619,潘丽萍,2022-11-06 02:48:24,0,0,0,潘老师人超好！
161867,619,潘丽萍,2022-11-14 15:02:30,1,1,0,电工训，老师人美心善，给分好。理论略显枯燥，下午第一节超困(QAQ，老师对不起）。但是只要认真听电路图部分，实验就没什么问题。（甚至可以提早一小时下课ヽ(✿ﾟ▽ﾟ)ノ）没听也没事（bushi），老师会告诉你哪里错了，该怎么改。
163854,619,潘丽萍,2022-12-16 08:55:27,8,8,0,电工电子工程训练作为一门博雅技艺的宝藏课程好少人发现真的太可惜啦，实验课真的很充实，老师真的很有耐心也很体谅学生，虽然绩点是看实验为主，但是老师会给调分。老师会陪你做实验接电路到很迟，只要你愿意老师都会陪着你，（但是基本都能按时完成哒，所以其实只是我太菜呜呜），我最开心的是最后一节课你可以自己焊接一个蓝牙小音箱带走。老师先前生病了秋学期重新开的课，但是备课做得很认真。只是高中没学过没物理通用的话会有些痛苦。
169033,619,潘丽萍,2023-02-24 05:28:06,3,4,1,【电工电子学及实验】老师人还是很好的，但是这门课的平时作业与实验报告扣的太细了。老师会要求助教严格批阅作业和实验报告，要求一定要批出区分度来，所以每年的助教都会按照老师要求来做，很多同学平时作业做得很粗枝大叶，每次都会扣一点分，最后累计起来会丢不少分。所以选这门课的同学们一定要认真做作业，平时作业尽量画图，步骤写完整，实验报告不要糊弄，思考题尽量都写上。最后祝大家都满绩。
169594,619,潘丽萍,2023-02-27 04:52:16,1,1,0,挺好的。
169599,619,潘丽萍,2023-02-27 05:20:58,0,0,0,给老师磕一个，海底捞，不仅没挂甚至还有七十多。平时实验报告写了基本给满，作业会抠一下，两三次小测，不定期点名，不过上课确实无聊了一点
170981,619,潘丽萍,2023-03-13 16:02:42,0,0,0,大爱潘老师！！！
171996,619,潘丽萍,2023-04-16 14:51:32,0,0,0,电工电子工程训练（通识），一门硬核得不能再硬的博雅技艺通识~
186423,619,潘丽萍,2024-01-11 04:30:36,0,0,0,【电工电子工程训练】老师人很好的，高中学过物理和技术而且动手能力很强的uu选这门课应该会觉得很好玩而且很容易拿到高绩点。\n\n但是本人是手残党，没学过技术物理也不太好，所有的实验基本都是全班倒数第2.3个做完的，实验报告认真写了，最后绩点是4.2。\n\n感觉当初选这门课是一种不爱惜自己绩点的表现，学得很辛苦绩点又高不起来，不过这门课确实能学到很多东西的。
190019,619,潘丽萍,2024-02-09 11:56:53,1,1,0,潘阿姨上课贼好！
191403,619,潘丽萍,2024-04-19 11:05:27,0,0,0,通识课很有趣，不水。课时看着长，但做完课上的任务就能提前离开。
192208,619,潘丽萍,2024-05-12 01:58:12,1,1,0,电工电子工程训练上课挺硬核的，但是也很好玩的，老师人很好
192706,619,潘丽萍,2024-05-29 04:06:16,-2,8,10,电工电子学真的别选，会变得不幸\n\njgj班平时测试是以作业形式布置的，而plp全部在课上限时完成\n\n和她几次交流下来她对于调分这种手段的态度十分反感，认为这样让50分的同学和49的同学都变成50分或者变成50分和49.5，都是对50分同学的不公平，殊不知在严苛且密集的课堂测试下没几个人拿得到50分\n\n因此给分非常求是\n\n楼下说好的似乎都不是电工电子学呢，呵呵
195338,619,潘丽萍,2024-06-27 20:13:27,0,1,1,老师人超好
201596,619,潘丽萍,2024-11-04 15:39:25,2,3,1,脾气很凶，喋喋不休的
202066,619,潘丽萍,2024-11-09 02:33:30,1,2,1,对真正喜欢电工电子的同学来说这门电工电子工程训练值得一选。可以学到东西又不至于难度太大。小登也可以冲！认真学习结果不会差。
204848,619,潘丽萍,2024-11-28 06:20:10,2,3,1,当时看评分高才去的，结果是另一个男老师上课，说她生小孩去了，哎，当时为什么不提前通知呢，感觉被诈骗了。
205906,619,潘丽萍,2024-12-12 14:54:29,2,3,1,潘老师真的特别好，她讲课虽然有点听不懂，但是会很耐心的在实验时给你纠正，语气可能不是很耐心，但是真的她其实是脾气很好，对待学生很认真的，她在你完成实验时也会替你感到成就感慢慢，也很有礼貌，真的很好的老师
208059,619,潘丽萍,2025-01-16 10:37:53,0,2,2,潘老师真的很好，讲课很清晰，对同学很和蔼。还没考试先打个分，求捞捞。更新，抱怨绩点的我只能说菜就多练，别怪老师。
208231,619,潘丽萍,2024-12-26 08:58:11,0,1,1,温柔智慧的老师，十分有耐心，讲的也很好
211045,619,潘丽萍,2025-01-10 11:45:02,3,4,1,老师老师，你的电工电子学确实很强，但还是太吃自学了了\n\n有没有什么更适合小白的老师推荐一下？\n\n有的同学，有的\n\n像这么 nb的老师共有3个\n\n都是当前院系热门老师\n\n告诉老师，你想拜师哪个\n\n除了 mje，还有 sh，jgj\n\n都是当前院系最 nb 的老师，想要大学上课学的开心从这三个里面选就对了
211244,619,潘丽萍,2025-01-11 05:13:27,3,4,1,讲课水平固然高，但不能掩盖非常折磨学生的事实。\n\n电工电子学事多分低，每个单元都有小测和慕课，每三章一次大测验，慕课期末考要拍照上传大题，甚至还有一篇思政报告。\n\n期末复习不会告诉你重点，只说哪些不考，期末试卷涵盖范围广题量多，要记忆的东西多。\n\n总之，授课水平高但不推荐选，给分求是且非常折磨。
211924,619,潘丽萍,2025-01-13 01:55:44,0,1,1,电工电子工程训练太好玩了，做完还能提前下课，最后还会亲自焊一个小音箱带回家，老师人很好，絮絮叨叨的，很像家里长辈
212205,619,潘丽萍,2025-01-13 11:15:31,0,3,3,老师的电工电子学如果为了绩点还是算了，3.6绩点直接爆拉我
213355,619,潘丽萍,2025-01-17 04:45:24,0,1,1,给分很好，耐心温柔，电工电子学感觉被捞了很多
215640,619,潘丽萍,2025-03-03 06:52:07,0,0,0,你说得对
217001,619,潘丽萍,2025-03-31 07:45:21,3,3,0,助教最心狠手辣的一集
221583,619,潘丽萍,2025-06-24 15:58:46,0,0,0,平时分干脆都给90%得了
1726,622,范承志,2015-03-23 23:13:43,29,30,1,人很好
4240,622,范承志,2015-06-18 09:04:49,15,15,0,好老师不解释
5894,622,范承志,2015-07-10 00:34:40,6,6,0,好老师
5905,622,范承志,2015-07-10 01:36:18,8,8,0,好老师～
6061,622,范承志,2015-07-10 13:56:26,3,5,2,超级好。讲得好给分高
8927,622,范承志,2015-10-01 10:46:36,11,11,0,好老师，课讲的十分透彻清晰，传业授道解惑
13807,622,范承志,2015-12-31 07:16:30,4,4,0,传道授业，好老师
18451,622,范承志,2016-01-21 16:00:26,6,6,0,这个老师超级好！超级赞！
18453,622,范承志,2016-01-21 16:00:38,3,3,0,非常好
18477,622,范承志,2016-01-21 17:12:39,2,2,0,传道授业解惑也，浙大男神
18942,622,范承志,2016-01-22 23:59:29,2,2,0,特别好
19185,622,范承志,2016-01-23 12:10:43,5,5,0,好老师，男神！
19394,622,范承志,2016-01-24 05:19:39,3,3,0,挺好的啊
22869,622,范承志,2016-03-21 02:33:02,2,2,0,太快了听不懂啊啊啊
22882,622,范承志,2016-03-14 05:44:29,1,1,0,其实我经常听不懂`_>`但是老师很好
23639,622,范承志,2016-04-11 09:07:50,0,0,0,太好了太好了太好了，浙大最好的老师
24185,622,范承志,2016-04-28 07:06:26,2,2,0,いい先生 大好きだ
24468,622,范承志,2016-04-30 14:50:26,1,1,0,虽然有点口音，但是课很好
24726,622,范承志,2016-05-03 08:15:01,0,0,0,条理清晰
28018,622,范承志,2016-06-28 07:59:50,0,3,3,讲课很棒，上课认真听期末没问题，最近模电考得越来越简单了
28059,622,范承志,2016-06-28 08:03:06,1,1,0,老师可萌了
28489,622,范承志,2016-06-28 09:24:33,1,1,0,有趣哦
28632,622,范承志,2016-06-28 11:17:34,1,1,0,口音很有趣，上课也很好，超级棒
30878,622,范承志,2016-07-02 17:32:02,2,2,0,橙汁人真的超好啊
31084,622,范承志,2016-07-03 08:05:54,2,2,0,好老师，给分很好，讲解也很耐心。上课语速比较快，有点杭州口音，可能不太适合北方的同学
31122,622,范承志,2016-07-03 08:46:51,1,1,0,老师挺好的，给分也好，就是有口音
31135,622,范承志,2017-01-20 00:21:10,2,2,0,萌萌哒！讲的很细，考点全到！
34101,622,范承志,2017-01-19 04:56:12,3,3,0,橙汁太优秀了  就是这个口音异常感人
34920,622,范承志,2016-10-26 12:57:06,-7,0,7,好气啊，他的实验课太痛苦了！稍微后排一点就根本听不懂他在说什么！跪着写完实验报告，好气啊～！！！！！！！！！！！！！！
40908,622,范承志,2017-01-06 08:17:14,2,2,0,非常好的老师，考试后排的同学没座位还特意搬凳子来～平时事情少
41001,622,范承志,2017-01-07 13:52:33,4,4,0,简直太帅了，虽然我经常听不懂，但是就觉得他讲的好，还经常跟我们培养工程的思想，口头禅：毫无疑问（带口音），这个太简单了。hhh
41534,622,范承志,2017-01-12 06:59:27,2,2,0,过渡过程，咕噜过程，好萌啊哈哈哈
44070,622,范承志,2017-01-17 08:59:41,4,4,0,实验考试操作题只做了第一小题，得了4.5，什么都不说了，满分?
46295,622,范承志,2017-01-21 07:06:20,2,2,0,超级超级好的老师！
46314,622,范承志,2017-01-21 08:11:36,4,4,0,是很好的老师呀！很负责\n\n不过推外功放是什么 期末才知道原来是推挽功放
46341,622,范承志,2017-01-21 09:24:53,2,2,0,真的可以的，橙汁人很好，也比较认真，从来不拖堂。
46369,622,范承志,2017-01-21 11:02:07,2,2,0,橙汁萌萌的男神
46882,622,范承志,2017-01-22 15:42:04,0,0,0,老师人很好的，有不懂的问题会很耐心解答，而且上课事情也不多。就是口音有点点啦，不过听习惯了还好
46928,622,范承志,2017-01-23 03:05:39,0,0,0,男神老师！除了有一点口音之外，讲课特别认真给分一级好！
47303,622,范承志,2017-01-25 07:17:12,2,2,0,祭出北高峰
48245,622,范承志,2017-03-01 11:39:58,2,2,0,老师对待上课十分认真，范老师明年就要退休了，十分感恩
50249,622,范承志,2017-05-02 03:20:18,0,0,0,满分不解释 谁上谁知道
23070,632,杨家强,2016-03-17 01:48:39,17,18,1,讲的很通俗易懂，但是废话有点多。
23214,632,杨家强,2018-04-14 06:36:43,26,33,7,两节课一节课废话 半节课开电脑
24320,632,杨家强,2016-04-29 10:43:39,3,4,1,老师话比较多，但是自己课后认真学的话，还是可以学到不少知识的，强调对模块的理解
28269,632,杨家强,2016-06-28 08:23:51,3,4,1,讲的不错
36509,632,杨家强,2016-11-14 10:37:37,0,3,3,好评！！！
49594,632,杨家强,2017-04-20 00:09:54,2,4,2,非常敬业非常好的老师，虽然有点絮叨
52970,632,杨家强,2017-06-24 08:25:48,4,6,2,在电院的个性课程里算是比较良心。期末抄A4纸有限开卷，张数不限，简答题大部分原理，比较，优缺点，组成等等，ppt里都有。真的很水，但不知道为什么选的人比较少。通信原理我这门坑竟然每次选这么多人，不解。
75303,632,杨家强,2018-03-09 00:29:12,0,4,4,还不错的老师 上课通俗易懂（但是有点啰嗦） 考试半开卷可以带不限张数的A4纸 稍微用点功应该能拿到不错的分数
77913,632,杨家强,2018-05-08 13:27:28,0,2,2,给分差死，呕吐
80818,632,杨家强,2018-07-01 11:11:26,5,7,2,抄PPT抄的手疼脑袋痛，上课还没意思。不知道算啥良心课，能跟供配电相比吗？
82228,632,杨家强,2018-07-17 04:22:48,0,3,3,讲课稀烂，抄ppt类似，还会考你不可能会的东西，给分差死。望周知！！！别选了！！
87675,632,杨家强,2018-10-10 02:30:52,0,2,2,辣鸡老师
105054,632,杨家强,2019-04-10 11:46:31,26,32,6,老子把课件抄完，抄了一百来张A4纸，然后今天上课跟我们说考试改成可以带书，也可以带打印的课件。
137962,632,杨家强,2021-07-07 01:56:42,0,0,0,最后某节课会有点名，点名形式是在一张纸上签名。考试只能带手抄资料，建议开学时就在网上找到2812或者28335的资料，最好是分模块的那种，每周抄一个模块。老师人很好，很随和。实验的老师也很好。课程体验很不错。
141345,632,杨家强,2021-09-30 05:58:09,-2,1,3,大家都懂
192032,632,杨家强,2024-05-08 03:25:34,0,0,0,电气装备计算机控制，4个实验+1个大作业。点名是手写在一张纸上，一共点四五次。\n\n考试只能带手写资料，建议提早开始抄PPT，反正最后早晚都是要抄的。\n\n最后给分还算中规中矩。
192038,632,杨家强,2024-05-08 05:06:18,0,1,1,呵呵大作业写多写少、是自己写的还是gpt写的压根就不看，给分都差不多；上课就照着PPT干念；辣鸡
16271,678,潘再平,2016-01-17 15:34:54,3,4,1,不点名    认真听课做作业正常都可以轻松上4    都是考期末复习课讲过的内容
43107,678,潘再平,2017-01-15 16:54:25,0,0,0,别选电气控制技术 垃圾老师
102993,678,潘再平,2019-02-25 08:46:39,0,0,0,嘤嘤嘤
2798,704,张德华,2015-05-07 13:06:39,7,25,18,讲的很条理，但是绩点被怒杀
3675,704,张德华,2015-06-17 02:11:57,-2,5,7,挺好的
5777,704,张德华,2015-07-09 10:23:24,10,15,5,老师挺好哒！\n\n
32772,704,张德华,2016-07-13 01:03:26,-2,5,7,绩点怒杀\n\n\n\n
33132,704,张德华,2016-09-13 11:23:26,8,11,3,老师讲课好细致啊  做实验有什么不会的也会耐心讲解，给分也超级好
34846,704,张德华,2016-10-25 03:37:00,2,6,4,讲课太无聊，完全考自学
38910,704,张德华,2016-12-31 06:42:43,-1,6,7,就说一件事，冬学期第七周还布置了研讨课作业，每个小组要十页报告。不上复习课就算了，课都上不完了还要搞研讨课还这么恶心的研讨课。真真不打算给我们时间复习。
45339,704,张德华,2017-12-22 02:35:29,-8,5,13,给分太惊喜了，谢谢老师!老师讲得也很认真哦!
45422,704,张德华,2017-03-01 02:44:56,0,2,2,感觉挺实在的！！\n\n
47237,704,张德华,2017-01-24 22:08:56,-5,3,8,多大点事，至于嘛
48997,704,张德华,2017-03-21 06:30:50,5,11,6,实验课公邮的课件和上课的不一样，连电路图都没有，实验报告要求也不说交了也没反馈，瞎做实验？？
49074,704,张德华,2017-03-23 06:54:23,6,13,7,上课自顾自high，实验课讲的贼快，EDA实验根本跟不上
49078,704,张德华,2017-03-23 10:08:12,3,6,3,实验课上的什么玩意儿？自顾自讲 完全不管学生  课件上还不全，怎么搞？
50094,704,张德华,2017-04-29 13:27:48,21,23,2,我觉得老师很好啊，讲的很清楚
50302,704,张德华,2017-05-02 08:36:39,2,2,0,quiz猝不及防
54607,704,张德华,2017-06-30 01:47:53,3,3,0,考前先给个满分
57427,704,张德华,2017-07-07 15:25:34,1,2,1,感谢老师给了我大学以来第一个满绩
63244,704,张德华,2017-11-29 12:05:07,6,7,1,老师太负责啦 上她的实验课  课后问了很多电子设计的问题 都给耐心解答 只要认真听 实验课讲的也很好！
70230,704,张德华,2018-01-26 09:12:58,8,10,2,跪谢老师！课讲的非常详细认真，有点快但是只要认真听就能听懂，考前还给总结。有三次还是四次课堂小测验集中在冬学期，还有一次研讨课也作为平时成绩，要认真对待。我器件部分搞不懂芯片也学的乱糟糟，考试七零八落本想不挂就好，没想到给了4.5，感动哭了。老师真的人很好，下课后经常给同学讲题什么的。
74589,704,张德华,2018-03-04 08:27:13,3,3,0,老师超级好的，讲的也很仔细，认真听课的话收货很多
75679,704,张德华,2018-03-15 05:27:45,0,1,1,棒棒棒！
76167,704,张德华,2018-03-28 06:41:57,1,4,3,实验课体验真的极差\n\n很难受
76502,704,张德华,2018-05-30 11:54:30,1,2,1,作业是怎么布置的?
80978,704,张德华,2018-07-03 07:15:54,5,5,0,老师很耐心很细致。对于学生问问题也是不遗余力地解答，体验很好。虽然不知道最后给分怎么样，但是讲课还是很好的。
82478,704,张德华,2018-07-08 09:53:50,5,5,0,老师讲的真的好，模电展示也是水水过，最后绩点还是要看自己，讲绩杀的是自己没学好吧
82479,704,张德华,2018-07-08 10:08:33,5,7,2,dehuazhang是我见过理论课讲得最好的老师，没有之一。
82514,704,张德华,2018-07-08 11:28:56,5,6,1,感谢德华。老师真的蛮不错的呀。。。模电实验总体任务比较轻，平时选做的实验任务可以不做(反正我从来没做过)，实验报告好好写＋期末操作题做出来，基本就稳了。。\n\n虽然实验课优秀良的评分标准还是有点坑吧。。。。
82515,704,张德华,2018-07-08 11:30:40,3,4,1,讲的很清楚，ppt很清晰。没有口音，给分很好！
82571,704,张德华,2018-12-12 01:49:53,5,7,2,不知道之前那些差评哪来的，幸好没有退课。老师的理论课讲的很有条理，人也萌萌哒，下课回答问题耐心从不会因为学生问了什么弱智问题不耐烦，展示也不像某些老师一样无厘头乱怼，不会因为展示没做好当众难堪，而是大家一起平等探讨。期末课程群里老师答疑从不缺席(另外老师的头像超萌的)。我觉得这样的老师值得给10分。
82668,704,张德华,2018-07-09 02:36:42,0,2,2,老师真的超级好啊，自己真的是太不努力了，对不起老师一学期以来的工作。
85347,704,张德华,2018-07-17 07:03:51,3,3,0,很棒哦！
85621,704,张德华,2018-07-22 02:56:45,18,18,0,好老师不多说 热心教学 不丢传统 敢于创新\n\n为数不多的能给电院教学增添活力的好老师\n\n希望一片死水中的希望不会被熄灭\n\n
91527,704,张德华,2018-12-12 14:42:20,0,0,0,挺不错
94797,704,张德华,2019-01-18 07:26:47,5,6,1,老师真的非常棒，是我进入大学以来最好的老师无疑。听课直接带着脑袋去就行，讲课非常认真细致有条理。而且老师身上有独特的魅力，有时候会有一点幽默风趣，真的很赞，超级nice，想选下学期老师的模电课结果冲突了，真的好老师
94954,704,张德华,2019-01-18 13:41:59,4,4,0,为什么给张老师低分啊！张老师超级可爱啊 讲的很清晰 除了那个展示我忍不住吐槽一下 但是那个展示也是为了教学改革 而且确实我们的题目也让我们加深了对课本儿的理解 老师超好的！！是我自己太菜！！一百昏！！
98222,704,张德华,2019-01-23 08:07:54,5,5,0,张老师也太好了吧！！强烈推荐！讲课好，气质佳，不会的提问还会认真跟你讲解。上的电路与电子技术实验1，老师实在太好说话了(实验报告没做完下次补上就没事，还可以最后补交)，讲课也非常清楚（实验报告按照ppt的要求做完分数不会低的，选做可以不做，我最低也是5-）。最后几次数电实验电路有些复杂，有时候出了故障让老师帮忙看，老师也会认真帮忙排查！！最后的考试有点难，虽然实验部分做出来了但是理论题不怎么会做，空了好几道，没想到最后还有4.5哈哈哈，太开心了，爱老师！！
109790,704,张德华,2019-06-19 08:27:13,1,2,1,模电实验考试也太难了  自闭了 自信为0
111475,704,张德华,2019-07-01 17:06:09,2,2,0,张老师讲课很细也比较慢，问问题会特别耐心，偶尔还会再课程群里和大家开玩笑，很幸运能上张老师的课！
111481,704,张德华,2019-07-01 19:08:58,3,4,1,模电和模电实验都是她，讲的很好，人也很好没有口音，就是模电最后一次测试太难了，也是自己菜，操作题一道都没做出来，希望老师能捞我一把吧
113296,704,张德华,2019-07-06 04:35:56,3,3,0,张老师特别好！理论课和实验课都讲的很细致，可以学到很多东西。平时QQ上答疑也很快，还会发颜文字超可爱o(≧v≦)o最后给分也很好，总之就是很好！
113752,704,张德华,2019-07-07 07:58:55,2,2,0,考完试模电实验才知道查老师里面的动手没搞出来还有4.5是什么意思
114838,704,张德华,2019-07-12 02:18:09,2,2,0,数电，很好，人超级nice，我觉得是大学以来最舒服的老师之一。
121858,704,张德华,2020-01-22 15:55:03,0,0,0,讲得不错
123796,704,张德华,2020-06-14 09:13:51,4,4,0,讲课讲得很好，人也很有耐心
138297,704,张德华,2021-07-14 01:16:19,4,5,1,讲课有点重点不突出，但是人是挺好的（建议B站郑益慧老师，这是真爹），不过希望张老师以后顺顺利利呀！
142375,704,张德华,2021-11-10 16:02:30,2,3,1,好老师，不必多言，10分送上！！
147363,704,张德华,2022-01-09 17:31:11,2,3,1,张老师是我的电学实验课启蒙老师，只能说从未被超越
152646,704,张德华,2022-04-17 07:58:43,0,1,1,授课有条理且耐心，不过张老师的节奏确实是略快一些的
157823,704,张德华,2022-06-25 03:35:00,-9,2,11,事多分烂，老是拖堂
158344,704,张德华,2022-06-28 13:17:37,1,5,4,感觉模电实验绩点不明确？虽然每项实验报告及期末考分数都给出，但我期末考试成绩和室友一样，平时实验报告分比他高，最后却是我3.5他4.5，这直接劝退好吧。。
171035,704,张德华,2023-03-15 01:06:32,2,3,1,几年前电工电子实习做数字频率计，老师讲的太好了，听完就知道怎么做的，给老师补个10分
171972,704,张德华,2023-04-14 10:48:41,3,3,0,电路实验1，事情比隔壁沈连丰多很多，但是真的学到很多，每次实验会从原理理论讲起，讲很久再开始做
176387,704,张德华,2023-06-28 16:06:13,11,11,0,这是我妈这是我妈\n\n妈妈妈妈妈妈妈妈妈妈妈妈
176395,704,张德华,2023-06-28 16:30:44,6,7,1,模电和模电实验都是德华姐，只能说老师人真的很好，模电理论课我认为还是讲的蛮清楚的，老师上课也很有活力。平时分感觉基本给满了，只有最后几周会做课堂练习，一共三次，第一次写完后老师直接讲解完再交，第二次小测在学在浙大，很简单两道题，第三次本来说要做做填空题，后来也没让我们交，直接课堂讲解。模电实验这门课本身设置决定了事情真的很多，但是老师真的是手把手帮你调示波器，从来不会不耐烦。另外老师学期末换了个卡通头像，可爱捏
176413,704,张德华,2023-06-28 19:00:02,4,5,1,数电，作业和实验报告给分都很好，对报告要求也不高，上课讲的也很细致，学习就该轻松而充实，好老师！
176447,704,张德华,2023-06-29 02:41:23,6,7,1,讲课好好好，给分好好好，好有气质的耐心美女妈妈老师5555
176761,704,张德华,2023-06-30 04:37:47,5,5,0,模电和模电实验都是张老师，讲课好，给分也好
176766,704,张德华,2023-06-30 04:56:13,10,11,1,模电和模电实验都是德华老师。平心而论，老师给分十分不错，感谢她没有绩杀我的实验。理论课讲解也不错，事情不是很多。老师的模电实验课，说实话，事情比较多，以至于每次写报告的时候都会痛骂老师破事真多，但是给分真的很不错，实验课几乎都是上满四节课的，最后一次实验考试，我记得两个操作题我一个都没调出来，考试的理论部分我也不太确定，下课后我就去问了老师我会不会挂科，当时我都做好1.5的准备了，没想到老师给的分出乎我意料，她说你每次都来上课报告都交我干嘛挂你科。是个好老师，推荐。
176767,704,张德华,2023-06-30 04:59:00,5,5,0,模电和模电实验都是德华老师。平心而论，老师给分十分不错，感谢她没有绩杀我的实验。理论课讲解也不错，事情不是很多。老师的模电实验课，说实话，事情比较多，以至于每次写报告的时候都会痛骂老师破事真多，但是给分真的很不错，实验课几乎都是上满四节课的，最后一次实验考试，我记得两个操作题我一个都没调出来，考试的理论部分我也不太确定，下课后我就去问了老师我会不会挂科，当时我都做好1.5的准备了，没想到老师给的分出乎我意料，她说你每次都来上课报告都交我干嘛挂你科。是个好老师，推荐。
184450,704,张德华,2023-12-20 02:28:01,1,1,0,老师很好，就是听她讲课莫名想点（shui）头（jiao）😢
184579,704,张德华,2023-12-22 01:26:52,2,2,0,上了老师的实验课，老师讲的还是很好的，有耐心，也不会因为你做错了或者上课听漏了说你什么。但是说实话老师上EDA的时候节奏把控可能不是很好，一次操作的太多了，往往一个地方没跟上就意味着接下去的十多分钟全面崩盘。软件崩溃闪退的时候真的无助，然后跟不上的大家伙都搁那面面相觑，你问我我问你，乐。
187128,704,张德华,2024-01-14 15:07:10,-6,3,9,她一直是我眼中的女神，直到成绩出来了才看出真面目…\n\n\n\n群里一堆谢谢老师我觉得只是客套，唉。给分没那么好啊
195923,704,张德华,2024-07-01 01:23:08,0,0,0,实验课的EDA权当了解吧
196009,704,张德华,2024-07-01 06:10:42,0,0,0,学渣友好型老师，讲课讲的超级清晰
207456,704,张德华,2024-12-22 03:21:34,1,1,0,林平，沈红，周箭，德华，电院F4编的模电教材书实在是太烂了，没有重点，内容和上课内容相比缺失，没有加粗符号，逻辑不清晰，导致模电部分还要回去翻电路部分的书，而且题目还经常出现下标印刷错误。比如说电流源书上就讲了三种但是上课有好多种。
213289,704,张德华,2025-01-17 00:54:10,0,3,3,好好学，好好听课，好好复习，个人感觉这课跟线代那些比起来真不难，老师讲课很清晰，但是不能走神，一走神就容易跟不上，最后也是拿满了
213290,704,张德华,2025-01-17 00:57:51,3,3,0,zdh是我永远的妈妈！巨捞啊！
213305,704,张德华,2025-01-17 01:43:22,2,2,0,巨好的老师 上课很清晰 给分很好！
213307,704,张德华,2025-01-17 01:47:00,3,3,0,真神（至少电路I是这样的），不要被均绩骗了。期末考成一坨给我捞到90，我宣布她是我的亲妈。
213315,704,张德华,2025-01-17 02:25:37,3,3,0,（电路与电子技术Ⅰ）德华姐实在是太好了我要哭了。一学期0点名，期末海底捞。平时的随堂小测验她都不计分只算作一次作业，最后平时分捞满。期中考期末考前还会有复习课，考点讲的也很详细，方便我们复习。而且我真的没想到她给分这么好啊啊！！！太牛逼了，这是我今年唯一一门有人在群里发谢谢老师的课
213326,704,张德华,2025-01-17 03:22:32,2,2,0,好老师，讲课巨清晰，给分很好，神中神
213328,704,张德华,2025-01-17 03:25:56,2,2,0,超级捞超级无敌好老师！！！
213369,704,张德华,2025-01-17 05:30:21,1,1,0,你就是我的亲妈
213451,704,张德华,2025-01-17 12:10:55,0,0,0,真的很不错的老师 平时上课思路比较清楚 虽然个人感觉有一点慢 主要是不点名而且平时分拉满还要什么自行车啊 真的给分超级超级好 强烈推荐！亲妈啊！
213587,704,张德华,2025-01-18 12:03:45,3,3,0,电路与电子技术（I）已出分几天，前来给老师打10分！\n\n①上课：老师讲课质量很高，但是语速可能偏慢。我个人习惯课后用智云的1.5倍速回放听一遍，基本上一遍都能听懂、而且感觉讲的特别好！不过这个学习方式就因人而异了。\n\n\n\n②给分：今年秋冬的电路I的一众给分里，zdh老师给分应该是最好的！！！\n\nⅠ.关于平时成绩：（1）这学期老师没点过名，课堂小测也是学在浙大线上提交，课堂自由度比较高（ ；（2）平时作业基本是认真完成并交了，就能满分；（3）几次小测据说只要参加了，就给满分（现在想想，她自己都把这些小测称作课堂小练习，可能也是有重在练习、轻结果的意思）；（4）MOOC按部就班做就好了，这个没啥好说的。\n\n  总的来说，平时分应该基本都给大家捞满了！\n\nⅡ.关于考试：个人感觉，老师应该是根据期末考的成绩进行了力度极大的打捞，简直是化腐朽为神奇级别的海底捞！比如，我一位朋友期中发挥的不好，期末努力考好了，结果直接给满了！又比如，我期中也没有考得很好，期末也错了两三道题，最后直接被捞高了一个档，不知道老师在平时30%+期中30%+期末40%的分数构成体系下是怎么做到如此之捞的，唯有喊一声“妈”了(QAQ)\n\n\n\n③关于电路与电子技术（I）：电原部分题目难度相对较大，但由于和高中物理等电学部分接轨，自学难度相对较低；数电部分题目难度不大，但知识点新、琐碎、量庞大，自学难度较高。我感觉最好还是每节课都能做到认真听（线下课堂or线上智云回放），这门课比较吃平时的积累，要在短时间内速成是很难的。\n\n\n\n总而言之，数电能选上张老师的课是我的幸运（不论从学习角度还是给分角度），模电没能再选上，有些遗憾。张老师是当之无愧的好老师！
213631,704,张德华,2025-01-18 15:40:28,2,2,0,电路1:神仙老师，给分好，上课讲的也好（但是我比较菜，说实话很多时候跟不上），如果没有听懂，课后答疑会非常热心帮助我！无脑选就好了！记得要好好听课，电路部分多做点题，争取考到八十多，数电多总结多提问，还是很有机会拿满的！
213639,704,张德华,2025-01-18 15:57:03,4,4,0,我愿意给张妈所有的尊敬，认真负责，踏实教学，我作为一个基础很差，在大多数人觉得老师讲的慢的情况下，我还有点跟不上的同学，如果没有老师的帮助和最后自己的努力，我可能会得到一个惨不忍睹的成绩（电路1是一门6学分的大课啊），但是在期中考不够理想（八十多分）的情况下，得到了很满意的成绩，德华姐太捞了，只要你认真完成平时的作业，认真听课，那就绝对不会有大问题，基本都是给满的，而且老师很好商量。电路考试相对较难，考前多刷题，每次上完课总结一下模型，还是可以考到八十多分的，数电则内容繁杂，部分模电基础知识也很难（但本学期数电期末考里掺杂的部分并不难，我当时听了课完全没懂是很绝望的，最后期末考并没有遇到什么阻碍），我认为上课好好听很重要，平时课本上的习题要好好做，希望每一个努力的同学都可以取得自己满意的成绩！
214144,704,张德华,2025-01-25 09:52:07,0,0,0,讲课好，不点名，平时分很松，给分好。伟大无需多言
216451,704,张德华,2025-03-16 14:59:18,0,0,0,老师给分很好也不点名，就是讲课我逐渐就听不懂了
221836,704,张德华,2025-06-26 15:40:58,0,0,0,给分神中神
221853,704,张德华,2025-06-27 02:11:35,0,0,0,伟大无需多言
221918,704,张德华,2025-06-27 11:56:47,0,0,0,妈妈！！
49041,744,王正仕,2017-03-22 07:25:58,16,16,0,为数不多的用心上好课的专业课老师
59344,744,王正仕,2017-09-21 03:10:16,-9,2,11,一般般，比较会吹比
79953,744,王正仕,2018-06-16 08:15:11,5,5,0,为了学生上课不困，很尽责地备课，达到生动有趣的效果~非常有使命感责任感的老师
86679,744,王正仕,2018-09-18 02:39:21,0,1,1,还好吧
87299,744,王正仕,2018-09-27 00:20:22,0,2,2,还好吧
90223,744,王正仕,2018-11-22 14:14:27,11,11,0,好老师，电力电子三个老师。王最好
111183,744,王正仕,2019-06-30 11:13:08,-4,2,6,总是在他的课上睡觉:(
112926,744,王正仕,2019-07-05 12:27:52,6,6,0,大爱王正仕，讲课用心，作业少，给分也好！
138416,744,王正仕,2021-07-09 04:29:41,2,4,2,电力电子最用心的老师（没有之一），出分前会把成绩先贴到钉钉群公示。只要不是班里少数几个厌学分子，85分一点都不难，90+也大有可能，学弟学妹们，冲就完事了！
138576,744,王正仕,2021-07-10 02:20:21,0,0,0,给分贼好
154784,744,王正仕,2022-06-05 09:31:43,0,0,0,好就完事
183609,744,王正仕,2023-11-28 01:37:00,3,3,0,确实是电力电子三个老师里最好的了，所以即使被老师的第一道题薄纱了但还是给十分
202266,744,王正仕,2024-11-11 06:09:08,1,1,0,电力电子最好的老师
3374,746,马皓,2015-06-08 01:41:11,56,82,26,不管他学术做的如何，现在他就是一个彻头彻尾的官僚。
11882,746,马皓,2015-12-20 09:39:28,13,15,2,妈的醉了
18104,746,马皓,2016-01-21 07:45:34,8,14,6,给分太差。这门课可控性为0，感觉给分很随意。
22894,746,马皓,2016-03-14 08:50:32,3,5,2,这门课。。。。。
23236,746,马皓,2016-03-22 11:08:28,10,11,1,自己讲的无聊也就算了，上课会记水手机的人的名字……
23284,746,马皓,2016-06-20 08:56:10,0,6,6,本站最低分保持者
23384,746,马皓,2016-03-28 07:02:46,3,6,3,不认识
26307,746,马皓,2016-06-16 17:07:34,-5,7,12,温文尔雅，很耐心，挺好的
32441,746,马皓,2016-07-07 00:28:41,0,1,1,无语，
33393,746,马皓,2016-09-19 05:56:47,2,5,3,很不错
33394,746,马皓,2016-09-19 05:13:50,2,10,8,老师给分超好
33739,746,马皓,2016-09-21 08:46:27,9,14,5,别选现代电源！！！
39768,746,马皓,2016-12-27 11:45:32,0,1,1,真的太催眠
47883,746,马皓,2017-02-27 02:41:04,21,23,2,音色很像唐老鸭
51824,746,马皓,2017-06-11 15:58:44,0,3,3,老师很儒雅，也很认真
53651,746,马皓,2017-06-27 08:47:42,-22,10,32,有的同学不要看着人家是副院长就说人家官僚作风！很不负责任的评价！反正马老师上我们课的时候超级负责.
63850,746,马皓,2019-03-09 11:50:39,4,9,5,电力电子，我挺石健将老师！
66227,746,马皓,2018-01-13 14:04:02,-2,3,5,大水课
71533,746,马皓,2018-01-28 15:50:34,0,2,2,垃圾，给分极差
75060,746,马皓,2018-03-07 07:15:05,16,19,3,现代电源。。是真的无聊
75743,746,马皓,2018-03-16 03:48:15,0,5,5,拖堂辣鸡
78748,746,马皓,2018-05-15 03:30:59,-3,5,8,电力电子辣鸡课
79852,746,马皓,2018-06-14 10:20:26,3,6,3,上课及其无聊，给分极差。
86246,746,马皓,2018-09-11 09:15:33,6,11,5,虽然不是很完美，但绝不是3分多的水平
86971,746,马皓,2018-09-20 00:16:57,-2,5,7,我醉了
86972,746,马皓,2018-09-20 00:17:47,-4,10,14,幼儿园老师才上课提问。。。。。
87302,746,马皓,2018-11-15 10:57:40,13,21,8,马老师讲的挺好的呀，感觉很认真踏实。
93932,746,马皓,2019-01-14 10:54:54,2,3,1,问题不在于这个课，我觉得课还好，\n\n主要是上课看广告你知道吗？\n\n我真想知道这个公司给了老师多少钱
93949,746,马皓,2019-01-14 11:45:44,6,6,0,现代电源就是划水的课。。。
102616,746,马皓,2019-02-13 16:03:06,0,1,1,3.9
102623,746,马皓,2019-02-14 06:39:52,1,1,0,还好吧 就是作业论文多
102645,746,马皓,2019-02-17 08:08:27,0,0,0,上课无聊，出分慢，而且给分超级差，没缺过课没晚交过作业结果居然被一门通识拉低绩点！！
116867,746,马皓,2019-09-17 02:02:45,11,11,0,什么垃圾玩意，上课提问现场打分，有什么意思?
118080,746,马皓,2019-10-20 16:25:07,2,2,0,无力吐槽。。。。。
118251,746,马皓,2019-10-24 00:23:59,10,11,1,本来我以为马皓讲的很差了，没想到石健将直接击碎我的底线
126066,746,马皓,2020-09-17 04:17:25,10,11,1,上课迟到，下课拖堂，支持鹅颈，爪巴！
127905,746,马皓,2020-11-30 04:30:45,0,1,1,绩杀。
149200,746,马皓,2022-01-15 09:36:18,0,0,0,垃圾。
149216,746,马皓,2022-01-14 23:36:11,3,4,1,纯纯的一个大傻逼。课堂念课件，无聊死了；作业很多，明明认真写了，最后85，卡绩3.9。给分不好，一点都不捞，给爷爬！
151723,746,马皓,2022-03-13 20:19:10,5,5,0,没有感受到院长任何的作用
160163,746,马皓,2022-09-14 04:18:47,1,1,0,安倍老师（doge
165039,746,马皓,2022-12-28 14:57:49,0,0,0,呃现代电源我就没怎么去听过吧
166599,746,马皓,2023-01-13 03:23:59,7,7,0,刚出分，被绩杀了，心态崩了。\n\n我以我3.3的绩点给大家排雷。。。\n\n没缺课，两次作业和报告都认真完成的\n\n不理解真的不理解
166614,746,马皓,2023-01-13 04:07:44,0,0,0,现代电源 怎么给分的？？？
166663,746,马皓,2023-01-13 07:42:36,1,1,0,绩杀，3.3属实没有想到
181084,746,马皓,2023-10-08 01:04:41,0,1,1,。。。
183608,746,马皓,2023-11-28 01:35:38,6,6,0,老师人挺好的，讲课非常清晰，dcdc部分感觉挺基础的。感觉老师也很认真，有一次我七点十几分到教室的时候老师已经在了。不过点名回答问题然后打分评级真的压力满满啊
188310,746,马皓,2024-01-18 15:17:42,0,0,0,课确实很无聊
202265,746,马皓,2024-11-11 06:08:51,3,3,0,其实没有楼上说的那么差，比sjj好多了，上他的课认真听没问题的
204503,746,马皓,2024-11-26 09:17:16,3,3,0,马老师人很好
204923,746,马皓,2024-11-28 15:26:02,5,5,0,老马讲课很好的，而且人也很好，很儒雅，这么多次组会从来没有看到他发过火
209161,746,马皓,2025-01-05 01:22:43,0,1,1,现代电源。3.6 。但认真听课认真写作业了
72,788,张红岩,2015-03-14 15:39:05,13,15,2,张老师讲的非常好，非常棒
1386,788,张红岩,2015-03-22 01:28:00,30,31,1,讲的很好  人也nice
1780,788,张红岩,2015-03-24 12:00:09,7,8,1,老师讲的很细
2625,788,张红岩,2015-05-05 00:59:07,8,9,1,老师讲的很细很好
2684,788,张红岩,2015-05-05 09:11:55,11,12,1,讲的很仔细，声音很温柔，听她讲课很享受
8611,788,张红岩,2015-09-23 06:04:14,9,10,1,老师讲得真好，学起来挺轻松
9386,788,张红岩,2015-10-25 14:04:18,5,6,1,她让我爱上了电学
9537,788,张红岩,2015-10-29 08:47:59,17,21,4,身材好好啊
12405,788,张红岩,2015-12-23 07:57:17,2,2,0,老师很有条理很细人也很好！
16610,788,张红岩,2016-01-18 14:00:07,6,7,1,讲的很细，必考重要内容还会让我们打电话让不来上课的同学来听...
19489,788,张红岩,2016-01-24 11:06:04,0,2,2,好。9分
20428,788,张红岩,2016-01-27 14:16:28,1,2,1,温和沉稳。听着不累。
20526,788,张红岩,2016-01-28 06:00:40,1,3,2,人很nice\n\n讲课很nice\n\n给分也很nice
20782,788,张红岩,2016-01-31 11:39:47,3,4,1,讲课细致，人特别棒~
22501,788,张红岩,2016-03-07 03:53:15,12,12,0,讲得特别好 我这种学渣也跟得上
24451,788,张红岩,2016-04-30 14:16:15,0,1,1,讲的超级细
34228,788,张红岩,2016-09-29 01:42:14,1,2,1,张老师人美身材好气质好讲课清楚……真女神
35853,788,张红岩,2016-11-10 08:31:03,3,3,0,人超好，满分~\n\n
35917,788,张红岩,2016-11-10 08:52:38,7,7,0,简直细致耐心到心动！表白张老师！！超级棒！我实验报告平均分93，应该算给分也不错吧
45017,788,张红岩,2017-01-18 23:54:20,3,3,0,讲的很细致，耐心，负责，还会劝那些想申请免听的学长让同学帮忙带作业到紫金港混点平时分更好过~
46776,788,张红岩,2017-01-22 10:01:14,1,1,0,上她的实验课，讲的很认真，很细
46958,788,张红岩,2017-01-23 05:37:31,1,1,0,老师超好！赞赞赞！
46966,788,张红岩,2017-01-23 05:58:04,1,1,0,老师上课讲的超细，每节课都会复习上节课学习过的知识，这点特别好。重难点老师会讲好几遍，人也很温和，给分也超级nice，值得推荐
50823,788,张红岩,2017-05-06 02:17:50,6,6,0,绝对女神啊啊啊！老师简直不要太好，身材好人又温柔，讲课讲的超级清楚。会和你聊天，会温柔的拍你的头，考完试发现最后一题错了觉得好对不起老师...大爱红岩女神！
55571,788,张红岩,2017-07-02 02:54:54,3,3,0,老师讲课条理很清楚，很有耐心，人也很好
63779,788,张红岩,2017-12-14 13:43:33,1,1,0,七年前上过红岩姐姐的课 仍然记忆犹新 非常认真细致
63917,788,张红岩,2017-12-19 07:00:49,6,6,0,对上了吧？那我们要开始跑路了呀
64039,788,张红岩,2018-05-31 04:54:32,0,0,0,特别好
69671,788,张红岩,2018-01-25 07:42:55,0,0,0,你觉不会后悔
72018,788,张红岩,2018-01-29 08:13:12,0,0,0,超温柔细心的老师
73677,788,张红岩,2018-02-02 14:21:42,3,3,0,红岩老师是真的女神，非常漂亮优雅，课上得也非常细致认真，尤其是她的ppt，不管是数电部分还是之前的电路原理，都很详细，电路与电子技术1这门大课学习负担比较重，但考试总体还是较为基础，但题量大，考前不用太多刷题，主要是要看看平时习题以及温习平时的ppt中的讲课重点。
73683,788,张红岩,2018-02-02 15:11:20,0,0,0,超贴心超可爱的老师!评分有一百分就给一百分惹，小测考的很烂，但老师平时分绝对给我满了~老师上课很细致很细致，智商低下如我也能很轻松的听懂~
73725,788,张红岩,2018-02-03 04:23:13,0,0,0,很舒服
73745,788,张红岩,2018-02-03 05:02:58,0,0,0,很耐心细致\n\n认真听绝对能学会
74435,788,张红岩,2018-02-23 15:51:42,0,0,0,张老师非常负责任，有丰富的教学经验，对学生很好
75285,788,张红岩,2018-03-08 14:21:45,1,1,0,超好的老师，耐心讲的很细，条理清晰
76679,788,张红岩,2018-04-18 05:48:58,3,3,0,是真正的好老师，深谙人事，如沐春风
78114,788,张红岩,2018-05-09 10:50:16,1,1,0,合作地太过愉快了
88752,788,张红岩,2019-01-26 01:35:13,10,10,0,对上了吧？！
90210,788,张红岩,2018-11-22 12:58:31,3,3,0,听老师的课就觉得特别充实，每节课都收获颇丰~想不听都难啊
91032,788,张红岩,2018-11-29 05:56:46,4,4,0,我只求那位王从健大物课也贼烦的哥闭上你的嘴
92025,788,张红岩,2018-12-25 12:39:57,0,0,0,每次都坐第一排！
92726,788,张红岩,2019-01-04 04:05:37,3,3,0,老师人真的很好，讲得很细，就算是没怎么听课的我也能感觉到，真的是个很好的老师，这个学期不懂事，对不起这么好的老师
94095,788,张红岩,2019-01-15 07:33:29,1,1,0,老师真的很棒！
100269,788,张红岩,2019-01-26 01:38:17,0,0,0,老师太好了啊啊啊啊啊啊啊啊，给分也超好啊啊啊啊啊啊啊啊！！！
100275,788,张红岩,2019-01-26 01:52:06,4,4,0,对上了！老师人超好！给分也超好！！
100279,788,张红岩,2019-01-26 02:00:05,0,0,0,老师超耐心 超可爱 经常自己讲着知识点自己就笑出来 即使其中临近挂科 也被老师捞回3 十分开心
100345,788,张红岩,2019-01-26 03:19:53,5,5,0,在浙大遇到的最好的老师\n\n讲课好 人好 期末还救死扶伤
101758,788,张红岩,2019-01-29 04:09:32,6,6,0,超级喜欢红岩姐姐的啊啊啊啊啊！\n\n讲的好讲的清楚而且对学生好啊！\n\n本来选了这个6分的课还心里没底呢\n\n不过老师真的！太！棒！啦！
101936,788,张红岩,2019-01-30 00:01:01,4,4,0,老师真的好棒好可爱 \n\n讲课很清楚\n\n超级负责\n\n
103680,788,张红岩,2019-03-04 06:44:32,0,1,1,好好好
105433,788,张红岩,2019-04-13 03:00:58,0,1,1,上大学以来最好的老师没有之一，是因为上了老师的课才没有转专业
105731,788,张红岩,2019-04-19 04:28:13,0,1,1,祝大家生活幸福也太棒了吧
107461,788,张红岩,2019-05-05 10:03:31,1,1,0,上课直入主题，实验耐心清楚，炒鸡nice
107465,788,张红岩,2019-05-05 10:33:52,5,5,0,等了一个星期，电网络出分了终于…相信我，电网络这门课来说，张老师就是所有老师里面最好的那个。没有mooc，没有杂七杂八的事情，给分很好，人非常温柔体贴，对学生很负责任。
107492,788,张红岩,2019-05-06 23:36:26,-11,0,11,怎么会有这么多菜鸡和我一样满绩啊
107639,788,张红岩,2019-05-08 01:46:02,0,0,0,史诗级好老师啊 自己上课会被自己逗笑 讲课巨仔细 给分十分decent把期中临近挂科的我拉到4 就是可能上课脉络不是很清晰（虽然所有老师都这样）
109150,788,张红岩,2019-06-10 08:29:17,0,0,0,这学期见识了别的课的垃圾老师，忍不住过来给女神刷十分，呜呜呜老师讲课也太好了，还人美心善，要是所有老师都像女神这样，我又怎么需要在考试周女娲补天呜呜呜
120994,788,张红岩,2020-01-19 08:15:16,0,0,0,老师讲的很详细 认真又仔细 真的女神了
121099,788,张红岩,2020-01-19 14:47:42,0,0,0,老师真的是女神老师那种
121794,788,张红岩,2020-01-22 02:38:31,0,0,0,要是我早生30年...\n\n老师真女神啊，性格真的好，人很nice，虽然被卡🐔了但还是非常非常感谢老师！
125933,788,张红岩,2020-09-16 01:45:38,0,0,0,吹爆女神张红岩！给分真的好，期末炸裂也把我捞起来了
125955,788,张红岩,2020-09-16 03:49:43,0,0,0,电网络有10分的慕课忘做了，最后居然88！感谢老师了
8285,861,吴新科,2015-09-18 03:25:45,2,3,1,出分快
8286,861,吴新科,2015-09-18 03:26:05,1,3,2,给分好！\n\n
11885,861,吴新科,2015-12-20 09:54:05,0,1,1,人不错！\n\n
70044,861,吴新科,2018-01-26 04:53:53,11,14,3,《现代电气传动及其应用》期末是报告加展示，展示只会diss和怼别人，动不动就是这个完全没有意义、展示得很失败，也不见他提出什么有建设性的建议。\n\n评分只看符不符合自己的口味，完全无视别人花了多少时间去做，垃圾老师！
107599,861,吴新科,2019-05-07 11:54:30,1,1,0,有点严格
151152,861,吴新科,2022-02-23 12:32:10,9,10,1,吴老师给本科生上课还是很认真的，研究生课能把自己讲困
25205,874,阮秉涛,2016-05-08 03:38:45,1,6,5,老师上课很认真，讲的很好
32752,874,阮秉涛,2016-07-12 08:33:07,1,3,2,有原则，不解释。
33987,874,阮秉涛,2016-09-24 12:22:33,3,4,1,完全念书\n\n
77037,874,阮秉涛,2018-04-29 03:10:47,0,0,0,老师很细心，但有时候也过于细心
78273,874,阮秉涛,2018-05-10 10:09:42,0,0,0,搞竞赛的
80264,874,阮秉涛,2018-06-23 14:03:08,6,8,2,老师讲课比较注意细节，认真负责
81097,874,阮秉涛,2018-07-04 02:23:57,8,8,0,这个老师的上课风格不是很适合我...老师本人水平是很高的 然而每次课念念书 课堂小测摸不着头脑
105685,874,阮秉涛,2019-07-04 07:48:47,6,6,0,小测这么扣分谁顶得住。。。
106582,874,阮秉涛,2019-04-28 07:51:30,1,4,3,电子系统设计居然还要课外时间，而且赶去紫金港做实验，大三大四玉泉的小伙伴一定慎选。
108111,874,阮秉涛,2019-05-15 06:16:04,0,0,0,想问一下实验考试怎么准备？
109446,874,阮秉涛,2019-06-14 12:41:19,3,4,1,老师做事有点古板了...看风格吧 是不是喜欢
109879,874,阮秉涛,2019-06-20 03:37:31,0,0,0,数电实验注意PPT的思考题，以及数字钟各个部分的原理
112012,874,阮秉涛,2019-07-03 07:24:00,2,2,0,讲的挺好 限制太多
135904,874,阮秉涛,2021-06-02 06:41:56,3,3,0,事情真多
136495,874,阮秉涛,2021-06-19 07:07:48,2,3,1,老师对待课程真的很认真，讲课也很有条理，有时候晚上六七点还会在办公室帮我们调试电路，课堂设计也比较合理，但有时候确实有些太古板了。
138597,874,阮秉涛,2021-07-10 02:48:21,8,9,1,19级的来答一波。首先老师的实验总内容结构逻辑性很强，总体脉络就是做一个数字钟，平时每个星期做一小块内容，最后把所有内容合在一起，加上硬件，做出一个完整的产品。平时实验要求是当天晚上24点进行验收成功，没有实验报告。最后的验收需要提交一个设计书。\n\n总体来讲老师的实验内容有点太老旧和古板了点，就和老师本人一样。可能也是一种严谨吧，不过有些不太能理解。比如最后验收的时候每个人的验收时间固定到分钟，每个人有五分钟，两次调试机会，如果两次没演示好就凉了。我同桌就是紧张加按键问题，两次都没调好。\n\n最后考试的内容是完全按照ppt上的内容来的，有一点点扩展也是在数电理论的范围之内的，平时只要是自己认真做，考前复习个一上午就基本没问题了。
144644,874,阮秉涛,2021-12-23 03:20:43,1,1,0,懂的都懂
154432,874,阮秉涛,2022-06-01 09:16:30,-4,3,7,什么牛马，教育体制内的腊鸡
2801,919,沈红,2015-05-07 16:44:14,38,61,23,上课很认真讲要点。后一节会温习前一节。有复习课。中间下课时候会注意等学生都回到教室再开始。作业虽然多了些但也不错。就是布置的时候拖时间…
6361,919,沈红,2015-07-13 08:14:16,0,3,3,不错
6863,919,沈红,2015-07-27 03:00:15,-23,6,29,讲不清楚东西
8896,919,沈红,2015-09-30 03:25:06,0,4,4,讲的很仔细很有耐心有时候走神了也跟得上节奏。
9303,919,沈红,2015-10-20 17:06:12,0,3,3,挺喜欢
10175,919,沈红,2015-11-17 06:12:53,0,3,3,不错哦
13790,919,沈红,2015-12-31 03:50:34,2,5,3,关心学生的好老师！
13835,919,沈红,2016-01-01 05:38:35,-2,8,10,给分不好
14025,919,沈红,2016-01-04 00:49:10,1,4,3,挺有耐心的
19288,919,沈红,2016-01-23 22:46:15,0,3,3,喜欢沈老师～讲课清晰节奏慢 还很照顾班里的妹子（感觉自己暴露了
20551,919,沈红,2016-01-28 09:59:19,7,11,4,课上挺好的，期末不调分，一分都不调
22378,919,沈红,2016-03-04 03:51:47,1,4,3,讲的很棒，但比起来给分略低
23126,919,沈红,2016-03-18 11:31:20,0,3,3,不错哦
25791,919,沈红,2016-06-08 11:10:33,0,3,3,讲的清楚，速度慢
26106,919,沈红,2016-06-15 23:28:02,0,4,4,讲的非常仔细\n\n
29785,919,沈红,2016-06-30 10:09:53,4,8,4,给分太差了
29801,919,沈红,2017-04-28 15:30:18,-38,6,44,58分，我真的佩服，还不如给我0分，58分，享受虐学生的快感吗
29873,919,沈红,2016-06-30 12:29:54,0,2,2,讲课没得说，良心老师
29891,919,沈红,2017-11-08 07:06:09,-58,5,63,室友说她给分好，所以学模电的时候就选了她的。结果沈红老师给分真的给力  随便学的模电居然就给满了。上课讲得也很细  而且每次课都会复习下上节课的内容  ，真是业界良心。
30030,919,沈红,2016-07-01 00:02:16,0,2,2,讲课清楚，仔细。
30131,919,沈红,2016-07-01 03:20:01,0,2,2,讲的挺仔细的。但是我依然经常不听…然后就听不懂了\n\n
30549,919,沈红,2016-07-02 02:26:19,9,12,3,讲得很不错，对不对啊！女神级老师，要点很清晰，模电主要还是靠自己花时间理解。
39592,919,沈红,2017-01-09 03:31:23,1,3,2,重点不太突出，PPT念得有点多，老师人很好很温柔\n\n
40631,919,沈红,2017-01-04 11:22:36,0,1,1,详细的
44433,919,沈红,2017-01-17 23:46:51,0,1,1,老师人真的超级好，感动哭了，实验课还是良好了只能怪自己，真的老师没话说，爱沈红！
44472,919,沈红,2017-01-18 00:54:39,-1,2,3,老师人很耐心很细心，讲课认真听的话肯定学到很多。但据说期末不调分，成绩没出来有点紧张。
45376,919,沈红,2017-01-19 13:21:21,1,3,2,老师真的很好，讲的比较清楚，复习课很好，作业比较多一些，但是讲评作业很认真
45970,919,沈红,2017-01-20 10:10:28,0,2,2,老师超好人的，挽救了我被大物和马原伤害的绩点
47107,919,沈红,2017-01-24 01:01:28,-2,2,4,沈红姐姐赞赞赞！关心学生，讲课仔细有条理
49108,919,沈红,2017-03-26 16:30:01,7,9,2,如果期中考得不好，那么恭喜你，等死吧！
50020,919,沈红,2017-04-28 15:20:19,0,1,1,挺好的老师，讲课好给分也不错！
50021,919,沈红,2017-04-28 15:22:54,3,4,1,好老师，很负责，给分实在，就是嗓门有点大的
50024,919,沈红,2017-04-28 15:25:17,3,4,1,调分很好
50033,919,沈红,2017-04-28 16:07:21,7,9,2,最后的给分不看平时分的 你卷面多少 总成绩就多少 也不调分 起码我们的数电是这样
50035,919,沈红,2017-04-28 16:21:34,-2,6,8,宁可给分好，不要讲课好，绩杀
50050,919,沈红,2017-04-29 02:00:28,-3,0,3,QAQ
51865,919,沈红,2017-06-13 03:14:39,0,1,1,老师讲课很详细。
55810,919,沈红,2017-07-02 12:04:02,-2,2,4,啧啧啧
57951,919,沈红,2017-07-18 10:23:14,6,7,1,沈老师真的很棒，声音洪亮至少让你不想睡觉，而且知识点讲的很清楚的，虽然用ppt但遇到难点都会在黑板上一步步画来解释，这点真的很赞
63725,919,沈红,2017-12-13 14:15:15,0,5,5,10年前上沈红姐姐的课，觉得很不错，人也长的漂亮，关键是她的课我都是满绩点呀！！！唯一可惜的就是没选上她的模电实验课
66377,919,沈红,2018-01-15 13:29:49,0,1,1,很细心，很能照顾到每一个同学，总是很热心过来帮助做不出来的同学，有种老阿姨的感觉
67197,919,沈红,2018-01-20 12:39:32,0,1,1,我上的数电实验课，非常棒，很耐心，实验调试也不会不耐烦，人超好，具体我也表达不好，就十分吧！
71617,919,沈红,2018-01-28 17:11:35,0,1,1,老师讲的真的特别好，电路一满绩了，给老师评10分。电路二没有选到老师的课很可惜
71634,919,沈红,2018-01-28 21:31:11,26,28,2,很热心的老师，是不是的啦？
71637,919,沈红,2018-01-28 22:54:26,3,4,1,讲课清楚明了，PPT特别清楚，还会领着复习，口音问题听一两节课就都听懂了。作业微多，但是作业做好了考试绝对没问题！而且老师特别特别友善。
71726,919,沈红,2018-01-29 01:58:33,0,1,1,第一次在查老师上评价，很幸运选上女神的数电，下学期模电还是她教，很有人格魅力，笑容很美，还很关心同学们～
74262,919,沈红,2018-02-08 10:37:55,-5,6,11,出分了很久才想起来查老师没有评分，总评96，有人说期中考的不好期末再高也总评也不会高，我只想问了，总评里期中占30%凭什么你仅仅是期末考得好就要给你高分啊?对期中考得好的同学公平么?自己辣鸡就不要怨老师。
75646,919,沈红,2018-03-14 14:19:43,0,3,3,是我们班主任~虽然大一就跨到金试去了，但是作为团支书真的感觉沈老师相当关心学生，团总支里交流起来就是沈老师最积极了~超棒的！！
80560,919,沈红,2018-06-28 02:19:09,0,1,1,罗切电路233333\n\n老师讲的很好的，很喜欢这个老师
84560,919,沈红,2018-07-13 07:32:19,0,1,1,稳扎稳打，关心学生的老师。
85103,919,沈红,2018-07-15 11:04:04,0,1,1,讲课的ppt和讲解都特别特别清楚，考试前复习她的ppt就没问题、给分也挺好的。比较赞的是会讲课后题
85263,919,沈红,2018-07-16 14:58:54,0,1,1,超级好的老师！对学生很上心，讲课也很仔细，经常照顾同学跟不跟得上。到最后感觉班里整体都掌握得挺好的。至于给分我觉得很好了，数字电路分析与设计是有平时分的！
91302,919,沈红,2018-12-05 09:04:18,0,5,5,数电实验上的极其之差，自己完全不理解上课内容，只是机械的带着做，有问题问她会果断让你重做，重做了两遍还是同样问题她表示是电脑问题，最后让人去问别的老师，结果人家一眼就看出来问题了，水平差的不是一点半点，还耽误了一小时时间，这老师是真的废
91989,919,沈红,2018-12-25 08:02:54,3,4,1,为什么这个老师的实验课每次都有附加实验？难受
92943,919,沈红,2019-01-06 06:33:56,4,4,0,讲道理虽然重做了两次，还让我去问别的老师但是老师还是很好的叭，不需要你帮我评价
96016,919,沈红,2019-01-20 11:28:39,1,1,0,讲课非常细致，ppt也非常的棒
96258,919,沈红,2019-01-20 15:17:24,0,0,0,超级好的老师，讲课清楚，人也很好
103153,919,沈红,2019-02-26 08:19:20,0,0,0,老师很棒，也很耐心
103215,919,沈红,2019-02-27 01:42:57,12,12,0,今天的作业是第一题、第二题、第三题......第七题.....
104618,919,沈红,2019-03-25 07:41:46,1,1,0,我的乌鸦嘴尝尝会灵验，上过数电的就知道
105235,919,沈红,2019-04-08 04:05:14,23,25,2,拜托周一3.4.5 模电课总坐第一排的那个男生，能不能上课不要总嘟囔，老师说一句你嘟囔一句，自言自语有意思吗，烦不烦，声音还那么大
112372,919,沈红,2019-07-04 03:11:49,1,2,1,希望能过吧！第二次上了
112903,919,沈红,2019-07-05 09:44:25,-4,0,4,
112944,919,沈红,2019-07-05 13:51:13,-3,2,5,很绩杀
113747,919,沈红,2019-07-07 07:47:03,-40,0,40,模电感觉卷面能100，结果只有4.8，但还是谢谢老师，人挺好的
114247,919,沈红,2019-07-09 09:49:52,3,3,0,老师很棒啊！ 讲得很好很清楚 作业虽然多 但只要都认真做的考前再做一遍 过一遍书 期末考还是很easy滴！
118025,919,沈红,2019-11-15 08:14:23,-55,2,57,傻逼东西
120560,919,沈红,2020-01-13 00:43:19,-4,0,4,哈哈哈好就好在 好太萌了隔壁的
125270,919,沈红,2020-09-05 06:20:53,0,1,1,挺好的 认真负责讲的清楚
140780,919,沈红,2021-09-16 03:59:26,0,0,0,我觉得超级好鸭
141706,919,沈红,2021-10-21 07:27:19,2,2,0,上课节奏很舒服\n\n老师人很好 \n\n解答问题也很有耐心很详细！！\n\n满分满分～
146574,919,沈红,2022-01-07 03:18:41,1,2,1,好老师，巨能捞
146631,919,沈红,2022-01-07 06:05:09,0,1,1,好老师不解释
147076,919,沈红,2022-01-08 15:04:18,8,8,0,我们寝室的几个人都管沈老师叫沈妈妈哈哈哈哈哈\n\n\沈妈妈/ \沈妈妈/ \沈妈妈/\n\n沈老师很可爱！ 人很好 点名次数不多 也是通过简单的课堂小测来的\n\n上课的“罗切”很清晰 听沈老师的课真的是一种享受TAT 不夸张的说这是我这学期唯一一门不看智云不二倍速 认认真真在课堂上听的课了\n\n上课节奏很舒服 问老师问题也很耐心的解答\n\n给分也很好会调分  虽然电路1没考很好 跟沈妈妈沟通以后老师也在安慰鼓励我！！\n\n下学期退了预置选了沈妈妈的课！
153081,919,沈红,2022-04-25 04:51:53,5,6,1,沈妈妈我真会的哭死😭\n\n理想的大学老师了\n\n做实验还会给我们带巧克力吃😘
156679,919,沈红,2022-06-26 08:35:52,0,2,2,还没出分，先来评价一波。\n\n1：一学期只有通过一次不提前通知的小测来点名，小测很简单，会做作业绝对能做出来的那种\n\n2：实验讲解很清晰，我们班普遍走的比较快\n\n3：讲课也很好，跟上节奏的话，课下可以省不少力气\n\n4：考前会带你复习\n\n5：出分后来评价一下给分吧2333\n\n————————————————————————————\n\n出分了，感觉还行。就是有一个朋友MOOC期末慕课答案忘记上传了，扣了不少平时分23333
157747,919,沈红,2022-06-24 15:37:54,1,1,0,跟了沈老师两个学期了，大二上的电路原理+数电，大二下的模电。沈老师讲课非常好！！认真听的话拿高绩点不难。很感谢沈老师，在沈老师的课上学到很多，希望沈老师工作顺利～♥️
158010,919,沈红,2022-06-26 07:50:22,-4,1,5,沈红就是我亲妈😭😭😭\n\n三次小测有一次没去，最后还有90😭😭
160973,919,沈红,2022-11-04 05:12:59,0,0,0,PPT比较清楚，会把重点都列出来
163538,919,沈红,2022-12-15 03:08:38,23,23,0,沈老师是学识渊博、讲课深入浅出同时关心学生的好老师，让我一个工科小白菜鸟理解了电路，我很感激先给10分。\n\n但我今天要好好喷一下猪脚，猪脚您是不是有点双标了？就说作业，凭什么十几道题我只错一道直接5->3，还有一次作业全部都打了对号却只给4分，故意恶心我呢吧？而某些字写的好看、爱好提问的xjj即使稍微错一点点也给5（而且还发的“下次注意，给你5分的（不过其他人给的都是4.5，嘘“）？我告诉你，我有图有真相，只是查老师不让上传图片而已！您是不是对我有什么意见？还是说，您作为一个助教最起码的公平公正和职业素养呢？
164030,919,沈红,2022-12-22 08:27:36,5,5,0,沈老师讲课讲的特别好，会提前快十五分钟来教室答疑，上课响亮流畅，ppt丰富详尽，及时上传，练习充足，讲解翔实，关心同学学习生活。功利地讲小测也比较简单，交了就有及格分。\n\n还有就是网课课间的音乐挺好听的（doge\n\n上面的同学别尬黑 还有\n\nParsley sage rosemary and thyme\n\n助教的事情我在朵朵上也看到了，现在也可查，只能说有点小6，建议去本科生院研究生助教评价里踩一脚。
164464,919,沈红,2022-12-21 06:19:19,11,11,0,i am sailing \n\ni am sailing\n\nhome again\n\ncross the sea~~\n\n老师线上课课间会放歌，但是一直都是同一首（笑哭）\n\nanyway，老师讲课还是很好的，很认真负责
168785,919,沈红,2023-02-22 07:42:07,5,5,0,期中考不好真的会死，期末救不起来的
168788,919,沈红,2023-02-22 08:10:13,0,0,0,感谢老师不杀之恩！期中没及格，期末自我感觉也不太好，最后居然没挂，浓浓师生情啊~~
168820,919,沈红,2023-02-22 13:15:21,1,1,0,老师非常非常好！讲课很认真清晰，答疑很耐心。只要认真，老师都会好好考虑你的感受。电原和数电合起来学分高，老师不会坑你，会捞的。认真学，不要辜负了这么好的老师！
168858,919,沈红,2023-02-23 04:06:48,2,2,0,谢谢老师不挂之恩，不过期中考试难成这样属实抽象了个人认为，并且电路原理本身就挺难的
176223,919,沈红,2023-06-28 06:07:00,3,3,0,跟了沈妈妈一年🥰老师讲课细致，小测做点名性质，难度和作业差不多。答疑的时候，你问一道题，老师可以给你把这个知识点前因后果和做题的方法给你讲一遍，怕你不懂还会重复一遍😭
176228,919,沈红,2023-06-28 06:17:31,1,2,1,很喜欢沈老师的杭普话\n\n上课有一种在老杭州市井里噶是非的感觉\n\n所以就不太困（（（\n\n教得真的好 完全无痛学习\n\n给分也超好
181730,919,沈红,2023-10-30 05:19:15,1,1,0,老师是我在大学里遇到的最好的一个老师啦！先不说给分怎么样，问问题都是秒回，真的很负责啦！！！！！
181914,919,沈红,2023-11-05 02:54:23,3,3,0,超级好
186922,919,沈红,2024-01-13 14:09:54,0,0,0,大学遇到过最好的老师，上课清晰、给分好、每次问问题都及时回，平时也不点名
187276,919,沈红,2024-01-15 11:19:28,0,0,0,老师是真的好 有问题必回 上课讲的很仔细 带大家一起复习 神 沈红老师
188208,919,沈红,2024-01-18 11:47:45,0,0,0,很好，有耐心，作为第一门专业课的老师，受益颇多
193343,919,沈红,2024-06-06 15:55:13,0,0,0,沈妈yyds
197570,919,沈红,2024-07-19 15:16:16,1,1,0,满昏，大二的专业基础课几乎就没有讲的不好的老师啊！
197732,919,沈红,2024-08-05 16:28:31,0,0,0,正在听她的智云预习电路原理，PPT真的很有用，例题和解析也很详细
207455,919,沈红,2024-12-22 03:21:13,0,0,0,林平，沈红，周箭，德华，电院F4编的模电教材书实在是太烂了，没有重点，内容和上课内容相比缺失，没有加粗符号，逻辑不清晰，导致模电部分还要回去翻电路部分的书，而且题目还经常出现下标印刷错误。比如说电流源书上就讲了三种但是上课有好多种。
220794,919,沈红,2025-06-19 18:27:40,0,0,0,（电路一）补个评价：老师人很好，会站在学生的角度思考问题。口音也很亲切，记得还送了我们在美国带回来的巧克力。上课讲的也很清楚，单独解答问题也很有耐心，很仔细。总体上感觉应该是数一数二的好老师了（虽然自己学的一般般）
33636,947,王慧芳,2016-09-20 13:11:59,-2,1,3,很好的
78901,947,王慧芳,2018-05-16 11:32:09,2,3,1,人挺好，就是上课要提问，而且要求太高了点
82450,947,王慧芳,2018-07-08 08:19:45,-2,1,3,挺负责的老师
83235,947,王慧芳,2018-07-10 03:15:49,3,5,2,上课点名，讲课不错，给分差，估计就是卷面分
87210,947,王慧芳,2018-09-22 14:15:50,-1,3,4,很好~
114387,947,王慧芳,2019-07-10 00:35:03,-4,3,7,哇老师给分好好
125440,947,王慧芳,2020-09-09 04:39:58,5,5,0,考试太难了。大学期间这么难的课程不多见，这是其中一个。
137206,947,王慧芳,2021-07-02 09:20:13,-1,4,5,讲的挺不错的，课也有意思
152733,947,王慧芳,2022-04-19 04:52:24,-14,6,20,21年春夏上的课，老师讲课十分清晰，而且继电保护这门课的内容很有趣、课程安排也很合理，可以说是所有专业课里让人思路最通顺的一门。没有突然跳出来的繁杂数学运算和变换，一切推导都是顺理成章的，让我非常喜欢这门课给我的感觉，到后面数字式继电保护的短学期课也比较得心应手。同时实验老师徐亮老师也平易近人、和蔼可亲，我个人认为这门课可以说是电自模块体验最好的课。
153513,947,王慧芳,2022-05-03 08:11:26,8,8,0,教学方式像教高中生，但是放在高中又太宽松了。
174948,947,王慧芳,2023-06-20 09:44:38,14,19,5,继保名师王慧芳，讲完全会不慌张。\n\n钉钉邮件等三日，实验安排有点忙。\n\n草纸零张为首创，全书重点也发扬。\n\n导师若选此人物，尊重祝福莫悔伤！
175286,947,王慧芳,2023-06-23 09:09:13,1,2,1,挺烦的，不咋地
191999,947,王慧芳,2024-05-07 06:57:31,8,8,0,每节上课点人答题
193323,947,王慧芳,2024-06-06 09:52:03,7,7,0,“因为这个，所以这个呢是这样的情况，然后可以得出这样的结论”\n\njb谁知道在讲什么
193339,947,王慧芳,2024-06-06 14:57:50,0,0,0,建议大家上课的时候数一下老师一节课能讲几个“这个”，可以有效预防走神😇
194165,947,王慧芳,2024-06-22 10:00:34,1,1,0,讲得其实还可以，继保本来内容就麻烦。就是这个每次课对着名单随机抽人回答也太慌了，站起来不会还会追问“那你上节课在听什么？”
195199,947,王慧芳,2024-06-27 06:38:38,4,5,1,我们客观的讲\n\n“讲完全会不慌张”是他的原话，他觉得我们听他课就可以学好继保了，但是这是不可能的\n\n“钉钉邮件等三日”现在不用再等了，回得很快，“实验安排有点忙”期末实验确实忙，但恰好和电力电子错开也是好事\n\n“草纸零张为首创”现在考试还是没草稿纸，“全书重点也发扬”现在上课只讲重点的，不能说全书重点
6575,958,项基,2015-07-15 15:50:07,-8,12,20,项老师讲得很棒，
23361,958,项基,2016-03-27 05:58:50,14,16,2,讲的飞快
27158,958,项基,2016-06-23 08:48:33,-5,8,13,萌的像树袋熊
28991,958,项基,2016-06-29 05:29:22,13,14,1,听不懂……
31776,958,项基,2016-07-05 01:55:30,-10,5,15,是萌得像藏狐好吗
55313,958,项基,2017-07-01 08:52:02,-13,4,17,棒棒棒
55491,958,项基,2017-07-01 15:47:59,0,7,7,面向电信的信号分析与处理：有三次quiz，会提前通知，千万不能翘！quiz可以翻书，但是不能交流，补做quiz不给分，每次5分呢，好说歹说才给三分，不管任何理由。复习课件特别好，考点都在上面，感觉给分一般。
55495,958,项基,2017-07-01 15:53:07,-15,4,19,虽然我真的学的不咋样，不过老师挺好的，挺风趣，点个赞。
55507,958,项基,2017-07-01 16:31:35,-10,3,13,谢老师不杀之恩
55573,958,项基,2017-07-02 02:58:53,-2,5,7,比别的班快三周吧，好多不考的东西也讲了，不过平时喜欢叫后排同学回答问题，晚到的同学要小心了
55590,958,项基,2017-07-02 03:41:19,-18,4,22,老师挺有趣的，喜欢点最后一排的同学，还喜欢下课走来走去找人聊天?。课讲的飞快，但思路还是蛮清晰的。测验开卷很水，但题目还是比较有价值的。给分应该还不错
55703,958,项基,2017-07-02 08:16:09,-13,9,22,一言不合就萌萌地怼人的老师。讲的飞快但是整个教室只有他一个人思路很清晰。跑到讲台下面来看我在玩什么游戏。喜欢叫最后一排的同学和睡觉的同学hhh。给分很好啊一个意外的90+。平时报告作业要求很简单的。Anyway他也不care这些的。
57953,958,项基,2017-07-18 10:27:55,-13,7,20,项老师人萌萌的，经常会有奇怪的玩笑，讲课还不错，不过信号这种课还是要自己花时间消化，另外上他的课别坐太后面
78933,958,项基,2018-05-17 05:05:58,5,11,6,你们的分打得太高了，我觉得7+差不多了
80142,958,项基,2018-06-20 13:43:42,17,23,6,跳梁小丑，一分滚粗
80391,958,项基,2018-06-26 03:41:05,23,29,6,宽于律己，严以待人
82042,958,项基,2018-07-07 02:34:53,21,25,4,猥琐至极，1分不能再多。
82550,958,项基,2018-07-12 04:29:20,29,32,3,大哥们不要被这个虚高的分数骗了，作为自动化专业的老师带有色眼镜看待自动化学生，老是问学生你是什么专业的。大家都是电院的谢谢老师了。（我不是自动化的）\n\n还有那个展示PPT非说是把最差的同学推出来讲PPT，我也是服了，我觉得有些人讲得不算差，过分了哈。\n\n信号还搞什么大作业？？？！！！简直了，我自己都不知道搞了个什么玩意，也不知道别人搞了个什么玩意。\n\n给分还行。
84124,958,项基,2018-07-12 05:20:21,-3,1,4,
84530,958,项基,2018-07-13 05:37:34,14,16,2,说不考的东西全考了，不好好讲课非要浪费两周时间搞什么展示，真的醉了。
84541,958,项基,2018-07-13 06:17:02,6,7,1,? ? ?
84549,958,项基,2018-07-13 07:09:59,10,12,2,一句话，不喜欢这老师
84554,958,项基,2018-07-13 07:21:07,15,18,3,一学期的课，全坐第一排，打印PPT下来看，期末刷了往年题，最后差点挂。三周结束夏学期所有新课，用三周做个大作业展示，做的内容跟课程联系不紧密他就听不懂，然后对你冷嘲热讽，还对三个专业各自有偏见，尤其是怼自动化，我不是自动化。直接说什么你们是不是把这组最差的人拉出来做展示，问分工，说是大家一起写的代码，他冷笑一下说我就不喜欢听见一起这个字眼，真是好老师。
85625,958,项基,2018-07-22 15:38:42,8,9,1,讲了和没讲一样，最后画考点的时候，他说不考的都会考。
88613,958,项基,2018-11-04 01:12:54,2,3,1,很难想象中国的“最好的大学之一”的浙大的信号分析还是在用到处是错误的书，老师讲自己都说不清楚的课，考从没见过的题。然而事实是这都是真的!
103032,958,项基,2019-04-13 03:03:20,1,3,2,老师变了
104555,958,项基,2019-04-23 10:10:13,12,14,2,基你太美
104922,958,项基,2019-03-31 08:21:30,1,3,2,非常恶心
104954,958,项基,2019-04-01 02:28:42,2,4,2,太坑了，别选
104957,958,项基,2019-04-01 03:00:07,2,5,3,真的不知道大哥讲的是啥，请学弟学妹们，另选高明吧，真的老师跟老师之间差别还是挺大的，孙盾就讲的很清楚，相机老师，就呵呵
104958,958,项基,2019-04-01 03:02:28,1,4,3,听不懂了，跟不上了，相机牛批。给个4分，再观望一下是不是我太菜了，选课冷静大噶。
105264,958,项基,2019-04-09 01:42:27,4,4,0,听不懂
107509,958,项基,2019-05-12 04:26:58,1,2,1,呵呵呵
108294,958,项基,2019-05-20 08:47:39,2,3,1,老师自我感觉比较良好
108553,958,项基,2019-05-28 10:05:13,5,7,2,基你太美～杯杯～哦～\n\n基你太美～杯杯～哦～\n\n基你实在是太美～
114159,958,项基,2019-07-09 01:56:25,3,4,1,这什么玩意啊，卷子贼简单，我期末就这点分？？？???上课体验极差，让你怀疑人生，来大家把这人的评分打下去让他永远也起不来。
117744,958,项基,2019-09-30 06:37:20,1,1,0,five
123343,958,项基,2020-06-04 07:44:13,-1,0,1,信号课的小朋友们，这个课只有📷开的需要搞大作业，需要写论文，做ppt，写代码，十分钟展示
123381,958,项基,2020-06-07 14:50:17,0,1,1,我澄清一下，应该是Q老师和Y老师的课也有大作业
144747,958,项基,2021-12-23 13:07:33,0,0,0,拜拜拜拜
160797,958,项基,2022-10-12 08:06:49,0,0,0,研究生课讲的飞快，还说什么会的都能听懂，不会的听不懂。我寻思我要是会还用你讲?
175605,958,项基,2023-06-25 23:57:21,0,1,1,求捞捞
177176,958,项基,2023-07-02 04:01:48,0,0,0,别听他的课，听别的老师，比如张健杨欢的智云就行，纯念PPT，夸张一点说：我上我也行哈哈哈
5857,959,熊素铭,2015-07-09 15:40:57,18,44,26,讲课挺清楚，作业会反馈，见过最负责的老师。
8042,959,熊素铭,2015-09-16 16:19:19,19,40,21,熊老师超级负责，虽然要求严格了点，但是上课讲的很清楚，我们实验出问题时她特别认真的帮忙检查，如果认真完成给分也是极好的。
8593,959,熊素铭,2015-09-23 02:02:52,5,16,11,好老师，非常细心
14390,959,熊素铭,2016-01-06 17:54:55,5,12,7,认真负责！
19420,959,熊素铭,2016-01-24 07:30:24,4,12,8,可以说非常非常认真。只是我比较渣渣，遇到这么一个要求严格的老师，一个学期上的很苦逼啊。不过还好最后成绩还不错。
20699,959,熊素铭,2016-01-30 03:05:05,0,5,5,好好的老师呀！讲的很清楚，很认真负责
22417,959,熊素铭,2016-03-05 00:33:01,10,24,14,一开始觉得老师要求很高，做实验麻烦。不过到后来觉得熊老师真的非常认真，很为学生着想。只要你认真做实验写报告分数就不会差的。
23146,959,熊素铭,2016-03-20 04:21:42,33,39,6,老师认真负责不用说。但是我个人不是特别喜欢，感觉有些束手束脚。
26445,959,熊素铭,2016-06-18 13:30:06,1,10,9,超级好的一个老师，我见过的最负责任的大学老师了
26512,959,熊素铭,2016-06-19 13:32:36,28,68,40,熊老师的课作业都是自己批的，上课有着高中老师的感觉。相当认真，有个同学跑完12分钟不想去做实验，熊老师后来单独为他跑了一趟去东三补实验，导致那个同学再也不忍心偷懒了——其认真如是
29501,959,熊素铭,2016-06-30 01:47:46,10,31,21,估计是浙大最负责老师了，作业全是自己判，一行一行的看，一个符号写错了都要标注出来，对学生也很好。好好学，成绩一定很好。
30841,959,熊素铭,2016-07-02 15:49:00,1,6,5,良心好老师
31842,959,熊素铭,2018-07-26 17:07:11,-5,10,15,满分不解释！！！
32806,959,熊素铭,2016-07-15 00:15:05,5,10,5,课程结束了每个人会收到一封信！感动满满！
38262,959,熊素铭,2016-11-28 11:45:28,1,5,4,很负责的老师
40368,959,熊素铭,2017-01-03 05:49:21,-1,4,5,电路实验。超级超级好，出问题去找她也会很仔细帮你分析解决。考前一天还发短信来提醒。给♡
41428,959,熊素铭,2017-01-11 13:55:09,-1,6,7,老师很认真，会陪你做实验到12点多，直到你做完为止，很感动!
45041,959,熊素铭,2017-01-19 01:22:25,-1,4,5,老师真的超级负责啊 特别棒的一个老师
47038,959,熊素铭,2017-01-23 10:24:25,-4,13,17,反正再选一次绝对不选她
48391,959,熊素铭,2017-03-31 00:08:58,7,11,4,事情超多
48585,959,熊素铭,2018-01-05 13:40:13,-15,15,30,教学水平太差了，讲课没有一点条理
52225,959,熊素铭,2017-06-16 05:44:11,-1,2,3,好老师。
55402,959,熊素铭,2017-07-01 12:28:08,-1,3,4,很满意，很贴心的老师\n\n
55439,959,熊素铭,2017-07-01 13:20:15,3,9,6,让你不好意思不好好学习的好老师，超级好。
55677,959,熊素铭,2017-07-02 07:15:09,1,4,3,要求严格，认真负责
57335,959,熊素铭,2017-07-06 23:29:04,-1,4,5,应该是浙大最认真最负责的老师了
57428,959,熊素铭,2017-07-07 15:40:48,0,4,4,教的好 给分好 负责任 还要什么？
58044,959,熊素铭,2017-07-26 02:58:49,0,4,4,很好的
58764,959,熊素铭,2017-09-17 02:08:52,0,3,3,好老师，很负责任\n\n
58839,959,熊素铭,2017-09-18 05:15:10,-2,1,3,熊老师特别认真，亲自批改作业，完成的电路板也会认真端详，思考后才会给分
58930,959,熊素铭,2017-09-18 13:47:35,-3,1,4,老师超级负责任，为了同学做完实验能找到她，基本一天都在实验室待着
59555,959,熊素铭,2017-09-22 16:20:25,-2,0,2,今天收到工磁课的课程结束信了，真的非常感动!很认真的老师!
59643,959,熊素铭,2017-09-25 06:50:49,0,3,3,超级好的老师，非常有责任心，讲课思路也非常清晰！可遇而不可求！
60610,959,熊素铭,2017-10-28 13:14:20,-7,2,9,呵呵呵呵呵呵呵呵
65542,959,熊素铭,2018-01-05 13:39:03,3,8,5,超级暖的老师！可以一边检查实验电路一边和学生有说有笑，然后和我们一起满脸兴奋的去看某同学接反电路炸坏掉的电解电容残躯（大雾），非常非常喜欢！
66695,959,熊素铭,2018-01-18 10:01:51,0,3,3,熊老师太细心啦><\n\n有次实验因为仪器问题做的很坎坷，老师后来专门来我这边问，人简直不要太好~
71255,959,熊素铭,2018-01-28 07:59:11,-14,6,20,给分不好，给分真的低，还恶竞严重
72526,959,熊素铭,2018-01-30 09:42:51,0,2,2,事多人好，给分学校正太她也没办法\n\n
74209,959,熊素铭,2018-02-06 15:43:18,0,2,2,这个老师对于认真学的人是很好的选择，只要好好做，高分妥妥到位。不像有些莫名其妙的课，感觉自己挺认真也和别人差不多的分数。
74667,959,熊素铭,2018-03-05 04:54:23,0,3,3,认真负责的好老师！
76874,959,熊素铭,2018-04-25 05:29:42,-1,3,4,老师真的非常好了，虽然比较严格，但是真是为学生考虑的，做得不好会陪下来认真帮你做。浙大最负责的老师，没有之一
78877,959,熊素铭,2018-07-10 22:58:59,1,4,3,呜呜呜，考的有点难了
83568,959,熊素铭,2018-07-10 15:21:29,-2,2,4,操作0分，还能3.5，尽心尽责，谆谆善诱，耐心幽默，真的学到了很多东西！
84477,959,熊素铭,2018-07-13 02:51:17,-1,3,4,老师对于同学们实验技能，实验内容的教导非常细致，对同学们也非常的有耐心，要求严格一些也是受益匪浅了！平时好好用功，成绩肯定不低！
84484,959,熊素铭,2018-07-13 03:11:53,-8,2,10,绝对负责，还有趣
85456,959,熊素铭,2018-07-18 04:39:15,-8,6,14,就不能把ppt做好点？就几个步骤，看ppt猪都能看会
85702,959,熊素铭,2018-07-26 13:14:23,-9,3,12,熊妈妈?
88252,959,熊素铭,2018-12-27 11:51:50,70,79,9,不知道怎么这么高分，实验天天拖堂，屁事一堆，1.5分实验比我4分大课事多，难道别人就不需要学其它课程了吗！
91434,959,熊素铭,2018-12-10 04:55:28,11,13,2,妈的做实验做到快一点我们不需要吃饭不需要上下一节课的么
91697,959,熊素铭,2018-12-18 04:29:29,18,21,3,妈的破事一堆，讲个锤子课，坑学生
93562,959,熊素铭,2019-01-10 11:38:24,-10,6,16,楼上说拖堂的怕不是上课不认真听，做实验像没头苍蝇乱转的？我反正每节课都做提高要求也能提早走
93740,959,熊素铭,2019-01-12 13:12:32,14,20,6,心情像是过山车一样，本来对你笑嘻嘻，突然却像只母老虎，PPt简单爆表，很多话由于太简略不完整而显得没有意义。要不幸选上了她的课，就好好预习吧，上课有蛮多反复强调却没什么用的话。对学生好?像笑面虎一样。
100153,959,熊素铭,2019-01-25 16:00:42,31,34,3,这是个天坑
100155,959,熊素铭,2019-01-25 16:01:57,15,16,1,……无语不解释
100200,959,熊素铭,2019-01-25 23:01:19,13,15,2,做了一学期实验，天天拖堂累成狗，然后3.5。大家看着吧
100221,959,熊素铭,2019-01-25 23:37:32,10,13,3,难受，每次课不迟到，做了很多次提高要求，写报告都彩印，报告要求高，不知道花多少时间，上课一般般，最终两次小测当考试，百分之八十都有把握，操作题很快就给他看了，最后3.5，呵呵…算了，可能老师很好，那我就把怒气归到五级制上面吧…
100244,959,熊素铭,2019-01-26 00:35:41,-11,2,13,上课一定要好好听，她没讲过的东西你去问她她会给你解答，她讲过的东西就别再问她了…她会生气…\n\n老师也不容易，我们中午吃不上饭，老师下午也有课啊，也是没法吃饭啊，都相互体谅一下。
100299,959,熊素铭,2019-01-26 02:26:43,-12,4,16,自己做不完实验还怪老师拖堂?为什么不看看别人做了提高要求还能早走。
100343,959,熊素铭,2019-01-26 03:19:25,9,10,1,这学期的实验做得很辛苦，自己水平不是很高但还是付出了很多，做了几乎所有的提高要求，没次实验做完都只能直接去上下一节课了，实验报告仿真下来也花了很多时间，最后能看到的报告成绩只有一半，两次考试都复习了，本来也不是很难比较有把握，最后分数是什么东西啊，谢谢你全家
100819,959,熊素铭,2019-01-27 01:17:17,-10,2,12,事情确实有点多，实验内容远多于其他班，还要搞一个什么平台上传实验数据，多此一举，浪费时间。另外选上这位老师的请做好没得吃午饭的准备。但是实验报告认真写还是能上4.5的，期末考试只占5-10%
102564,959,熊素铭,2019-02-08 13:37:52,0,2,2,熊素铭
103250,959,熊素铭,2019-02-27 03:30:21,47,52,5,上了两节课 上课形式史纲 上课内容工磁 懂的都懂
103806,959,熊素铭,2019-03-13 02:23:00,38,42,4,感觉讲课很不清楚？讲不透，而且上课很无聊
103813,959,熊素铭,2019-03-14 02:28:17,81,99,18,看到楼下说老师讲课差被踩了20多次，我就感觉不舒服。\n\n认真教学跟教学水平和方法合适与否是两个问题好吗？认真是认真，浪费学生上课时间是另一码事。听课几乎无收获。一节课自学完的她要讲两个星期。\n\n作业要求太多，时间都花在写步骤上了，0.1分0.1分的计算，有多大意义？物理不是文科，天天上课问我上节课讲的什么，有意思吗？
104141,959,熊素铭,2019-07-12 15:58:18,52,57,5,让我来概括一下本学期的工磁（已经把影响后人判断的情绪词基本删了，其他遗漏或者错误内容欢迎各位补充指正）:上课节奏慢，老师喜欢问学生问题。除了临近期末的两三周之外，每节课有三到五分钟的课前测验，形式为多选和填空。除此之外，有两次四十五分钟左右的大测验。作业批改抓细节。分小组进行展示，内容为习题讲解+自己出题并附上答案。实验课安排在周末，除两个必做实验之外，选做实验也必做。实验前给原理讲解和操作视频，学生必须测验过后才能参加实验。
104144,959,熊素铭,2019-03-13 03:06:18,31,35,4,认真过头了。\n\n让人丧失学习兴趣。
104419,959,熊素铭,2019-05-29 03:31:03,22,24,2,为什么没有0分？0分都嫌多了
104426,959,熊素铭,2019-03-20 05:28:47,5,8,3,cnm
104600,959,熊素铭,2019-03-25 03:29:50,13,15,2,#黑粉\n\n学长给的评价是给分好？这是什么评价标准？）\n\n相信前面几个同学也讲的比较清楚了，事情多，讲课细碎，教的根本就是幼儿园孩子，极不适宜高水平同学听课。熊老师认真负责本意当然是好的，但是大学课程的本意又是什么呢？
104601,959,熊素铭,2019-03-25 03:33:31,8,10,2,#工磁\n\n认真地在教小学生。\n\n可惜认真不等于上的好。
104707,959,熊素铭,2019-03-26 08:24:24,13,15,2,认真和不会讲课是两码事，拘泥于自己的讲课方式无法自拔，口口声声积累了许多经验还是上课揪住一个细枝末节的点不放，毫无意义。
104742,959,熊素铭,2019-03-27 02:51:07,31,32,1,老师活得真累，作业一共占十分，一学期交十几次作业，平均下来一次作业也就占零点几分，就这样老师还要一次作业算五分，零点一零点一给你算，不仅如此，每天都不厌其烦做小测问卷，真的太累了
104745,959,熊素铭,2019-03-27 03:31:26,17,21,4,我没有听过她的别的课，据说好像还不错，但单从工磁来说，基础稍微好点的建议最好别选了，每节课都是小学生模式，讲了半个短学期基本没讲什么内容，进度落后别的班一大截，每节课还要问卷小测，作业评分，更正，还要分小组展示，根本就不像我之前上过的工科课程或者理科课程，更像是思修或者史纲，细枝末节处太过纠结，学生真的是没有自由。每次上课都好像我们没学过物理数学一样，讲的太多太慢了。
105038,959,熊素铭,2019-04-03 00:28:14,10,10,0,事情太多了8，我们不要上别的课的吗\n\n
105050,959,熊素铭,2019-04-03 02:42:26,7,7,0,服了服了
105335,959,熊素铭,2019-04-10 04:27:50,12,12,0,对不起，我要骂人了，我TM又不是只选了你这一门课，当个老师不知道给学生考虑，说起来自己也很忙，自己也很辛苦，那不是你自找的吗？那你就说为了学生好，学生有觉得这样好的吗？
105351,959,熊素铭,2019-04-10 10:14:26,8,11,3,哭了…老师教工磁比学生更努力，老师真挺辛苦的…但真是好狠一女的…?
105370,959,熊素铭,2019-06-30 14:23:46,21,24,3,一个个都稳满了？把我们敬爱的熊老师分数抬的这么高
105417,959,熊素铭,2019-04-12 04:04:44,2,2,0,，，，
105584,959,熊素铭,2019-04-17 01:56:20,9,11,2,辣鸡老师赶紧退休吧
105606,959,熊素铭,2019-04-17 06:26:17,10,10,0,倒霉选你
106802,959,熊素铭,2019-04-29 15:35:07,12,13,1,有的时候提出了一个问题，嗯，这个还是需要你们好好想想的，然后，就没有然后了，我唯一的心里弹幕 是 ？？？？？？？？刚刚发生了什么
107375,959,熊素铭,2019-05-04 13:39:32,20,20,0,点名批评，吵你一顿还不教你的那种
107559,959,熊素铭,2019-05-06 13:52:26,13,13,0,这个老师真的太差了。千万别选。
108106,959,熊素铭,2019-06-11 10:12:44,26,26,0,如果你想\n\n实验课：靠群里的小视频自学以节省时间做实验，比其他班多做一倍的实验，多谢至少一份的实验报告，实验过程中问任何问题先逼问你做了实验预习测验没，所有实验报告两周完成（也比其他班早交）\n\n理论课：每堂课小测验，讲课讲超多废话重点基本靠自己看书，随机抽人上台做题至少浪费十分钟，额外一次的中期测验（手机上做），每次作业0.5 0.1这样扣，以上全部计入平时成绩，........\n\n师者，传道授业解惑者也\n\n不知道给好评的人什么想法。仅靠认真吗？但浪费的是一个班几百人的时间，消磨的是一个班对工磁这门课的兴趣
108361,959,熊素铭,2019-06-05 10:40:44,41,41,0,我服了真的，每天上课问你问题，问完点人起来回答，答不对就再点人回答，浪费好长好长时间，教训你一顿，教训完也不告诉你答案是啥，说你们自己想去我不讲，下次小测就考，我真的服了，会的人依旧会，不会的人依旧不会，要老师有什么用
108394,959,熊素铭,2019-05-22 15:37:26,2,10,8,老师确实有点太狠了，不适合教大学生……但楼上没必要这么骂老师吧…\n\n没有功劳，还没有苦劳吗\n\n指出不足就得了，何必这样
108430,959,熊素铭,2019-06-26 08:17:30,8,8,0,考前小测试的只有您了吧
108440,959,熊素铭,2019-07-11 17:33:20,20,21,1,出这么晚也没捞我，还是我太菜，难受，熊老师明年再见?
108447,959,熊素铭,2019-06-04 15:59:28,2,4,2,
108531,959,熊素铭,2019-05-28 00:34:10,15,16,1,这怕是电院最差的老师了吧，奉劝后来人无论如何都别选，大四回港都不要选她！
108578,959,熊素铭,2019-05-29 03:18:11,7,7,0,我疯了
108579,959,熊素铭,2019-06-12 11:40:55,20,20,0,人倒是很好，但您这样真不累么？您不累我们也累啊…哭辽
108580,959,熊素铭,2019-06-19 03:05:43,28,28,0,如果换个老师我这学期会快乐很多
108622,959,熊素铭,2019-06-29 05:30:29,106,115,9,黑了一个季的角色妄图最后一集强行洗白？\n\n然而正义的观众是不会买账的！
108733,959,熊素铭,2019-06-01 04:41:50,14,14,0,天坑朋友们，如果你真的想好好学习，熊老师不会给你这个机会，老师会把你学习的时间都压榨掉搞一些毫无意义的事，等着每周浪费5节课的生命就好了。
108748,959,熊素铭,2019-06-01 09:09:57,-23,1,24,私戳老师问问题都会很耐心地解答，课后作业能帮助我们检测自己有没有学懂，PPT的话这门课基本共用的，每个老师不是差不多嘛。老师的认真是大家有目共睹的，但是可能脾气时好时坏，最后，我还是觉得熊老师很好的。
108952,959,熊素铭,2019-06-12 05:06:43,-18,6,24,老师认真负责 工作态度认真 是不可多得好老师 电院学子不得不选得好老师！
108969,959,熊素铭,2019-06-05 01:07:40,14,14,0,这么说吧，她只教工磁这一门课，并且她以为你只学工磁这一门课。
108972,959,熊素铭,2019-06-05 02:17:52,29,29,0,“你们不动脑子，我讲了也没用，自己回去想，下次小测我一定把这道题放进去”\n\n于是会的人会，不会的还是不会，课堂上老师不教，这哪算的上上课，不过是下次小测的考题情报分享会
109128,959,熊素铭,2019-06-19 02:42:15,24,24,0,真的是想一出是一出，有本事考完小测改规则，那你有本事出分了捞我吗！
109130,959,熊素铭,2019-06-24 11:00:11,23,24,1,操，今年工磁考试加多选题？选错一个没分？你出的卷子吧？！
109137,959,熊素铭,2019-06-12 04:33:24,22,22,0,刚做完小测，过来给个1分
109151,959,熊素铭,2019-06-10 09:13:22,19,20,1,我看出来了，老师就是想要扣我的平时分。(╯‵□′)╯︵┻━┻
109152,959,熊素铭,2019-06-12 16:51:59,17,19,2,患有斯德哥尔摩综合征的我表示我❤️熊老师???
109172,959,熊素铭,2019-06-11 05:44:51,14,14,0,天天测，还是天天不会
109194,959,熊素铭,2019-06-29 04:29:54,2,9,7,还是爱的
109196,959,熊素铭,2019-06-12 08:51:05,17,17,0,碰上这种老师 我真的累了
109205,959,熊素铭,2019-06-26 08:17:56,19,21,2,考前三天又放网上测试出来，心态爆炸
109210,959,熊素铭,2019-06-12 05:36:08,13,15,2,说好的12:19交，时钟刚过12:19我点的提交。然后tm就没了？？？没了？？？wqnmdgdsb
109224,959,熊素铭,2019-07-12 10:11:48,13,20,7,还是，，谢谢老师叭。。
109225,959,熊素铭,2019-06-12 05:00:01,11,11,0,听好多同学对她评价都很差，不能让她再祸害别的同学了。
109226,959,熊素铭,2019-06-12 05:02:43,14,14,0,想不到zju的老师竟不知如何设计小测试问卷
109227,959,熊素铭,2019-06-12 05:04:14,13,13,0,问卷真的无语，各种问题
109233,959,熊素铭,2019-06-12 06:05:56,11,12,1,辣鸡熊素描毁我青春
109254,959,熊素铭,2019-06-12 10:09:41,6,7,1,Nc老师早点退休
109259,959,熊素铭,2019-06-12 11:03:27,10,10,0,每次课点人起来回答问题，答不上也不回答，考无数次小测
109272,959,熊素铭,2019-07-13 04:50:02,17,27,10,这是我第一次给老师差评，理由是我小哥哥每周三上完他的课都会变暴躁。
109276,959,熊素铭,2019-06-12 16:19:57,15,15,0,我舍友每次上完课就会变得奇奇怪怪的
109381,959,熊素铭,2019-06-13 14:27:20,7,7,0,只想问为什么没有0分?
109450,959,熊素铭,2019-06-14 14:22:10,5,5,0,无语。尤其是问卷。
109469,959,熊素铭,2019-06-16 07:31:10,6,8,2,第一次举报给了第一次给老师差评那位xjj，因为我怀疑你不只是在评价老师:(
109560,959,熊素铭,2019-06-19 02:28:01,-37,4,41,老师很好啊，认真负责，知识点也讲得很到位。那些说老师过于认真嫌烦的就是自己懒而已
109592,959,熊素铭,2019-06-17 09:59:03,4,4,0,烦 烦 烦
109622,959,熊素铭,2019-06-18 03:17:44,5,5,0,很无语
109725,959,熊素铭,2019-06-29 05:43:43,2,13,11,考完试决定给老师比个心
109726,959,熊素铭,2019-06-19 02:02:44,18,18,0,真的\n\n太煎熬了\n\n最后一节课开始放网课\n\n还截止到第二天\n\n你的平时分占总评300%吧
109731,959,熊素铭,2019-06-19 03:02:05,8,8,0,习惯了
109956,959,熊素铭,2019-07-11 23:02:42,13,15,2,真的是辣鸡老师 屁事儿多还绩杀
110408,959,熊素铭,2019-06-29 04:31:24,2,7,5,虽然听课体验不佳，但是答疑体验极佳
110900,959,熊素铭,2019-06-30 13:27:57,9,10,1,惊了 从未想过能有如此老师存在
110918,959,熊素铭,2019-06-28 14:06:51,-1,4,5,老师人很好，我也认真学习。
110944,959,熊素铭,2019-06-28 16:01:16,-7,3,10,我爱熊老师♥
111015,959,熊素铭,2019-06-29 06:38:51,7,8,1,小惠未徧，民弗从也 \n\n小信未孚，神弗福也\n\n懂的都懂
111223,959,熊素铭,2019-06-30 15:52:57,6,7,1,一个个都稳满了？把我们敬爱的熊老师分数抬的这么高
113005,959,熊素铭,2019-07-05 17:25:06,-16,0,16,非常好。\n\n
113356,959,熊素铭,2019-07-06 09:38:45,-26,5,31,我来客观地评价一下吧，的确熊老师是一个对于细节要求十分严格的人，但是熊老师绝对是非常认真负责的。熊老师对于作业的要求是很高，但是如果你平时作业认真一点，端正一点，又怎么会嫌要求多呢。大学的教学方式本来就和高中不同，更多的是要求你有自助思考的能力，老师不可能回答你的没一个问题，更多的是要你自己去想清楚。如果你对于自己的成绩不满意，你更多的是需要去思考是否自己的学习态度有问题，是否自己真的有认真学习这门课。我也是熊老师班的，我自己做了二十多页的笔记，期末考试没有觉得有任何问题，所以关键在于自己\n\n
113723,959,熊素铭,2019-07-07 05:59:39,3,3,0,我呵呵
113750,959,熊素铭,2019-07-07 07:55:05,6,7,1,为什么没有0分的选项？\n\n千万别选她的电工实验\n\n很虚伪的老师了，上课跟你说说笑笑，成绩出来转眼就给你个1.5 3.5，我要呕了\n\n每个星期就想着怎么让学生恶竞的老师，再见了您嘞
114209,959,熊素铭,2019-07-09 04:32:12,3,3,0,屁事真多
114565,959,熊素铭,2019-07-10 17:19:16,5,8,3,分也不出了？准备对着记录对着向量剪头再0.1 0.1地扣分是吧？
114760,959,熊素铭,2019-07-11 11:19:55,4,4,0,求求你出分吧，平时上课磨人，考完试了还磨人
114835,959,熊素铭,2019-07-12 02:06:43,2,2,0,卡绩了呵呵呵呵
114886,959,熊素铭,2019-07-12 10:17:34,4,5,1,工磁一门课的小测可能比其他所有课的小测加起来还多... 不过期末发的复习提纲还是很不错的
114887,959,熊素铭,2019-07-12 11:01:59,2,4,2,辣鸡老师举报了
114888,959,熊素铭,2019-07-12 11:21:40,-2,1,3,呵呵，就期末有点用
122788,959,熊素铭,2020-04-07 04:46:15,4,4,0,刚刚网课做完线上小测。测验一堆多选题 还给两个大题目 50分钟做完 您当我是神仙？？
122880,959,熊素铭,2020-04-16 10:09:52,-1,0,1,进度慢，喜欢抠细节，作业以小测为主，平时分瑟瑟发抖。
123066,959,熊素铭,2020-05-07 13:26:44,1,4,3,我上的是电工电子学实验，还是很喜欢熊老师的。熊老师的实验很认真负责，每次实验课开始都会很细致地把实验讲一遍。在同学们遇到问题的时候也会很耐心地解答。有一次实验我一直没有做出来，在实验室一直待到很晚，只剩了我和老师两个人，老师一直帮我检查哪里出了问题。但最后也没有发现哪里不对，我因为接下来还有别的课不得不另寻时间重新做这个实验，老师一直叮嘱我到实验室和她说一声，自己做注意安全。我记得那时班里面有一个留学生，中文不是很好，老师也一直耐心地指导他，和隔壁大物实验老师对待留学生的态度形成鲜明对比。总之还是推荐大家选熊老师的实验课~
125730,959,熊素铭,2020-09-13 16:06:12,-4,2,6,平时上课：为什么老师讲的这么慢我还是听不懂。\n\n小测：woc这选择题啥玩意儿，woc这怎么来得及写。\n\n复习课：提纲不错，终于可以写课后题了。\n\n出分后：老师我爱你！
125743,959,熊素铭,2020-09-14 02:22:46,6,6,0,工磁。老师其实很认真，但是讲课水平实在不能恭维。小测题目量大，没几个人能做完；上课讲半天都讲不到点上，可以不用仔细听；本来会的东西反复讲半天，不会的却匆匆略过；考试重点复习ppt就行，一共五个ppt，复习一天左右，做做去年的题就差不多了。
125807,959,熊素铭,2020-09-14 11:16:01,-2,0,2,没有传说中的那么可怕，但是事情的确不少，平时分确实严格
126741,959,熊素铭,2020-10-17 11:56:54,1,3,2,电路与电子技术实验。现在课上了四周左右，可以来谈谈感受了。\n\n做实验前会很细致的给你讲，基本你听了整个实验就没啥问题了，一些实验报告的要求也会给出。但是正是由于讲的比较细致，所以会花费大量的时间，导致做实验的时间相对比较少。其实这个时候就可以一边听一边写实验报告。\n\n做实验的时候基本手一举老师就过来了，当然老师得有空。每个实验都会给出必做部分和提高部分，想要在课堂时间内都做完挺难的，有一次做完了所有的实验出来就是十二点五十了（12:15下课）这个时候老师还在给其他同学解决问题，其他时候一般就是12:30前出来。\n\n实验报告的批改非常的细致，每次实验报告的打分也会考虑是否做了提高部分，相当于是一个加分项。反正实验报告就硬卷，不能卷创造条件也要卷。我本不想卷，奈何。。\n\n总结一下，作为一个理论课的实验部分，我确实从中多学了点东西。
126857,959,熊素铭,2020-10-25 07:43:52,6,6,0,以前，我以为是我错了 看了这么多低分评价，这老师果然不太行
127085,959,熊素铭,2020-11-06 05:34:48,3,5,2,千万千万别选她的模电实验 经常一点半还吃不上饭 实验报告鼓励恶竞 打分以0.1为单位 看起来上课很认真实际上屁都没讲 总是抠一些无关紧要的步骤 建议直接仿造签名偷偷走人
127643,959,熊素铭,2020-11-25 08:19:32,8,11,3,能学到东西不假，老师认真也不假，看到自己做的电路板时的成就感也不假，但是，绩杀更是不假！我承认我菜，我承认上课听完一脸懵逼，但是我还算认真啊，时间花的比线代都长但是回报远不如线代带给我的啊（主要指绩点）！所以各位学弟耗子尾汁！啪，很快啊，这门课就拖你保研的后腿了，这好吗？这不好！可能我略带偏见，不过选课真的要慎重噢！谢谢朋友们！
127645,959,熊素铭,2020-11-25 08:26:48,6,6,0,听不懂，难，老师以为你啥都会，把你当大四的教，结果还真有大四的来水课，人家几分钟搞定的，愣是几个小时做不完。
127741,959,熊素铭,2020-11-26 09:24:22,7,7,0,慎选！
128250,959,熊素铭,2020-12-15 05:10:26,8,8,0,大一，上电工训，完全听不懂这老师想讲啥，报告也不太会写，哭辽
128268,959,熊素铭,2020-12-16 01:28:39,10,10,0,坑死学生不解释
129537,959,熊素铭,2021-01-07 02:43:33,-1,2,3,理论课不知怎样，实验课老师真的很认真温柔。会很耐心的解答问题，实验前的讲解也很详细清晰（虽然有些墨迹）。还没出分，希望给分不差吧。\n\n但从实验课来看老师绝对是8分以上的。
129780,959,熊素铭,2021-01-12 09:23:43,2,3,1,电工电子工程训练结课了，来总结一下：\n\n前4次课，训练接电线，接线图有点复杂，需要自己绘制；每次课程的实验报告完成时间约3小时；\n\n后4次课相比前4次轻松很多，5-6用软件画电路，每一步都很清楚，7焊接一个简单电路，8练习示波器使用。每次课都要实验报告。\n\n期末要交不限字数的实验心得体会。\n\n总体来看，是一门比较硬的通识课，但学到的东西也比较多，非工科的慎选，大一的慎选。\n\n至于老师本人，比较和蔼可亲，但有些吹毛求疵，不知最后给分如何。
132111,959,熊素铭,2021-01-30 10:47:13,-21,0,21,老師太好了吧，大家別被黑了。老師人挺不錯，會細心講解，按要求做就好了啊，給分也超好的（大一小新第一个99滿積！）大家別被黑了！！！
134859,959,熊素铭,2021-04-19 08:17:31,4,4,0,恶心至极
136219,959,熊素铭,2021-06-13 02:42:28,3,3,0,老师是挺认真的，但是课事情巨多，给分不行。特别有一点，有实验让你选三个难度的，但是选了第二个做到最好分数竟然没有第三个没做出来高，而且一下就差距10分，别的都是差距零点几分，只要没选那个最难的，剩下做得再好也没用，笑死根本拉不回来。
149255,959,熊素铭,2022-01-15 01:26:15,-4,2,6,老师很好！会耐心地解答问题，上课的时候稍微有点慢，但每一次模电实验的步骤都讲得很清楚，每一次实验都有提高要求，但是提高要求都不难。好好做了所有的实验，最好的测验虽然实验操作没有做出来老师也给了4.5，建议多和老师沟通，真的是很好的老师！
150083,959,熊素铭,2022-01-19 02:05:44,-7,0,7,很亲切
151294,959,熊素铭,2022-03-03 00:07:12,7,7,0,讲课慢的很，在小细节上拖拖拉拉，没有多大意义的问题也要叫好多人回答问题（请问一节课开头啥都不讲，就单提问上节课上过内容的名称，名称！有什么意义？？）。我觉得比较适合当小学教师，别来大学祸害别人
151526,959,熊素铭,2022-03-07 01:44:43,10,12,2,她说没人想当她助教\n\n是因为这门课太难\n\n哈哈
152125,959,熊素铭,2022-03-28 02:01:21,15,15,0,语言组织能力有很大缺陷，一节课说的话里最多的词是“那个”，PPT十分简洁，应该和我制作PPT水平差不多。每节课问几个无厘头的问题，知道被问者不知道直言要他猜一个，直接在那里尬着。还有，真没想过找不到助教是谁的问题吗😅
152226,959,熊素铭,2022-03-31 00:45:16,7,7,0,水平低的无以复加，脑子像是有什么大病
152268,959,熊素铭,2022-04-01 03:53:52,2,2,0,1分，不解释
152520,959,熊素铭,2022-04-14 01:47:36,12,13,1,天坑啊，第一节课听她上课，啥也没讲，问问题问不清楚，导致学生答不清楚，答的她不满意，就换个人继续，有必要吗，大学课程从来没见过这么教的，教小学生吗，学习完全不能自主。天天上课点人回答问题，问上节课讲了什么，答不出一个问题就一直耗着，进度超慢，讲的超烂，还逼你一定要去上课，一定要听她的课，不能听别的老师的课。作业给分1分1分细抠，天天上课随堂练习随堂测试，还到每个人的座位上让每个人签字当作点名，坐牢，避雷。主要是老师细心我可以理解，但这么低效真的，不能理解，学弟学妹们避雷吧，无语，第一次给一个老师差评
152650,959,熊素铭,2022-04-17 11:24:56,2,3,1,不解释
152667,959,熊素铭,2022-04-18 02:28:45,17,18,1,电气学院的宝藏老师！！！集各优秀老师之所长于一身，讲课不清、答疑不清、作业不清、偶尔还误导一下！讲课不行事还多。没上过熊素铭的课，相当于没上过浙江大学！强烈推荐大家选择熊素铭，欢迎各专业的同学们，让我们一起体验坐牢的感觉，调整心态，每天一遍熊素铭真***可爱！😓😰😢
152919,959,熊素铭,2022-04-21 16:13:35,-7,5,12,我感觉熊老师讲电工电子学实验很好，很温柔，有问必答，其他不了解，但是实验课真的很细致，也会测验。
153474,959,熊素铭,2022-05-01 03:49:23,14,14,0,进大学以来见过讲课最烂，币事最多的老师。求求您别教书了，上课让我们自己看书本就是你最大的贡献了。上课测测测，问问问，问你mother呢。讲的烂还不让我们好好自习了啊？\n\n听我说，谢谢你，温暖了四季🤤
153809,959,熊素铭,2022-05-12 00:16:50,5,8,3,真的傻逼，狗屎都不如，可能脑子里都是自己的排泄物吧
154401,959,熊素铭,2022-06-01 01:24:44,-38,2,40,我不知道你们有没有满绩，反正👴满了。10分，不解释。
154402,959,熊素铭,2022-06-01 01:24:44,-33,3,36,我不知道你们有没有满绩，反正👴满了。10分，不解释。
154908,959,熊素铭,2022-06-06 16:23:27,22,22,0,n 为什么是法向\n\nt为什么是切向\n\n这是人能问出来的问题吗？\n\n你他妈问了也不会答\n\n\n\n老子还真搜了搜\n\nn指normal \n\nt指tangent\n\n\n\n你他妈的 答非所问 问非所答\n\n无语
155398,959,熊素铭,2022-06-12 07:16:49,9,9,0,纯纯的抽象
155399,959,熊素铭,2022-06-12 07:25:25,5,5,0,一分不解释
157562,959,熊素铭,2022-06-23 17:09:51,1,2,1,慎选吧，讲的慢，还讲不清楚。好在还算有点耐心
160010,959,熊素铭,2022-09-11 13:39:09,2,2,0,都把重点题目都说了，无可厚非了
162242,959,熊素铭,2022-11-18 07:10:09,8,9,1,实验报告怎么这么多啊啊啊啊啊，为什么每次都有附加实验鼓励内卷wwwww，做死我了，不过老师本人还是很温柔耐心的，上实验课也没什么压力，但是实验报告真的好多啊啊啊，别的班数电实验都没报告了，我们为什么还要写，实验原理还要自己写都没地方抄
164191,959,熊素铭,2022-12-19 04:54:42,14,14,0,请老师多多关注与其他教学班的教学进度与教学内容，尽量保证作业、实验报告的一致性，减少作业提交要求的繁杂程度如需同时提交纸质版与电子版，此外，希望老师能够像物理实验一样提供作业反馈，方便与学生在再次书写实验报告时主义之前未发现或遗漏的问题。把握上课时间与教学进度，电子与电路实验的上课时间仅仅到上午第四节课，但常常拖课至第五节课，但相较于其他教学班能够多次准时下课相比，我认为既然学生是随机筛选至教学班，那么就并不是学生乃至整个班级的水平差距。在数字电路部分时，我们每次实验均需要验收，提高任务，以及非常没有必要的实验报告，电原部分，我们整个班每次均需要不同部分的验收，期中期末，我们还有及其正式的期中期末考，然而在我询问其他教学班的教学情况时，均无大部分我所描述的情况，对此我不禁对该门课程的教研组产生疑惑，为何班级之间的差异可以如此巨大？最后希望老师能够在之后的日子里努力提高教学水平，而非将学生产生的问题交给学生自行思考，能够将学生产生的疑惑讲出知其所以然。
170834,959,熊素铭,2023-03-10 07:57:06,7,7,0,"对于xsm老师：laji老师，sb老师，sb讲课方式，谁选这个老师谁后悔，每一次实验报告都写得很认真，因为疫情没参加一次实验（后面跟她求了老师能不能补一下补一下，但她就说:""哎呀呀，没有关系的，只要把试验报告认真补上来就可以了，学校会理解疫情原因的....说了一堆废话""），期末也认真参加了（成绩都接近满分），结果给个通识课最低成绩，真的是无语了。\n\n对于课程：电子电工试验课程是挺好的，而且也有意思，无论自己是什么专业还是推荐学弟学妹们体验一次自己给自己做蓝牙音箱，而且其他几个老师的课程还是相对来说比较轻松好玩的，但就是这个xsm（你咋不去die呢），但是死也别选这个老师，真的会后悔，就一个通识课还布置这么多内容，真的事多。害~看到成绩真的无语透顶！"
171712,959,熊素铭,2023-04-03 02:23:16,5,5,0,上课水平挺低的；上课进度安排混乱又奇怪；控制欲又很强
171729,959,熊素铭,2023-07-08 05:57:10,6,6,0,黑转黑
171989,959,熊素铭,2023-04-16 09:09:05,3,3,0,给你一分都觉得多余，事多，给分差，还搞绩杀，被它卡了一分，掉了个档
172016,959,熊素铭,2023-04-17 12:36:44,27,28,1,某同学开学时：其实我觉得xsm讲的还可以哎，没有查老师说的这么差\n\n半个学期过后该同学：纯纯的傻逼xsm
173991,959,熊素铭,2023-06-05 13:19:01,4,4,0,建议别选她的实验课，上课拖延严重（16节课有三分之一是拖堂的，原定11点多下课很多人12点才能做完）而且讲得稀里糊涂不明不白，要求还蛮严格，是一个工作认真但是能力跟不上想法的老师
177403,959,熊素铭,2023-07-03 06:58:23,-8,5,13,不足之处：这学期最大的问题就是老师上课的进度安排的不太好，第二章占用了太长时间，尤其是习题课。在后面上第三章的时候讲课速度很快，上课很难跟上，所以熊老师也布置了笔记整理的作业作为监督。电场和磁场部分确实有很多相通之处，熊老师的意思是学好电场，磁场都可以类比。道理是这个道理，但是我认为只适用于小部分学生。\n\n建议：熊老师的作业都是自己出的，但是有必要做课后习题，关于作业，熊老师批改很细致，而且我有几次作业做的不太好，但好像对总评影响不大🤔。熊老师点名形式以笔记整理和小测为主，小测参与即可，做的好可以算作多次点名记录。\n\n优点：熊老师最后发的复习提示很有用，09-10的真题卷好好用，懂得都懂，有些话不能明说。🤫还记得熊老师考完试跟我说，我肯定会帮你们的…然后最后一堂课也说希望大家能取得好成绩。事实证明熊老师言行一致。\n\n这门课我的总评是94，还是挺满意的，熊老师给分我觉得不错，人也很耐心、可爱，就是讲课可能一言难尽。学好这门课我觉得大物电磁学的基础还是挺重要的，说白了主要就是在大物的基础上加了镜像法和列写边值问题求解，然后用新的思路理解大物已有的电磁学知识。下面有则评论是我课友发的，讲第二章的时候我确实发表了对熊老师的不当言论，在这里对熊老师表示歉意，但是在考试之前我就已经黑转粉了，我觉得还是有必要澄清一下，熊老师人真的挺不错的👍
181548,959,熊素铭,2023-10-22 11:45:13,6,6,0,呵呵 辣鸡 不解释
181685,959,熊素铭,2023-10-28 04:58:47,11,11,0,讲的跟屎一样，屁事无敌多，作业0.1 0.1地扣，写报告的时候真想创死全世界
182292,959,熊素铭,2023-11-14 06:37:34,16,16,0,1分，不信你选试试？
190392,959,熊素铭,2024-02-29 14:31:57,1,2,1,老师真的很好，很关心学生，虽然明天才是我的第一节课，但是今天晚上我就感受到老师对我们的关心，今晚六点半就就提醒我们预习mooc的课程并在明天课前完成学在浙大上布置的预习作业，虽然预习作业与预习内容毫不相关，但老师对我们的关心真的很让我感动！
190780,959,熊素铭,2024-03-18 14:26:41,5,5,0,这个老师B事贼多，扣分事项事无巨细，非常负责，奖励1分
190825,959,熊素铭,2024-03-20 06:13:47,7,7,0,What can I say？
191937,959,熊素铭,2024-05-06 01:41:59,5,5,0,电工电子学实验，你可能觉得这个老师很认真，可是事实是认真的地方完全不对。只能说一点都不会教书。每次实验课前做小任务，经常浪费一节半课，讲又含含糊糊。建议千万别选。
192260,959,熊素铭,2024-05-13 06:18:02,5,5,0,电工电子学实验，几乎节节拖堂，如果你想每节课先小练习半节课导致之后吃不上饭，实验报告扣分细心认真，选她\n\n\n\n好评，11分，这分是溢出的
193021,959,熊素铭,2024-06-02 14:08:08,-3,1,4,老师希望培养你们的能力~你们这样以后怎么做研究？
194185,959,熊素铭,2024-06-22 11:14:25,0,2,2,熊老师人挺好。另一个老师人不行。\n\n还是不建议选，事儿太多。选别的老师会教一些。这门课一定要预习，否则可能拖堂，吃不上饭
198772,959,熊素铭,2024-09-11 13:44:49,3,3,0,额，课表下午五点下课硬是给我感到了下午五点50
199223,959,熊素铭,2024-11-21 11:28:23,15,15,0,哥们能别再这么自我感动了吗。。\n\n我时常怀疑我们是不是都是中国人，因为我既听不懂你上课讲的话也读不懂你讲义上的字
199818,959,熊素铭,2024-10-11 01:39:23,6,6,0,你鼓励思考我没意见，但你不能不解决我们的问题啊。啥都要我们自己解决你干脆不用来了。还只能验收两次，搞得我自己解决不了的问题都不敢问。讲的话一半都是没什么价值的碎碎念，真的无语。\n\n\n\n\n\n明明做完实验所有曲线图都给验收过了，为什么还要在实验报告里手绘。实验报告0.1，0.1地给分，还设置一堆所谓“加分项”，而且加分项分值往往较高，就是变相的必做项。上课有讲义要填，下课还有量超级大的实验报告要写。讲课是讲究细节的，讲出来是云里雾里的，问问题是不明所以的，批作业是吹毛求疵的。
200164,959,熊素铭,2024-10-14 09:04:37,4,4,0,sb玩意一天到晚结合理论我结合nm呢结合。上课讲的b东西讲的明白么。这么爱拖课真服了，能拖一个小时sb老子澡称冯个福
200211,959,熊素铭,2024-10-15 02:28:20,4,4,0,私募的玩意
200372,959,熊素铭,2024-10-16 10:01:51,4,4,0,现在六点多刚下课
200503,959,熊素铭,2024-10-27 07:20:55,5,5,0,有点：讲的细，认真且有耐心的同学能学到很多东西\n\n\n\n缺点：典型的没有困难也要创造困难，没有问题也要制造问题，课堂上一个同学实验出现了问题，要把全班同学都叫过去一起看，讲课啰嗦，像是在给幼儿园小孩讲课，上一次实验课能布置两个实验报告，极度吹毛求疵，拖堂极度严重，要以“节（四十五分钟）”来计算拖堂时间
200577,959,熊素铭,2024-10-19 14:46:32,4,4,0,讲解没有条理，逻辑混乱，事情太多，不按照计划来，想怎么搞就怎么搞，说改就改。负责倒是真的负责。
200664,959,熊素铭,2024-10-20 15:42:18,3,3,0,老师挺负责，但是好像负责的点不太对，试图教会我们很多东西但是没有条理始终是竹篮打水一场空，上课拖堂严重，作业极其繁重且要求极其严格，老师出发点是好的但是能不能考虑考虑实际情况？如此繁重的作业和任务恐怕不能很好的达到最初的目的甚至可能直接打消学生学习的积极性。
200716,959,熊素铭,2024-10-21 09:06:45,18,18,0,这老师我是真绷不住了 这学期课上了一半我就要给她打低分了\n\n1.上课不知所云 看似很认真负责实际上全在做无用功 做了一堆没有用的破事导致每节实验课都拖堂\n\n2.明明这个课程有统一的实验报告模板不用 一定要自己整一个以显示自己的与众不同 把一份满分5分的实验报告分成几十个0.1、0.2、0.3分的条目 一份报告两个小时起步 \n\n我不知道她是不是觉得自己超级负责超级细致\n\n3.做个破实验能搞出一大堆提高要求 疯狂鼓励内卷 实际上做的那些东西有一些甚至只是她自己没搞明白的 让我们在上课时间帮她测几组数据而已\n\n4.发布作业极其不及时 本周三做了两个实验 要写两份报告 本来恰好周末学校开运动会三休想着正好能写掉 结果她迟迟不发布作业（因为她的模板跟别的老师不一样，必须要等她发才能做） 周末钉钉从周五到周日晚上一直未读 到周日晚上十一点把作业发布出来了 你这让我们什么时候写？ 周中都不用上课的是吗 下周末又有下周的实验报告 说不定又是两份
200719,959,熊素铭,2024-10-21 09:17:58,4,5,1,傻逼。。
201121,959,熊素铭,2024-10-29 05:09:23,4,5,1,纯傻逼
203487,959,熊素铭,2024-11-20 00:12:10,6,6,0,消息是不回的；发资料是前一天深夜泄洪的；上课是什么内容都不讲的；问问题是要鼓励我们思考，自己不回答的；上课任务都是灵机一现的；没讲过的东西是要我们硬做的；实验报告一定是要加很多提高要求的。纯坐牢。
203636,959,熊素铭,2024-11-20 08:15:14,2,2,0,弱智，不多说
206604,959,熊素铭,2024-12-16 11:47:14,3,3,0,就说一点，我上完熊老师的第一节电路实验课就下定决心换老师了，为了选别的老师我不惜调整了我的全部课表，现在在上王旃老师的电路实验1，数电实验部分无实验报告，学的很开心
207383,959,熊素铭,2024-12-21 05:44:25,4,4,0,你踏马脑瘫玩意能回个消息吗，脱一星期资料还不发，要考试了还布置作业。学习通你玩的明白吗你，作业自己都不知道放哪，玩个仿真软件自己都搞不灵清(≧▽≦)
207667,959,熊素铭,2024-12-23 15:15:05,3,3,0,考完了，说一句，电路与电子技术实验的学弟学妹，快跑，不然你会后悔的。
208073,959,熊素铭,2024-12-25 12:46:14,0,0,0,类似了
209646,959,熊素铭,2025-01-06 11:57:43,0,0,0,两年回看这个伟大的熊老师风评还是一如既往地差，本菜b欣慰的跑了，垃圾老师为何还在祸害人间啊，再送一个1分
209776,959,熊素铭,2025-01-07 05:12:35,3,3,0,老师还是挺好的，在做实验不顺利的时候会一起留下指导很长时间，线下对待学生也挺好，线上回消息比较慢，但回了之后会态度很好的解决存在的所有问题。最后还是很感激老师能有足够的帮助和关心让动手能力较差的我顺利完成这门课
210206,959,熊素铭,2025-01-08 11:11:05,0,1,1,工磁预置了这位的，先码住，下学期回来评价。。。。害怕。。。
212307,959,熊素铭,2025-01-14 01:15:11,1,1,0,电路与电子技术实验1拿了4.5，但我还是要为又臭又长的实验课和繁重的任务以及混乱的讲解打一分
212693,959,熊素铭,2025-01-14 13:28:05,1,1,0,讲课水平一般，不过最后一节课会列考试重点，复习了就没啥大问题
213461,959,熊素铭,2025-01-17 13:21:34,4,5,1,缺点是表达能力确实一般，经常讲半天大家都不知道该干什么（不过也和实验进度经常比理论课快，大家不懂原理有关系，老师确实讲原理讲的不清楚）。但其他的说实话感觉还行。不知道为啥大家都在喷0.1 0.1的给分制度，我感觉这样起码评分标准非常明确，做实验、写实验报告的时候目标也很明确，按部就班完成就可以了。期末mooc的答案网上搜搜都能搜到，期末考前会把每个题要考的知识点发出来，对着学就不会有太大问题。老师人也是比较认真负责的，必做实验大部分能在规定时间内完成（除了两三次课），你想课后拖时间做加分实验老师也会留下来陪你到六七点（这个班好像确实不太卷，除了刚开始几节课之外，做加分实验的人都不是很多）。加分实验有能力做尽量做，其实只要理论课学过，或者抱边上大佬大腿，加分基本都能做出来（如果没学过理论确实做不了）
218691,959,熊素铭,2025-04-29 03:25:31,5,5,0,没吃过屎的可以来上他的工磁，妈的上几节就发现讲的就是一坨，重点也没有，前面比lyl老师慢两三个星期的进度，然后又莫名其妙的持平，完全就是垃圾，每次上课写那几张恶心人的讲义不知道在干什么，要是啥也不干让我自己听lyl的网课我还给你打个3-4分，tmd一分都不想给
218781,959,熊素铭,2025-05-07 23:59:09,9,9,0,老师很用心，每节课都发讲义，几乎当堂发当堂收，还布置自己弄的作业题，以及实验预习的东西，这又要做那又要做又要收的。我只能说很适合当初高中老师。但是大学生上她的工磁，讲课水平.....，约束又多毫无自由，我只能说。（总所周知工磁无期中考，把作业截止到别的科目期中考当天的早八，连推迟几个小时都不愿意，哈哈）
218797,959,熊素铭,2025-05-06 03:49:40,1,2,1,觉得评分不公，评分太低的，建议无脑选这位老师😄
219118,959,熊素铭,2025-05-22 01:25:56,3,3,0,就是一泡臭屎
219591,959,熊素铭,2025-05-30 11:44:37,3,3,0,事情又多，讲得又烂
220195,959,熊素铭,2025-06-16 08:07:53,0,0,0,（数电实验，电路Ⅰ）老师事情比较多，但是很耐心。就是讲得有些不清楚，下课时间又比较晚。然后实验报告0.1的明确评分有个好处就是你只要写完了，就基本确定能拿到优秀了。并且问老师问题老师都会及时回复。顺带一提，如果选上熊老师的课了，建议第一节课加她的微信，她微信回复很及时（）另外老师其实能讲清楚课的，但是上课不知道为什么就是会讲得比较模糊，补实验的时候老师三下五除二就把实验要求说完了，绷。
220337,959,熊素铭,2025-06-17 10:10:30,0,1,1,工磁事情事情是真多\n\n但是最后发的讲义也是真神
220363,959,熊素铭,2025-06-17 13:14:55,1,1,0,神様だ！！
221937,959,熊素铭,2025-06-27 13:40:39,1,1,0,坐标25春夏工磁，仔细考虑后，给老师打个7分。\n\n一方面，熊老师十分敬业，对于教学方面投入了很多心思，她备课和上课的认真程度还是能够予以充分肯定的。但也正是由于过强的责任心，使得她的课堂约束和琐事颇多——每节课都有的她自己编的课堂讲义、考前两周密集布置的（同样也是她自己编的）作业题，单是这两个就已经把我们搞得苦不堪言。其实xsm的这种模式更适合高中教学，也就是手把手带着人学，保证学习的连续性，但是由于熊老师的讲课水平实在有待提高，以及这门课确实难，听课甚至不如对着李玉玲的PPT自学。因此，对于她上课的效果，我是感觉不佳的（其实我基本没听过），这也是扣分点。\n\n另一方面，不知道是不是22级先辈们对峙成功的结果，今年熊的表现相比去年先辈们描述的无恶不作的极端形象，还是有了很大的改善，没有再固定座位、动不动点名，上课也不再动不动提问奇怪的问题，平时的考勤基本就用讲义是否到堂提交、讲义整体完成情况等进行考量，只要把讲义好好写了、当场交了，平时分基本都是拿满的。2025的这次工磁期末还是比较难的，创新题也不少，但最后据我了解，xsm班的给分应该都还不错，老师还是会捞的。\n\n总的来说，希望老师能保持已改进的部分，并继续优化她的讲义模式（其实我觉得这个东西还是利大于弊的，想学的可以认真学，不想学的可以混一混，平时分也好拿），如此继续，风评可逆转矣。
49422,988,周浩,2017-04-12 02:35:40,2,2,0,写板书的老师不会差！
50300,988,周浩,2017-05-02 08:31:53,9,9,0,周浩真心是个好老师，就是他的新搭档陈向荣是个dashabi
76506,988,周浩,2018-04-12 02:04:16,1,1,0,嗯？？？
105514,988,周浩,2019-04-16 02:32:58,3,3,0,比陈老师好?
755,991,干于,2015-03-16 09:36:22,0,10,10,老师长得很帅，知识水平很高，上课有趣主要还是由于和我室友同名，于是过来点赞
3258,991,干于,2015-05-24 11:44:08,-10,4,14,讲课很清晰，很好懂
7021,991,干于,2015-08-29 01:33:16,6,9,3,对他不想说什么
10015,991,干于,2015-11-14 09:00:22,2,4,2,做实验基本还是靠自己
10026,991,干于,2015-11-14 11:44:49,1,5,4,给分还可以的...
10229,991,干于,2015-11-17 14:31:33,11,14,3,自己动手
10335,991,干于,2015-11-18 06:15:06,2,3,1,不知道为什么分有点低
13098,991,干于,2015-12-25 01:00:11,0,0,0,主要靠自己
13392,991,干于,2015-12-27 14:43:12,2,2,0,自己动手
17264,991,干于,2018-10-29 01:25:26,1,10,9,老师人不错哒～给分也很好。实验很有意思，也学到了很多，推荐！！！
21391,991,干于,2016-02-28 12:43:36,1,4,3,老师上课讲不清，很多自己都不了解，实验出问题问了也不知道怎么解决，经验不够
25808,991,干于,2016-06-08 14:20:07,12,13,1,只能说课程设置的不好，对电路和软件不熟悉的同学学起来有点吃力，但关键还只是一门通识而已。。坑啊
30809,991,干于,2016-07-02 14:14:01,2,5,3,老师上课讲的有点快，自己做的时间很多，需要多用心，实验报告也认真写，分数还可以的
33048,991,干于,2016-09-11 05:13:53,3,4,1,靠自己！全靠自己！
33074,991,干于,2016-09-12 00:28:59,20,25,5,呵呵，为什么我tm3.3
35885,991,干于,2016-11-10 08:41:31,6,7,1,老师，我真的不会连电路啊，你再怎么跟我讲原理我还是不会啊。。
35926,991,干于,2016-11-10 08:54:08,3,4,1,真的靠自己，上课一般讲的比较少，
36028,991,干于,2016-11-10 10:18:16,1,2,1,老师上课讲课还好，但电工电子这个课还是看自己的动手能力\n\n
36326,991,干于,2018-10-29 01:25:04,-8,5,13,电工电子工程实验的，上课好好学，作业简单而且不多，最后绩点可高了。
36433,991,干于,2016-11-13 12:22:23,5,9,4,分真低，第一节课直说正态
38683,991,干于,2016-12-14 11:24:17,3,6,3,作业好好做，绩点还低死，就是坑
45144,991,干于,2017-01-19 04:57:48,7,7,0,经常就没有实验报告了..  但是你报告写不好的话什么都白搭
47328,991,干于,2017-01-25 09:12:50,3,5,2,讲的偏少，强烈建议提前预习ppt
51634,991,干于,2017-06-07 16:40:13,-7,3,10,电工电子训练里算是比较水的，不会要你多做，适合不怎么了解电路来凑学分的，如果你是大神就别选了，一件事，动手能力不过，实验报告来凑，实验报告非常非常重要
59398,991,干于,2017-09-21 06:44:39,2,8,6,干老师是真的帅
59777,991,干于,2017-09-27 02:30:26,1,3,2,太啰嗦了。
60071,991,干于,2017-10-09 10:48:08,-3,1,4,老师有耐心
60344,991,干于,2017-10-18 02:01:37,3,6,3,看起来有点凶，但实际非常关心学生，问他问题也很有耐心!好老师!
61743,991,干于,2017-11-20 13:33:21,0,3,3,给我3.3分，大水课，不能选
65317,991,干于,2018-01-22 04:42:06,-1,5,6,实验轻松，给分好，长得帅，干老师的模电实验，你值得拥有
67678,991,干于,2018-01-22 04:56:02,-12,5,17,电工电子工程训练。本人工科，本来自己就想学。刚开始也不明白，不过小伙伴是大佬，前几次实验抱他腿。后来多画了几次电路图，复习复习，查查资料就跟上了，其实老师讲得挺清晰的，实验报告要求也很明确，不然大一萌新根本不知道要写什么。总之我喜欢，个人意见，仅供参考。最后满绩。
69801,991,干于,2018-01-25 11:58:50,-3,1,4,老师讲课认真，遇到问题也会各种帮你解决。至于学不会，要么是没预习实验，要么就是理论课没跟上
71625,991,干于,2018-01-28 17:58:04,6,9,3,绩杀 慎重点 兄弟
87190,991,干于,2018-09-21 15:35:33,18,19,1,给分是瞎给的吗！？
87209,991,干于,2018-09-22 12:47:58,-10,1,11,刚刚出了小学期绩点前来表白干于老师！老师人很好讲课很慢很细致（个人体验），布置的实验报告内容要求在我知道的里面不算多，强势感谢老师（｡ò ∀ ó｡）
87231,991,干于,2018-09-26 02:46:31,6,6,0,对学生有固定看法。
87426,991,干于,2018-09-29 01:19:26,-11,3,14,我是小学期的电工电子实习，强电部分我是认真听课的，主要是要看懂原理图和知道各个器件是什么，这个上课没听懂的话其实随便问问同学或者学长都可以。弱电部分画图的时候老师其实讲得很好的，关键你不能走神...一走神就不知道该怎么画了...然后焊电路板其实蛮简单，老师也说过关键是焊芯用量和顺着焊脚往上走。焊芯用量主要看接触时间，注意这两个关键点真的能焊好，最后那个示波器我没听懂，直接抄了后面同学的数据。老师对实验报告要求很少，真的很少。完全不需要恶竞，恶竞也没用。我就是只按照老师要求去做，其他一点没多写别的东西。五级制度最后4.5，大家自己看吧
89196,991,干于,2018-11-16 14:58:08,-11,1,12,老师挺好...但是能不能不要卡我绩哇！89不也是90以下的嘛…也符合正态分布的呀…哭辽
89199,991,干于,2018-11-16 15:23:22,-7,1,8,我一个没选物理的妹子上了工程训练课。 老师人很好很温柔会很耐心地讲解 在不会的时候老师一下就弄好了 太帅了?
89547,991,干于,2018-11-19 12:49:19,1,1,0,讲太快了。。。听天书。。。
91967,991,干于,2018-12-25 06:32:42,2,2,0,绩杀难受，
96272,991,干于,2019-01-20 15:51:12,1,2,1,主要还是课程本身的问题，老师是很好的老师
97535,991,干于,2019-01-22 10:12:04,0,0,0,讲的细致，解答问题也很耐心
102790,991,干于,2019-02-23 05:54:29,-8,1,9,讲道理自己不行不能怪老师，做的好了分自然高。老师给分很公道，指望一点不动脑经的还是不要选了
105654,991,干于,2019-04-18 02:43:35,7,8,1,电子电工概论是我上过最蠢的一门通识，早知道我同学退课的时候我也退了，最近闲来无事翻开查老师，特地补充这条评论
105986,991,干于,2019-04-24 04:40:57,2,2,0,呵呵呵
110794,991,干于,2019-06-28 08:35:22,16,16,0,实话实说，这个课你的付出绝对和你的成绩不成比例，说平时好好做，报告好好写然后老师给分好的只是少数的存在
110829,991,干于,2019-06-28 09:48:55,5,7,2,老师还是比较好，但我认真做实验和报告分还是很低
118996,991,干于,2019-11-09 05:12:00,3,3,0,烦，认认真真做实验写实验报告，反手给我一个3.3
121181,991,干于,2020-01-20 02:46:46,-7,1,8,辣鸡老师，上课讲一堆没有的东西，实验做错只会说一句“你高中物理没学过吗”，我高中要是会还要老师来上课？
121443,991,干于,2019-12-16 06:04:09,1,1,0,呵呵呵
122183,991,干于,2020-02-19 15:20:37,-2,2,4,我绩点3.6，我给自己打及格，给老师也打及格
124375,991,干于,2020-06-30 03:00:23,1,3,2,上的是模电实验，感觉礼貌点问老师，老师还是很热心地帮忙解答或者帮你找问题的，前提是你要认真做好预习工作，上课好好听。如果是上课强调过的东西，你再去问，显然没有听课，老师当然不乐意了。就是模电实验是五级制的，最高4.5，有点坑
125403,991,干于,2020-09-08 06:53:36,0,5,5,垃圾老师
130655,991,干于,2021-01-24 06:11:41,2,6,4,还好，认真点做绩点还行，电子电工训练实验报告图画画好，就算不是班里最好几个绩点上四应该不是太难。\n\n但老师人挺不错啊，很有耐心的啊，有一次电脑上的实验没做完，学生节那天中午去打扰他也没说啥啊。每次实验课，都是同学问这问那，老师都好好回答的，感觉评论里有些人是不是因为绩点低了，对老师印象都变了
133418,991,干于,2021-02-28 03:30:37,15,19,4,为了岩王帝君！\n\n       ————甘雨
136016,991,干于,2021-06-09 09:40:59,7,7,0,强烈建议学校改革实验课
136177,991,干于,2021-06-12 02:39:47,5,5,0,这位老师是只会打3.3吗？问了好多课友都是3.3就很离谱……
142561,991,干于,2021-11-13 09:42:32,-2,1,3,实验报告好好写，接线图好好画，虽然我的实验做得不太好，但老师给分不错！
142726,991,干于,2021-11-15 13:27:44,-4,1,5,给分很棒
146157,991,干于,2022-01-05 15:03:51,6,6,0,你就这么喜欢打3.3吗
148300,991,干于,2022-01-12 05:45:52,-4,0,4,模电实验，实验考炸了，感谢老师捞我
149896,991,干于,2022-01-17 15:30:29,1,6,5,老师本身比较佛系，模电实验事情比较少，对实验报告要求也不高，班级氛围相对来说不是很卷，实验有困难的时候也会亲自指导，体验还不错，就是模电实验这课又正态又五级制，整体给分就不太好
155550,991,干于,2022-06-14 08:34:37,-3,2,5,电工电子工程训练，一个班就14人，老师非常耐心指导我们做实验，理论讲解也很细致！超级好玩的通识课\n\n实验报告好好写，接线接整齐，给分不错的
181324,991,干于,2023-10-14 12:27:12,3,3,0,什么鬼老师做不来就‘高中物理没交’？这门课也是个鬼，实验报告要花挺多时间，没基础的人建议能逃则逃
182606,991,干于,2023-11-18 06:42:06,-4,1,5,老师上课讲解挺多，实验时对同学也一直在认真指导，只是对之前没有基础、动手能力不够的同学可能确实不太友好。给分不高？想水绩点的同学别来吧。反正我认认真真做完每个实验就4.2……感觉有被调分
182609,991,干于,2023-11-18 07:45:09,-3,0,3,老师非常友好亲切～课程是有难度的，组员之间沟通一下可能会好很多，当然还是要有一定基础的好，实验报告认真写，减少错误，上课不懂的地方多问，老师还是很耐心回答的，感觉投入和回报还是可以成正比的，给分还是不错的
182676,991,干于,2023-11-19 11:12:57,1,4,3,老师超级温柔有耐心，我一个大一的医学生上课一脸懵，自己动手啥也不会，后面几节课在电脑上操作更是会不了一点，但是每次老师都很关照像我一样做得慢的同学，做不完还会和我约时间去教室做，甚至还手把手给我的电脑装上了 Altium designer 软件！有任何问题钉钉私信他，全都是秒回！就问有几个老师能钉钉秒回？太帅啦！课上是真的学到东西了，我比较菜，大概是班里倒数的几个同学之一，但绩点 4.5，只能说爱惨干老师（最后提醒大家实验报告认真写，别拖，高分不累）
186645,991,干于,2024-01-12 10:08:49,-7,3,10,呜呜老师真的太好了，模电实验真的是每次都能让我自我怀疑的课，但是干于老师真的很好，问问题会很耐心的教（有时候会故意不说让我们自己动脑子，但最后如果实在想不出来还是会教的！老师和学生像朋友一样相处，哈哈会一起探究问题，如果时间再充足些，ppt再把要求细化一下，简直是理想的实验课（ppt不详细应该是要我们自己调试，不过上课时间真的太紧张了），焊电路板也超有成就感好吧，试音的时候我们几个人都很激动。好好写实验报告，平时操作有不懂的弄明白，平时多出点奇奇怪怪的问题对最后操作考试很有帮助！
186653,991,干于,2024-01-12 10:58:50,0,7,7,nt老师
186662,991,干于,2024-01-12 11:34:10,1,8,7,模电实验彻底结束了，来给老师打个满分。干于老师真的很好很耐心，模电实验报告要求应该是所有老师中最低的了，只需要你把实验讲清楚报告就能拿高分，没有什么感想之类的要求，而且也不需要进行实验仿真和做线上的学习，期中考试附近那几次实验甚至不需要交报告只需要交数据。总之，冲！
187026,991,干于,2024-01-14 07:41:36,-2,6,8,模电实验课主打一个耐心细致，只要愿意问老师总是能彻底解决问题。\n\n给分也很不错，平时实验报告认真写的话平时分就能拿很高了，期末操作题也不难。\n\n谢谢老师。
191768,991,干于,2024-04-30 03:57:51,-8,2,10,干饭于，是真的喜欢干饭，每次实验必提前两个小时讲完，提前一个小时下课，学生都没走完自己先去干饭。。。\n\n\n\n讲课水平在电院属于中等水平，干饭能力在电院老师中属于加分项，冲他每次提前下课这一点，本来打八分，现在给打九分。
193443,991,干于,2024-06-11 04:30:53,10,10,0,烂老师，纯粹的sb
193502,991,干于,2024-06-12 02:42:34,8,8,0,只能说从平时考查和期末考试来看，这个老师不适合任教任何五级制的课。选他就等着随机绩点吧
193666,991,干于,2024-06-14 15:12:34,13,13,0,统一解释一下评论两极分化的原因，仔细听这个老登的课就会发现这老登压根不备课，上去就是念PPT，PPT念不清楚要求提不清楚，还阴阳怪气“我PPT不可能写出全部要求，如果要你干嘛都写在PPT上，那......”\n\n\n\n事确实少，人是真垃圾，一点不关心学生死活，事少也不是为了学生考虑，纯纯楼下说的一样为了自己去干饭。。。楼下那b还把他列为“中等水平”，试问哪个理论课“中等水平”的老师敢一点课不备虚短虚断算不明白就敢上台去讲？业务能力极差，别人的模电实验事再多也多少能辅助正课理解，他的模电实验对正课半点帮助没有，教电院的学生跟教大一通识课一样，所有要求都不说清楚搁那故弄玄虚，问他还阴阳怪气。只能说学期中到考试一直拿不清不楚的要求折磨学生，就不要怪学期末学生拿1分教评折磨你
193741,991,干于,2024-06-17 06:52:54,10,10,0,真的是一个sb
196869,991,干于,2024-07-05 16:23:16,3,3,0,对学生有固定看法。
200743,991,干于,2024-10-22 00:52:19,5,5,0,依托答辩烂完了，你的PPT和别人的真的能比吗？
201107,991,干于,2024-10-28 17:32:37,8,8,0,与成绩无关，非期中期末出分时间，特意来查老师给gy一个差评。师者传道授业解惑倒是占一个啊!纯纯学生求学路上的阻碍。。。\n\n看了下面的评论，我都好奇是不是有老师和他重名。问问题是敷衍着回答的，一句话能敷衍过去的不会说第二句，问一点有技术含量的问题打个哈哈就能糊弄过去，真服了。钉钉私信是四个小时以上才回的，课程的群更是一点不看。实验前的准备“忘了说”，群里有同学问跟没看见一样，影响到了所有同学上实验课。唉，当初是哪些人在说他很好，快冲的啊。。。唉，就算我热爱模电实验，也经不起gy这么摧残啊。
201160,991,干于,2024-10-29 12:15:55,8,8,0,逆天老湿，任务多的一批，讲课速度还慢，讲的东西还少，回去写报告的时候对照课件写基本是写不全面的。平时钉钉是半天才回的，群里消息是不看的，回答问题是敷衍的，打哈哈就过去的。报告是难写的，花好几个小时写的报告就因为几个数据没有算（因为他的课件里没有让你测）喜提最低分，任务里做的东西是不够用的，写报告就知道任务少测量了一部分，那部分你要么瞎编，要么要别人的，要么等着扣分。总之它太逆天了，本来模电实验事情就多，干于还搞背刺，随便做的ppt整的我们实验数据少于报告要求，然后理所当然的狠狠的给你你用了几小时写出来的报告打低分。这就是我们干于老湿的教学态度，ppt是劣质的，币事是多的，答疑是不回的，背刺是经常的。
202309,991,干于,2024-11-11 11:48:23,2,5,3,似乎是有重名的情况，我上的模电实验没有遇到过老师提前一小时下课干饭的。就我上的这个老师而言，实验讲的还是比较清楚的，做不出来他会帮你慢慢查，最后考试的电路搞不好也能问他。拿了一个良好吧好像是，实验报告也没有给最低分的情况。看评论区严重两极分化，应该是有重名老师
202552,991,干于,2024-11-13 05:58:06,1,2,1,挠摊一样，报告给分特别逆天，你花心血时间写的报告很有可能给分巨低，而且扣分理由及其离谱。
202793,991,干于,2024-11-14 11:42:41,5,6,1,刚开始几节课感觉尚可，最近几节课逐渐感觉到逆天了，ppt上要求写不清楚，每次听完你讲课不知道自己要做什么，今天演示实验居然自己在讲台上卡了十分钟左右......
202953,991,干于,2024-11-15 11:04:46,0,2,2,烂完了，记得期末官方那个系统给他一分教评，都是刷查老师评分的B，牢光坠机了牢干怎么还活着，教学质量督察不查模电实验了属于是
205169,991,干于,2024-12-02 11:16:25,2,2,0,呵呵了，真别选，你不知道他的实验报告到底在要求什么
209363,991,干于,2025-01-05 15:19:55,-4,1,5,卡绩，别选！
209502,991,干于,2025-01-06 06:21:52,-6,0,6,干老师能干学生，能干饭，唯独不能干绩点
220050,991,干于,2025-06-14 07:19:49,0,0,0,老师中规中矩吧。PPT要求写得不清不楚，但你问他的话还是会给你认真解答的。
220194,991,干于,2025-06-16 07:56:41,0,0,0,评价一下，这个学期上下来，没有前面评论说的那么差劲。PPT中规中矩，但是任务其实还是比较明确的。相对与其它老师的教学班，干于老师的事情比较少，这学期也只写了三次报告（不过两个是带仿真的大报告）。然后的话不存在提前干饭的行为，同学电路什么的有问题老师会一个一个下来帮忙看帮忙处理。上课请假、报告迟交方面老师管的也很宽松。期末考试比较简单，这可能在五级制下不是特别友好，但是对于理论基础比较弱的同学比较友好。总结：事少人好。分的话在五级制下看你的班级卷度咯，尽量刷满分吧。报告分数问题也可以私聊干老师给你解答，他钉钉回复很及时的。
220786,991,干于,2025-06-19 17:34:28,0,0,0,模电实验。马上大四了，来补个评价。个人感觉这门课挺轻松的，报告老师明确说了前面几个部分（原理那些）不超过两页来着（好像是），避免了一些恶竞吧。只看关键结果，所以只要报告数据都有，基本上都没啥问题（报告满分要一些自己思想，这个挺难的，我没得到过，但是影响不大）\n\n然后干老师上的这门课压力其实很小，比电路实验一好多了，总体还是比较水的。（电路一上的是傅老师的，一些附加实验等等东西都挺多的，但是也有一些收获吧）\n\n至于两极分化的评论，不太清楚，感觉老师也挺好的吧，早八实验课经常迟一点，老师也没有很计较，一般还等一等。建议这种实验课都对照前辈的实验报告来做，这样不容易漏东西
2806,1036,吴浩,2015-05-08 00:42:01,3,5,2,想死胡言乱语\n\n
38340,1036,吴浩,2017-01-12 14:31:30,0,1,1,好！好！
63563,1036,吴浩,2017-12-07 02:34:57,8,9,1,这个简单，就是直接套公式……
100798,1036,吴浩,2019-01-27 00:55:05,4,4,0,还可以吧，按着PPT一直讲下去
104979,1036,吴浩,2019-04-01 13:52:46,4,5,1,念PPT，暂态讲的不怎么样
106361,1036,吴浩,2019-04-26 16:18:10,3,4,1,太差了讲不清楚，去听王老师吧
106392,1036,吴浩,2019-04-27 04:11:32,4,6,2,老师没用\n\n
110106,1036,吴浩,2019-06-23 04:56:36,0,1,1,暂态完全看运气，今年卷40个选择题80分，都是最基本的概念，计算题也非常简单，就一个计算机算法和一个欧拉法，老师给的历年卷合编里都有基本一样的原题
118948,1036,吴浩,2019-11-08 08:10:51,-2,4,6,老师很认真负责
172232,1036,吴浩,2023-04-23 04:29:34,1,2,1,吴浩老师我的神
172556,1036,吴浩,2023-04-29 20:21:41,2,2,0,你是我的神！
172557,1036,吴浩,2023-04-29 20:24:03,1,1,0,我只能说，吴浩牛的，跪谢
172870,1036,吴浩,2023-05-09 02:12:27,0,0,0,吴浩老师yyds！！！人巨好，分巨捞！
173044,1036,吴浩,2023-05-12 02:12:24,0,0,0,吴浩yyds 真的无敌
191576,1036,吴浩,2024-04-25 08:31:19,0,0,0,我感觉挺好
191909,1036,吴浩,2024-05-04 15:12:18,9,10,1,温柔吴浩微醺感
194169,1036,吴浩,2024-06-22 10:03:27,1,1,0,人还行，上课就念ppt，反正考得不难，但是会压分。
217414,1036,吴浩,2025-04-10 03:18:24,2,2,0,金句频出
217533,1036,吴浩,2025-04-12 12:10:16,0,0,0,虽然只见过老师一面（考场上，对不起没上过课），但是感觉老师非常萌，打个10分。。
25094,1040,吴建华,2016-05-05 08:24:53,3,4,1,老师很好。
56421,1040,吴建华,2017-07-03 17:03:17,1,3,2,很认真很可爱的老师，但是..给分真心低.......哭
61626,1040,吴建华,2017-11-19 10:31:51,-1,0,1,严格的好老师
81576,1040,吴建华,2018-07-05 12:37:11,2,2,0,老师人挺好的，也很有意思，就是这个课吧…emmmm
82536,1040,吴建华,2018-07-08 12:18:55,2,2,0,嘤嘤嘤
84914,1040,吴建华,2018-07-14 10:42:42,2,2,0,老师应该挺好的。就是课有点坑。。。
108450,1040,吴建华,2019-06-21 12:13:13,-11,5,16,开卷考试省省吧，真正要背的东西还没电力电子和电机控制多，老师最后一节课已经把考点讲得非常清楚明白了\n\n
109195,1040,吴建华,2019-06-11 12:37:16,19,23,4,一人血书此课开卷考试
156395,1040,吴建华,2022-06-19 10:38:42,2,2,0,老头退休快乐!
24167,1128,刘妹琴,2016-07-03 06:12:19,8,12,4,出分特别慢感觉很熬人，担心挂。
25572,1128,刘妹琴,2016-05-26 03:42:02,4,5,1,上课挺无聊的，没有废话
32107,1128,刘妹琴,2016-07-05 15:43:42,6,8,2,反正作为一个自动化专业的你也避不开妹琴老师了，祝你好运，买个好点的计算机，平时没事多算算矩阵求逆，上课听不听没关系，就算每节课背背公式也行，做到上面这几点，也不一定考好，还是看你算矩阵准不准。
51267,1128,刘妹琴,2017-05-26 12:07:21,1,3,2,很无聊，真的不行
57117,1128,刘妹琴,2017-07-05 14:37:25,4,6,2,上课就是照着课本读，典型古代应试教育失败产物，出的试卷计算量极其变态，根本让人来不及做，如果不会做导致考试失利我没话说，因为题太多做不完让人挂我表示很不能理解，完全不知道这种人叫来当老师干嘛。如果一年换一个老师授课我愿意为了选别的老师迟修一年，但是又绕不过这么一个人，让人绝望。\n\n
79229,1128,刘妹琴,2018-05-28 06:08:19,12,17,5,隔壁李超勇老师人超好，期中考超简单，自动化学生终于有了替代项
81737,1128,刘妹琴,2018-07-06 04:42:17,11,15,4,听说18年最后一道大题是刘老师出的，隔壁李老师班的学生特地前来差评
81751,1128,刘妹琴,2018-07-06 05:33:41,5,7,2,15级考完现控过来吐槽，刘老师出的最后两题，实在是恶心，题目没创新点，就是难算。\n\n    更气人的是，说最后两题是隔壁老师出的，自己做的事不敢担吗
84613,1128,刘妹琴,2018-07-13 10:22:40,6,7,1,能给你挂绝对不会给你过，基本不给学生留活路，此生遇到这样的老师，我很有跳楼的冲动\n\n
87697,1128,刘妹琴,2018-10-10 07:03:33,3,3,0,2018.10.10，可能挂了班里20%的人吧
87895,1128,刘妹琴,2018-10-17 05:49:52,2,2,0,气出心脏病
88743,1128,刘妹琴,2018-11-07 06:50:41,1,4,3,认真负责，上课严格
95897,1128,刘妹琴,2019-01-20 07:48:43,-1,4,5,严格负责，改作业一丝不苟，是个好老师!
114791,1128,刘妹琴,2019-07-11 17:43:26,5,5,0,恶心至极！
114841,1128,刘妹琴,2019-07-12 02:45:34,4,4,0,建议选李，不要选她
133788,1128,刘妹琴,2021-03-05 10:43:36,0,0,0,讲课很认真，像她这么高的职务还能讲得这么认真，感觉还是蛮难得的。\n\n当然，认真的另一个结果就是分数过于求是呜呜呜
135313,1128,刘妹琴,2021-05-08 04:28:53,7,7,0,论讲课风格，我认为她比隔壁班老师好。讲课十分详细，公式的推导什么的都能讲到，整节课没有一句废话，如果认真听的话，基本上在课堂就能把东西都理解了。但给分过于求是，基本没有调分，考试考的再差都直接按原成绩。对于考试，一道题如果思路对，只是计算错误，会扣掉1/3的分数，即使第一问算错导致后面都错也只会扣总分的1/3。考试最好采取高中模考的应试策略，遇到不会的题不要纠结太久，会导致后面会做的来不及做
23856,1268,沈海斌,2016-04-19 01:29:12,2,2,0,讲的mmqm
36428,1268,沈海斌,2016-11-13 11:58:06,0,0,0,渣体验
76780,1268,沈海斌,2018-04-23 06:29:00,0,0,0,一切看心情\n\n
77072,1268,沈海斌,2018-05-01 08:43:02,0,0,0,研讨课要求较高～
121363,1268,沈海斌,2019-12-17 17:40:07,0,0,0,无聊。
627,1279,孙盾,2015-03-15 08:34:07,93,98,5,孙老师上课真得很用心，她会记住每一位学生的名字，爱死她啦
1215,1279,孙盾,2015-03-21 16:43:06,24,27,3,好老师！耐心负责！
2441,1279,孙盾,2015-05-02 09:49:24,-12,9,21,任务超级多 占用时间特别长
4266,1279,孙盾,2015-06-18 12:32:43,12,14,2,真的好老师   上过课后还建立了长久的联系  这样的老师太难得
5005,1279,孙盾,2015-07-02 03:09:33,8,10,2,老师人很好，讲解题目思路清晰。给分也不错
5431,1279,孙盾,2015-07-07 11:58:38,18,21,3,认真负责，改卷神速，给分很好
5807,1279,孙盾,2015-07-09 12:39:22,-38,7,45,给分坑
5890,1279,孙盾,2015-07-10 00:01:15,6,9,3,耐心负责！深入浅出！
23967,1279,孙盾,2016-04-23 06:36:39,-41,3,44,讲的不好…课件很不清楚
23996,1279,孙盾,2016-04-25 01:04:23,2,5,3,好老师，不解释
26087,1279,孙盾,2016-06-15 15:13:49,-2,1,3,mhd
27268,1279,孙盾,2016-06-24 09:26:35,4,5,1,真才实学
28135,1279,孙盾,2016-06-28 08:09:08,8,9,1,特别负责的老师 给分也好 并且有意识锻炼学生思维
38005,1279,孙盾,2016-11-23 04:19:01,9,10,1,很好的老师，课后有qq答疑（只要@她就会给予解答），按照她说的去做就能拿高分^_^
46924,1279,孙盾,2017-01-23 02:31:22,16,18,2,出分前先给盾妈评论一哈\n\n人超级好\n\n上课很耐心\n\n而且会记住每一个同学的名字
47074,1279,孙盾,2017-01-23 14:17:03,12,14,2,老师人超好呀！讲课好！给分也好！老师是女神呀！！！！
47084,1279,孙盾,2017-01-23 15:37:44,8,9,1,很棒的老师！
47090,1279,孙盾,2017-01-23 15:59:12,10,12,2,从讲课到给分到关心学生说不出哪一点孙老师做得不到位，进入浙大以来遇到的最好的老师。
47091,1279,孙盾,2017-01-23 16:09:21,8,9,1,对同学的关心，上课逻辑棒，很有教学修养
47115,1279,孙盾,2017-01-24 02:20:25,20,21,1,还好没挂，浓浓师生情，谢谢老师，对不起。
47122,1279,孙盾,2017-01-24 02:54:16,8,9,1,真的好，给分也好
47127,1279,孙盾,2017-01-24 03:22:59,4,6,2,好老师不解释
47130,1279,孙盾,2017-01-24 03:36:21,2,4,2,盾妈妈超级负责讲的也很详细人超级好给分也好还特别有气质！简直完美！女神！
47489,1279,孙盾,2017-01-28 01:18:12,4,5,1,浓浓师生情！尊重学生的好老师！选上是福！
48190,1279,孙盾,2017-03-01 06:44:37,0,1,1,很棒的老师
48690,1279,孙盾,2017-03-09 12:16:46,2,3,1,可惜没有教数电
50504,1279,孙盾,2017-05-03 07:57:56,0,1,1,老师超级认真负责，满分好老师\n\n
50510,1279,孙盾,2017-05-03 08:18:26,0,2,2,老师认真负责，关心学生，给分也很好\n\n
50512,1279,孙盾,2017-05-03 08:29:11,1,2,1,就问了老师一次问题\n\n一直到期末考都还记得我名字！\n\n大学第一次碰到这么认真的老师\n\n给分也好
52437,1279,孙盾,2017-06-20 04:41:13,1,4,3,盾妈妈这样的女神我要一打！实验课一学期下来记住每个学生的名字，考试出了问题找人帮你查线，有好的设计主动同你分享，讲课的时候自信从容又有魅力，这样的老师谁能不喜欢
52527,1279,孙盾,2017-06-21 01:50:17,0,1,1,好，上课炒鸡耐心，会记住同学的名字，认真解答问题
52948,1279,孙盾,2017-06-24 03:42:14,0,1,1,老师超好人，会记住你的名字，会在qq群上解答你的问题，会亲自打电话给你告诉你刚才的实验是啥问题，最重要的是，老师给了我优秀！！！
52949,1279,孙盾,2017-06-24 03:50:35,0,1,1,非常耐心的好老师
60129,1279,孙盾,2017-10-11 06:04:49,0,1,1,盾妈讲课超好，非常有条理
61194,1279,孙盾,2017-11-10 13:50:17,0,1,1,孙盾老师是真的强
64484,1279,孙盾,2017-12-24 12:33:50,4,5,1,真真切切感受到了关怀。\n\n有种班主任的感觉\n\n讲课不错的，每节课都会留下来解决同学们的疑惑。\n\n客观的打分应该出现在出绩点之前
69352,1279,孙盾,2018-01-24 13:57:27,0,1,1,教的不能再好，第一次评分，是真的被老师感动到了！
69353,1279,孙盾,2018-01-24 13:58:35,0,1,1,很舒服
72615,1279,孙盾,2018-01-30 13:37:56,4,5,1,亲切温和，从容自信
72766,1279,孙盾,2018-01-31 05:09:12,0,1,1,我是真的爱孙妈
73054,1279,孙盾,2018-01-31 22:00:55,24,25,1,真的很幸运能跟着孙老师学习了电路与模电，ppt做的很清晰，虽然有一个研讨题和一个报告比较费时间，但是做出来的话真的能学到好多，而且老师人真的很好，真的会去记住每个同学的名字，还会嫌打字说不清楚而给你打qq电话。我说这么多的原因是，希望有幸能选上老师的课的你们啊，好好听课，别再掉队让老师操心了。
73605,1279,孙盾,2018-02-02 05:35:53,1,2,1,很细致，很负责！虽然平时安排的作业有些多，但看得出是真的想提升我们的思维能力。模电很难学，诸位还要努力的！
75469,1279,孙盾,2018-03-12 07:22:54,2,3,1,这样的老师不给十分对不起我的良心
76592,1279,孙盾,2018-04-16 04:45:55,0,1,1,第一次课：有些同学期中考如果只考了90，那么会影响你满绩。\n\n孙妈是真的很厉害了，很多东西说的很细，让人去懂这些管子的内部的东西，去理解，给你打电话给你解释题目，很关心同学成绩，很担忧他们挂科，各种过程监督，真的是很像高中老师，这门课似乎是没法补考的，一年一次，以后去了玉泉再来重修什么的都不方便，老师是真的很关心同学了。下面有人提到是这样的：这课5.5，你这学期必须把最大的精力放这门课，模电对于工科太重要了，后面的模拟电路真的挺麻烦的。 这里想说下本垃圾模拟电路那块，第一次听课基本都是没听懂，真的难，后来去问老师，老师说没事的很多人上课的时候都是听不大懂的（似乎是说第一次听懂的没几个？，得回去多看，真的有时间建议预习。反正平时不多看期末肯定挂的，课后还是要放很多时间
78329,1279,孙盾,2018-05-11 02:13:58,0,1,1,孙盾老师对同学对自己都是高要求的，会及时答疑，是很负责任的老师了。跟盾妈这学期学的电网络是很愉快的体验~
78338,1279,孙盾,2018-05-11 03:13:36,1,2,1,老师真的炒鸡温柔，上课讲的很清楚!只要你认真听!课后完全可以不复习就能做题，作业量也不大，真的很棒棒了!给分还非常好!希望能再选老师的课!!!
78349,1279,孙盾,2018-05-11 04:11:55,0,2,2,考的不好只能怪自己
78352,1279,孙盾,2018-05-11 04:34:38,0,1,1,盾妈真的超好，人也很耐心，非常关心学生，总之很棒很好的老师
78364,1279,孙盾,2018-05-11 06:37:29,1,2,1,抱歉成绩配不上老师的优秀。
78453,1279,孙盾,2018-05-12 03:33:47,0,1,1,小班教学也无所谓点不点名，老师总能记住同学们的名字。想要刷绩点的，选盾妈的课最棒了。
78919,1279,孙盾,2018-05-17 01:53:54,-3,1,4,舒服了
89443,1279,孙盾,2018-11-19 07:05:41,8,9,1,如此这般的好老师?
93219,1279,孙盾,2019-01-26 12:55:37,35,39,4,期中考了66之后感觉要死了，在老师的鼓励下下学期更加努力了，最后终于上四了，感动！特别好地老师！
93679,1279,孙盾,2019-01-11 12:48:08,12,14,2,默默地把夸盾妈的全都赞了一遍。\n\n业界良心啊啊啊啊啊啊啊啊啊！！！！！！！！！！本来秋学期忙的要死电路原理炸了，下学期模电差点没信心，在盾妈的强力扶持下，真的是越学越轻松！         我做个比较吧，盾妈这学期有一次出门找一个老师代课，那个男老师看上去至少交了30年书吧，也不能说人家讲的不好。就是觉得，照盾妈来说，emmmm……反正大家都有点不适应，还好盾妈上节课多讲了一点，下节课又稍微回顾了一点嘻嘻嘻(♡˙︶˙♡)\n\n表白我盾妈！
95348,1279,孙盾,2019-01-19 08:48:46,4,5,1,出分之前来赞一波盾妈
99595,1279,孙盾,2019-01-25 03:59:30,3,5,2,盾妈行行好，求求您调分。
100623,1279,孙盾,2019-01-26 12:37:25,7,12,5,这学期最幸运的事，选上了孙盾老师的模电！如此这般，这样难的一门课，碰上这样好得一个老师，超满足！感恩，谢谢老师！\n\n我们手中没有擦去困难的橡皮，只有战胜困难的笔！\n\n日拱一卒无有尽，功不唐捐终满绩！
104514,1279,孙盾,2019-03-22 05:58:31,0,2,2,真诚地对待每一位同学
105085,1279,孙盾,2019-04-03 10:43:08,10,12,2,进浙大以来听过最好的老师，没有之一
106972,1279,孙盾,2019-04-30 13:12:03,0,2,2,老师讲的特别好，上课语言生动活泼，还会用很多的四字词语哈哈哈哈。每次实验都会让做完的同学帮助其他同学查线，有问题孙盾老师也会很耐心地回答。电网络本身也不难，在孙老师的指导下好好学，绩点肯定不会低哒
106974,1279,孙盾,2019-04-30 13:18:49,1,3,2,精妙绝伦，语惊四座。把电路分析得淋漓尽致。哇，然而老师好优秀，是我太菜啦
106979,1279,孙盾,2019-04-30 13:49:45,0,2,2,很棒很负责的老师啦
107564,1279,孙盾,2019-05-06 16:36:52,1,3,2,上课就像老司机一样熟练！电网络理论课真的赞！
107827,1279,孙盾,2019-05-10 07:29:10,1,3,2,超级棒的老师 上电网络的课也是绘声绘色\n\n实验课会有拓展内容 也并不是很难 做完超级有成就感 问答群里总是很耐心很及时的回复 爱了！
108641,1279,孙盾,2019-05-30 07:23:04,0,2,2,讲的真的好，像高中老师一样
109263,1279,孙盾,2019-06-12 11:49:59,0,2,2,这学期上老师模电实验课，虽然这学期模电没怎么认真学，但竟然能感觉到老师讲得很好
110067,1279,孙盾,2019-06-22 06:05:07,2,4,2,老师很用心，超级认真！！对于模电实验，就算理论学的不怎么样，老师实验课时候给的理论介绍会让你有恍然大悟的感觉，然后可以借机弥补理论课的不足哈哈！！就很棒的，超级nice！！不过嘛，实验报告多了点hh，但多写写实验报告，就会发现理论课的东西很多就能理解了！！反正吹爆就对了！！
111004,1279,孙盾,2019-06-29 05:41:36,1,3,2,模电课没上懂，模电实验上懂了，神奇的体验！老师非常nice，很温柔很耐心，就是报告内容多
120314,1279,孙盾,2019-11-28 06:56:08,1,3,2,啊 我盾化了！
121744,1279,孙盾,2020-01-21 11:57:23,2,4,2,超温柔！学电路一时间适应不过来，但盾妈真的太好了，学模电的时候慢慢找到方法超级爱盾妈
123275,1279,孙盾,2020-05-28 02:56:10,2,4,2,上了数电之后，极度想念盾妈
125744,1279,孙盾,2020-09-14 02:24:36,-26,5,31,复习一晚上满绩了，10分 感谢盾妈！
126470,1279,孙盾,2020-09-28 01:55:33,1,4,3,盾妈的模电课真的是在教你魔法，用魔法打败魔法，我这种反应慢的都可以听的很明白！
129569,1279,孙盾,2021-01-07 14:01:00,1,4,3,能在模电实验听懂模电课听不懂的知识，不愧是盾妈
129952,1279,孙盾,2021-01-14 05:39:43,4,7,3,吹爆盾妈
130157,1279,孙盾,2021-01-18 07:56:21,44,48,4,没有擦去困难的橡皮，只有写着坚持的笔。——盾妈
132574,1279,孙盾,2021-02-02 11:35:48,0,2,2,盾妈这样热爱教学、关心学生的老师，请再给我来一打！
135026,1279,孙盾,2021-04-27 09:50:11,0,3,3,盾妈完美地诠释为人师表所应有的谦逊、负责和热情，课程终了，难得的感觉很不舍。
135242,1279,孙盾,2021-05-06 16:19:00,0,3,3,感谢老师，给分很好，平时很亲切温柔，会记住学生的名字，把每个人都放在心上，非常负责任， 谢谢老师！
135485,1279,孙盾,2021-05-11 09:07:29,1,4,3,我愿称盾妈为浙大最棒老师
135994,1279,孙盾,2021-06-08 11:42:45,0,3,3,孙老师真心是好老师，爱她呜呜呜
138435,1279,孙盾,2021-07-09 07:16:36,1,4,3,一位真正关心学生的好老师，钉钉私聊会认真回复，上课会记住每位同学的名字，还会记住你平时的实验情况，留意你的每一项学习表现。模电的好多知识都是在盾妈的模电实验课上学的哈哈哈，可想而知老师的模电课肯定也很棒！！好课，好老师，盾妈yyds
141831,1279,孙盾,2021-10-27 07:08:12,0,3,3,乐乐乐乐耶写～满分老师！
143218,1279,孙盾,2021-11-21 14:30:50,0,3,3,各方面完美，尽心尽力的好老师
143837,1279,孙盾,2021-12-08 07:03:18,-10,4,14,差不多得了
144103,1279,孙盾,2021-12-17 14:54:09,0,3,3,yyds
147293,1279,孙盾,2022-01-09 12:18:22,14,15,1,更喜岷山千里雪，三军过后尽开颜！
147541,1279,孙盾,2022-01-10 08:00:01,3,4,1,yyds，钉钉电话警告[doge]
147608,1279,孙盾,2022-01-10 09:37:40,1,2,1,盾妈很棒，上课也很好，讲的非常清楚，认真负责，只是我太菜，辜负了老师
149008,1279,孙盾,2022-01-14 06:35:08,1,2,1,真正为学生着想的好老师，希望能捞下我
149589,1279,孙盾,2022-01-16 05:18:21,2,3,1,盾妈yyds
149879,1279,孙盾,2022-01-17 12:46:49,6,8,2,盾妈wwwwww
149882,1279,孙盾,2022-01-17 13:09:44,23,25,2,谁说站在讲台上的不是英雄
149890,1279,孙盾,2022-01-17 15:13:16,10,11,1,来浙大学习一年半了，找不出其他任何一个老师，像盾妈一样，这么认真负责地对待自己的课程、对待自己的学生。人好，讲得好，给分也好，给10分是因为满分只有10分。
149893,1279,孙盾,2022-01-17 15:21:19,4,6,2,不能再好，知识收获满满
149905,1279,孙盾,2022-01-17 16:27:43,11,12,1,盾妈yyds！！她真的不想放弃任何一个同学，包括她的模电实验课，为了同学有时候午饭都吃不上。还跟我们说学生在挂科边缘她也很难受很痛心，甚至为此睡不好觉，还会打电话给每一个出问题的同学，就是想抓紧同学别掉队。盾妈真的诠释了什么叫爱生如子。
149914,1279,孙盾,2022-01-17 17:50:40,50,50,0,我就说一个细节\n\n某次问老师题，老师直接打电话过来跟我讲题，提到一个知识点时，我说没有这个概念，然后她说她在哪节课哪张课件上讲过这个，我才反应过来\n\n我以为她要说“哎呀我都讲过了你怎么没记住啊”\n\n她却说“哎呀这里我是不是没讲清楚啊，怎么没给你们留下深刻的印象”\n\n在我遇到的所有老师中，她是唯一一个因为学生的问题反思自己而不是批评学生的老师\n\n当然我认为老师没有什么需要反思的，她讲得十分完美
150126,1279,孙盾,2022-01-19 08:32:26,7,8,1,盾妈是我上大学以来碰到的最好的老师
150145,1279,孙盾,2022-01-19 10:22:11,16,17,1,盾妈：轻松玉快～
153432,1279,孙盾,2022-04-29 12:08:47,4,6,2,能上到盾妈的课，是我的荣幸。她真正做到了用大学的授课方式给我们夯下高中般扎实的基础。最后考试不够理想完全是自己没有复习充分的结果，但是有盾妈教的体系在身，日后复习起来是非常快的
161460,1279,孙盾,2022-11-07 06:26:04,2,2,0,盾妈yyds
163406,1279,孙盾,2022-12-14 08:28:28,2,2,0,妈妈！！！希望期末能拿个还不错的成绩QAQ
168698,1279,孙盾,2023-02-21 06:50:30,3,3,0,好亚撒西的妈妈，没选上她的课真的很可惜TT（但是没选上的同学也可以去蹭课问题什么的！孙老师赞赞赞）
169514,1279,孙盾,2023-02-26 14:46:15,1,1,0,孙盾老师，捞捞，我再给你好多个10分
169543,1279,孙盾,2023-02-27 01:17:15,2,2,0,求盾妈捞捞，我也给了你10分（不过老师确实就应该是10分，模电最好的老师，没有之一）
169713,1279,孙盾,2023-02-27 13:11:11,2,2,0,秉承求是精神，浙大好老师！
169824,1279,孙盾,2023-02-28 05:14:28,1,1,0,10分，上课非常尽心尽力。\n\n\n\n\n\n应该快出分了，求老师捞捞。
169889,1279,孙盾,2023-02-28 08:41:57,4,4,0,盾妈真的好好！讲课节奏把握得很棒，上课跟着她听课后认真完成作业就可以学好模电了！盾妈还超敬业，会检查笔记的梳理，梳理不限制形式，但是对掌握知识点超有帮助！最后就是盾妈给分也很好，只要认真完成盾妈交代的任务就可以拿到一个很棒的绩点了！而且盾妈真的对每个人都很负责，每次作业都会催着没交的人交。
169891,1279,孙盾,2023-02-28 08:49:07,4,4,0,盾妈为什么是神，在谈论这个问题之前，我想先说说（以下省略500字）。
169949,1279,孙盾,2023-02-28 15:10:42,7,7,0,评分下9.9是对盾妈的大不敬
169950,1279,孙盾,2023-02-28 15:12:52,1,1,0,盾妈！！！太感动了，大学以来最负责的老师！！！模电认真跟着盾妈学一定能获得好成绩！！
171352,1279,孙盾,2023-03-22 07:37:54,4,4,0,建议考途搜题
171937,1279,孙盾,2023-04-13 03:28:00,2,2,0,盾妈是真神，但我是真菜，因为疫情提前回家在家里摆烂，导致模电学的一塌糊涂，很对不起盾妈和自己
172881,1279,孙盾,2023-05-09 04:21:04,1,1,0,有不会的钉钉电话直接打过来，讲到你听懂。只可惜我的模电理论课不是盾妈的
173900,1279,孙盾,2023-06-04 08:16:57,1,1,0,真的好
174271,1279,孙盾,2023-06-08 13:34:18,0,0,0,好好好好好
174521,1279,孙盾,2023-06-13 15:15:22,9,11,2,认真负责，教的不错\n\n略啰嗦\n\n比较喜欢打破砂锅问到底\n\n鼓励同学互帮互助\n\n打电话压迫感很强\n\n任务量比较大 鼓励恶竞\n\n给分有托底\n\n说实话上她实验课比较折磨
176125,1279,孙盾,2023-06-28 01:24:09,2,2,0,谢谢盾妈的教导，她模电实验真的教的非常用心，关心每一位同学，平时有问题在钉钉上问都及时回答（通常打钉钉电话），最后考试为了大家顺利结课也会提供帮助，总之无脑选盾妈就对了。
182808,1279,孙盾,2023-11-20 10:43:48,2,2,0,妥妥十分
183663,1279,孙盾,2023-11-28 08:30:28,2,2,0,我何德何能选到孙老师的课
183978,1279,孙盾,2023-12-05 08:44:30,1,1,0,十连三金不一定能证明你的运气，但是选到孙盾老师的模电课可以\n\n神
185456,1279,孙盾,2023-12-29 13:57:27,0,1,1,选上盾妈的课耗尽了我一学期的运气
187163,1279,孙盾,2024-01-15 01:44:28,0,0,0,真的很耐心
188340,1279,孙盾,2024-01-18 16:18:43,0,0,0,出门前给盾妈打10分
188720,1279,孙盾,2024-01-19 16:41:47,0,0,0,盾妈评分不是十分我都觉得于理不合
188973,1279,孙盾,2024-01-21 03:25:30,0,1,1,感谢老师，感谢模电
189025,1279,孙盾,2024-01-21 09:40:46,3,3,0,好老师，十分\n\n但是超级关心学生以至于记住所有学生的名字，并且会一对一约谈，并且上课会叫你名字来回答问题，会让人感觉很不好意思，考差了会有于心有愧之感哈哈哈
189980,1279,孙盾,2024-02-05 10:37:26,0,0,0,老师很好，谢谢老师
190863,1279,孙盾,2024-03-22 05:05:30,2,2,0,我爱你\n\n妈妈！
191186,1279,孙盾,2024-04-11 03:09:46,1,1,0,好老师，不多说
191893,1279,孙盾,2024-05-04 04:21:05,0,0,0,好老师不解释
191962,1279,孙盾,2024-05-06 10:16:09,0,0,0,好老师，无需多言！
192843,1279,孙盾,2024-05-31 03:30:09,0,0,0,超级超级好
193322,1279,孙盾,2024-06-06 09:10:53,-7,3,10,事太多。。。
193960,1279,孙盾,2024-06-21 06:05:41,3,3,0,任务比较多，然而这就是模电\n\n上课水平和敬业令人惊叹的老师\n\n神中神
199178,1279,孙盾,2024-09-18 15:51:24,4,4,0,外专业问盾妈问题依然很认真，当然盾妈也一眼看出我没选她的课hh，可见盾妈对待自己班是多么负责！
199601,1279,孙盾,2024-09-26 07:39:28,-6,4,10,过誉。。语速有点慢\n\n不过补充的思考题质量挺高的
200088,1279,孙盾,2024-10-12 17:25:15,0,0,0,好老师！
200321,1279,孙盾,2024-10-16 03:35:09,3,3,0,已经毕业了再回来评价，大学四年，没有其他老师能接近盾妈的用心，也比不上盾妈讲课有条有理，深入浅出。真正的师者。
201266,1279,孙盾,2024-10-31 02:15:41,1,2,1,为什么不是10.0？？？
203313,1279,孙盾,2024-11-19 05:37:00,4,5,1,苯人非电类专业，选不上盾妈的模电所以选了zxt的，然后日常听盾妈的智云，有一次在宿舍里外放了，一个室友直接说：这绝对是个好老师，语速很合理，能给人留足思考的时间\n\n总之听盾妈的智云真的让我学习新知识的压力小了很多，毕竟讲课真神\n\n另外盾妈是真的爱穿红色衣服（几乎每节课都是这么穿的）
203339,1279,孙盾,2024-11-19 08:29:36,0,0,0,盾妈 伟大无须多言
204660,1279,孙盾,2024-11-27 08:29:02,0,1,1,盾妈人超好，素未谋面却深得帮助。
205475,1279,孙盾,2024-12-07 09:53:26,1,1,0,终极无敌好老师
207175,1279,孙盾,2024-12-19 14:41:27,1,1,0,最后一节课前排合影，现在来补个高分\n\n\n\n老师在你上课睡觉时会看着你，不过我还是睡着了(bushi\n\n\n\n讲课平心而论很好，睡着是我自己没休息好，给老师道个歉\n\n\n\n电网络期末突击还挺有用，本来后面基本跟不上，补天之后盾妈捞到4.5了
207427,1279,孙盾,2024-12-21 14:02:13,3,3,0,非常好实验课 使我电路板旋转
208759,1279,孙盾,2025-01-01 11:01:34,2,2,0,伟大无须多言\n\n电类基础课很重要，遇到认真负责的老师就很好。不必在这里提个性与自由，基础不牢地动山摇。\n\n盾妈非常细心与贴心，讲题极其仔细有耐心，十分送上。
211402,1279,孙盾,2025-01-11 10:32:26,0,0,0,还没出分先来评价，盾妈是真正关心同学、认真负责的老师，讲解非常细致清晰，上浙大以来最好的老师之一，拥有盾妈是浙大的荣幸！
211721,1279,孙盾,2025-01-12 09:10:16,0,0,0,超级好老师，虽然没选上盾妈的课，但是跟着盾妈的智云学完了模电，真的豁然开朗了！
213080,1279,孙盾,2025-01-16 03:01:42,5,5,0,盾妈没得说，讲的确实不错，给分也很捞，而且只要成绩好充分给予你自由空间\n\ntips：本学期有三次点名和三次学在浙大课堂练习，还是不要随意翘的好
213589,1279,孙盾,2025-01-18 12:04:41,1,1,0,盾妈伟大，无需多言\n\n上大学以来最负责的老师，讲课清晰，关心学生，钉钉消息20min内基本必回
213650,1279,孙盾,2025-01-19 00:19:28,1,1,0,电路和模电，讲课都比较清楚，改卷手也比较松，给分不错，会点名和线上小测，但是老师说了不计入平时成绩，是为了督促我们来上课。冬学期明显来上课的同学变少了，还是挺让老师心寒的。模电只学半学期，个人觉得进度很赶，即使是盾妈我觉得上课仍有一些没讲透的地方，更不用说很多地方都没学，不知道为什么要把电路和模电合成一门长学期课，完全可以大一下学电路，大二上学模电啊。
217727,1279,孙盾,2025-04-15 14:06:24,3,3,0,伟大，无需多言
220052,1279,孙盾,2025-06-14 08:02:20,1,1,0,模电实验工作量有点多 但给分无敌 好么！！！
220962,1279,孙盾,2025-06-20 13:18:36,0,0,0,教学能力卓尔不群，非常好非常负责的老师，选上这辈子有了！
221915,1279,孙盾,2025-06-27 11:38:13,0,0,0,模电实验任务量略多，本学期更换仿真软件之后老师在仿真软件的使用讲解上也花了不少功夫，老师对实验报告要求还是比较严格的\n\n就是这期末考真的没绷住，两个操作题以至于最后全员被迫打加时赛😅
222079,1279,孙盾,2025-06-29 12:39:30,0,0,0,有耐心 好老师\n\n事情略多 报告任务和实验任务比较多且要求严谨\n\nbme慎选，感觉被电气爆杀
45942,1298,王维维,2017-01-20 09:34:12,0,1,1,课水，给分差且随意，真的不建议选硬件描述语言。凭我的能力（py的数字系统我拿4.9）绝不可能只得4.2的。
55141,1298,王维维,2017-07-01 01:55:06,0,1,1,这老师真的是巨恶心的
57543,1298,王维维,2017-07-27 02:51:19,0,0,0,www~
70626,1298,王维维,2018-01-27 10:00:58,0,0,0,别选Verilog，别选Verilog，别选Verilog，重要的事情说三遍。大程熬夜写三天，感觉自己很膨胀，最后考试开卷考，考完大家全都觉得要满。然后一看发现全是3.3
84732,1298,王维维,2018-07-13 16:08:30,0,1,1,巨恶心，老师给分超级求是，AI考试全班第二，平时成绩全班最高还是没能满绩，94分就是不肯调。其他考的不好的同学就很同情他们。不想这么求是的分数还是去另一个班吧。诶。
787,1319,蔡忠法,2015-03-17 02:48:41,0,20,20,讲的很好，很清楚是个好老师
2403,1319,蔡忠法,2015-04-29 04:14:13,-12,7,19,讲课超级无聊，做实验巴不得你早点走，教学死死的
8807,1319,蔡忠法,2015-09-28 05:22:57,-1,5,6,无聊死了
9542,1319,蔡忠法,2015-10-29 12:56:42,12,20,8,感觉老是呆萌的，有时候蛮幽默
14440,1319,蔡忠法,2016-01-07 06:17:48,-9,3,12,如果一个电路老师说话分不清1和e也就算了，他居然分不清r和i。。。
17636,1319,蔡忠法,2016-01-20 14:08:18,42,46,4,老师很呆萌，蠢蠢的，讲课讲的很细，作业不多，期中考试题量也少
21358,1319,蔡忠法,2016-02-28 08:02:13,1,3,2,一般。上他的课很容易瞌睡。。。
21388,1319,蔡忠法,2016-02-28 12:41:32,0,3,3,我一直睡过来的，老师上课会点人上去写解答过程，每次都吓死我，上课不让水手机
22363,1319,蔡忠法,2016-03-04 02:38:40,-19,1,20,讲课很细致，就是不太帅。\n\n
28720,1319,蔡忠法,2016-06-28 12:58:55,29,33,4,真搞不清那些给低分的人什么心态，法法人超好的，课件做得好，不听课看课件自学完全没问题，当然上课听就更好了，讲得超清楚。他的期末复习课超好，讲什么考什么，真良心老师。
32616,1319,蔡忠法,2016-07-08 05:08:53,0,2,2,明明就很无聊
37018,1319,蔡忠法,2016-11-17 06:39:23,0,1,1,无聊无聊
39086,1319,蔡忠法,2016-12-21 05:07:48,-1,0,1,至少三个字
39394,1319,蔡忠法,2016-12-22 11:41:19,1,2,1,老师很呆萌，讲课也特别详细，有时还很幽默
42878,1319,蔡忠法,2017-01-15 10:38:15,0,2,2,讲得可以\n\n强行被正太心痛
44993,1319,蔡忠法,2017-01-18 18:06:45,3,3,0,老师挺好的，不过我总要睡觉，复习课讲什么考什么
45946,1319,蔡忠法,2017-01-20 09:38:47,2,2,0,讲的挺细致的，只不过下午容易睡觉。。
46242,1319,蔡忠法,2017-01-21 04:37:15,4,4,0,老师人很好，解答问题非常耐心，作业不多，PPT条理结构都很清晰，就是讲课语调有点单调，有时候会点名都黑板上写题目。总之个人觉得老师很不错。
46779,1319,蔡忠法,2017-01-22 10:02:11,2,3,1,老师很不错啊，实验课讲的虽然慢了点但是很仔细
48834,1319,蔡忠法,2017-03-14 08:06:24,2,2,0,老师人很好，有一点口音，但是讲得很清楚很详细。PPT尤其做得好，虽然法法基本上就是讲PPT内容。
50473,1319,蔡忠法,2017-05-03 05:45:20,2,2,0,老师人很好的，可能说话不太清楚，但是讲东西都讲得非常透彻，好评！
57077,1319,蔡忠法,2017-07-05 12:28:29,2,2,0,满分好老师\n\n
57136,1319,蔡忠法,2017-07-05 15:47:04,9,10,1,好老师！说话声音小，但是不讲废话，能把原理讲通讲透而且易于理解，毕竟也是教材编写人，问题他都看不超过5秒就给你解答，神一般都人物，想学好，稳妥的模电建议是坐前三排，一定要仔细听，作业自己做，不要抄，能想起的暂时就这些了！
57170,1319,蔡忠法,2017-07-06 01:04:19,-5,1,6,有点严厉
59976,1319,蔡忠法,2017-09-29 11:32:24,0,0,0,有趣。\n\n
72152,1319,蔡忠法,2018-01-29 13:12:53,2,2,0,老师上课讲的很细致\n\n有时候也会很逗\n\n很稳的老师
72160,1319,蔡忠法,2018-01-29 13:50:04,1,1,0,呃呃呃，法法hin可爱，课讲得也很好。模电的学分很高啊，大家只要认真听一定会爱上法法的
72197,1319,蔡忠法,2018-01-29 14:17:01,0,0,0,老师讲的很好，给分也很好，就是最后需要多练练题，不能只看ppt
72198,1319,蔡忠法,2018-01-29 14:19:05,2,2,0,超爱法法的，厉害又呆萌，讲课清楚PPT帮助也很大，表白
72201,1319,蔡忠法,2018-01-29 14:27:55,2,2,0,老师很耐心，讲的很清楚，只是可能对于大家来说第一次有点难理解。课件很棒
72202,1319,蔡忠法,2018-01-29 14:28:41,1,1,0,老师真的很好的，讲课也清楚，而且给分很不错的
72206,1319,蔡忠法,2018-01-29 14:31:43,7,7,0,一百婚一百婚！讲得不错而且给分很宽容  重点是 超级呆萌！
72208,1319,蔡忠法,2018-01-29 14:35:01,4,4,0,千言万语一句话：谢法法给过之恩
72212,1319,蔡忠法,2018-01-29 14:37:52,1,1,0,超级爱法法，人特别有耐心，认真听课收获很大，给分也很感人
72313,1319,蔡忠法,2018-01-30 01:37:19,1,1,0,老师讲得很细致，偶尔会说一些老梗哈哈哈哈\n\n
75339,1319,蔡忠法,2018-03-09 04:01:18,0,0,0,老师真的讲得很细呀，超级喜欢老师。
81421,1319,蔡忠法,2018-07-08 13:31:19,1,1,0,模电出分啦！再次感谢老师！！
81537,1319,蔡忠法,2018-07-05 10:28:09,5,5,0,都把题出的这么可爱了，就给十分吧！有些许希望不挂科
82578,1319,蔡忠法,2018-07-08 14:38:59,9,10,1,法法应当是9+老师！出分了来贡献自己的力量。因为是教材编者之一所以听课和看书巨舒服！平时上课一本正经的卖萌，讲题思路无比清晰！这法法出卷还很善良！很良心啦
83085,1319,蔡忠法,2018-07-09 15:48:37,0,0,0,好老师(￣▽￣)
84979,1319,蔡忠法,2018-07-15 00:16:22,0,0,0,他说他今年出的题，很简单，果然就是很简单，一点也不像隔壁的信号课，说简单，还死难死难的。
86297,1319,蔡忠法,2018-09-12 13:32:21,-2,2,4,太感谢老师了，小学期的电工电子实习2，虽然信号发生器完成的还可以，但数字频率计做了两天一点没弄出来，没想到还有优秀
88342,1319,蔡忠法,2018-10-29 05:54:30,0,0,0,666
94384,1319,蔡忠法,2019-01-16 09:14:59,3,3,0,老师本身人很好，感觉和高中时候的那些年纪大的老师一样，讲课很细但有些无聊，不过脾气和性格都超好，呆萌是真的hhhhh
98702,1319,蔡忠法,2019-01-23 23:48:12,0,1,1,老师超级棒的，上课讲的特别清楚而且PPT也归纳总结的很有条理
100785,1319,蔡忠法,2019-01-27 00:21:54,0,0,0,人很好，课件概括的很棒
108668,1319,蔡忠法,2019-05-30 23:57:17,5,6,1,这学期专业课最好的老师之一，比? 强十八条街
113489,1319,蔡忠法,2019-07-06 18:31:42,0,1,1,难受啊
113660,1319,蔡忠法,2019-07-07 02:23:51,3,4,1,老师待我不薄，数电和模电都给了很不错的成绩(4.5/5)，谢谢蔡老师。
114091,1319,蔡忠法,2019-07-08 22:06:53,2,2,0,谁要是预置法法还换老师那一定是个智障，没错就是我
114185,1319,蔡忠法,2019-07-09 03:35:56,0,0,0,老师给分好好鸭
115440,1319,蔡忠法,2019-07-24 02:10:29,-1,0,1,电工电子实习，个人体验有点差，感觉不对胃口吧，一步检查到位，不允许更改，有点死板\n\n
117731,1319,蔡忠法,2019-09-30 03:08:07,3,4,1,老师并不对我胃口，但我真的好喜欢他
122670,1319,蔡忠法,2020-03-16 04:01:54,1,3,2,一节课下来不知所云，慎选
123990,1319,蔡忠法,2020-06-19 02:31:02,1,2,1,课前会用学在浙大点名。ppt，直播录像都会传到学在浙大。讲课只讲难点，很细致，讲完就提前下课，简单的内容就完全不讲让我们自学，然后第二周交作业，讲作业。这种方式好还是不好，见仁见智吧，我个人非常喜欢。另外二倍速看回放真的香！
125462,1319,蔡忠法,2020-09-09 13:52:11,1,1,0,感谢老师海底捞！谢老师不挂之恩
125466,1319,蔡忠法,2020-09-09 16:02:31,0,1,1,老师给分还好吧，谢谢老师给高分
129731,1319,蔡忠法,2021-01-11 15:09:48,1,1,0,老师很和蔼，必须十分，考前祈福 开心回家过年！
130541,1319,蔡忠法,2021-01-23 14:10:00,1,1,0,老师人好，教的很用心，是我太菜了真的听不懂模电，劝大家慎重选择电路与模拟电子技术这门课，后面模电部分比电路原理部分难太多了
132173,1319,蔡忠法,2021-01-30 23:51:02,2,2,0,课件逻辑性很好！完全可以根据课件自学了。老师自身讲课趣味性可能不强，但是内容还是挺充实的，这学期学到挺多。
134353,1319,蔡忠法,2021-03-24 14:50:35,7,7,0,我有句爸爸不知当讲不当讲
137586,1319,蔡忠法,2021-07-05 07:53:54,9,9,0,蔡老师比较适合自学能力强的同学，因为他过电路图时候非常快，对推导运算讲的不是很细致。你之前预习过，听他的课会好一些。不喜欢预习的同学上课那几分钟是很难快速读懂电路图的。
140575,1319,蔡忠法,2021-09-14 03:19:09,5,8,3,模电讲课没有章法，而且讲的飞快，不预习完全听不懂。
143755,1319,蔡忠法,2022-01-03 04:24:50,-3,6,9,爱法法，法哥捞我wwww
147332,1319,蔡忠法,2022-01-09 15:01:58,-2,4,6,nice  nice   nice 老师
148995,1319,蔡忠法,2022-01-14 06:14:26,7,11,4,给分很一般
149021,1319,蔡忠法,2022-01-14 07:15:56,8,16,8,上课嘻嘻哈哈，期末大绩杀。
149053,1319,蔡忠法,2022-01-14 08:25:30,10,12,2,挂了，但是老师很好的，就是我太菜了
150438,1319,蔡忠法,2022-01-25 08:00:59,5,9,4,讲课还行，给分很差。
150875,1319,蔡忠法,2022-02-20 11:19:38,8,10,2,！！！讲课确实没话说。但是这给分是不是也太差了点（因为老师不调分）\n\n还是建议选隔壁的。认真学，不会担心绩点。而这个老师你需要担心（巨佬除外，调不调分没影响，但是模电的难度我认为>>微积分）
153116,1319,蔡忠法,2022-04-25 15:38:59,-26,1,27,老师有调分啊，给分不错的说实话（期中错了2题，最后98）
168404,1319,蔡忠法,2023-02-15 12:28:54,2,2,0,求老师捞捞我，特地来刷一个好评
168949,1319,蔡忠法,2023-02-23 15:48:14,6,6,0,电路与电子技术一 老师应该是有微调分的 但是应该调整幅度不大 讲课巨好 语速很满 思路很清晰 而且PPT巨好 而且回答问题巨耐心 感觉是个很可爱的老师 虽然感觉用可爱来形容一位男老师有点不太合适呜呜 法法真的巨好 可惜这门课对应对应实验课的设置有点难顶 数电部分理论课落后实验课好多进度导致实验课巨痛苦 但是听完理论课之后实验课没懂的地方也就基本了解了 总而言之是个很好的老师 作为我的第一门专业课 我很感谢能遇到这位老师
169161,1319,蔡忠法,2023-02-24 13:23:41,11,11,0,电路与模拟电子技术\n\n法法是一个看起来有点严肃但是实际上很可爱的老师，期中考前甚至会吓唬你说“模电这门课是很难的，你们不要想着做全对”，但是他的课真的讲的很清楚（不过可能上的速度会比较快，需要课后花时间领悟，我就是上课写别的科目作业然后课后听智云的），可能模电你第一遍听不懂，但是当你学两遍三遍的时候你再看他的ppt和上他的课，会发现他讲的条理很清晰，ppt上也很完整，期末复习的时候顺着ppt下来就基本上很全面了，模电本身就是一门理解透了就不难的学科。这次期末考试可能因为有一个假期复习的缘故，有很多没见过的题型，本来期末很多题目不确定但是最后还是被老师捞满了（期中90，几次小测基本都扣了几分，mooc也只有80多，期末大题新题型基本就是随缘蒙，感觉老师还是有调分的）\n\n总结：如果你愿意认真的学这门科目而且想把这门科目学懂的话，选他绝对没错！我也听过盾妈的课，盾妈讲解的确实很细致，但是条理可能没那么清晰，法法的课是需要自己课后再花时间的
169169,1319,蔡忠法,2023-02-24 13:45:32,6,6,0,出分了来给老师一个好评\n\n法法上课确实是比较快的，很多其他老师会分析的地方他会直接说结论，没有预习听起来确实是比较难懂，需要课后多花时间。\n\n之前看到很多人评论说他不调分，我还是很慌的，因为今年期末全是怪东西，而且我已经知道自己扣了不少分了，所以最后成绩出来了真的很惊喜。\n\n期中85，总评老师给我捞到了94（期末再高也就90左右）
169224,1319,蔡忠法,2023-02-25 00:37:24,0,0,0,感谢感谢感谢老师捞我呜呜呜呜呜
170385,1319,蔡忠法,2023-03-03 10:54:18,1,1,0,法法yyds!
176651,1319,蔡忠法,2023-06-29 14:41:52,3,3,0,老师就是很理工科的一位老师，讲课很规矩，但是条理和思路都很清晰，而且很严谨，说错了还会对不起。上课节奏挺快，讲话调调却慢慢的，所以跟不上很容易走神睡着（是本人）。ppt我感觉是所有模电老师里最好最清楚的了，所以课上没听也没关系，课下一定要花时间搞明白ppt。有四次小测，全是选择，人太少的时候会点偷偷点名。模电这种课跟老师关系也不大，主要看期末（但还是感觉被捞了一手），给分可以的，好好学了就不用担心。
183453,1319,蔡忠法,2023-11-26 11:39:53,1,1,0,严谨，认真又温和，平静\n\n给分不好说，但绝对是好人，好老师
186249,1319,蔡忠法,2024-01-10 05:25:23,1,2,1,真真切切，好老师！这是我转专业后补选上的老师，也是我第一个专业课老师，讲课的思路很清晰，速度也很恰当，就是一个非常工科的老师，如果有幸预置到了他就偷着乐吧，早上数电刚考完就来写评价，虽然还不知道最后的成绩，但就冲着考试前一天我钉钉上问老师问题老师都秒回，现场去问老师问题老师看一眼就能回答你，就真的是个好老师，10分带走！也希望最后我能如愿拿到满绩吧
187698,1319,蔡忠法,2024-01-17 07:30:41,1,2,1,爱死法法了，法法好能捞
188075,1319,蔡忠法,2024-01-18 07:14:19,2,4,2,超喜欢法法\n\n老师人很和蔼温柔，上课的时候坐在前面，语速慢吞吞，时不时有个有点傻气的笑，其实讲得飞快。PPT会在上课前全部上传学在浙大，但是习题这些的PPT不会给，上课要认真听。这学期5.5学分模电只小测两次也没有点名，听说隔壁数电最后一节课老师说“玩点刺激的”来了个线下小测，其实就是讲点题+点名了。\n\nPPT思路非常非常清晰，模电最开始学不懂，最后学完了回去看发现真的编排得很用心。在上模电的时候老师说上课一定要听，电路可以自己看，模电自己看可能看不懂。所以模电我也上得认真一点。秋学期电路结束之后班上人肉眼可见地变少了，老师也没管，这点对重修又不喜欢来上课的同学说不清是好是坏。\n\n电路学的时候没认真上课，而且感觉自己脑子里有些东西一直转不过来，最后期中87；模电感觉学的不错，期末估计有九十多；最后法法给了总评94，平时分肯定是满的，期中不知道有没有动，这样已经是给分很好了吧，毕竟这门课平时分也就30分。\n\n赞美！
191544,1319,蔡忠法,2024-04-24 12:31:06,1,2,1,上的模电，法法讲课飞快，我整个冬学期模电部分几乎都没怎么跟上，课上发呆玩手机课下面目狰狞地写作业，课后问老师的题目基本上是n节课前讲的基本内容（估计老师内心都要扶额苦笑了orz）。但是期末复习过了一遍老师的ppt（ppt逻辑清晰内容全面），突然像大脑被开光了一样顿悟了。平时的小测和mooc我做的都一般，期中八十多，期末有一道大题的一个小问不会做，最后总评满了^_^
193710,1319,蔡忠法,2024-06-16 03:16:14,0,1,1,法啊，模电给人上麻了，可能是电路1简单，上他的课感觉条理清晰很好，电路2模电完全跟不上，小测也变随机了。考试周补天要哭了，如果能重来一定选个讲的慢讲的仔细的老师。
196619,1319,蔡忠法,2024-07-04 09:09:40,0,2,2,好好好！
199634,1319,蔡忠法,2024-09-26 12:16:47,3,3,0,蔡老师讲课很用心，课后会很认真的答疑，PPT真的很有条理。
199801,1319,蔡忠法,2025-01-18 04:56:00,6,8,2,急刹，你数电还扣平时分啊？
211502,1319,蔡忠法,2025-01-11 19:23:27,0,2,2,很好的老师
213401,1319,蔡忠法,2025-01-17 08:15:36,1,3,2,出分前先给法法打分以免我自己的低绩点产生评判偏差。法法讲课会很慢但是条理性也比较好，上课不会强调一些重点内容需要仔细听课但是期末的复习课件非常清楚详细，复习起来也很方便。虽然他自己说分数不会调整而且期中平均分整体偏低，所以可能算是比较求是的，但是只要你跟着学成绩绝对不会差。上课不点名小测题也是历年题所以平时分比较好混。总之法法绝对是值得十分的好老师！
213516,1319,蔡忠法,2025-01-18 03:39:45,8,8,0,法法你也太求是了吧，期中均分比别的班低了至少十分期末还不调分，还扣平时分呜呜呜
213521,1319,蔡忠法,2025-01-18 04:38:43,2,3,1,快跑，隔壁zdh给分好多了
213562,1319,蔡忠法,2025-01-18 08:13:30,1,2,1,老师讲的很好，考不好是因为我菜，但是给分真的很求是
213708,1319,蔡忠法,2025-01-19 08:31:42,3,3,0,讲课思路清晰，人也很友善，但是给分是真的求是一点也不捞，6学分的电路与电子技术是成功把一学期的努力送走了，给分还是其他几个老师比较友善，选择大于努力吧
215934,1319,蔡忠法,2025-03-07 14:27:15,1,1,0,讲的还可以，PPT清晰，就是有点绩杀
217702,1319,蔡忠法,2025-04-15 09:45:12,0,0,0,很好很好的老师，ppt条理很清晰，而且讲课慢吞吞的真的好可爱
219581,1319,蔡忠法,2025-05-30 04:52:16,0,0,0,电路一，电路二都是蔡老师，只能说太头铁了，电路一已经发现可能不怎么捞结果不信邪上头了，电路二赶着送，强行换成他的可。最后靠着平时作业比电路一认真高了一分。但依然很低，悲\n\n言归正传，讲的其实挺不错，非常认真，基本不点名，但最后一节课概率偷袭，最好去一下
220793,1319,蔡忠法,2025-06-26 08:59:48,0,0,0,补个评价：（模电）上课会有随机小测，然后提醒下后面的同学，小测题目很可能就是跟去年一模一样的，所以翻下往年的智云，平时分就能尽量保住（痛恨自己当时前两次小测不知道这个）\n\n然后老师讲课水平个人感觉中规中矩吧，期末复习可以也看看其他老师的复习课，都综合一下，记得有些老师会划重点的。\n\n给分的话，个人感觉是挺一般的（也有可能是课程本身原因吧）。比较电路一（sh老师）和同时期其他专业课，感觉$分数/努力 $是偏小的
220983,1319,蔡忠法,2025-06-20 14:47:18,0,0,0,总体还好，答疑挺认真的而且一下就能找到问题关键点，讲的开倍速也能过，我是和上交大的综合听的（上交大原理讲得好，czf方法讲得好），小测应该是两次（原谅我老翘课可能会有错误），可以看历年视频题目是一样的，但是给分至少去年数电坑了我一次，希望模电捞一下
221600,1319,蔡忠法,2025-06-25 01:49:42,1,1,0,电路1和电路2都是蔡老师的，老师几乎不点名，小测可以线上做（和往年小测题有点像），上课一年感受来看，老师讲课还不错PPT很棒适合自学，但是法法你给分是不是太求是了一点，感觉平时分还扣了不少(˚ ˃̣̣̥᷄⌓˂̣̣̥᷅ )
221619,1319,蔡忠法,2025-06-25 03:02:50,4,4,0,关于平时成绩，对于MOOC成绩和平时小测成绩全部满分的同学，由于没有满足独立完成的要求，这些成绩改用综合表现来替代。所以你的独立完成的要求就是mooc和小测不能满分吗。。。
221681,1319,蔡忠法,2025-06-25 11:56:13,0,0,0,给分太差，孩子们快跑，但是课讲的还好
221718,1319,蔡忠法,2025-06-25 12:22:47,2,2,0,上了一年法法的课了，上课体验真的很不错，但是两门课都取得了极差的成绩。电路1是因为电原考差了，可能是因为期中考试是老师单独批卷，而法法的要求又比较严格（感觉是不会给过程分），虽然后面数电很努力，但也没有救回来；电路2自我感觉其实很不错，但是最终取得的分数和电路1一模一样，去问了一下，原因居然是因为“小测和mooc全部满分，没有遵守独立完成的规则”？平时分扣了六分，直接下了两个档。虽然很气愤也很后悔，但要说蔡忠法老师是个怎么样的老师，我还是会说他是一个负责并且教书水平很高的老师，但是似乎不太关心同学的得分，所以我建议还是最好别选czf老师了吧，他的课程和ppt可以想办法获取一下，但是他的给分，这6+3学分的糟糕给分真的对卷绩点的人是个致命绝望的打击
221941,1319,蔡忠法,2025-06-27 14:47:42,1,1,0,坐标25春夏模电，先说结论：老师水平高，但他的部分观念太古板僵化，极其不推荐选他的课，稍有不慎就会被绩杀！！\n\n    首先讲优点，czf课件顶级，对着自学没问题。他讲课也很好，开2倍速看智云很舒服。如果是想学习模电，那么参考他的课件、智云，是没问题的。\n\n\n\n    然后讲缺点，主要是给分太差。老师的观念好像还停留在上世纪，他的平时分规则看似写的清楚，作业、慕课占、小测各占多少。但实际情况呢？他会将你的期末考成绩与你的各项平时成绩进行对比，若差距较大（比如平时全满，期末考差），他就认为你的平时成绩是“不独立完成的”，改用“综合表现”来给分，而这个给多少完全靠老师的主观判断！\n\n    这其实极不合理。一方面，平时分的一大作用就是与期末对冲，防止期末过难等意外状况，使总成绩滑坡严重，而czf这样操作，相当于平时分与期末成绩也直接挂钩，一考定一门，要是你期末稍微出点意外，整门课就直接崩掉；另一方面，这“不独立完成”的判断简直是疑罪从有！高考尚不能一考定终生，你怎么能仅凭一次考试就能断定一个人的平时学习是不认真的？测试不是自己辛苦完成的？如此一来，大家还有什么平时努力的必要？考前狠狠刷题，把期末考好，平时随便混也无所谓，不如直接改成期末考占比100%来得实在！\n\n    拿我自己举例，大二下我能保证每周认真看智云回放、自主完成作业的课，仅模电一门，结果如何呢？期末前熬夜，考试犯浑只考了个七十，平时也被扣去7分，直接下三个档，更何况这是一门3学分的大课。何等讽刺！唯一一门能保证平时学习认真的模电惨遭屠戮，其他的工磁、信号等平时投入不大、考前几天临时突击的反而都有4.8+，这难道不是一种莫大的悲哀？\n\n\n\n    出分后，我与老师争论许久，老师竟说“平时若非独立完成，本应取消平时成绩，直接挂科重修，考虑到太严厉，才采用综合表现酌情扣分”，我看到回复，一时无语。总之，慎重吧。
222077,1319,蔡忠法,2025-06-29 12:37:28,0,0,0,喜欢你的ppt，但是给分真的很不好。
735,1541,姜国均,2015-03-16 06:14:14,3,36,33,上过姜老师的电工电子学概论 毫无疑问的大学最爱通识没有之一❤️人很幽默 课讲的也好 电工电子学概论是非理工科妹子们也可以接受的通识喔^ ^
966,1541,姜国均,2015-03-19 15:03:13,3,10,7,好老师
1934,1541,姜国均,2015-03-26 11:34:46,3,12,9,幽默\n\n
3074,1541,姜国均,2015-05-13 11:40:04,7,18,11,老师有些幽默，课上会有小测变相点名，给分还好
6167,1541,姜国均,2015-07-11 14:07:09,36,58,22,上课条理清晰到位。常爆金句，萌萌酷酷逗逗的老师✌️。期末复习课简直是宝！
7986,1541,姜国均,2015-09-16 11:29:34,3,8,5,太萌了\n\n\n\n
8003,1541,姜国均,2015-09-16 12:19:51,14,30,16,电工学概论。上课和课本完全不符，都不知道听什么。
8873,1541,姜国均,2015-09-29 06:55:08,3,10,7,超级喜欢的老师
10529,1541,姜国均,2015-11-19 11:45:19,6,15,9,从不拖堂，老师人很风趣，上课也很生动有趣，很吸引人。给分很不错
10639,1541,姜国均,2015-11-21 06:53:46,0,4,4,上课挺好玩的虽然很多听不懂，不过不用担心考试还是比较好过呢。
11517,1541,姜国均,2015-12-03 10:21:01,13,34,21,太坑了 给绩点很低n
15909,1541,姜国均,2016-01-16 14:45:19,1,9,8,上课无聊，说幽默个人感觉不至于，平时都做足功课，最后给分有点坑
16004,1541,姜国均,2016-01-17 03:04:28,0,4,4,赞到爆
17707,1541,姜国均,2016-01-20 16:17:45,0,6,6,很赞的老师。 最后一节课一定要去听的！  给分也不错\n\n
18448,1541,姜国均,2019-11-09 02:19:25,8,13,5,少来一次扣五分，当心了哦！
19429,1541,姜国均,2016-01-24 08:07:00,11,19,8,慎选！
20814,1541,姜国均,2016-02-01 05:10:12,-5,6,11,就这么说，烂！
23086,1541,姜国均,2016-03-17 06:37:13,0,4,4,轻松\n\n有趣
25146,1541,姜国均,2016-05-06 07:11:28,-9,3,12,哗众取宠，不务实业。
28179,1541,姜国均,2016-06-28 08:13:01,4,9,5,电工电子学讲课很棒，很少有对课本内容不熟悉的地方，延伸拓展也都很充分，重点是上课听段子好玩啊！！！好想跟着他继续学电气啊！！！
28233,1541,姜国均,2016-06-28 08:19:06,0,3,3,好老师啊，没的说
28897,1541,姜国均,2016-06-29 03:02:01,0,4,4,老师上课萌萌哒，讲得特别好，强烈建议大家最后一节复习课一定要去，划重点的\n\n
29352,1541,姜国均,2016-06-29 15:33:35,0,2,2,上课蛮有趣的～不知道给分怎么样?
29603,1541,姜国均,2016-06-30 04:40:01,4,13,9,这学期上姜老师的电工电子学 老师真的超可爱啊！超喜欢！讲的清楚还给画重点～只要上课稍微听一听 考试一点问题都没有～
30829,1541,姜国均,2016-07-02 15:04:09,-2,3,5,感觉已经是一个经过岁月，教学热情不太大的老师，给分客观的说，应该是ok的
30901,1541,姜国均,2016-07-03 00:39:50,0,1,1,有趣但无收获
32391,1541,姜国均,2016-09-27 05:06:39,2,7,5,江湖人士，教的还行，给分客观，上课气氛还好。社会味道重一些
33071,1541,姜国均,2016-09-11 15:31:03,1,3,2,我们班电工电子实习几乎没有上4.2的……这不公平啊为什么
33706,1541,姜国均,2016-09-21 06:15:59,1,3,2,老师挺好很和蔼，就是绩点看着很不爽
34836,1541,姜国均,2016-10-24 12:23:55,-5,7,12,艹，非常不认真！！！！乱写，看不清。还坐着讲，非常懒，不写字！！烦
36136,1541,姜国均,2016-11-10 14:14:34,4,6,2,老师很好，能学到很多东西，课程有点点难度但很有趣，最后的考试很简单，就是会让大家过的那种！
36350,1541,姜国均,2016-11-12 07:04:04,0,4,4,电子电工学概论上课一脸懵逼，但考试还挺容易
36363,1541,姜国均,2016-11-12 09:08:58,1,5,4,绩点低。。。\n\n
36494,1541,姜国均,2016-11-17 02:55:36,2,5,3,很有趣的老师，很喜欢这个电工电子学概论。课程难度还是不小的，不过毕竟是概论，对自己要求也不用很高。能学到的东西很多，前提是要下点功夫，否则容易听过就忘。老师很幽默哒~也很和善哟~至于绩点，我个人还不错的。
36734,1541,姜国均,2016-11-15 15:50:44,0,1,1,有意思！
37042,1541,姜国均,2016-11-17 07:16:44,1,2,1,很幽默，就是讲得好跳跃←_←
37121,1541,姜国均,2018-05-31 06:14:14,71,88,17,文科妹子千万别选电工电子学概论，你们真的听不懂的
37191,1541,姜国均,2016-11-18 01:04:24,1,2,1,老师挺幽默的，课讲的也不错，但毕竟通识课，所以讲的比较简略，理科有基础的还是比较轻松的，文科生慎选！！！！
37262,1541,姜国均,2016-11-18 05:50:59,0,1,1,棒棒哒
38200,1541,姜国均,2016-11-26 08:13:12,3,6,3,本来上课一堆听不懂，觉得很难，然而考试真的简单，只要上课认真听做笔记就能过，开卷的考试上90没问题……其实还是很好的老师，上课幽默有料
42320,1541,姜国均,2017-01-14 04:25:48,1,2,1,给分坑....
45053,1541,姜国均,2017-01-19 01:55:19,1,5,4,电工电子学，还是看给人努力吧。平时上课风趣幽默，期末划重点很给力，好老师。没觉得给分很坑
46837,1541,姜国均,2017-01-22 12:12:40,2,5,3,很喜欢很喜欢的一个老师
48098,1541,姜国均,2017-02-28 12:21:41,-9,0,9,他就点了1次名，我基本水过，拿了83分，你们自己看吧
51365,1541,姜国均,2017-06-02 02:55:28,0,0,0,比较有趣，讲课比较认真的
52790,1541,姜国均,2017-06-23 02:11:22,0,2,2,老师认真负责 幽默风趣
54493,1541,姜国均,2017-06-29 11:44:12,0,0,0,明天考试了...保佑一下
54715,1541,姜国均,2017-06-30 05:34:43,3,3,0,姜老师我求求你了，给分好一点吧，我给你满分，呜呜呜
55108,1541,姜国均,2017-07-01 00:25:33,0,0,0,不管老师给分怎样就凭上课唱过辣妹子模仿过警铃叫，我给老师十分
56752,1541,姜国均,2017-07-04 14:16:26,0,3,3,上课比较风趣幽默，讲得也很仔细，给分还行~\n\n
56845,1541,姜国均,2017-07-05 01:02:03,1,4,3,姜老师是我男神！！！成绩差是课的原因或个人原因。感谢姜老师让我没挂科～
57027,1541,姜国均,2017-07-05 08:28:36,1,2,1,上课还行，给分不高
57392,1541,姜国均,2017-07-07 07:35:57,5,6,1,均绩3.28我是不信的\n\n唉分数好低啊
57671,1541,姜国均,2017-07-12 05:24:34,7,11,4,讲真难得给满分的老师。感觉把这门课，把学生心理都研究透了。上课幽默风趣，常用苦肉计来调侃学生。期末考卷很有水平，给分，客观吧。平时认真学最后都很好，期末才学的……那就看人品吧。
57673,1541,姜国均,2017-07-12 05:29:23,-1,4,5,满绩爽爽  老师把课讲的烂熟于心了
58743,1541,姜国均,2017-09-16 10:51:00,4,5,1,电院小学期电工电子实习课是姜老师的，授课水平中上，脾气极好，给分较好，对每个学生还是比较关照的，10分应得。
59989,1541,姜国均,2017-09-30 03:08:01,0,1,1,老师很幽默\n\n
61665,1541,姜国均,2017-11-20 03:25:58,0,4,4,概论。课上听不懂没关系，记得交作业和参加小测，考前好好复习，老师给分很好的。10分！
61704,1541,姜国均,2017-11-20 07:36:28,40,50,10,客观地说，老师本身是没有任何问题的，上课也挺幽默，但是电工电子学概论这门课的设置真的有些问题。课程很难理解，作为一个高中学理科但是没碰过竞赛的大一新生，我大多数时候什么都听不懂。虽然每节课都认真听但还是听不懂。最后是靠考试前两天自己看书加问物竞同学才大概理解了一些知识。不推荐大一新生选，至少不要在大一上秋学期选，不要把这个作为自己刚开始大学的一个见面礼。
61778,1541,姜国均,2017-11-21 01:34:40,0,1,1,老师萌萌哒 讲的内容有点难 不过考试很水 最后一节课一定要听
61885,1541,姜国均,2017-11-21 11:19:42,0,1,1,讲的飞快，而且挺难的，但是考试比较简单
64181,1541,姜国均,2017-12-21 08:25:59,0,0,0,电气专业的可以用来刷绩点吧
64501,1541,姜国均,2017-12-24 15:22:54,1,4,3,被正态，好好学了没有什么成果
80233,1541,姜国均,2018-07-06 10:12:13,3,4,1,喵喵喵喵?
80468,1541,姜国均,2018-06-27 01:43:52,4,5,1,谢谢老师
81368,1541,姜国均,2018-07-05 02:23:58,2,3,1,我给老师打十分!!求老师给我过!!!
81417,1541,姜国均,2018-07-05 04:32:46,15,17,2,我们一起学猫叫，一起喵喵喵喵喵～
81525,1541,姜国均,2018-07-05 09:30:37,3,4,1,喵喵喵
81540,1541,姜国均,2018-07-05 10:34:08,11,15,4,老师很皮，讲段子信手拈来!\n\n上课逻辑很清晰，考试考点会很直接点出来，上课体验极佳!
82105,1541,姜国均,2018-07-07 06:25:13,0,0,0,喵喵喵
82838,1541,姜国均,2018-07-10 02:18:35,-4,3,7,老师太可爱了?
83200,1541,姜国均,2018-07-10 02:18:28,0,4,4,安排上了。上姜老师的课，且不说知识内容。人生哲理绝对让人信服！坐等老师出书，从电气原理看殊途人生！满分教授，选爆
83205,1541,姜国均,2018-07-10 02:27:09,1,4,3,好老师 讲课有条理 段子手
83605,1541,姜国均,2018-07-10 23:18:58,0,5,5,这老师不给10分天理难容啊，上课会讲段子，平时还会和同学在微信群里扯皮，关键是专业课内容讲的也很透彻，成绩比别的老师班的要高，来到就是赚到啊！
84200,1541,姜国均,2018-07-12 08:14:57,-5,3,8,简直乱来，明明作业做的很好，考试也还不错，给个这么低的分数，让他查成绩也不搭理。差评
85468,1541,姜国均,2018-07-18 06:42:10,-10,4,14,老师经常在课上信口开河，顾及一下学生行不行，要是一个人讲课爽就够了的话还当什么老师，老师的工作不就是教书育人么…
86906,1541,姜国均,2018-09-19 10:36:07,2,3,1,第一节课被吓到了，好难啊
87279,1541,姜国均,2018-09-26 12:09:19,0,5,5,真不知道他说啥呢，就一个人自己在那讲，这堆听不懂的学术语言都不解释，我一个理科生都听不懂真不知道这老师怎么讲课的
87914,1541,姜国均,2018-10-17 13:08:27,1,2,1,老师很认真，但我听不懂(=_=)
88069,1541,姜国均,2018-10-21 11:39:35,1,1,0,老师很认真讲电工电子学概论 其实我们也听的很认真 但希望老师出题简单一点啦 因为真的很难 我们不是嫌弃您的课拉绩点 而是毕竟不希望认真学了却倒在难度大的考试上咯
89118,1541,姜国均,2018-11-16 02:12:10,1,8,7,好喜欢姜国均老师的电工电子学概论！上课很幽默，氛围很轻松，尽管有些东西听不太懂，但不影响考试，课后自己学一学重点就行了。高中只选了技术没选物理，但也不怎么影响，作业好好做，考试还是简单的。推荐喜欢电工的同学选！最喜欢的通识课！老师超可爱！
89286,1541,姜国均,2018-11-18 05:04:02,5,5,0,看到绩点 心塞塞
89302,1541,姜国均,2018-11-18 07:38:10,6,11,5,讲得毫无逻辑，完全听不懂，他还总以为把学生讲懂了，作业、考试也难死人，关键是给分极低，千万别选。
89312,1541,姜国均,2018-11-18 09:37:17,9,12,3,老师很可爱但是课程真的难，考试虽然开卷但也没什么用……所以貌似高中学没学过物理理工科的还是人文社科什么的人都可以选...反正都听不懂，不过至少挂科基本是不存在的，作业少事少是真的。
89315,1541,姜国均,2018-11-18 10:17:49,6,7,1,电工学概论这课真心别学，这就是个坑，上课听不懂，绩点还低。
89317,1541,姜国均,2018-11-18 11:00:57,1,1,0,害怕?
89327,1541,姜国均,2018-11-18 12:46:56,1,3,2,概论，第一节课口口声声说给文科生开的，结果问了周围几个理科生都说不懂，然后绩点贼差。呵呵
89328,1541,姜国均,2018-11-18 12:52:09,6,7,1,绩杀，讲课速度极快而且完全听不懂，真不知道为什么评分这么高
89331,1541,姜国均,2018-11-18 13:01:21,1,3,2,电子电工学概论学不到什么，给分还低，直接劝退
89333,1541,姜国均,2018-11-18 13:27:25,6,6,0,千万别选电工学概论   听不懂分也贼低
89339,1541,姜国均,2018-11-18 14:13:11,4,5,1,好好听课 认真做作业2.4
89345,1541,姜国均,2018-11-18 14:37:29,5,6,1,老师不错，但听不懂啊，绩杀啊，唉?
89386,1541,姜国均,2018-11-19 16:42:25,7,13,6,电子电工学概论这门课非常具有挑战性。①课程难度巨大，几乎无视高中理科基础，即使期末考开卷也没有什么用，课本原话根本就没有。\n\n②老师讲课太粗略，概念不解释清楚，在ppt上喜欢用视觉体验极差的荧光笔，涂得乱七八糟。\n\n③非常考验心理素质，难度太大可能心态就崩了，还要面临最后的绩杀。    不是电工学大佬或心理学大佬，真的要慎选！
89393,1541,姜国均,2018-11-19 02:38:48,7,7,0,绩杀，慎选，2.4绩点怎么来的你问问他就知道了
89421,1541,姜国均,2018-11-19 04:30:24,1,2,1,就是一门拉低均绩的课，真是服了
89518,1541,姜国均,2018-11-19 11:14:32,2,4,2,慎选\n\n及格是一定有的\n\n绩点是确实低的
89552,1541,姜国均,2018-11-19 13:18:29,2,4,2,哇，这个又听不懂，绩点给的也太低了吧
89826,1541,姜国均,2018-11-21 02:40:18,-16,5,21,绩点只有3.9的我还是要给老师打十分
92759,1541,姜国均,2019-01-04 08:00:54,7,8,1,完全听不懂，像听天书，作业考试又难，努力坚持学还是学不懂，绩点2.1。不管你是想去水还是想真的学点知识，都千万别选。
92931,1541,姜国均,2019-01-06 01:49:13,-4,4,8,垃圾老师，毁我青春。
92932,1541,姜国均,2019-01-06 01:49:13,-4,4,8,垃圾老师，毁我青春。
92994,1541,姜国均,2019-01-06 16:09:31,2,3,1,听不懂呜呜呜
95967,1541,姜国均,2019-01-20 09:41:39,0,1,1,很喜欢老师，虽然成绩不是特别高，但是也不错了? ? ? \n\n
95973,1541,姜国均,2019-01-20 09:49:14,0,5,5,大学目前为止最喜欢的老师！！上课风趣幽默 比较擅长让学生理解原来很难记的内容！电工电子学个人觉得学的超差但是老师应该是调分了 所以绩点还可以 平时在微信群里各种表情包也是一股清流的存在！为老师疯狂打call！！
96073,1541,姜国均,2019-01-20 12:24:20,3,4,1,听不懂
97036,1541,姜国均,2019-01-21 15:10:37,9,14,5,大绩杀！！我讨厌您！！【指概论课
98302,1541,姜国均,2019-01-23 09:50:50,1,4,3,个人认为这课应该不是老师的问题，而是这课的问题，感觉这种奇葩课程应该被取消
98800,1541,姜国均,2019-01-24 02:57:11,1,1,0,就是讲些高中常识，啥东西都没讲清楚，原理也不怎么讲，刚想知道的清楚点就跳过了。想学知识同学的别选。
100420,1541,姜国均,2019-01-26 05:54:36,2,2,0,
106700,1541,姜国均,2019-04-29 03:33:17,11,12,1,作为一个学法但深深热爱电工的女生，姜老师真的爱了，幽默风趣，非常可爱，电工电子学概论很有意思！好好复习了绩点也不错。（不过感觉还是要运用一些高中技术学的电工知识的，复习和作业也挺重要，毫无基础且不太热爱电工的同学们还是慎选）
108514,1541,姜国均,2019-05-27 12:32:24,-2,5,7,千万不要选电子电工学概论，这简直是通识课的灾难
110651,1541,姜国均,2019-06-28 02:15:57,3,3,0,真的好老师，讲课超逗，考前划重点，人超好
111773,1541,姜国均,2019-07-02 22:17:31,5,7,2,姜老师我吹爆，教的清楚，幽默，考前还画重点，给分还好。你能想象一个对物理极度恐惧但是电工电子拿了满绩的人的欣喜吗？真的太感谢姜老师了！
111796,1541,姜国均,2019-07-02 23:24:10,5,5,0,最后一节复习课抵得上大半学期，最后考点清清楚楚就差告诉答案了，我tm吹爆
111939,1541,姜国均,2019-07-03 03:45:02,-5,2,7,电工电子学及实验必须选姜老师！！渣渣期末被挽救成4.8我吹爆！！
112064,1541,姜国均,2019-07-03 11:06:40,3,5,2,吹爆电工电子学及实验和姜国均老师，老师上课很幽默，会帮大家想一些很好记的口诀，最后一节复习课一定要去，老师会很隐晦（明明白白）告诉你要考哪些内容，复习思路很清晰。最后给分也超级好，我有很多没做出来，但还是上4了，谢谢老师o(^o^)o
117650,1541,姜国均,2019-09-27 16:30:27,13,13,0,姜老师是浙江大学好老师之典范！认真做好预习复习和课堂，电工电子学及实验不存在听不懂的。在我看来，老师没有任何问题！多是学生花的功夫少了！
118571,1541,姜国均,2019-10-28 16:27:36,36,37,1,老师今天眼睛出血了，坚持来上课，还带了浅色墨镜防止我们害怕。这样的老师，无论给分如何，都应当收到尊重。
118974,1541,姜国均,2019-11-08 19:26:32,2,2,0,没出分，客观评价电工电子学概论这门课。开课的出发点应该是想让更多人了解电工的应用知识；作为绪论课，因此包含的内容很多(包括电路原理，模电，数电以及输电，通信，人工智能等等)，但是课时又极为有限，导致课程不可避免地变成了流ppt式上课。学知识的话应该说是学不到什么真家伙(期末题里最难的计算比不过高中学考物理难度)，但是可以对电工电子学有一个初步的了解。另，电科学生在理解上会有很大的优势，因此不推荐纯人文社科同学选课……
119405,1541,姜国均,2019-11-12 17:28:46,5,5,0,"前排提醒电气及其他工科学院的同学：这门课里你们占不到什么优势。考试里主要考察对概念的记忆和开卷翻书能力，这方面恐怕也没什么优势吧。计算题只有最简单的kclkvl，弯都不拐那种。最后最重要的一点，不要抱着""我都学过模电数电就来划划水吧""这种心态，不然结果与预期相比会有较大落差(一位卡在88的电气大三狗溜走了)"
119497,1541,姜国均,2019-11-13 05:42:45,4,4,0,一共旷课一次还被抓住，我太倒霉了。上课划水，最后成绩难堪的一批。不过有一说一，老师是个不错的老师。敬业，幽默。
119499,1541,姜国均,2019-11-13 05:51:07,1,3,2,老师是好老师，但是电工电子学概论上课真的太水了，可能和课程安排有关系，上课太快，懂得不用听，不懂的听不懂，最后绩杀
119502,1541,姜国均,2019-11-13 06:17:00,0,3,3,emmmm大二? ，自认为小测+最后考试应该都可，高中学过物理竞赛，绩点4.2，感觉可能是平时抄抄写写的概念类的作业and没有做需要额外下载一个软件的电路bonus拖后腿了。\n\n老师上课还是挺风趣的，平时的生活小常识也会普及，氛围很融洽hhh，不过真的课程设置不合理，最后还是啥都知道但也听不明白，科普性质强⑧\n\n推荐电气有关专业大二生上，绩点应该可以很顶
122443,1541,姜国均,2020-02-27 15:05:21,5,5,0,过了一年了突然想再来评价一下，很怀念大一上电工电子学概论的日子。本人社科专业，高中没选物理，更没有竞赛，但是非常喜欢学电子电路知识；平心而论，这门课内容输出量非常大非常大，当年因为没有专业课所以大部分时间都在学这门课，付出了很多时间；平时作业我认为比较难，但期末考比起平时作业简单太多了，重中之重的概念学清楚了就基本ok，考完试甚至觉得卷子难度太对不起我平时努力了哈哈。最后强调一下，我是发自内心喜欢电工，所以哪怕花了很多时间学也觉得享受，老师也很可爱；但这门课真的不是人文社科同学们想象的通识，想舒舒服服水高分肯定不可能。
123065,1541,姜国均,2020-05-07 13:13:39,2,4,2,去年上的电工电子学，网课无聊来答一波~感觉老师从事电工电子的教学很久了，知识讲得很到位。老师很幽默风趣，经常调侃自己，上课也会讲一些小段子这样。留教材上的习题说是最后期末的时候交，平时要交的作业是老师另外出的，大概平均三周交一次这样？结果期末教材上的习题也没有检查哈哈哈~老师的小测都很简单，一学期应该是两三次，还说不会写也没有关系，就是拿来当作点名。可能是因为安排的课时比较充裕，本来上到第五节的课也日常提前下课。我本人平时上课经常昏昏欲睡，但老师留的作业都有认真做，最后拿到了不错的成绩。总之姜老师真的是很喜欢的老师啦~（最近听说老师上网课没意识到自己黑屏 学弟学妹们听了整整一节课纯音频哈哈哈）
124159,1541,姜国均,2020-06-26 01:56:03,0,0,0,太惨了\n\n
125309,1541,姜国均,2020-09-06 06:31:01,4,4,0,希望老师捞一捞我啊啊\n\n\n\n不要相信老师给的自测题，和考试内容没有任何关系
127609,1541,姜国均,2020-11-25 03:51:41,5,6,1,难不建议选
127611,1541,姜国均,2020-11-26 04:47:00,3,4,1,我劝这位老师耗子尾汁好好反思
127629,1541,姜国均,2020-11-25 06:08:15,2,2,0,讲课挺好的，第一节课问他听不懂考试有没有问题，虽然挂科不存在，然而绩杀，3.0大学第一门通识 傻了……平时感觉上课也好好听了
127794,1541,姜国均,2020-11-27 06:37:59,1,2,1,姜老师上课涉及方面很广，能初步了解到关于电的很多东西，但是因为涉面太广，对于没有基础的同学还是有难度，需要课下反复观看回放与ppt，开卷考试把ppt打印下来，花两天看看ppt和书本就没什么问题。总之，老师很棒，可以了解很多，需要认真学。
127980,1541,姜国均,2020-12-02 06:15:30,3,4,1,电工电子学概论非常的硬核，但是也正是浙大开设通识课的初衷，能让非电气专业的学生了解到很多的电气知识。但是如果没有理科基础以及强烈的兴趣还是不建议选
128039,1541,姜国均,2020-12-04 03:12:17,7,7,0,老师只能说还行 但是电工电子学概论这门课可以说是非常烂！一节课学完模电一节课学完数电几次讲完大学工科几门专业课 跟本不可能学会 课外作业不好做 考试难 给分烂 建议慎重！
129996,1541,姜国均,2021-01-14 16:19:50,1,1,0,我选的电工学概论，老师人还是很好的，但这门课真的很讨厌，既硬核又浅薄，没有物理尤其是电学的基础会很痛苦。
130036,1541,姜国均,2021-01-15 11:34:50,1,9,8,你妈，老子第一门通识就挂了，???什么东西
130942,1541,姜国均,2021-01-25 10:14:54,1,2,1,老师真的很不错的，主要是喜欢引申内容，但是我确实也只是个关心考试的学生。
132140,1541,姜国均,2021-01-30 12:58:51,6,6,0,老师人很有趣，但课是真的听不懂，最要吐槽助教，问了几次问题，都没回答过，既然当了助教疑问都不解答吗？？？助教就最后出成绩的时候在钉钉露了句话。
139130,1541,姜国均,2021-07-13 03:50:11,2,2,0,感谢姜国均爸爸捞我！！！
139452,1541,姜国均,2021-07-15 23:52:05,-5,0,5,呵呵了
142543,1541,姜国均,2021-11-13 01:19:50,2,2,0,好老师，但是这门课给我绩杀了，寄
152716,1541,姜国均,2022-04-19 01:34:48,3,4,1,能不能别一直点前面的学生回答问题
153845,1541,姜国均,2022-05-13 04:05:46,-24,0,24,杨昕我嫌你上课不好，所以退课弃修了
153846,1541,姜国均,2022-05-13 04:05:15,-24,0,24,老子杨昕嫌你上课不好，所以退课弃修了
156256,1541,姜国均,2022-06-18 13:35:49,3,5,2,我爱姜老师！！我爱电工电子学！！老师讲的好，知识点很清晰，平时还会拓展，菜鸡获得了史上最高的专业课绩点！爱老师（づ￣3￣）づ╭❤～
156259,1541,姜国均,2022-06-18 13:47:28,3,3,0,老师讲课好，押题准
156361,1541,姜国均,2022-06-19 08:17:36,0,0,0,好！讲得很清楚很详细了 而且老师还挺幽默的说实话
161708,1541,姜国均,2022-11-11 01:28:57,-8,4,12,概论课绩杀！！！滚吧傻逼东西
161724,1541,姜国均,2022-11-11 08:30:13,4,5,1,啊大一萌新的当头一棒
161894,1541,姜国均,2022-11-15 01:34:32,4,4,0,选的电子电工学概论，老师上课很幽默，课程也能学到很多有用的东西，但确实是一门非常硬核的通识课。如果你想要学点东西，欢迎选这门课；如果你理科水平比较差而且只想选个水课，那快跑千万别选这门课！！
162002,1541,姜国均,2022-11-16 02:19:47,2,2,0,我感觉挺一般的。老师自身水平是挺高，但他讲课实在是太快了，他以为同学都懂了，但电路挺难的，同学理解速度没这么快啊
163717,1541,姜国均,2022-12-16 04:09:54,-4,1,5,概论通识课\n\n课基本没怎么听 ，一些小作业可能会有点难度，考试是开卷的，凭借我高中的物理知识后面的大题目基本都能做，最后4.2\n\n老师挺不错的，课程容量是大了点，讲的快也没办法，老师上课会提醒你哪些地方是重点，考前结合ppt看看就行了
168158,1541,姜国均,2023-01-31 02:13:46,3,3,0,www只能说高中浙江选技术的随便选，高中外省大一真别选，，，老师讲课贼快且普通话不标准，虽然干货很多但是他总是觉得大家都会，就讲的贼快，，，总之不是水课，平时作业查各种东西自学，平时分挺高了，但是期末考好多题不会，最后才3.9
175327,1541,姜国均,2023-06-24 02:08:20,0,0,0,上的电工电子学课（专业基础课），老师人很好，讲课很仔细清晰，作业不多。跟着老师按部就班学就可以了，不懂的可以问老师，老师答疑也很仔细
176203,1541,姜国均,2023-06-28 05:00:19,0,0,0,姜老师我的神！感谢电工电子学不挂之恩！！！
176260,1541,姜国均,2023-06-28 07:32:45,0,0,0,老师水平真的高
181399,1541,姜国均,2023-10-17 01:08:31,0,0,0,电工电子学，老师讲的太好了，我吹爆
182436,1541,姜国均,2023-11-16 03:50:01,0,2,2,电工电子学概论，事少分还行
182646,1541,姜国均,2023-11-18 16:23:09,-7,1,8,绩杀，别选\n\n给你打1分是因为打不了0分
182647,1541,姜国均,2023-11-18 16:40:21,0,2,2,唉内容太难了
183097,1541,姜国均,2023-11-22 06:19:23,2,3,1,绩杀，我每一节课认认真真上，作业论文认认真真写，绩点还没4.0  乱评吧你就
183670,1541,姜国均,2023-11-28 09:36:39,2,3,1,理工科自认为是学霸的男生也别选电工学概论。不要以为你之前会的那些数电模电物理竞赛可以盖过这门课TAT\n\n不要对1楼取补集
184680,1541,姜国均,2023-12-22 07:00:11,-4,2,6,非常好的电子电工学概论，绩点4.8，作业认真做，考前过一遍教材就可以了
184733,1541,姜国均,2023-12-22 10:56:43,2,2,0,电工电子学概论，6分，老师人很好很和蔼，但是课内容挺难的，说是面向人文社科，但我一个自认高中物理学的还行的人出分只有3.0
184776,1541,姜国均,2023-12-22 15:11:12,0,1,1,课真的很好，大一同学也能很好理解，建议大一新生多选
186746,1541,姜国均,2024-01-13 02:07:08,1,1,0,不好说
188026,1541,姜国均,2024-01-18 04:42:33,3,3,0,电工电子学\n\n讲课不错，最后的考点总结也很详细
195566,1541,姜国均,2024-06-28 22:10:25,3,3,0,电工电子学去年选plp班挂了，还好今年选了姜老师班，总算过了，提醒最后一节课一定要在智云课堂逐帧观看啊
211006,1541,姜国均,2025-01-10 10:08:21,1,1,0,24秋冬plp班的，从mooc听了jgj的网课就感觉讲得很好；\n\n然后现在期末又看了往年智云，愈发感觉传道受业解惑不过如此；\n\n可能是我个人主观色彩太重觉得他讲得好，但确实要干货有干货；\n\n偶尔的延伸拓展不是即兴表演，真是对知识点再强调了；\n\n明天电工电子学期末考，先给素未谋面的老师刷个十分
212202,1541,姜国均,2025-01-13 11:06:45,1,1,0,远超plp
213141,1541,姜国均,2025-01-16 06:01:25,0,0,0,老师衣品很好，我毕业快两年了还翻回来去智云课堂学穿搭
21990,1575,陈隆道,2016-03-02 04:46:48,3,4,1,"萌萌的老头子。\n\n""我其实很善良，他们还说什么电院几大杀手"""
23252,1575,陈隆道,2016-03-23 03:34:24,3,3,0,老爷子太可爱了hhhh
30629,1575,陈隆道,2016-07-02 05:56:13,1,1,0,上课有趣的讲的挺好的，就是。。。。。绩杀。。。。。记住没有平时分加成。。。平常的研讨课好像没啥用，不过学确实能学到东西
30716,1575,陈隆道,2016-07-02 09:57:32,-1,1,2,其他都满意，就是给的绩点低，冲着满绩去的可以走开了
30718,1575,陈隆道,2016-07-02 10:09:29,3,4,1,给分实在不太好......主要难过的是和其他老师比这差距有点大。毕竟电院竞争激烈。差个四五分真的很重要啊
32199,1575,陈隆道,2016-07-06 02:41:07,2,2,0,上课还是很好玩的，有两次研讨课！每次三节的课很早就下课！但讲真给分是真的很不好！
54695,1575,陈隆道,2017-06-30 04:57:11,2,2,0,啊呀啊呀，讲的很好，还是我太菜了
82114,1575,陈隆道,2018-07-07 07:06:57,2,2,0,老师讲的确实是不错，ppt做的比较用心，给分也还好，看自己一分耕耘一分收获吧(据说原来82比，现在73给分比了)，也没传说中那么绩杀。老师今年最后一年教模电了，开课前给学生还鞠了一躬，给个满分吧，好歹也算老先生了。
82350,1575,陈隆道,2018-07-08 03:13:03,0,0,0,就冲着老师每次把三节课讲到两节课就下课也要打高分? 不过讲道理模电的内容确实少，然后老师真的很友好啊，说模电不难但是要花时间。虽然最后因为自己太浪考砸了但是不是老师的问题iui
82483,1575,陈隆道,2018-07-08 10:15:52,1,1,0,老师很好啊，很用心地在教
4357,1597,李玉玲,2015-06-19 12:03:27,31,38,7,好老师
6507,1597,李玉玲,2015-07-14 14:13:50,11,13,2,老师人很好
9538,1597,李玉玲,2015-10-29 08:48:37,3,5,2,讲得很好！
9653,1597,李玉玲,2015-11-04 00:26:44,0,2,2,满分不解释
12764,1597,李玉玲,2015-12-24 03:24:13,0,2,2,讲的很好很细致
14918,1597,李玉玲,2016-01-11 03:17:48,0,1,1,好老师，很有耐心
18439,1597,李玉玲,2016-01-21 15:43:16,0,1,1,超级好！
18617,1597,李玉玲,2016-01-22 06:43:10,0,1,1,超级和蔼给分好
19295,1597,李玉玲,2016-01-23 23:39:10,0,2,2,讲的非常棒，给分也非常好
22207,1597,李玉玲,2016-03-03 02:43:27,0,1,1,非常好
22281,1597,李玉玲,2016-03-03 07:36:01,1,3,2,好，想念啊
22602,1597,李玉玲,2016-03-08 12:52:03,0,2,2,满分不解释
23075,1597,李玉玲,2016-03-17 02:20:49,0,0,0,很不错的老师 上课比较轻松 讲得也很详细 \n\n\n\n
24476,1597,李玉玲,2016-04-30 15:16:48,0,2,2,反正就是好！
25035,1597,李玉玲,2016-05-05 02:35:38,0,1,1,人很好，很耐心，讲课很轻松但又很详细
26536,1597,李玉玲,2016-06-20 03:22:20,15,19,4,电路实验上过李玉玲的课之后再没见过PPT这么详细的老师了，照着PPT就能把实验早早做完
28053,1597,李玉玲,2016-06-28 08:02:40,0,0,0,满分没的说
34303,1597,李玉玲,2016-09-30 04:57:40,0,0,0,满分不解释
40816,1597,李玉玲,2017-01-05 16:03:37,18,20,2,声音和我妈妈一样，好巧哎。很温柔~
41139,1597,李玉玲,2017-01-09 11:55:52,0,1,1,从没见过这么好的实验老师
42649,1597,李玉玲,2017-01-14 16:27:52,0,0,0,老师挺好的
44750,1597,李玉玲,2017-01-18 07:59:58,10,12,2,期末实验没接出来，平时分给得我感动得哭了。\n\n实验课条理清晰，老师知道实验的意义和目的是什么，会根据前一个班的情况调整实验内容。\n\n实验任务总是最少的，却能有近乎理论课的收获。
45072,1597,李玉玲,2017-01-21 06:59:49,0,5,5,给分一般
46250,1597,李玉玲,2017-01-21 04:47:45,8,9,1,老师简直女神，实验课讲得非常清楚，而且任务不多，很会为学生着想，而且期末考试前会特意帮我们复习前一模块实验的知识。很想下个学期继续选她的电网络分析，但课表动不了还是算了。
47001,1597,李玉玲,2017-01-23 09:01:35,0,0,0,不知不觉电路实验课结束了。很高兴也很荣幸这个学期能选上李玉玲老师的电路课程。也要感谢自己当初做出了正确的选择
50034,1597,李玉玲,2017-04-28 16:19:49,8,9,1,老师讲课超级棒，满分，电网络考完了，题感觉挺难的，心里没底，不知道怎么样
50686,1597,李玉玲,2017-05-04 09:12:14,3,3,0,老师挺好人的，讲课很棒，电网络这次感觉考的挺偏的，所以3.9的成绩意料之中了，没办法了
51549,1597,李玉玲,2017-06-07 05:12:39,0,0,0,讲课清楚，和蔼可亲，关心学生，你不会失望的。
57138,1597,李玉玲,2017-07-05 15:49:37,2,4,2,工程电磁场炸了，老师我给您打了10分，可怜可怜我?
57239,1597,李玉玲,2017-07-06 05:45:22,0,2,2,还行吧\n\n
58952,1597,李玉玲,2017-09-19 00:53:36,-2,6,8,催眠大师
65922,1597,李玉玲,2018-01-10 08:48:22,-9,3,12,人还好，实验考试坑。为什么别的老师可以翻书，还允许用电脑！！！
67245,1597,李玉玲,2018-01-20 13:57:02,0,3,3,老师的实验很赞！但是要压过班级内百分之七十的同学好难啊……为什么要等级制呢？摊手
75972,1597,李玉玲,2018-03-23 02:53:30,28,32,4,对bo？
77543,1597,李玉玲,2018-05-06 11:20:20,13,16,3,李玉玲老师是迄今为止我最最最喜欢的专业课老师没有之一！！！好想好想把所有课都换成她的！
84922,1597,李玉玲,2018-07-14 12:08:18,3,5,2,对工磁的评分机制表示质疑。
104210,1597,李玉玲,2019-03-14 03:39:35,1,2,1,老师讲得很好，实验课ppt真的很详细，可惜电路实验2没有她的实验课了。。
104363,1597,李玉玲,2019-03-19 00:48:07,-13,3,16,真的好催眠啊……
105522,1597,李玉玲,2019-04-16 03:37:34,1,1,0,真的好老师
106937,1597,李玉玲,2019-04-30 10:12:21,1,1,0,真的好老师，给分也很不错
107026,1597,李玉玲,2019-05-01 02:35:50,1,1,0,老师很温柔
108782,1597,李玉玲,2019-06-02 04:33:14,19,20,1,工磁从大家一定要理解到大家一定要背会
110042,1597,李玉玲,2019-06-21 15:54:02,3,3,0,选中李玉玲老师的课应该感到幸运！真的好老师！对比隔壁xsm，不想说话。。。
112247,1597,李玉玲,2019-07-04 00:07:43,4,4,0,老师太好了
112536,1597,李玉玲,2019-07-04 17:13:20,-9,1,10,老师人很好没话说，教的也很出色。但是只有我觉得期末给分偏低吗。我觉得卷面应该稳上90。期末只占60，结果总评86？
112729,1597,李玉玲,2019-07-05 01:20:28,3,3,0,特别特别特别温柔的老师！讲课特别细致，然后课真的讲得很到位。虽然这样的讲课风格不适合所有人，比如说有时候我就会很困|ω・），不过老师还是特别好的老师！
113748,1597,李玉玲,2019-07-07 07:48:26,-21,1,22,老师出分好快，电网络和工磁都是，工磁就是背书课吧，刷了两遍课后全部题，考试却是默写，五天速成4.8
120666,1597,李玉玲,2020-01-14 23:06:09,-23,1,24,不咋地
121796,1597,李玉玲,2020-01-22 02:44:24,2,3,1,老师的实验课挺好的，事情一般都比其他班少，也会主动给我们降低要求和难度，而且PPT做的好，讲的也清晰，基本上对着PPT就能做出来了。\n\n有一说一，用给分来评判电路实验老师是一个很憨的行为，这门课本身就有要求优秀率和良好率各不过30%...老师真的已经做得挺好了，值得10分
125558,1597,李玉玲,2020-09-11 12:32:56,5,5,0,完美的老师，上课很温柔，很照顾学生，最后给分也很有师生情
125957,1597,李玉玲,2020-09-16 03:56:47,7,7,0,谁能想到一个数电60分飘过的人实验能拿4.5？
138790,1597,李玉玲,2021-07-11 00:52:45,5,5,0,老师超级好，就是工磁这次考试tnl，可能是我太菜吧ww
143684,1597,李玉玲,2021-12-01 13:50:38,0,0,0,好好好
145063,1597,李玉玲,2021-12-27 07:26:51,6,6,0,虽然实验还没出分但真的是温柔善良的妈妈型老师\n\n爱了爱了
145139,1597,李玉玲,2021-12-27 16:14:11,5,5,0,好几次我因为线路问题迟迟做不出来实验，老师都耐心地和我一起检查电路，对于同学们各种问题老师都很认真仔细地解答，有时候就算是犯了一些很简单的问题也不会生气，说话总是很温和，选到李老师的课真的很幸运
145203,1597,李玉玲,2021-12-28 07:43:13,0,0,0,老师确实是好老师，10分，讲的很清楚，可我是菜货，数电实验寄了
145275,1597,李玉玲,2021-12-28 16:16:24,1,1,0,老师真的好好！讲课细致，ppt学期开始就会发给我们，实验的内容、原理什么的都讲得很清楚。像我这样数电理论课学得稀烂的也能顺利连好电路……\n\n如果有问题都可以问老师，老师十分耐心温柔！我自己都觉得自己提的问题很幼稚，但凡上课认真听了的都不该不知道（因为我有时候困死），但是老师还是，完全不会责怪我，很耐心地回答。检查电路连接情况这样麻烦的事情老师有空的话也会认真帮同学检查。菜鸡大受感动！不管最后得多少分，都要过来给老师打call！\n\n看之前的评论，“妈妈型老师”的形容十分贴切呢哈哈哈哈。
147174,1597,李玉玲,2022-01-09 03:40:54,1,1,0,老师超好！！
147239,1597,李玉玲,2022-01-09 08:09:28,3,3,0,我永远喜欢温柔的人\n\n之前看查老师似乎唯一的不满意是闭卷，今年期末都开卷了，真的完美。
147347,1597,李玉玲,2022-01-09 15:52:02,1,1,0,好老师，各种意义上的
147475,1597,李玉玲,2022-01-10 05:12:01,0,0,0,没话说
148623,1597,李玉玲,2022-01-13 04:37:21,1,1,0,老师实验讲的很清晰，很清晰，很清晰，会很耐心地解决同学遇到的问题，爱了
148989,1597,李玉玲,2022-01-14 06:06:09,7,7,0,老师好善良，讲课好清晰，比隔壁那位强好多。作业没交然后期末不停提醒，尽力让同学不挂科，能看到同学身上的哪怕一点点的优点，属于是真正的好老师
152951,1597,李玉玲,2022-06-22 02:56:29,8,8,0,lyl我滴神！上课讲得蛮清楚的，脾气也很好超级温柔。每次私戳都会及时回我。有一次她忘记了，已读一直没回我，第二天发现了以后特地来和我说。真的太好了呜呜呜呜呜
154811,1597,李玉玲,2022-06-05 15:25:34,11,11,0,呜呜呜呜老师是我亲妈！！！感动
157671,1597,李玉玲,2022-06-24 09:35:04,26,29,3,玉玲老师的女儿也是女神级别的姑娘！
161379,1597,李玉玲,2022-11-05 11:11:02,0,1,1,很不错 不知道给分咋样
161830,1597,李玉玲,2022-11-14 08:30:08,6,6,0,老师真的太太太太好了，可惜老师本人不开光电和自动化的模电，只是给张老师代课半个学期
165212,1597,李玉玲,2022-12-30 06:39:04,2,2,0,可惜不能把光电的模电讲完
168493,1597,李玉玲,2023-02-18 13:38:16,-28,2,30,上的老师的电路实验，十分耐心，女神般的老师，最后期末考的时候我的仿真波形出了竞争-冒险的错误，有个非常明显的毛刺，本来担惊受怕很久，但最后还是拿到了优秀档，可能是我三万多字的实验报告有用吧（
173110,1597,李玉玲,2023-05-13 14:42:28,2,2,0,lyl老师为什么不是满分！
173115,1597,李玉玲,2023-05-13 16:53:26,1,1,0,女神老师，讲课很细很温柔，也很关心学生
173147,1597,李玉玲,2023-05-14 11:12:18,13,13,0,课好事少，大大减少了无效工作\n\n这不比某些老师好？\n\n能默默记住你的长相和名字\n\n所以用不着点名
174338,1597,李玉玲,2023-06-10 00:27:43,7,7,0,满分！电路1，电网分析，工磁都是直接听的李老师的智云！
179523,1597,李玉玲,2023-09-18 02:23:24,2,2,0,超级好～
183646,1597,李玉玲,2023-11-28 06:40:27,5,5,0,虽然很心疼隔壁班的同学但是哈哈哈哈哈哈哈哈哈哈哈哈哈哈哈哈哈哈
183673,1597,李玉玲,2023-11-28 10:22:08,5,5,0,李玉玲老师让我们下课时绕到对面去，老师说因为我们下课太早了，我们走的时候别的班都还在做实验，给别的班看见了不太好哈哈哈哈哈
185556,1597,李玉玲,2024-01-02 06:48:04,0,0,0,好老师，值得满分
187816,1597,李玉玲,2024-01-17 13:52:54,0,0,0,神中神
190052,1597,李玉玲,2024-02-17 11:24:33,0,0,0,整个大二最好的老师
191256,1597,李玉玲,2024-04-15 11:55:43,2,2,0,虽然电院好老师挺多的，但是李老师你别太好呜呜呜
191302,1597,李玉玲,2024-04-17 05:19:51,2,2,0,李老师真的很好，教学认真还会默默记住每个同学。但这学期的助教挺无语的，李老师说作业和实验这些平时分不用担心，但助教批起来是，七八道题里面错了也扣分，卷面也扣分，最离谱的是做完了抄一遍把卷面搞整洁ta说我过程不详细。。。如果都是这样且助教不换的话我觉得要慎选，但还是给李老师10分啦～
194393,1597,李玉玲,2024-06-23 15:15:22,0,0,0,给分很好
194394,1597,李玉玲,2024-06-23 15:15:38,0,0,0,好老师！
196177,1597,李玉玲,2024-07-02 04:07:41,1,1,0,女神老师，讲课很细很清晰，认真负责，会很耐心地解答问题，甚至还会牺牲个人时间帮学生线下答疑，很关心学生平时的学习，期末希望大家都能过，满分！！！！！！！
199363,1597,李玉玲,2024-09-22 07:47:37,2,2,0,很好的老师，耐心负责，很关心学生
200492,1597,李玉玲,2024-10-17 15:37:27,1,1,0,非常棒的好老师
206978,1597,李玉玲,2024-12-19 02:21:03,1,1,0,超级超级好，妈妈级别的，又温柔又有耐心，关键是事情特别少，四节课的实验课基本上两节课多一点就能做完走人了，无脑冲
217980,1597,李玉玲,2025-04-18 15:57:29,0,0,0,可以无脑冲选她课的级别，相对来说最稳定的好老师
219321,1597,李玉玲,2025-05-25 06:54:19,1,1,0,超级无敌爆好
220788,1597,李玉玲,2025-06-19 17:51:12,0,0,0,（电网络与分析）补个评价：老师挺好的，也关心学生，风评也都看见了。只是当时mooc期末考试，系统截止日期自动突然提前10多天，然后错了这部分，被坑惨了，挺难绷的。后面的同学要以引为戒，尽量早点做mooc
221927,1597,李玉玲,2025-06-27 13:12:26,0,0,0,PPT质量高，上课讲得好，给分也是能捞则捞，更关键的是不会为难学生、切身为学生着想，单这一点就已经赢了太多。总之，是可以无脑冲选课的级别，选lyl就完事了！
537,1600,杨欢,2015-03-15 04:28:15,23,27,4,教得一般，题目讲得不透彻。基本靠自学。
5623,1600,杨欢,2015-07-08 16:59:44,6,6,0,我们的班主任！很负责关心学生！欢哥！
8306,1600,杨欢,2015-09-18 05:44:42,-2,2,4,很负责很认真
15131,1600,杨欢,2016-01-12 07:04:56,2,3,1,好好好
23582,1600,杨欢,2016-04-07 06:46:30,13,13,0,人好，讲得一般，助教严。
25854,1600,杨欢,2016-06-12 09:40:07,4,4,0,不清楚，助教真的太太太太太严了
56361,1600,杨欢,2017-07-03 14:45:41,9,10,1,没找到张健老师就来这里，助教真的很严，作业很喜欢打叉叉，包括有些跟答案一样的题助教也不小心打了叉叉，估计很享受这种感觉吧。平时的任务全交了，到课不缺，平时分给了33分。总评85，真希望能再多给一分啊。。。就一分要求不高啊。。。
57078,1600,杨欢,2017-07-05 12:30:17,6,8,2,信号都是自学的，但是这平时分是什么东西啊？作业什么都认真做了40分只有33？
57548,1600,杨欢,2017-07-09 13:04:32,1,2,1,第一次遇到这种用平时分拉低我们绩点的老师
84224,1600,杨欢,2018-07-12 09:32:21,1,4,3,一般般，很一般，很失望。
84298,1600,杨欢,2018-07-12 13:09:23,3,3,0,老师人蛮好的
92433,1600,杨欢,2018-12-28 14:29:02,1,7,6,给张健老师打10分，给你打5分
105117,1600,杨欢,2019-04-04 02:02:34,0,5,5,讲的实在差\n\n
108903,1600,杨欢,2019-06-04 02:53:29,0,5,5,讲课实在是差，根本听不懂，光想着赶进度根本不管学生听没听懂，也不讲例题，垃圾老师
109452,1600,杨欢,2019-06-14 14:46:22,2,3,1,一般般吧，主要春学期大家自己也都没在听。
116089,1600,杨欢,2019-09-03 09:25:17,4,4,0,欢欢人很好！！涉猎也很广泛！
144750,1600,杨欢,2021-12-23 13:06:15,0,1,1,你。你看i哦
153478,1600,杨欢,2022-05-01 08:11:59,2,3,1,老师很好，同学们冲就对了
153608,1600,杨欢,2022-05-06 00:54:10,1,3,2,真的真的超有耐心的老师，有问必答，而且很厉害~
155031,1600,杨欢,2022-06-07 15:23:48,8,8,0,上的是信号课，与其他老师的课相比没有大作业，就只是实验和日常的每一章一次的作业。老师讲的很细，会从学生的角度来考虑问题，怕大家听不懂，会再讲一遍。课后假如去问问题，老师会去书上把概念都给你找出来一步步讲给你听很耐心的好老师。最后一节课复习课很有用~~~~~
155643,1600,杨欢,2022-06-15 03:01:38,3,3,0,感觉没有那么糟糕\n\n挺好的老师 ppt做的也很好 考前可以直接看ppt
157019,1600,杨欢,2022-06-21 15:08:41,3,3,0,老师人超级好！！！平时也不点名，讲课也很清晰易于理解。期末复习也很贴合考点，快冲杨欢老师的信号课啊！！
157022,1600,杨欢,2022-06-21 15:16:31,3,4,1,平时给分很好，考试也不难，老师也很关心学生；但是期末的时候“同学们有问题线上问我”——已读不回；lz平时分基本上满的，但是总评很低
157024,1600,杨欢,2022-06-21 15:24:22,1,1,0,欢欢超级好！！！人真的很好55555有问必答而且超耐心 给分也很好
157106,1600,杨欢,2022-06-22 02:47:55,0,0,0,老师很好，给分也很好。主要信号这门课课程比较烂，学起来感觉连贯性很差，全是公式推导，平时要多注意回顾。
159295,1600,杨欢,2022-07-11 06:17:56,4,4,0,老师本人非常和蔼可亲，上课认真负责，两位助教学长解答问题非常耐心，平时分给的高。
170499,1600,杨欢,2023-03-06 03:06:22,-3,0,3,讲得很清楚
173530,1600,杨欢,2023-05-28 04:20:54,2,2,0,公式啥的都不推，ppt放放，直接说推出来这个结果怎么怎么样，那和我自己看书有区别吗
175980,1600,杨欢,2023-06-27 10:14:38,0,1,1,主要是zj老师上课，yh给分一般，建议去zj班
176739,1600,杨欢,2023-06-30 03:19:15,0,0,0,yh给分还可以啊，就是上课讲的确实没有zj思路清晰，两个老师一起开班的给分啥的都差不多，lx感觉不够求是
177007,1600,杨欢,2023-07-01 04:49:06,0,1,1,讲的很清楚！
196723,1600,杨欢,2024-07-05 02:09:26,0,0,0,欢欢人很好，信号讲得也很清晰，推荐选～
220597,1600,杨欢,2025-06-18 23:21:25,-1,0,1,老师讲课挺好的，前八周就是稍微有点快了
220789,1600,杨欢,2025-06-19 17:52:23,0,0,0,挺和蔼的，其他忘了
221045,1600,杨欢,2025-06-21 04:05:57,-1,1,2,各方面都挺不错的，讲课可能略比zj差点但也不错了，作业、实验这些任务的传达比zj清楚，人也挺不错，作为副院长对待教学还有这个态度很难得了
221798,1600,杨欢,2025-06-26 09:42:20,0,0,0,挺好的老师，信号课讲得还行 最后跟不上应该是我的问题
41694,1632,史峥,2017-01-12 11:04:52,1,1,0,女同学有没有问题？
63654,1632,史峥,2017-12-11 22:58:04,1,1,0,好的好的好的
72130,1632,史峥,2018-01-29 12:02:01,2,2,0,需要认真听，多练习
75108,1632,史峥,2018-03-07 10:49:17,2,2,0,很好很靠谱的老师，咋没评价呢
50900,1660,胡斯登,2017-06-21 13:49:33,-27,6,33,人很善良的
51825,1660,胡斯登,2017-06-11 16:00:39,16,22,6,上课都是助教讲课，老师刻薄，脾气大
51925,1660,胡斯登,2017-07-01 04:17:19,27,32,5,下一届某班的同学不哭，其实除了这个老师，班上其他老师对大家是超级好的\n\n( ´•ω•)ノ(._.`)
52425,1660,胡斯登,2017-06-20 03:12:22,40,48,8,难受死了，不把别人的辛苦当回事，做的少了就是糊弄？助长恶竞之风！
52489,1660,胡斯登,2017-07-03 06:21:52,35,44,9,很随意的一个老师，说话做事毫无标准可言。检查期末作业刁难学生，而且带过来的王助教检查学生作业比老师还要坑。最后一节课老师都不来只是助教来检查作业，还威胁说要赶校车要我们快点，要不就扣分。研究生助教跟这样的老师在一起天天耳濡目染，早就被带坏了。研究生的悲哀啊。。。
55155,1660,胡斯登,2017-07-01 02:14:23,21,25,4,全部自学，啥也不讲
55159,1660,胡斯登,2017-07-01 02:22:28,29,38,9,我就当你这个功能没完成…\n\n给你们思考五分钟，思考完了吗，开始做吧。这…这节课时间很充裕喔，我…我只讲五分钟。我在清华读博士的时候…好的老师我们知道你是清华的博士，还出过国，真厉害
55162,1660,胡斯登,2017-07-01 02:25:05,-17,7,24,比较随意的一个老师，要求比较高，总是希望同学们尽可能的多做内容，所以熬夜是免不了的……但是的确是个蛮有趣的老师，没有什么架子也不故意刁难学生，如果讲课能更清楚一点就更好啦hhhh
55164,1660,胡斯登,2017-07-01 02:27:16,-22,5,27,人还不错，平易近人
55168,1660,胡斯登,2017-07-01 02:33:59,18,21,3,自力更生，艰苦奋斗！
55172,1660,胡斯登,2017-07-01 02:43:57,18,23,5,说实话，这老师丝毫没有老师的作用，一节课给个ppt然后讲5分钟，检查作业更是一塌糊涂
55176,1660,胡斯登,2017-07-01 02:50:36,15,19,4,要求不讲清楚.....
55186,1660,胡斯登,2017-07-01 03:08:43,10,12,2,不是很懂为什么我的分数会是全班倒数?
55206,1660,胡斯登,2017-07-01 03:41:23,18,21,3,不是很懂怎么给分的，还说让我们不要质疑给分标准，什么鬼啦。。。
55212,1660,胡斯登,2017-07-01 03:48:50,18,22,4,默默的给上面所有骂他的人点了赞。别的不说，助长恶竞这点真的呵呵
55420,1660,胡斯登,2017-07-01 13:03:37,-9,8,17,嗯，虽然评论各种差，但是这门课4。2在班里就快是倒数了
55493,1660,胡斯登,2017-07-01 15:50:55,17,21,4,盛气凌人……我觉得大家总结的已经很到位了
56062,1660,胡斯登,2017-07-03 04:15:07,19,23,4,“有没有退格？有没有掉电保护？”\n\n很多功能不是我们不会，而是在有限的时间内非要把一堆东西塞进去搞恶竞有什么意义？\n\n本科阶段应该更注重数理等基础的学习，不认为做个大作业就能提高多少能力，尤其是这种恶性竞争，害莫大焉
56122,1660,胡斯登,2017-07-03 06:37:15,17,20,3,老师您是清华的博士我们都知道了，您真厉害
57677,1660,胡斯登,2017-07-12 07:34:16,20,24,4,怎么说呢，来来来，我们开始上课了，好的，大家都懂了吧，现在开始写代码吧。\n\n期末检测，你的计算器不能算小数啊，还不能连加连减，那只能80了。\n\n什么，我要求没讲清楚，是啊，就是这样子的，你做系统还不考虑客户体验，自己分数低还怪我，分数低请不要来找我，谢谢，要不你写一篇论文吧，论单片机课堂应该如何给分，到时候我一定拜读一下哦
80598,1660,胡斯登,2018-06-28 07:37:22,-6,8,14,我觉得还行
80628,1660,胡斯登,2018-06-28 12:59:17,-8,7,15,人挺好滴
80630,1660,胡斯登,2018-06-28 13:40:41,-3,8,11,其实还行
80639,1660,胡斯登,2018-06-28 23:49:07,-4,7,11,其实老师还是很不错的，助教也很好，
83835,1660,胡斯登,2018-07-11 09:34:37,-13,3,16,老师挺好的
106638,1660,胡斯登,2019-04-29 07:32:59,14,16,2,垃圾，至少三个字，很垃圾
106739,1660,胡斯登,2019-04-29 07:30:02,9,10,1,辣鸡老师
109693,1660,胡斯登,2019-06-18 12:23:59,7,9,2,计算器和洗衣机都要搞清楚整个流程，比如说计算器既可以连加也可以直接重新开始另一个算式，比如说洗衣机脱水之前要把水排干。另外，实验报告（老师说）不看代码，最好写调试过程、摘要、目录等。
109697,1660,胡斯登,2019-06-18 12:36:29,6,7,1,你跟他谈代码，他跟你谈效果。
109751,1660,胡斯登,2019-06-19 03:54:18,6,7,1,很差哦，给分最差的爱班老师
109757,1660,胡斯登,2019-06-19 05:01:14,11,12,1,我只是来给byn助教打call的！助教人超好！
110141,1660,胡斯登,2019-06-23 16:28:21,6,7,1,”我讲的东西，我估计90%都听不懂，但这不重要” !???
112337,1660,胡斯登,2019-07-04 02:10:52,6,8,2,给分极差
112478,1660,胡斯登,2019-07-06 02:15:02,7,10,3,我这1分是给byn助教的，老师上课和给分都很垃圾，还自以为自己很厉害......\n\n
115412,1660,胡斯登,2019-07-22 02:18:42,7,8,1,建议把这个老shi安排在所有课程学期的第一节课，可以提前锻炼不良环境的生存( •̥́ ˍ •̀ू )
115634,1660,胡斯登,2019-08-13 03:21:42,13,14,1,垃圾，请问你是什么垃圾
116700,1660,胡斯登,2019-09-13 13:51:58,9,11,2,我的班主任，请问您开个班会课要提几次T大？
124413,1660,胡斯登,2020-06-30 12:37:33,5,6,1,感觉不太适合当老师，把师生关系当作上下级关系一样，不愿意教学生东西，但是很看重学生做出来的结果。
138585,1660,胡斯登,2021-07-10 02:34:32,14,14,0,"老师前几届怎么样的我不了解。我是19级的，感觉整个学期下来老师真的是超级好，在爱班的所有上过的实验课里面可以说排在前几的不为过。\n\n首先，老师这届的实验讲课节奏和顺序感觉很不错，不会像其他一些实验一样有一定的门槛和适应期。\n\n其次，这届老师是不怎么要求实验报告的。平时的一些实验内容在课上自己完成即可，老师会随缘选几个内容比较少的实验让交一下实验报告，内容真的很少，基本都是两三页搞定。最后期末大作业实验设计书，老师怕我们压力太大，特地要求只写三页。\n\n还有，平时老师非常有亲和力的，上课总是很早就到。到了之后一般都是在实验室里溜达。看看同学们都在干些什么，找同学聊聊天。上课实验的时候，也走到下面帮助同学解决问题。遇到问题，或者某个问题压根不会的时候，他都会耐心讲解。最后大作业验收的时候也很宽松，让同学处于一种放松的状态，不会出现某位老师的""你还有一次机会""的情况。如果某个功能没做出来，老师也不会说什么，甚至还有安慰你，有被暖到。\n\n最后最关键的是这届老师给分特别好，我大作业有些功能还没实现，但老师说只要是看到我们自己认真做了就行。真的很nice。最后提一下助教，白助教真的很温柔，没有任何架子。从来都是认真听同学的问题，并想办法解决，对都有同学都一视同仁。\n\n之前没出分的时候看到前面的评价还有点担心，现在分数刚出，就凭这个分数也要来评价一波。不知道老师前几届是什么样子的，如果前几届真像前面所说的那样，那这届老师是真的变了。本着求是精神，给老师点一个赞。"
140380,1660,胡斯登,2021-09-10 10:14:32,2,2,0,有一说一，上课自由度高，给分挺好的。
144522,1660,胡斯登,2021-12-22 05:14:22,5,5,0,就我19级某班上课经历，赞同之前那位老哥，我是我们班唯二把板子烧了的，胡老师用非常亲和的语气和我们协商解决，最后结果是再买一块，然后我们帮老师焊回去；上课节奏方面，胡老师应该是吸取了前面几届的教训，每一行代码都等我们完全没问题之后再继续，体验极佳；鹅颈的话确实有，但比不过其他几门某班的实验课，给分巨好；老师很求是，点赞！
151124,1660,胡斯登,2022-02-23 08:45:56,13,13,0,Houston， we have a problem.
153599,1660,胡斯登,2022-05-05 11:37:45,7,11,4,坐标20级爱班，刚检查了微机实验的期中作业，老师并没有你们说的这么难伺候（或者说改过自新了？），检查作业很和蔼，能给的分也都给了，打分真的很不错，甚至打分之前还会和我们商量，“就跟他一样了？”“等你调出来了再给你挣扎一下”。包括这次大作业考虑到考试周取消的原因，还会和我们商量检查时间delay的事情，平常上完课也愿意留下来陪同学debug，拍拍你的背，跟你侃侃大山，可以说是亦师亦友。从我的角度来看，并没有前辈们所说的那么差，甚至他一次也没有提过他的T大。如果是老师真的变了，我愿意给他这个机会，10分奉上不谢！
163650,1660,胡斯登,2022-12-16 02:00:39,0,2,2,坐标20爱班，感觉没有之前学长学姐说的这么不堪，至少个人观感是能商量，也愿意听学生意见的
179559,1660,胡斯登,2023-09-18 08:15:04,9,12,3,口蜜腹剑胡斯登
193137,1660,胡斯登,2024-06-04 03:21:59,0,1,1,还行，在改，先给个十分，某班觉得听着还行，喜欢折腾学生，但是感觉无恶意
10876,1691,林振智,2015-11-23 08:00:56,25,30,5,良心好老师！讲得好！人好！答疑非常耐心！考前划范围！
11838,1691,林振智,2015-12-17 05:23:43,9,9,0,好老师，可爱*^o^*\n\n
36356,1691,林振智,2016-11-12 07:36:57,8,9,1,很好！把“讲一讲”说成“捡一捡”
41293,1691,林振智,2017-01-10 12:04:06,5,5,0,棒棒棒
72190,1691,林振智,2018-01-29 14:11:53,7,7,0,老师人很好，很年轻，口音很可爱
72241,1691,林振智,2018-01-29 15:25:10,5,5,0,老师对学生很好 就是稳态这门课给老师的时间太少了 老师想给大家多讲一点 但时间也不允许 没法展开讲很多
72251,1691,林振智,2018-01-29 15:53:22,3,3,0,挺好的老师，希望能多一点时间讲专业课吧~
74004,1691,林振智,2018-02-04 05:01:23,1,4,3,好老师！就是学校给的课时太少，老师没法把知识展开
86404,1691,林振智,2018-09-15 07:08:42,1,5,4,cdc NM$L
101372,1691,林振智,2019-01-28 06:34:38,-37,15,52,非电气专业的就不要选了，根本学不到什么，期末考30个判断题，10个2分的多选完全就是靠背，背书背ppt，计算题简单到没意思，估计文科生来做，表现要好的多。我可qnmd吧!有意思？学个? 啊!!!
135214,1691,林振智,2021-05-06 05:04:37,2,4,2,我家小朋友的导师，不错子
148014,1691,林振智,2022-01-11 10:15:57,15,17,2,好老师，但是稳态这门课被sb本科生科排到大三上和电机学控制理论什么的一起上，替我问候一下本科生科那些乱改培养方案的老师的妈妈，哦，他们没有，那没事了～
150650,1691,林振智,2022-02-10 01:54:25,1,2,1,林老师备课认真，讲课仔细，口音可爱，答疑耐心，大赞！！！
170572,1691,林振智,2023-03-07 00:49:23,11,13,2,很一般，不知道评分高在哪里，给分不好。
182597,1691,林振智,2023-11-18 03:31:45,2,5,3,出的什么构思试卷，给文科生做的
189132,1691,林振智,2024-01-22 05:37:05,-6,4,10,那些给老师恶意刷低分的识趣点好吗？自己平时一节课不来最后临时抱佛教发现来不及的再这边yygq，是不是多少沾点
194168,1691,林振智,2024-06-22 10:02:29,2,4,2,个人不喜欢，一直在宣传山林寺。平时上课水水过，最后疯狂赶进度。
202681,1691,林振智,2024-11-14 00:46:35,5,5,0,讲课及其他几个老师好，但给分也挺一般
203016,1691,林振智,2024-11-16 02:26:02,3,3,0,不知道为什么评分高，给分很差，而且作业布置不会提前说，赶进度，基本布置了作业一周内要交，稳态的作业上过的都知道题目计算量很大难度也高，总之这课学得又折磨给分又不好
208333,1691,林振智,2024-12-27 02:16:53,1,1,0,“我们很注重时间观念的”指4个人开题答辩能拖1个小时
190,1695,周箭,2015-03-14 16:40:07,40,69,29,上课认真负责。。但是分数过于求是。。
2216,1695,周箭,2015-04-09 14:18:18,28,48,20,好老师！虽然成绩很求是，但是上课更加求是！\n\n老师很儒雅，很有耐心，很负责任，很富有童趣，总之炒鸡好。
3366,1695,周箭,2015-06-07 12:20:09,-9,12,21,给分太TM求是了！真不公平
3367,1695,周箭,2015-06-07 12:25:21,17,23,6,老师温文尔雅，认真负责，求实精神贯穿始终。嗯，就是这样。
5004,1695,周箭,2015-07-02 03:08:29,-6,3,9,上课认真，实验课比较水。成绩求是
6175,1695,周箭,2015-07-11 15:42:31,12,14,2,负责任，好老师，好好做实验老师都记在心里的
8425,1695,周箭,2015-09-21 07:09:58,8,11,3,好老师，不解释。
11223,1695,周箭,2015-11-25 10:28:07,10,19,9,总是黑光电
12640,1695,周箭,2015-12-23 17:24:04,11,12,1,好老师呀！
13752,1695,周箭,2015-12-30 14:22:45,12,14,2,温文尔雅。是个读书人的样子！
13975,1695,周箭,2016-01-03 08:19:36,-11,3,14,两个字：求是。5.5分的模电要被坑死了，羡慕隔壁范橙汁老师。
18941,1695,周箭,2016-01-22 23:58:34,7,11,4,上课认真负责，对学生也特别负责，问什么都能在给你讲一遍讲清楚。只是给分过于求是
19973,1695,周箭,2016-01-25 17:20:12,8,11,3,好好好
20378,1695,周箭,2016-01-27 08:26:02,77,102,25,以为老师很坑，然后很努力的去学，发现周老师一点不坑，真的很负责，最后97分，周老师讲得很清楚，ppt做得很好，只要努力学，不会很差
20380,1695,周箭,2016-01-27 08:49:25,32,50,18,谁再说zj绩杀我跟谁急
20398,1695,周箭,2016-01-27 12:27:12,16,18,2,课讲得非常清楚，人也很耐心负责，给分也就说得吓人实际上也还好的吧
20412,1695,周箭,2016-01-27 13:39:38,18,21,3,业界良心
20688,1695,周箭,2016-01-30 00:44:13,10,12,2,讲课耐心
20700,1695,周箭,2016-01-30 03:08:29,19,24,5,什么叫求是 这样的老师才是合格的老师 虽然是讲师但却有极强的原则 平时付出了老师都看在眼里 分数也是真实水平的反映 不知道说击杀的是什么心态？
21277,1695,周箭,2016-02-28 02:59:53,11,12,1,期末给分很可以，老师很温和哦~
22548,1695,周箭,2016-03-08 01:36:11,3,7,4,儒雅 有种唐僧的感觉
22697,1695,周箭,2016-03-10 03:11:28,9,11,2,PPT超清晰，在PPT上写字也超有条理
26711,1695,周箭,2016-06-21 03:06:39,18,20,2,理想中的老师 温文尔雅耐心负责 实验报告中对于的任何问题和疑惑老师都会亲自找你给你解答 讲课也很细致周到认真学习能有很多的收获
27988,1695,周箭,2016-06-28 07:57:21,7,9,2,模电实验期末考试不限时间，赞，PPT有时实验步骤不全面，整体还可以吧
30979,1695,周箭,2016-07-03 05:37:57,7,10,3,好感动，给分很棒！平时好像没有好好听课但是实验有好好做所以各种原理也知道的差不多，最后系统的复习了一下竟然就满了，感动！
31281,1695,周箭,2016-07-03 14:03:12,13,15,2,老师真的很求是，每次报告都会详细的反馈，而且上课也讲得很认真，另外，绝对不是绩杀！！
31417,1695,周箭,2016-07-04 01:37:58,4,6,2,一分耕耘 一分收获
31537,1695,周箭,2016-07-04 05:46:20,-9,2,11,实验很水，基本不验收，反正实验课给分挺好的
31856,1695,周箭,2016-07-05 04:29:08,4,6,2,非常好 耐心 温文尔雅\n\n
34534,1695,周箭,2016-10-13 02:10:05,8,9,1,很温柔的一位老师
34592,1695,周箭,2016-10-15 07:06:02,7,8,1,好老师啊！
35308,1695,周箭,2016-11-08 06:16:54,26,33,7,不知道大家是怎么想的……反正我觉得这么认真负责的老师真的太少了！模电:上课的态度，讲课的方式，总是有一种温暖的感觉。虽然不知道给分如何，但是一定很合理。给人一种父亲的感觉（自己体会）……再加上王旃老师的模电实验，总有一种家的感觉……
38628,1695,周箭,2016-12-12 16:45:53,13,13,0,真的很好，是我的男神
47403,1695,周箭,2017-01-26 04:39:06,11,14,3,周箭我男神  讲课条理清晰，人也很好很幽默。  期末考之前会吓吓你叫你认真对待考试，其实给分很好的。
47931,1695,周箭,2017-02-27 10:34:36,7,10,3,表白周箭老师！我上了他的模电，不能更好！PPT很清晰，而且会很耐心地解答问题，给我一种就算我是zz也不会被他嫌弃的温暖感！然后他真的不是绩杀，好好学肯定会有回报！PS我这学期拼死选上他的数电，跟定这个老师了
49968,1695,周箭,2017-04-28 01:14:00,6,6,0,好老师，不解释
50378,1695,周箭,2017-05-02 13:58:47,13,15,2,周箭爸爸超有趣，平时还会和我们开玩笑。。课件都会传到群里，认真学一定会有收获的
50730,1695,周箭,2017-05-04 15:25:40,7,8,1,条理很清晰，注意听老师讲的例题，数电还是比较容易学好的
50736,1695,周箭,2017-05-04 16:05:22,8,8,0,幽默风趣的好老师
50737,1695,周箭,2017-05-04 16:15:06,8,9,1,绝对好老师，上个学期我模电是他的课，考得不好，但都是因为自己能力有限，这学期又上了数电，考的还算理想，总之，感慨颇多。。。谢谢老师！
50831,1695,周箭,2017-05-06 06:08:50,4,5,1,好老师。
50947,1695,周箭,2017-05-09 14:57:24,4,4,0,好好好
52919,1695,周箭,2017-06-23 13:43:32,5,5,0,老师温文尔雅，讲课、考试、报告都有自己独特的方式和要求。特别细心耐心，好老师！\n\n
57291,1695,周箭,2017-07-06 12:02:04,12,12,0,我从未见过如此可爱的老师?\n\n在老师的实验课上可以学到包括理论和实验的很多知识，很多时候不是在复习理论课就是在预习。老师会陪同学做实验到最后一刻，课堂课后也是经常答疑解惑。考试的时候也是给足时间，可以说是非常棒棒的了～
57658,1695,周箭,2017-07-11 15:32:12,3,3,0,好好好
59880,1695,周箭,2017-09-28 03:48:03,48,54,6,QQ头像是老鼠?
64568,1695,周箭,2017-12-25 09:41:39,3,5,2,超级好！
65094,1695,周箭,2017-12-28 16:14:52,8,9,1,爸爸一样的老师，超级好，要是选不上他的数电我就要哭啦
67193,1695,周箭,2018-01-20 12:36:24,2,4,2,老师人特别好，超级喜欢他
73509,1695,周箭,2018-02-02 00:14:43,5,6,1,耐心负责，浙大应该有的好老师
73681,1695,周箭,2018-02-02 14:48:52,7,8,1,刚开始感觉老师很坑，尤其是前半学期电路原理部分学的有些不明白，后来冬学期反思了一下自己，模电部分投入了很多时间，发现老师讲的还是很好的，祝各位取得满意成绩！
73682,1695,周箭,2018-02-02 14:57:36,2,4,2,讲课讲得不错
73928,1695,周箭,2018-02-03 15:00:30,5,6,1,真的超级喜欢这个老师，太好了
74070,1695,周箭,2018-02-05 00:45:58,16,17,1,少见的极其认真负责的老师\n\n以及请各位学不动模电时牢记一句：这课5.5学分
74390,1695,周箭,2018-02-17 12:59:55,3,5,2,老师人很不错，温文尔雅，上课讲解也很详细，也很有耐心，给分也很不错。希望上周老师课的同学好好珍惜。
74619,1695,周箭,2018-03-05 00:26:37,6,7,1,周箭爸爸绝对是非常好的老师不解释~
75662,1695,周箭,2018-03-15 02:00:36,5,7,2,老师很不错的
75810,1695,周箭,2018-03-19 03:40:27,-13,1,14,優しい
75948,1695,周箭,2018-03-22 12:13:51,48,55,7,周箭经典语录 爆笑！\n\n\n\n二阶电路和一阶电路本质上没啥区别，无非是把1改成2了\n\n这个电路应该说说就能做完了\n\n当然这个只是说说而已说起来好像方法就这些计算起来肯定还是有一定工作量的\n\n首先要判断非截止区，这个不用多说，眼睛看看\n\n这个电容爆的时候，有声音的，声音还挺响的\n\n这里建议大家先算戴维南等效，有些同学喜欢…这个我只能说，你电路学的不错\n\n写肯定可以写，无非就是累一点\n\n这些例题我们讲讲，其实没什么好说的对吧\n\n这些东西听起来可能比较无聊，可能是因为你们现在对这些式子都不熟，我说对的我说错的好像你们也也觉得不能想想\n\n模电基本都是说说而已，不怎么用去想\n\n模电考试也就会轻松一点，都是说说对吧\n\n看看好像都对，实际上每个地方都有点错\n\n模电都说是看看，不是靠算，永远算不出来\n\n这边的写写表达式看看应该就出来了\n\n反馈的判断，第一步，用眼睛看，第二步，用眼睛看，…当然这里不是眼睛看就能算数，脑子还要配合一下\n\n你们能想到的数学表达式运放都能算，比如均方根，阶乘之类的，当然这个表达式复杂一点运放当然就累一点，累不是说运放累，是说这个电路会复杂一点\n\n上面这个电路看着很多，实际上你看看好像就只有场效应管对吧
79804,1695,周箭,2018-06-14 01:44:30,7,9,2,数电课 老师特别温暖啊很负责！！！最负责的老师了，发现你作业问题都会QQ私戳你，作业上有题没听懂打了个问号，上实验课的时候老师就来单独找我问我哪里不明白，真的好。大学上课能遇到这样的老师真的幸运啊！
80073,1695,周箭,2018-06-19 15:08:17,7,10,3,这样的老师就活该得10分
83706,1695,周箭,2018-07-11 04:50:47,2,4,2,好老师，认真负责
85658,1695,周箭,2018-07-24 09:20:27,-9,1,10,模电实验挺迷的，感觉从实验到报告都比较随意，但最后考试比别的班要求都高不少。
87561,1695,周箭,2018-11-12 11:51:46,-21,5,26,照本宣科的感觉。。。
90965,1695,周箭,2018-11-28 06:50:11,-5,8,13,模电上成了玄学啊。。
93139,1695,周箭,2019-01-07 15:14:10,7,9,2,为什么会有这么迷人的老师啊啊啊！！！
101720,1695,周箭,2019-01-29 02:23:38,2,3,1,周爸爸啊啊啊啊啊啊\n\n我永远爱周爸爸
101722,1695,周箭,2019-01-29 12:57:43,1,2,1,周老师实在是太可爱啦！我给满分！！！
101732,1695,周箭,2019-01-29 02:58:47,1,6,5,老师超好，给分求是，是我太菜?
101735,1695,周箭,2019-01-29 03:03:05,0,1,1,很棒很棒
101767,1695,周箭,2019-01-29 04:26:04,3,5,2,非常认真负责的老师，他所希望同学们掌握的都是方法，都是希望在这门课之后能够留下的电路技能，试问从小到大，能有几门课可以不看答案，只看过程，期中多少水平我自己清楚，期末总评能拿这分有多少老师的关怀也一清二楚，非常感谢周老师的教导!\n\n
101835,1695,周箭,2019-01-29 08:39:37,16,18,2,本人微积分2和大物2都只有六十几分，非常菜了。电路与模电这门课，期中考电路部分是属于“远远没及格”这部分，最后总评上七十了。感谢老师期中考之后出来刺激我让我之后憋着一口气学到最后，也感谢老师对我期中成绩的宽容。
101850,1695,周箭,2019-01-29 09:18:16,1,2,1,超级负责超级好又有趣的老师
102398,1695,周箭,2019-02-01 12:04:21,1,2,1,来浙大这一年半中大概是最负责的老师了，作业都是自己批改，批改时发现任何问题都会QQ上给你留言~PPT也非常好，模电还会把考试考什么说的非常明白！还有《老生常谈》，也可以说是非常有帮助了，说真的，这个学期的模电是真的享受！只可惜下学期数电就不是老师的了……
103454,1695,周箭,2019-02-28 07:42:35,0,1,1,善解人意，耐心负责，上课条理清晰口齿清楚，绝对满分老师，不能要求更多了。
104738,1695,周箭,2019-03-27 01:03:19,6,9,3,PPT鼠标手写大师！讲课超级有条理，ppt看起来也很舒服。以及老师一直亲自改作业和实验报告，发现问题还会在QQ上私戳，真的是用心上课的老师了ww
105283,1695,周箭,2019-04-09 05:16:36,1,2,1,儒雅随和的老师，亲自批改作业和实验报告，不认真学的会被私戳喝茶的。
106892,1695,周箭,2019-06-11 16:13:05,1,4,3,真的是以为老师很坑，快上完了有点后悔没有好好适应老师、好好预习实验了呜呜呜！老师还是很好的，他的教学方法确实有利于提高学生的实验能力。一定要好好预习！
108340,1695,周箭,2019-05-28 02:10:23,0,1,1,还好吧
109673,1695,周箭,2019-06-18 08:59:25,0,3,3,真佛真好
112127,1695,周箭,2019-08-14 08:15:09,4,6,2,周老师绝对认真负责，不认真还会被私戳，督促着我认真学习数电。最重要的是，周老师实在是太可爱了！老师每次在群里发言的时候，语气都会逗我一笑。
114975,1695,周箭,2019-07-13 12:45:06,-39,4,43,话不多说，最后96/5.0
115039,1695,周箭,2019-07-14 23:28:39,-38,0,38,话不多说，最后89/4.5? ? ? ?
115102,1695,周箭,2019-07-15 14:42:50,4,11,7,成绩出了点问题，问了几句就不耐烦了。老师讲课还可以，很负责，但这种态度我是真的不能理解。我又没有要求什么，只是想了解一下自己的成绩，问了四五个小时才非常不耐烦的告诉我。
116877,1695,周箭,2019-09-17 02:56:34,-2,9,11,给分极差
117132,1695,周箭,2019-09-19 17:40:51,4,6,2,老师很好 电工实习给了3.5 为了这个短学期画接线图 写程序 做仿真经常搞到十二点 是我太菜了 0.01均绩没了
117316,1695,周箭,2019-09-23 02:05:49,-1,3,4,温文尔雅，君子之风
117720,1695,周箭,2019-09-30 01:47:24,38,39,1,费玉清
121918,1695,周箭,2020-01-23 17:58:55,2,5,3,这个男人，我爱死他了！\n\n温文儒雅，思路清晰。只要你努力，而且被老师看到你的努力，老师都会给你一个不错的分数的！
122743,1695,周箭,2020-03-28 12:53:39,3,5,2,给力！难顶
123061,1695,周箭,2020-05-07 07:47:38,-1,2,3,真没想到，数电课程竟然提前好几周就结束了，秋学期考试就离谱，不过老师真的是个好老师！
123274,1695,周箭,2020-05-28 02:52:56,9,11,2,本届体验感极差
123748,1695,周箭,2020-06-13 10:43:39,-1,2,3,周箭老师人很和蔼，期中考的不是很好也不要紧，期末考好一样高分
123991,1695,周箭,2020-06-19 02:34:53,11,11,0,效果，部分，效果部分
124887,1695,周箭,2020-07-15 01:12:14,2,4,2,网课效果体验不佳，老师是好老师，就是方法感觉有点压力大
125727,1695,周箭,2020-09-13 15:25:17,-19,1,20,数电内容不多，平时没怎么听，最后期末考前看了一下午，刚刚出分，4.5，挺不错的
125746,1695,周箭,2020-09-14 02:28:57,12,13,1,看看数电均绩，说明一切
128411,1695,周箭,2020-12-22 12:43:03,1,5,4,这是我遇到的最nice的老师，我对浙大情感最深处可能就在于模电了
129108,1695,周箭,2020-12-30 07:16:16,5,16,11,阴阳人
129409,1695,周箭,2021-01-05 06:20:28,7,7,0,啊，好，用眼睛看。\n\n这道题，看看就行\n\n啊，行，那我们说，啊对，也对。\n\n想想看，应该没有什么问题
130686,1695,周箭,2021-01-24 07:55:39,9,10,1,这个属于，效果，效果部分\n\n弱弱地问一句，虚短虚断够用不
132051,1695,周箭,2021-01-30 04:20:14,8,11,3,隔壁czf出分后第二天作为zj男神的学生过来膜一下顺便给个10分\n\nzj治学功底深厚，上课逻辑清晰思维连贯，但是节奏比较快，有时候会像大跃进。上课时对学生哪些部分要花力气，哪些部分不用掌握原理只用背等等拿捏的非常到位。答疑时也非常耐心仔细，温文尔雅，是个非常好的老师
132547,1695,周箭,2021-02-02 08:18:41,-4,2,6,周箭爸爸上课条理清晰，但是不会讲的很细，需要自己课后去自己复习
132556,1695,周箭,2021-02-02 08:43:04,14,16,2,今天模电成绩出了，跟预期一样，非常低，导致这学期其他科目的努力全部白费，挺伤心的，所以来这里评论一下。首先zj老师我认为非常好，上课条理清晰，讲课耐心，温文尔雅，也很幽默随和，虽然我这学期没有好好听课，但是仍然能感受到他的专业水平和个人气质都很棒。但是他最后只会捞不及格的同学，对前面的低分同学基本不会调分的，当然这更多的其实是我自己的问题，一开始就没认真对待这门课，又因为自己不是太聪明，后面就一直跟不上。所以对后面选zjbb模电课的学弟学妹们要说的是，老师真的不错，但是要认真学才能考到高分，毕竟这一门学分5.5，对均绩的影响挺大的，对以后帮助也很大，所以希望以后的同学认真对待这门课，一开始就不要松懈。就难度而言，对一般人肯定会比较难学，上半学期的电路部分是后面越来越难，下半学期的模拟电路部分是一开始就很难，但是搞懂了后面就越来越简单，大概能说的就这些了吧。
132564,1695,周箭,2021-02-02 09:28:55,4,6,2,老师是个好老师，上课柔声细语的，常有催眠buff。进度跳跃。个人还是期中考差了点，不过努力一下期末还是能取得不错的成绩的（期中之前的电路原理内容在期末基本不考，虽然也有用到。期末主要还是模电。
133110,1695,周箭,2021-02-08 13:53:00,10,14,4,前排已经评论的很到位了，这边着重说点前面没太提到的\n\n个人感觉在zj的班上应试会相对容易一些，老师平时讲课时会提到考试要考什么大题，什么题型，甚至具体到课件上的哪张图（当然一般不是原图，但也变化不大），基本等于把大题都提前交代了。模电难是难，但好在考试的套路基本年年固定，尤其大题，在准备上还不是特别困难的，搞通课件这一节最复杂的一张图，往往就拿到了期末的一道大题。此外，老师讲课时会讲很多经验性的结论、思维方法，个人认为这些是需要着重理解的。但模电细节太多，上课基本听不明白什么，基本都要靠课下自学、听回放，配合老师的讲述，如果足够努力，还是可以理解的。总之，zj讲课清晰，课件让人感觉舒服。绝对的10分。
139052,1695,周箭,2021-07-12 09:38:15,0,4,4,上课用心，会捞人，学弟学妹们认真学啊，给分会很好的
140948,1695,周箭,2021-09-18 06:28:11,2,3,1,周爸爸！
144849,1695,周箭,2021-12-25 06:39:30,21,22,1,他态度不卑又不亢，他神情不阴又不阳。\n\n周老师，你又要搞什么鬼花样？
144878,1695,周箭,2021-12-25 11:35:45,-7,2,9,给分好，讲课好，长的帅，学弟学妹赶紧选
145049,1695,周箭,2021-12-27 05:19:03,2,4,2,讲课像打太极
145058,1695,周箭,2021-12-27 06:39:35,9,10,1,阴阳大师，安倍晴明
145667,1695,周箭,2021-12-31 04:24:35,3,3,0,只捞不及格的，老师人很好
145894,1695,周箭,2022-01-04 01:26:43,2,4,2,安倍晴明
147556,1695,周箭,2022-01-10 08:19:31,1,2,1,过了 终于过了
148639,1695,周箭,2022-01-13 05:31:55,25,28,3,出分前来评论一下\n\nzjbb平时讲课是非常ok的，菜确实是我自己的原因，但是zjbb给分真的吓人……\n\n\n\n希望能在zjbb手下活下来\n\n\n\n附zjbb的最新语录：\n\n《镜子》\n\n《不是个例》\n\n《并非罕见》\n\n《阶跃信号》
150124,1695,周箭,2022-01-19 08:29:31,11,16,5,老师他好温柔，我真的哭死😭
150128,1695,周箭,2022-01-19 08:45:15,22,25,3,zjgg直接绩杀
150140,1695,周箭,2022-01-19 09:52:31,16,20,4,讲得很好，绩杀，杀疯了都
150148,1695,周箭,2022-01-19 11:33:28,13,14,1,挂了，但是老师很好的，就是我太菜了
150161,1695,周箭,2022-01-19 15:55:52,2,11,9,周老师讲课真的很好！！！\n\n是那种成绩就算很差 也不会认为是老师上课的问题的好\n\n但是给分相比其他模电老师可能求是了一点（只捞不及格的）\n\n我只能说，多少付出多少回报\n\n希望学弟学妹选到周老师班的不要觉得绩杀\n\n相信一点，模电，5.5学分。\n\n平时多付出一点，因为以后模电的知识是绕不开的。\n\n应考，建议结合老师最后一节课说的复习。
150201,1695,周箭,2022-01-20 14:29:07,21,31,10,周箭，你个不要脸的，老子辛辛苦苦付出这么多，你tm直接给我来个低分+卡绩？？\n\n你tm差不多得了😅
150233,1695,周箭,2022-01-20 23:36:42,18,23,5,傻逼老师\n\n大家快跑！
150240,1695,周箭,2022-01-23 07:41:49,25,27,2,大阴阳师安倍晴明
150360,1695,周箭,2022-01-23 07:43:22,26,29,3,无语了不解释，大寄杀，阴阳怪气
150377,1695,周箭,2022-01-23 14:41:42,19,24,5,除了整天搁群里面阴阳怪气，期末绩杀之外，还会什么？？
150474,1695,周箭,2022-01-26 05:14:05,22,24,2,阴阳大师安倍晴明
150475,1695,周箭,2022-01-26 05:14:04,20,22,2,阴阳大师安倍晴明
150587,1695,周箭,2022-01-31 09:55:33,-13,7,20,模电5.5学分，本来模电部分开始三极管场效应管和多级放大那些都是基础，这学期又赶上疫情线上授课，听课效果难免会打很大折扣，更不必说周老师讲课速度很快，按我“预习”看老师课程回放的经验模电部分的第一章没有花课程安排上150%的时间很难弄懂，后面的部分会好理解一些但是也有很多要背诵的东西，考试题量会刚好不够时间来现场推导公式，纯靠期末补天的话大概也要个60小时以上有效复习时间才能拿到还看得过去的成绩（按周老师的经验每个教学班都会有20%不能捞到及格的同学）\n\n周老师讲课水平很高，跟着他的课程（录像）走基本就能掌握考试内容，PPT也很清晰，只是学习的话我还是比较推荐周老师的，但是给分真的很求是，对绩点有期望的慎选\n\n跟学生的沟通上的话可能是有一些代沟，线上沟通有一些话越看越像阴阳怪气，不过线下教学还是风趣幽默的风格\n\n希望之后的同学们在这门课上多多下功夫，模电是一门（基础打好了）越学越有意思的课程
150603,1695,周箭,2022-02-03 13:25:58,27,29,2,阴阳大师安倍晴明
151145,1695,周箭,2022-02-23 11:46:32,15,15,0,呜呜呜
152406,1695,周箭,2022-04-08 10:57:18,15,17,2,真的阴间
152729,1695,周箭,2022-04-19 03:10:18,18,21,3,快跑呀，傻孩子们！
155129,1695,周箭,2022-06-08 14:53:30,13,15,2,害人不浅，期末考试之前看大家比较菜说要更改考核标准，敢情是改的更狠了。
156164,1695,周箭,2022-06-18 03:53:41,23,27,4,sb老师，p事多给分差
156170,1695,周箭,2022-06-18 04:13:08,20,23,3,期末不写座位号扣两分，不写上下午扣一分，差不多得了哈😅😅😅
157720,1695,周箭,2022-06-24 12:40:44,25,28,3,给分是真的差，还经常阴阳怪气，差不多得了😅
158066,1695,周箭,2022-06-26 14:30:28,-9,6,15,好老师？。。？。？
161158,1695,周箭,2022-10-30 05:42:07,13,15,2,阴阳大师，绩杀怪人，第一次这么厌恶上一门课
162741,1695,周箭,2022-12-05 11:57:38,12,12,0,老师长的好像费玉清
165098,1695,周箭,2022-12-29 06:41:32,18,21,3,？？？什么sb老师啊 上网课了一周两次小测 你没事吧 隔壁班轻松地要死 你今天这个事 明天那个事 上课讲例题，也讲得飞快 大部分例题说都不说 好像有人讨命一样 作业题基本不讲 就是把答案拿出来让你自己对 那我要你当老师干吗？不如自己看PPT 真的离谱 不知道为什么这么高分 除了这些 还有期中成绩也很离谱 隔壁班九十以上二十多个 我们班一共两个 呵呵哒
166063,1695,周箭,2023-01-11 04:06:18,-2,4,6,好老师，不解释
168124,1695,周箭,2023-01-29 07:43:24,2,4,2,模电，老师温文尔雅，讲课条理清晰；经常督促同学们好好学习，反复强调这门课在课外要付出1.5-2倍的时间复习消化，所言非虚；给分实事求是，想得到高绩点必须自己努力。
168540,1695,周箭,2023-02-19 09:04:13,2,3,1,上课很负责，给分太求是
168846,1695,周箭,2023-02-22 19:52:55,1,5,4,出分前来评价，上课很有条理，但比较快，需要课后花很多时间来消化。经常有课堂小测，督促大家及时复习。感觉老师还是比较开明的，从来不点名，小测和作业也都是允许补交的，比较看中结果，意思是期末考试要考的够高。
169879,1695,周箭,2023-02-28 08:04:11,0,9,9,本来以为崩了，结果总评狠狠超过预期，zj99 I love uuuuuuuuu~~~~~
169942,1695,周箭,2023-02-28 14:27:46,1,4,3,模电，只能说这个课本身就很难。。
170593,1695,周箭,2023-03-07 04:02:05,-2,3,5,压迫感有点强但是很负责 自己认真学了不会有大问题
171021,1695,周箭,2023-03-14 07:40:18,21,23,2,我是个差生，但我要来谈谈我认识的周箭。\n\n①往届循环班的通过率为70%，与其他老师的普通班相当。\n\n②给分十分求是，不会因为你上循环班而手下留情，你能得多少分就是你自己的能力，这届循环班通过率为80%，周箭夸我们把握住了机会。\n\n③循环班有斩杀线，期末成绩少于一定值就不及格。\n\n④关于斩杀线事谊不会提前说明，只是含糊说考得太少肯定不行，但也没说多少分，估计在50分以上。循环班\n\n⑤所以关于你考个4. 50分，周箭拥有一票否决权。循环班，普通班也是如此。\n\n⑥对于斩杀线，未通过者平时分，期中考试分一概不算，期末成绩以100%计，也就是说你考几十分，就有几十分的总评，哈哈，循环班，普通班亦然。\n\n⑦循环班考试题目并没有比普通班简单。\n\n⑧循环班平时有很多小测。他说不计分数，但我并不相信。\n\n⑨对于成绩构成从不详细说明，搞得好像都不重要，但该期末又说如果按照慕课分数，怎么怎么多少人就挂了。\n\n除此之外，也会经常在群里点名问人是不是放弃了，他以后就不管这些人了，不回答就默认弃课了等等等等。\n\n\n\n本人期中86，期末40多，还不算平时分，循环班，荣被斩杀，\n\n\n\n\n\n不论如何，循环班有斩杀线，我一生不能理解的玄学。
171524,1695,周箭,2023-03-27 09:58:19,9,11,2,讲的差，给分差。跟盾妈能比？
171882,1695,周箭,2023-04-10 12:18:45,1,2,1,我觉得不行
178175,1695,周箭,2023-07-07 12:15:46,6,9,3,事情多，给分差，有时甚至让我觉得恶心。
178564,1695,周箭,2023-07-14 14:54:57,5,7,2,阴阳怪气
179526,1695,周箭,2023-09-18 02:40:21,4,5,1,规矩怎么那么多？
183033,1695,周箭,2023-11-21 15:51:28,3,4,1,老师上课真的很好啊，而且讲的也很清楚，甚至在我看来比孙老师讲的还清晰，绩点不太清楚，但就这负责的态度10分
183970,1695,周箭,2023-12-05 07:07:05,5,7,2,重要的事情说三遍，老师人真的很好很好很好！！！讲课逻辑很清楚，比较关心学生，会亲自批改作业和实验报告，要是你不认真了可能会提醒一下你哈哈。之前看到有人说老师阴阳怪气，我一开始还蛮担心，但后来自己跟老师交流下来感觉可能是由于年龄差造成的代沟问题，其实我没感觉到过老师阴阳怪气啥的
185911,1695,周箭,2024-01-05 20:05:38,3,4,1,像雷军
186016,1695,周箭,2024-01-07 16:18:56,1,7,6,教的好不好先不说，阴阳怪气恶心人真的有一手
186766,1695,周箭,2024-01-13 03:30:14,3,3,0,还没出成绩，不过万一挂了只能说我自己菜了，期中和平时分都不太高，期末考的自我感觉应该还可以，不知道老师会不会捞\n\n不过无论如何，我只能说老师真是绝佳的老师，相比我大学期间上的其他课程，老师的课件，讲课顺序等等绝对是第一梯队的优秀的，另外老师也会很耐心的回答问题，人也特别温柔。对于平时表现差的同学也是一视同仁并不会说就彻底放弃你。尽心尽力又负责任的好老师
187361,1695,周箭,2024-01-15 15:12:50,10,10,0,还没出分，犹豫了一下要不要先打分，还是回来打了10分了，讲课上没的挑剔，很清楚，但是你有一两节课不认真可能跟不上了智云回放也很清楚，期末考的平时都讲了，我决定不能以分数论英雄，老师绝对是好老师，我能考多少分已经不重要了。
189328,1695,周箭,2024-01-23 08:55:05,13,13,0,老登讲课讲得还挺好。\n\n课堂小测多，但允许课后交。模电上的太快根本没听懂，后来一点点照着作业、小测补交补的。
189340,1695,周箭,2024-01-23 09:32:36,1,2,1,算了，过了就行
189480,1695,周箭,2024-01-24 16:44:12,5,5,0,看均绩以为老师会很坑结果出分结果还可以（）\n\n上课总体来说讲的还是比较清楚，但可能受个人习惯影响讲的速度比较快，同时作业相较了解到的其他老师班级会少一点？所以可能需要课下用功夫稍微多一点，不然期中期末考试可能会因为练习少比较手生\n\n非常喜欢课程小测，大概秋冬学期加起来练习了十余次，不过每次题量都不大，也允许课后补交\n\n总的来说应该比较适合愿意多花时间认真把这门课程学好的同学，老师人还是很好的
189516,1695,周箭,2024-01-25 06:58:46,-7,3,10,绩点：3.6
189681,1695,周箭,2024-01-26 15:22:48,12,13,1,周爸爸周爸爸我的神！！！模电跪谢
189798,1695,周箭,2024-01-29 11:20:00,2,2,0,控院模电\n\n70昏飘过，电路实在是考的太烂了，模电自以为学的比较认真了，但是考试时候十分的困，好像也没有考的很理想。奉劝大家考试周不要狂暴刷夜………………\n\n老师平时分应该是给的比较严格的，一个学期总共小测了十四次，所以说平时事情是有点多的，但是跟着小测确实很能巩固知识，最后考试的题型有不少也是和小测题型类似的。所以说平时认真学的dl应该都能取得不错的成绩吧QAQ（我是菜。老师人还是比较负责的，小测做的不好还会私戳提醒，但是确实感觉怪有点阴阳怪气的🤨🤨🤨\n\n这门课感觉节奏还是比较快的……感觉泥浙排课不是那么合理。总之除了课上听讲课下还需要大量时间去巩固知识才能学的比较通透。总之我在课上的大部分时间是不能很好的跟上老师的，经常课下自学。
190713,1695,周箭,2024-03-15 11:55:44,11,12,1,讲课逻辑非常清晰，语速合适答疑也很耐心，很棒的老师！！
197270,1695,周箭,2024-07-12 12:47:42,-3,5,8,模电和数电都是跟着他学的，我只能说不好评价。
199816,1695,周箭,2024-09-30 07:25:01,4,5,1,电院电工电子实习，老师很儒雅很负责，时刻关心同学的焊板子进度，人也很幽默，可能是聊天风格导致在钉钉上感觉老师有时候有点阴阳怪气，但这并不是周老师的本意。\n\n事情稍微有点多，比起别的班级要多交预习报告和工作日志，但是我最后数字频率计只做了一半还拿了优秀，总体来说还是很推荐老师的
201552,1695,周箭,2024-11-04 08:16:15,2,8,6,事多还会阴阳人
201700,1695,周箭,2024-11-05 13:24:32,8,9,1,上课逻辑很清晰，答疑很负责的老师
202797,1695,周箭,2024-11-14 12:11:31,14,18,4,@所有人 说完了
204363,1695,周箭,2024-11-25 12:19:04,-2,4,6,模电皇帝
204364,1695,周箭,2024-12-04 01:46:44,1,8,7,他简直就是模电皇帝，讲课清楚但是规则卡死，作业格式要求很严格
204856,1695,周箭,2024-11-28 07:15:56,5,6,1,很求是
204858,1695,周箭,2024-11-28 07:22:37,-2,1,3,好也不好
204910,1695,周箭,2024-11-28 12:43:49,0,2,2,云里雾里
205014,1695,周箭,2024-11-29 14:39:47,9,9,0,老师讲课逻辑很清楚，但模电是一门课后需要花很多很多时间的课
205048,1695,周箭,2024-11-30 08:58:30,-3,5,8,仅有的优点就是课件。除此之外，每周小测，作业量大，慕课一堆章节作业以及两个根本做不完的几十道题的慕课考试。跟着这位上课，平时分能比其他老师多扣七八分
205100,1695,周箭,2024-12-01 11:59:45,8,12,4,在他的课上我把电路原理学得实实的，坐在期中考试考场上时难得没有对考试焦虑过
205112,1695,周箭,2024-12-05 09:25:40,-1,6,7,神人，快跑
205623,1695,周箭,2024-12-10 07:38:10,6,9,3,话不多说 5.0
206743,1695,周箭,2025-01-14 06:35:04,12,18,6,我收回对zj老师的一切不好的意见，给分意外的好，神，zj99我爱你
207176,1695,周箭,2024-12-19 14:51:39,7,13,6,客观讲他绝对是一位要求高的老师，有自己想法的老师。我也承认他在课堂上超凡入圣的想法，我也肯定他批我作业批的很认真，我更理解他课堂小测的作用。\n\n       但如果让我回到期中我会弃修这门课，让我回到开学我会退掉这门课，让我回到上学期我不会选这门课，让我回到大一我不会选这个专业，让我回到高考我不会选这个大类。
207457,1695,周箭,2024-12-22 03:21:44,10,14,4,林平，沈红，周箭，德华，电院F4编的模电教材书实在是太烂了，没有重点，内容和上课内容相比缺失，没有加粗符号，逻辑不清晰，导致模电部分还要回去翻电路部分的书，而且题目还经常出现下标印刷错误。比如说电流源书上就讲了三种但是上课有好多种。
209951,1695,周箭,2025-01-14 01:07:10,20,20,0,分数还没出，正好客观地说一下我的个人感受：周箭老师课讲得很好，有自己的节奏和思路，往往能化繁为简，直击要害，上课重点也很突出，会专门提醒一些重要的知识和方法，当然可能就会觉得有点快，所以课下还是要花一些功夫。我很喜欢老师的ppt，我觉得做得很美观比较好看，用起来也很舒服。作业方面，老师的作业量不多，而且基本半学期交2-3次，给了很多缓冲时间，避免我们没学到相应位置，这点很赞，老师对于作业检查应该还是很重视的，所以这块不能敷衍。其次就是诟病很多的小测，这个小测不是随堂性的，当天之内可以反复提交直到正确，理论上这块是可以全部满分的，不过小测次数的确很多，通常测试内容比进度慢个一周吧，还是比较友好的，但我觉得周箭老师的小测题非常有意义，基本告诉你了期中期末大题怎么考，如果能把他的小测全部弄懂，大题肯定不成问题，而且这个小测也能保证你不拉下太多的进度，我觉得是很大的优点啊，好好利用这个小测资源非常有帮助，不过这个也算是隐形点名，所以当堂一定要提交一份。其实周老师会通过许多方式来提醒大家跟上进度，所以我觉得老师其实是很负责的，基本跟着他的节奏走不会太差的。阴阳怪气的相关问题我不怎么和他交流没怎么体会到，但我觉得老师还是蛮幽默的，上课很多笑话真的蛮有趣的，只不过群里面@具体的人和集体通报平时情况的确有些压迫感。老师的确是一位严格的老师，但的确负责且有水平，我给予好评吧。至于给分我就不评价了，还没出分呢，不过可以多给我们一些平时分吗？🥹🥹🥹\n\n\n\n追加评论：谁说给分不好？简直主人级别的给分啊😍😍😍
211535,1695,周箭,2025-01-12 01:27:55,7,8,1,（为了避免成绩带来的评价偏差）出分前来写一下\n\n1、老师讲课特别特别好，很清晰但是信息量比较大，如果没听懂回去快速过一遍智云基本上都能听明白。考试重点、题型总结、ppt逻辑什么的都特别好（我们这届其他老师班级的同学很多都是拿zjbb的ppt复习的）\n\n2、老师性格不是传统那种“慈祥”的感觉所以会有同学说他是阴阳怪气，其实老师只是有些特殊的幽默感（爆出很多梗图hh），补交作业什么的都很好说话，学期末还特地开了一个通道补交所有东西。课后答疑什么的也很认真！\n\n3、给分上总评还没出但是他期中的成绩只是给了划档没给分数“问了成绩就没法改了”希望是会捞hh\n\n4、说是每周小测其实是课堂练习（可以反复提交、回去提交、抄同学的（bushi）），不强制要求到课但是会有一两次无法逃脱的点名（但是只要说明为什么没来就行，编一编…）\n\n总而言之zjbb是很不错的老师！认真学（模电5.5分活爹你还不学你学什么啊）在他手下认真读会有好的结果的！\n\n希望他给我的好一点呜呜
212283,1695,周箭,2025-01-14 00:42:35,15,15,0,99我错怪你了，感谢99\n\n99是好老师，讲课清晰，给补交通道，感谢99大人
212300,1695,周箭,2025-01-14 01:03:14,6,6,0,我给zj老师打10分\n\n首先他的上课思路非常清晰，同时他的上课课件我认为是神器，基本上涵盖所有，只要把ppt搞好了基本上后续就没问题了，老师可能事情会多一点，但是对于想要拿到高分的同学来说未必不是好事，平时分上可以拉开差距。模电的期末以及电路原理的期中考试难度并没有说很大，平时基本上弄懂就够了。最后老师给分也还可以不知道有木有捞，但是你把平时任务完成了就能拿到还算不错的分数
212322,1695,周箭,2025-01-14 02:01:07,7,7,0,模电：感觉没有传闻中那么“求是”，说实话是出乎意料地高。\n\n关于老师，PPT风格比较简洁，上课非常清晰（可能信息量比较大但我也很懒没听过回放Orz），同学的课前展示复习还是比较好的（课件展示尽量越早越简单），小测非常有用，作业非常少。\n\n关于模电，电路部分没太多好说的，模电部分说实话学不懂，我基本全靠背的，包括各个组态，连微变等效电路图都很少画，其实也并不太影响考试结果。最后考试的教训就是，填空题并不会考偏的知识，例如各种管的温度效应之类的，主要还是基本原理的运用熟练程度。\n\n模电部分的书，我觉得原理写的是比较清楚的，习题有些会难了，没有必要要求自己全部会做。前面管的各种知识，可以看看b站上的视频，但是不理解也完全没关系，主要会求静态和算各种组态就可以，实在不行背也可以。后面反馈有个很重要的概念是瞬时极性，这里我觉得书上和老师讲的都不是非常清晰，推荐找其他懂的同学讨论一下。\n\n其实相比模电实验，在模电本身上花的时间并不是非常多，还是感谢老师以及一起学习的同学。
212376,1695,周箭,2025-01-14 02:28:50,3,3,0,zj99\n\n...
212410,1695,周箭,2025-01-14 03:16:48,3,3,0,讲课很清晰，作业少，答疑很耐心，小测也非常有用！！！期中考后公布了大致的成绩分段，自己感觉天都塌了，但期末出分很不错😍所以平时分虽然很严格但zj99还是会捞的
213674,1695,周箭,2025-01-19 05:25:25,8,8,0,浙大的模电教材就是💩，要不是99的课件和清华的教材，这学期就栽在模电上了
215653,1695,周箭,2025-03-03 10:55:52,0,1,1,伟大无需多言
218305,1695,周箭,2025-04-22 11:55:03,4,6,2,ZJ99真的是神仙老师了，不知道为什么查老师评分一般，模电这种纯硬课，及格线之上自己的分数怎么样基本都是靠自己的努力了，zj99把课讲得非常清楚，内容量很大，课后有问题也可以积极与他交流讨论，他是很乐意与同学交流的那一类老师
219293,1695,周箭,2025-05-24 08:56:19,3,3,0,十分。很像雷军，你们不觉得吗
219350,1695,周箭,2025-05-25 14:43:31,2,4,2,上大学以来遇到的最负责任的老师，对待学生很认真
220949,1695,周箭,2025-06-20 12:40:20,-1,2,3,电院3分电路与电子技术②来评：只是听课的话老师讲课水平不错，备课也认真负责。但模电这门课本身就史，教材也是史，PPT编写也是史，这不是老师的问题。总的来说学习很困难，它也不是纯难，就是让人感觉很不系统、很莫名其妙，尤其是教科书编的依托。平常每节课都有课堂小测，如果能选到别的老师的话，个人不推荐选zj的课。如果能回到选课的那一天，我只会对自己说一个字，跑！
221755,1695,周箭,2025-06-26 03:45:02,0,1,1,神仙老师
8410,1706,聂曼,2015-09-21 05:32:58,49,51,2,上课啥也听不着，事儿巨多。实验报告自己不看让学生自己看。真不知道这种老师教个什么劲。
8414,1706,聂曼,2015-09-22 07:21:31,33,33,0,思维混乱，不知所云，大言不惭，偷奸耍滑。
8428,1706,聂曼,2015-09-21 07:40:54,23,25,2,上课毫无章法  想到哪讲到哪  很多内容根本不讲  听的一头雾水  絮絮叨叨乱七八糟的东西浪费时间严重
8440,1706,聂曼,2015-09-21 09:23:44,17,17,0,讲课毫无章法，经常听得一头雾水，不知所云
8442,1706,聂曼,2015-09-21 09:34:57,14,15,1,见过的最烂的老师……
8443,1706,聂曼,2015-09-21 09:59:10,16,16,0,毫无章法可言，估摸着不备课，想到哪讲哪，除了瞎BB啥的不会，没有货！湿货都没有！
8445,1706,聂曼,2015-12-06 15:09:07,22,22,0,人生得聂须尽欢
8446,1706,聂曼,2015-09-21 10:07:25,10,10,0,呵呵。
8447,1706,聂曼,2015-09-21 10:18:30,33,33,0,毫无逻辑性和条理性，周一下课总是神经衰弱
8450,1706,聂曼,2015-09-21 10:30:34,11,11,0,你去听听看喽\n\n
8476,1706,聂曼,2015-09-21 14:27:35,17,17,0,坑人呢 讲课东一句西一句的 不停地拉家常 你这做实验呢她突然冒一句注意事项 根本就不知道在说啥 真不知道咋混到浙大来当老师的 垃圾
8577,1706,聂曼,2015-10-05 05:51:42,10,11,1,老师简直无语
8578,1706,聂曼,2015-09-22 14:59:19,-49,4,53,真心好老师！
8599,1706,聂曼,2015-09-23 03:10:19,9,9,0,感觉什么都没讲清楚就让我们做实验了。只能对着PPT和课本慢慢做。
8794,1706,聂曼,2015-09-28 02:52:26,3,3,0,呵呵哒
8810,1706,聂曼,2015-09-28 05:38:51,44,45,1,你叫什么名字  马晟杰
8817,1706,聂曼,2015-09-28 07:59:06,3,3,0,任务又多又烦，上课什么都讲不清楚，只能靠课前预习
9259,1706,聂曼,2015-10-19 05:12:28,2,2,0,超级坑！！！最烂的老师没有之一！！
9302,1706,聂曼,2015-10-21 18:42:09,64,68,4,长风破浪会有时自己回去搞仿真。渭川斜阳照墟落你们全都不听课。一身去国六千里我就明确告诉你。雪消门外千山绿实验报告哪里去。春色满园关不住我弄丢了你们补。
9488,1706,聂曼,2015-10-28 16:02:44,1,6,5,好老师，决定良心\n\n还有机会可以教两次同样的报告噢
9700,1706,聂曼,2015-11-04 19:48:34,2,2,0,P话连篇&自我评价过于良好
9790,1706,聂曼,2015-11-09 07:36:36,1,1,0,呵呵哒
9791,1706,聂曼,2015-11-09 08:30:46,6,7,1,自习之外，你永远学不到新东西，永远不知道要做什么，永远不知道她在说什么，永远不知道她要求什么，你甚至不知道她自己知不知道，选了她的课，就呵呵吧
11637,1706,聂曼,2015-12-09 04:53:14,-3,8,11,老师早日康复
11692,1706,聂曼,2015-12-11 14:08:19,16,16,0,自从用了傅晓程的课件，思维明显清晰了。
11902,1706,聂曼,2015-12-21 03:38:50,3,3,0,不多说了，都是泪
14977,1706,聂曼,2016-01-11 10:53:05,12,13,1,傅晓程老师的课件挺好\n\n\n\n
15028,1706,聂曼,2016-01-11 14:44:40,15,15,0,被清退了之后还阴魂不散。
17621,1706,聂曼,2016-01-20 13:43:27,3,3,0,很好奇她怎么当上老师的
21761,1706,聂曼,2016-03-01 04:20:35,5,5,0,总评竟然这么高，是不是有水军啊
22187,1706,聂曼,2016-03-03 01:57:17,2,2,0,自学能力max(╯°Д°)╯︵┴┴
23352,1706,聂曼,2016-03-26 05:55:08,13,15,2,如果说漂亮而没有能力的女性被称作“花瓶”，那她就应该被称为屎盆子。
23705,1706,聂曼,2016-04-13 05:24:22,2,2,0,不想说话
24629,1706,聂曼,2016-05-02 11:18:39,1,2,1,千万别选
49488,1706,聂曼,2017-04-17 02:32:42,0,0,0,一切尽在不言中
52951,1706,聂曼,2017-06-24 04:27:19,0,0,0,不知所云，吭
108962,1706,聂曼,2019-06-04 17:16:04,0,0,0,这人是怎么混进浙大当老师的？
53556,1727,罗小华,2017-06-27 03:40:32,1,1,0,《微机原理与接口技术》中的接口技术部分，讲得非常非常仔细，有时候会讲两遍，代码也是一句句讲的，告诉我们写汇编的技巧，考点也讲清楚，超棒的老师。
57956,1727,罗小华,2017-07-18 10:36:48,0,0,0,老师还不错，回答问题很细心
66282,1727,罗小华,2018-01-14 15:10:42,0,0,0,。。。
38051,1733,杜丽,2016-11-23 17:24:10,1,1,0,老师人特别好
57082,1733,杜丽,2017-07-05 12:59:00,0,2,2,老师讲课挺细的 看到大家一脸迷茫还会停下等大家 挺关心学生的 像妈妈一样 考试出的题目也比较基础
61503,1733,杜丽,2017-11-18 02:23:21,5,6,1,课程很好，老师不错，就是考试题目有点奇怪，不按套路来?
79141,1733,杜丽,2018-05-24 03:38:55,9,10,1,周周三节课，只需要知道上课时间就可以了，什么时候下课看进度
84442,1733,杜丽,2018-07-13 01:06:52,1,1,0,啊啊啊啊！期末考试题真的很怪。。一点都不给加分，给的成绩是真的凉。。估计大部分都是三多?可能是自己太菜了，但期末考试题是真的奇怪，有点恶心。
84556,1733,杜丽,2018-07-13 07:25:13,0,1,1,讲课应该算是大三的老师里面最好的，十分清晰耐心，但是考试题目略怪，给分严苛。大家谨慎选择
88555,1733,杜丽,2018-11-01 09:27:25,1,3,2,我也觉得像妈妈一样。
90346,1733,杜丽,2018-11-23 08:20:48,-1,2,3,老师很耐心细致。考试题也比较基础啊，满了
90373,1733,杜丽,2018-11-23 09:47:13,-1,0,1,whhhat
90450,1733,杜丽,2018-11-23 13:39:01,-13,2,15,外院来选课刷分的，这门课满了。这个老师人是真的好，很温柔，上课会有一点点让人想睡觉（虽然我也不听hhh）。计算机软件技术基础没有简答题，只有选择填空和大题，亏我把前面概念都背的滚瓜烂熟，原来没有简答题，概念只会挖空让你填。今年最操蛋的一题是，哈希表除了是一种“”的方法，还是一种常见的查找方法。空填“存储”，我也是醉了，好好看ppt满绩还是不难的。
114064,1733,杜丽,2019-07-08 15:33:10,1,1,0,为什么出分这么慢啊呜呜呜一直怀疑自己挂科了
114790,1733,杜丽,2019-07-11 17:31:43,3,4,1,老师给分很好呀……\n\n期末几乎所有的小论述都不会……最后很高……\n\n论述考的很偏\n\n但是可能占的分不高\n\n平时老师上课真的很认真\n\n如果听课了 好好做作业没问题的
114935,1733,杜丽,2019-07-13 00:40:02,-14,4,18,满绩怎么说
126392,1733,杜丽,2020-09-25 00:23:06,0,0,0,
127894,1733,杜丽,2020-11-30 02:16:32,0,0,0,分数比我预想的低一点，还被卡了一手呜呜呜。但是我还要给10分！！！老师备课超认真，讲的也好。大作业着实任务量有点大，考试难度稍大，但都在正常可接受范围内。推荐！
135615,1733,杜丽,2021-05-17 03:39:05,1,2,1,声带落家里了
135760,1733,杜丽,2021-05-24 03:37:54,5,5,0,真尼玛能拖堂
139360,1733,杜丽,2021-07-14 17:22:58,2,2,0,电力电子（自动化专业）背书课吧，要是能开卷考试岂不是很容易，能带张A4纸也行。老师讲课还行，点名很频繁。给分不好，也可能是我考的不好
160710,1733,杜丽,2022-10-04 02:35:30,0,0,0,上机作业无话可说
161677,1733,杜丽,2022-11-10 10:50:58,3,3,0,三节课只休息一次课间，并且还稳定拖堂5分钟起步，想吃到午饭慎选
163683,1733,杜丽,2022-12-16 02:53:08,0,0,0,很负责
172040,1733,杜丽,2023-04-18 03:20:13,2,2,0,好无语啊，老师讲的很好，但是连上两节课真的让人听不下去。为什么不能休息五分钟换点听课质量呢？
192406,1733,杜丽,2024-05-18 06:17:13,0,1,1,不是姐，你的气泡音我听的真的毛骨悚然啊，第一次因为一个老师的声音感到非常难受，对课一点都听不进去，你一张嘴我就起鸡皮疙瘩\n\n姐，我真的生理上厌恶你的气泡音。
25571,1781,江道灼,2016-05-26 03:39:32,3,4,1,好老师，给分很好
38833,1781,江道灼,2017-04-12 02:31:47,1,2,1,很有气质，男神哦
55373,1781,江道灼,2017-07-01 11:42:10,1,1,0,老师人很好，热情，就是有点讲的不清楚。
76672,1781,江道灼,2018-04-18 03:04:12,0,3,3,听不懂
84110,1781,江道灼,2018-07-12 04:38:19,1,1,0,很有气质的老师
84299,1781,江道灼,2018-07-12 13:10:19,3,4,1,老师给分不错的
112011,1781,江道灼,2019-07-03 07:23:53,9,10,1,出了一张满载知识的试卷，彰显了他深邃的思想。
123268,1781,江道灼,2020-05-27 04:21:41,-2,2,4,拖堂拖一整节课，以为是要把内容讲完，结果也没讲完，最后轻飘飘一句原来已经十二点了啊，我可去你的吧，你咋不拖到晚上九点去
125138,1781,江道灼,2020-09-02 03:54:13,-1,1,2,讲课差劲，还喜欢拖堂
139347,1781,江道灼,2021-07-14 14:04:24,1,1,0,上课水平无话可说，反正我也不听，给分巨好，应该是开方乘十了
139349,1781,江道灼,2021-07-14 14:27:14,0,0,0,感谢老师捞我之恩\n\n这次的考试确实难得有点发麻...
139470,1781,江道灼,2021-07-16 08:36:44,1,1,0,讲课认真，给分无敌，但是复习ppt建议看其他两个老师班
765,1793,姚维,2015-03-16 14:13:29,8,13,5,老师讲的好棒，讲的较快且透彻，很赞
10893,1793,姚维,2015-11-23 08:21:02,0,1,1,很好的老师
13911,1793,姚维,2016-01-02 08:22:55,0,0,0,清晰明了
16940,1793,姚维,2016-01-19 09:37:39,3,3,0,下课早，利索爽快好老师
24195,1793,姚维,2016-04-28 07:42:23,3,6,3,过控成绩感觉很神秘
42654,1793,姚维,2017-01-14 17:17:43,4,7,3,凸老师最棒
46971,1793,姚维,2017-01-23 06:10:06,3,5,2,老师讲得很清晰，上课就能听懂，下课不用花很多时间去看。老师上课会讲综合性的题目，对思维考试帮助很大~给分也很好~棒棒的老师
70607,1793,姚维,2018-01-27 09:39:18,0,1,1,老师人很和善，课讲得很好，给分也很好！
71310,1793,姚维,2018-01-28 09:22:33,2,5,3,18年姚维老师出卷，16级的学弟学妹们加油(ง •̀_•́)ง
72187,1793,姚维,2018-01-29 14:09:42,0,0,0,老师人很好
75047,1793,姚维,2018-03-07 06:36:58,2,2,0,凸老师萌萌哒！
98308,1793,姚维,2019-01-23 09:53:49,0,3,3,这次卷子出得不太好，大家出来就骂了，本班同学也骂，别班同学也骂，服气把一个控制理论乙出成了这个样子
98379,1793,姚维,2019-01-23 11:34:39,1,2,1,老师是很好，但是出卷子太难了
99071,1793,姚维,2019-01-24 08:27:25,1,1,0,看了别班的绩点，才知道老师给分还算良心至少不难为人   学弟学妹可以考虑选了
100796,1793,姚维,2019-01-27 00:51:51,0,0,0,讲的很快但是却很透彻，是好老师，今年题出的和历年卷不一样大家就炸锅我觉得不是老师的错哈
105994,1793,姚维,2019-04-24 06:00:59,0,0,0,炒鸡逗比哈哈哈
105996,1793,姚维,2019-04-24 06:07:44,2,2,0,“天气那么好，出去走走吧！”老师富有童心，粗中有细。
106002,1793,姚维,2019-04-24 07:48:05,0,0,0,讲的很好，老师也很可爱！
106390,1793,姚维,2019-04-27 04:02:32,0,0,0,很棒的老师！
118856,1793,姚维,2019-11-07 05:40:13,1,1,0,实验报告格式也太麻烦了555
119070,1793,姚维,2019-11-10 03:26:00,2,3,1,实验报告格式巨麻烦，屁事巨多，其他老师没一个像他那样要求这么多的，至于吗？写个实验报告格式设置半天，本末倒置
122040,1793,姚维,2020-02-04 08:00:14,4,5,1,这是我这学期的经验，老师讲课算好吧。但某些内容是老师不讲但在考试里面出一个大题目。说到给分，老师给分太差了是因为老师说只用4个小时就改完试圈了，你们觉得老师会认真改试圈嘛？我还问一些同学他们也不满意他们的分数。你们好好考虑吧
131157,1793,姚维,2021-01-26 09:01:42,2,5,3,老师很有趣，讲的又快又清晰，体验极佳。控制理论乙的内容不多，老师提前四五周就把课上完了，每节课还会留出时间来做题。这样一学期下来，确实是把控制理论给搞懂了，而不是学会一些数学游戏。不过老师给分确实一般，他自己第一节课也说了如果分数在95左右他会尽量拉到94，事实也是如此。虽然被卡了很难受，但还是给了10分，毕竟这是大三上讲的最好的老师了。
151645,1793,姚维,2022-03-10 07:35:01,2,2,0,现代传感技术原本是给大四开的，但说实话真的像通识课。老师讲的不多，同学的ppt展示倒是每人5次。给分挺好的，算是给分高的水课
188792,1793,姚维,2024-01-20 03:04:58,0,0,0,隔壁班来评，好老师
211226,1793,姚维,2025-01-11 04:51:25,2,2,0,感觉后半学期讲课摆摆的\n\n多讲点题目也好啊考试题比作业题难太多了吧....
211379,1793,姚维,2025-01-11 09:17:07,3,3,0,真的无奈
212136,1793,姚维,2025-01-13 08:55:31,-5,0,5,讲课好，言而有信不点名，另外今年考的好像难一些，应该捞了，得分比预期的高
6143,1886,傅晓程,2015-07-11 08:27:07,13,15,2,可以拖实验报告
8800,1886,傅晓程,2015-09-28 03:13:50,21,25,4,挺好的老师，很细致，关键是和隔壁聂曼比起来好太多了，不解释
8823,1886,傅晓程,2015-09-28 09:31:56,3,6,3,课讲的挺好的
8882,1886,傅晓程,2015-09-29 09:10:42,23,25,2,老师超级有耐心，认真也负责，脾气很好，就是口音有点重 在后面听不清
11480,1886,傅晓程,2015-12-02 11:20:58,3,5,2,人很好！
13753,1886,傅晓程,2015-12-30 14:34:31,5,8,3,挺萌的 人超级善良
15037,1886,傅晓程,2016-01-11 15:34:46,-2,4,6,水水哒
18029,1886,傅晓程,2016-01-21 06:47:01,9,12,3,凭什么实验课是等级制？？一定都不合理
21486,1886,傅晓程,2016-02-29 04:39:55,1,4,3,不错不错
28662,1886,傅晓程,2016-06-28 11:50:44,-5,1,6,
28722,1886,傅晓程,2016-06-28 13:01:17,7,9,2,人超好，可以拖报告，给分还不错，毕竟实验是等级制的，总有人要受伤。
30516,1886,傅晓程,2016-07-01 23:31:20,2,5,3,老师人很好，给分又良心
30542,1886,傅晓程,2016-07-02 01:33:38,3,6,3,人很耐心，给分良心。上了他一年实验，好老师不解释！
30738,1886,傅晓程,2016-07-02 10:49:22,6,9,3,讲的挺好 学了对模电理解深入很多 报告可以随意拖 自己安排时间就好\n\n吐槽下坑爹的等级制打分?
44562,1886,傅晓程,2017-01-18 05:34:00,1,5,4,嗯，略遗憾
44564,1886,傅晓程,2017-01-18 03:09:18,-1,2,3,感谢老师不杀之恩。。。
44602,1886,傅晓程,2017-01-18 04:03:55,2,6,4,这个老师 真的好。下个学期又选他了
44638,1886,傅晓程,2017-01-18 05:11:11,3,7,4,老师超级耐心，有问必答。最后实验题没怎么做出来，给了良好…
44808,1886,傅晓程,2017-01-18 09:26:51,2,6,4,老师讲得非常细致，人也很好。学得不好只能怪自己了
44976,1886,傅晓程,2017-01-18 16:39:49,3,6,3,超赞的老师，讲的清楚，只要好好做实验就会挺好的
47025,1886,傅晓程,2017-01-23 09:48:43,2,5,3,好！很好！
48099,1886,傅晓程,2017-02-28 12:26:00,0,5,5,第一天上课老师就推荐了很多“秘密武器”，还懂得很多“奥秘”，如果这样子示波器还不行，那么它你看到的可能是“假象”。
48165,1886,傅晓程,2017-03-01 04:49:26,6,10,4,简直我男神啊！！！可惜这学期选不上实验二了。实验做不出来还会手把手帮忙调试的✧٩(ˊωˋ*)و✧
48551,1886,傅晓程,2017-03-07 06:31:10,-5,5,10,真心不好
55572,1886,傅晓程,2017-07-02 02:57:09,2,5,3,实验课很认真，讲课很细致！
55730,1886,傅晓程,2017-07-02 09:46:50,2,4,2,给分很良心
57952,1886,傅晓程,2017-07-18 10:25:30,2,6,4,傅老师人不错，也很关心学生，就是口音有点重，坐在后面的同学建议到前面听
65617,1886,傅晓程,2018-01-07 10:36:18,2,6,4,真的好，会给很多选做，有能力的同学建议选
69675,1886,傅晓程,2018-01-25 07:51:26,2,5,3,老师人太好了，真的好
69706,1886,傅晓程,2018-01-25 08:43:55,3,5,2,好老师，讲课很耐心，问他什么问题都会给你细心的解答，人也很亲切和蔼
69711,1886,傅晓程,2018-01-25 08:54:52,3,6,3,老师讲的很透彻，理解起来很容易
71619,1886,傅晓程,2018-01-28 17:18:22,7,14,7,老师真的很有耐心，待人和蔼，喜欢启发学生思考问题，身上有一种资深工程师的气质。不过讲课声音会有些小，坐在后排的同学可以到前面听课。实验课等级制度其实也有一定道理，有人抱怨自己3.5的绩点是被正态，但如果你扪心自问，如果这门课真的像其他课一样按照平时成绩和考试成绩相应比例直接评分，你的绩点真的能超过3.5吗?傅老师的实验课如果想拿4.5，一定要掌握好理论，平时不能仅仅按照ppt接好线之后就走，一定要明白原理，清楚设计过程，否则考试会蒙逼，实验题自己设计电路也有可能漏洞百出。
73753,1886,傅晓程,2018-02-03 05:06:34,3,7,4,全部电子版报告
82442,1886,傅晓程,2018-07-08 07:52:36,-1,3,4,讲课内容比较丰富，但对学生要求不是很高，很多东西都是选做。老师真的特别和善，有耐心，还有点小幽默，课下碰到还会和同学打招呼。有一点口音，建议后排听不清楚的同学做到前面。
82447,1886,傅晓程,2018-07-08 08:12:30,4,10,6,我爱傅晓程老师！\n\n大家选做实验一定要做！\n\n实验是等级制的不合理但这跟老师没关系！\n\n我再大声的说一次：我爱傅晓程老师！
82459,1886,傅晓程,2018-07-08 08:56:03,4,6,2,指导实验还行，理论讲得不怎么样，口音太重，催眠。给分没办法，该被正态还得被正态。
82475,1886,傅晓程,2018-07-08 09:48:41,5,8,3,挺不错的 平时的选做仿真和期末选做设计可以做一下
82528,1886,傅晓程,2018-07-08 12:01:18,3,6,3,老师绝对是最最有耐心的那种，可惜电路实验这种智障的等级制度，残害生灵，不仅最高分才4.5辣鸡等级之间还差那么多
82667,1886,傅晓程,2018-07-09 02:35:11,7,12,5,果断10分啊！\n\n老师讲的挺好的，，而且特别亲切和蔼，实验会帮我们调试，很耐心的答疑，实验考试可以拖时间 ? 每次上完课的时候都觉得原来不会的理论知识都懂了。傅老师的实验课是没有恶竞的实验课，只要认真听课实验报告好好分析肯定会有所收获。。感谢老师在我简答题炸了的情况下仍然给了我不错的分数 ?
82901,1886,傅晓程,2018-07-09 09:33:24,3,7,4,好老师，等级制太sb
85730,1886,傅晓程,2018-07-30 13:55:13,4,7,3,太喜欢这个老师了！！很遗憾电路实验和数电实验不是这个老师的
85814,1886,傅晓程,2018-08-16 13:54:53,-1,2,3,好老师！
86525,1886,傅晓程,2018-09-17 04:49:17,0,5,5,刚开始学模电的时候一脸懵逼人生绝望，上过傅老师的实验课之后真的有种醍醐灌顶的感觉，原来不会的东西也都理解了。老师讲课是有点催眠，不过认真听的话真的能够get到其中的点，会学到很多的
88497,1886,傅晓程,2018-10-31 10:14:55,3,5,2,超负责任的老师，而且很关心学生，课讲得也好
88510,1886,傅晓程,2018-10-31 13:28:52,0,4,4,非常好
88511,1886,傅晓程,2018-10-31 13:29:45,-1,3,4,好好好好好好好
91245,1886,傅晓程,2018-12-04 05:46:43,4,5,1,数电实验理论课都没上过，一脸懵逼啊老师
98727,1886,傅晓程,2019-01-24 00:33:22,-2,2,4,上课非常认真，脾气特好，给分特高，平时实验报告不多。完美！！n
98747,1886,傅晓程,2019-01-24 01:18:24,4,7,3,我 爱 傅 晓 程 ！ ！ ！(大声吼
98926,1886,傅晓程,2019-01-24 05:18:34,-1,4,5,给分超棒的 最后实验没弄出来也4.5
99631,1886,傅晓程,2019-01-25 04:20:30,1,5,4,老师超级赞！！长得还巨帅！！给分巨好！！男神男神！！我要嫁给他！！
99773,1886,傅晓程,2019-01-25 07:02:40,1,4,3,数电实验秋学期的Multisim和冬学期的quartus有很多选做，认真做需要时间，但是认真学能学到很多东西！
100744,1886,傅晓程,2019-01-26 16:30:53,4,6,2,好可爱的班主任
101941,1886,傅晓程,2019-01-30 00:11:11,0,5,5,老师会有很多选做 给我们很多自主学习的资料 在基本要求之上学到很多实在的东西
110043,1886,傅晓程,2019-06-21 15:55:43,0,4,4,实验课吹爆！很仔细的老师，关键后半学期基本没有实验报告！！！给分还贼好！！
111387,1886,傅晓程,2019-07-01 05:53:37,0,2,2,太耐心了
112385,1886,傅晓程,2019-07-04 03:28:01,0,3,3,考试和隔壁班比简单多了
115441,1886,傅晓程,2019-07-24 02:12:11,-3,1,4,很耐心，很和蔼！我没上过他的理论课，但是实验课特别好(✪▽✪)！
115454,1886,傅晓程,2019-07-25 01:41:07,-2,1,3,还可以\n\n
115458,1886,傅晓程,2019-07-25 07:11:10,-3,0,3,太好了，我哭了
115459,1886,傅晓程,2019-07-25 07:11:58,-2,1,3,难得的好老师
117868,1886,傅晓程,2019-10-07 01:36:14,14,18,4,老师直接按学生信息打印表固定座位，然后被固定到后面的我只想说什么都听不到也看不到。收益的只有前几排的欧皇选手吧。\n\n很多同学说去前排才能听到，但去前排也不现实啊，讲课过程中要动手操作仪器尤其是调试设备难道要快速走个十万八千里回到自己的座位操作自己的设备吗。一门实验课这样安排真的有毒。无fuck说。
120519,1886,傅晓程,2020-01-19 04:05:53,3,3,0,老师给了4.5 虽然很高兴 但是仔细一想感觉自己不配 傅老师很好 考试好像相对其他班已经很简单了 平时实验报告认真写 应该没什么大问题 我电路原理选做的部分几乎都不做的 下半学期数电的选作做了一些 eda选作对自己很有帮助 建议大家有空尽量做吧
121872,1886,傅晓程,2020-01-25 03:17:18,1,4,3,我在这个实验上付出的时间和精力最多，才3.5，努力与收获不成正比😂
123306,1886,傅晓程,2020-06-02 03:57:49,2,2,0,无比怀念傅老师的口音和佛系实验报告要求，来自一个模电实验一次课两次实验内容还要期末考无力招架的菜鸡。建议大家选课选择和自己相适应的老师，而不是仅看评分。
132172,1886,傅晓程,2021-01-30 23:49:42,0,0,0,老师给分真的很好！虽然讲课比较模糊，但是实验更多还是靠自己预习和理论课学习。老师很有耐心的。
138301,1886,傅晓程,2021-07-08 11:45:54,2,2,0,上课很晕，不过只能说看自己学习的成果吧，但是老师人和蔼，问问题就能收获解答
156280,1886,傅晓程,2022-06-18 16:07:24,0,0,0,老师有点口音，在后排看得不太清楚，老师人很好，给分好（PS：选做很重要）
157109,1886,傅晓程,2022-06-22 02:57:02,1,1,0,老师好好呜呜呜好温柔讲得也不错
164854,1886,傅晓程,2022-12-27 03:14:23,4,4,0,数电实验选做好难……\n\n\n\n\n\n\n\n是我不配了
166320,1886,傅晓程,2023-01-12 02:35:03,1,1,0,棒棒棒！
166348,1886,傅晓程,2023-01-12 04:40:43,7,7,0,电路电子实验I得了4.5，太太太太惊喜了！感谢fxc老师～\n\n老师实验讲的很细，由于初高中从来没有任何实验基础，刚开始我真的不太会做，老师会亲自辅导直到会为止，而且实验室工作日开放，有空都可以来做。此外，老师拓展的资料很多，如果有兴趣可以学的比较深，后来我学得入门之后也开始研究老师发的各种资料了，如果真的把老师的资料都看过、选做都做了的话那一定会收获非常大的。不过有1说1，有的选做是真的难。\n\n期末考试不是特别重要，不要太过紧张；重要的是平时的选做一定要尽自己可能去完成。我记得我期末线上70分钟的考试空了三道大题，但是我数电小测全做了，电原小测做了一部分。\n\n加油，anyway，预置了或选上了fxc，你就收获了一位宝藏老师，只可惜下学期不是他了。
172287,1886,傅晓程,2023-04-24 09:21:10,0,1,1,给分真的超好，话说选做实验感觉不是很重要，我几乎一次都没做过🤣🤣🤣
179552,1886,傅晓程,2023-09-18 06:53:38,1,1,0,在老师这里拿了两个4.5和一个3.5\n\n简而言之老师人真的很好，也很有热情\n\n看中操作的熟练度，主要需要多练习
186687,1886,傅晓程,2024-01-12 12:54:52,1,1,0,上的电路与电子技术实验1，还没处分但fxc老师在我心里值得100分。老师人非常非常好，非常耐心，课后问他问题也会非常细致地解答，爱了爱了
207847,1886,傅晓程,2024-12-24 13:02:07,0,0,0,fxc老师真的好好！原谅我之前一直对他有不好的印象，后来才意识到是自己没认真听课的缘故，实验课本身也有些通病在里面。但是老师人真的超好，很耐心也会很人性化，只要认真对待，就非常稳~
213698,1886,傅晓程,2025-01-19 08:11:37,1,1,0,《电路与电子技术实验I》\n\n前来打10分咯，fxc超级好！！！人很和善，有问必答，平时实验哪里有问题也会很耐心地帮你一起排查。上课可能由于口音关系讲的不是太清楚，但是课件里都写的非常明白，建议自己好好看一遍！\n\n由于傅老师的课有独特的选做作业，所以事情确实会比其他老师多不少。但我感觉，他的选做虽然量多、有些难度较大，但自主完成之后都是实打实的收获，会对课程学习有非常显著的帮助，真的是“一分耕耘一份收获”的体会！！比如数电实验部分，其他老师可能对EDA就是一笔带过，但傅老师这里每周都会有自行使用Quartus软件完成一些仿真的选做任务，如果都能做完，那么可以说，对于这门课所涉及的EDA的部分的掌握就已经完全没有问题了！又比如期末的选做大作业（步进电机控制器or多功能数字钟），自己设计框架、一点点敲好几百行代码、最后验收通过的成就感真的超级爽！\n\n总之，fxc是神，冲就对了！
221198,1886,傅晓程,2025-06-22 02:18:46,0,0,0,模电实验就1学分的课，事情真的有点多
33708,1894,石健将,2019-02-14 03:12:23,-49,9,58,好老师班主任，不管是学习，专业前景还是班级工作都很关心
49624,1894,石健将,2017-04-20 15:20:00,79,85,6,石健将比王正仕差了一百个马皓
49854,1894,石健将,2018-09-18 01:43:56,7,15,8,去他大爷石健将
50633,1894,石健将,2017-05-04 02:54:30,32,40,8,电力电子技术I有三个上课老师，石讲得最烂
51224,1894,石健将,2019-01-06 11:52:25,13,18,5,去他大爷石健将
51225,1894,石健将,2017-05-24 15:25:54,3,12,9,去他大爷石健将
52313,1894,石健将,2017-06-18 08:30:09,13,17,4,去他大爷石健将
52886,1894,石健将,2019-05-11 22:50:21,-63,13,76,石，人不错，对同学也挺关心的。做研究很强（主要做军工国防这种，挺牛逼的）。就是讲课是真的不怎么样，好多重要的东西根本讲不清楚。
54343,1894,石健将,2017-06-29 06:29:44,-15,2,17,老师重点hua de hao
63736,1894,石健将,2017-12-13 15:51:06,22,25,3,去他大爷sjj谁认识谁傻逼
73732,1894,石健将,2018-02-03 04:51:16,10,11,1,听不懂
80520,1894,石健将,2018-06-27 11:15:27,11,13,2,真的太差了，千万不要选他做导师
88136,1894,石健将,2018-10-23 02:16:31,6,8,2,去他大爷sjj
88365,1894,石健将,2018-10-29 13:05:33,6,7,1,去他大爷
93544,1894,石健将,2019-01-10 08:48:38,7,9,2,恶心字数布丁
102619,1894,石健将,2019-02-14 03:11:11,15,18,3,好老师，给1分鼓励
102620,1894,石健将,2019-02-14 03:11:28,9,11,2,人品不行
102621,1894,石健将,2019-02-14 03:24:53,9,10,1,太差了，什么也不讲，一口方言
103713,1894,石健将,2019-03-04 11:50:51,0,2,2,听不懂，不认真讲课
103838,1894,石健将,2019-03-06 07:41:40,3,5,2,去你大爷石健将
115665,1894,石健将,2019-08-17 03:33:57,-4,6,10,长得帅
118173,1894,石健将,2019-10-22 03:32:32,14,15,1,讲的真差，想马皓了
123109,1894,石健将,2020-05-10 10:34:16,3,3,0,去你大爷sjj
127939,1894,石健将,2020-12-01 00:35:15,8,8,0,我是傻逼
141644,1894,石健将,2021-10-19 02:17:25,2,2,0,这一分给你了，对吧，是吧
141953,1894,石健将,2021-11-02 02:17:14,4,4,0,这什么牛马
150408,1894,石健将,2022-01-24 14:08:46,11,11,0,全国最懂IGBT的
160903,1894,石健将,2022-10-19 02:38:31,2,2,0,上课毫无逻辑，读课本还没课本讲得好
160904,1894,石健将,2022-10-19 02:52:44,0,0,0,没听懂
161255,1894,石健将,2022-11-02 10:10:02,6,6,0,A4纸上sjj=mh+wzs
182223,1894,石健将,2023-11-13 02:52:24,6,6,0,不能用正常人的思维去理解它
198403,1894,石健将,2024-09-08 13:40:48,2,2,0,去他大爷
202264,1894,石健将,2024-11-11 06:08:04,5,5,0,纯逆天老师，电力电子一得抄几百页ppt，上课啥也讲不清楚
204693,1894,石健将,2024-11-27 11:24:09,2,2,0,是吧？
207758,1894,石健将,2024-12-24 07:25:31,1,1,0,上课确实听不懂，但抄了ppt，考期末也算是够了。可是，就凭他的讲课态度，我觉得他的分数也应该大于rn。
216813,1894,石健将,2025-03-26 04:27:31,1,1,0,从未见过如此垃圾的人品，这种人怎么能当教授，怎么能站到讲台上去的？
6690,1895,郑太英,2015-07-19 01:22:11,-16,6,22,坑
9539,1895,郑太英,2015-10-29 08:49:59,7,12,5,还挺好的
9605,1895,郑太英,2015-11-02 15:59:12,0,4,4,看中平时分
14527,1895,郑太英,2016-01-07 12:01:49,8,15,7,顶起！！！
28007,1895,郑太英,2016-06-28 07:58:53,6,9,3,讲课非常好，比隔壁辛老师好，容易理解，记忆，就是这门课公式太多有点艹蛋
29980,1895,郑太英,2016-06-30 15:54:37,9,14,5,奶茶老师萌萌哒，每节课都喝麦斯威。\n\n
38626,1895,郑太英,2016-12-12 16:40:17,13,19,6,哎，我就喜欢这字正腔圆的标准普通话
57385,1895,郑太英,2017-07-07 07:08:34,7,9,2,老师真的很棒！每节课都喝麦斯威\n\n
57512,1895,郑太英,2017-07-09 04:46:35,-4,5,9,给分不是很好，平时成绩很重要，最后总评低于卷面QAQ
73944,1895,郑太英,2018-02-03 16:47:46,-19,7,26,目前我的最低绩点就是郑老师的电气控制。考试题很迷，主观的课本外的内容占了20分，平时分扣的特别狠，莫名其妙被一个看起来笑嘻嘻的老师绩杀了，一言难尽。
76761,1895,郑太英,2018-04-21 14:51:54,59,63,4,正太嘤
77740,1895,郑太英,2018-05-07 12:37:40,5,6,1,嘤嘤嘤
78452,1895,郑太英,2018-05-12 03:32:10,5,8,3,一定要坐第一排搭下茬，很爽的对口相声的感觉
87997,1895,郑太英,2018-10-20 03:58:07,-14,6,20,老师是一个笑嘻嘻的小可爱，但是又会在绩点上给你暴击，明明觉得自己做得可认真了，最后给你2.5，说实话，真是没想到，也想不通，大二两科最低都是他给的，无语……
100381,1895,郑太英,2019-01-26 04:16:02,4,6,2,老师讲课很清楚，很负责，期末考试也不难，基本是作业题。
103388,1895,郑太英,2019-05-04 07:48:32,7,11,4,不错哦
105171,1895,郑太英,2019-04-06 01:41:18,0,7,7,能不能不要拖堂了呜呜呜。
107354,1895,郑太英,2019-05-04 07:50:43,8,9,1,说一说上完计算方法的感悟：1.上课很喜欢拖堂，但是最后提前上完了课，最后一次课就没上了。所以其实也还好。2.讲课很清楚，考试也不难。3.老师人挺可爱的，报告说按照用心程度给分，编程几乎完全自学，学的时候有点痛苦。第一次很认真的写了。但是后来太赶，后两篇报告只完成了最基本的任务。4.分数和自己预期一样。
107355,1895,郑太英,2019-05-04 07:52:41,6,8,2,老师给分挺好的，这种课拿多少分还是看自己。而且老师人很可爱！
107359,1895,郑太英,2019-05-04 08:07:40,7,8,1,老师上课也太有趣了，点名就吓人都不记录，给分超级超级好，经常给我们讲相声
107360,1895,郑太英,2019-05-04 08:13:30,1,9,8,1.讲的蛮详细2.内容不难3.因为是出卷老师，讲的就是考的，比隔壁辛老师要好，不过耿好像直接给了复习重点4.考试蛮简单5.认真写报告，三个matlab，都实现了n阶，尽量用高级算法和简单语句完成，用心写报告，画流程5.考试不难，查老师说绩杀，注重平时分，自己字迹潦草，作业分数很低，有点慌张6.最后还是满了，谢谢老师\n\n
107365,1895,郑太英,2019-05-04 09:28:53,-7,6,13,太好了 上机课可以不去 我最后一周才做的....本来以为凉了 因为报告写得很烂 但最后满了 不知道为什么有人说绩杀
112839,1895,郑太英,2019-07-05 05:38:19,2,5,3,10分
122954,1895,郑太英,2020-04-25 10:47:41,3,5,2,郑老师超好！！
125137,1895,郑太英,2020-09-02 03:18:07,3,5,2,郑太英老师的可很值得上
125322,1895,郑太英,2020-09-06 16:24:00,1,5,4,挺好的，讲课很清晰，很风趣
133789,1895,郑太英,2021-03-05 10:45:09,16,21,5,上过98十大第一的大博主（并引起广泛讨论），人还不错，课讲得也认真
134108,1895,郑太英,2021-03-16 06:19:49,0,4,4,老师呢？\n\n老师在屏幕里
135353,1895,郑太英,2021-05-08 10:16:06,35,39,4,1.基本每节课都会点名，有时候会有一两道随堂测试题目，所以尽量到课。有信心期末考95+不来也行。\n\n2.有三个matlab报告，不难，自学一下matlab两三天可以源代码和报告都完成的很好。如果牺牲一些质量，只完成基本要求一两天内也能完成。我是考试周前翘了周四周五的课加上周六赶完的。质量应该还可以，从最终分数来看应该没有扣分。\n\n3.上课发言1次可以在最后总评加0.5-1分，课前固定发言机会是总结上节课学的东西。不过我没有发言，影响也不大，只是bonus。\n\n4.mooc占20%分数，都在考试里。老师说慕课题目不难，我觉得还是比最后线下期末考覆盖范围更广，更难一点。\n\n5.最后的考试题目不难。都是每章的基本内容，作业题会独立做不看ppt就没问题。\n\n6.老师人很好，给我加分了，我慕课考试的分数算了一下在总评里应该扣2.4分，但是总评是99分，谢谢老师。
139966,1895,郑太英,2021-08-22 14:41:24,2,3,1,很关心学生的一位老师，不仅仅教你知识
139968,1895,郑太英,2021-08-22 15:35:48,3,4,1,[ac06]
139977,1895,郑太英,2021-08-22 16:39:53,2,3,1,ac01
139980,1895,郑太英,2021-08-22 16:58:29,-9,7,16,你就是阁主？[ac06]
139988,1895,郑太英,2021-08-22 19:09:29,2,2,0,ac01\n\n十大观光团
139993,1895,郑太英,2021-08-23 01:04:59,2,2,0,ac01
139994,1895,郑太英,2021-08-23 01:26:44,2,2,0,[ac01]
139997,1895,郑太英,2021-08-23 02:09:50,-17,4,21,查老师的分数就像绩点，你得再多5.0，我一门1.5就能把均绩拉下马
140003,1895,郑太英,2021-08-23 04:48:40,0,0,0,[ac06]
140005,1895,郑太英,2021-08-23 05:06:14,0,0,0,ac01
140008,1895,郑太英,2021-08-23 06:00:17,0,0,0,ac01
140014,1895,郑太英,2021-08-23 10:57:52,-1,0,1,AC01
140143,1895,郑太英,2021-08-29 10:34:39,13,17,4,你知道我怎么翻到的吗？\n\n把与课程有关的帖子全看了一遍，然后知道老师交什么课，然后课程居然有同名的，再知道老师是工科，再在某平台查开课老师。\n\n根据评分，锁定目标。\n\n不愧是我，ac01
141273,1895,郑太英,2021-09-28 03:56:43,0,3,3,横眉冷对千夫指，俯首甘为孺子牛\n\n向郑老师致敬
143390,1895,郑太英,2021-11-25 01:57:57,2,5,3,ac01
144086,1895,郑太英,2021-12-17 10:08:42,1,5,4,好老师\n\nfrom 98
151073,1895,郑太英,2022-02-22 23:59:45,4,5,1,郑太英老师正态吗？
151101,1895,郑太英,2022-02-23 04:26:02,1,3,2,从计算方法过来，然后发现了老师，什么叫惊喜[ac06]
159081,1895,郑太英,2022-07-06 01:10:17,-26,5,31,垃圾。。。
172621,1895,郑太英,2023-05-02 11:42:12,-1,0,1,好好好
179289,1895,郑太英,2023-09-07 11:36:42,0,0,0,课程内容本身比较简单，老师教学水平影响不大
181014,1895,郑太英,2023-10-02 11:39:26,-1,6,7,好势利的老师
182191,1895,郑太英,2023-11-12 06:42:11,-1,0,1,ac01
184219,1895,郑太英,2023-12-13 09:47:22,3,3,0,[ac06]
191151,1895,郑太英,2024-04-09 04:25:09,-1,0,1,[ac01]
210473,1895,郑太英,2025-01-09 08:19:32,1,2,1,计算方法可以跟他学，研究生就别了。。。多调研
211069,1895,郑太英,2025-01-10 12:57:28,1,2,1,是一个关心学生成长的好老师。
217954,1895,郑太英,2025-04-18 09:42:58,0,0,0,上课没发过言，但最后给分很满意
218819,1895,郑太英,2025-05-07 02:36:08,-1,0,1,老师是好老师给分也不差 分数好不好感觉和老师没关系
221926,1895,郑太英,2025-06-27 13:09:54,1,1,0,坐标2025春学期的计算方法，平时上课没发过言（前排那几位太能抢了hhh），考前对照课件和作业突击复习了一下，最后成功拿满了。总的来说，这门课速成是可行的，zty老师给分也不错。
48208,1906,齐冬莲,2017-03-01 08:06:55,1,2,1,山东口音的可爱的老师
54276,1906,齐冬莲,2017-06-29 02:52:32,0,0,0,老师性格不错
74787,1906,齐冬莲,2018-03-06 01:53:59,0,0,0,还没上完
75785,1906,齐冬莲,2018-03-18 03:25:29,0,1,1,虽然课真的很难，但老师人很好
76450,1906,齐冬莲,2018-04-23 15:35:48,31,31,0,讲得天花乱坠，可就是不讲怎么应用，不讲例题，听完课不会做题。
76664,1906,齐冬莲,2018-04-17 14:30:54,10,10,0,讲的乱七八糟
76728,1906,齐冬莲,2018-04-19 07:53:30,7,8,1,老师性格很好。讲课风格……类比辛焕海……建议：老师多做科研少上课。老师很勤快也很友善，要是不在课堂中遇见我会更爱您
78222,1906,齐冬莲,2018-05-10 05:13:12,0,0,0,老师很有活力
78223,1906,齐冬莲,2018-05-10 05:13:58,5,5,0,老师讲的很厉害的样子，就是我真的听不懂
78932,1906,齐冬莲,2018-05-17 05:03:36,6,6,0,老师性格很好。讲课风格……类比辛焕海……建议：老师多做科研少上课。老师很勤快也很友善，要是不在课堂中遇见我会更爱您。\n\n听了项基老师一节课，来帮您把分提一提，我觉得相比之下还是齐老师讲的让人困意少一点。
80817,1906,齐冬莲,2018-07-01 10:59:56,3,3,0,老师贼强是我菜
84108,1906,齐冬莲,2018-07-12 04:31:48,6,6,0,老师性格很好，但是同学们千万不要选她和项基老师的课，有大作业的，任务量超级大，头痛死了。\n\n那个跟齐老师搭班的项基老师是真的不太可以，不是说学识，是说他开玩笑的方式。
105464,1906,齐冬莲,2019-04-15 01:38:32,16,17,1,齐老师挺好的，但别选她和于淼的课。
112815,1906,齐冬莲,2019-07-05 03:54:55,1,2,1,信号课讲得很好！
115026,1906,齐冬莲,2019-07-14 10:02:50,1,1,0,上课很生动\n\n考前居然告诉我们错误信息！害我花大量时间背了会给的公式\n\n但鉴于给的分不错就算了
115386,1906,齐冬莲,2019-07-20 13:55:13,0,0,0,谢谢老师捞我信号一把
122651,1906,齐冬莲,2020-03-12 04:08:40,-19,12,31,就是把条狗栓讲台上都更好
144763,1906,齐冬莲,2021-12-23 13:01:39,0,0,0,好好好
152665,1906,齐冬莲,2022-04-18 01:59:46,3,4,1,已读不回😅\n\n再发不读了，问您个问题这么难吗
191268,1906,齐冬莲,2024-04-16 06:24:36,1,1,0,真的讲得不行（课上完无法完成作业，也不知道讲课重点），ppt也不能起到很好的预习复习作用，还总喜欢抽同学回答问题
196050,1906,齐冬莲,2024-07-01 09:49:26,5,5,0,（仅指和qdl，ym，zjl合开的信号分析与处理课）老师人不错，上课讲故事，比ym生动，但她只上了1/3的课，剩下2/3都是ym上的\n\n此外，信号这课吧，首推zj班。学期末备考阶段我才意识到，zj班的课对于其他教学班是碾压级的好，zj讲了很多qdl，ym没讲的精华内容\n\n我也是做zj的自测题后才意识到水平差距，如果考前没意识到，估计我就寄飞了
217631,1906,齐冬莲,2025-04-14 08:44:32,0,0,0,难评啊
4926,1957,沈连丰,2015-07-01 05:38:35,-8,14,22,电路与电子技术实验II，几乎全靠自己自学……
5156,1957,沈连丰,2015-07-05 10:15:05,-16,7,23,水且坑
8272,1957,沈连丰,2017-01-15 15:51:15,-43,5,48,字写的中文和英文 一口一个柏克莱大学 就他这水平...还柏克莱
10114,1957,沈连丰,2015-11-16 08:43:37,41,50,9,口齿确实不太清楚，但其实没有说的这么恶心，改作业蛮认真的
15433,1957,沈连丰,2017-01-15 15:51:19,-16,3,19,呵呵呵
16525,1957,沈连丰,2016-01-18 10:04:37,23,25,2,见过批改作业最认真的一个老师
19684,1957,沈连丰,2016-01-25 05:41:34,8,8,0,虽然口齿不清 但是人很认真
20846,1957,沈连丰,2016-02-02 04:23:44,21,23,2,批改作业最认真的老师，没有之一
24028,1957,沈连丰,2016-04-25 15:19:33,20,22,2,除了外形比较不拘小节，我真心觉得是好老师。有实际的工程经验，给同学讲设计产品的知识。
26889,1957,沈连丰,2016-06-21 13:04:45,5,5,0,上课要想听清楚就得往前坐…不然容易睡着
27021,1957,沈连丰,2016-06-22 08:10:50,1,2,1,会介绍很多工程实际应用～
27022,1957,沈连丰,2016-06-22 08:16:39,3,6,3,好老师，很温和善良，很耐心。而且期末开卷考，没有更赞！
27397,1957,沈连丰,2016-06-25 16:11:20,3,3,0,老师超级可爱！
27513,1957,沈连丰,2016-06-26 15:59:34,4,9,5,老师很认真，对学生要求可能有点高，但是我挺喜欢的，认真听肯定能听清楚的，如果想水水过的同学就算了吧
32051,1957,沈连丰,2017-01-15 15:52:30,5,7,2,很认真，好老师！\n\n
32755,1957,沈连丰,2016-07-12 09:06:45,5,7,2,良心老师
40224,1957,沈连丰,2016-12-30 08:31:34,7,8,1,当过工程师的老师，上课会给你讲很多设计产品的经历。理论知识扎实与实践经验丰富，是工科学生入门基础课的好老师!
46639,1957,沈连丰,2017-01-22 04:44:00,1,1,0,老师特别好  平时讲的挺难  但考试时你会觉得难度比作业要简单一些 给分棒棒哒～(⁎⁍̴̛ᴗ⁍̴̛⁎)
46839,1957,沈连丰,2017-01-22 12:29:42,1,2,1,很好。
47021,1957,沈连丰,2017-01-23 09:43:54,3,3,0,我下个学期还有他的实验课，平心而论知识很渊博但是讲课实在听不懂，然后期末还是感谢沈爸爸最后一堂课才没有挂的···虽然我想说最后辣鸡三分档坑死人
48437,1957,沈连丰,2017-03-03 15:10:58,11,15,4,轻松愉快
48438,1957,沈连丰,2017-03-03 15:12:49,7,10,3,轻松~愉快！
48501,1957,沈连丰,2017-03-06 06:42:04,3,6,3,口齿不清，一点听不清楚，建议别选！
54243,1957,沈连丰,2017-06-29 01:13:39,35,38,3,拍拍脑袋，轻松愉快！
56531,1957,沈连丰,2017-07-04 02:47:54,0,1,1,好好好\n\n
56839,1957,沈连丰,2017-07-05 00:20:59,3,3,0,老师真的好好好!知识渊博讲课也幽默，作业批改炒鸡认真!对学生考试前也很照顾，认真学成绩不会差!
57632,1957,沈连丰,2017-07-11 08:00:26,3,4,1,上了他的二短小学期，不得不说一下，老师检查验收完全按照实验书按部就班，过程比别的老师复杂，参数也比别的老师查的多且严格，仿真还要你现场做给他看，打印图片都不行。  拿着原理图去问，他也不说，什么都不管，全靠自己，学渣还是别选了挺难受的。最后，应该是因为老师工程师出身，对效果和参数很重视，对原理就。。。。我想9分应该是给的理论课，实验课嘛还是别选了。
63802,1957,沈连丰,2017-12-15 04:44:11,0,3,3,老师讲课会注重实践设计，也会说一说发展历史，有趣。讲课时有些时候会说一些吴语，感到很亲切。
71518,1957,沈连丰,2018-01-28 14:35:26,0,2,2,老师的口齿确实不是很清楚..需要一段时间去习惯。不过老师讲课很认真，作业批改也很认真，最后给分也不错。
73552,1957,沈连丰,2018-02-02 03:09:01,1,1,0,达林顿帽印象深刻hh
75407,1957,沈连丰,2018-03-11 04:37:01,6,8,2,第一节课的体验。。。这个老师好像很懂古诗词文学的样子！！就冲这一点给10分！！！
78292,1957,沈连丰,2018-05-10 12:59:59,9,9,0,最后一节课真的很重要，平时听听课做作业，听了最后一节课不上4对不起老师
82860,1957,沈连丰,2018-07-09 08:34:38,1,2,1,挺好的老师
82993,1957,沈连丰,2018-07-09 12:20:15,4,4,0,平时讲课好，复习课全干货，给分又好，电气学院老师都不错。
83021,1957,沈连丰,2018-07-09 13:28:51,1,2,1,讲的挺不错，目前遇到的批改作业最认真的一个老师，没有之一
83025,1957,沈连丰,2018-07-09 13:40:08,1,1,0,老师答疑很耐心
83055,1957,沈连丰,2018-07-09 14:37:03,0,3,3,课讲得很好，但是大绩杀，30%的平时成绩非常低，基本上对正确率90%以上的有步骤的作业只能给4-，一学期下来平时就得扣8分
85287,1957,沈连丰,2018-07-16 22:52:51,0,3,3,轻松愉快
85519,1957,沈连丰,2018-07-19 01:45:27,0,0,0,不知道
97028,1957,沈连丰,2019-01-21 14:54:58,0,3,3,轻松愉快
103084,1957,沈连丰,2019-07-13 06:55:43,12,12,0,虽然讲课有点迷，但老师人其实挺好的，实验任务不重，实验报告要求也比较佛
103956,1957,沈连丰,2019-03-08 02:40:24,1,20,19,垃圾老师，有口音，上课完全自嗨毫无逻辑，ppt也没有章法，搞不懂为啥分这么高，真的垃圾，跟其他老师完全不能比！\n\n根本不管学生的停课体验
103959,1957,沈连丰,2019-03-08 03:42:43,9,10,1,问一下老师的模电课小测吗？
103961,1957,沈连丰,2019-03-08 03:18:37,13,15,2,我感觉上课真的很扯啊，就属于完全不知道他在讲哪里，书也对不上，真的一点都听不懂！
103963,1957,沈连丰,2019-03-08 03:38:00,11,13,2,上课前不好好预习完全听不懂，基本不讲基础，自嗨状态以为学生基础都很好
105220,1957,沈连丰,2019-04-07 12:34:44,0,11,11,好扯淡啊，模电一上来先上2.4的多级放大，在没有第一章的基础上谁听得懂啊，而且自嗨，仿佛觉得我们第一章早就会了，我就佛了第一章的基础您不讲吗？？然后我也想问有没有小测。实在听不下去了，极差的体验，作业还5个礼拜一交谁会按时写啊，那知识点就跟没上过一样也不会写啊！再见(脏话)
105413,1957,沈连丰,2019-07-08 22:47:57,12,12,0,老师挺可爱的，讲课前面接受不了后面慢慢习惯了
107433,1957,沈连丰,2019-05-05 06:59:27,8,11,3,除了不会讲课，其他都挺好
109448,1957,沈连丰,2019-06-14 12:44:51,2,2,0,稍有点口音 但讲解还是认真细致的
110373,1957,沈连丰,2019-06-26 07:25:45,3,5,2,平心而论，实验课还是不错的。
111397,1957,沈连丰,2019-07-01 06:20:01,10,10,0,刚开始听课听不懂，讲到后面就发现还是挺清晰的，老师PPT东西太多了，主要是有很多拓展，反正对我而言还是有课程以外的收获的。作业可以迟一周或两周交，只有几次作业。最后就是他猜题猜的超级准啊，最后一节课直接告诉你今年怎么考啊，信丰哥，得永生。
114110,1957,沈连丰,2019-07-08 23:40:01,9,9,0,平时上课体验不佳，复习课体验极佳，押题贼准！
114504,1957,沈连丰,2019-07-10 08:42:01,3,3,0,老师人非常好，温柔细致有耐心。上他的模电实验和小学期，不点到，焊完板子直接验收就行。pspice有许多问题他也没碰到过，就会让你自己摸索一下，但他空余的时候一直在做仿真故意有错误的操作看会出现什么现象。验收的时候你不会他也会提示，结束了也会和你讲这样是为什么。建议选！！！
115024,1957,沈连丰,2019-07-14 09:59:12,0,0,0,批作业很认真\n\n上课声音很轻，得做到前排\n\n期末复习总结超级有用，基本就是原题了
125192,1957,沈连丰,2020-09-03 10:12:08,0,0,0,小学期我真是爱了，请问是实验报告少了还是功能没做完，为啥3.5？
125473,1957,沈连丰,2020-09-10 02:08:19,0,0,0,感谢老师的复习课，让本学渣也拿到了不错的成绩！！！
125535,1957,沈连丰,2020-09-11 04:36:55,0,0,0,非常非常好
125745,1957,沈连丰,2020-09-14 02:28:05,11,11,0,事少分好。选上的就偷着乐吧，事最少，就四次作业；期末很多都是复习课的原题；给分也超好，只要把作业题大概40道左右全搞懂，平时不听课也能满绩。
139102,1957,沈连丰,2021-07-12 23:51:12,15,15,0,老师上课的节奏我很难跟上，最后选择去别的老师地方听课。但老师从不点名，原话是“崇尚自由”，这让我直接路转粉。而且复习课干货满满，很多都是考试原题了
140715,1957,沈连丰,2021-09-15 09:02:40,0,1,1,丰哥!
152885,1957,沈连丰,2022-04-21 07:58:12,3,3,0,老师更适合搞科研
153428,1957,沈连丰,2022-04-29 11:51:59,11,11,0,“我们崇尚自由”
155923,1957,沈连丰,2022-06-16 14:23:23,3,3,0,模电理论和实验课都是他上的，实验课没话说，事真的算少的，期末还是开卷，理论课感觉有点难跟上，主要是老师的PPT有点乱？最好能提前搞清楚重点再听，会觉得老师上课很有意思，来浙大遇到的神仙老师之一！
160957,1957,沈连丰,2022-10-21 00:29:42,1,1,0,真的云里雾里……一张PPT似乎试图要把整本书的内容都揉进去
161046,1957,沈连丰,2022-10-25 02:00:52,3,3,0,只能说不太适合我这种只想通过考试的🐭🐭👼
168532,1957,沈连丰,2023-02-19 07:54:29,3,3,0,dan桥不dan
168845,1957,沈连丰,2023-02-22 17:33:03,1,2,1,好！我的神，捞王之王，谢谢老师！
170230,1957,沈连丰,2023-06-30 05:50:32,22,23,1,哞电～～～\n\n一流的老师指导你自学，引领你理解和领悟知识，鼓励创新和举一反三，不上课都没问题；\n\n二流的老师天天点名、抓作业；\n\n三流的老师固定座位、收手机，只会念ppt（甚至ppt都念不熟）。\n\n——————————\n\n出了分评价一下，平时分给分好，MOOC、第二次小测直接算满分了，周围好多人都上4了。平时课基本都不用去，哪怕班里面就剩几个人了都不会点名。
171411,1957,沈连丰,2023-03-23 15:58:55,0,0,0,真正的大学老师，据室友说到课率20%也不点名
173634,1957,沈连丰,2023-05-30 23:21:09,1,1,0,理论课挺好的\n\n实验课对基础差的同学非常不友好
175174,1957,沈连丰,2023-06-22 06:53:28,4,4,0,《轻松愉快》
175205,1957,沈连丰,2023-06-22 09:39:53,0,0,0,答疑慢
176763,1957,沈连丰,2023-06-30 04:45:51,1,1,0,老师上课不点名，讲的课适合预习过的同学听。平时分基本送满了，事是最少的老师没有之一，给分也很好
176914,1957,沈连丰,2023-06-30 16:11:36,1,1,0,老师上课很有启发性，一门模电学到的应用知识比大三专业课学到的都多，平时认真学，考前好好历年题，满绩了
177179,1957,沈连丰,2023-07-02 04:05:10,3,3,0,挺好的，哈哈哈
177930,1957,沈连丰,2023-07-05 13:58:31,1,1,0,人类之光
180735,1957,沈连丰,2023-09-25 12:06:43,3,3,0,沈连丰永远的神！“我们崇尚自由！”爱沈老师一辈子！！！！！！！！！！！！！！期中30分，最后总评2.7，海底捞中捞，从来不点名，平时分满分，作业我迟交了一个多月，老师还是认真验收，永远的神！！！！ yyds！
187889,1957,沈连丰,2024-01-17 17:01:38,2,2,0,虽然我是沈老师班上同学，但是只来上过一次课，沈老师班主打的就是一个放养，会有一点考验自学能力，为沈老师从不点名点个赞！！！and 沈老师班上事情也比较少，没有小测，平时分基本全部给满，大爱！！
190401,1957,沈连丰,2024-03-01 02:50:30,3,3,0,电路与电子技术I，mooc不强制做（分数直接送给大家），不点名，没小测（可能因为课时比较紧张）虽然教室里面没几个人，但是老师讲得还是很认真，作业都是自己批改，挺好的老师
195206,1957,沈连丰,2024-06-27 08:03:57,0,0,0,居然有人觉得沈连丰老师会点名？
196434,1957,沈连丰,2024-07-03 10:25:51,1,1,0,模电海底捞，给沈爹磕一个
196436,1957,沈连丰,2024-07-04 02:53:14,5,5,0,崇尚自由，免听无需申请，可以不去。\n\n上课旁征博引，但是就是让人想睡，且讲的很多东西偏向于古代文学或者电子应用技术而不是考试，如果模电不考试以及有很多时间听一听是极好的。\n\n改卷子极其松，你以为70+的卷面最后就是80+，你敢信模电总评90+一个班四分之一一个班三分之一（破正态输入）？\n\n请注意：童梅老师说过电路12试卷都是自己老师改自己班，所以改卷子松很重要。\n\n沈老师yyds！据说要退休了，退休快乐！
196438,1957,沈连丰,2024-07-03 11:18:49,-3,0,3,给分见仁见智 其实就是按照框架算下来几分就是几分 没有捞人一说 说改卷松也是年级统一的 老师上课emmm 但是退休快乐
196533,1957,沈连丰,2024-07-04 03:04:48,4,4,0,电路与电子技术系列都是自己老师改自己班的试卷，沈老师改试卷极其松，基本都给大家送分。\n\n人也很好笑眯眯的允许补交作业，作业4+和5-都算5分，人非常好！\n\n上课会发散到很远，不过崇尚自由，绝对不点名。\n\n老师退休快乐！！
196582,1957,沈连丰,2024-07-04 06:24:48,3,3,0,退休快乐！\n\n老师终于可以继续自由地研究他的东周列国志、佛教道教、史记、资治通鉴了
200042,1957,沈连丰,2024-10-11 15:29:41,1,1,0,神，无需多言\n\n祝老师退休快乐!
3010,1974,张伯尧,2015-05-13 00:51:39,2,7,5,电工电子学概论大一狗考试挂了，，，，，通识课挂死。。。。。。。。。。。。。
9979,1974,张伯尧,2015-11-13 23:15:19,2,2,0,还行吧，毕竟这东西本来就难以理解
10311,1974,张伯尧,2015-11-18 04:45:39,0,0,0,才3.4，给分低，还有作业
11230,1974,张伯尧,2015-11-25 11:56:58,1,1,0,老师很认真的讲 但太难 不介意选 给分也不好
12242,1974,张伯尧,2015-12-22 13:46:15,0,0,0,催眠弹
15990,1974,张伯尧,2016-01-17 02:07:24,0,0,0,老师讲的挺好的，就是口音我有时听不懂= =平时认真对待绩点不会很低
16253,1974,张伯尧,2016-01-17 14:54:17,0,0,0,2.6  不用解释什么了  为了身心健康 慎选
21294,1974,张伯尧,2016-02-28 03:18:18,2,2,0,非常好的老师，有幸上他的最后一门课应用电工电子学，今年退休了
1213,2025,林平,2015-03-21 16:42:04,8,12,4,讲的通俗易懂，幽默风趣
2179,2025,林平,2015-04-05 11:27:33,4,8,4,上得好
2744,2025,林平,2019-05-28 02:10:52,56,65,9,讲课很快，很经常提前下课，但是只要你有不懂的去问他，他都会很耐心的解答而且上课的时候很经常提到一些以前上课的同学问他的一些问题，顺便就解答了自己心里的疑惑
8757,2025,林平,2015-09-25 13:21:14,10,14,4,不错，挺负责
8839,2025,林平,2019-05-28 02:10:49,20,24,4,上的很好。通俗易懂，而且有意思\n\n
9372,2025,林平,2015-10-25 11:22:50,-17,8,25,讲课，答疑无可指摘，但是搞突击测试减了印象分。
9762,2025,林平,2015-11-08 11:32:22,9,14,5,男神级别。很好。
10669,2025,林平,2015-11-22 06:59:34,4,8,4,很不错
10915,2025,林平,2015-11-23 09:40:58,3,7,4,老师讲课有条理也很风趣，答疑十分耐心。
11091,2025,林平,2015-11-24 06:08:21,5,9,4,细致周到，幽默风趣\n\n
14185,2025,林平,2018-09-20 07:32:18,-72,11,83,爱搞狗屁研讨，一搞就是3节课还搞2次。期末别的班都在赶进度，留出时间总结，讲习题，他连内容都没讲完，还在那安逸的搞研讨，真是能混！
16274,2025,林平,2016-01-17 15:49:26,3,6,3,赞赞赞
16516,2025,林平,2016-01-18 09:42:30,16,18,2,幽默爽朗，条理清晰。虽然讲的是最基础的模电数电，但是总是向我们渗透更专业的知识与思维，研讨课也锻炼了同学的能力。
18372,2025,林平,2016-01-21 13:42:05,2,6,4,挺好的老师
20069,2025,林平,2016-01-26 04:24:05,10,12,2,炒鸡棒唉！虽然画风很粗犷但是人真的很好玩
20464,2025,林平,2016-01-27 16:27:02,6,9,3,课讲的清楚，给分高
20479,2025,林平,2016-01-27 17:14:47,8,10,2,讲得很快，但很清楚，经常提早下课让我们去吃饭。总之好老师
20578,2025,林平,2016-01-28 14:38:27,2,6,4,老师真心负责，给分也是超级好
22593,2025,林平,2016-03-08 08:59:53,5,8,3,听着带劲，听完了爽。
28049,2025,林平,2016-06-28 08:02:19,3,6,3,讲的很清楚
28442,2025,林平,2016-06-28 09:00:08,32,34,2,鱼非萌
28633,2025,林平,2016-06-28 11:19:09,19,21,2,好老师不解释，讲课我只服林平老师！
28905,2025,林平,2016-06-29 03:07:06,3,6,3,很负责的老师，讲课很清晰，考试从不出偏题怪题。认真听懂他上课讲的典型例题就能考好
30415,2025,林平,2016-07-01 13:46:56,4,6,2,超级好的老师，耐心答疑，给分高
35830,2025,林平,2017-01-20 21:45:06,3,4,1,条理清晰，幽默风趣，给分极好！
38670,2025,林平,2016-12-14 06:32:52,5,5,0,林老师讲课好，我觉得关键在于说话自带着重号，听起来很舒服，能帮我们抓住重点，理清思路。
39106,2025,林平,2016-12-21 07:42:54,5,6,1,爱林平，林平让我有种自己是工科生的幸福感，不解释
39137,2025,林平,2016-12-21 09:55:32,2,3,1,爽爽爽
40777,2025,林平,2017-01-05 11:22:56,1,4,3,虽然大概我考得不好 但是老师真的很棒啊！ 研讨课也蛮有意思的 毕竟可以拿来当平时分加分项啊\n\n
46042,2025,林平,2017-01-20 13:23:55,2,4,2,老师太好了！！！听课没话说，每次问问题态度都好温柔！即使我问很蠢的问题他也很深入地分析还帮我联系其他知识！喜欢
46292,2025,林平,2017-01-21 06:55:10,6,8,2,老师很好，给分也好，我只知道abxi和abc傻傻分不清
46534,2025,林平,2017-01-22 02:02:17,1,4,3,老师超棒！
46858,2025,林平,2017-01-22 13:51:16,3,4,1,真的像保姆一样，很耐心，讲得很好，给分很客观，就是不喜欢讨论课加分，大家都太水了，就像去水平时分一样，特别是组队抱别人大腿的。
46883,2025,林平,2017-01-22 15:43:29,6,7,1,老师萌萌男神，上课讲知识点清晰易懂，喜欢打各种漂亮的比喻，还会跟我们谈人生谈理想。
47166,2025,林平,2017-01-24 07:58:26,5,5,0,虽然觉得容量比较大速度比较快但是莫名其妙就能听懂2333体验真的很好~
48338,2025,林平,2017-03-02 07:35:58,3,3,0,超级喜欢
50267,2025,林平,2017-05-02 05:39:04,4,4,0,老师很随性hhh讲的很清楚，人也很好很简单的问题也会耐心给你讲，男神！
50317,2025,林平,2017-05-02 10:23:05,9,10,1,同学们这是什么萌？搞清楚哦，这是与非萌，这是欧西萌。
50484,2025,林平,2017-05-03 06:14:17,2,4,2,老师很好，讲课很清晰，虽然实验的时候会怼人，但收获很大
50914,2025,林平,2017-05-08 13:43:28,9,11,2,什么叫做实验？不是做的快，做得好才叫做实验。实验过程中出现了问题，解决了问题才叫做实验。上老师的课很舒服，不着急。
52803,2025,林平,2017-06-23 03:36:58,13,14,1,林平爸爸水平比较高，但是认真听能听懂，然后课后作业认真做，跟着老师学不会出错的。最后夸一句林平爸爸萌萌的口音嘻嘻
55280,2025,林平,2017-07-01 07:52:59,1,3,2,很很棒～
57333,2025,林平,2017-07-06 22:47:52,6,11,5,谢谢老师！给了我4.5\n\n
58151,2025,林平,2017-08-08 10:06:59,7,8,1,风趣幽默，直击要点，要是模电是他教的就好了
70458,2025,林平,2018-01-26 15:59:31,3,3,0,我爱平哥！
71537,2025,林平,2018-01-28 14:56:33,14,16,2,听我的林平爸爸上课真的会很舒服，感觉他上课没讲啥东西，但就是不知不觉把知识点讲完了。(虽然考前一天问题目竟然被质问你上课有没有听?，同时也提醒不要一味做题也要去看书上的基础，可以说是为复习指明方向了)，爱林爸爸一万年+
71549,2025,林平,2018-01-28 15:14:25,6,7,1,模电来评。老师超棒！！！感觉水平很高，讲课很自如，感觉没讲什么但是已经学会了，还经常和同学分享一些有关学习的看法，很受用！总之很棒，不拘泥于形式的好老师。
74663,2025,林平,2018-03-05 04:46:00,0,2,2,人好，给分好，可惜后来课表实在补选不上他的课了
76463,2025,林平,2018-04-10 06:29:23,1,3,2,太帅了
79154,2025,林平,2018-05-24 15:22:34,1,4,3,突然有一天，觉得老师好帅呀！！！平叔叔就是那种又帅又腻害的男神老师～～～模电数电都选了男神的课！开心?
80714,2025,林平,2018-06-29 14:21:57,9,10,1,实验完成的顺利不是我们要追求的目标，因为一帆风顺的实验并不一定能带给我们做到的收获，而出现问题并解决问题的过程，恰恰是对我们非常重要的学习过程。 在林老师的课上做实验，出现失误和挫折不丢人，也不用慌乱。上了这么多门有实验的课，我认为，林老师对实验的态度，大概是最接近实验教学的本质的。
93517,2025,林平,2019-01-10 07:17:37,1,1,0,老师人超级好
94498,2025,林平,2019-01-17 02:40:06,5,5,0,讲课有自己的风格，不拘泥于形式，上下来对整体的知识点都能掌握，细节还需要自己看书梳理。老师很好，特意在出分前给老师打十分，因为实在考的太差了，怕出分后emmm
98716,2025,林平,2019-01-24 00:18:41,0,0,0,老师超级超级好啊
98766,2025,林平,2019-01-24 02:05:54,1,2,1,老师超胖！ 6学分的课从没想到能考那么好 可惜下学期没选上他的课
99472,2025,林平,2019-01-25 00:34:38,1,1,0,老师巨好，喜欢老师的与非萌
104583,2025,林平,2019-03-24 10:10:08,2,3,1,没那么多花里胡哨的，我只想给100分
104858,2025,林平,2019-03-29 02:09:01,0,0,0,听课太享受了！思路清楚，幽默风趣，电院上课最棒的老师了
113410,2025,林平,2019-07-06 17:09:16,-3,2,5,不错的老师，通俗易懂，给分好
113465,2025,林平,2019-07-06 17:44:06,-2,2,4,老师上课讲的好，课后答疑非常非常认真，讲到懂为止。考不好真的是自己太菜了。。。
113493,2025,林平,2019-07-06 18:39:41,4,6,2,某班给分一般
114781,2025,林平,2019-07-11 17:10:30,14,16,2,数电。上课讲的让人听不进去，但是新开了mooc挺好的。感觉考的还行，而且老师也说刷完mooc平时分会高，结果80都没有，可能是我太菜了吧。唉，对数电对老师都无爱了。
114796,2025,林平,2019-07-13 12:44:25,18,25,7,天，怎么给分这么差啊……
114949,2025,林平,2019-07-13 02:30:07,14,16,2,给分太实在太差了
114968,2025,林平,2019-07-13 07:27:09,11,13,2,给分奇差无比
114974,2025,林平,2019-07-13 12:42:00,-10,7,17,说老师给分差的，你们确定不是自己考的不好？
115051,2025,林平,2019-07-15 01:01:02,-7,2,9,普通班，春夏模电。老师在讲完知识点后经常提前下课，课上还会补充一些课外知识，我感觉讲得挺不错的但就是有点快。课后答疑很耐心，是真的想让你弄懂的那种。给分还行吧，期末记得好好看作业题?
120181,2025,林平,2019-11-18 03:50:00,2,2,0,（:…）
120754,2025,林平,2020-01-18 22:31:05,-1,2,3,10分没商量 讲的好 给分高 上课还拓展知识面 告诉我们不要太过注重绩点 如沐春风
120921,2025,林平,2020-01-18 21:45:39,-3,1,4,讲课水平高，而且给分也太好了！感觉自己期末考崩了还是被捞了一手，从来没想过自己能拿这么高的分数
122169,2025,林平,2020-02-18 13:57:42,-5,2,7,老师知识丰富，讲话方言很萌，但每一个点还是会给你弄清楚，顺便还带我复习了下我辣鸡的常微分。。。最后给分超级好，感觉期中崩了最后竟然99。。。所以大家还是重点关注期末吧。在此特别祝贺老师升任教授！
125428,2025,林平,2020-09-08 13:39:39,4,9,5,给分奇低，慎选
125586,2025,林平,2020-09-12 02:11:14,0,2,2,给分很好，上课能把模电讲的很清楚，超赞
125590,2025,林平,2020-09-12 03:04:41,7,19,12,wc。。。期末自己算至少扣了八九分，mooc也只有80分，总评96.。。。老师真的能捞人。。。。
125603,2025,林平,2020-09-12 08:22:45,0,1,1,我的数电模电、电工实习都是他的，感觉老师特别认真负责，会给你分析原理，让你学的懂
125659,2025,林平,2020-09-12 15:51:02,0,3,3,疫情期间老师线上上课，要求先听mooc，上课再讲的一遍重点，个人觉得比较浪费时间。\n\n但老师给分实在太好了5555！神仙老师！
130685,2025,林平,2021-01-24 07:53:04,-1,2,3,林爸讲的好，给分好，还能说什么呢！
133499,2025,林平,2021-03-01 09:31:56,0,8,8,电工电子实习做了将近2周，功能和仿真也都实现了。验收的时候被老师上来一顿骂，可能是我实现方式和别人不一样吧，老师也不听我解释。最后给分中等，是我大学阶段最差的一门课。我不知道他其它的课怎么样，但电工电子实习选他会后悔的
145653,2025,林平,2021-12-31 02:46:11,-2,2,4,林平 你是我爹，好老师！吹爆
147037,2025,林平,2022-01-08 13:25:16,11,12,1,给分差
148250,2025,林平,2022-01-12 03:31:36,15,18,3,讲的挺好的，但是想不到怎么只有这么几分…
148257,2025,林平,2022-01-12 03:42:58,-25,5,30,林爸讲的很好，虽然课都翘了，考前两天2倍速看他的智云硬是给学明白了。谢谢老师的4.8！
156977,2025,林平,2022-06-21 13:04:41,0,6,6,很坑，网课强烈不建议选
163549,2025,林平,2022-12-15 05:31:33,9,11,2,上得是很有水平，也愿意给学生解答疑问。但是，林老师觉得每道题都很简单，“考试就考这种简单题”，可是（个人感觉）真的还是挺难的啊。
169650,2025,林平,2023-02-27 09:10:40,-1,2,3,讲课很清楚，有提高内容，给分也仁慈
170334,2025,林平,2023-03-03 02:26:48,5,6,1,上了林老师的电路1，老师人很好，电原的时候感觉讲的有些快跟不上，期中也挺难的。不过进入数电部分就觉得挺简单的，老师讲的很顺，思路很清晰，零基础学起来也没什么压力，期末考题目量很大，做的时候不要反复检查，不然肯定会来不及。老师平时都会传ppt，复习的时候可以多看看。最后出分感觉还是很捞的，谢谢老师啦~
170450,2025,林平,2023-03-05 05:20:18,0,0,0,老师水平很高
171482,2025,林平,2023-03-25 16:48:02,11,11,0,爱班的课授课顺序是电路I模电，电路II数电，和别的班不一样，生仪的同学选课的时候要注意一下不要选带爱班标记的
175285,2025,林平,2023-06-23 08:25:35,0,1,1,感觉是个好老师 是想传授知识而不是应付考试的 但是个人觉得老师水平太高了所以模电不太能跟上老师的节奏 先给个10分 希望老师给分好点 捞捞我
175806,2025,林平,2023-06-26 23:14:38,0,1,1,条理清晰，顺畅淋漓
178165,2025,林平,2023-07-07 11:15:15,3,4,1,有水平 但只适合佬
183948,2025,林平,2023-12-04 13:05:28,4,5,1,无关成绩，只是单纯听老师的课很舒服。思路通畅，逻辑严密，和我听数学时云里雾里的感觉完全不同
187681,2025,林平,2024-01-17 05:41:32,1,1,0,林平老师我真的i死TAT
196575,2025,林平,2024-07-04 06:13:26,2,3,1,理论课讲的还行，实验操作一点不教问就是导线断没断芯片检查没有，给分很很很一般。。。
196661,2025,林平,2024-07-08 16:23:43,4,6,2,模电今年传闻说卷子难了，别的班老师怕学生成绩波动太大都不扣平时分，林老师对自己上课自信，该怎么扣怎么扣，最后扣出来也的确跟往年没什么区别。林老师扣平时分不是因为你该扣平时分，而是因为他觉得模电没期中平时分白给60%太多了，都得扣点（人均小测全对也要从研讨里扣2-3分，mooc扣多少就多少，加起来3-5分总有的），要是你小测从头错到尾，期末大题也没做对几个，那就更惨了，你要知道模电卷子是自己班老师自己批的，林老师一看你期末还不会，小测卷子一看你没写几个对的式子，该给你扣光两个分都扣光，15分的小测只有五分点名分。。。\n\n\n\n林老师讲课水平确实很高，上课都听懂了，答疑都去了，期末都做出来了，得分自然也会高。反正我平时作业认真做了，研讨没怎么卷，期末复习体验挺好，最后分数没有满绩但也还算满意。林老师班上的高分都是自己考出来的，班上大佬多，卷王多，寒假提前学完模电的人也很多，所以顶着扣三分平时分的压力拿满绩也大有人在。模电是质量最高的基础课了，学会了什么才是最要紧的。\n\n\n\n当然秋冬数电放心选，林老师期中改卷也挺严的，但不会比别的班差太多。。。总之一句话，想求高分勿入斯门。
196811,2025,林平,2024-07-05 08:54:43,3,4,1,林老师见惯了高徒，自然而然成了严师，但是无论怎么说一定是一位好老师
196893,2025,林平,2024-07-05 19:55:52,1,2,1,给分也太差了，就算期末按斩杀线算，平时分也扣了不少，不知道这个分怎么来的
197073,2025,林平,2024-07-08 10:40:28,0,3,3,楼下你按斩杀线算45分，考试就扣总评20几了，你又说平时分扣很多。。那你总评差不多就60几吧，考试考了45难道平时分还要给你100吗，不知道你小测研讨做得怎么样，还是觉得只要去了做了就能拿满，期末考个45，平时给个80已经算很好了吧（60%换算下来总评扣个12，加上你期末45差不多就是60几），难道平时分所有人都要给满吗（作业只要交了就满但只占10%是所有人都满。。）。就我感觉lp老师适合佬，很良心很求是（中性），适合大佬，最后我i林平。
200773,2025,林平,2024-10-22 07:03:56,1,1,0,电路一上到一半 目前没点过名 讲课很清楚！
207454,2025,林平,2024-12-22 03:20:54,5,5,0,林平，沈红，周箭，德华，电院F4编的模电教材书实在是太烂了，没有重点，内容和上课内容相比缺失，没有加粗符号，逻辑不清晰，导致模电部分还要回去翻电路部分的书，而且题目还经常出现下标印刷错误。比如说电流源书上就讲了三种但是上课有好多种。
207848,2025,林平,2024-12-24 13:05:43,9,9,0,太好了，是突击小测，我们没救了
210695,2025,林平,2025-01-10 00:44:32,2,2,0,查老师上的第2025个老师处打卡
213420,2025,林平,2025-01-17 09:06:44,8,10,2,真算了吧，太求是了，而且感觉上课也确实不是很可以（可能我不太适合），讲的太快了，而且PPT纯纯防自学
213427,2025,林平,2025-01-17 09:39:43,4,4,0,老师上的真的挺好的，但是最后分数跟其他老师比起来略低，更适合佬
213435,2025,林平,2025-01-17 10:38:25,7,7,0,在已知课程学分较大、成绩构成对学生不友好的情况下，加入过难的小测和过于求是的给分，讲课质量再好也难以让人接受
213441,2025,林平,2025-01-17 11:08:17,5,5,0,电路1给分差，在别的老师平时分都能给满的情况下硬是要扣你好几分，慎选
213458,2025,林平,2025-01-17 13:07:55,3,3,0,上课讲的还是蛮清楚的，但是突击小测（不提前通知），其他时间不点名。我是上课不听，课后智云2倍速+PPT自学（2个半小时的课实在没法一直集中注意力）。数电期末题量很大，本人题做的不多，确实学的不扎实，好多题没做完（给够时间应该是能做出来的，建议把历年题全限时刷一遍提高熟练度），第一次突击小测的时候自学进度没赶上，应该直接0分，期中（1道半大题没写出来）和mooc（期末83分测试全满）都做的一般，最后2.7只能说自己确实功夫不到家。总之讲课质量行，但求是绩杀，能选zdh尽量换老师。
217922,2025,林平,2025-04-18 03:28:37,5,5,0,第二次体验突击小测，还是被恶心到了，故来打低分。考试周突击小测真邮电部诗人了吧
218744,2025,林平,2025-04-30 06:55:39,3,3,0,lp，sb中的sb，上课讲的飞快，也不管你听不听的懂，每节课就一个人在自嗨，智慧树要求也不说清楚，悄咪咪的布置一个讨论又截至，80%的人都错过了就说第一节绪论课说了，只能说选上了就赶紧跑吧，模电本来就难，摊上lp那可真是sb老师配sb学科，锁死
218954,2025,林平,2025-05-15 02:53:25,4,4,0,我他妈不明白为什么这种老师评分这么高，讲课飞快，画图跟一坨屎一样，在黑板上写东西好像有人追着他投胎一样，写的乱七八糟一坨狗屎，纯粹自嗨，语速飞快，自言自语，就没打算让你听懂，不负半点责任，感觉就是应付教学，就只管把自己教学任务完成，不知道怎么还有人说这种傻逼教学质量高，他妈就一坨狗屎
219786,2025,林平,2025-06-06 08:59:01,2,2,0,智慧树悄咪咪截止了，上课不知道在讲什么，唯一的好处是完全不点名，但是突击小测（悲）
221446,2025,林平,2025-06-23 14:05:15,2,2,0,🙏🙏🙏
221912,2025,林平,2025-06-27 11:34:20,0,0,0,电路与电子技术2。虽然智慧树网课要求不明晰甚至相当一部分同学错过了第一个讨论任务，但是从平时总成绩来看老师在网课上要求并不算高，该做的资源学习和测试做完就可以拿到对应分数。\n\n从来不点名，但是突击小测😭\n\n平时成绩会捞，但是期末下手狠😭\n\n讲课水平很高，但是ppt防自学😭
6689,2051,杨仕友,2015-07-19 01:20:23,9,13,4,好
26034,2051,杨仕友,2016-06-15 07:13:52,25,30,5,上课经常迷之微笑的老师\n\n
48158,2051,杨仕友,2017-03-01 03:49:24,1,2,1,其实我就是乱打个分的
55704,2051,杨仕友,2017-07-02 08:18:47,6,8,2,先打个十分，要是工磁没挂再回来写评论
55964,2051,杨仕友,2017-07-02 22:46:15,-8,2,10,先打个十分，工磁要是满绩了回来评论
56103,2051,杨仕友,2017-07-05 15:36:24,4,4,0,没挂科，谢谢老师
57751,2051,杨仕友,2017-07-14 02:11:59,4,6,2,上课不好给分贼好
57954,2051,杨仕友,2017-07-18 10:32:45,5,5,0,杨老师上课总是蜜汁自嗨然后蜜汁微笑，所以上新课会有点吃力，但是他的总结课习题课还是很好的，而且回答问题非常耐心，不懂的都去问吧
59573,2051,杨仕友,2017-09-23 08:22:12,1,2,1,经常谜之微笑，给分贼好。
74639,2051,杨仕友,2018-03-05 02:31:22,1,3,2,。。。
74640,2051,杨仕友,2018-03-05 02:31:29,1,4,3,好奇怪，自己聊
74652,2051,杨仕友,2018-03-05 03:24:14,9,16,7,先给个10分，能坑一个是一个
74956,2051,杨仕友,2018-03-07 00:43:01,5,10,5,求他上课说话张开嘴……
75881,2051,杨仕友,2018-03-21 00:44:47,4,6,2,有点像六小龄童呀
75883,2051,杨仕友,2018-03-21 01:08:28,5,6,1,terrible
76031,2051,杨仕友,2018-03-25 06:42:46,1,3,2,课堂体验……极……
76343,2051,杨仕友,2018-04-04 01:00:49,8,14,6,上课体验极差……从来没遇到过讲课这么不明白的老师……
76737,2051,杨仕友,2018-04-19 13:27:15,0,5,5,周一刚小测一次，周三又来了一次。讲课真的不怎么样基本自学还用小测逼着学生去上课。
79025,2051,杨仕友,2018-05-21 03:22:26,-4,3,7,先给个1分，8.2的评分太高了，坑人
80343,2051,杨仕友,2018-07-05 10:29:45,7,10,3,大家千万要注意！注意什么啊？什么啊？什么啊！(喝口水)
80750,2051,杨仕友,2018-07-13 08:02:14,1,2,1,自学吧朋友们
84588,2051,杨仕友,2018-07-13 08:49:53,0,2,2,谢老师不挂之恩
84978,2051,杨仕友,2018-07-15 00:14:22,1,2,1,给个十分
85556,2051,杨仕友,2018-07-19 10:12:41,-38,1,39,坑爹，一次小测没去，就差这一分满绩，早知道选个没小测的老师，反正都是自学
86633,2051,杨仕友,2018-09-17 14:37:38,2,3,1,emmm...虽然讲课不是很清晰...但是老师人很nice并且给分很棒呀
86634,2051,杨仕友,2018-09-17 14:43:12,0,1,1,人特别好 很亲切 给分厚道
88728,2051,杨仕友,2018-11-06 16:51:21,3,3,0,蜜汁微笑的老师
91770,2051,杨仕友,2018-12-19 16:55:21,1,2,1,对学生超级好很负责的老师
102968,2051,杨仕友,2019-02-25 06:41:32,2,2,0,好想睡觉...?zzz
103249,2051,杨仕友,2019-02-27 03:22:27,2,2,0,杨老师人特别好，温文尔雅，学术水平很高，非常负责的老师
103834,2051,杨仕友,2019-03-06 07:25:52,0,2,2,蜜汁微笑，老师人很好，学术水平高，虽然讲课听不懂，但是给分高
104059,2051,杨仕友,2019-03-11 06:59:34,5,8,3,所以他在讲什么呢？上课两句话一个对吧，永远不知道他在笑啥，把课讲的听不懂就那么值得高兴吗
105237,2051,杨仕友,2019-04-08 05:49:47,2,5,3,不知道这位老师在笑什么
112772,2051,杨仕友,2019-07-05 02:49:12,-12,4,16,90/4.5，本来希望能冲5.0的，结果选择填空要了我的小命??老师的工磁事情少，实验简单，作业轻松，还能学到很多知识！！不需要什么竞赛基础，只要好好学，重视这门课，考前仔细看书，尤其是那些没有习题的地方很容易出填空的，最后考试肯定能获得满意的结果。但是要想冲5.0的话还得需要一定的技巧和运气…下学期去玉泉跟着老师搞科研了，看来自己还要加强一些数学物理基础…
125305,2051,杨仕友,2020-09-06 05:25:22,6,6,0,给分好
125313,2051,杨仕友,2020-09-06 10:56:53,20,20,0,老师很好，一点架子也没有，非常和蔼可亲。钉钉群里回复很及时，即使是一句“谢谢老师”也会礼貌回复，印象很深一次有个不是我们班的留学生进群询问了一些东西，群里没人理这个人，结果老师用英文给他回复了很长的一段。平时如果作业迟交了也会马上帮我们延后，最后平时分基本都很好。虽然上课时因为经常会拓展一些课外的，讲得可能有点晕，但是可以看出老师的水平是很高的。在考前也会为我们安排答疑，复习课上会把以前做的作业都讲一遍，然后会把重点再梳理一遍，所以复习课一定要好好上。最后出分很快而且给分真的贼好，真的没想到自己能有这么高，感谢老师！（不明白为什么这里的分为什么这么低，工磁本身就是一门比较难理解的课，课上不懂也不能全怨老师，课后还是需要多花工夫的。）
136033,2051,杨仕友,2021-06-10 01:30:18,6,6,0,老师讲课是意识流讲课，让我深觉知识是只可意会不可言传的。老师总是面带微笑，虽然上课一点没听懂，可是心情很好～(￣▽￣～)总之态度好，最后大家平时分都是99、100
138533,2051,杨仕友,2021-07-09 16:00:12,2,2,0,谢谢老师捞我
140170,2051,杨仕友,2021-09-02 06:41:26,2,2,0,学术水平高，和蔼可亲的老师
156322,2051,杨仕友,2022-06-19 05:10:26,0,1,1,老师的课事很少，平时分基本都给满了。最后期末都写了虽然只有70分。可能是我自己的问题吧。有点不甘心还是给9分了。
156974,2051,杨仕友,2022-06-21 13:03:47,0,0,0,意识流教学，ppt水分很大，建议拿其他老师的ppt
176660,2051,杨仕友,2023-06-29 15:27:47,2,2,0,大雾甲2拿了4.8\n\n伟大的杨老师工磁拿了3.6\n\n上课对着自己几乎没有汉字的ppt乐呵呵\n\n当然他的ppt上面有的都考到了\n\n想要看明白他ppt的前提是你懂工磁\n\n顺带一提，\n\n电气的夏长亮院士从副教授升到教授的时间花的比ysy久\n\n他现在天天对着我们乐呵乐呵\n\n呵呵
182388,2051,杨仕友,2023-11-15 12:05:10,0,0,0,讲课 讲着讲着自己会蚌埠住
185364,2051,杨仕友,2023-12-28 10:55:45,0,0,0,上课会偷偷的讲历年卷，期末还可能考到，乐呵乐呵的老头子，经典穿搭
191727,2051,杨仕友,2024-04-29 05:25:14,2,2,0,微笑哥
192737,2051,杨仕友,2024-05-30 00:35:45,1,1,0,听不了一点，一大片人都在他课上听lyl的智云。为什么到课率低？上课蜜汁微笑真的很窒息，对吧？对吧？还没考，真的绷不住了来打分了。签到形式包括但不限于：钉钉限时一分钟签到，最后几个挨个查；每两三周做个题交纸（不过这个还好，都给答案的）；第6周习题课一上课就交纸条一个个收点名……我承认老师的学术水平什么的都很高，人也和蔼，但既然这样为什么不专心科研呢，来教学岗凑什么热闹？可能是我菜，他讲的课或许适合拿来当复习课，上新课纯坐牢。还有一件事，单双周上课，双周周一本来是两节的，春学期某次他出差和我们“商量”上三节，就一直上到了整个学期末，然后我们课程进度比其他班快一周，但是有什么用呢？还不是找lyl智云补？真想跟着老师好好学，不如选lyl或者yyy
195570,2051,杨仕友,2024-06-28 23:40:58,2,2,0,建议上ysy的课，听lyl的智云，做xsm的卷子，博众家之所长
202757,2051,杨仕友,2024-11-14 07:16:27,6,6,0,老师上课讲的挺认真，人很随和，但就是听不太懂
206792,2051,杨仕友,2024-12-17 14:30:27,14,14,0,杨老师会有奇奇怪怪的点名，不过因为我每节课都去，所以没有影响。上课的口音是有一点，单纯上课体验是比较一般的，听着听着就困了。不过从老师本身来说，我觉得是好老师！下课后或者钉钉上问问题都会耐心回答。有一次路上遇到了，我还在犹豫要不要打招呼，杨老师就先打招呼了。平常杨老师骑着二八大杠上下课，感觉也很亲切。老实说这门课我是非常认真学了，最后96/5.0。
215645,2051,杨仕友,2025-03-03 07:49:55,3,3,0,课程中实在听不下去了，只能说老师的口头禅，一节课总计可能上百次的“是不是啊”“是不是”“对不对啊”“听懂了吗”把讲课思路撕得稀碎；打听式教学，讲课过程中问句比陈述句都多，时不时会来一段让人困惑的停顿，好像是在等我们回答他的问题（但通常没有人回答），听课时让人体会到深深的无力感和气不打一处来的感觉
216071,2051,杨仕友,2025-03-10 07:10:21,1,1,0,喜欢穿粉色衬衫 和上课时的蜜汁微笑很相配。
216996,2051,杨仕友,2025-03-31 06:21:08,2,2,0,在讲啥？
220696,2051,杨仕友,2025-06-19 08:47:05,1,1,0,你要说杨老师讲课，我只能说确实听不懂，但你要说杨老师捞人，那是真的能捞，非常温柔善良的老师
220787,2051,杨仕友,2025-06-19 17:44:02,1,1,0,补个评价：讲课挺水的的，印象中班上也没几个人听。然后上课会随机签到，有相关需求的同学可能要注意下。但是老师本身还是不错的，挺好说话的，当时选课冲突了，补选杨老师的课然后申请整个学期都听智云，老师还答应了（感激不尽）。然后给分个人感觉还不错吧，但这个也挺看期末的（我只是比较了同学期的其他专业课得出的这个结论）
220950,2051,杨仕友,2025-06-20 12:31:44,1,1,0,卧槽，给了我一个我完全不敢想象的成绩
220952,2051,杨仕友,2025-06-20 12:38:36,1,1,0,在工磁这门课里好像没啥人提到的老师，选上之后就明白原因了，0人能听懂他在讲什么。听懂他的课的前提是你本来就懂。不过工磁听lyl老师的网课自学还是挺有条理的，不难学，看群里大家反馈给分普遍也都很好，预置到ysy老师的课但选无妨~
221834,2051,杨仕友,2025-06-26 15:35:05,1,1,0,工磁选不上lyl其实ysy也不错，平时小测当点名，少一两次也没关系，做最后一排lyl启动就行了，期末感觉比lyl给分好，回答问题也很热心
22518,2088,彭勇刚,2016-03-07 07:28:13,9,16,7,讲得很清楚
27283,2088,彭勇刚,2016-06-24 11:40:56,-7,7,14,讲的真的是烂到家了，然而单片机又是一门很难靠自学搞懂的课。\n\n\n\n所谓传业受道解惑，连照本宣科都做不到。
28086,2088,彭勇刚,2016-06-28 08:05:25,-4,1,5,挺无聊的不过讲道理本来就是很靠自学的一门课楼上说自学很难的兄弟花点心思准备考试吧哈哈哈
30885,2088,彭勇刚,2016-07-02 22:35:46,1,3,2,还好，就是有时讲得比较快
48207,2088,彭勇刚,2017-03-01 08:05:56,3,5,2,我觉得讲得比较杂比较乱
49242,2088,彭勇刚,2017-03-30 11:15:39,-6,2,8,讲得不是一般的烂
51232,2088,彭勇刚,2017-05-25 00:51:04,3,7,4,离期末还有两周，布置了额外实验 智能车寻迹是什么样的体验
56842,2088,彭勇刚,2017-07-05 00:23:38,0,2,2,老师很有耐心，也很有本领，只是讲课有些无聊，认真学也能拿到不错的成绩。
66346,2088,彭勇刚,2018-01-15 07:55:56,-5,0,5,单片机学习首先要自己有兴趣，其次要多动手，光想听听老师讲就会了那是不可能的。
79706,2088,彭勇刚,2018-06-13 02:35:28,5,6,1,老师课上的蛮仔细的，没耐心听先找找自己的问题好吧~_~ 就是喜欢在课件上画圈圈-_-||
103913,2088,彭勇刚,2019-03-07 07:32:39,9,12,3,当一张PPT画了三次圈圈以后，这张图真的看不清了。
105099,2088,彭勇刚,2019-04-03 14:54:43,4,5,1,讲的很流水账，教材也很烂
105122,2088,彭勇刚,2019-04-04 04:09:00,0,0,0,。。。
113873,2088,彭勇刚,2019-07-07 22:38:23,-1,2,3,上课很详细，讲了许多不考的东西。。。复习时算是没画考试范围（他的考试范围基本就是全书，都是看别的老师画的范围复习）\n\n不过鉴于给分不错，还是给9分
114026,2088,彭勇刚,2019-07-08 11:23:40,1,2,1,老师上课爱画圈圈哈哈哈，是真的。上课很容易睡着，但是当你下定决心去听会发现老师真的讲的特别好，很细致，听完基本就懂了，课后题就可以自己做了。老师是那种科研型的，讲课应该就类似于很直白的给你讲原理，刚开始还挺难的，坚持下去就好了。主要是老师给分好！
122609,2088,彭勇刚,2020-03-07 13:22:59,2,2,0,上课全在画圈圈，画到最后什么也看不懂，课件非要做成ppt形式，一大片一大片的相互遮挡，期末复习还得一下一下划过去，课程内容又多，又不讲重点是什么，还要求课余自学一堆东西，建议这门课的同学这学期少修学分。
123342,2088,彭勇刚,2020-06-04 07:28:18,0,0,0,靠实验和微信文章理解他上课到底讲了些什么
123344,2088,彭勇刚,2020-06-04 07:47:54,0,0,0,您是真的爱拖堂哦
125202,2088,彭勇刚,2020-09-03 13:48:51,2,2,0,来还愿了，谢谢老师给的分，比预想的高。
125212,2088,彭勇刚,2020-09-03 16:57:19,2,2,0,说多不多说少不少吧，打分还行\n\n建议老师来年再开微机的时候别在第二章花那么多时间，更好的应该是在讲完后面之后用第二章来做个回忆总结，要不然那一段纯纯的坐晕车
125288,2088,彭勇刚,2020-09-05 14:10:09,8,8,0,不预习课本，刚开始听微机确实一脸懵逼，上课每一分钟都是煎熬。但是你一旦预习了课本，就会发现彭勇刚讲的不是一般的好，真tm讲的面面俱到，已经不能再详细了，连课本里面没讲清楚的人家都给你讲的明明白白，什么叫搞学术的人，这就是！
133978,2088,彭勇刚,2021-03-11 06:12:15,6,7,1,上的彭老师的微机课，感觉讲课很枯燥。由于是疫情期间上网课，还是中午1点15，听着听着就脸滚键盘了。后来干脆上课时间直接睡午觉，课后再看回放了。考试内容很基础，很多难的地方都没考，比隔壁班好多了。最后差1分满鸡
151396,2088,彭勇刚,2022-03-02 06:32:30,0,0,0,好老师，虽说上课稍微无聊了点，但只要你认真听就会发现讲的真的很好很全面
156133,2088,彭勇刚,2022-06-18 02:00:46,3,3,0,嵌入式，老师上课很负责，知识很丰富，但是好像很喜欢数电和汇编，这些东西大家看着办学，作为拓展，考试掌握c51就够了
157771,2088,彭勇刚,2022-06-24 18:26:32,1,2,1,老师很负责，也真的捞人的，就是这门课太难学了，包含的东西太多了
157780,2088,彭勇刚,2022-06-24 21:27:56,1,1,0,老师讲的很详细
176939,2088,彭勇刚,2023-06-30 22:46:07,1,2,1,爹！！
177003,2088,彭勇刚,2023-07-01 04:45:38,3,3,0,老师很负责，对51和32有自己的理解\n\n不过我还是想不通为什么课间不休息\n\nand老师很喜欢汇编，上课的例程都是汇编，但是这门课考察的主要是C51，所以汇编大概听听好了\n\n最后给分还不错
177296,2088,彭勇刚,2023-07-02 17:48:32,1,1,0,老师讲的很详细但是总是听的想睡觉，后面基本自己看书了，给分很不错，平时作业认真做，期末好好准备满了
194377,2088,彭勇刚,2024-06-23 12:47:25,2,3,1,快逃快逃快逃
194599,2088,彭勇刚,2024-06-24 13:56:04,2,2,0,老师上课讲得挺好的，在讲的过程中会很仔细的讲到所有的细节，包括一些考试不考的部分，可能是因为这门课是控院出题。就是语调比较平，上课可能会比较困，建议听不下去的话课后倍速智云。数电部分讲的很详细，但是实在听不懂推导也没关系，记下来公式概念啥的就行。作业问题基本上就是整理课上讲过的内容，认真完成对课程内容理解挺有帮助的。上课例程基本都会用汇编语言写，控院好像是直接用C语言，个人感觉我在花时间认真理解汇编之后C语言完全不在话下，不会影响考试，而且加深了我对汇编和硬件的理解（就是理解的过程确实有点痛苦）。他会软硬件结合地详细介绍各种引脚的功能，作用过程，软硬件都讲的很详细，电院的配套实验课难度适中，认真完成之后代码编写基本上就不成问题，实验课llx老师人美心善。推荐选课。
195291,2088,彭勇刚,2024-06-27 15:43:24,6,6,0,此处点评自动化的嵌入式系统。老师人还是很好的，也不怎么点名也认真在讲课。但是这门课确实没救了。很多人说抽象，但很少有人说清楚为什么，今天好好说一说，\n\n\n\n嵌入式=数电+电院以前的微机原理+控院的stm32。最后的事实是，pyg老师班上这门课等于数电+微机原理，大量汇编例程，上课很少讲C51例程，stm32两三周结束。控院几乎不涉及汇编，数电要求很低，stm32有大实验。\n\n可以看到非常之割裂。最后的考试，在前几年，大致可以认为是两个学院的交集。主要考8051，而且不要求汇编。stm32看得懂例程就可以，数电很少考。对硬件具体电路要求很低，不过要掌握芯片本身的组成和特点（此处吐槽pyg疯狂涉及电路具体实现看得人想死）。这样的情况下，看wy老师的复习课，抄抄a4还挺好。汇编掌握得好的话看C51完全可以二十分钟速成。\n\n\n\n今年拉了坨大的，数电和电路变多，扩展外接设备也考了……有种命题不再是wy管而是pyg管了一样。真的有点像电院微机原理的试卷。默默祈福\n\n\n\nBTW实验课的llx老师人美心善，十分和蔼。
220743,2088,彭勇刚,2025-06-19 12:45:14,0,0,0,痛苦，完全听不下去
221796,2088,彭勇刚,2025-06-26 09:37:54,0,0,0,老师还不错，只是嵌入式这门课太逆天了，自己没怎么学，一学期都没跟上进度\n\n问老师问题也很细心的回答，很和蔼
221972,2088,彭勇刚,2025-06-28 06:55:10,0,0,0,老师还不错，上课还挺认真，但是是否可以考虑优化一下课程内容？嵌入式和32部分的PPT和授课内容太逆天了，其他部分其实还行。平时分相对其他班级给的也不错。
41,2124,姚缨英,2015-03-14 15:30:48,19,79,60,姚妈最赞\^O^/
195,2124,姚缨英,2015-03-14 16:43:45,2,14,12,负责任、亲切
410,2124,姚缨英,2015-03-15 02:01:23,10,34,24,负责、耐心。她是我评价其它老师的标杆之一。
533,2124,姚缨英,2015-03-15 04:24:33,2,14,12,思路清晰，老师平易近人。
973,2124,姚缨英,2015-03-20 00:02:51,-11,15,26,姚妈的课吧，听着不累，走一会神她还在讲那个地方
1339,2124,姚缨英,2018-06-12 10:21:31,5,42,37,姚妈十分认真负责，深夜还给我们答疑，传课件，改竞答作业，期末给分也是相当高，5.5学分的模电大家基本都上4了…总之是非常好的老师。
1655,2124,姚缨英,2015-03-23 06:38:54,1,10,9,姚妈赛高
6343,2124,姚缨英,2015-07-20 08:13:18,4,16,12,姚妈威武\n\n
9570,2124,姚缨英,2015-11-01 15:59:48,5,21,16,万能的姚妈，佩服！
9902,2124,姚缨英,2015-11-12 14:25:51,5,15,10,姚妈赞的不行，耐心负责，讲题仔细全面，态度亲切，课后认真答疑，非常好的老师。
10570,2124,姚缨英,2015-11-20 03:50:52,5,21,16,亲和，耐心，真的倾注了很多心血
14784,2124,姚缨英,2016-01-09 06:11:39,-3,5,8,
19433,2124,姚缨英,2016-01-24 08:16:04,-2,10,12,教师，教书育人的最高境界。
19436,2124,姚缨英,2016-01-24 08:19:50,1,9,8,姚妈赞
19437,2124,姚缨英,2016-01-24 08:20:00,-3,6,9,老师非常认真负责。超赞。给分也好！
19443,2124,姚缨英,2016-01-24 08:37:08,0,9,9,怎么说呢。很负责，老师最怕的就是对不起学生。感动
19444,2124,姚缨英,2016-01-24 08:38:46,0,11,11,好顶赞('∀')教得很好，而且经常布置课外题扩展思路(自选做不做，做了可加分)因此给分也棒棒哒
20740,2124,姚缨英,2016-01-30 13:57:12,-4,4,8,负责任
23394,2124,姚缨英,2016-03-28 13:46:34,1,5,4,。。。。。
23399,2124,姚缨英,2016-03-29 01:54:37,28,33,5,电网络分析课真的事情太多了
23672,2124,姚缨英,2016-04-12 03:08:19,46,66,20,姚妈所有的课都像复习课，也就是潜意识里你已经能够运用书上的公式。事情极多，喜欢恶竟。优点是对课程有自己的理解。适合听，不宜选
26919,2124,姚缨英,2016-07-07 11:11:37,0,9,9,课可以很水，给分确实很好
28362,2124,姚缨英,2016-06-28 08:40:24,0,5,5,好好的老师，好认真，好负责，好有耐心
28621,2124,姚缨英,2016-06-28 11:06:44,-4,2,6,
28636,2124,姚缨英,2016-06-28 11:21:27,2,9,7,电院最认真的老师了，很负责，为学生花很多时间，虽然有时负担有些重，但是收获很多
29502,2124,姚缨英,2016-06-30 01:49:16,1,6,5,很负责，而且学姚妈的课很锻炼自己的能力。
31401,2124,姚缨英,2016-07-04 00:48:07,0,5,5,赞赞赞负责任讲得好
32939,2124,姚缨英,2016-08-11 09:05:25,5,11,6,不喜欢……讲的没有条理不如自己看书
40682,2124,姚缨英,2017-01-14 09:57:15,0,4,4,好啊啊啊啊啊啊
40766,2124,姚缨英,2017-01-05 10:12:54,-2,1,3,考试有点难
41000,2124,姚缨英,2017-01-07 13:46:22,0,3,3,好好好
42713,2124,姚缨英,2017-01-15 03:23:03,10,10,0,事情多
43265,2124,姚缨英,2017-01-16 05:02:25,1,5,4,姚妈很和蔼很负责任，平时会在QQ群里答疑，就是平时作业有点多
45762,2124,姚缨英,2017-01-20 04:50:58,-2,6,8,真心喜欢姚妈，她给我的感觉很舒服。\n\n有一次上课快睡过去了她说这里比较简单你们要是懂了的话睡一会儿也可以，吓得我立马清醒了←_←。\n\n姚妈妈理论课带了三个班，还带着两个班的实验，很辛苦，但她依旧是全心全意在给每个班付出。姚妈妈眼睛不好，担心她的身体。\n\n平常事情确实是会多，但这也是给了我们很多的平台和资源去学习，而且很多额外的事情姚妈妈并没有强求，所以想提升的去做就好。我个人会比较喜欢这样，虽然临近期末还要做研讨的时候简直爆炸，跨年夜也泡在实验室学习。\n\n最后给分的话，总体上来说姚给分挺好的。
45811,2124,姚缨英,2017-01-20 06:28:56,1,3,2,特别细致，不批评人，跟过最好的老师！~~
48028,2124,姚缨英,2017-02-28 05:30:55,0,2,2,姚妈绝对满分
49582,2124,姚缨英,2017-04-19 10:28:06,3,3,0,实话实说，老师是负责任的，不过很喜欢用加分来搞的大家不得不恶竞，还有就是电网络的事情真的很多
50250,2124,姚缨英,2017-05-02 03:22:23,0,3,3,如沐春风
57237,2124,姚缨英,2017-07-06 05:38:19,-2,1,3,耐心什么的，还有事情多什么的，常态，给分nice是重点！
57678,2124,姚缨英,2017-07-12 07:39:14,-2,1,3,真心好老师，负责，认真，是真的想要提高学生能力，给分又能体谅我们的辛苦，人很nice
59532,2124,姚缨英,2017-09-22 07:03:03,51,57,6,第一个星期的感受：事情是真的多啊啊啊啊啊
59665,2124,姚缨英,2017-09-25 13:11:26,102,114,12,第一个星期的感受，课堂，雨课堂，慕课三管齐下，真的很霸道，随时布置作业，随时打分，随时排名，随时崩溃。上课形式突破了常规了，占用了巨量课堂外的时间。
59720,2124,姚缨英,2017-09-26 07:27:49,63,67,4,事情贼多 平时一不注意就来一个任务 ?
59725,2124,姚缨英,2017-09-26 07:46:18,31,36,5,老师是挺不错的，就是雨课堂和慕课这两个东西太烦了，作业什么的根本不知道做哪里，布置的十分不清楚
59727,2124,姚缨英,2017-09-28 07:28:21,23,28,5,评分为什么这么高
59728,2124,姚缨英,2017-09-26 07:59:45,2,8,6,想起了被高中老师支配的恐惧，屁事多。除了评分高没别的好处...
59763,2124,姚缨英,2017-09-27 01:02:21,32,37,5,见过的最用心的老师，课上的我筋疲力尽
59866,2124,姚缨英,2017-09-28 01:38:33,3,9,6,老师必须打10分，但课前课上课后均体验极差……
60110,2124,姚缨英,2017-10-10 13:17:58,25,27,2,想跟她说一句 我们不只学模电
60151,2124,姚缨英,2017-10-11 13:14:15,1,3,2,。。。
60221,2124,姚缨英,2017-10-14 04:02:09,11,14,3,一年之后的评论：老师确实很负责，也很有耐心。不过或许是我个人的问题，并不是觉得她讲课水平很高，查老师上的评论有点太神了。补充一点，电网络分析课不是很恶竞但事情确实巨多。
60306,2124,姚缨英,2017-10-17 04:35:50,6,10,4,讲的很用心，真的很难，而且班级大佬太多了，第一次作业连班级平均分都没到，雨课堂和摩课超级费时间，不知道最后给分会不会好一点
60328,2124,姚缨英,2017-10-17 11:50:57,0,4,4,姚妈真的是很负责很负责，虽然很demanding，但是这么慈祥和蔼的老师真的让我感觉像妈妈一样，上课讲的也很清晰，大爱姚妈!!
60387,2124,姚缨英,2017-10-18 23:55:09,0,3,3,非常好，认真负责
60738,2124,姚缨英,2017-10-29 06:25:13,-2,6,8,卧槽理论课是她的 实验课也是她的 真的感觉倒八辈子霉了
60987,2124,姚缨英,2017-11-06 12:46:58,0,3,3,老师很好
61864,2124,姚缨英,2017-11-21 10:11:09,0,5,5,看到老师批改的卷子，不知道是谁的整道题概念搞错了才扣了四分，瞬间被老师圈粉。
63402,2124,姚缨英,2017-12-03 04:52:40,8,11,3,姚老师真心好老师，除了事情多，课程难也是课程决定的...\n\n不过姚老师的助教啊...我不欠助教哥钱的，助教哥给分也别跟花钱一样谨慎啊TAT...不多说了，期末教务评价系统见
64674,2124,姚缨英,2017-12-26 07:49:05,2,6,4,确实非常非常负责任。前排预定师生情，走一会神你三节课就报废了，乖乖自学吧，然后整整三节课感受被大佬碾压的恐惧，不说了，自学去了
65222,2124,姚缨英,2018-01-01 09:15:48,4,11,7,姚妈是真的不错，又耐心又负责。但是某助教，呵呵
65962,2124,姚缨英,2018-01-21 03:20:00,2,3,1,许愿期末别挂 ????
66103,2124,姚缨英,2018-01-23 07:46:25,0,3,3,前排，姚老师的模电实验，之前一直嘀咕的“虽然我们事情多，但是我们绩点低啊，虽然我们学分少，但是我们学时多啊”，拿着1.5的学分，上着5.5的课时，却只有0.5的绩点（吐槽隔壁班事情少得多但是绩点却高一些）。刚刚成绩出来了，平时很认真努力的，最后绩点也不错～姚老师辛苦了。真的是浙大最认真负责的老师（虽然事情也真的多），祝身体健康～
66675,2124,姚缨英,2018-01-18 06:50:18,0,3,3,上课是很认真负责的，对学生也非常照顾，称呼学生时还会称呼“您”，但是各种雨课堂，慕课，研讨，事情太多了，课前，课上，课后都很累，想水的建议不要选，然后实验也是她的，一个adlab搞死我了，意义也不大，总的来说还是个很好的老师。最后在说说助教，只有两个字“呵呵”，给分极差，总分五分，题量极大，错一题就扣一分，实验给分也极差。
66696,2124,姚缨英,2018-01-18 10:24:38,19,19,0,助教小哥哥给分超棒哦 模电实验报告动不动给你3.5哦
68440,2124,姚缨英,2018-01-23 08:11:56,0,2,2,实验高过均绩，但还是想哭
69690,2124,姚缨英,2018-01-25 08:23:38,0,3,3,我打9分，10分给姚妈，-1分给助教
70456,2124,姚缨英,2018-01-26 15:56:15,18,19,1,蓝色天空中的微笑，大雨瓢泼似的课堂
70532,2124,姚缨英,2018-01-27 00:56:14,1,4,3,老师真的很和蔼负责，就说一点，不知道大家以前或是之后遇不遇得到“你们觉得需要什么时候答疑，答疑到几点”的老师。尽管一开始理论课有雨课堂，有网课视频，还有网上小测。很占用时间还很令人焦虑，（网课视频这个制度听上去也很制仗）不过事实上...（可能这一点我代表不了所有上课的同学）到了后面没有雨课堂的时候我反而觉得不适应了ˊ_>ˋ因为以前可以通过雨课堂预习一次，后来没有了，又会有些跟不上（还是自己没养成预习习惯）魔法电路本来就很花时间的呀…一开始给我们这种压力好像也很正常。\n\n至于实验课（也是理论课的）助教哥...humm，的确给分比较低，人也比较任性(´･_･`)不过，他每次给你打低分你去问他为什么，他总是会给你合理的解释的，比较不爽的只是“这么点问题就扣掉1/5的分”这一点。不过不用担心的...从我个人的实验课成绩来看，老师确实是不会按助教给的分数来作为最后评定的，只是相对排名保持不变。
71556,2124,姚缨英,2018-01-28 15:26:31,0,2,2,姚妈真的很赞，很认真负责，虽然任务有点多吧，修了她的电原和模电实验，雨课堂和慕课双管齐下真的有点爆炸，不过后来用的不多啦，不科学的地方老师也调整了平时分占比。最后说一句，助教真的很过分，脑子堪忧。
71715,2124,姚缨英,2018-01-29 01:39:25,-8,1,9,老师真的很好，真的很好，带着病给我们答疑。事情确实很多，我一学期积攒的怨念全都在答疑的时候一次性清空了。最后给分虽不是太好，4.5也是不错的，毕竟期末感觉做的不是很好。说到底老师真的是大学里你很少能见到的好老师。至于助教。。。。
74629,2124,姚缨英,2018-03-05 01:50:21,-5,1,6,助教非常负责，给分很有原则，人格也很高尚，选到了真的很赞呢~
75692,2124,姚缨英,2018-03-15 07:14:27,16,17,1,感觉很乱\n\n
75765,2124,姚缨英,2018-03-17 01:45:44,48,59,11,这个老师真的会讲课么？打高分的都是怎么想的?见过的最差的电院老师，没有之一。不管理论课还是实验课逻辑都很差，这里点一下那里点一下，以为在开教学组会?PPT上有什么自己都不知道还敢讲课？
75940,2124,姚缨英,2018-03-22 09:15:42,46,47,1,上她的模电实验咋就这么累呢。。。
76512,2124,姚缨英,2018-04-12 02:48:32,30,35,5,她的电路实验是我这学期体验最差的一门课，感觉讲的特别不清楚
76975,2124,姚缨英,2018-04-27 02:11:44,25,27,2,姚缨英，要嘤嘤？\n\n一支穿嘤箭，千嘤万马来相见
77860,2124,姚缨英,2018-05-08 08:30:02,-13,2,15,姚妈人很好啊，认真负责，讲的非常清楚
77938,2124,姚缨英,2018-05-08 17:13:44,25,27,2,mad，都是怎么评出来的?
78340,2124,姚缨英,2018-05-11 03:14:06,26,28,2,事情真的多，给分我觉得超级一般，不说了，哭去了
78345,2124,姚缨英,2018-05-11 23:51:20,26,29,3,非爱班同学慎选她的课，给分不好，问问题也不是很热心。
79147,2124,姚缨英,2018-05-24 06:07:20,-4,6,10,老师比较有耐心，电网络感觉事情不是特别多，讲课感觉有点乱。。。
82530,2124,姚缨英,2018-07-08 12:09:24,11,12,1,事情多，给分也很一般吧，没有感觉到有魅力的点
83767,2124,姚缨英,2018-07-11 07:46:14,-5,5,10,工磁来评.其实就想回应一下前面有同学讲的东点一下西点一下，其实我认为姚老师还是有着自己的教学考量的。不管是上它的模电，还是电网络，还是工磁，都会发现听她的课要比其他老师更累，因为确实她讲了很多不考的东西，但是只要上课认真听了，课后及时巩固了，在最后期末统筹复习的时候 会发现着一些知识点其实已经被串在一起了。大学本身更多靠得是自己，我认为姚老师在老师这一角色上已经做到很辛苦了，所以也希望大家如果选上姚老师的课都能够快速适应其上课模式~
87569,2124,姚缨英,2018-10-07 05:55:51,28,28,0,那一天，人们又想起了被雨课堂支配的恐惧
90856,2124,姚缨英,2018-11-26 15:47:38,10,10,0,感觉一般
91007,2124,姚缨英,2018-11-29 01:12:31,13,13,0,概念不强
92294,2124,姚缨英,2018-12-27 13:43:39,-19,2,21,一开始真的很烦，但是约上越感受到姚妈的好。真的良心好老师，特别特别负责，喜欢姚妈！
93306,2124,姚缨英,2019-01-09 02:44:49,7,7,0,事情多
95158,2124,姚缨英,2019-01-19 02:27:13,25,25,0,模电实验差到无法用语言形容
97305,2124,姚缨英,2019-01-22 07:57:45,6,8,2,讲课偏向解题，没有很好地为同学们建立相应的概念（有一部分原因是教材不行）
99924,2124,姚缨英,2019-01-25 09:55:38,-3,6,9,姚妈人很好，讲课超级细心，非常温油！而且还很体谅学生，感觉她真的是尽力在让我们掌握模电的知识了\n\nbut！给分有点一言难尽，秋学期有慕课，雨课堂，还有线下作业，真的是模电天天见……而且一定一定要听清楚绩点占比是怎么搞的，慕课上的视频是要计入成绩的……雨课堂写预习作业也是计入的……各位不要做漏了……（我啥也没课，平时分低的可怕ರ_ರ \n\n
103082,2124,姚缨英,2019-06-11 05:54:19,12,14,2,实验课不让提早下课，中途还会突然加一个任务，实验要求说的也不是很清楚，鹅颈较严重。anyway，老师人还是很好的
104105,2124,姚缨英,2019-03-12 04:25:32,13,13,0,不知道前面打高分的什么情况，只知道这老师实验课完全没有重点没有章法的讲，实验任务也不清晰，根本不知道在说什么，莫名其妙加一大堆任务，如果不拖堂她就不舒服
105040,2124,姚缨英,2019-04-03 00:49:05,4,4,0,雨课堂与天空中的微笑
105140,2124,姚缨英,2019-04-04 08:49:37,6,6,0,永远不知道她布置了什么任务
105957,2124,姚缨英,2019-05-04 08:01:03,0,1,1,还好吧
106375,2124,姚缨英,2019-04-26 23:35:44,4,6,2,先讲优点，老师慈祥温柔，问题目时耐心解答，喜欢出难题考验大家，会有很多课外任务，但初心还是为了锻炼同学们的能力。再讲不足，姚妈不太擅长清晰完整地讲课，虽然讲课的框架在那里，但是总让人觉得很乱，有时候PPT上的题目也读不懂怎么解答的以及条件是什么。总而言之，姚妈是个好老师。
108806,2124,姚缨英,2019-06-03 00:29:07,-4,0,4,她的工磁讲得很好，慕课不怪她，她也不想让大家做，学校安排的。人是真的好，只是我太菜，上课只能听懂一半
109455,2124,姚缨英,2019-06-20 07:27:56,1,2,1,辣鸡！天天拖堂
110071,2124,姚缨英,2019-06-22 07:09:20,1,2,1,老师人很好的，就是教的差，电磁波就是没听懂过?
113261,2124,姚缨英,2019-07-06 03:12:45,0,1,1,给分挺不错的\n\n
113470,2124,姚缨英,2019-07-06 17:49:01,-2,0,2,作业和实验报告全a平时分为什么没满啊（30分平时分扣了3分左右）
113668,2124,姚缨英,2019-07-07 02:54:34,0,4,4,工磁作为一个数学物理基础要求较高、难度较大的课程，就应该把它的魅力向大家全面地展示，把难点遮住了，还有什么意思。其实以后出卷子，稍难一些没关系，大部分同学做不出来结果，也没关系。只有让你在学习的过程中碰碰硬，不妨弄一个对称一些的边值问题，解一个分离变量，哪怕是解一个常微分方程，其实都很有意义。只考概念，那还有什么意思，完全是助长大家平时水水过然后考前背书，学的多的不如背的准的，还给大家“调分”，真是有些愧对去年超级难答的偏微期末了。
114001,2124,姚缨英,2019-07-08 07:36:36,0,0,0,不是很合适
116329,2124,姚缨英,2019-09-08 11:04:10,2,2,0,学学熊素铭！
116360,2124,姚缨英,2019-09-09 14:15:32,0,0,0,wwwwww
117022,2124,姚缨英,2019-09-18 11:02:19,4,4,0,事情真的太多。要求你随时关注慕课雨课堂，她的课占用的时间至少是其他课程的两倍
117089,2124,姚缨英,2019-09-19 05:38:40,7,7,0,不太喜欢嘤嘤嘤的上课方式，麻烦+麻烦+麻烦，不合理+不合理+不合理
117228,2124,姚缨英,2019-09-20 15:48:21,9,9,0,上课讲得……还过得去吧，但是是真的麻烦，最后祝雨课堂服务器早日瘫痪
117320,2124,姚缨英,2019-09-23 02:28:50,9,9,0,不会上课 不讲知识就让同学讲题 那我为什么要来上课？？？？？？？
117335,2124,姚缨英,2019-09-23 04:33:43,7,7,0,我选的怕不是电路习题课？老师你打得不错，我真是活久见
117339,2124,姚缨英,2019-09-23 05:20:42,13,13,0,我们来回顾一下定理\n\n咳咳咳咳\n\n新课当习题课讲的高端玩家
117350,2124,姚缨英,2019-09-23 07:26:27,8,8,0,雨课堂就不说了。。。。讲课是真的逻辑混乱\n\n
117500,2124,姚缨英,2019-09-25 06:14:29,11,11,0,不会教书就不要教，喜欢做题就多做点
117578,2124,姚缨英,2019-09-26 07:28:08,4,6,2,全都自学就可以了，很简单的
117583,2124,姚缨英,2019-09-26 08:08:28,6,6,0,学习方式自由度太低，有种被人牵着鼻子走的感觉。希望线上内容少一点，真的是浪费时间。
117737,2124,姚缨英,2019-09-30 03:47:24,4,4,0,真的难受，这是我在浙大上的上的最心累的一门课。上课的知识点讲的很少新课变成习题课。全部需要课下看视频自学，巨占时间
117963,2124,姚缨英,2019-10-17 03:17:57,4,4,0,每次都浪费大量课后时间，又是雨课堂又是慕课，上课也不知道在讲什么，实验课完全脱离书本，实验报告写起来完全靠自学，课件也乱成一团，实验报告都不知道从哪着手。评分居然还有按照报告提交早晚来评分，那实验提早做完的人直接满分算了好吗？
117986,2124,姚缨英,2019-10-17 16:37:18,10,11,1,很痛心之前的姚妈变成这样了啊，不知道什么原因。上了这么久的课了，客观来讲，适应节奏后嘤嘤的课还是基本上能听的，但是一定要集中注意力，除非提前做好了预习，否则短暂的走神就会彻底掉线。嘤嘤每次在雨课堂上留的作业题也是很好的（虽然错误比较多）。不知道是不是赶进度的原因，嘤嘤在课堂上介绍一个新知识点时总讲的很快，还没来得及理解就开始讲后面的例题了，所以一定要保持头脑清醒。作为非常重要的一门大课，我个人认为还是尽量不要受到嘤嘤带来的不良影响，自己多想办法，不管是自学还是翘课听别的老师讲，这门课都还是得学好的。课选都选了，抱怨解决不了事情。顺祝各位学习愉快。
118029,2124,姚缨英,2019-10-19 03:48:39,2,2,0,太不友好了
118658,2124,姚缨英,2019-10-30 06:10:45,7,8,1,遭咯！！！\n\n新课上成复习课\n\n复习课上成绪论课
119323,2124,姚缨英,2019-11-12 05:39:08,7,8,1,花里胡哨的东西一大堆，不明白好好上个课整这么多东西有什么用
120973,2124,姚缨英,2020-01-19 06:06:38,1,4,3,虽然线上线下教学模式有些麻烦而且会让同学们感到不太适应，但是不得不说姚老师的课上得还是很棒的。另外，老师课后会很负责地解答同学的问题，而且最后给分也挺公正的。
122448,2124,姚缨英,2020-02-28 03:44:23,5,5,0,麻烦，事多，讲课快
122747,2124,姚缨英,2020-03-30 06:06:25,1,2,1,感觉讲的有点凌乱，不过预习后再听还好。
124293,2124,姚缨英,2020-06-29 00:12:53,0,2,2,打了一个九分，有一说一老师事情确实很多，但是像我这种理论课不是特别爱学的，她准备的这些东西很大程度上实验课等于给我补习了，确实存在有的同学做更详细的实验任务来博取老师的关注与认可的情况，但是像我这种实验只做基本的，实验报告当天就凑合写出来的也给了一个不错的成绩，可能这种老师比较适合我这种不上进的学生叭，dl们更喜欢自己安排学习时间，花在更有用的地方
126712,2124,姚缨英,2020-10-15 01:48:47,7,7,0,事情贼多，弄得一个学期被模电搞得晕头转向，两节课从来都是理所应当的上三节，而且还常拖堂，进度上的贼快，不是dl还是不要选她的课，上的糟心
127177,2124,姚缨英,2020-11-12 02:40:38,10,11,1,你若问电气卷王是如何诞生的？就来上她的课吧
127184,2124,姚缨英,2020-11-12 06:17:36,5,5,0,研讨，雨课堂，讨论，就不能整点阳间的东西，laji老师
128089,2124,姚缨英,2020-12-07 05:42:21,10,12,2,傻逼老师，鹅颈之母
131976,2124,姚缨英,2021-01-30 00:52:04,1,3,2,给分不错，就是事情比较多，最后只能说是付出与回报相抵，毕竟干了那么多，给个好分也是应该的。
132029,2124,姚缨英,2021-01-30 03:31:56,0,2,2,老师讲课很清楚，平时也很和蔼，虽然事情布置的比较多，但是好好做的话确实能学到很多。给分挺好的。
132175,2124,姚缨英,2021-01-31 00:33:16,0,3,3,老师事情是真的有点多，但上课准备是充分的，还会帮你罗列、回顾知识点，而且是真的会听同学们的意见，如果大家平时时间比较多的话，还是可以选的
135287,2124,姚缨英,2021-05-07 14:40:20,-8,4,12,给分很好，电网络满绩了，哈哈哈哈哈哈
141569,2124,姚缨英,2021-10-15 02:16:31,4,5,1,上课完全跟不上，新课就不怎么讲知识点，默认你什么都会，体验极差
143353,2124,姚缨英,2021-11-24 02:37:32,4,5,1,感觉上课讲不清楚orz
143950,2124,姚缨英,2021-12-14 02:49:47,3,4,1,天天上课就做题，5.5学分的课上到6分还说自己上不完 上不完就不要讲这么多废话。
145448,2124,姚缨英,2021-12-29 15:56:48,-11,2,13,上的是姚妈的模电……一个班只有二十个人。姚妈真的人超好，ppt和雨课堂感觉边听边做还是很有效果的。本人也很和蔼，会跟同学们谈笑，课程压力也不是很大……考前选课的时候看到姚妈的课老是没人选感觉好难过……大家一定要选！
145840,2124,姚缨英,2022-01-03 08:20:37,16,18,2,我++了，真不想骂人，怎么会有屁事这么多的老师啊。课前又雨课堂预习又学在浙大测试，课后还要学在浙大测试还要学在浙大讨论。 一个b实验课踏马这么多事，实验课也不按着理论课的进度来，上课做啥根本不懂，一顿乱弄，实验报告也瞎写。
147651,2124,姚缨英,2022-01-10 10:58:02,3,4,1,真的很认真负责！虽然事情有点多但是很认真解答所有问题
147653,2124,姚缨英,2022-01-10 11:00:40,3,5,2,上的是姚老师的模电实验，任何时候钉钉找她都会很快的回！上课做不出来也可以随时找她，她每节课都在很忙的帮各个同学看实验台hhh虽然模电实验很难，老师事情相对有点多，但是人真的特别好！！！
147698,2124,姚缨英,2022-01-10 13:33:35,1,2,1,模电实验真的很难，事情也好多，但是是课程原因！老师超负责！
147815,2124,姚缨英,2022-01-11 02:34:14,1,3,2,老师温温柔柔的，课前一定要看好评分标准按要求完成任务，虽然课程真的很累但是结束以后会觉得很有成就感！
147816,2124,姚缨英,2022-01-11 02:40:01,0,2,2,姚老师的课程事儿有点多，但是还是很有收获的！如果问老师问题也会很认真很快的回答，人好好！
151267,2124,姚缨英,2022-02-27 06:26:27,1,1,0,她的课都很难
151513,2124,姚缨英,2022-03-06 12:21:01,1,2,1,姚妈——————最最最最最负责人的老师，事情很多，但是给分真的很好，你努力与回报是成正比的！
152176,2124,姚缨英,2022-03-29 12:02:32,0,2,2,事真TM多，雨课堂，mook测试，等等等等，层出不穷，但上课很认真很用心也很有耐心，真心想学知识的来！
154184,2124,姚缨英,2022-05-25 10:07:47,0,0,0,感谢姚老师帮我调试电路板
154481,2124,姚缨英,2022-06-02 01:25:14,1,1,0,。。。
160256,2124,姚缨英,2022-09-16 02:24:52,0,1,1,姚老师真的很细心，会考虑学生的情况，基础差些也完全没有问题。
163674,2124,姚缨英,2022-12-16 02:34:39,4,7,3,如果我有罪，请惩罚我，而不是让我上Yyy的课
165074,2124,姚缨英,2022-12-29 03:55:27,21,22,1,模电实验期末问卷：\n\n本学期我们班上课以及做实验的时间是其他平行班的两倍，虽然很累，但是我觉得收获与与付出是成正比的，有所值（非常不同意 不同意 一般 同意 非常同意）\n\n老师很有耐心，但是经常答非所问，事情巨多，布置任务也朝令夕改、含糊不清，期末考试不仅要线上理论题+仿真设计题，还要开学回学校实操，真特么无语，1.5学分180块钱就能上这一学期的课算是大赚特赚了
169013,2124,姚缨英,2023-02-24 03:46:30,7,7,0,事情贼多，给人一种凌乱的感觉
169849,2124,姚缨英,2023-02-28 06:13:14,2,4,2,给分真的很好啊姚妈，是个很可爱且认真负责的老师
170402,2124,姚缨英,2023-03-03 23:45:14,1,3,2,哈哈，电路与模拟电子技术实验五级制
170626,2124,姚缨英,2023-03-07 09:32:00,-1,0,1,姚老师人很好，对学生也很有耐心，认真负责，想要学生学好。但老师的模电实验比着其他平行班确实事情比较多，要求比较高，而且有的时候任务布置的不是很清楚，不过也不至于说特别混乱。
171861,2124,姚缨英,2023-04-08 08:34:38,7,8,1,事情太多，平时作业就是为了发现错误来改正用的，弄那么多细枝末节的东西打分影响总评，实在是大可不必
172796,2124,姚缨英,2023-05-07 08:44:35,7,7,0,这模电实验工作量是其他班两倍是我不能接受的
179652,2124,姚缨英,2023-09-19 05:47:46,2,2,0,先保个底
180742,2124,姚缨英,2023-09-25 14:51:28,2,2,0,。。。
180785,2124,姚缨英,2023-09-26 07:25:06,1,4,3,很好，分期付
184235,2124,姚缨英,2023-12-13 13:57:22,3,5,2,姚老师人真的很好，很关心学生，在群里会耐心解答，提醒你有问题一定要及时问！希望自己模电能有一个满意的成绩～
185861,2124,姚缨英,2024-01-05 04:06:06,4,13,9,您老到底学没学过语文？？在群里发的文字内容自己不会读一读？语言表达能力一言难尽。。。不知道是我没学会说话，还是您的交流方式太过高深。实验课明明理论学过那么多非要做理论课没学过的实验，还要先自学理论做仿真，如果我有罪，请让法律惩罚我，而不是上yyy的电路课，做yyy的电路实验，写yyy的实验报告，看yyy编的辣鸡电路书（电路书也是胡言乱语）
185919,2124,姚缨英,2024-01-06 04:45:38,5,6,1,十几年前电院“卷”的风气开始盛行的主要始作俑者，尤其是各种附加任务和要求，懂的都懂
187202,2124,姚缨英,2024-01-15 04:41:25,1,2,1,模电实验还是慎选吧。。。学银上的作业真的很没必要。。。
189773,2124,姚缨英,2024-01-28 14:35:33,3,3,0,横向对比事情有点多，但感觉模电实验这门课本身就很烂。。。\n\n五级制纯纯鼓励鹅颈\n\n\n\n上课指导还可以，就是作业太多了
189991,2124,姚缨英,2024-02-06 15:10:42,1,2,1,老实说老师上课很上心的，就是任务量实在实在太多了，不过老师人很好基本不给挂科，最后还在大群劝我们大三到玉泉重修很麻烦不要放弃，基本上不会挂你
191836,2124,姚缨英,2024-05-01 12:06:05,2,2,0,好！！！
191924,2124,姚缨英,2024-05-05 10:37:59,3,4,1,姚妈！谢谢你
196040,2124,姚缨英,2024-07-01 08:46:58,3,4,1,姚妈！！谢谢您工磁的教诲
199511,2124,姚缨英,2024-09-25 01:16:21,2,2,0,事多，而且讲完原理就默认你会做题了
199947,2124,姚缨英,2024-10-09 05:47:24,6,8,2,听她讲模电课还不如自己学，她讲新课搞得像我们已经学过似的，很模糊。好，你想自己学是吧，她整个*雨课堂，逼得你不得不去，不得不听，完美，无懈可击
203429,2124,姚缨英,2024-11-19 13:31:39,5,5,0,天杀的预习报告，老师也知道这是超出学生能力范围的，那为什么还要布置呢，是布置给领导看，还是减少课上自己的工作量呢，预习报告一知半解，实验操作一知半解，实验结果还是一知半解，我是真菜不是，我寻思我模电学的也比均绩高很多啊，真崩溃了
205364,2124,姚缨英,2024-12-05 06:12:15,4,7,3,不敢恭维
208086,2124,姚缨英,2024-12-25 13:48:15,3,6,3,傻逼，讲课一坨，事真多，给分感觉也不会好的，别选
209829,2124,姚缨英,2025-01-07 07:54:54,1,3,2,上过姚老师的课，事情确实有点多hh，给分上感觉自己最后是被捞了的
209930,2124,姚缨英,2025-01-12 01:34:49,0,5,5,卡绩，完全不捞；\n\n钉钉已读不回，回答问题也不及时；\n\n喜欢签到，点名小子；\n\n上课依托，语言组织能力为零；\n\n还鼓励恶竞\n\n摊上这个傻逼玩意这辈子有了，可惜狗比东西退休了，祝您明年吃席哈
211536,2124,姚缨英,2025-01-12 01:28:30,5,6,1,不知道是讨厌模电还是讨厌姚缨英，也可能是两个都让人讨厌
211560,2124,姚缨英,2025-01-12 02:27:22,-1,3,4,24-25秋冬，只能说伟大无需多言！！！\n\n模电这个课确实知识非常繁杂，yyy老师的课件可能初学的时候觉得有点乱看不懂，但是复习的时候强烈推荐过一遍，覆盖了绝大部分考点\n\n给分好的让我惭愧！！！
211585,2124,姚缨英,2025-01-12 03:21:40,0,3,3,选课时看到老师的评价是任务量多，一学期结束感觉任务量可以接受。每周作业会稍微多几题；饱受诟病的雨课堂是课上做的练习，总共只占2分；研讨在秋学期和冬学期各一次，秋学期是小组合作讲题，尽量多投稿几次，冬学期的研讨难一些，是有难度的征解题，建议早点准备。听说《电路与模拟电子技术》期中期末是老师自己改卷，姚老师改卷是比较松的，会看你有没有掌握原理，计算错误扣分很少，感觉也是会捞捞的。关于表达不清晰的问题，我个人感觉没有受到很大的影响，但有时的确不知道老师的意思。而且老师真的很负责任，去问她题目很温柔地跟你讲，还会约课外时间答疑。总的来说是推荐学弟学妹选姚老师的，老师没有其他评论说的那么可怕~
211594,2124,姚缨英,2025-01-12 03:34:36,3,4,1,事多分少，讲课一坨，卡绩不捞
212118,2124,姚缨英,2025-01-13 08:15:01,2,5,3,上课体验确实不太好，经常性的点名以及随堂小测题（雨课堂），以及研讨环节和小组讲题的环节，总之事较多较杂。\n\n另外，老师上课节奏较快，上课前一定要预习，不然几分钟走神包听不懂的，这个节奏适合接受能力较强的同学，如果上课都能听明白那其实非常厉害。\n\n我本人感觉老师可能捞了一下的，这个具体捞不捞也不清楚。\n\n我们的成绩组成是：2%雨课堂（排名前面的会直接赋满）20%线上（上半学期下半学期各占十分，其中每半个学期的十分里有5分线上考试，5分几次的小测加起来） 28%期中 38%期末 4%作业 8%研讨\n\n模电基本上还是以考试为主，线上部分只要你认真做基本上能满（但是有时候答案有问题），作业研讨也基本上给满了。\n\n建议平时一定要下来弄懂上课不懂的，不然做作业就是很痛苦的。。。
213447,2124,姚缨英,2025-01-17 12:05:16,3,3,0,非常好雨课堂，使我一节课也不敢旷
213921,2124,姚缨英,2025-01-21 10:48:27,1,1,0,助教和你至少有一个是**
216646,2124,姚缨英,2025-03-20 04:06:11,5,5,0,来工磁代课最后一分钟雷达点名😅y3真有你的
218711,2124,姚缨英,2025-04-29 10:48:25,2,2,0,人是挺好的，为学生着想，就是事情有点多，守序邪恶嘛，哈哈。听说老师明年就要退休了，还是来改个高分，感谢付出。
219284,2124,姚缨英,2025-05-24 07:19:22,0,0,0,老师退休啦，但退休前的最后一舞电网络分析给分真的很好，上课速度确实有点快，但态度和讲的还都是很好的
15130,2159,辛焕海,2016-01-12 07:04:20,1,3,2,好好好
25760,2159,辛焕海,2016-06-07 07:32:45,15,23,8,适合研究上通识，但不适合上一门要考试的课
26342,2159,辛焕海,2016-06-17 04:04:09,4,5,1,讲课不为考试的好老师
27269,2159,辛焕海,2016-06-24 09:30:05,3,3,0,真才实学，不为考试
29976,2159,辛焕海,2018-04-18 06:43:34,9,11,2,易筋经的收敛性非常好。。。
31272,2159,辛焕海,2016-07-03 13:55:00,6,6,0,老师数学非常好，上课讲的比较大，不太适合考试，但思维不错
51332,2159,辛焕海,2017-06-01 00:41:41,1,1,0,我还以为是王成波
52308,2159,辛焕海,2017-06-18 07:55:08,4,4,0,易筋经集大成者
54974,2159,辛焕海,2017-06-30 13:54:50,4,6,2,讲道理⋯⋯复习得我想骂人
57268,2159,辛焕海,2017-07-06 10:13:16,-1,3,4,给分好
57269,2159,辛焕海,2017-07-06 10:15:20,-2,2,4,给分高\n\n
57285,2159,辛焕海,2017-07-06 10:55:23,-23,3,26,老师给分简直好炸了呀，讲课听不懂是因为这门课本来就是要记很多公式，老师把公式的主要目的和产生背景讲出来就很不错啦，但给分是真心好哇，感觉好多大题都没有写出来还有4.5?自己学院老师果然是亲生的!
57324,2159,辛焕海,2017-07-06 15:56:04,0,2,2,又一个85。。。我就求多给一分就那么难吗
57690,2159,辛焕海,2017-07-12 14:15:29,0,0,0,希望楼下说说考试范围
78661,2159,辛焕海,2018-05-14 14:41:03,-21,5,26,\n\n复习一定要看郑太英老师的ppt！因为试卷是郑老师出的。但是辛老师和助教给分是真的好，满绩美滋滋
78683,2159,辛焕海,2018-05-14 12:16:17,3,5,2,老师讲的很好，最后考试考的都是比较简单的几个公式，白记了龙格库塔阿达姆斯balabala，老师和助教给分很好。上课认真听的话收获会很多（千万不要像我一样考前才开始预习，全是泪）
78685,2159,辛焕海,2018-05-14 12:36:25,9,10,1,呜呜呜，复习好辛苦，成绩未达理想值，那个说好多大题没写出来还有4.5的，我觉得有误导嫌疑
78697,2159,辛焕海,2018-05-14 14:09:24,4,6,2,看见很多同学出成绩后第一时间也都过来评价了。成绩没有达到理想值，老师平时讲课比较大，内容比较多，但是考试范围要比老师讲的少，因为郑太英老师教学班的内容要少一些。复习如果时间紧张建议问隔壁教学班考试内容。平时多听老师的课还是受益颇多的，一位有情怀的老师。
79860,2159,辛焕海,2018-06-14 12:09:15,1,1,0,点名。考试的老师一定会讲，但除考试外讲得太多了。考试大家不用担心不算难，而且老师会有调分，考前努力多学多背。重点：公式一定认真背啊！！！
105991,2159,辛焕海,2019-04-24 05:09:17,6,6,0,考的很简单，稍微复杂一点的都没考，大家千万别慌，稳住
106377,2159,辛焕海,2019-04-26 23:39:15,3,4,1,我希望你们把计算方法学好，而不是把计算方法考好（当然考好也重要啦）
106740,2159,辛焕海,2019-04-29 07:30:02,1,2,1,怎么还没出分...
107863,2159,辛焕海,2019-05-10 12:48:28,0,1,1,老师很好，给分也挺好
108807,2159,辛焕海,2019-06-03 00:51:21,2,2,0,讲的很大而宽泛，不讲例题，说实话上的和通识课一样，不适合一门需要考试的课程。\n\n不过期末考试较简单，需要去隔壁郑太英老师班问考试范围。\n\n学习比较认真的建议选择郑太英老师。\n\n
110045,2159,辛焕海,2019-06-21 16:00:17,1,1,0,唯一一次点名，因为翘课的人太多了，然后本主翘课就被抓了哈哈！不过老师其实挺佛的，这门课复习参考隔壁郑太英的课件，听课可以来这里听一听，权当放松吧
125098,2159,辛焕海,2020-08-31 07:17:29,4,4,0,讲课重点讲考试不考的东西，因为老师认为只有这样同学们才能真正学会计算方法。\n\n建议去听隔壁郑太英老师的课，不然期末连怎么复习都不懂。
145014,2159,辛焕海,2021-12-26 13:22:24,1,1,0,老师讲课稍微讲的有点广不怎么抓重点，另外一般在群里永不说话，甚至有位同学在群里@过他，他也并没有回答。
151269,2159,辛焕海,2022-02-27 06:46:02,1,1,0,讲课富有哲理，内容远多于考试范围。最后一节课上说考试很简单。
172231,2159,辛焕海,2023-04-23 06:08:47,0,0,0,刚考完，希望老师捞捞
172393,2159,辛焕海,2023-04-26 03:48:28,1,1,0,现在不讲易筋经了，改讲不忘初心了\n\n讲得非常好，对计算方法很有理解\n\n经常提示我们未来计算方法需要应用创新\n\n🔌需要这样的老师\n\n考试么确实没大纲，但zty的班也就在隔壁\n\n考试是自己的事情
198366,2159,辛焕海,2024-09-08 05:24:43,2,3,1,非常好👌
199461,2159,辛焕海,2024-09-24 04:55:17,0,1,1,好老师，经费特别多，快来
218184,2159,辛焕海,2025-04-22 02:46:56,2,2,0,上课讲得不太行，但给分超好，还不点名
218193,2159,辛焕海,2025-04-22 03:23:20,3,3,0,不点名，给分无敌，期末对着隔壁zty的ppt复习好好背公式就行
218219,2159,辛焕海,2025-04-22 06:03:01,1,1,0,复习看zty老师的视频和课件就行，给分超好的！
218254,2159,辛焕海,2025-04-22 08:29:35,0,0,0,理想中的好老师，学术有造诣，讲课有水平（讲课和考试不太契合是事实，如果对这门课兴趣不大只是面向考试的话建议听隔壁zty）\n\n\n\n完全不用签到小测这些为难学生\n\n\n\n一个学期不点名，只有4次作业，3个实验报告；全部都会给满分\n\n\n\n最后考试考高一点就行了，老师给分也超级好
218469,2159,辛焕海,2025-04-24 02:28:03,0,0,0,不点名，作业少，给分好，上课内容和考试内容结合不算紧密，可以考虑不听，考试完全可以快速过一遍隔壁的智云或者ppt
220792,2159,辛焕海,2025-06-19 18:10:45,1,1,0,补个评价：24年上的，点过一次名，一个个读名字点的。然后计算方法这门课就纯背了，背的下来，分数就不会差，考场还很考验按计算器的手速，当时最后道题没咋来得及算（结合了一个电路图），但是最后给分还是非常不错的。\n\n然后个人认为老师还是很有思想的，上他的课也可以学到很多课程之外的东西，扩展的内容也不少，老师也是走在科研前线的（还是电机系主任吧）
57004,2179,邓焰,2017-07-05 06:37:56,2,15,13,问点问题爱搭不理，这也就算了，点名都到了，实验选做都做了，考试题目也都找到答出来了，然后70+，开玩笑呢？
57522,2179,邓焰,2017-07-09 09:06:23,0,8,8,给分极差 人很不好 实验繁多 考试巨难 无发刻说
87470,2179,邓焰,2018-09-29 07:15:07,1,15,14,孤儿老师，垃圾的一批，给分巨差，电院最垃圾的老师之一
103919,2179,邓焰,2019-03-07 08:31:19,1,7,6,大放厥词，respect三连。
105276,2179,邓焰,2019-04-09 03:04:16,43,48,5,重点是这课的实验老师叫陈宏，铁孤儿，自行查老师。不是电信专业的千万别选，后悔到死。
105524,2179,邓焰,2019-04-16 03:50:27,22,27,5,千万别选这门课，实验老师是陈宏，实验课浪费时间，浪费生命，还会让你感觉生不如死，真的垃圾
105771,2179,邓焰,2019-04-20 08:47:06,18,19,1,重点是这课的实验老师叫陈宏，铁孤儿，自行查老师。不是电信专业的千万别选，后悔到死。
105805,2179,邓焰,2019-04-21 02:05:53,13,16,3,讲课挺好的，实验呵呵
107452,2179,邓焰,2019-05-05 09:07:40,14,25,11,好老师，知识广博
107456,2179,邓焰,2019-05-05 09:31:06,5,15,10,我觉得挺好的
107464,2179,邓焰,2019-05-05 10:24:25,2,19,17,我觉得老师还是比较儒雅随和的一个人，助教人也挺好，给分也算公允
125803,2179,邓焰,2020-09-14 11:02:36,1,9,8,做人要堂堂正正，不要做枭小之人
127993,2179,邓焰,2020-12-02 12:38:26,1,3,2,大三，自动化专业。上了电子信息新技术讲座这门课，主要是修个性学分。上课要求就是听讲座，做随堂作业，很少写报告。任务不多但都按要求做了，给分3.9。。。问了问其他几个同专业选这个课的大三同学基本上都是3.9。。。给分真的不好，课上点名的时候我看很多人都不去上课呢。。真不知道那4.2几的平均绩点怎么来的。水坑，又水又坑。
134264,2179,邓焰,2021-03-22 00:15:41,9,15,6,傻B玩意儿，卷你妈呢，阴阳怪气有一套哈
134965,2179,邓焰,2021-04-25 09:01:14,2,8,6,阴阳怪气，出尔反尔，电院最官僚最没水平又最自以为是的老师。
135530,2179,邓焰,2021-05-12 12:49:46,0,6,6,老师对不起
135542,2179,邓焰,2021-05-13 06:10:41,16,16,0,每节课照例点名三分之一，讲课比较跳脱，给分还不错。考试大题只考布置过的作业题（原题/同类题），一定要打印；小题也都能在课本上找到。
136011,2179,邓焰,2021-06-09 08:47:37,4,10,6,这波改分操作真是秀啊...学生面前阴阳怪气，专家面点头哈腰，真是狗啊
136012,2179,邓焰,2021-06-09 08:57:06,12,12,0,这波改分操作真的秀到我了，平时分比例算错能算出-8来？
137414,2179,邓焰,2021-07-04 04:04:04,10,11,1,笑面虎
137447,2179,邓焰,2021-07-04 08:05:59,10,11,1,这调分真是秀啊，“普遍会降一点，但没有质变”，人均降两档还不叫质变吗，67降成不及格的都有，太恐怖了
137650,2179,邓焰,2021-07-05 13:04:29,8,11,3,想凑个性的朋友千万别选这门课，上课和实验都浪费时间，老师考后出尔反尔调成绩比例。
137651,2179,邓焰,2021-07-05 13:06:43,3,7,4,来帮室友点个1分
137652,2179,邓焰,2021-07-05 13:07:14,3,6,3,垃圾老师
138019,2179,邓焰,2021-07-07 05:34:04,10,13,3,笑面虎
152692,2179,邓焰,2022-04-18 11:14:07,0,2,2,这老师讲的不行，作业布置得还慢
153286,2179,邓焰,2022-04-27 13:06:17,18,18,0,上课随机抽一部分点名，讲的还行，不过作业布置太慢。助教哥哥人巨好，很耐心，麻烦他帮了不少忙。实验就呵呵呵呵呵呵呵呵呵
153479,2179,邓焰,2022-05-01 09:12:22,4,7,3,真的垃圾，ch也是sb，大三了还tm给你卡绩
172286,2179,邓焰,2023-04-24 09:10:35,11,13,2,确实笑面虎，上课时乐呵呵的说大作业要是实在有困难，可以申请缓交，结果私戳他申请缓交时，就说全班就你一个人提这种要求，巴拉巴拉把人骂一顿，还针对总分，认认真真听课，做大作业总分只有七十多
190471,2179,邓焰,2024-03-05 08:23:37,7,7,0,您好大的威风。。。
190638,2179,邓焰,2024-03-13 00:19:18,6,6,0,sb一个
190793,2179,邓焰,2024-03-19 09:16:34,16,16,0,请停止你的咀嚼和吞咽
191291,2179,邓焰,2024-04-17 00:08:52,6,6,0,这么有性格，都不想混了是吧
192012,2179,邓焰,2024-05-07 16:13:23,30,34,4,四川的学生，他当时负责四川的招生，这老师shabi到极点了，家长随便问个问题他就是到哪自行查找，老子都会自己查找了还要你有ball用，然后给的网址还能拼错，事后还说“不能因为我们拼错网址就不知道咋办了”，明明是自己拼错还要说个“我们”拖其他老师下水，人家惹你了吗？案例太多无法一一列举，目中无人，自诩清高，很难想象他是一个正常的还活着的人。
195209,2179,邓焰,2024-06-27 08:09:41,15,15,0,招生减章无敌了，不会尊重人
195212,2179,邓焰,2024-06-27 08:19:33,6,6,0,辣鸡，不解释
195259,2179,邓焰,2024-06-27 13:17:44,4,4,0,你是个什么东西
195260,2179,邓焰,2024-06-27 13:28:21,5,5,0,件货而已
195270,2179,邓焰,2024-06-27 14:20:54,11,11,0,就您也配在浙大当老师？\n\n我回答一贯是就事论事，比较冷血，你这种人模狗样的东西赶紧滚出浙大\n\n你对浙大毫无存在的意义
195280,2179,邓焰,2024-06-27 14:53:28,1,2,1,98观光团来围观招生减章
195398,2179,邓焰,2024-06-28 03:03:11,0,0,0,buyiban
195403,2179,邓焰,2024-09-03 08:11:15,4,4,0,无需多言
195426,2179,邓焰,2024-06-28 04:14:34,54,54,0,适合跟陈宏一起绑在变压器副边做负载
195470,2179,邓焰,2024-06-28 07:36:55,0,0,0,先想想自己配代表浙江大学吗？给学校抹黑对得起前辈吗？
198141,2179,邓焰,2024-09-02 12:17:55,9,9,0,四川来的，这批人就是行走的招生减章
199788,2179,邓焰,2024-09-30 02:26:48,6,6,0,电气学院里最会出尔反尔的老师
206646,2179,邓焰,2024-12-17 03:00:22,6,7,1,保研如猪，找工作如狗，考研猪狗不如
216623,2179,邓焰,2025-03-19 10:53:33,7,7,0,万泉部诗人
217652,2179,邓焰,2025-04-14 16:19:57,7,7,0,m4码了
218248,2179,邓焰,2025-04-23 00:42:18,17,17,0,不想对这个老师用语太难听，但是每节课都认认真真听讲，课后再用智云把没消化的都消化了一遍，每个作业都按照要求认真完成，甚至连他双面打印，推荐一张纸上交这些吹毛求疵的要求都去完成了，期末考试认认真真考，每个图都用尺子认真绘制好，原理也都弄清楚了，最后给分奇差，如果考试不是为了公平，不是为了检验我们是否求是笃学，而是单纯让人不知所云，迷茫人生，焦虑保研毕业，为了让我们懂得人生不如意者十之八九的话，那大可以不需要考试，不需要公平。给分真的不知道是怎么给的，批卷也不知道是怎么批的，如果说我自身还有问题，那最大的问题就是对这样的老师还心存希冀，写在这里，也希望后来的学弟学妹们不要气馁，有的时候尽力了，知道自己无愧于自己了，剩下老师是什么样的老师，大家心里清楚就好了
218261,2179,邓焰,2025-04-22 13:34:22,11,11,0,上课莫名其妙一直笑，下课去交作业司马脸一句话都不肯讲，给分也不行，大三还卡绩，通信原理一门听上去就是计算的硬课，考成不三不四的都是选择填空，还都是考的稀奇古怪的
218276,2179,邓焰,2025-04-22 10:16:05,12,12,0,天天点名点你🪵呢？讲的好的话也没人逃课啊。\n\n问题就是你讲那么垃圾，硬是把硬课上成水课，考试考一堆乱七八糟的东西，平时讲课也东拉西扯的，实验也抽象的一批。能不能把你点名的功夫用在打磨课程内容上？？\n\n1分最多了，真是个🌶️🐔老师
218277,2179,邓焰,2025-04-22 10:21:37,9,9,0,辣鸡辣鸡辣鸡，每节早八是要点名的，考试内容时偏得离谱的，出分是要拖到十天期限的，最后给分也是依托⑩的
218299,2179,邓焰,2025-04-22 11:27:01,5,5,0,早八课是要次次点名的，期末考试是要出课外内容的，希望你们有好奇心去探索。。。
218302,2179,邓焰,2025-04-22 11:45:19,4,5,1,天天点名，课程内容稀碎，实验内容抽象，考试试题乱出
218346,2179,邓焰,2025-04-23 00:41:50,5,5,0,不想对这个老师用语太难听，但是每节课都认认真真听讲，课后再用智云把没消化的都消化了一遍，每个作业都按照要求认真完成，甚至连他双面打印，推荐一张纸上交这些吹毛求疵的要求都去完成了，期末考试认认真真考，每个图都用尺子认真绘制好，原理也都弄清楚了，最后给分奇差，如果考试不是为了公平，不是为了检验我们是否求是笃学，而是单纯让人不知所云，迷茫人生，焦虑保研毕业，为了让我们懂得人生不如意者十之八九的话，那大可以不需要考试，不需要公平。给分真的不知道是怎么给的，批卷也不知道是怎么批的，如果说我自身还有问题，那最大的问题就是对这样的老师还心存希冀，写在这里，也希望后来的学弟学妹们不要气馁，有的时候尽力了，知道自己无愧于自己了，剩下老师是什么样的老师，大家心里清楚就好了
218358,2179,邓焰,2025-04-23 02:12:49,6,6,0,不知道考试题目出课外的东西意义是什么，没讲过的考nm呢，除了拉低大家均分有什么作用？
218426,2179,邓焰,2025-04-23 11:20:27,0,0,0,可能是老师这次把前面客观题的占比调高了吧，毕竟选填和判断题是死的，也不太好捞，可以调分的范围有限。而且大题里画这么多码，一画就是一长串，太浪费时间了，属实没必要。
1756,2190,祁才君,2015-03-24 04:52:40,16,23,7,悬！满！
2967,2190,祁才君,2015-05-12 02:27:15,1,6,5,要求较高
3081,2190,祁才君,2015-05-13 13:36:57,5,10,5,超赞
4049,2190,祁才君,2015-06-17 15:27:18,1,5,4,好
5115,2190,祁才君,2015-07-04 08:30:34,1,6,5,上课有意思
6170,2190,祁才君,2015-07-11 14:30:40,1,7,6,老师很像我爸爸
9726,2190,祁才君,2015-11-06 03:35:15,11,15,4,讲得听不太懂
20364,2190,祁才君,2016-01-27 07:10:32,1,4,3,才君超赞！！！\n\n
22046,2190,祁才君,2016-03-02 07:12:03,0,3,3,给分超好
23368,2190,祁才君,2016-03-27 11:09:43,-2,5,7,辣鸡辣鸡
25264,2190,祁才君,2017-01-11 12:51:51,0,4,4,。。。
26063,2190,祁才君,2016-06-19 02:07:37,0,6,6,听求不懂破事还多
26602,2190,祁才君,2016-06-24 02:10:09,0,5,5,坑啊。。。。\n\n
31308,2190,祁才君,2016-07-03 15:26:23,-4,5,9,祁老师很萌的，也很负责任。尽管有口音，但北方人表示可以听懂。上课跟着老师思路走，还是很轻松的。
31402,2190,祁才君,2016-07-04 00:49:51,-1,1,2,自娱自乐
32623,2190,祁才君,2016-07-08 07:22:57,2,7,5,不能接受老师的教学风格，板书全靠在PPT上用鼠标胡画，要求多，且摇摆不定；缺乏对课程提前的规划和把控。
35205,2190,祁才君,2016-11-05 03:40:58,5,5,0,好好好
49037,2190,祁才君,2017-03-22 06:33:42,2,4,2,听不懂他说话啊，作业布置也不清晰
49361,2190,祁才君,2017-04-08 02:01:46,1,6,5,事贼TM多，数电实验除了他没别的老师要求做仿真，乐此不疲每次实验课都要写代码做仿真！而且疯狂恶竞，讨论课题目和实验都要记录做完的时间，简直太可怕
49678,2190,祁才君,2017-04-23 11:07:16,18,18,0,再小项：）
59621,2190,祁才君,2017-09-25 03:14:14,6,10,4,执着于用鼠标在ppt上乱画
60149,2190,祁才君,2017-10-11 12:51:57,0,4,4,灵魂画手
63682,2190,祁才君,2017-12-12 13:58:29,7,7,0,qi ou jiao nie qi
63730,2190,祁才君,2017-12-13 15:14:31,8,9,1,超爱祈老师，讲的特别清楚明白，特别好的老师！
70464,2190,祁才君,2018-01-26 16:03:33,8,8,0,所以说老师名字到底是写成，祁才军，祁才君，祈才军还是七彩君（误）
70498,2190,祁才君,2018-01-26 22:15:13,1,1,0,我就想在此地问一句，老师会给调分吗
71988,2190,祁才君,2018-01-29 07:30:25,3,3,0,老师上课讲得很好的
72022,2190,祁才君,2018-01-29 08:16:13,7,7,0,祁哥超萌，和蔼可亲！讲课其实挺有意思的！刚上他的课有点不习惯，但后来发现眞的是非常好的老师！
84521,2190,祁才君,2018-07-13 04:51:45,3,4,1,祁老师很好！\n\n之前看评分不高有点怕怕的，没想到这么好！\n\n老师讲课有激情，答疑很认真。跟着祁老师能学到很多东西。\n\n数电理论+实验，老师会拿将近1200块钱的FPGA给我们玩！顺便学一点EDA/VHDL.很棒的！\n\n
87473,2190,祁才君,2018-09-29 08:07:52,21,27,6,生怕学生听得懂
102922,2190,祁才君,2019-02-25 03:50:22,2,2,0,大馄炖大家一定要去吃
102924,2190,祁才君,2019-02-25 03:50:50,7,7,0,大家脑子不要僵化！
102925,2190,祁才君,2019-02-25 03:51:47,8,8,0,一定要从宏观把控！
103765,2190,祁才君,2019-03-05 06:01:41,8,9,1,老师模电讲得很好很清晰啊，先打个10分
109416,2190,祁才君,2019-06-14 04:37:35,13,14,1,excel点名册随机生成姓名\n\n恭喜xxx\n\nxxx站起来回答问题\n\nwhile（xxx问题回答不上来）{\n\n    xxx回答下一个问题\n\n    if（回答上来了）\n\n         break；\n\n}
111121,2190,祁才君,2019-06-30 02:43:26,3,3,0,老师的模电讲的很好，不过上课喜欢随机点名233
115326,2190,祁才君,2019-07-18 15:31:39,0,1,1,听不懂讲话
116806,2190,祁才君,2019-09-16 03:14:46,2,2,0,老师会现场教学，很棒
131959,2190,祁才君,2021-01-29 14:47:57,1,2,1,大爱祁老师!
147131,2190,祁才君,2022-01-09 00:34:24,7,9,2,祁老师真的真的太好了，首先讲课清晰有逻辑，上课的时候会直接讲这一讲的重点以及一些能够帮助你更好做题的做题方法和做题技巧，三节课基本第一节课会画十几二十分钟把前一次的课回忆一下，在祁老师的课堂上你会觉得这门课的内容屈指可数而且会在脑海里有清晰的脉络，其次老师自己也是个很好的人，一学期把我们所有人的名字都记住了，还能和脸对应起来，最后一节课和我们随便聊了些，隐约间看见曾经意气风发的年轻的祁老师，祁老师的一些教诲和一些思想大概是真的能够影响我一生的东西，电路课还没出分，好坏我都要给祁老师十分！
152099,2190,祁才君,2022-03-26 05:53:30,1,1,0,听了几个老师的智云，应该说还是祁老师画的图最为清楚，小信号模型整理的井井有条，点赞！
152100,2190,祁才君,2022-03-26 05:53:27,0,0,0,听了几个老师的智云，应该说还是祁老师画的图最为清楚，小信号模型整理的井井有条，点赞！
154730,2190,祁才君,2022-06-04 10:32:26,1,1,0,老师模电讲的真好，难得的好老师
159265,2190,祁才君,2022-07-12 13:38:58,2,2,0,讲的真的不太行，听讲真心不如自学，实验报告还巨多
159339,2190,祁才君,2022-07-14 00:31:02,2,2,0,您凭什么控制学生的课余时间，来不来实验室是我的自由，您无权干涉
168395,2190,祁才君,2023-02-15 11:14:52,3,3,0,qcj，真的是好老师，教你思维方式，和学生就像朋友一样，赞
170585,2190,祁才君,2023-03-07 03:20:08,2,2,0,讲的特别好 别管了 祁cj我的神
172000,2190,祁才君,2023-04-16 23:36:39,6,6,0,讲的太快了真的，我感觉没必要讲这么快的，搞得人好累
172001,2190,祁才君,2023-04-16 23:36:39,5,5,0,讲的太快了真的，我感觉没必要讲这么快的，搞得人好累
172036,2190,祁才君,2023-04-18 02:11:26,5,5,0,模电好难模电好难模电好难模电好难模电好难模电好难模电好难😭😭😭🥶🥶🥶😭😭😭😫😫😫👊👊👊👊😭😭😭😥😥😥👊👊👊
172882,2190,祁才君,2023-05-10 03:47:15,1,1,0,聪明！
173551,2190,祁才君,2023-05-29 00:19:08,3,3,0,有激情，但是讲得很复杂
173990,2190,祁才君,2023-06-05 13:15:05,3,3,0,电原和数电，讲得还挺仔细，每节课都会叫很多同学上去做题，还专门叫坐在后面和角落的，所以上课很难摸鱼
176272,2190,祁才君,2023-06-28 08:06:35,6,6,0,绩你态没
177042,2190,祁才君,2023-07-01 09:03:50,1,1,0,聪明！
178718,2190,祁才君,2023-07-19 18:55:48,11,12,1,坐标爱班短学期。累嘛个累死，报告多的要死，难么个难死，
181802,2190,祁才君,2023-11-01 06:32:36,0,1,1,太尼玛快了讲的
185674,2190,祁才君,2024-01-03 12:13:15,1,2,1,1.老师讲得比较快，知识点过得比较迅速，重点在解题技巧，上课认真听的话可以少走很多弯路（做完课后题自己总结的一些技巧，回放智云发现老师都有讲到），但没有充分预习的话get到这些技巧还是有点困难的，尽力跟住老师的步伐，跟不住的话就睡觉吧，老师的口音挺催眠的（大雾）\n\n2.老师很重视思路和对知识点的梳理，期中期末都会要求做思维导图提交到学在浙大，我的建议是平时复盘的时候就当笔记做好\n\n3.从期中看给分还是挺仁慈的，老师一直强调“用解题思路告诉我你都会做了”就能拿到大部分的分数，想考一百分的人才按计算器（）\n\n4.不想被点名回答问题的同学建议坐在教室的正中间，不要太靠前或者靠后，最好也不要靠过道（摸鱼大师的总结）老师问会不会的时候要敢于举手，老师点的就是不会的同学（如果只有一个人举手，那我也没办法了，祝你好运）\n\n5.前期每节课都会点名，而且是悄无声息的，课间不要急着睡觉，注意一下黑板上有没有多一串神秘数字（）睡醒了记得检查一下点名记录\n\n6.非常适合喜爱自学并且定期复盘，目标是掌握应试技巧的同学。\n\n7.反正我很喜欢祁老师，下学期还选，嘿嘿
192920,2190,祁才君,2024-05-31 14:29:36,0,0,0,认真学就是好老师
196105,2190,祁才君,2024-07-01 15:57:41,2,2,0,不想被点名回答问题的同学建议坐在教室的正中间，不要太靠前或者靠后，最好也不要靠过道。\n\n\n\n总的来说，和同期另一门开电路与电子技术II（模电）的老师形成了鲜明的对比，讲课元气十足活力满满，可惜隔壁沈老师马上就退休了。\n\n\n\n可以说是电气学院的招牌之一了，托祁老师的福，模电打下了很扎实的基础，因为上他的课你没办法摸鱼，会点同学起来画电路图，直流通路交流通路，必须保持精力高度集中。口谈禅是“学会负反馈你就搞懂模电了”。\n\n\n\n隔壁沈老师期中为小测形式，而祁老师则是两次笔记总结，我觉得这样的处理非常好，无论是在知识的巩固、应试的要求、还是给分的好坏上，都能让几乎所有同学满意。
200105,2190,祁才君,2024-10-13 06:50:09,0,0,0,生怕学生能听懂
50952,2223,倪光正,2017-05-10 02:24:02,0,0,0,倪老师千古。
67132,2223,倪光正,2018-01-20 10:09:34,0,0,0,好啊好啊
86638,2223,倪光正,2018-09-17 15:12:50,0,0,0,太强了
194410,2223,倪光正,2024-06-23 16:47:11,0,0,0,倪老师千古！深夜阅读工磁，越看越佩服老先生！
76379,2238,徐德鸿,2018-04-05 13:50:13,0,5,5,老师很厉害
109441,2238,徐德鸿,2019-06-14 12:35:47,13,19,6,大师级的人物 还那么认认真真给大家上课
161038,2238,徐德鸿,2022-10-24 12:50:28,35,38,3,上课可以，不要读他的博士，八年起步，少一年算我输。
197668,2238,徐德鸿,2024-07-26 05:35:14,9,10,1,德高望重，鸿运当头，学生徐徐毕业
215384,2238,徐德鸿,2025-02-25 15:24:02,3,3,0,德高望重，鸿运当头，学生徐徐毕业
63970,2264,郭清,2018-01-10 07:39:50,7,8,1,课件能不能做好一点……
67453,2264,郭清,2018-01-21 08:28:15,-5,2,7,不错喔
91331,2264,郭清,2018-12-06 03:48:31,6,6,0,时间掐的真准
91567,2264,郭清,2018-12-13 12:37:27,7,7,0,讲的比较意识流
91900,2264,郭清,2018-12-24 14:04:50,-4,4,8,这老师太强了
96894,2264,郭清,2019-01-21 12:01:13,-3,4,7,很随和，能感觉到是很认真在讲的。就是和盛老师比起来确实讲的比较乱不太能抓住重点，也可能是想让同学们了解更多。还没考试，还没复习慌的一批。
106619,2264,郭清,2019-04-28 11:30:02,-5,1,6,挺好的，回答问题很耐心
107110,2264,郭清,2019-05-01 16:05:05,7,7,0,？？？
107117,2264,郭清,2019-05-01 16:36:44,13,18,5,交期末报告要先交给宋同学?我怎么知道宋同学值不值得信任，我跟他又不熟?熟也不一定知道人品啊?
107162,2264,郭清,2019-05-02 03:18:43,17,20,3,对这老师真的是无语。。大三一直就跪在这老师身上了。超大导论讲的是真的水。给分呵呵了。。
107194,2264,郭清,2019-05-02 07:47:04,3,3,0,有点无聊\n\n
107206,2264,郭清,2019-05-02 08:28:36,14,14,0,给分跪了……写这么认真……
107531,2264,郭清,2019-05-06 09:14:18,16,17,1,超大导论的论文水水就行了，反正给分随机。三小时复制粘贴出来的成绩比三十个小时精心写出来的成绩还高，呵呵
107557,2264,郭清,2019-05-06 13:26:39,2,2,0,???
107913,2264,郭清,2019-05-11 08:51:26,8,9,1,超大导论完全是瞎给分，上课完全不用听，点名去了就行。
113543,2264,郭清,2019-07-06 23:34:36,4,4,0,一点都不专业，先是大作业电子版让同学代收，再是让把作业交到公邮上???公邮???
124193,2264,郭清,2020-06-27 01:07:38,2,2,0,超大上课水，给分玄学，垃圾课
124203,2264,郭清,2020-06-27 03:14:06,1,1,0,这个老师真的迷，给分不知道标准是啥
129542,2264,郭清,2021-02-01 09:33:21,0,4,4,还可以
132401,2264,郭清,2021-02-01 09:55:20,2,2,0,分如其人
132673,2264,郭清,2021-02-03 09:15:54,2,2,0,讲不清楚，比院长差远了
135268,2264,郭清,2021-05-07 08:02:25,0,1,1,还行吧
154591,2264,郭清,2022-06-02 09:23:37,0,4,4,好老师，能体谅学生，不吹不黑
177210,2264,郭清,2023-07-02 07:50:52,3,3,0,个人觉得还可以吧，至少对于器件的各种特性讲的还是比较清楚的。就是上课的时候喜欢讲一些别的东西容易跑题，而且有时候语速太快了听不清楚。但是授课态度啥的还是没问题的，如果有问题去找老师也会耐心答疑。
182225,2264,郭清,2023-11-13 02:56:17,3,3,0,摆烂男神，给分一般，但容易水
184857,2264,郭清,2023-12-23 13:38:35,1,1,0,课是比较水的
190626,2264,郭清,2024-03-12 07:28:28,0,0,0,真听不懂！
190875,2264,郭清,2024-03-23 09:04:40,0,0,0,讲的真lj
191589,2264,郭清,2024-04-25 11:50:34,7,8,1,郭老师可能是没院长讲的好，但wanghengyu和郭老师真的没法比——来自电子器件why班正在补天看郭老师智云回放
191749,2264,郭清,2024-04-29 14:20:59,7,7,0,郭老师人还蛮不错的，看着很和蔼，很佛系
210468,2264,郭清,2025-01-09 08:09:25,4,4,0,郭老师人蛮好的，比较好商量，佛系
215728,2264,郭清,2025-03-05 01:53:46,0,0,0,集成电路导论 和郭老师不太熟的不要选 拿不到高分的
218473,2264,郭清,2025-04-24 03:06:58,0,0,0,郭老师
218833,2264,郭清,2025-05-07 12:04:36,0,0,0,上了电子器件，老师很平易近人很有趣，考的也不难。还是很喜欢上郭老师的课的
84573,2267,孙丹,2018-07-13 08:07:35,3,5,2,老师教的好给分也好
115320,2267,孙丹,2019-07-18 12:29:08,2,2,0,还行啊
136744,2267,孙丹,2021-06-24 02:16:41,1,2,1,挺好的！
160248,2267,孙丹,2022-09-16 00:08:02,5,7,2,海院的孙丹老师人超级好，讲课也很好！
162606,2267,孙丹,2022-11-28 10:26:03,4,4,0,海洋学院的孙丹老师真的是绝对的好老师，很和蔼而且很有耐心的回答同学的问题，给分也还不错
162607,2267,孙丹,2022-11-28 10:27:40,5,5,0,海院孙丹老师绝对是好老师，讲课给分都不错，而且很耐心回答同学的问题
196616,2267,孙丹,2024-07-04 09:02:24,1,1,0,电气工程学院孙丹老师：\n\n跟年珩老师一个实验室~\n\n老师很健谈，因为大部分同学都去年珩老师的班里了，所以我们班其实就10几个人，而且有不少重修的\n\n所以一般就只有6，7，8个同学到场\n\n最后一节课老师会说几个人比较眼熟，报个名字给你们加平时分\n\n因为周五早八比较难顶\n\n总的来说老师很不错，课程也是统一的\n\n三次实验，包括一次实物两次仿真\n\n一次大作业，做了选做给满分\n\n值得一提，孙老师和年老师都是贺益康老师的博士生~\n\n师姐是章玮老师\n\n给孙老师10分了！\n\n（不过磁链符号应该读皮塞吧，老师一直读的φ）
221789,2267,孙丹,2025-06-26 08:52:51,0,0,0,电机控制：上课不清楚，但是给分还不错。考前突击了下，给捞到了卡绩的上一档
143365,2288,陈国柱,2021-11-24 06:59:52,2,7,5,老师讲的非常清楚，都是干货
154735,2288,陈国柱,2022-06-04 11:43:39,0,2,2,不点名，可以不听，没啥用，建议别选，每周问你报告进展，公开处刑
154785,2288,陈国柱,2022-06-05 09:32:53,0,0,0,不点名，想要学到东西得靠课后自己努力，可以不去听课
195627,2288,陈国柱,2024-06-29 05:35:46,-1,1,2,到底是谁说不用听课的我真的被你害死了。老师不会纸质点名，不会电子点名，没错，他会偷偷把你名字记住，然后心里记下来每个人的到课情况。平时分30+报告70，平时分全靠自己站起来回答问题和考勤。ppt写的一塌糊涂，问他问题也答非所问。真的不建议选，不差这两分真的。
34061,2373,樊臻,2016-11-10 11:53:17,0,0,0,从不点名，讲课按部就班，作业量少，数字图像处理今年题量有点大，樊老师延长了15分钟，然而，我也没做完。
62978,2373,樊臻,2017-11-27 15:18:07,0,0,0,给分贼好，课程任务也很少，超好的一门课
88421,2373,樊臻,2018-10-30 13:23:12,0,0,0,讲的还蛮好的
8472,2409,汪涛,2015-09-21 13:44:25,0,1,1,老师人非常好！
107525,2409,汪涛,2019-05-06 08:34:55,1,1,0,老师人超好，就是口语不好上双语课没人听
107538,2409,汪涛,2019-05-06 10:30:48,6,6,0,老师人很好，上课很自由，随机几次点名，内容不难，认真写论文就能拿高分。
116302,2409,汪涛,2019-09-07 15:00:09,0,1,1,作为一班主任 为啥全是发广告
36267,2414,胡长生,2016-11-11 11:11:13,4,5,1,退了吧  不听劝会后悔的
36493,2414,胡长生,2016-11-14 09:01:24,19,20,1,润放。
47877,2414,胡长生,2017-02-27 01:35:24,3,4,1,学不到东西
59339,2414,胡长生,2017-09-21 02:52:23,-3,0,3,红学讲师
63849,2414,胡长生,2017-12-17 12:25:07,6,10,4,推荐石健将老师
85818,2414,胡长生,2018-08-18 11:47:42,6,7,1,水做的老师
116975,2414,胡长生,2019-09-18 02:05:19,6,7,1,今天的DSP课堂，只剩七人
117459,2414,胡长生,2019-09-24 16:04:20,-9,2,11,挺不错的
119172,2414,胡长生,2019-11-11 03:55:45,-27,1,28,4.8
141168,2414,胡长生,2021-09-25 12:51:28,7,8,1,话唠，特喜欢自娱自乐
143059,2414,胡长生,2021-11-18 13:22:44,4,5,1,上课举的例子引起不适
151886,2414,胡长生,2022-03-19 07:08:12,9,10,1,废话很多
152611,2414,胡长生,2022-04-15 17:28:55,9,10,1,DSP的授课和课件都让人难以接受。。。\n\n很杂乱，学起来很累
152745,2414,胡长生,2022-04-19 06:20:42,7,8,1,寄汤来咯
152749,2414,胡长生,2022-04-19 07:52:22,8,9,1,别选。。。要想学东西别选，要想水绩点别选。。。笑容很到位，扣分也很到位。。。
153675,2414,胡长生,2022-05-07 14:43:37,8,9,1,故事大王
170994,2414,胡长生,2023-03-14 01:23:59,3,3,0,润用&润放
172921,2414,胡长生,2023-05-10 02:57:15,9,9,0,垃圾课程，垃圾实验，垃圾考试，垃圾给分，谁选谁sb
172922,2414,胡长生,2023-05-10 02:58:06,7,7,0,垃圾课程，垃圾实验，垃圾考试，垃圾给分，谁选谁傻逼
172923,2414,胡长生,2023-05-10 03:01:07,7,7,0,求求了，千万别选这门课，求求你们了
172925,2414,胡长生,2023-05-10 03:02:10,12,12,0,DSP只能说上课又烂给分又烂，劝退劝退
172927,2414,胡长生,2023-05-10 03:15:48,7,7,0,快跑！
172930,2414,胡长生,2023-05-10 03:39:53,6,6,0,妈妈生的，劝退，喜提新低，不是高手不要来
193729,2414,胡长生,2024-06-17 01:53:54,6,6,0,把上台演讲的同学晾半小时，自己在那讲
202621,2414,胡长生,2024-12-05 01:41:14,8,8,0,工程伦理会点名的
202717,2414,胡长生,2024-11-14 03:41:35,4,5,1,我以为我在上马院的课呢，原来是电气的老师呀失敬失敬
203533,2414,胡长生,2024-12-04 03:24:30,3,5,2,傻逼啊 刷新下限
203781,2414,胡长生,2024-11-21 04:54:21,3,3,0,槽多无口
204016,2414,胡长生,2024-11-23 04:39:25,-4,0,4,评分5分
205082,2414,胡长生,2024-12-01 06:17:45,1,1,0,南屏。
205292,2414,胡长生,2024-12-04 03:23:19,2,2,0,人机一枚
206721,2414,胡长生,2024-12-17 08:27:13,5,5,0,不可多得的傻逼货色
207884,2414,胡长生,2024-12-25 01:05:14,1,1,0,真是极品
6387,2417,孙志锋,2015-07-13 12:52:58,-5,12,17,老师人很好，上课时会把考试重点都讲了，作业略多不过考试考作业题，只要每次去考试肯定没问题噜。但是上课有点困哈哈
26517,2417,孙志锋,2016-06-19 15:38:03,-2,7,9,上课对着ppt，超级无聊\n\n但是人还不错，期末有重点\n\n
49217,2417,孙志锋,2018-08-27 04:51:23,6,6,0,书是他编的，ppt和书上内容一毛一样，上课念ppt，不如自学
49375,2417,孙志锋,2017-04-08 13:11:25,9,9,0,浪费时间
78201,2417,孙志锋,2018-05-10 03:12:59,7,10,3,给分很烂 慎选
78237,2417,孙志锋,2018-05-10 06:14:57,10,12,2,给分很烂  教材很差  要拿学分就选吧   要真的学东西去上计院的数据结构
78278,2417,孙志锋,2018-05-10 11:18:58,10,10,0,没点东西
78850,2417,孙志锋,2018-05-15 23:58:29,11,12,1,给分渣的一批
85771,2417,孙志锋,2018-08-05 11:57:41,5,6,1,给分巨nm烂
106666,2417,孙志锋,2019-04-29 01:28:03,0,2,2,给分巨坑，上课内容无意义，考试都是术语解释记记背背的题，神坑，慎选！！！
141242,2417,孙志锋,2021-09-27 06:08:25,2,4,2,你上尼玛呢？\n\n一个计算机老师上课带U盘，不带键盘，你是真的行
142106,2417,孙志锋,2021-11-06 04:27:54,0,1,1,老师很烂 别选 建议旁听计院的课
142419,2417,孙志锋,2021-11-11 07:20:25,4,4,0,辣鸡！
142423,2417,孙志锋,2021-11-11 07:46:37,2,3,1,老师很烂，给分很差
142424,2417,孙志锋,2021-11-11 07:49:17,3,4,1,垃圾，臭sb
142512,2417,孙志锋,2021-11-12 11:58:01,2,2,0,谢谢您嘞🙂
142530,2417,孙志锋,2021-11-12 15:51:04,3,3,0,寄吧。
142566,2417,孙志锋,2021-11-13 12:07:54,2,3,1,分数低得离谱
142590,2417,孙志锋,2021-11-14 02:25:07,3,4,1,烂，什么都烂
155235,2417,孙志锋,2022-06-09 14:58:27,7,7,0,相比于后面的部分专业课已经不错了
161840,2417,孙志锋,2022-11-14 14:24:36,2,3,1,水课，学不到什么东西，可以学些数据结构基本的概念，每次作业都写写考前复习ppt最后分数也不至于太差。
161849,2417,孙志锋,2022-11-14 13:02:28,1,1,0,快逃！
162025,2417,孙志锋,2022-11-16 05:58:01,1,1,0,所有作业都做了，期末感觉自己考的也不差，2.7?认真的？
162182,2417,孙志锋,2022-11-17 10:58:39,2,2,0,听楼下的吧，他说分数不会太差，反正多努力都是差的意思吧。能不能把评分再拉低一点
162197,2417,孙志锋,2022-11-17 14:16:09,1,1,0,课是真的水，事情是真的不多，给分也是真的烂
162305,2417,孙志锋,2022-11-19 21:00:38,-1,0,1,傻逼一个
162421,2417,孙志锋,2022-11-22 04:14:11,-2,1,3,还可以
63508,2428,邱建琪,2017-12-05 10:53:15,2,2,0,非常好
76673,2428,邱建琪,2018-04-18 03:17:15,0,0,0,嗯？？？
84572,2428,邱建琪,2018-07-13 08:06:58,2,2,0,给分很差
102904,2428,邱建琪,2019-02-25 02:10:21,1,1,0,很奈斯
103807,2428,邱建琪,2019-06-17 03:59:01,1,1,0,不咋地
136902,2428,邱建琪,2021-06-28 02:43:32,2,2,0,考前来评一波，老师讲课很流畅很好、语速偏快，能听得进去跟上的话我觉得挺好的，不点名
176643,2428,邱建琪,2023-06-29 14:01:51,3,4,1,电力电子技术教的挺好的
177047,2428,邱建琪,2023-07-01 09:24:25,2,2,0,不点名 上课很好 分还没出！
178862,2428,邱建琪,2023-07-26 09:37:00,1,1,0,老师人很nice
221706,2428,邱建琪,2025-06-25 10:35:27,0,0,0,给分太差啦老师！！！！
7917,2439,颜钢锋,2015-09-16 06:18:31,0,1,1,好老师，挺有意思得课
78920,2439,颜钢锋,2018-05-17 02:04:07,2,2,0,很无聊，照本宣读
90565,2439,颜钢锋,2018-11-24 05:58:50,0,0,0,慈祥和蔼
119271,2439,颜钢锋,2019-11-12 01:48:40,0,0,0,不错的老师，课堂氛围很好，下次还会再来
126422,2439,颜钢锋,2020-09-26 05:42:55,0,0,0,照本宣读，ppt也不好看
126423,2439,颜钢锋,2020-09-26 05:44:38,-1,0,1,上课真的无聊
128134,2439,颜钢锋,2020-12-08 04:41:56,5,5,0,感觉他上课都能把自己讲睡着……研究生课《离散事件系统》难度不是很大，课比较水，但是今年的考试题量格外大，给分还行，可以选。
25992,2459,史涔溦,2016-06-15 03:06:43,10,10,0,好！好！
47532,2459,史涔溦,2017-01-30 05:10:59,4,4,0,讲的很清楚，电机学事情少，靠谱的好老师！
71244,2459,史涔溦,2018-01-28 07:43:49,8,8,0,老师讲课超认真 给学生答疑很有耐心 给分也很好
72189,2459,史涔溦,2018-01-29 14:10:46,3,3,0,老师人很好，讲课很认真，虽然可能会听不进去
72252,2459,史涔溦,2018-01-29 15:53:44,5,5,0,很好的老师啦~
73800,2459,史涔溦,2018-02-03 06:13:22,7,7,0,老师人很好 课讲得很清楚 答疑也很耐心
79213,2459,史涔溦,2018-05-27 10:21:08,9,9,0,史老师的电机学内容充实，讲的快但是很清楚，一看就知道备课很认真的。
94071,2459,史涔溦,2019-01-15 05:53:40,3,3,0,非常好的好老师
96103,2459,史涔溦,2019-01-20 12:51:28,4,5,1,课讲的很认真 比大二某些专业课老师好得多
96141,2459,史涔溦,2019-01-20 13:24:48,4,4,0,老师真的特别特别好，上课认真，讲课清楚，电机学，好好学吧，挺难的，哭唧唧……
97307,2459,史涔溦,2019-01-22 08:00:28,6,6,0,心疼老师嗓子经常会哑
104100,2459,史涔溦,2019-03-12 03:15:38,2,2,0,非常好的老师！
109439,2459,史涔溦,2019-06-14 12:30:54,2,2,0,讲课认真 答疑耐心 女神！
115619,2459,史涔溦,2019-08-09 16:58:14,7,7,0,讲课细致清楚，课下和学生交流也很热心耐心，来玉泉后最喜欢的一位任课老师
122450,2459,史涔溦,2020-02-28 06:26:02,3,3,0,是小姐姐呀💓💓集智慧和美丽于一身
133628,2459,史涔溦,2021-03-03 03:32:18,2,2,0,史老师又有气质，专业本领又过硬，电机学讲得非常好，强推！
141339,2459,史涔溦,2021-09-30 03:19:59,1,2,1,讲课非常非常清楚，ppt详略分明非常棒！\n\n上女神的课感觉思维都是流动的，很久没有体会过这种感觉了！
146856,2459,史涔溦,2022-01-07 16:51:34,2,2,0,真的讲的很棒，课件做的也很好，上课思维是跟随着老师的，不会断掉。体验绝佳
146881,2459,史涔溦,2022-01-08 01:39:13,1,1,0,老师上课很仔细，而且私底下问老师问题也会很耐心的答疑，是个负责任的好老师，强推！！！
147357,2459,史涔溦,2022-01-09 16:29:47,0,0,0,"""对待每一门专业课，考完了并不意味着结束"""
149597,2459,史涔溦,2022-01-16 06:52:38,0,0,0,讲的很清楚，强力推荐！
161172,2459,史涔溦,2022-10-31 03:24:55,0,0,0,史老师曾经说穿不惯平底鞋😎
185757,2459,史涔溦,2024-01-04 07:07:58,2,2,0,期末复习看看了她的回放，感觉比zw讲的好
186778,2459,史涔溦,2024-01-13 04:44:42,1,1,0,老师真的讲的很好很细
186780,2459,史涔溦,2024-01-13 04:46:09,3,3,0,出分快，给分好
186891,2459,史涔溦,2024-01-13 12:25:46,5,5,0,老师讲的真的很好，学到很多，努力学，最后会有好结果的
190461,2459,史涔溦,2024-03-05 02:16:01,0,0,0,春学期的电机专业课好多电机学的知识都忘了。回过头来看老师的智云，讲的真的好好555
198490,2459,史涔溦,2024-09-09 08:20:18,0,0,0,好好好
208285,2459,史涔溦,2024-12-26 13:14:58,0,0,0,思路清晰
213059,2459,史涔溦,2025-01-16 01:57:39,2,2,0,伟大，无需多言
213128,2459,史涔溦,2025-01-16 05:10:28,0,0,0,讲的很好，给分求是，不点名
1376,2513,何乐年,2015-03-22 01:20:25,0,7,7,CMOS这课很难，但老师讲的挺详细的。虽然讲课方式很奇怪，但实际上也是个好老师。\n\n
15461,2513,何乐年,2016-01-14 13:15:29,4,5,1,无话可说……一句话，想考高分，答疑不能不去
19274,2513,何乐年,2016-01-23 17:46:31,9,9,0,老师很负责，答疑很细致，很耐心
34587,2513,何乐年,2016-10-15 00:11:12,1,7,6,能感觉到老师很想把课上好，也经过了认真的准备，但是：1.口音浓重听不清；2.思维跳跃跟不上；3.讲义凌乱看不懂；4.缺乏基础学不会；5.助教答疑是正道。
34989,2513,何乐年,2016-10-28 03:24:16,4,5,1,讲道理，真觉得虽然准备了，但是真的说不上充分。感觉上课没有条理，想到哪儿讲到哪儿。不过讲到的地方应该他都是好好讲的。可能口音真的是最大的问题，大家都纠结在这儿，其他也没看出来吧。
72797,2513,何乐年,2018-01-31 05:42:47,3,3,0,老师虽然讲的很难懂 但是人很负责，认真复习给分也不错
81298,2513,何乐年,2018-07-04 15:09:13,0,1,1,老师很好，需要理解
145504,2513,何乐年,2021-12-30 04:17:23,1,1,0,老师很有实际设计经验，讲课有条理，而且考前会告诉考题详细范围，作为大四课程没有太多压力
8307,2517,赵荣祥,2015-09-18 05:46:03,0,0,0,太好了
59569,2517,赵荣祥,2017-09-23 05:00:34,2,2,0,赵老师真厉害\n\n
92698,2594,赵梦恋,2019-01-04 00:43:46,-4,3,7,一般般
104089,2594,赵梦恋,2019-03-12 01:15:11,-5,2,7,还好吧
105993,2594,赵梦恋,2019-04-24 05:21:52,-4,3,7,很好哦
108856,2594,赵梦恋,2019-06-03 09:00:46,7,9,2,讲课就是为了完成任务，知识点讲得稀碎。根本不管学生有没有明白。
108925,2594,赵梦恋,2019-06-04 09:03:37,7,11,4,作业xjb布置
109158,2594,赵梦恋,2019-06-10 13:36:47,6,10,4,非常差。讲课把知识点稀释在口头禅中，作业没有条理，课件错误百出。
109583,2594,赵梦恋,2019-06-17 08:05:57,8,12,4,一节课下来有两百个的话呢
110108,2594,赵梦恋,2019-06-23 07:02:37,9,11,2,实在是讲课讲的太垃圾的，根本不知道在讲什么xjb东西
112990,2594,赵梦恋,2019-07-05 17:17:05,6,9,3,大学三年到现在为止，这个是最差的老师。
113034,2594,赵梦恋,2019-07-05 18:20:27,6,7,1,听不懂 不想听\n\n
113127,2594,赵梦恋,2019-07-06 00:00:32,1,3,2,求你好好做研究别祸害我们本科生了
116498,2594,赵梦恋,2019-09-11 02:28:31,6,9,3,前面有人说有200个“的话呢”，这么说的话呢，其实有500个“的话”都不过分。
145921,2594,赵梦恋,2022-01-04 10:57:31,4,5,1,上的是模拟集成电路设计，听说这个和信电学院的赵梦恋老师是一个老师？\n\n那边评论了在这边也来评一下\n\n听说赵梦恋老师的分很低，我赶紧来说道说道\n\n个人觉得赵梦恋老师唯一的缺点就是语速过慢，给人一种不是很确定的感觉，但是认真听课就会发现老师讲课的思路非常清晰，逻辑严密，能看得出来对拉扎维的那本书理解很深，摸集虽然考试感觉考得一般（刚考完），但是个人挺喜欢赵梦恋老师的~\n\n助教人也超好的，对助教印象最深的就是“乌兹，我的青春~”（希望助教别看到
158260,2594,赵梦恋,2022-06-28 01:27:59,2,3,1,还没出分给赵老师刷一波分，感觉评分偏低\n\n这学期上的赵老师和谭老师合开的集成电路课\n\n我很喜欢赵老师诶（笑哭，而且觉得老师讲得挺有逻辑的，而且年轻时候肯定是大美女好吧，现在也很有气质哇\n\n课件确实感觉逻辑差一点，字少一点\n\n问老师问题解答超有耐心的，感觉对老师评分差的可能没和老师交流过？\n\n给老师刷刷分保一保我集成（双手合十）
556,2595,马钧华,2015-03-15 04:55:19,17,18,1,老马的魅力值爆表
16946,2595,马钧华,2016-01-19 09:45:13,10,10,0,讲的很好~
34578,2595,马钧华,2017-01-12 14:32:02,1,1,0,好！好！
44816,2595,马钧华,2017-01-18 09:41:01,8,8,0,小马哥这人炒鸡搞笑，简直一老油条。世界第一无敌负责任，还有助教gg们人都超棒，不水但也不难，期末也不会故意为难大家，建议学弟学妹们选马老师的课哇
46893,2595,马钧华,2017-01-22 18:28:27,2,2,0,上课超赞\n\n都怪这学期排课一坨?，早课有些时候没忍住
57545,2595,马钧华,2017-07-09 12:54:03,2,3,1,超级好的一个老师，非常耐心，态度非常好，感觉到了服务业？？
71242,2595,马钧华,2018-01-28 07:42:42,1,1,0,微机原理这课绝对物超所值 课上能学很多东西 老师传递给学生很多思想
74005,2595,马钧华,2018-02-04 05:03:36,4,4,0,课程干货很多，4学分的课学到了6学分的东西，建议准备搞ee的同学跟着马老师走，收获满满
86403,2595,马钧华,2018-09-15 06:39:26,1,1,0,老师太英俊了，有魅力的工科男老师应该是什么样的？就是这样的啊！！！上课一定要认真听，因为课件完全不能看，还喜欢讲到哪是哪，笔记比较难做。实验考比别的老师难，但其实只要认真准备了就没问题，何况还有无敌及格包加持。大家都去选他的课吧！
87888,2595,马钧华,2019-01-22 08:34:43,5,6,1,我！要！吹！爆！老！师！
89446,2595,马钧华,2018-11-19 07:24:07,0,4,4,上课听不懂，真的听不懂，对不起，达不到老师的高度。
93442,2595,马钧华,2019-01-09 15:07:31,2,2,0,强推 真的能学到许多有用的东西 实验考试有强大的及格包 理论考给你划了各种重点（隐隐已经有透露考题走向了hhh） 在群里回答问题也很严谨 还有助教ggjj超厉害啊 每次实验都会提供非常实用的提示 吹爆Majunhua老师和助教鸭 老师上课前会给大家拍张照（说是点人数 实际就不知道怎样了 可能并没有算） 祝选这位老师的朋友都能取得好成绩啦。
95491,2595,马钧华,2019-01-19 13:02:40,4,4,0,出分之前赶紧来打个十分，超有魅力的老师，刚开始接触dsp的啥也不会实验一做一下午加一晚上，到最后编程编到开心，那种感觉真不是一般的过瘾～听课开始确实不好听懂，但等你实验全部做完就会有种实验理论两开花的感觉。总之dsp选马老师就对了～
97381,2595,马钧华,2019-01-22 08:28:29,1,1,0,喜欢马老师
97547,2595,马钧华,2019-01-22 10:29:00,4,4,0,马老师真的很棒，一开始学不懂觉得很抵触，但是坚持听课做实验，会摸到一点门道的。最后的实验考试老师会给及格包，理论考试划重点，给分也很好。马老师给我的感觉是你如果想好好学东西他能教给你很多，如果只是想完成这门课程他也绝不会难为你。真的非常好的老师。
97668,2595,马钧华,2019-01-22 12:55:45,9,9,0,选老师的心路历程：\n\n1.这老师评分比另一个高，就他了\n\n2.这老师上课讲的什么玩意儿\n\n3.这老师实验课怎么一做就是一天，还一次比一次难\n\n4.这老师怎么有两个这么麻烦的大作业\n\n5.我靠，竟然最后能做DSP实验了\n\n6.我靠，原来老师这一学期讲得这么好，原先听不懂的东西，被老师给弄顿悟了？？\n\n7.我靠，原来老师给分这么好
101706,2595,马钧华,2019-01-29 01:59:10,3,3,0,给学弟学妹一些建议：最开始可能完全听不懂课，完全不清楚实验怎么做，但是一定要坚持听下来！到后来就会有一天突然顿悟所有的内容hhh  还有，最开始听不懂课也一定要认真听和记笔记或者录音，因为马老师的ppt相当于没有，考前突击只能靠笔记，千万不要想着完全考前速成
133626,2595,马钧华,2021-03-03 03:29:06,1,1,0,马老师和助教都非常好，上课能学到东西而且老师很风趣，实验手把手指导，考前会给及格包，实验报告也不整虚的，想好好学、想学到真本领、愿意下功夫的同学一定要选。给分也很好，微机收获大学第一个100分，学弟学妹冲！
26881,2599,姚文熙,2016-06-21 12:35:35,4,7,3,好！好！好
57319,2599,姚文熙,2017-07-06 15:34:32,1,6,5,给分超级好
58546,2599,姚文熙,2017-09-01 14:32:01,7,10,3,老师很好，讲的很仔细很负责！
105222,2599,姚文熙,2019-04-07 15:08:57,-6,9,15,呵呵。
107113,2599,姚文熙,2019-05-01 16:11:13,-10,11,21,绩杀。
121625,2599,姚文熙,2019-12-12 04:21:34,6,7,1,讲课讲的很清楚，认真负责，发邮件问老师问题会很快回答
133810,2599,姚文熙,2021-03-06 07:25:32,15,16,1,人很不错，上了他一门研究生现控
136930,2599,姚文熙,2021-06-28 10:18:27,10,14,4,电力电子方向最nice的老师
159313,2599,姚文熙,2022-07-12 06:28:58,0,2,2,好老师，都可以选
181829,2599,姚文熙,2023-11-02 02:13:54,3,4,1,研究生现控两学分真的内容又多事情又多，还有大作业
182529,2599,姚文熙,2023-11-18 07:51:52,8,9,1,非常有少年感的一位老师，难得的会亲自备课并且喜欢和学生一起讨论的好老师，让人如沐春风。但他的课程很硬，干货很多，不适合想水课的同学来上。
204538,2599,姚文熙,2024-11-26 13:34:14,0,1,1,很好的老师
217101,2599,姚文熙,2025-04-02 01:24:14,0,2,2,电院专业课里少数认真讲的好老师，同时也是好人👍
23144,2624,包哲静,2016-03-19 17:10:08,4,8,4,好好好
33635,2624,包哲静,2016-09-20 13:11:14,0,1,1,很好的
47129,2624,包哲静,2017-03-16 05:38:37,7,11,4,给分神坑
65649,2624,包哲静,2018-01-08 03:51:15,-3,4,7,老师讲的很好，期末也不为难学生。
72364,2624,包哲静,2018-01-30 03:18:41,3,7,4,老师很负责任，讲的很清楚，速度适中，人非常好
73876,2624,包哲静,2018-02-03 09:38:22,1,7,6,给分超级不好
75611,2624,包哲静,2018-03-14 05:03:46,-34,3,37,考前一夜果然可以满绩\n\n
99069,2624,包哲静,2019-01-24 08:24:50,9,13,4,课件整理地清楚，和书上脉络完全一致。\n\n课后题相比其他老师布置得多。\n\n看之前的评价以为老师上课和蔼，实际感受老师比较容易生气。\n\n教学水平对个人而言较为一般，循规蹈矩无功无过。作为女老师比较细心。但后期因为终究不习惯生气时拔高的尖细嗓音就开始自学了。\n\n给分极其一般，或者说是差的地步。收获大学最低绩点并且是遥遥领先的低，这种情况班里也有好几个。\n\n
99104,2624,包哲静,2019-09-16 01:46:07,9,12,3,贼鸡巴女老师屁话多。。。。。讲的都是什么乱七八糟玩意，问题目TMD贼不耐烦。。有机会还是选姚维的吧。
99124,2624,包哲静,2019-01-24 09:47:41,9,10,1,上课无功无过，找来一些题目还是不错的，但是，真的不明白绩点为什么是这样的。虽然也有满的同学，但是全对的话在哪个老师地方都是满的，看给分还是看中游的分数，毕竟考试全是大题，给分怎么样真的很影响。
99128,2624,包哲静,2019-01-24 09:55:50,16,19,3,这是唯一一门，认真学了，认真准备考试了，你还会得很低分数的老师，退掉选姚维的吧
104744,2624,包哲静,2019-03-27 03:27:24,1,1,0,垃圾老师，不解释。\n\n明明考试题目都会做，结果还是hin低。。慎选
116796,2624,包哲静,2019-09-16 02:27:17,1,1,0,真的什么都讲不清楚
212403,2624,包哲静,2025-01-14 03:10:51,7,7,0,给分非常非常不好
212409,2624,包哲静,2025-01-14 09:52:51,4,4,0,给分很不好
212917,2624,包哲静,2025-01-15 09:03:02,-3,1,4,不点名事少\n\n\n\n（作业全抄，考前一直在玩，只留半个晚上复习拿了98分
214592,2624,包哲静,2025-02-14 04:53:03,2,2,0,给分太差了，感觉更不会的电机学都比这个给分好
22643,2637,何奔腾,2016-03-09 05:39:44,3,4,1,差的不行
23014,2637,何奔腾,2016-03-16 06:30:59,3,3,0,讲得很垃圾
24266,2637,何奔腾,2016-04-29 03:58:57,3,3,0,不咋样
24279,2637,何奔腾,2016-04-29 05:19:45,5,5,0,反正我觉得讲得很乱，可能是自己听不懂吧。\n\n慎选，何老师班上的学生上着上着就基本上都跑到另一个班上去听课了。
38835,2637,何奔腾,2016-12-19 12:56:01,-10,3,13,好！好！好！
49948,2637,何奔腾,2017-04-27 12:10:35,8,8,0,不知所云…专业必修课就一个人上，让我们如何是好。
50667,2637,何奔腾,2017-06-29 13:59:54,1,1,0,垃圾老师。
51843,2637,何奔腾,2017-06-12 08:37:05,16,16,0,腊鸡一个
52285,2637,何奔腾,2017-06-17 11:52:29,-8,1,9,超帅的！能量法第一人！
53863,2637,何奔腾,2017-07-01 13:52:04,7,7,0,不会上课，就不要上课啊
55395,2637,何奔腾,2017-07-01 12:16:41,3,3,0,讲得差给分更差
81100,2637,何奔腾,2018-07-04 02:27:44,1,1,0,求不挂...
83251,2637,何奔腾,2018-07-10 03:34:53,2,2,0,谢老师不挂之恩...学弟学妹还是都去读电控吧...
83330,2637,何奔腾,2018-07-10 06:28:06,4,4,0,港咁多搞咩春啦，吔个屎先啦
84574,2637,何奔腾,2018-07-13 08:08:41,1,1,0,讲课不知所云。。。
87043,2637,何奔腾,2018-09-20 05:27:07,1,1,0,继保本来就一门很烂的课...老师又完全不上心 给分还烂
109438,2637,何奔腾,2019-06-14 12:30:20,1,1,0,他怎么还在代课啊...
115317,2637,何奔腾,2019-07-18 11:53:11,2,2,0,赶紧退休离开教师队伍吧。。。
558,2642,章玮,2015-03-15 04:56:48,24,27,3,有责任心，讲课好
1018,2642,章玮,2015-03-21 10:20:25,13,15,2,讲的很好，虽然我考的挫了，不怪老师
7256,2642,章玮,2015-09-12 09:55:31,4,7,3,很负责任
19392,2642,章玮,2016-01-24 05:07:39,-8,7,15,讲的还行，人品不行
20084,2642,章玮,2016-01-26 05:08:09,-4,5,9,有课的时候挺负责的无论是答疑解惑还是了解学生的学习情况，但是出了教室她就不管我们了，谁让她是大忙人呢。
43928,2642,章玮,2017-01-17 06:37:02,2,2,0,很负责，课讲的很好\n\n
44391,2642,章玮,2017-01-17 17:02:49,6,9,3,不知道有些评论是怎么回事，章老师人好，讲的也好，相信上过课的同学都能体会到。只是电机学真的很难，学分又多。要是这门课有个期中考试就好了，期末压力会小点。而且平时作业跟考试不是一个难度啊，平时作业看似差不多会做了，考试时除了计算题还是一脸懵逼。
65821,2642,章玮,2018-01-09 10:53:51,0,2,2,听不懂\n\n
69692,2642,章玮,2018-01-25 08:26:42,2,6,4,老师对同学态度不一样，让人感觉有点不舒服
69830,2642,章玮,2018-01-25 13:18:31,4,5,1,要不是章老师抬我一手我就凉了…
86575,2642,章玮,2018-09-17 09:24:11,2,2,0,很社会！
91658,2642,章玮,2019-01-16 02:37:33,-4,3,7,期末考题太坑了。。。
95484,2642,章玮,2019-01-19 12:53:39,3,4,1,老师水平很高，讲的很细致而且感觉有很多实际经验。
95487,2642,章玮,2019-01-19 12:56:41,4,6,2,很有情怀的老师，对于这门课只能说，还好我选的是电力系统
95494,2642,章玮,2019-01-19 13:05:00,1,2,1,讲课很好，会透彻地分析原理，不拘泥于课本
128298,2642,章玮,2020-12-17 03:23:07,0,4,4,上课就懂了，还好只是上她一学期的课
130816,2642,章玮,2021-01-24 17:15:59,5,5,0,老师很好，我很菜
140726,2642,章玮,2021-09-15 11:01:44,-5,2,7,上完绪论没憋住，来评一下吧。老师觉得我们应该尊重企业老板，因为人家承担了更多社会责任，可能比较喜欢输出自己的价值观？好坏大家自己判断。另外要求打印PPT还要下次上课检查我以为是回到了小学课堂，你可以建议但是为什么要强制学生怎么学习呢？不是所有人都喜欢在PPT上做笔记吧......
147102,2642,章玮,2022-01-08 17:03:48,2,3,1,很负责的老师，虽然最后主要靠自学，但是还是很不错的
165445,2642,章玮,2023-01-05 12:48:55,-6,4,10,嘴上说的好听，实际不行
170545,2642,章玮,2023-03-06 09:57:25,5,6,1,章玮老师，我真的哭死，讲的真的好，老师很负责，学不好是我的原因，最后老师很失望，但也捞了我，让我及格了呜呜呜，章玮老师太棒啦
170828,2642,章玮,2023-03-10 07:06:47,1,5,4,单论讲课，比隔壁史老师差一些，而且不用话筒，下课后想看看回放都看不了，然后看了史老师的...嗯.......
179371,2642,章玮,2023-09-13 09:27:37,4,4,0,有责任心，负责
181696,2642,章玮,2023-10-28 09:25:41,3,3,0,老师人挺好的其实
185275,2642,章玮,2023-12-27 12:57:48,15,16,1,章老师对电机有着企业级理解，“很多企业都是半路出家的，对电机都不懂的，这个方法我已经教给十多家企业了”，但她教不会我😭
186259,2642,章玮,2024-01-10 07:05:04,2,2,0,人挺好的
186648,2642,章玮,2024-01-12 10:28:55,7,7,0,很好的老师，课后答疑很有耐心，能看出老师对电机学以及教学的热爱。美中不足是作业不下发答案，但瑕不掩瑜。
189959,2642,章玮,2024-02-03 18:23:57,0,2,2,讲的很好，电机学5分，考试感觉难度较大，应该是挺多挂科的
194167,2642,章玮,2024-06-22 10:02:07,0,1,1,出卷出说好不考的内容.......
201117,2642,章玮,2024-10-29 04:04:00,2,3,1,纯nt，期中前最后一节课你又没有期中考试你还点名扣分
212675,2642,章玮,2025-01-14 12:22:07,2,2,0,上课上的挺好的，智云收声不太好
215198,2642,章玮,2025-02-24 06:16:19,0,0,0,感觉还可以的
4982,2653,王建全,2015-07-02 01:25:11,7,8,1,很好
15737,2653,王建全,2016-01-16 08:11:59,1,1,0,有点难
38832,2653,王建全,2016-12-19 12:53:14,0,0,0,我的导师当然帅啦
73781,2653,王建全,2018-02-03 05:31:27,1,1,0,老师太好了认真负责
77197,2653,王建全,2018-05-03 14:13:57,1,1,0,老师挺好的
77234,2653,王建全,2018-05-04 05:21:04,3,3,0,老师人很好 备课很细致 比隔壁不知道高到哪里去了 就是课时太少 老师没办法放慢速度让大家都明白 另外 考试太难了...
77455,2653,王建全,2018-05-05 16:14:32,2,2,0,老师讲的超好，很细致，emmm，对渣渣来讲就是题出得有点难了
78309,2653,王建全,2018-05-10 17:23:05,0,1,1,快出分吧
92604,2653,王建全,2019-01-03 05:46:19,0,0,0,棒棒哒
106152,2653,王建全,2019-04-25 09:43:27,3,3,0,这么良心的试卷，虽然我不是王老师班的，也要给王老师10分
106397,2653,王建全,2019-04-27 04:48:50,0,0,0,讲得很清楚明白
106463,2653,王建全,2019-04-27 15:07:32,2,2,0,很好的老师，讲的很好，不拘泥书本，认真听会对暂态有很好的理解
109445,2653,王建全,2019-06-14 12:39:39,1,1,0,暂态还是要听王老师的啊 别的老师没个认真讲的
130155,2653,王建全,2021-01-18 07:41:24,5,6,1,研究生必修课《现代控制理论》也推荐选王老师，比其他老师讲的好很多
151452,2653,王建全,2022-03-03 12:43:20,-11,1,12,推导你🐴的公式，喜欢让人做无意义的繁琐劳动是吧，捏麻麻石蜡
158676,2653,王建全,2022-07-01 08:31:52,0,1,1,暂态真得选王老师吧，太细了
3003,2674,李涛,2015-05-12 15:28:08,0,1,1,军训嘛，，，挺严的，但平时作为辅导员人很好
5915,2674,李涛,2015-07-10 02:09:23,2,2,0,简直就是一垃圾，就是一书呆子啥能力没有
65573,2679,丁勇,2018-01-06 12:05:31,0,0,0,机器学习第一次讲 还比较照本宣科，上课准备不充分 但是很愿意和同学交流，能学到一些基本知识，更多的需要自己下来学。
117446,2679,丁勇,2019-09-24 11:56:15,0,0,0,老师很有意思
7643,2695,黄进,2015-09-15 07:16:05,4,7,3,记得电气装备的考试开始前，老师跟我们说：这张试卷很简单，只要大家平时认真听了，考试一定不会挂。结果果然是个flag，试卷难出翔了，最后成绩你们懂的。\n\n
38836,2695,黄进,2016-12-19 12:56:44,0,0,0,好！好！好！
50818,2695,黄进,2017-05-06 00:01:32,2,4,2,第一句话就能知道是个shibi老师
52801,2695,黄进,2017-06-23 03:26:05,0,0,0,不准说话 不准迟到 （好一个黑脸老师
75814,2695,黄进,2018-03-19 05:24:14,1,1,0,声音毫无起伏真的催眠
77204,2695,黄进,2018-05-03 16:07:03,2,2,0,老师挺严格的，但是真的人还不错\n\n
125220,2695,黄进,2020-09-04 01:39:47,1,1,0,给分垃圾，上课还不如siri，我呵呵了
125418,2695,黄进,2020-09-08 10:12:41,1,1,0,这个老师给分辣鸡，教的很一般，期末考试成绩出来没有一个在群里感谢老师的，建议选杨家强老师的课，hj老师快退休了，有些事情不顾及后果
126022,2695,黄进,2020-09-16 13:36:23,1,1,0,老师上课讲的挺清楚的，考试内容也是他上课强调过的。
127230,2695,黄进,2020-11-16 08:10:25,0,0,0,老师讲的其实很细有逻辑，就是声音真的催眠
539,2747,陈敏祥,2015-03-15 04:30:24,2,4,2,教得好，耐心、细致，也好打交道。不过《电机学》课本身有难度，大家要全力以赴。
40936,2747,陈敏祥,2017-01-06 14:10:09,-13,6,19,可以看出对讲课没有别的老师上心，说话还经常带着讽刺…\n\n
40937,2747,陈敏祥,2017-01-06 14:17:41,2,2,0,老师人很好，关心学生
44153,2747,陈敏祥,2017-01-17 10:55:32,2,2,0,好老师，讲得好，人也好
44173,2747,陈敏祥,2017-01-17 11:23:37,5,5,0,为什么没人么？陈大侠其实上课讲的很耐心，下课也很乐于给我们回答问题，12:15下课以后也不顾耽误午饭时间给有需要的人答疑解惑，在qq上也是一个很逗的人，总之挺不错的。大家选课的时候不要被上面的均绩所迷惑，只要自己认真好好学，最后都会取得好成绩的！
75079,2747,陈敏祥,2018-03-07 08:51:10,5,5,0,这种专业课几乎不点名就值得10分，均绩低是因为电机学本来就难，老师也是很辛苦的在讲。出成绩了全班感谢老师，都知道自己本来是啥水平，也知道老师花了多大力气才让我们不仅没挂还上了2甚至3。(温馨提示)好好学，多刷题，班里大佬同样有4.8和满的哟：）
97348,2747,陈敏祥,2019-01-22 08:19:09,3,3,0,老师课讲的很好 如果你直接问他考试相关内容一般他是不会回答的 但是如果你问习题，学习上的问题他会认真解答。平时挺严肃 偶尔逗比一下的老师吧哈哈
97530,2747,陈敏祥,2019-01-22 10:02:06,0,1,1,陈老师蛮好的，讲课很仔细，思路也很清晰，有的知识课件上没有，所以上课最好还是认真听。另外，电机学确实算是比较难的课了，知识点太多了。
120762,2747,陈敏祥,2020-01-16 17:29:01,1,2,1,。。。
155240,2747,陈敏祥,2022-06-09 15:53:59,0,0,0,题目出得比较体谅学生
38837,2776,王康元,2016-12-19 12:57:14,0,0,0,好！好！好！
55492,2776,王康元,2017-07-01 15:50:17,0,0,0,老师看起来怕怕的，不过还有点萌。哈哈哈
80925,2776,王康元,2018-07-02 20:46:58,1,1,0,给分垃圾，我认识的同学没一个上85
80964,2776,王康元,2018-07-03 05:04:49,1,2,1,打分摇号的？
80965,2776,王康元,2018-07-03 05:04:49,3,3,0,打分摇号的？
81113,2776,王康元,2018-07-04 03:11:21,1,1,0,老师还可以，给分一般
84570,2776,王康元,2018-07-13 08:06:12,1,1,0,给分不怎么样
109440,2776,王康元,2019-06-14 12:34:24,0,0,0,老师人挺好的 课程任务要认真做啊...
113784,2776,王康元,2019-07-07 12:25:08,0,0,0,好舒服啊(✪▽✪)
175202,2776,王康元,2023-06-22 09:28:02,0,0,0,老师挺好的，就是有点子凶凶的感觉。
192503,2776,王康元,2024-05-22 05:19:35,10,10,0,电院执剑人
6678,2802,董树锋,2015-07-18 08:35:41,3,14,11,好老师！！给分超级好！！\n\n
23570,2802,董树锋,2016-04-06 12:38:29,-2,3,5,很好！
24030,2802,董树锋,2016-04-25 15:31:44,-2,4,6,好！好！
24513,2802,董树锋,2016-05-01 02:47:54,3,12,9,虽然上数据库课有点不知所云，平时作业也是难的不得了，只能各种上网抄，但是给分超级好！！！力荐！
24547,2802,董树锋,2016-05-01 11:59:44,-7,8,15,不得不说数据结构想学好真的是需要花功夫的，但就上这门课而言拿到高分是不需要什么本事的，因为我平时报告全抄，上课经常不去，只是考前看了一下，抱着求不挂的心态参加考试，董老师居然给我4.5！简直不敢相信我浙有这么完美的老师！
24555,2802,董树锋,2016-05-01 14:31:36,-1,5,6,董老师人很好，上课可能有些无聊，但可能是因为数据结构本身就是一个比较枯燥的课
25036,2802,董树锋,2016-05-05 02:45:33,0,5,5,这门课的作业是难了点，但是老师人很好，给分也不错
31540,2802,董树锋,2016-07-04 05:51:15,-2,6,8,平时成绩是这么算的:报告写的特别好的同学给满分，写的不那么好的同学给接近满分。
50243,2802,董树锋,2017-05-02 02:40:48,-14,2,16,给分好名不虚传！像我这样的学渣，平时上课不怎么去，几次作业都是百度抄的，最后考前看了两天书，最后4.5。
50264,2802,董树锋,2017-05-02 05:10:23,9,11,2,说好的给分好呢？我感觉学的很用心了呀
50268,2802,董树锋,2017-05-02 05:41:27,-7,3,10,良心评价：大三狗出国党需要数据库的名字所以选了这个课，之前学过数据结构。因为专业课冲突所以一个学期没有上过课。课程作业最后一周一起交的。老师之前在网上查了一些各种数据结构的卷子然后就上了。基本上大同小异。最后4.3，不高，可以参考。
50270,2802,董树锋,2017-05-02 05:52:46,-14,2,16,没上过课 作业五一交的 上90 非常稳
50518,2802,董树锋,2017-05-03 09:03:47,9,10,1,讲得不是很好。\n\n另外，楼上各位说的给分好\n\n是基于有些人认认真真上课每次报告自己写十几个小时结果没上85的基础上的：）
50696,2802,董树锋,2017-05-04 10:40:39,8,9,1,当初一直想抱怨老师讲的不好来着，但是听说老师给分好就忍了。花了超级多时间，自己完成了他神奇的作业(就那种上课教你1+1，作业让你造飞机的难度)。最后一个辣鸡绩点真的让人怀疑老师打错分...ps.之前选他明明还在9+现在怎么只有6了(Ｔ▽Ｔ)
50723,2802,董树锋,2017-05-04 14:06:25,-10,3,13,讲课超级烂，给分超级好，所以是个难的的好老师，力荐！！比那些讲课好给分烂的老师强10000倍！
51309,2802,董树锋,2017-05-31 00:57:08,5,11,6,董老师是一个讲课一点也不无聊，作业一点也不多，难度一点也不大的好老师。主要是最后的给分还一点儿都不差。大家选吧，我一点儿都没说错！
52279,2802,董树锋,2017-06-17 10:23:42,0,4,4,不点名，老师人挺好的，字写的很好看。但是上课无聊难懂+作业如果自己做真的很难+最后你辛苦了一学期得个很差的绩点，有人啥都是抄的得了4.8。
76377,2802,董树锋,2018-04-05 13:13:09,17,22,5,别选了 超级难  根本啥都没教  默认我们水平很高了
76767,2802,董树锋,2018-04-22 12:39:52,2,3,1,选择死亡  不会编程序
78735,2802,董树锋,2018-05-15 02:31:11,2,2,0,没用的课，
78907,2802,董树锋,2018-05-16 12:24:15,0,1,1,给分也没说的那么好哈哈哈！可能是自己太贪婪了吧。不过作业真的难得离谱，考试还行。
79606,2802,董树锋,2018-06-11 08:27:14,-2,0,2,每周造飞机+考试手写c语言。认真上的话会学到很多
81418,2802,董树锋,2018-07-05 04:43:10,3,3,0,我话就放这儿，你敢选他的课死的时候别怪我没提醒你，不开玩笑。
84234,2802,董树锋,2018-07-12 10:13:08,0,0,0,…………
84980,2802,董树锋,2018-07-15 00:19:22,0,0,0,上课教你1+1，下课让你造飞机。
113783,2802,董树锋,2019-07-07 12:24:38,0,0,0,辣鸡！！！
133885,2802,董树锋,2021-03-09 02:37:09,0,1,1,（数据结构与数据库技术）非本学院，看中课程名称而选课，第三次课布置了第一次作业决定退课。\n\n前两次课的感受和这里其他同学的总结类似，上课比较简单。PPT基本可看作是课本电子版的节选，老师讲解主要在解释代码中的术语。\n\n本来考虑自己的主要目的是要一个成绩单上的课程名称，可以课后mooc自学。但是今天作业布置下来，描述模棱两可、不够清晰。虽然我没有尝试，但推测很多实现的细节需要自己从作业描述的话中（而不是课本、阅读资料中）揣摩。在我看来数据结构与另一些包含项目设计的计算机课程存在不同，后者可以在一定约束内适当围绕自己的想法发挥，但如果前者缺失了精确性，我不太能接受。\n\n综合上课内容和作业要求，总之就是教学质量离我的心理预期相差较远吧。
150135,2802,董树锋,2022-01-19 09:21:36,1,4,3,上学期上了智能配电网建模与分析，是董老师新开的课程，个人感觉难度适中，和稳态一起上的话有助于融会贯通，事也不多（4次作业，期末半开卷），好好看书（其实老师大部分都是念PPT，而PPT和课本内容基本上一致），然后期末好好准备，给分还是不错的。\n\n\n\n吐槽一下：三节课中的第三节一般会讲一些课外，比如用RUST语言编写馈线模型什么的…虽然不考，但是看不懂RUST会很煎熬
159328,2802,董树锋,2022-07-13 06:34:02,0,2,2,董老师超级好，人品又好，讲课也好，给分也高，力荐！！！
189520,2802,董树锋,2024-01-25 07:33:17,2,2,0,（智能配电网络建模与分析）开课第二年\n\n课程主要内容是配电网各元件的建模与辐射状电网潮流算法。难度上相比稳态，好比电网络分析之于电路原理。建议弄懂每个矩阵的意义和作用。\n\n五次作业每次两道大题期末统一交。\n\n考试半开卷，现在98上已经有回忆卷了，大题基本是作业原题，给分还可以，但不能像电气化交通那样啥也不学。\n\n两个三节课中最后一节老师会讲自己做的潮流计算软件或者低代码计算平台，以及一些配电网最新进展，未来还可能会有小实验？可以不听，但蛮有意思。
48948,2809,陈恒林,2017-03-18 00:49:02,2,3,1,失去学位是什么啊？失去学位就是布拉布拉………那学位很重要啊(￣▽￣)
85637,2809,陈恒林,2018-07-23 11:57:25,4,4,0,日了狗了的班主任
85712,2809,陈恒林,2018-07-27 08:18:59,4,4,0,sb一个
127243,2809,陈恒林,2020-11-17 02:09:43,5,5,0,属实sb一个
181677,2809,陈恒林,2023-10-28 01:38:00,0,2,2,这位更是重量级，总共八周的课程，第六周的周末突然通知大作业不用做了，改成考试。不是，前几周你干什么去了，知不知道我们为了做大作业付出的时间？研究生的时间不是时间？研究生研一的课程压力本身就大，还要兼顾科研，还能碰上这种贵物，我也真是没话说
192418,2809,陈恒林,2024-05-19 02:42:08,0,1,1,上课没有重点，讲得一般。脾气温和
193076,2809,陈恒林,2024-06-03 09:06:03,3,3,0,sb老师，纯纯傻逼
193434,2809,陈恒林,2024-06-11 01:11:08,0,0,0,此君平时上课念九十分钟ppt，不仅念中文还坚持念完英文。念完总要问问大家：你们选了这门课为什么不来上？
199636,2809,陈恒林,2024-09-26 13:50:30,1,1,0,不知道
217681,2809,陈恒林,2025-04-15 05:58:44,1,1,0,看到没有这个老师的评价，那我就来写一下吧。首先点名是叫名字点到，点名时间不定，可能课前可能课中，平时分占比还是比较高的。然后上课时喜欢找人问问题，没人举手会抓人回答问题，被叫起来的同学不能回答不知道，必须要说点什么，说不出他想要的可能会尬住几分钟，一个问题有时能占用十几二十分钟时间。上课时不太允许你玩手机，理由是会伤眼睛和无法锻炼思考能力，但是睡觉和写作业似乎管得不严。
220552,2809,陈恒林,2025-06-18 12:35:03,0,0,0,不要选电磁兼容，会变得不幸
62914,2821,许力,2017-11-27 10:42:19,-12,5,17,智能控制与智能系统上课听的不是很懂，但是自己钻研认真做作业做展示还是能得到很好的分数的！老师把我领进人工智能的大门，非常感谢老师！
86395,2821,许力,2018-09-15 02:12:12,0,2,2,双语?
89085,2821,许力,2018-11-15 09:55:24,-24,3,27,这门课没考试，大家可以在平时学到很多东西，老师也很随和的，很有意思的一门课。
128293,2821,许力,2020-12-17 01:11:18,18,21,3,垃圾课垃圾老师
145514,2821,许力,2021-12-30 06:11:20,11,13,2,很无语
145515,2821,许力,2021-12-30 06:26:37,13,13,0,非常较真，上的很难受
145526,2821,许力,2021-12-30 07:11:27,34,37,3,作业：一篇读书报告，一个手写MLP作业，一个大作业（题目自选）\n\n老师：平时不用听，都是老东西，大作业提问的时候是个杠精\n\n结论：不如孟濬
145568,2821,许力,2021-12-30 09:17:04,14,14,0,个人认为老师比较保守傲慢，接受新东西不够快，所以大作业选题的时候要选一些老师听得懂的东西，不然他会和你杠半天
145612,2821,许力,2021-12-31 09:29:40,13,13,0,这老师人品有问题
145837,2821,许力,2022-01-03 07:48:54,7,7,0,展示的时候，一定得选他没听过的选题，但是还得别选太难的，不然他听不懂，就把你杠住了。展示是讲给老师听的，老师知道了就是直接过，不知道的就直接杠。还有就是最好别组队，不然就会杠死你
145909,2821,许力,2022-01-04 07:18:39,8,8,0,为什么不能打0分 大学以来最最最最最无语的老师，杠精，压迫感拉满，求学弟学妹们别选。
145935,2821,许力,2022-01-04 13:00:10,4,5,1,从布置作业的形式、答辩时的“拷问”等方面可以看出来，\n\n老师并不信任学生
146028,2821,许力,2022-01-05 05:57:50,3,4,1,大概是这次选的人太多了，总想施压赶走他眼中“水学分”的学生。\n\n课程没什么意思，和人工智能课重复太多，不如隔壁班模糊控制。评价看不懂，很喜欢关注英文语法什么的。\n\n如果不是学院这一模块开课没几门能选，谁愿意挤这老师的课呢？
146316,2821,许力,2022-01-11 05:08:05,7,7,0,不好 体验很差
146378,2821,许力,2022-01-06 11:30:09,14,14,0,杠精啊。群里看抖音，说一个跳舞的男的像某个同学，呵呵😄
147897,2821,许力,2022-01-11 06:17:50,-11,1,12,给分还行
148808,2821,许力,2022-01-13 14:47:18,9,9,0,怀疑老师师风师德有问题😅
160926,2821,许力,2022-10-20 01:27:41,2,2,0,上课能不能吐字清楚点，说中文都说不好，天天拽英文，呵呵
161027,2821,许力,2022-10-24 08:22:20,3,3,0,杠精，喜欢打断别人
162085,2821,许力,2022-11-16 15:21:15,4,4,0,智控，真nm傻逼，2篇读书报告2份大作业还要求英文，总共就8周课诶憨批
165492,2821,许力,2023-01-07 07:47:25,-8,2,10,emmm…是一门很好的用来学人工智能的课，同时也能了解到模糊控制。比起另一个班，许老师这里作业时间要求会更紧一点，但是形式是两次大作业，另一个班是多次小作业。\n\n讲课上挺好。也挺负责的。\n\n这门课偏难，占用时间非常多。有一些自己已有理解或已有项目的来上大概可以轻松一点。\n\n项目展示要理清逻辑。\n\n整体来说给分挺好。在控院大三课表里算的上一门设置很合理的课了。
168270,2821,许力,2023-02-08 07:22:37,6,6,0,纯纯➗ 给分标准闭口不谈喜欢刁难别人 上的课质量也不行 上到最后感觉人品也不太行 总结就是依托答辩
183274,2821,许力,2023-11-23 10:21:04,6,6,0,就你对学生这态度，zju还是太儒雅了，放职校直接给你头打没
189462,2821,许力,2024-01-24 11:37:56,1,1,0,关于智控这门课，老师很喜欢点名，但上课基本上都是在卖弄自己的英语以及让学生翻译英文，学不到什么东西；一共两个大作业，一个手写MLP一个自主选题，作业量比隔壁班是少了很多，但最后的展示老师会很较真，抓住一个纰漏就会把你批到下不来台，如果比较走运没有怎么批评你，那你就会得到一个相对不错的分数。总体来说上课体验并不好，不推荐选
189538,2821,许力,2024-01-25 09:37:17,4,4,0,智控事少给分好，完爆隔壁刘山老师的班。每节课点名扣一分，期末答辩喜欢压力扣一分
189982,2821,许力,2024-02-05 17:08:33,6,7,1,就智控这门课而言，和隔壁刘山班比的话，教学态度：刘山＞许力，工作量多少：刘山＞＞许力，给分：许力＞刘山。\n\n就这门课而言，许力还是值得一个7分以上的
418,2833,韦巍,2015-03-15 02:09:05,22,36,14,他的《控制理论》教得不怎么样，上课老扯别的，而且课的内容基本就是念课件，例题也不认真（碰到难的就直接显示结果）。基本自学。
7263,2833,韦巍,2015-09-12 11:09:42,17,21,4,让这种为了本学科利益而牺牲学生，搞什么“按高考分专业”丧心病狂政策的混蛋领导见鬼去吧！
11654,2833,韦巍,2015-12-09 11:17:26,5,7,2,学术嘛……对学生要求到挺高
11883,2833,韦巍,2015-12-20 09:47:14,17,19,2,院长事务繁多，貌似学术上的东西已经忘得差不多了吧，控制理论的有点难度的题他都必须看答案讲解
23175,2833,韦巍,2016-06-17 00:46:19,1,8,7,好老师 改变我的一生
34320,2833,韦巍,2017-01-22 17:10:37,6,9,3,控制理论给了我99。但是，全靠自学。不考虑老师教了什么内容之外，老师的人生经验还是可以听一听的。
36292,2833,韦巍,2016-11-11 13:51:10,7,9,2,韦巍一笑很倾城。。。
46749,2833,韦巍,2017-01-22 09:15:40,8,9,1,很无聊 上微微一笑很倾城的课基本靠自学？ 题目必须先显示答案才能进行讲解 碰到稍微麻烦点的就说过了 还需要学生告诉他为什么会这么做 电院院长教书的能力真的合格嘛？
46752,2833,韦巍,2017-01-22 09:18:50,4,6,2,搞科研就搞科研，搞行政就搞行政，上不好课要么好好准备要么就别出来上，真不知道对不对得起电院院长的名称。
46892,2833,韦巍,2017-01-22 18:16:37,3,7,4,其实喷的人也可以考虑考虑大学教育
88337,2833,韦巍,2018-10-29 02:44:19,5,5,0,一本正经地胡说八道
89409,2833,韦巍,2019-01-26 11:47:24,9,9,0,笑死我了，第一次见考试时间都能搞错的老师。\n\n不过助教哥哥改卷给分是真的好，还会在期末考前划重点。
91187,2833,韦巍,2018-12-03 02:55:20,16,16,0,边讲课边玩手机也是很? ? 了
94463,2833,韦巍,2019-01-24 13:10:17,19,20,1,怕不是在城市学院打麻将把脑子打傻了
116951,2833,韦巍,2019-09-17 14:02:15,6,6,0,上课一大半时间吹牛逼，剩下一点时间赶进度，根本学不到东西
117319,2833,韦巍,2019-09-23 02:19:30,5,6,1,才上了他两次课，心态就快崩了。\n\n上课就会说大话，讲空话。\n\n其他老师半小时的内容，他要讲两小时\n\n这门课看来真的只能自学了…
126758,2833,韦巍,2020-10-19 02:22:44,5,5,0,误人子弟
145274,2833,韦巍,2021-12-28 16:03:08,4,5,1,很垃圾，屁都不会，上课只会吹牛
150092,2833,韦巍,2022-01-19 03:40:30,6,6,0,老师讲课格局比较大，但课程相关内容讲的稀里糊涂，会时不时发散，建议听姚维的。最后给分还可以。助教非常负责，平时作业和实验报告没交会私戳催。
170401,2833,韦巍,2023-03-03 17:08:43,-10,0,10,教的不好，但给分真的可以
181360,2833,韦巍,2023-10-16 03:04:27,0,0,0,逆天逆天
188019,2833,韦巍,2024-01-18 04:28:11,5,5,0,逆天，上课不会上，给分也不好。
188030,2833,韦巍,2024-01-18 04:54:09,5,5,0,上课不会上，根本讲不清楚，自己根本不会用钉钉\n\n开学一个多月了都没有钉钉群，最后还是助教自己建群，一个一个学生拉人\n\n作业没答案，也不讲评，全靠自己上网搜，搜来的答案也有很多错\n\n考试也抽象，嘴上说简单结果题目全是陷阱\n\n最后给分也不怎么样，根本不知道分都扣哪了，难受的很\n\n整个下来的体验比《电力稳态》还要差
188040,2833,韦巍,2024-01-18 05:19:23,6,6,0,上课乱讲一通，下课全靠自学，考试全凭天意，教考严重分离，和平行班上的就是两门课，真是牛马老师配牛马助教
188665,2833,韦巍,2024-01-19 13:34:05,-5,4,9,上课如上，作业如做，考试如考，分数如给，但是助教gg很好，翘课不去教室还可以线上钉钉给他交作业，作业交了基本就是满分，很为学生考虑🥰
188790,2833,韦巍,2024-01-20 03:03:19,8,8,0,学生不来上课也请反思一下自己课上得怎么样吧。期末考拖拖拉拉不出分，给分情况一般。在查老师上给评分最低的老师。
189796,2833,韦巍,2024-01-29 10:30:27,17,17,0,助教值10分，老师-9分\n\n我给大家解析一下VV上课的笑点\n\n“大家觉得我的课不好，就不要选”——您可以跟教学科沟通一下，您的课只设10个容量，其他容量分给其他老师，不然我们也不想选您\n\n“你们可以给我分数打低一点”——老师您的分数够低了，三个您还比不上姚老师一个人\n\n“但大家要知道我这种老师是很难遇到的，我的授课是面向人生整个阶段的”——不上V老师的课难以面对整个人生，上了V老师的课会失去走完人生的动力\n\n“大家不来上课，我是不会点名的，上课是你们的事不是我的事”——出自点名前最后一节课\n\n“整个动物界也是一个控制系统，大家体内的细胞也是控制系统”——老师的课本身也是控制思想的控制系统的一部分\n\n“学在浙大我不会弄，你等我回去研究几天”——开学第一天，同时也是老师正式拉出学在浙大群的一个月前\n\n作颂：\n\n至阳至刚，电网专家。执电枢磁，控制大师。\n\n出分一周，过程无分。绩杀之尊，VV教授。
189906,2833,韦巍,2024-02-02 02:05:43,3,3,0,考的不讲，讲的不考，最后给分也很不怎么样，难受的一笔
190711,2833,韦巍,2024-03-15 11:31:09,4,4,0,What can I say？
199417,2833,韦巍,2024-09-23 07:14:58,2,2,0,姚维，启动！
199418,2833,韦巍,2024-09-23 07:20:00,1,1,0,姚维。启动！！！ww不知道在讲什么
199919,2833,韦巍,2024-10-08 10:49:31,3,3,0,话多，但是废话🥰
211956,2833,韦巍,2025-01-13 02:56:10,11,12,1,期末过程分可谓是一点没给，甚至梅森公式都没给分，过于逆天了。\n\n慎选，除非你觉得你期末能一路对到底，不然明显应该选别的老师，毕竟都是听yw，向yw提问，\n\n反正实验课时间也是后期安排的，课表上无所谓。
211959,2833,韦巍,2025-01-13 02:54:33,7,7,0,幽默上课，vv的课最好一个字不听，听yw的。期末考也不给过程分，出分一坨。
212038,2833,韦巍,2025-01-13 05:28:01,4,4,0,不备课，乱讲一通
212143,2833,韦巍,2025-01-13 09:08:36,6,7,1,讲的很烂，批卷不捞，吹毛求疵，煞笔
212174,2833,韦巍,2025-01-14 16:48:56,4,4,0,老师会突然抽一下的来次点名（可能没有可能也有两次），上课听了学长学姐的建议，直接听了yw老师，讲的是挺不错的。作业量倒还好，最后考试给分也是有点（看完上面评论的大家都懂）。能选其他老师还是选其他老师吧，选上的话，最后期末考还是尽量写严谨点吧（给选上的同学的忠告）。
212180,2833,韦巍,2025-01-13 10:14:25,-7,2,9,好老师，最后给分给的很好
212206,2833,韦巍,2025-01-13 11:27:11,4,4,0,为什么给分这么差……平时作业都按时交，实验报告也按时认真完成并提交，每节课都去不存在没签上到的情况。期末考试也就最后一个大题写了一半（自我感觉考的还不错）最后怎么给分这么差。。ps：评论区的大家是怎么知道阅卷过程的，单纯想问问
214255,2833,韦巍,2025-01-31 02:49:01,-1,0,1,还可以啊
216029,2833,韦巍,2025-03-09 14:41:03,0,0,0,超级大沙比
37469,2882,李武华,2016-11-19 03:08:02,2,6,4,上课吹刘，下课就要写专利了。
52215,2882,李武华,2017-06-16 03:24:04,-1,10,11,李老师的课注重于教会大家如何思考，如何产生灵感.课程任务比较重但是以后想做科研的同学绝对值得一上
59968,2882,李武华,2017-09-29 04:41:56,-5,3,8,灰常爽
75355,2882,李武华,2018-03-09 06:51:01,-5,2,7,讲的不错
90046,2882,李武华,2018-11-22 02:55:17,-2,4,6,给分很好，上课会吹牛
95473,2882,李武华,2019-01-19 12:36:00,-6,4,10,上课吹牛，听起来很爽
116385,2882,李武华,2019-09-10 01:00:33,6,9,3,呵呵了
125405,2882,李武华,2020-09-08 07:28:16,6,6,0,用脚趾头写论文
130299,2882,李武华,2021-01-20 14:16:13,28,32,4,就一个吹牛逼的，学不到东西，自己牛逼不代表交的好
151974,2882,李武华,2022-03-22 07:57:12,8,8,0,纯吹牛成功学，别信就完了 毫无逻辑无法落地
154045,2882,李武华,2022-05-20 08:11:55,0,2,2,老师讲的是更偏思维层次的内容
154734,2882,李武华,2022-06-04 11:42:30,-1,2,3,这人不点名，感觉上他的课很折磨，没啥用，可以不听，事情略多
154794,2882,李武华,2022-06-05 12:22:36,12,12,0,有没有人注意到他的ZJU主页域名是：\n\nperson.zju.edu.cn/001
182244,2882,李武华,2023-11-13 07:35:33,-1,0,1,大功率那课，没啥用且不点名的水课，给分好，就交一个课程报告，但是喜欢吹牛逼
183401,2882,李武华,2023-11-25 03:11:06,-1,0,1,不一般
188298,2882,李武华,2024-01-18 15:06:19,1,3,2,科创 感觉老师人蛮和蔼的 很平易近人的感觉 上课不点名 众所周知课程作业是写个专利 给分的话一般吧 虽然拖均绩但是能拿到学分 影响不大就是了 但是看主修掉了一点点还是会心疼的
189436,2882,李武华,2024-01-24 06:53:12,-6,0,6,未来院士
193376,2882,李武华,2024-06-08 01:24:51,1,1,0,愤世嫉俗
193511,2882,李武华,2024-06-12 09:14:59,2,3,1,。。。
193537,2882,李武华,2024-06-12 14:10:43,23,25,2,杂交版：“我不避讳地说，其实我对‘査老师’这种阿猫阿狗的评价是毫不在意的，但看到楼下和楼上很多同学不经过思考就打低分，我就很恼火。有些人提起我上课会点名，但是我每次也都会提早下课的。我还可以毫不避讳地说，我们很多同学其实是不具备批判性思维的，这就是东亚教育模式的弊端。做人其实和做科研一样的，要讲究三个字——正、反、合，好比我说过鼓励每个同学都翘一次课，但我也可以在那堂课上点你的名（bushi）。如果你不服你可以退课，因为你自己选的课来了又不听，这不是玩弄我吗？其实我做这些事情背后都是有理论依据的，有些人说我喜欢威胁同学退课，否则给他打零分，因为什么？因为中国人实在是太tm的多了！最后我想说的是，这条评论以及其他形形色色的评论不过是片面的概括罢了，你们有些人把它们称之为‘典’，而经典评论就是让人能理解最基础的东西就够了，而我lwh到底是个什么样的人，这就是研究生、博士生要探索的东西了。”
193986,2882,李武华,2024-06-21 07:54:46,4,6,2,大功率变流一坨屎，b事一堆，还颠来倒去，学不到任何东西
212536,2882,李武华,2025-01-14 07:05:24,8,8,0,一坨.
212549,2882,李武华,2025-01-14 07:29:14,5,6,1,这就一个纯傻逼，快跑
212553,2882,李武华,2025-01-14 07:55:18,7,7,0,科创课上课次次到堂，甚至都能记得每个教授大概讲了什么，就因为心得没出现请来的教授名字，就要了解我的课堂到课率，不补交就要挂科，太纯了
213404,2882,李武华,2025-01-17 08:24:43,3,3,0,人生建议别选他的课
213937,2882,李武华,2025-01-21 16:13:47,4,4,0,这种水课认真写了给分这么差，垃圾
989,2909,陈辉明,2015-03-20 17:03:22,3,3,0,思路非常清楚 虽然有时容易走神
60490,2909,陈辉明,2017-10-22 11:31:13,1,2,1,挺好的 真的不错
61881,2909,陈辉明,2017-11-21 10:57:28,1,1,0,哈哈哈
63971,2909,陈辉明,2017-12-20 08:29:34,0,0,0,不知道怎么样
101377,2909,陈辉明,2019-01-28 06:07:45,0,0,0,不错啊
120549,2909,陈辉明,2020-01-12 12:54:44,1,1,0,走神儿
132938,2909,陈辉明,2021-02-05 07:38:16,3,3,0,老师水平很高，讲课思路很清晰。没有展示，只要认真听课认真做实验就行。就是这门课实在太玄学了，前面没有半导体物理的基础，课程的内容又丰富，一节课下来啥也没记住，期末花了四天才勉强过一遍。考试倒不是很难，不过两个班是一张卷子的，建议有时间的话过一遍另一个班的内容。
133028,2909,陈辉明,2021-02-06 15:18:04,0,0,0,老师很好，但课程设置不合理，给分蛮好的
178881,2909,陈辉明,2023-07-27 12:36:06,1,1,0,上课很认真，思路也很清晰，但是课程内容过多，平时不跟着节奏走的话期末哪怕只看考纲内容也会火葬场。23年春夏试卷整体难度不大但选择题出现了一些较偏的考点，复习时最好参考另一个班会给出的范围。
25045,2915,郭创新,2016-05-05 03:31:00,0,2,2,数据结构与数据库技术，他从来都没出现过
38627,2915,郭创新,2016-12-12 16:43:08,0,2,2,从来没有出现过的迷之老师
106512,2915,郭创新,2019-04-28 03:25:16,0,0,0,前排观望
175586,2915,郭创新,2023-06-25 16:10:50,0,1,1,电力信息技术事少开卷，老师上课也很有意思，推荐大家选。
192699,2915,郭创新,2024-05-28 21:11:06,0,9,9,郭老师还是非常不错的\n\n但是电力信息技术后半段是一位新老师来上课，该老师美其名曰上课增加互动，活跃气氛，实则问同学各种稀奇古怪的问题，上至历史下至语法，“你们都上过一到两门人工智能课吧，那么这位同学你来谈谈看法”，老师觉得你们都上过人工智能和算法，就算没上过肯定也课后自己学过，上课提问压力拉满。还有最折磨人的大作业，涉及人工智能编程，什么要求没做到就会“你的分数会很低哦”，写大作业的过程有一种读博抑郁的美😇
193263,2915,郭创新,2024-06-05 10:57:18,0,5,5,电力信息技术\n\n快跑啊啊啊啊啊\n\n换了个年轻老师教后面人工智能的部分\n\n老师最喜欢的口头禅是你这样子分会很低的\n\n然后期末大作业答辩他带了两个博士生过来\n\n展示完之后问你的论据从哪来的\n\n让你把论文发给他们\n\n他们要核实一下\n\n这谁顶得住？\n\n这么压力\n\n看到这条信息的所有人\n\n希望你们仔细思考一下电力信息技术2个学分是不是真的走投无路了\n\n不然还是选选其他的吧
193513,2915,郭创新,2024-06-12 06:11:34,0,6,6,人工智能哥\n\n有zj之压力，xsm之问题，whf之点名\n\n废话之多，抽象之甚\n\n集百家之众长，有春秋之遗风
195934,2915,郭创新,2024-07-01 01:57:40,-1,4,5,hg是我大学以来上课观感最差的老师，没有之一，大量提问中夹杂细碎知识点，完全听不到重点，除非真的对人工智能了解颇深且感兴趣。大作业有点烦，更多靠课后自学，他课堂上检验学习成果，拿捏翻转课堂。
208632,2915,郭创新,2024-12-30 08:47:24,2,2,0,课挺好的，大作业二选一，不喜欢编程的可以选非编程题，很人性化
214487,2915,郭创新,2025-02-08 06:18:53,0,0,0,非常好！
11833,2917,卢俏,2015-12-17 03:39:04,8,14,6,太差了！拖课超久！随便点名回答问题！喜欢讽刺人！
11872,2917,卢俏,2015-12-19 11:52:37,6,10,4,我始终觉得思政类的课应该讲求润物细无声。一天到晚要创业，要眼界开阔，看不起去事业单位的毕业生，随随便便把自己的三观强加给别人也真是够烦的。
12013,2917,卢俏,2015-12-21 13:41:23,3,7,4,这个思修课真是让人绝望，严重拖堂不说，强加三观给学生。
14425,2917,卢俏,2016-01-07 03:30:45,3,7,4,每一节课都拖堂，每一节。一拖十几二十分钟。废话极多，逻辑极混乱，慎选，慎选
14575,2917,卢俏,2016-01-07 17:07:52,1,4,3,无聊无语无奈无药可救
15076,2917,卢俏,2016-01-12 02:06:56,3,6,3,完全没有时间观念 二十分钟起拖 期末不讲考试早知道翘掉去其他班了
15161,2917,卢俏,2016-01-12 09:20:47,3,5,2,期末不讲课本瞎逼逼些什么乱七八糟的
20829,2917,卢俏,2016-02-01 13:21:00,4,6,2,是拖过一次，二十分钟起拖夸张了吧，给分还可以，哈哈
20835,2917,卢俏,2016-02-01 13:12:37,0,5,5,我觉得卢老师真的很为我们着想，也会和我们分享一些她认为有价值的东西。说真的，现在很少有这样的老师了，很多老师看到一些事情都是睁一只眼闭一只眼
20836,2917,卢俏,2016-02-01 14:06:04,0,3,3,挺认真的
20837,2917,卢俏,2016-02-01 14:12:14,1,3,2,能真的讲一些法律的东西
20845,2917,卢俏,2016-02-02 07:44:53,1,4,3,给分不错
21006,2917,卢俏,2016-02-09 13:42:17,-1,2,3,給分好
23343,2917,卢俏,2016-03-27 00:36:58,1,2,1,还可以
61039,2917,卢俏,2017-11-07 09:49:05,2,2,0,说话无逻辑，爱怼人，她说什么就是什么。恶心。
19273,2932,张培勇,2016-01-23 17:42:29,9,15,6,每周至少花半天时间在数设编程上，还有一个耗时几天的大作业，最后考试考的和平时编的关系不是很大，能学到东西，但投入产出不成比，慎选
19276,2932,张培勇,2016-01-23 17:53:46,0,7,7,呵呵 对这老师也是无语了
35118,2932,张培勇,2016-11-02 14:51:56,2,7,5,数设简直神坑，每周有好几个课外实验不说，最后还要自己做一个大项目，写报告，做展示，各种通宵，不过收获挺多的。
35175,2932,张培勇,2016-11-04 00:38:00,54,64,10,这是一个能让电院大佬们在深夜抱头痛哭的男人。
35436,2932,张培勇,2016-11-10 07:16:11,3,7,4,py的快感
36346,2932,张培勇,2016-11-12 05:17:47,6,10,4,能学很多东西，但老师是个变态！教的东西少的可怜，布置的实验多的可怕，最后考试的时候再出一套与平时学的一点关系都没有的试卷。真不知道py是什么心态？
37368,2932,张培勇,2016-11-18 13:34:47,7,9,2,不想说什么了，平时事情那么多，上课基础知识也不讲，最后写大project，投入产出不成正比，考试和平时毫无关系，不想被虐，慎选
38409,2932,张培勇,2016-12-03 01:45:24,0,3,3,对～～
39360,2932,张培勇,2016-12-22 07:39:06,1,3,2,暗无天日的日子
50883,2932,张培勇,2017-05-08 03:02:39,0,7,7,不建议选这门课，如果想学数字系统相关的，可以先选大三上的硬件描述语言，再选大三下的FPGA应用，再选短学期有关课程。毕竟循序渐进比一步登天好…
51226,2932,张培勇,2017-05-24 15:35:57,11,14,3,PY循环：\n\n拉经费;\n\n     |\n\n买板子（示波器）;\n\n     |\n\n给课程加实验（大作业）提高难度;\n\n     |\n\n课程申优;\n\n     |\n\n新拉到经费并重复循环;
58005,2932,张培勇,2017-07-22 09:14:29,2,5,3,不选个数设，还想读超大？
75105,2932,张培勇,2018-03-07 10:47:44,3,6,3,痛并快乐着，电院最难的实验课程，一是嵌入式短学期，二是数设，都是py的。说实话，收获是真的很大，但这过程里要脱几层皮。奔着投入/学分比的千万别选了。
85677,2932,张培勇,2018-07-25 04:41:20,4,5,1,hhhh
88714,2932,张培勇,2018-11-06 11:38:55,7,10,3,虽然数设期末考试取消了   但是大作业都给我哭
88718,2932,张培勇,2018-11-06 12:14:20,3,5,2,傻逼期末 还改考核方式
88739,2932,张培勇,2018-11-07 05:17:19,9,14,5,电气大佬真强我真垃圾?
90241,2932,张培勇,2018-11-22 16:05:08,-3,2,5,培勇真的很严格，但真的能学到东西
90243,2932,张培勇,2018-11-22 16:31:58,2,2,0,临时改了考核方式，平时作业补补补……上课和没上课一样，最后还是得自己学，对于我这种自学能力差的渣渣来讲每周作业和最后大作业简直是煎熬……没人明白学弱熬了好多晚上最后大作业还简单得要死的痛苦……强烈建议每周实验进实验室做，有老师助教指导，不然对于学弱来说选这门课相当于短学期自杀( ･_･)ﾉ⌒●~*最后谢老师不挂之恩，真诚感谢！
90248,2932,张培勇,2018-11-22 17:48:46,4,4,0,给后来人提个醒：硬件描述语言设计与应用=数字系统设计
90262,2932,张培勇,2018-11-23 01:28:36,-1,1,2,乱给分
102051,2932,张培勇,2019-10-29 09:05:17,-7,8,15,zpynm$l
103224,2932,张培勇,2019-02-27 02:06:02,-3,3,6,非常好的老师！平时虽然基础的会略过但是在做实验方面可以利用好现成代码学习！慢慢的自己水平也会提高。vivado也比ise好上手多了，大作业可以放飞自己的想象力！
104813,2932,张培勇,2019-03-28 06:50:40,1,2,1,上课状态：一群沙比.jpg\n\n座谈会状态：全是沙比.jpg，浪费时间.jpg
109164,2932,张培勇,2019-06-12 07:21:17,5,6,1,在微电子的专业课上，面对着所有经过多少努力做出来的还有怎么也做不出来的微电子学生，轻蔑的笑了笑说了句：“我对你们很失望。” 在这里我们衷心道歉，对不起老师，我们太垃圾了真是委屈您了。
112825,2932,张培勇,2019-07-05 04:39:37,0,1,1,酸爽就对了
115068,2932,张培勇,2019-07-15 05:51:30,20,23,3,客观评价张培勇老师和他的课程：张老师是当年超大所最年轻的博士，如今的超大所副所长，个人能力和业务能力毋庸置疑。老师性格属于直接型，私下交流其实很活泼开朗，喜欢一直笑，当然也有比较明显的自负感，在批评学生时不会照顾学生的感受，说话比较难听。其所授几门课程，就经费设备与条件而言，在电院首屈一指，课程的难度与实用性更是无出其右，给分堪称求是，二十人的班级敢给一半的人满绩。作为教师，张老师的做法难以称得上优秀，其教学思想以放养为主，即他为学生提供条件和学习渠道，但是本人基本很少做直接授课式教育，对于很多习惯了填鸭的同学以及自主学习能力薄弱的同学是很大的挑战。作为一门课程，数设也好嵌入式也好，都有很大的不足，但是相较于很多落后陈旧，或者纸上谈兵考试前突击了事的课程，其对个人能力和知识的提升非常的大。其课程特点浓缩为两字，就是真实，与工程实际相近的难度与流程，与科研与工作相近的充满挫折和磨砺。我个人认为，这门课可以视作一个门槛和镜子，经历两三年大学教育的诸位，是否有了足够强的自主学习能力面对庞大的行业信息，是否有决心与毅力继续吃苦，乃至于筋疲力竭仍一无所获，在中国的IC这一荆棘之路上负重前行，相信课程结束时你已经有了答案。值得一提的是，py的经典台词之我对你们很失望，这句话很难听，有失师者风度，但作为个人听到这句话，我想倘若我真的已竭尽全力而失败，反倒不会像由于没有足够付出而失败那样羞愤。至于发现自己真的无法接受的同学，也不必觉得被侮辱或轻蔑，倘若你真的付出了自己的全力但仍然失败了，谁又能轻视你呢，转行再干，总有良业。
115622,2932,张培勇,2019-08-11 03:12:27,2,3,1,老师人不错，课程太硬核。
118610,2932,张培勇,2019-10-29 11:19:35,3,7,4,微电子的同学今晚注定要哭晕在厕所
119067,2932,张培勇,2019-11-10 03:08:35,-1,1,2,有一说一，课程很硬盒，收获很多，只要认真做，成绩是不错的，是一门有意思并且有用的好课，竞赛都用得到
119092,2932,张培勇,2019-11-10 09:04:46,2,2,0,la j
123440,2932,张培勇,2020-06-09 02:42:09,5,6,1,室友说 很简单，让我选
124833,2932,张培勇,2020-07-11 14:54:45,3,3,0,小学期以来三天了，他没有讲过一句话，确实能提高能力，但是确实靠对着一张任务单一样的ppt来自学提高能力，如果不是一天十五小时高强度投入，大概率跟不上进度的一半。可能是我太菜了。\n\n除非你保研不需要暑假复习考研且头发充足，不然别选。\n\n快跑啊\n\n退课补选也要跑
125298,2932,张培勇,2020-09-06 01:14:23,2,3,1,0基础被调剂到嵌入式的小学期，做的过程极其痛苦，明白自己做的是什么都要花费好长时间。我前面小学期全部满绩，这次72？电院设置这种要预修的课恶心被调剂的人？
135768,2932,张培勇,2021-05-24 14:22:09,10,10,0,你敢信教学视频只有不到1帧，你敢信教学视频没声音，你敢信实验没有文档直到，敢信那就选
139259,2932,张培勇,2021-07-14 01:12:38,3,3,0,嵌入式小学期慎选
141348,2932,张培勇,2021-09-30 07:44:16,8,8,0,作为一名信电学生，真诚的希望py老师能去zjg学习一下李xh、叶xf、施hj这三位老师是怎么指导学生做实验的
192409,2932,张培勇,2024-05-18 07:47:49,0,1,1,2024年了，还在用2017年的教学视频，3秒动一下，平均0.3帧
77085,3039,江全元,2018-05-01 16:00:12,0,8,8,只有一句mmp，上的什么鬼？听说给分还很差………
78657,3039,江全元,2019-09-10 01:10:49,-3,11,14,垃圾江全元，课上讲的重点考的时候全没考到，考的计算题课上还明确说不考，别的班老师出卷自己心里没点b数吗，白复习，还不如去别的班听课。
78671,3039,江全元,2018-05-14 10:36:47,-2,13,15,电院的声誉就是让这样的老师整没的
79091,3039,江全元,2018-05-22 14:37:54,-1,10,11,赶紧去选王健全吧。。。
93704,3039,江全元,2019-01-12 05:06:17,5,14,9,老师知识精通，授课深入浅出，本人受益匪浅
93706,3039,江全元,2019-01-12 05:18:21,8,21,13,江老师上课幽默风趣，下课悉心指导，考前给我熬夜答疑，有问必答，重点画的也非常好，点个大大的赞
106428,3039,江全元,2019-04-27 10:10:59,0,7,7,人和上课都很烂
106476,3039,江全元,2019-04-27 17:02:14,0,5,5,答疑耐心细致！
110785,3039,江全元,2019-06-28 08:22:28,3,6,3,还行吧！幽默风趣
113782,3039,江全元,2019-07-07 12:16:51,-2,6,8,渣滓，不配当老师
116389,3039,江全元,2019-09-10 01:10:14,2,4,2,醍醐灌顶，如沐春风
119504,3039,江全元,2019-11-13 06:24:38,-4,1,5,非常棒
133791,3039,江全元,2021-03-05 10:48:07,1,1,0,人看起来儒雅严肃，课程讲得中规中矩，给分似乎不是很好哇
191892,3039,江全元,2024-05-04 08:52:28,11,12,1,背景介绍：今年因为教务网实验安排冲突的原因，选了zzr高电压就选不了jqy的暂态，所以大多数人都选了wh，运气不好没选上的只能补选jqy，也就导致jqy班人很少\n\n讲课方面：讲的比隔壁吴浩好，在班上只有个位数人来听课的时候，他也不点名。但是不用话筒有时候喜欢走来走去，补智云声音忽大忽小比较崩溃。\n\n作业方面：只有4次学在浙大测试，3次机会给你一个礼拜时间，选择题比较恶心，比吴浩班难，大题全是习题集上能找到，为了平时分可以直接抄答案，后面自己学懂就好。相比于隔壁班没有大作业，比较轻松。平时作业的给分从最后成绩来看也是有换算的，平时分应该很高\n\n考试方面：选择题中隔壁班平时作业的选择题占90%以上，找室友考前看个3遍就稳了，大题题型隔壁班考前也会透，所以有一个隔壁班室友非常nice😋我们班有些人没看过选择题自然就拉开差距了。加上由于隔壁班人多，高手云集，大家分数都差不多，甚至期末考90分以上超过了30%，最后总评分数还往下拉了\n\n给分方面：虽然往年学长学姐都说隔壁班给分好，但今年在我一个样本和其他许多隔壁班朋友样本对比下，我认为给分比隔壁班好（人数原因占了很大关系）
217685,3039,江全元,2025-04-15 06:11:25,1,1,0,老师人还是很不错的，讲课有重点，期末说一定会考的也考了，还提醒我们去看看隔壁班作业题
218218,3039,江全元,2025-04-22 05:59:30,0,0,0,不点名，刚开始学觉得很抽象但同步电机模型只需要掌握一些关键点就可以，选择题找一找往年的整理一下小测和考试大部分没问题，大题题型基本也比较固定，做好作业和习题指导也问题不大，给分比较好
221708,3039,江全元,2025-06-25 10:39:04,0,0,0,讲课不错，事情不是很多，没有大作业
138904,3044,虞小鹏,2021-07-11 17:00:09,0,0,0,给分超好
141829,3044,虞小鹏,2021-10-27 07:02:46,0,0,0,讲课详细，给分很好
157760,3044,虞小鹏,2022-06-24 17:15:02,1,2,1,集成电路产业技术讲座，10%考勤分，签到有时候会课前开始，课前结束；平时分打分比较主观，占比30%；最后一个大报告占比60%，看了几个同学大报告分数和平时分差不多，应该没有好好批改大报告，直接照着平时分给分。总体而言，在集成电路产业技术讲座上课程不怎么负责吧。
185024,3044,虞小鹏,2023-12-26 01:53:30,-1,0,1,好老师！
82992,3055,厉小润,2018-07-09 12:14:58,-4,2,6,大水课，水学分的学弟学妹们抓紧了
125317,3055,厉小润,2020-09-06 13:38:46,8,9,1,emmmmmm，如果不是真的缺学分的话，换个课吧
127568,3055,厉小润,2020-11-24 12:51:31,6,6,0,老师人很好，讲课也不错，我们寝室四个人都及格了，都上60了，可惜没上70。隔壁寝室选了这个课的同学也上60了，隔壁的隔壁有同学挂掉了的，感谢老师不挂之恩。
127569,3055,厉小润,2020-11-24 12:54:43,3,3,0,窗户，白纸，快逃·JPG🙃🙃🙃
48741,3059,王瑞飞,2017-03-11 02:54:57,0,0,0,经验丰富
50897,3059,王瑞飞,2017-05-08 06:54:48,0,0,0,经验丰富
181681,3059,王瑞飞,2023-10-28 03:37:13,1,1,0,垃圾老师
8207,3074,盛况,2015-09-17 12:21:27,14,18,4,男神好老师
11530,3074,盛况,2015-12-03 16:32:18,1,2,1,男神老师
16166,3074,盛况,2016-01-17 11:09:51,2,4,2,好老师，认真负责，课堂报告要好好准备才行。
22445,3074,盛况,2016-03-06 05:35:54,9,11,2,盛老师知识面很广，讲课深入浅出，有条理，再复杂的问题，他都能让你听懂。而且他很欢迎同学问问题，会耐心的讲解！他是一位难得的好老师。
40971,3074,盛况,2017-01-07 04:14:07,5,9,4,“全球最懂IGBT的人数十个，盛况老师肯定在里面”
63848,3074,盛况,2017-12-17 12:23:11,28,36,8,全国最懂IGBT的人是石健将
74328,3074,盛况,2018-02-11 05:53:46,6,8,2,院长大大讲课很清晰，很和蔼哦，而且还在课上讨论保研政策的修改，就这一点挺萌的
75086,3074,盛况,2018-03-07 09:12:11,6,8,2,不知道为什么 院长讲课就是很听得进去，各种比喻形象生动，是男神了
96897,3074,盛况,2019-01-21 12:02:20,4,6,2,强就完事了。理论扎实，思路清楚。
151474,3074,盛况,2022-03-04 07:07:34,1,1,0,还行吧
200963,3074,盛况,2024-10-25 12:03:33,2,2,0,据说要去湖师大了？
206655,3074,盛况,2024-12-17 03:17:31,1,2,1,湖师大应该是假的，下个学期还有他的课
214844,3074,盛况,2025-02-18 08:04:51,1,1,0,温文尔雅，讲课深入浅出、引人入胜，即便是听过很多遍的东西都能讲出更深刻的见解，简直就如同降下神谕般的男人\n\n\n\n另外课上盛院长也说了在湖师大那边有副校长的工作，估计以后还是会去那边吧。但不管怎么说，先好好珍惜盛院长的课便是了
216578,3074,盛况,2025-03-19 00:58:55,4,4,0,电力电子器件课，除了第一节课之外从未来过。。。why讲课让人感觉很命苦啊/(ㄒoㄒ)/~~
9071,3091,方鸽飞,2015-10-12 06:03:52,0,0,0,好多人选他的课。。。。
45992,3122,黄晓艳,2017-01-20 10:52:24,-24,5,29,很好，亲戚还不给我5
60310,3122,黄晓艳,2017-10-17 05:35:46,10,12,2,好像再看两杯速视频的电拖课
62635,3122,黄晓艳,2017-11-28 14:22:26,-12,0,12,上课不好\n\n给分不好
63310,3122,黄晓艳,2017-11-30 10:30:47,-13,0,13,教学水平一般，主要是给分太坑
79582,3122,黄晓艳,2018-06-11 00:25:09,2,3,1,还好吧
90329,3122,黄晓艳,2018-11-23 07:16:30,-9,3,12,给分确实是坑了点。不如卢琴芬老师。。。
120193,3122,黄晓艳,2019-11-24 01:35:18,7,7,0,好老师！！！！！
133497,3122,黄晓艳,2021-03-01 09:16:18,11,12,1,老师讲课中规中矩，给分其实很客观的，期末考的好给分肯定好啊
134135,3122,黄晓艳,2021-03-17 01:09:49,9,9,0,黄老师人真好，打心底为学生着想呐
150729,3122,黄晓艳,2022-02-16 06:22:59,-10,0,10,水平低，上课念稿子
218522,3122,黄晓艳,2025-04-24 07:02:20,5,6,1,机器人关节电驱系统，好课，好老师
218871,3122,黄晓艳,2025-05-10 05:43:28,4,4,0,机器人关节 备课认真，内容干练
220058,3122,黄晓艳,2025-06-14 10:33:13,1,1,0,考试周摸鱼刷下查老师，顺便给上学期的老师评价一下。《机器人关节电驱系统》，第一次开，5个人上，不知道下次还开不开了。课程非常轻松，就只有三次实验，两次要写报告，报告模板都有，贴个图算个数据就行。课程本身设置也还不错，毕竟与时俱进，虽然上课没很认真听，但最后也还是学了一些东西，实验也挺有趣的，难度也不大，都有老师或者研究生带着做。\n\n老师非常好，弄错实验时间撞到饭点，还请我们吃肯德基。最后给分就不必多说了，本来也就两个很水的报告，所以老师主观因素很大。个人觉得综合体验应该大学三年独一档了（其实大四也没啥课了）\n\n好像老师现在也不怎么上本科生的课了，不知道这门课还开不开，如果遇到老师还开这门课，或者其他选修课，冲就对了。
51776,3168,文福拴,2017-06-09 15:19:46,0,1,1,好！好！
87137,3168,文福拴,2018-09-21 01:54:34,1,1,0,说话说不清
90024,3168,文福拴,2018-11-21 16:53:13,1,1,0,有作业上课的时候不布置，课下通过一个同学突然发了一个通知说要交作业结果今天通知你牛了就要交！真的很过分啊！完全不给时间准备啊也不管大家能不能及时收到通知也不管大家那一天是不是很忙有没有时间，早一点通知有论文要写是会怎样啊！
120212,3168,文福拴,2019-11-24 04:00:03,3,6,3,上过他的课，堂堂都去，但，不知道老师长啥样。
181834,3168,文福拴,2023-11-02 03:21:02,3,3,0,这个讲座课怎么什么也没有
199044,3168,文福拴,2024-09-14 09:31:37,0,0,0,事情不多，给分还行
215033,3168,文福拴,2025-02-20 07:17:47,1,1,0,好！好！好！
215034,3168,文福拴,2025-02-20 07:19:20,0,0,0,老师的课特别好，都不点名
215035,3168,文福拴,2025-02-20 07:19:46,0,0,0,老师非常好，推荐
25362,3173,孟濬,2016-05-16 03:24:48,5,18,13,老师逼格很高
26772,3173,孟濬,2016-06-21 05:40:24,0,9,9,有意思
40783,3173,孟濬,2017-01-05 12:20:40,0,11,11,老师人很好！
51082,3173,孟濬,2019-07-05 09:09:35,16,28,12,满嘴跑火车，毫不务实
52375,3173,孟濬,2018-06-26 15:25:50,17,24,7,课讲得一坨翔一样还自以为是地说自己从来不备课。
54923,3173,孟濬,2018-06-26 15:25:42,6,9,3,其实我来到这里就是想看一下期末考试考的都是复习ppt上的吗
81037,3173,孟濬,2018-07-03 11:49:22,5,10,5,老师很有激情
82400,3173,孟濬,2018-07-08 05:38:01,11,13,2,就70％大作业，自己设计一个运控系统做出来，0.3期末，稍微复习吧，临考PPT翻书。总之给分不错，有点跑火车，天天灌输动手实验，不要死读书的理念。。最后几节课，上课才到20个人，（自动化90选），总之老师有点不靠谱，大作业展示好好搞就OK
109638,3173,孟濬,2019-06-18 06:09:09,0,4,4,搜易贼
114120,3173,孟濬,2019-07-09 00:16:39,0,8,8,孟老师人真的很好，给分我感觉是我大学见过最好的老师，必须给10分好评啊
114436,3173,孟濬,2019-07-10 02:58:19,1,8,7,老师很好
119180,3173,孟濬,2019-11-11 04:20:05,8,11,3,一点都不靠谱
133787,3173,孟濬,2021-03-05 10:39:43,0,6,6,非常稳！
138045,3173,孟濬,2021-07-07 07:24:07,7,8,1,考试的时候真是被你叭叭叭烦死了
139357,3173,孟濬,2021-07-14 16:49:40,21,27,6,上课大部分时间在说自己学生的优秀作品和无人机之类，课程内容不怎么讲。重视大作业，大作业占比70%，考试只有30%。而且大作业评判很玄学，偏爱有趣的作品，而不是有技术含量的作品，还特别喜欢女生的作品。给分还行，我猜平均分有90
142801,3173,孟濬,2021-11-16 08:34:10,-4,5,9,真心待学生的老师
145660,3173,孟濬,2021-12-31 03:24:51,2,5,3,和许力形成鲜明的对比
149268,3173,孟濬,2022-01-15 03:03:02,18,26,8,"出分第一时间来评价，我们组四个人，两个男生3.9，两个女生4.5，我是男生，大部分工作是我们组另一个男生做的。之前有条评论说""喜欢女生的作品""，现在看他还喜欢给女生高分。展示时候需要录视频，一直找我们组两个女生帮忙，非常关心她们；考试结束之后要留两个同学，至少十几个男生没走，他点名让坐在教室中间的一个女生留下，大家考虑一下，懂得都懂。有搞小团体的倾向，谁和他请教的多就对谁印象好，展示时候我们前一组，读了两分钟组员感想他都二话没说，到我们还在讲技术细节他就不停的催""讲重点讲重点""，表面也对我们举大拇指，实则心口不一！最后的报告就看心得体会，技术部分基本不看，我详细的介绍我的工作就给我两行回复，什么都没做的人只要心得体会写得好，那就是你做的！他会很高兴，给你一长篇回复。不公正！不求是！\n\n之前还觉得他不停鼓吹的""敢闯会创""挺好的，现在看，也就这样。什么讲课啊，什么大作业都别讲了，同一组的给分居然出现两个男生3.9两个女生4.5，这就是最大的不公正！\n\n我就说这么多，这门课本身还行，他之前的9+分数也不算空穴来风，但我说的也都是事实，大家自己判断"
149294,3173,孟濬,2022-01-15 04:04:07,9,12,3,老师其实不怎么样。偏爱女生，偏爱关系好的这些问题，其实之前就有，但那时大家成绩整体相差不大。这一届给分突然变差，就觉得很多不公平一咋显现。\n\n我的一位朋友C了全组，却比组里没干活的女生整整低了0.6。我们组技术上也不差，但因为没和老师讨论和老师关系一般成绩也不高。\n\n老师在群里针对成绩的话很虚伪，睁眼说瞎话。
149295,3173,孟濬,2022-01-15 04:12:26,9,12,3,讲课巨烂，这届给分也不好，楼上同学说的属实，他确实很偏向女生。而且运动控制这门课的课程设置就有问题，我们这届自动化根本没有学过电机，啥都不懂就去上电机控制，根本听不懂。而且大作业过于看中新颖好玩，也不考虑具体实现难度。总之这门课的大作业评分标准模糊，很大程度上取决于老师个人印象；考试也很迷，因为没有电机的基础只能靠开卷资料，大家都不太会。自动化培养方案里运控和过控二选一，虽然过控事情很多很烦，这门课相对水一些，但是还是建议慎选。
149309,3173,孟濬,2022-01-15 05:09:12,0,9,9,整体还是推荐的。\n\n事情不算多，比过控应该是少很多了。平时没有作业，也可以不听课。\n\n大作业更注重好玩有趣，而不是技术难度。做的时候要和老师多交流，刷个脸熟。\n\n今年分数低，老师说是因为大家电机基础比较差，卷面得分低，但也有说法是要和过程控制分数平衡，整体上给分确实没以前好。\n\n另外看到有评论说没有电机基础，上这门课之前先学电气控制技术，应该会好很多。
149354,3173,孟濬,2022-01-15 07:05:28,10,15,5,两个字概括：离谱。\n\n从来没在这个平台上评论过，这次实在是受不了了。第一次感受到有这样一个能够评论老师和课程的平台的重要性。\n\n先说老师吧。能力水平一般，最擅长的是吹牛和说空话。对于学生做的大作业，丝毫不关心技术细节。提交大作业之后收到的回复要么是简单的收到，要么是跟大作业内容一点关系都没有的长篇大论，净扯一些宏大的东西，一句跟课程本身相关的实在的话都没有。\n\n期末考试也离谱到了一定境界，连复制粘贴PPT的原话作为选择题的4个选项之后都能现场自圆其说，说题目没有问题，甚至会单独走到平时跟他走得很近的学生边上告诉他答案是什么。至于考卷上病句、错别字连篇就不提了。\n\n值得一提的是，非常偏爱平时找他讨论多的学生，这些组在展示时间紧张的情况下说了半天心得体会也不会被叫停；而没有跟他混脸熟的、正常做大作业的组甚至会在讲技术细节的时候被催讲快点。无语，无奈。\n\n除此之外，非常喜欢女生，喜欢接近女生，喜欢给女生高分，喜欢女生做的作品，哪怕是无聊、没有难度的作品，也会说可以量产。\n\n就说到这里吧，虽然在寒假之初收获低成绩很难受，但是以上所言都是真的，自己慎选吧。
152621,3173,孟濬,2022-04-16 05:50:45,0,1,1,...
156125,3173,孟濬,2022-06-17 16:24:09,2,2,0,他真的很喜欢电磁学
161243,3173,孟濬,2022-11-02 03:09:45,9,12,3,什么lj，明知道运控这门课只给电院预置了，还专门拒掉控院补选的学生
178785,3173,孟濬,2023-07-22 13:11:59,13,13,0,运控这课感觉没啥太多的收获，给分中偏下吧
179401,3173,孟濬,2023-09-14 11:33:46,12,12,0,他真的很喜欢bb
183708,3173,孟濬,2023-11-29 05:58:22,22,23,1,“好玩”“玩”，你的关注点就只有好不好玩是吧。老师上课一般般，不过到了大三大多数专业课也就这样了，这也无可厚非。但真的很能看出来，这老师的对于大作业的评分标准就是好不好玩，对于技术细节关注度可以说是非常低，了解了下班级里的大作业选题，基本都是紧贴“好玩”这个主题，甚至于有些选题我都怀疑到底能不能单纯凭几个大三的同学在一个月内完成。\n\n要是这门课要是给分都不行，那你妈就真死了
189847,3173,孟濬,2024-01-31 05:38:50,21,22,1,给分纯烂，不如过控，呵呵
189849,3173,孟濬,2024-01-31 07:31:57,17,17,0,早知道选过控了。。。。
189921,3173,孟濬,2024-02-02 10:45:28,16,16,0,给分真烂，不知道班里的女生得分怎么样。
189983,3173,孟濬,2024-02-05 17:12:22,19,19,0,我的评价是纯➗
203294,3173,孟濬,2024-11-19 03:06:33,11,11,0,虽然运动控制比过程控制事情少很多很多，但真的有点难评。。
203752,3173,孟濬,2024-11-21 02:37:45,11,11,0,除了事情少几乎没什么优点，抽象且啥都学不到，适合对成绩没有要求混个学分的选…
205402,3173,孟濬,2024-12-05 23:28:11,15,15,0,上这课真是这辈子有了😅
205600,3173,孟濬,2024-12-10 04:10:52,12,12,0,唐完了
207671,3173,孟濬,2024-12-23 15:28:39,7,7,0,当年可是我专业选修课最低分，早知道选过控，起码努力点分数掌握在自己手里。\n\n这门课做了一堆事情，最后分数莫名其妙
208496,3173,孟濬,2024-12-28 11:45:41,-8,2,10,很好的老师，运控我的神
209432,3173,孟濬,2025-01-06 02:54:49,15,15,0,上课上的和考试考的都是什么狗史😅
209469,3173,孟濬,2025-01-06 04:55:14,15,15,0,初生东曦，碧阳晚意
209471,3173,孟濬,2025-01-06 04:58:02,15,15,0,考的什么东西，自己题目都不知道在说什么，之前看98学长说不用复习，我没信，考完发现还真是，白吃史
209474,3173,孟濬,2025-01-06 05:04:18,9,9,0,史诗级老师，简称史
209479,3173,孟濬,2025-01-06 05:08:27,11,11,0,不评价人机，运控是我上了三年最赤石的一门课，真赤石
211458,3173,孟濬,2025-01-11 13:30:55,8,8,0,不配当老师
212772,3173,孟濬,2025-01-15 01:23:38,-10,2,12,老师给分挺好的，不过讲课有点云里雾里，点名差不多两节课一次，对自学来说还好，真要听课的话可能会有点难度
213615,3173,孟濬,2025-01-18 15:03:34,8,8,0,给分好个牛魔
213887,3173,孟濬,2025-02-02 15:39:06,12,12,0,牛魔的14天过了还不出分，不知道改没改，改了又是不是在根据性别调分\n\n\n\n\n\n\n\n\n\n1.6考完，2.2出分的，非得拖到过年
214426,3173,孟濬,2025-02-02 15:13:55,4,5,1,考试前觉得这课莫名其妙，考试后觉得比人机还恶心，出分后让我想去举报这节课。\n\n请问老师你教了什么，考了什么？大作业是要“好玩”的，考试题是重点不清乱七八糟的。这节课的意义在哪里，在取悦孟老师您吗？大过年的出分还给分如此之差、真要命了。建议学弟学妹们选过控（至少过控知道自己在干什么唉。
214446,3173,孟濬,2025-02-04 13:52:41,9,9,0,非要扯你那个逼AI，有病吧？PPT做的和史一样，东拼西凑，还说自己的PPT通俗易懂？一门什么都学不到的烂课。
214458,3173,孟濬,2025-02-05 09:24:44,1,3,2,24-25秋冬的给分似乎还行，但是无论是上课考试大作业都是纯抽象，纯纯吃史。想要水是可以真的很水，但也是学不到任何东西。
214848,3173,孟濬,2025-02-18 08:47:52,-6,2,8,挺好的，给分很高
7452,3238,祝长生,2015-09-14 12:18:44,-36,7,43,很幽默，旁征博引，会涉及到很多东西
7512,3238,祝长生,2015-11-25 06:58:17,3,6,3,我不给予评价，我无语了
8781,3238,祝长生,2015-09-28 11:46:02,3,8,5,有些知识没讲清楚
9291,3238,祝长生,2015-10-20 06:50:57,4,6,2,讲的没什么内容
10601,3238,祝长生,2015-11-20 13:32:30,4,8,4,讲得很好考试一坨屎
10615,3238,祝长生,2015-11-20 15:31:45,16,19,3,通识课老师都跟我有仇吗？！！
10626,3238,祝长生,2015-11-21 02:40:07,23,45,22,上课水得一比，很多知识自己都讲不清楚，分数。。卧槽我只能说我尽力了，看到分数想死
10627,3238,祝长生,2015-11-21 02:49:27,3,7,4,就是老师太消极 讲的还可以
10723,3238,祝长生,2015-11-23 03:26:36,4,7,3,上课很好，考试我就呵呵了，明明都是上课讲过的题目，我都认真记了结果这个分数。。。
10738,3238,祝长生,2015-11-23 03:56:18,15,20,5,当你听他讲课时，你不会后悔选了这门课，到当你看到自己的分数时估计连他人都会替你后悔选了这门课。
10926,3238,祝长生,2015-11-23 10:30:29,12,13,1,绩杀一个，讲的东西书上都有而且讲的还不好，上这门课完全没卵用，认真做笔记，考试照着写，一样挂，选择需谨慎\n\n
11057,3238,祝长生,2015-11-24 04:21:27,4,4,0,很无语
13072,3238,祝长生,2015-12-24 17:12:38,3,3,0,我也是醉了
15590,3238,祝长生,2016-01-15 13:21:22,4,7,3,爸爸想骂人
33751,3238,祝长生,2016-09-21 10:30:39,2,3,1,可以的，耳朵不太好使。\n\n
34863,3238,祝长生,2016-10-25 12:35:40,3,5,2,什么都讲不明白\n\n
34879,3238,祝长生,2016-10-26 05:47:23,14,17,3,臭傻逼
36060,3238,祝长生,2016-11-23 01:27:33,2,8,6,老师上课有一些难点还会特别另讲，上课稍微认真听80+肯定有
36163,3238,祝长生,2016-11-10 16:29:58,3,3,0,肯定不过考试
37470,3238,祝长生,2016-11-19 03:09:40,11,13,2,讲座课一上课就说不想听可以走，没见过这样的老师。
37822,3238,祝长生,2016-11-21 08:19:08,2,8,6,绩杀老师，考试有几道题完全没讲过，还要求画图？！我认认真真做好了每一页ppt的笔记，然后去考试，看到题目简直一脸懵逼，还好最后有85分?，但是绩点为什么tm是3.9，表示不服???
37839,3238,祝长生,2016-11-21 10:25:12,5,6,1,上课把ppt抄完考试照样崩。
38012,3238,祝长生,2016-11-23 05:02:13,3,7,4,怎么说吧，按老师说的，认真听课，好好完成作业（不仅要整理上课内容还要仔细思考），思考老师上课提的问题，考试还是可能会过的。。。
38633,3238,祝长生,2016-12-13 02:40:51,2,4,2,认真听讲做笔记，可是分没有达到自己的预期!
41121,3238,祝长生,2017-01-09 09:16:14,11,12,1,这真是伤了大一新生的心。。。没心情挣绩点了，不知道怎么打分的。。。。\n\n\n\n
42489,3238,祝长生,2017-01-14 09:28:05,5,6,1,全程懵逼，老师自己也不知道在讲什么！！！
53077,3238,祝长生,2017-06-25 10:01:29,3,3,0,太不负责  学不到东西
59244,3238,祝长生,2017-09-20 10:41:33,-21,3,24,老师。讲课很深入的，赞
61913,3238,祝长生,2017-11-21 15:11:28,-15,2,17,其实老师还是挺好的，虽然我不知道我的绩点有多少，但是我愿意给这个评价。
65090,3238,祝长生,2017-12-28 15:30:59,52,57,5,呵呵，在他的课上我和同学上了十多颗星
71920,3238,祝长生,2018-01-29 05:46:23,4,4,0,怎么没有零分？我怕自己的笔记不全，特意又朝学长借的笔记，尼玛3.0？
87060,3238,祝长生,2018-09-20 06:13:29,-48,3,51,电气学子满绩打卡
88381,3238,祝长生,2018-10-30 02:11:08,4,5,1,这个是真的蠢
88506,3238,祝长生,2018-10-31 11:55:22,3,4,1,睡觉(＠￣ー￣＠)
88622,3238,祝长生,2018-11-15 12:35:08,-20,4,24,还行吧
89095,3238,祝长生,2018-11-15 12:34:56,6,7,1,考试真是一种煎熬，认真听还听不懂，考试全程懵逼。
89096,3238,祝长生,2018-11-15 12:47:33,40,52,12,考试题很简单? ? ?都是课后习题? ? ?为什么我不知道? ? ?每次第一排C位，ppt全拍+认真认真做笔记.还是无能为力啊!可能是我太笨了吧?\n\n    老师自己很消极，觉得听不听是我们的事，而且讲课丝毫没有重点可言啊!神奇的是有-次竟然赶火车提前下课了? ?\n\n    好吧好吧，不强求了，毕竟老师人品不错，从来不点名，也不布置论文什么的，只希望考试及格吧。\n\n(现在我知道3.0也是有原因的_(´ཀ`」 ∠)__ )
89619,3238,祝长生,2018-11-20 03:48:04,17,18,1,这老师蠢得一批 看着就很傻 看到绩点想死 非此专业千万别选\n\n
89677,3238,祝长生,2018-11-20 08:17:15,4,5,1,认真听拍ppt还是绩杀
89760,3238,祝长生,2018-11-20 15:50:39,6,8,2,真的很差，哪怕对这门课很感兴趣也别选！！！老师讲的稀里糊涂的，自己也不知道自己在讲什么，总是说:反正就这样，就这么点东西。倒不是说绩点给的低就是差老师，但是，我笔记是全的，完全把ppt上的东西记下来了，考试也原原本本地写上去了，旁边的人看我写了这么多都傻眼了，其他人都是每道题瞎写一两行就没了，我真不知道3.3怎么改出来的，而且卡分数，明明可以80到3.6非要79
89790,3238,祝长生,2018-11-21 00:29:24,5,6,1,老师讲得乱七八糟的，绩点就不说了，总之选了就凉了。
89981,3238,祝长生,2018-11-21 12:32:38,4,6,2,千万别选，非本专业听着就是去死。作为一个社科生选完全是为了凑培养方案科技创新的通识，尼玛上课水的要命，非常无聊，认认真真记笔记从不缺课迟到还是不行，绩杀绩杀，看到成绩我都呵呵了，2.7
90425,3238,祝长生,2018-11-23 12:41:07,1,7,6,老师讲的不是很深的知识，只要你对自动化感兴趣，并愿意努力学，其实考试容易得很。
90869,3238,祝长生,2018-11-27 01:58:42,5,7,2,为什么查老师不能打零分？
91632,3238,祝长生,2018-12-17 00:01:01,3,4,1,挂科了你叫我说啥???
94526,3238,祝长生,2019-01-17 05:20:47,-1,4,5,知识丰富，虽然无聊，但对电气专业极有帮助。
100752,3238,祝长生,2019-01-26 17:12:49,10,12,2,…挂辽。。。。\n\n非本专业千万别选。。\n\n老师从来不会布置作业，也不会点名，全屏期末试卷。。。就算认真做笔记，认真拍照，认真准备，em。。后悔ing，一个文科女为什么要选这个…
114823,3238,祝长生,2019-07-12 01:16:21,1,5,4,电院知名儒雅随和
117032,3238,祝长生,2019-09-18 11:46:13,3,3,0,我死了啊
117148,3238,祝长生,2019-09-20 01:18:42,4,4,0,机电一体化这门课听下来意义不大，反正我听下来没学到什么东西。分数给的也不高。
118817,3238,祝长生,2019-11-14 09:00:58,3,3,0,ppt多\n\n不点名\n\n考试一半多是课上讲过的\n\n然后剩下？？？
119569,3238,祝长生,2019-11-15 03:28:41,4,4,0,浪费时间
119581,3238,祝长生,2019-11-14 02:14:45,4,4,0,无话可说
119587,3238,祝长生,2019-11-14 03:03:16,6,7,1,本来就是为了水学分的，绩点放弃。课讲得一般，没一节课是听的，刷完了一千多集的名侦探柯南（跳着看的），最后考前突击，万岁我及格了
119598,3238,祝长生,2019-11-14 04:13:19,-5,3,8,认真拍PPT记笔记不会绩杀的！（有被以前评论吓到战战兢兢半学期）有没有学到东西见仁见智吧～我觉得还可以哦
119599,3238,祝长生,2019-11-14 04:39:38,4,4,0,我服了，被无情绩杀
121479,3238,祝长生,2019-12-15 14:00:24,3,3,0,上课基本没有什么内容，ppt拍了还是有一半的题用不上，无情绩杀
126017,3238,祝长生,2020-09-16 13:14:00,3,3,0,感觉不好
127255,3238,祝长生,2020-11-17 09:46:17,4,4,0,老师很无语，随便换课，上课啰嗦，无聊，自己承认水时间
127442,3238,祝长生,2020-11-25 10:53:25,5,5,0,哈哈哈哈呵呵呵呵
127649,3238,祝长生,2020-11-25 10:34:05,6,6,0,有一说一，我反正是懵逼了，自认为每个题都有记过，但还是绩杀。。。\n\n只能说非本专业别选
127792,3238,祝长生,2020-11-27 06:26:08,6,6,0,没有内容，绩点低，考试内容超出上课讲的范围
128689,3238,祝长生,2020-12-25 04:23:24,-13,0,13,还不错 考试难度适中
136142,3238,祝长生,2021-06-11 09:10:30,2,2,0,垃圾老师
141295,3238,祝长生,2021-09-29 01:58:14,2,2,0,就这态度啊
141311,3238,祝长生,2021-09-29 08:02:13,6,6,0,没人求着你上课嗷
143146,3238,祝长生,2021-11-20 03:15:57,1,1,0,平时不点名，每节课都来，每节课都有作业，最后考试做了很多笔记但是大部分没啥用，最后绩点3.6，反正是一分耕耘一分收获吧，除了最后抄笔记没用多少时间，感觉拿水学分是可以的，但是想要高绩点绝对要花时间，慎选
143152,3238,祝长生,2021-11-20 04:02:00,1,3,2,他妈的只能说没兴趣就不要选 平时也不知道怎么学 咱也不知道讲得怎么样反正也听不太懂 拍拍ppt给了3.3有点太拉了md
143186,3238,祝长生,2021-11-21 03:09:31,-1,2,3,老师上课啰嗦，课比较水（不过看你怎么理解通识课了，二倍速刷智云课堂的时候觉得对我一个大一新生蛮有收获）。老师从不点名，也基本不留作业。智云课堂听一听，笔记记得勤一点，想获得一个较高的绩点还是不难的。
152014,3238,祝长生,2022-03-23 05:59:30,2,3,1,很像黄猿😢
155102,3238,祝长生,2022-06-08 09:46:31,2,5,3,垃圾老师，狗都不选
160311,3238,祝长生,2022-09-18 14:42:05,2,2,0,xswl，ex
160616,3238,祝长生,2022-09-28 07:00:02,11,11,0,屁老师，天天说屁，本科生是个屁，你是个臭屁
164825,3238,祝长生,2022-12-26 11:09:47,-4,1,5,仙人抚我顶，结发祝长生。\n\n好名字，好老师
165728,3238,祝长生,2023-01-09 12:38:41,8,9,1,ppt抄了，每次坐一、二排，绩点2.7。真好
170690,3238,祝长生,2023-03-08 07:29:34,-16,0,16,讲干货的老师
173078,3238,祝长生,2023-05-12 12:32:47,17,17,0,傻逼东西祝你死全家你妈了个逼
173104,3238,祝长生,2023-05-13 12:33:40,8,8,0,选了他的课，成功的拿到了大学最低的绩点，不想说什么了
182019,3238,祝长生,2023-11-08 07:38:13,5,5,0,纯恶心人，跟学生有仇吗
184852,3238,祝长生,2023-12-23 12:49:26,4,4,0,纯纯艾斯比
47498,3257,颜文俊,2017-01-28 07:29:36,15,24,9,学弟学妹们，反正也是避不开的，就当作个心理准备吧。不备课不调分不好好出试卷不准时上课不准时公布成绩，大年初一让你的绩点爆炸。嗯，没见过更让人无语的老师了，good luck to you guys......
58869,3257,颜文俊,2017-09-18 06:53:14,-1,0,1,博古通今，娓娓道来
73338,3257,颜文俊,2018-02-01 11:06:49,0,0,0,很认真的老师
73344,3257,颜文俊,2018-02-01 11:21:55,2,4,2,15级自动化的同学求求你快出分吧
74123,3257,颜文俊,2018-02-05 11:11:37,1,2,1,老师很可爱 讲课还是比较认真 会扯一些课外的东西或者是一些科研项目 一些基本概念会讲清楚来龙去脉 至少两个老师中 这个老师上的课还是听的懂的 作业布置的也还可以
75550,3257,颜文俊,2018-03-13 06:58:43,1,1,0,颜老师很可爱的，比另一位老师讲的清楚。来自绝望而无聊的现控课。
132291,3257,颜文俊,2021-01-31 14:10:52,3,3,0,挺好的老师，希望给过
133495,3257,颜文俊,2021-03-01 09:13:26,7,7,0,老师讲的挺好的，但是这门课是真的难
144756,3257,颜文俊,2021-12-23 12:45:10,0,0,0,好纠结
152450,3257,颜文俊,2022-04-11 16:12:03,1,1,0,教室人越来越少，老师你不应该反思一下为什么吗？
157773,3257,颜文俊,2022-06-24 18:27:38,4,4,0,挺有趣的老师，不过为啥状态空间那块压根没讲？考试考了一道大题呢
178375,3257,颜文俊,2023-07-11 05:40:05,-1,0,1,自控炸了，但是老师讲的挺好，自控是一款我的问题。状态空间和微分方程还是没讲，不过自己学比较重要
186348,3257,颜文俊,2024-01-10 14:41:07,1,3,2,讲的真烂，还对不来的同学耿耿于怀？也不知道有没有做手脚故意扣分数，笑死，听隔壁zyh老师网课收获远远是你的多少倍，你不反思一下自己的原因怪同学不来干什么？非要强拉着在你的教师里听别的老师的网课你才满意？
188924,3257,颜文俊,2024-01-20 16:10:34,0,1,1,公正评价，老师还行，讲课认真，至于讲课当然还是zyh老师最好，不过颜老师也算挺认真的
197177,3257,颜文俊,2024-07-08 17:08:43,2,2,0,感谢老师不挂之恩🙏🙏
197217,3257,颜文俊,2024-07-09 09:40:49,2,2,0,讲的不行，给分一般，没有小测，偶尔不来上课让助教上习题
197238,3257,颜文俊,2024-07-09 17:04:49,1,1,0,给分真差！
197285,3257,颜文俊,2024-07-10 08:52:26,3,3,0,班上最高是95分，平时分给得不是很高，对比zyh班上可以说惨淡。\n\n\n\n讲课一般，蜻蜓点水式地讲，主要靠自己学。最大的问题是这门课现在貌似控院出题，但是讲课的教材PPT是老师自己做的，进度很不统一。习题课很抽象。唉，选了ywj老师就等着自己学吧
10559,3286,林志赟,2015-11-20 01:57:24,3,5,2,快的一笔不建议选
10567,3286,林志赟,2015-11-20 03:02:02,3,4,1,太快了
10867,3286,林志赟,2015-11-23 07:50:43,1,3,2,一般般
16533,3286,林志赟,2016-01-18 10:19:59,4,4,0,给分很坑，
24670,3286,林志赟,2016-05-03 04:04:54,1,2,1,认真听讲的话，其实讲的很好。给分跟平时是不是认真学有很大关系，刷不出来的。要是很感兴趣或者大学霸随便选，反正再给我一次机会，肯定不选FPGA了。
33601,3286,林志赟,2016-09-20 08:16:34,1,1,0,只是没课选了而已，完全不顾学生感受
35082,3286,林志赟,2016-11-01 15:11:19,1,1,0,今年上课内容，实验内容和期末大作业的用的是完全不一样的知识内容，教材完全脱离教学，慎选
413,3303,徐习东,2015-03-15 02:05:30,2,6,4,非常棒。
568,3303,徐习东,2015-03-15 05:15:49,5,10,5,老师简直不能更好！！！讲的很赞给分好棒~
47534,3303,徐习东,2017-01-30 05:14:56,17,25,8,DSP很水，给分很好，人品不行。做实验的时候不帮忙还嘲笑学生。
66972,3303,徐习东,2018-01-19 13:14:59,0,2,2,超级好的老师，很厉害，讲的详细而且认真，人很好很耐心
68301,3303,徐习东,2018-01-23 02:58:43,3,5,2,给分好，考试内容主要在最后几节课，很重要
68807,3303,徐习东,2018-01-24 02:22:02,5,6,1,这个老师教的比另外一个老师的简单点，给分也不错
71308,3303,徐习东,2018-01-28 09:20:33,1,2,1,人挺好
91284,3303,徐习东,2018-12-05 02:56:07,2,2,0,。。。
93103,3303,徐习东,2019-01-07 10:41:12,-6,4,10,学不到东西，建议选马老师
99687,3303,徐习东,2019-01-25 05:04:39,6,6,0,老师给分很好，但据我了解隔壁给分更好
117111,3303,徐习东,2019-09-19 07:48:08,-11,7,18,光看书不知所云艰涩难懂，然而徐老能让你难以置信如此枯燥的课程也能上的这么有趣
117930,3303,徐习东,2019-10-13 15:09:00,25,26,1,谁能教我怎么看他的课件啊
129405,3303,徐习东,2021-01-05 05:59:29,2,3,1,实验考试比隔壁班简单很多，讲课的内容也很有深度（虽然比较枯燥）。
145294,3303,徐习东,2021-12-29 03:00:04,4,4,0,设断点啊
146031,3303,徐习东,2022-01-05 06:27:17,5,6,1,教的很好，如果可以设断点的话就更好了
164116,3303,徐习东,2022-12-18 07:29:25,4,4,0,需要自学编程 基础不好的慎选\n\n给的课件和资料比较乱
168457,3303,徐习东,2023-02-18 03:26:47,3,3,0,不擅长编程慎选
181625,3303,徐习东,2023-10-24 13:50:58,4,4,0,上课很乱，ppt很乱，实验甚至基本全是自学
191678,3303,徐习东,2024-04-27 13:57:02,0,0,0,老师授课最早是2006年，甚至可能更早。\n\n课的内容比隔壁班少很多，考试内容少很多，也简单很多\n\n基本上用学长留下来的东西，稍微改一改就行了\n\n在这里你只需要背cmd，背文件，然后写古典老大作业\n\n虽然学不到东西，但是能拿比隔壁高的分\n\n这就是徐老师给我们正交班的自信\n\n纯默写课，建议想学的直接看前一年最后四节课，这时候才开始讲有用的\n\n我们连can都不用学，ev也不考，ad更是了解一下就好了
211724,3303,徐习东,2025-01-12 09:19:38,4,5,1,伟大无需多言
211745,3303,徐习东,2025-01-12 09:55:12,3,3,0,伟大无需多言
211747,3303,徐习东,2025-01-12 09:55:24,2,2,0,伟大无需多言
211752,3303,徐习东,2025-01-12 10:16:32,4,4,0,伟大无须多言
211846,3303,徐习东,2025-01-12 16:27:30,2,2,0,这么说吧，平时不听课，考前猛背几天期末考就能好很好了，但平时的实验是有难度的(结果实验考试又挺简单)，唯一吐槽的地方就是每隔两周就有20分钟的智云听不到
212358,3303,徐习东,2025-01-14 02:08:36,2,2,0,伟大无须多言
220059,3303,徐习东,2025-06-14 10:30:31,0,0,0,其实课程本身没学到什么，实验课有时候挺难搞的。但是考试比隔壁班应该简单，基本就是默写，一学期没咋听，最后记一记分数也还行
11702,3328,徐政,2015-12-11 17:31:48,0,4,4,nice
178942,3328,徐政,2023-08-03 01:48:43,2,3,1,讲的清楚，考试也不难
57320,3336,吕征宇,2017-07-06 15:35:29,-2,0,2,老师给分很好～
64218,3336,吕征宇,2017-12-21 15:01:41,0,0,0,还没听，试试看
102822,3336,吕征宇,2019-02-23 14:13:55,0,0,0,还行吧
104421,3336,吕征宇,2019-03-20 03:46:45,2,3,1,英语口语听的好难受。。课听着难受(✘_✘)
106926,3336,吕征宇,2019-04-30 09:44:05,-1,0,1,aho
107013,3336,吕征宇,2019-04-30 18:08:48,-4,0,4,仿真课不错，考试很简单
107114,3336,吕征宇,2019-05-01 16:12:27,2,2,0,hhhhhh
90693,3337,甘德强,2018-11-25 09:25:54,2,11,9,甘老师人一级棒！
105004,3337,甘德强,2019-04-02 06:22:15,3,7,4,ppt都不准备好就来上课，
133150,3337,甘德强,2021-02-10 11:27:33,1,8,7,误人子弟，没选上隔壁林振智就退课吧
133627,3337,甘德强,2021-03-03 03:30:44,1,7,6,快逃，去听网上的课或者隔壁林老师的课
138760,3337,甘德强,2021-07-10 16:51:35,2,4,2,甘老师讲的是不错的，虽然对稳态这门课的课程安排还不太熟悉，但是课堂上一再强调的东西都是电力系统里重要而实用的，一个学期下来感觉对很多知识点的理解都很深刻。拿matlab写潮流程序既对自己有帮助还省了小学期的事。不过估计不调分，给分应该比lzz班差一些。
159327,3337,甘德强,2022-07-13 06:02:05,1,5,4,温柔，善良，体贴的资深老师！
159620,3337,甘德强,2022-08-22 08:03:54,2,5,3,和蔼可亲，是很棒的老师！
159779,3337,甘德强,2022-08-29 11:45:40,1,4,3,有国际视野，老师挺不错。
159803,3337,甘德强,2022-09-01 04:24:22,1,5,4,蛮推荐非线性这门硕博选修课的，不错不错。
162132,3337,甘德强,2022-11-17 03:35:21,5,5,0,垃圾人一个，不做PPT，不会讲题，作业题要同学教他，不答疑，给分还烂
162294,3337,甘德强,2022-11-19 10:16:25,4,5,1,自学或者去隔壁听林振智老师课吧
168159,3337,甘德强,2023-01-31 03:22:21,7,8,1,上课划水，不会做作业题，PPT是别人的，动不动就来一句“我不知道他为什么要把这个写在这里”，答疑只有其他两个老师，给分极其烂，是我所有课里最烂的
169354,3337,甘德强,2023-02-25 14:30:00,5,6,1,老师自己对所讲的内容都一知半解，也没有备课，上课就讲了一些标题类的东西，也不会展开讲，不会深入分析，这只要认字的人都可以讲课了。
179304,3337,甘德强,2023-09-08 13:01:44,1,2,1,老师人超级好，很nice，很耐心
181850,3337,甘德强,2023-11-02 08:00:59,13,16,3,电院教学科太抽象了。本专业几乎最重要的课，五节课改四节课，冬学期改秋学期，加上国庆冲课，课时严重压缩，预修知识储备严重不足。老师赶得累，学生跟得疯。不是德强讲得快，而是到最后所有老师都只能跟上德强的节奏…
182105,3337,甘德强,2023-11-10 03:34:17,0,3,3,gdq好！
182322,3337,甘德强,2023-11-14 14:41:04,45,48,3,我在原神里肝的强。
182323,3337,甘德强,2023-11-14 14:42:36,19,19,0,我不明白为什么他的课件会出现在我的文件夹里。
182324,3337,甘德强,2023-11-14 14:43:29,15,15,0,“我不知道这位老师为什么会出现在我的电力稳态课上”
182523,3337,甘德强,2023-11-17 03:26:18,0,1,1,一般般
182596,3337,甘德强,2023-11-18 03:28:19,2,3,1,挺实在的老师，有详有略。
190452,3337,甘德强,2024-03-04 13:14:07,4,4,0,上课没必要去听
198757,3337,甘德强,2024-09-11 11:02:04,13,13,0,“这我也不知道，我不感兴趣，你们自己看看”“我主要领域不在这儿”
199047,3337,甘德强,2024-09-14 10:46:03,12,12,0,你在教集贸呢
201528,3337,甘德强,2024-11-04 06:07:05,-17,1,18,电力系统稳定分析的甘老师具有深厚的专业知识和丰富的实践经验，能够深入浅出地阐释复杂的理论和概念。他不仅具备扎实的数学和物理基础，还能灵活运用各种工具和技术来分析和解决问题。在课堂上，他总是耐心指导、鼓励学生提问，营造了良好的学习氛围。通过他的教学，我对电力系统的理解得到了极大的提升，为未来的工程实践打下了坚实的基础。\n\n甘老师的奉献精神和对教育的热爱，深深地激励着我们！
202711,3337,甘德强,2024-11-14 03:04:26,-1,1,2,我也不知道怎么评价，我也不想评价，因为我很懒
384,3372,吴晓波,2015-03-15 01:45:28,-1,2,3,嗯。。挺好的～
14948,3372,吴晓波,2016-01-11 07:36:30,2,9,7,晓波男神很棒！不过学院是什么鬼。。
19703,3372,吴晓波,2016-01-25 06:24:31,-1,11,12,说实话讲的很一般 觉得太水了
35483,3372,吴晓波,2016-11-10 07:20:55,-1,7,8,男神?虽然吴老师本科是电院的，但现在不应该是管院的吗
74998,3372,吴晓波,2018-03-07 02:42:20,-4,2,6,老师比较幽默风趣
83615,3372,吴晓波,2018-07-10 23:58:54,-1,0,1,给分不错的(*๓´╰╯`๓)♡
93963,3372,吴晓波,2019-01-14 13:19:55,0,3,3,遗憾少听了一节课，很有魅力的老师
143258,3372,吴晓波,2021-11-22 12:54:07,2,2,0,上课喜欢点名，点人回答问题
548,3400,杨莉,2015-03-15 04:45:19,9,14,5,她的《电力经济》讲得好，老师人也好，很乐于帮助努力的同学。不过这门课还是未洗去“绩点杀手”的名声（2014年）。
25994,3400,杨莉,2016-06-15 03:14:57,1,2,1,好！好！
33995,3400,杨莉,2016-09-25 05:16:02,-2,1,3,还行。。。
34350,3400,杨莉,2016-10-06 03:15:01,1,2,1,呵呵呵呵呵呵呵
34354,3400,杨莉,2016-10-06 06:06:23,1,1,0,66666666
37614,3400,杨莉,2016-11-19 22:21:10,1,2,1,对学生不错，挺好的
38178,3400,杨莉,2016-11-25 09:08:13,-12,0,12,发电厂电气部分，水课考前刷一夜
59187,3400,杨莉,2017-09-20 06:28:47,18,20,2,压水zui和沸水zui
61741,3400,杨莉,2017-11-20 12:55:52,5,6,1,老师不错，但是发电厂这门课真的是，又难又无聊绩点还低还不好复习，而且还是闭卷
62768,3400,杨莉,2017-11-27 02:33:44,3,3,0,这课简直了，内容多还没重点，关键老师出题全是偏门知识点，无语了
62846,3400,杨莉,2017-11-27 06:37:24,5,6,1,老师人其实很好的，不过感觉一直在念书，ppt也是书上都有的东西，有些公式可能解释的不是很详细，不是很看得懂。最后考试也比较坑，是闭卷的
62972,3400,杨莉,2017-11-29 06:42:12,-48,2,50,考前一夜果然可以满绩
71426,3400,杨莉,2018-01-28 12:06:44,2,3,1,老师人很好，就是发电厂这门课实在太没意思了...
90201,3400,杨莉,2018-11-22 12:26:03,-6,1,7,考前好好背 高分不难
90222,3400,杨莉,2018-11-22 13:59:04,-8,0,8,老师很好，上课会讲重点，还各种暗示考试会不会考某个知识点。上课重点强调的例题一定要搞懂，考试基本全考了。不仅如此，最后一节课还会划重点，以及各种暗示考试题目。考试题目90%是上课重点强调过的，只有5、6分左右的题目有点坑（比如什么输电线的A、B、C相分别用什么颜色标识）。考前用了两三天背，最后成绩很好。
90271,3400,杨莉,2018-11-23 02:20:09,1,1,0,上的发电厂，老师人还是不错的，很热心很负责，但是课程是有些无聊，讲的也都是书上写的东西。最后考试闭卷但是没划范围，1.5的课很磨人。
90514,3400,杨莉,2018-11-23 17:43:10,2,2,0,发电厂这门课不有趣但是是必修，知识点太多了每年考试内容形式都有很大差异（老师本来说是只改形式不改内容）今年计算题的那个什么经济背了公式都不顶用，得彻底理解才行。还有我希望老师能多给一分，这样我就能多0.3的绩点。别信楼下说考前刷一夜的，我上课听了考前刷了太痛苦了考试成绩也就八十多，人和人是不一样的，熬不住的，刷夜太痛苦。
117504,3400,杨莉,2019-09-25 07:27:33,0,0,0,很和蔼的老太太，满脸笑容很可爱
118866,3400,杨莉,2019-11-07 07:29:03,2,2,0,老师很温柔！
119585,3400,杨莉,2019-11-17 04:27:42,-6,4,10,背书课\n\n平时上课因为上午dsp 下午根本不想听\n\n考试周就这一门考试\n\n考前花个三四天对着重点背背差不多了 \n\n老师考场疯狂暗示，满绩挺容易的
119887,3400,杨莉,2019-11-16 17:04:55,2,2,0,谢谢老师！给分比我预料的好太多太多了！好好看98上的考试资料果然有效！
119891,3400,杨莉,2019-11-16 18:28:14,-3,2,5,满绩含金量不大
119943,3400,杨莉,2019-11-17 01:31:56,4,4,0,老师超级温柔，给分也很棒，谢谢老师！
120070,3400,杨莉,2019-11-17 09:52:12,0,0,0,老师真是太好了！
120484,3400,杨莉,2019-12-09 07:37:05,0,2,2,老师人很好，\n\n
139466,3400,杨莉,2021-07-16 07:28:54,4,4,0,老师人很好，在努力让发电厂这门课变得有趣，最后按照老师强调的来复习即可，考试难度不高。此外作为学长想跟新培养计划下的同学说，即使发电厂这门课再无聊、内容再多，它也是电力系统方向一切专业课的基础，希望未来有可能从事相应工作的同学一定要学一下。
143584,3400,杨莉,2021-11-28 02:55:27,0,0,0,我觉得很好
150651,3400,杨莉,2022-02-10 01:57:02,0,0,0,杨老师很和蔼，讲课深入浅出，备课认真，答疑有耐心，考试划重点，好！！
162107,3400,杨莉,2022-11-17 01:32:38,2,2,0,背的挺多，复习很累 但给分还行
181297,3400,杨莉,2023-10-13 08:35:11,0,2,2,快跑！
182236,3400,杨莉,2023-11-13 05:27:51,1,2,1,老师特别喜欢跟第一排的人交流\n\n然后思路很清晰\n\n背的东西挺多\n\n不过很喜欢发电厂这门课\n\n平时作业交三次，内容也不多\n\n最后ppt看了两遍书看了一遍\n\n98的资料看了三遍\n\n98分满了——\n\n不过98资料只写了水电厂厂用电率最低，没有写0.5-1，然后我这里选错了，所以书本一些概念还是要从根源出发（
202712,3400,杨莉,2024-11-14 03:06:48,1,3,2,杨老师很好，就是某沈姓助教太鲨臂了
202859,3400,杨莉,2024-11-15 02:23:24,5,5,0,虽然今年第一道大题不会写，但是给分巨好！
47872,3402,汪震,2017-02-27 00:23:11,-1,3,4,直流输电好水啊，上课不知所云
59966,3402,汪震,2017-09-29 04:40:35,0,2,2,真棒哦
116024,3402,汪震,2019-08-30 16:50:21,0,3,3,不是什么好人
117264,3402,汪震,2019-09-21 21:11:18,1,7,6,没有上他的课，是我班主任，sha bi一个
142107,3402,汪震,2021-11-06 05:10:27,-1,2,3,好老师，输电这课挺不错的
159716,3402,汪震,2022-08-24 11:25:19,1,3,2,刚开始还以为是个不错的老师，结果发现是个又菜又自以为是，自己不会教还对学生要求高的人。。。
208435,3402,汪震,2024-12-27 14:46:58,2,3,1,我是汪老师的本科生，第一次接触汪老师是去找他给实习报告签字，去之前室友说他们都是直接签名&打高分的，但是我过去的时候汪老师认真的看了我的实习报告（我是比赛替代的），然后问了我几个问题，我答不上来，他批了我一顿，告诉我不能这样不求甚解，当时挺不爽的，觉得自己很倒霉选这么一个老师。\n\n第二次是本科毕设开始，汪教授和我们谈了一下，问我们是不是都要考研，我说我没有考研打算，他又说了一些数落指责我的话，然后说人应该努力往上走，令我有些不爽\n\n第三次汪老师是在本科毕设开题答辩之后，汪老师留下我们谈了一下开题报告中存在的问题，聊完以后我说想和汪老师单独聊一下，然后跟他讲了最近遇到一些大的挫折，他却很出乎意料的没有指责我，而是很耐心的鼓励我，给了我不少好的建议；告诉我人生就是这样，过去的都翻篇了，让我以后只要保持上进一切都没什么问题。那次大概聊了半小时吧，还正当饭点，这才知道汪老师虽然表面爱挑刺，但出发点是很好的，内心底很温柔很关心学生，也很有治学的精神，比其它一些“事不关己 己不管事”的老师好太多了。我没上过汪老师的课，但出于这点我是愿意给他高分的。
73340,3404,张森林,2018-02-01 11:07:42,3,3,0,很认真的老师
74124,3404,张森林,2018-02-05 11:13:35,4,4,0,应该是对控制理论有比较深的理解的一个老师吧 上课不是很容易完整的听懂课 作业布置的比较多 喜欢把一些理论串起来讲 对基础不扎实的同学 是比较痛苦的 总体老师还是蛮棒的 上课认真
132292,3404,张森林,2021-01-31 14:11:42,5,5,0,老师很认真，讲课也围绕考研什么的
134075,3404,张森林,2021-03-15 06:12:48,12,14,2,先放前提：可能因为培养方案改革加上所谓平行班统一，老师只能按照不熟悉的书和不熟悉的院长的ppt上课。\n\n上课逻辑很差，基本就是念ppt，总是重复某些易懂，分辨不出干货\n\n不知道8分怎么来的
144755,3404,张森林,2021-12-23 12:43:36,1,1,0,该喝喝
156137,3404,张森林,2022-06-18 02:03:48,0,0,0,绝对的好老师，上大学以来见过的讲课最好最负责的老师
174647,3404,张森林,2023-06-15 04:31:30,0,3,3,喜欢搞随机小测，0
196908,3404,张森林,2024-07-06 01:16:32,0,0,0,自控被血捞到及格，满分！
196997,3404,张森林,2024-07-06 12:01:28,0,0,0,自控甲，上课不会刻意点名，但是春学期有过两次小测，主要起点名作用，讲得挺清楚的，给分也不错
198419,3404,张森林,2024-09-09 00:32:00,0,0,0,有两次小测起到一个点名的作用。老师讲课还不错，人很亲和，给分非常好。
216315,3404,张森林,2025-03-13 07:50:07,3,3,0,具体～的！
37008,3446,郑荣濠,2016-11-17 05:56:20,0,0,0,。。。。。。
38462,3446,郑荣濠,2016-12-06 01:51:21,1,1,0,给分好低
51772,3446,郑荣濠,2017-06-09 12:21:45,1,1,0,超帅的男神老师
63783,3446,郑荣濠,2017-12-14 16:32:11,0,0,0,认真负责，讲课详细，对学生体贴，给分也不错，完美。
73145,3446,郑荣濠,2018-02-01 04:19:58,1,1,0,讲课清晰，认真负责，人也很有趣\n\n
83318,3446,郑荣濠,2018-07-10 05:24:28,5,7,2,又结束了郑老师一学期的课程，机器人这门课算是电院选修课中很有内容的非水课了，的确能学到一些东西，也有动手实验和仿真实验。郑老师人也很好，考试难度适中，想学东西的同学可以考虑一下机器人这门课，想水水的还是去选供配电这种课吧。
91296,3446,郑荣濠,2018-12-05 06:49:31,5,7,2,我要是做实验前代码什么的都会写还上fpga干什么
116021,3446,郑荣濠,2019-08-30 11:53:35,0,0,0,老师很负责哈哈
133458,3446,郑荣濠,2021-03-01 03:13:09,9,15,6,老师讲课还行。不过呢，FPGA平时任务非常非常多，给分非常非常差
136795,3446,郑荣濠,2021-06-24 17:55:09,5,8,3,实验内容和难度心里没点b数吗？2.5学分的课实验还要花整体去写，以为自己的课很重要？
138131,3446,郑荣濠,2021-07-07 12:32:29,5,6,1,人很好，很不错。\n\n上的机器人课，实验报告很费时间，因为用到的是一个matlab上的robot toolbox库，这个库不稳定，有很多版本，在不同的matlab版本上运行会有不同的结果。有的时候照着ppt上的代码示例也出不了结果。老师自己也在上课时说自己有的代码也跑不出结果。\n\n为了让matlab出结果，会花很多时间，而且版本适配这类事情与课程无关，这样的时间浪费真的非常打击学习积极性。\n\n一份实验报告大概需要8-12小时来完成，我能接受，但是不能接受无意义的时间浪费在解决版本不适配导致的报错上，很痛苦很折磨很虚无很玄学。\n\n建议：有些代码如果跑不出来，可以借用一下能做出来的同学的电脑。有的时候你的版本能做出来而他的不能，有的时候会反过来，可以互帮互助。实在做不出来还可以上手修改toolbox里的函数，或者下载一个python版本的robot toolbox另起山头，不过这样会投入比较多的时间，不推荐。总体来说我认为python版本的rtb工具箱运行起来更稳定，但要自己找函数调用方法，比较烦。
139359,3446,郑荣濠,2021-07-14 17:18:02,10,13,3,机器人建模事情特别多，给分非常差。不过老师人挺好
169971,3446,郑荣濠,2023-03-01 00:17:55,3,3,0,老师人很Nice，给分也很好
173498,3446,郑荣濠,2023-05-26 10:14:29,5,5,0,机器人建模和控制这门课真的很阴间，但老师给分挺好的
189617,3446,郑荣濠,2024-01-26 04:25:22,4,4,0,FPGA，课程很硬核，对应的类似课程应该是数逻/数电+数电实验，用的是VHDL。老师上课很清楚，但最后给分感觉一般
192352,3446,郑荣濠,2024-05-16 08:56:48,3,3,0,机建上课挺清楚的，最后给分也还行。老师上课没有点名&小测，所以智云也友好。\n\n不过还是吐槽一下这课的实验，只能用“毫无指导”四个字来描述，当然这也不是郑老师的锅，是整个课程组的问题
192373,3446,郑荣濠,2024-05-17 02:10:21,-1,2,3,上课很清晰，虽然我卡绩了，应该是没有调分的，但是老师给分是很不错的，总的来说值得一上
202966,3446,郑荣濠,2024-11-15 13:01:39,5,6,1,老师讲课非常清晰，很细致，PPT也做得很容易理解，fpga是自控大三上难得的值得听课的一门了
211882,3446,郑荣濠,2025-01-13 01:07:18,-4,0,4,老师还是很负责的，但这门课也只剩下这一个优点了，课程难度非常的大，教的还是既不好学又没什么应用市场的VHDL，各种实验报告和程序能写的你头痛欲裂，课程量和实验量远大于上学期的嵌入式系统，而且给分还很差。
217384,3446,郑荣濠,2025-04-09 08:52:18,4,4,0,机建不点名不小测，满昏。就是实验的机械臂实物稳定性太差了点，
218909,3446,郑荣濠,2025-05-17 18:32:10,4,4,0,给分一坨\n\n后续：实验给分出问题了，成绩撤销\n\n再后续：出分还可以
218921,3446,郑荣濠,2025-05-17 07:05:53,3,3,0,机器人建模与控制：完全不点名不小测，上课也尚可，5.16更新后实验成绩后给分也正常了。最后问了助教期末平时作业50，实验20，期末卷面30，本人前两者加起来扣了2分，可以说给分很不错了，如果分数不高很可能是因为期末卷面不高，这课本身难度很大。总之非常推荐选课。
48967,3449,丁一,2017-03-19 15:53:12,-9,4,13,耐心的老师
109040,3449,丁一,2019-06-06 05:59:25,11,17,6,不关心学生
110006,3449,丁一,2019-06-21 05:08:38,-12,5,17,讲课生动形象，很幽默，逻辑性强
113710,3449,丁一,2019-07-07 05:26:58,17,23,6,我见过名字最简单的老师
114629,3449,丁一,2019-07-11 01:44:39,-1,2,3,嘲讽IT?
115465,3449,丁一,2019-07-25 16:24:46,11,17,6,唯利是图
123091,3449,丁一,2020-05-09 06:30:10,-6,4,10,有丰富的电力市场经验，讲课很生动
135162,3449,丁一,2021-05-05 07:58:06,4,5,1,这老师不行啊
153023,3449,丁一,2022-04-23 18:26:20,2,4,2,运控好课，虽然老外讲的几节不太听的明白，但他自己讲的几节真的很棒
162611,3449,丁一,2022-11-29 02:34:24,8,9,1,你有什么价值?
164170,3449,丁一,2022-12-18 15:52:37,29,37,8,"讲课如何暂且不谈，说说他对研究生怎么样，供选导师的本科生参考。\n\n先说结论：如果一定要选他作为导师，不要抱太高的期望。\n\n2022年末政府对疫情的管控放开，开始有大批学生感染，在此背景下学校下发了允许学生申请改变学习场所的通知，他对此事只字未提，没有人会相信作为副院长的他没收到这条通知。后来学院再一次给导师开会并发出研究生应返尽返的通知，开会过后，很多导师开始让学生尽快返乡，并对学生给予相应的关怀。但他依旧只字未提，并依旧召开线下组会。组会上，嬉皮笑脸地说道""你们想什么时候阳？早阳还是晚阳？""根本没有人想阳。组会后一切工作照旧，大家每天都在他的项目四处奔波，包括往返于玉泉和紫金港盖章，去电网公司开会，去有阳性老师的计财处借发票。很快，组内连续出现阳性，他依旧当做无事发生，没有跟大家说过一个字。\n\n且不说平时接一堆横向丢给学生就不管了，项目各种日常事务都需要学生处理，连看论文写论文都要挤时间？项目经费一大把却不舍得像其他课题组一样聘请一位在学校处理事务的助理，他的助理只存在于钉钉里。项目做好了相安无事，做不好还要被质问。疫情越来越严峻，隔壁组已经让大家回家，他的实验室有人感染之后还要大家继续留在学校，以项目为重，甚至连一句关心和问候都没有。\n\n同学都在尽心尽力为他做好项目，有些人完成了几百万的项目甚至上千万的项目后，换来的只有他对学生生命健康的漠视和继续压榨，作为学生只有失望，失望，失望。\n\n所以，给后人一点建议，如果一定要选他作为导师，就千万不要抱太高的期望。"
173230,3449,丁一,2023-05-16 08:04:06,22,24,2,丁老师已经臭名昭著了。呵呵。
208318,3449,丁一,2024-12-27 00:44:18,-1,2,3,逻辑清晰
208329,3449,丁一,2024-12-27 02:01:16,-3,1,4,讲课讲得很好，也很关心学生。组内同学就业都不错，口碑也很好。好老师！
208339,3449,丁一,2024-12-27 02:42:51,-4,1,5,专业不失幽默，关心同学，个人觉得是一位比较靠谱且强烈推荐的一位导师！
213777,3449,丁一,2025-01-20 00:49:21,3,3,0,楼下三个水军闹麻了，活该当一辈子牛马
213778,3449,丁一,2025-01-20 00:50:01,2,3,1,楼下三个水军闹麻了，活该当一辈子牛马
219664,3449,丁一,2025-06-03 15:10:13,0,0,0,丁化是一个很奇妙的变化
26755,3465,Pfister Pierre-Daniel,2016-06-21 04:59:25,1,1,0,好。好。好
61886,3465,Pfister Pierre-Daniel,2017-11-21 11:24:48,2,2,0,我真的是无fuck可说！！！
90849,3465,Pfister Pierre-Daniel,2018-11-26 14:04:03,2,2,0,电力与运动还是很有收获的，对很多现象有了全新的认识，还可以锻炼英语能力，老师也很棒！给分也很好！
118255,3465,Pfister Pierre-Daniel,2019-10-24 03:03:39,3,3,0,老师超级认真努力可爱！课堂很有趣！
118902,3465,Pfister Pierre-Daniel,2019-11-07 12:51:13,5,5,0,每場點名，不過老師非常負責，很禮貌，對同學們很溫柔，超好！！
142252,3465,Pfister Pierre-Daniel,2021-11-09 10:08:54,6,6,0,理想中的老师，谦逊，博识，温和，重视学生的想法
142882,3465,Pfister Pierre-Daniel,2021-11-17 05:27:35,7,7,0,非常好的老师，课上的知识提供了学电机学的崭新视角
142942,3465,Pfister Pierre-Daniel,2021-11-17 15:18:33,7,7,0,老师讲课好、热情、给分好，大学遇到的最好的老师之一。
145757,3465,Pfister Pierre-Daniel,2022-01-01 12:39:32,6,6,0,从另一个角度解释电机运作原理，对于接下来电机课的学习很有帮助，可以看作电机学的绪论内容的展开。
147038,3465,Pfister Pierre-Daniel,2022-01-08 13:28:50,2,2,0,非常热情，给分很好，讲课也不错
181105,3465,Pfister Pierre-Daniel,2023-10-08 20:26:29,5,5,0,老师人很好（就是那种谈到好外教，多数人脑中会跳出的谦逊温和、非常尊重学生的理想形象hhhh）下课时间经常和学生闲聊。电磁与运动是全英文授课，但是语速不是很快，会有详细清楚的板书，所以即使英语不太行也不至于一点也上不了手，跟着记笔记就算听不懂他在讲什么也能自学个7788。课堂不强制回答问题，每次必签到，没有大作业。期末考试比课上讲的略难，但感觉老师有在努力捞（大概？）最后给分挺好的。
26074,3572,徐文渊,2016-06-15 11:11:20,6,12,6,作为我的新生之友，两年来都没出现过一次
33952,3572,徐文渊,2018-10-01 13:29:54,2,3,1,好好好
34773,3572,徐文渊,2016-10-21 05:26:23,11,14,3,老师超级可爱！
35760,3572,徐文渊,2016-11-10 08:04:26,2,5,3,好老师不解释
62461,3572,徐文渊,2017-11-25 10:48:10,2,6,4,进度有点快，英文教材讲的很详细生动，但是有些啰嗦，所以课后自己看书的时候花的时间很长很长。考试方式是可以带手写的8页cheating sheet，写这个也花了很长时间——结果最后考试大家都觉得没用上，但其实抄这个的时候带来的复习效果非常显著，挺有创意的开卷方式(当然可能这在国外不算什么新鲜事儿吧)
62636,3572,徐文渊,2018-06-12 09:44:24,-23,4,27,基本每节课都有quiz\n\n上课不怎么听，课后自己翻中文书对着全英文PPT看，最后满了
63311,3572,徐文渊,2017-11-30 10:32:55,7,9,2,讲课确实很有意思。但是，考试之前老师连带助教消失是什么意思？群里那么多学生问问题，老师和助教一声不吭？全靠2个大佬帮忙在群里回答问题，这点真的让人很生气
89922,3572,徐文渊,2018-11-21 09:17:58,3,3,0,课一点都不水，每周都有homework or project，每节课几乎都有quiz（每次quiz都会算分数）。全英文课看书要花很长很长时间，老师人确实是很好，不过计网这课确实内容太多，期末很爆炸。另外最后抄的4张纸确实是毫无用处（对考试来说，对复习还是蛮有帮助的）。如果期末考试不多的话，可以选一下，毕竟要学好这门课期末还是要花蛮多时间的。
93420,3572,徐文渊,2019-01-09 13:00:07,-2,2,4,自己导师，上课会发糖哦
117515,3572,徐文渊,2019-09-25 08:52:16,3,5,2,很一般，很无情
133498,3572,徐文渊,2021-03-01 09:20:28,14,17,3,英文授课真的受不了。我上课跟不上，基本靠自己看书，课下付出很多。考前总结一张纸的内容基本用不到，就当是过了一遍吧。给分还行，后期每节课都有小测，建议找一些往届学生的小测卷，有惊喜哦
135400,3572,徐文渊,2021-05-10 00:21:32,6,6,0,老师很好。\n\n英文听不懂，计网学不会，课后一定要多花些时间（泪奔）
192169,3572,徐文渊,2024-05-10 14:38:22,12,13,1,老师还是很不错的，系主任一点架子都没有，考试前一天还给了答疑，我原来以为答疑会由助教来，没想到是徐老师亲自跑到紫金港。计网这课的话和其它评价一样，全英文，内容巨多，小测非常频繁几乎一周一次，而且课堂/作业/考试三者的分裂感很重。但是不得不说，这门课能学到的东西还是非常多的，在project里面抓包分析网络也很神奇，我们还有课友找到浙大体艺的漏洞hhhh。至于给分的话我觉得没有其它评论说的那么不好，我C小3.6，C大4.2还拿了计网89/4.5
192430,3572,徐文渊,2024-05-19 13:30:37,15,15,0,徐老师是所里大老板嘛，上课前还很害怕，不过课上下来感觉老师人很好很温柔，助教也很耐心，整体上课的体验很不错。\n\n计网今年看班上给分其实还行，因为期末比较难，平时分几乎是给满的（不过这大概不意味着作业小测可以乱做）。不过这门课本身还是偏繁重的，五百多页的英文PPT/英文教材，每周上课都很赶，几乎每周都小测，作业和上课差别很大……这些都有点难受。老师上课经常讲英文，不过比较困难的地方会说中文，上完课之后我竟然基本不懂中文术语，只记得英语，这点很神奇。\n\n所以为什么计网不是国际化，这比好多国际化课还英语吧？？
192642,3572,徐文渊,2024-05-26 11:23:34,5,5,0,计网上课很好，答疑也很及时，推荐选
192752,3572,徐文渊,2024-05-30 05:01:26,7,7,0,老师上课讲的很有趣，也能收获到很多东西，最重要是美女老师比较赏心悦目哈哈哈哈。但是事情真的太多了，几乎每周都有小测，每周要么有作业，要么有project，最后考试狂抄四大张cheat sheet，占用了很多的时间。不过这次给分还行，助教最后捞了。
218621,3572,徐文渊,2025-04-27 07:20:26,0,0,0,讲的不错，给分也好，推荐\n\n其他课程资料可以上98搜索
58010,3580,卢慧芬,2017-07-22 17:08:13,2,3,1,真的真的是个好老师啊！
80747,3580,卢慧芬,2018-06-30 08:02:51,2,3,1,认真负责！收货最大的一门课！老师为了开这么一门创新实践课下了太大的辛苦！
87045,3580,卢慧芬,2018-09-20 05:30:03,2,3,1,好老师！卢老师的课上收获很大！
92144,3580,卢慧芬,2018-12-26 15:53:47,2,3,1,好老师！！
108949,3580,卢慧芬,2019-06-04 15:06:44,-1,2,3,海星吧
109042,3580,卢慧芬,2019-06-06 06:03:25,2,2,0,收获很大！
122930,3580,卢慧芬,2020-04-21 21:35:53,0,0,0,对学生特别好！耐心细致！跟着老师可以学很多很多东西！
124881,3580,卢慧芬,2020-07-14 12:31:36,0,0,0,实践出真知
19953,3607,金孟加,2016-01-25 15:46:54,2,3,1,还好吧，就是太年轻，缺乏经验
24106,3607,金孟加,2016-04-27 07:03:44,1,1,0,还可以，不明觉厉
47533,3607,金孟加,2017-01-30 05:12:43,0,0,0,电拖思路很清晰，人也帅~
71041,3835,杨嘉帆,2018-01-28 02:03:34,2,2,0,这军训辅导员话是真的多，每天BB半天，同样的事情讲好几次，给分又低
76549,3835,杨嘉帆,2018-04-14 01:10:16,0,0,0,这军训我是服气的
78215,3835,杨嘉帆,2018-05-10 04:30:26,2,2,0,辣鸡老师
92247,3835,杨嘉帆,2018-12-27 08:34:48,2,2,0,垃圾，乱给分
103945,3835,杨嘉帆,2019-03-08 00:10:53,2,2,0,垃圾老师
74855,3860,白志红,2018-03-06 06:29:04,15,15,0,不会讲课
75342,3860,白志红,2018-03-13 06:33:37,16,17,1,垃圾老师不会上课
75548,3860,白志红,2018-03-14 05:17:45,12,12,0,求求你认真点
76645,3860,白志红,2018-04-17 05:05:59,7,8,1,很严肃吧，不是很喜欢
78896,3860,白志红,2018-05-16 09:09:47,9,10,1,没有群，不点名，讲课就是跳着念ppt，不想上课干嘛不去带研究生啊
78950,3860,白志红,2018-05-17 10:16:01,51,56,5,理论课照本宣科 实验课我们都没有接触过这些仪器 也不动手教教 我做实验你说理论有个屁用 这老师不光不会教书 态度还傲慢得一批 这一定就是浙大自己培养的老师吧 真的恶心
79062,3860,白志红,2018-05-22 01:32:19,11,12,1,很难受，不管是理论课还是实验课。\n\n实验课基本什么都不讲就让我们做，上一次全班基本都没做完，听了另外一个老师的讲课才知道实验怎么做……实验仪器出问题了还让我们做下去而不是换设备，总之态度很不好吧，也爱理不理的，问问题也没什么用。很羡慕别的同学的老师。
81360,3860,白志红,2018-07-05 02:11:44,7,8,1,老师讲课很无聊，完全念PPT\n\n实验报告要求多\n\n和另外几个老师差距很大\n\n慎选\n\n
81461,3860,白志红,2018-07-05 06:42:35,14,16,2,考前一天晚上才偶然得知别的老师老早给了自测题……但是已经来不及看了……考试试卷上应该有好多是原题…我……拜托老师你上课上成那样也就算了，自测题都不给的吗……这样和别的班的同学拉开多少差距……
83744,3860,白志红,2018-07-11 06:50:03,9,10,1,上课总是自顾自地讲，给分极差
84137,3860,白志红,2018-07-12 06:16:55,5,6,1,水 不走心 实验体验不佳 给分差
84181,3860,白志红,2018-07-12 07:37:23,10,12,2,理论课念ppt无聊，实验课也在念ppt，完全没动过手示范过。反正感觉不是很负责吧。也没有群，复习资料什么的，甚至考试题型都没怎么好好布置。可能老师太高冷了？需要学生们剥开层层伪装，呵护她柔软脆弱的内心吧。\n\n
103835,3860,白志红,2019-03-06 07:27:16,2,3,1,辣鸡，师德败坏，讲课水平低下，态度傲慢
103836,3860,白志红,2019-03-06 07:33:44,16,16,0,据说其科研水平也很差劲，还压榨研究生，拖欠学生补助。
103887,3860,白志红,2019-03-07 03:15:32,1,2,1,辣鸡老师
109916,3860,白志红,2019-06-20 06:58:05,2,3,1,很差，别选，评论都是真的
110958,3860,白志红,2019-06-28 23:09:33,1,2,1,有点太差
112199,3860,白志红,2019-07-03 22:23:37,1,2,1,课的确上的不咋样 全靠自学 90分跟她倒是没一点关系
112201,3860,白志红,2019-07-03 22:29:11,2,4,2,一门课真的可以毁掉一个人
112753,3860,白志红,2019-07-05 02:12:47,-5,5,10,其实老师人还不错，就是上实验课不够详细，考试也没像其他老师那样划重点
113314,3860,白志红,2019-07-06 05:43:17,3,5,2,理论课照本宣科是真的 不过最后给划了重点 但还是主要靠自己 实验课体验真的是极差 书上没有也不讲清楚直接让我们做 全班此起彼伏的仪器报警声 连着烧了两台仪器之后还不讲清楚 又烧了第三台也真是够了→_→
125541,3860,白志红,2020-09-11 06:22:17,2,3,1,贼差的老师，给分特别差，千万不要选，宁愿不学这门课也不要选！！
125676,3860,白志红,2020-09-13 01:44:54,4,5,1,给分巨差
126252,3860,白志红,2020-09-21 02:59:21,3,3,0,只能教的很不用心
134896,3860,白志红,2021-04-21 10:24:34,4,4,0,这实验课我服了，读ppt大神
135964,3860,白志红,2021-06-06 03:07:36,11,11,0,听我一句劝，看到这个评论的人，快逃，其他老师评分低选着也没关系，这老师选上的赶紧退了，真不是人上的实验课，上成ptsd了，我选过许多评分低的老师，这是最折磨的一个，我把握不住
136796,3860,白志红,2021-06-25 00:07:51,5,6,1,平时的骚操作:\n\n别的班不要写的实验报告要写\n\n实验课自己电路图给错了还问同学是不是没有认真听，为什么做不出来\n\n什么都不教，还说为什么有人会你不会\n\n实验不发电路板，就让我们做，做做做个p\n\n期末考试:\n\n一半以上的人实验题做不出来，总评分20分没有，还反问为什么一样的课程有的人做得出来，又辣鸡有傲慢
136925,3860,白志红,2021-06-28 09:51:38,-12,4,16,电工电子学实验课\n\n老师人很好，实验做不出会帮你找原因，还没学的理论也会仔细讲解，考前也给了提示
138126,3860,白志红,2021-07-07 12:02:05,0,3,3,再见了
139183,3860,白志红,2021-07-13 07:10:41,-9,3,12,感觉老师人还是挺好的，考前也会说哪些是重点，但因为这门课比较杂，上课一遍可能听不懂，建议先看看MOOC预习一下
151800,3860,白志红,2022-03-16 07:06:11,5,5,0,mooc和线下双倍作业，线上作业第一单元说不用做，结果截止之后说这个也算分数，没做就没分了，我直接呵呵…
151801,3860,白志红,2022-03-16 07:22:37,5,5,0,很不靠谱的一位老师。如果你有幸上她的课，请指导她的教学工作，特别是立规矩的时候请跟她再三确认，否则可能出尔反尔，倒霉的是学生。
153729,3860,白志红,2022-05-09 13:20:54,5,5,0,sb  bzh
155353,3860,白志红,2022-06-11 10:08:03,2,4,2,无语，快逃\n\n想高分的别想了\n\n想及格的挣扎一下
155456,3860,白志红,2022-06-13 05:24:09,0,2,2,快跑吧\n\n别看评论了
155457,3860,白志红,2022-06-13 05:30:25,1,3,2,别的也不多说了，就希望能按照一开始制订的说好的标准执行下去，把各项分数算清楚。出分之后再来评一次，看我们能不能好散吧。反正现在的情况是，各项事情都得提醒老师，反复确认...
155466,3860,白志红,2022-06-13 07:49:07,0,2,2,听我说谢谢你
155523,3860,白志红,2022-06-14 02:54:05,-3,1,4,希望bzh捞捞我
156413,3860,白志红,2022-06-19 12:54:04,-4,2,6,白老师，捞一把咱还有情谊在
157100,3860,白志红,2022-06-22 02:27:26,9,9,0,挺傻逼一老师，给分标准不确定，上课水平极差，实验课零演示，全靠自己摸索，给分极差，能跑就跑
157114,3860,白志红,2022-06-22 03:04:58,-18,7,25,没有像大家说的那么不好，选上了也别太难过，期末感受到了浓浓师生情
157182,3860,白志红,2022-06-22 07:49:35,0,1,1,。。。
163811,3860,白志红,2022-12-16 07:11:31,46,47,1,预置了，其他时间都冲突了跑不了了怎么办啊
171754,3860,白志红,2023-04-04 04:32:20,6,9,3,有种族谱不全的美
173294,3860,白志红,2023-05-18 03:06:52,7,8,1,上课念ppt领域的大神，自学后才能跟上她上课念ppt的速度，不过上课不就是为了学会吗😂你上课屁用没有我上你课干嘛
173342,3860,白志红,2023-05-20 07:31:10,6,8,2,评分甚至不如均绩高。。。
174857,3860,白志红,2023-06-19 05:44:42,3,4,1,明知当天大部分人得调休上课，还把答疑时间放在当天，水平太高
175273,3860,白志红,2023-06-23 06:01:07,0,2,2,感觉很神秘
175556,3860,白志红,2023-06-25 13:06:02,7,7,0,讲课纯念ppt，问问题也从来不正面回答，实验课操作从来不演示还美名其曰你要是看懂了你就能做，最后给分还贼差，快逃
175560,3860,白志红,2023-06-25 13:25:31,9,9,0,凭什么认真学了，最后分数还那么低？？一点几的评分都是我们血与泪的教训，大家能跑的快跑
175562,3860,白志红,2023-06-25 13:27:28,-3,6,9,老师挺负责任的，对学生也没有评论区说的那么不好。感觉就是课讲的挺干巴，很多要点没有强调，包括复习课和实验课很不详细，但是老师心里还是希望学生好的，调课也在听学生的意见，还有几次带病上课，私下交流也很温柔，不至于这么低的分数。另外给分很求是，感觉没有捞人。选上了也不用很慌，没有评论区说的那么差。p.s.习惯智云补天的同学注意，老师上课不拿麦克风，她的智云听不了
175563,3860,白志红,2023-06-25 13:32:18,5,6,1,真别让这种人教书了吧，一定要恶心你一下，课又上不来，还假装很关心学生，评不上正教授是有原因的吧。
175565,3860,白志红,2023-06-25 13:41:32,7,7,0,刚出分，3.0。\n\n每节课必点名，但是声称点名不计入绩点，最终记不记入我也不知道。\n\n上课纯念ppt，实验课也是，不做实验演示。\n\n其他班无期中考试，只有两次小测，她有一次小测，但是出成期中考试的格局。而且小测的时候要求搁这巨大的空隔位就坐。\n\n反正我是没听过她的课，纯纯对书自学，3.0也是挺符合我的水平的，确实脑子不好使。但是几个比较聪明的同学都说得分不佳。\n\n我的实验课队友还挂了（
175569,3860,白志红,2023-06-25 13:58:52,9,9,0,教学水平比平行班差太多了。建议逃不了的话听隔壁班智云。\n\n实验课就没办法了。别的班老师讲得清清楚楚，bzh你问她问题她还得先数落你一番。唉
175570,3860,白志红,2023-06-25 14:05:54,9,9,0,傻鸟老师吧，第一节课说期中占比10%，最后出了成绩了又说占比15%，而且问她为什么还反过来威胁学生，整个无语了
175572,3860,白志红,2023-06-25 14:15:10,9,9,0,事多分低。我们m最爱bzh老师的课了。有一种被蹂躏的爽感
175574,3860,白志红,2023-06-25 14:22:50,7,7,0,快跑吧，一个班讲考试范围，一个班不讲。还随意改评分规则，钉钉日常找不到人，问分数还阴阳学生
175575,3860,白志红,2023-06-25 14:28:55,7,7,0,再也不敢不把查老师评分当回事了
175595,3860,白志红,2023-06-25 16:50:57,7,7,0,【电工电子学及实验】真的傻逼，能润就润，课讲的一坨，不如自己看mooc，实验基本不讲操作细节，全靠自己摸索，实验报告也没给具体要求，也不给平时成绩和实验报告成绩，还有很多迷惑操作，最重量级的当属开学给的评分细则，在期末出成绩时随意修改，自己搞的期中考试一开始说10%最后出成绩时变成15%（而且搞得巨正式，还东西全收起来，隔位就坐，据我所知其他班是小测，没这么严格），在同学询问时还阴阳怪气，“你这么自信，其他部分你都能拿满分？”（原话，好几个人问她她都这么回）。每节课学在浙大点名，只开一两分钟，然后说点名不会算到成绩里（谁知道呢）。最后，为什么最低只能打一分。
175628,3860,白志红,2023-06-26 03:00:39,10,10,0,只能说查老师评分很真实，知道一点几的含金量就好
175805,3860,白志红,2023-06-26 22:51:25,6,7,1,这b老师有种唐氏的美
175915,3860,白志红,2023-06-27 06:29:35,-10,3,13,其实感觉老师没有评论区里那么不好，上课可能是枯燥了一点，但老师和助教都有捞人的
176113,3860,白志红,2023-07-03 12:29:01,-7,2,9,课讲的一般，但人好像还行，就是这个给分标准……
176181,3860,白志红,2023-06-28 03:58:51,3,3,0,快跑！
176186,3860,白志红,2023-06-28 04:08:40,4,4,0,上课和实验都很烂暂且不提，rp也不太行，选到她的课真的痛苦，有人期末去问分她直接怼你《你觉得你很自信吗》《你那么牛逼期末考试可以满分的》
176876,3860,白志红,2023-06-30 13:44:27,3,3,0,快润，有多快跑多快
176910,3860,白志红,2023-06-30 16:01:30,-2,1,3,老师很好，非常严格，特别是给分
184193,3860,白志红,2023-12-12 10:12:15,1,2,1,又要选课了，给您打个1分
189486,3860,白志红,2024-01-25 01:48:31,0,1,1,一分是查老师的下限
191859,3860,白志红,2024-05-02 07:36:10,1,1,0,。。。。。
192048,3860,白志红,2024-05-08 07:37:32,0,0,0,赶紧润
192327,3860,白志红,2024-05-15 08:14:35,0,0,0,一坨答辩
192710,3860,白志红,2024-05-29 06:13:35,2,4,2,白志红点名好像真的不计入成绩
192794,3860,白志红,2024-05-30 12:13:34,6,6,0,每节课都点名，上课进度较快人也比较严肃，小测不开卷且难会影响一点平时分，会随机抽人回答问题并记录，期末前不会发押题卷之类的东西。但说心里话，和老师几次沟通下来人还是友善的，只是对学生严格，不喜欢通融分数。倒也没有有些评论说的这么夸张，预制到的认真学生不用太慌张，如果是比较摆的或者不到课的建议尽早换个好说话的老师。
193881,3860,白志红,2024-06-20 11:58:34,4,5,1,白老师人其实挺好的，问的问题都会耐心回复。她只是没有那么迎合学生的需求，比如小测难、不开复习课、实验检查严格等，绝对没有评分那么差。最后一节课上老师说了平时分都会尽量给高，期末反正大家统考，所以选上了也不用担心。均绩比别的班低很大一部分是因为重修的都在她班上拉低了，预制的学生不用那么担心，给分绝对没啥问题，平时比较严格而已。
195080,3860,白志红,2024-06-26 17:20:01,6,7,1,开学前看见老师的评分一点几真的有被吓到，但是跑也跑不掉，整个学期都很忐忑，就这个学期的上学体验来说，老师人其实挺好的，上课上的怎么样的话，感觉讲的也还行，不过我上课摸鱼时间太多，智云重播发现老师的话筒收音不好，智云听不清，所以我最后还是听孙晖的智云学的。\n\n老师对学生也挺好的，我这学期生病一直咳嗽，老师课前听到我一直咳嗽，还过来给我一颗润喉糖，问我是不是咽喉炎，如果咽喉炎的话吃这个糖会舒服点。\n\n总体感觉老师人挺好的，这学期也说会尽量捞人，给分感觉也还行，虽然这门课我最后的绩点也没有很高，但是我觉得老师还是有捞人的。\n\n被预置白老师不要太害怕，老师人真的还是不错的。
195136,3860,白志红,2024-06-27 02:34:54,3,4,1,没想象中那么差，期末还捞人了
195269,3860,白志红,2024-06-27 14:18:03,3,4,1,比之前能好一点，看得出来她也在改变。问问题也不会再说你，就是每节课都会点名，换着方式点名。同时相比于其他班还有一次比较正式的期中考试占总评十五分。
197476,3860,白志红,2024-07-16 10:19:37,4,6,2,白老师改邪归正了，黑子说话！
203270,3860,白志红,2024-11-18 16:38:50,-3,0,3,白老师改邪归正了
218197,3860,白志红,2025-04-22 03:43:17,0,1,1,受不了了，感觉话里话外都在阴阳人
221077,3860,白志红,2025-06-21 07:33:47,0,0,0,感觉1.7分有点低了，可能是课程难度的问题，学起来确实比较痛苦。有人说点名的问题，我觉得这对那些去听课的人是公平的。我也上过其他低分，比如1.3分跟1.5分老师的课，实话实说，也没有感觉多糟糕，所以就算预置上一些评分比较低的也不要太焦虑，自己的努力终究是占了大部分的。
221422,3860,白志红,2025-06-23 10:21:24,0,0,0,她捞了，我哭死。
93418,3865,于淼,2019-01-09 12:58:10,6,8,2,于老师是我的班主任，认知实习和嵌入式都给满了，事情不多就是真的有点水了\n\n老师态度这么好，当时把他丢在长兴最后也没发火
104047,3865,于淼,2019-06-18 09:19:18,3,3,0,boring
105545,3865,于淼,2019-06-15 17:11:58,3,3,0,一般般
109009,3865,于淼,2019-06-05 10:12:56,1,2,1,熊猫老师还是很认真负责的，平等地听取学生的意见。偶尔的劣质冷笑话真的别样搞笑。课堂8分，劣质冷笑话加2分
109270,3865,于淼,2019-06-12 13:41:01,3,4,1,信号课讲得真的不怎么样。。。
110323,3865,于淼,2019-06-25 15:45:03,6,7,1,老师是个负责老师，就是这种慵懒风的上课讲话方式让人渐渐有了睡意，跟声情并茂的Q老师形成鲜明的对比
111358,3865,于淼,2019-07-08 03:30:54,13,19,6,信号不好，我先挂了
112092,3865,于淼,2019-07-05 03:52:41,4,4,0,给分很好
114312,3865,于淼,2019-07-09 17:43:45,1,1,0,学了一个学期信号屁都没学懂的我，拿到这个分数表示很满足
114344,3865,于淼,2019-07-09 23:16:59,1,1,0,。。。。
115025,3865,于淼,2019-07-14 10:00:35,4,4,0,上课时语调一点起伏都没有，超容易睡着。。。
116553,3865,于淼,2019-09-11 12:35:33,-4,1,5,快逃！
125799,3865,于淼,2020-09-14 10:44:48,1,1,0,老师给分还是很公道的，不过有大作业，大家还是注意下，也会算一点分。这次最后考试反而比平时简单些，感觉老师很不错
133460,3865,于淼,2021-03-01 03:19:54,9,11,2,嵌入式系统是给分好的水课！老师讲课很催眠。不过期末开卷考试，把ppt打印出来直接抄就完事了。实验也很简单，有的几分钟就做完了
177002,3865,于淼,2023-07-01 04:44:10,4,4,0,听了老师一节课之后就再也没听过，都是靠着zj老师和yh老师的智云学的信号\n\n最后给分还不错
196176,3865,于淼,2024-07-02 04:02:01,2,2,0,很认真负责的好老师，虽然信号课难，但是老师很捞最后给分很好，认真学一定会有好结果
196179,3865,于淼,2024-07-02 04:11:51,0,0,0,很好的老师，给分挺好的，认真学可以得到好成绩，但不一定能学懂信号
74901,3879,陈向荣,2019-06-12 02:54:13,-10,32,42,没作业，开卷考。\n\n但是老师极其不负责任，给分也很差。\n\n不多说，问个14的都知道怎么回事
75214,3879,陈向荣,2018-03-08 04:21:58,-10,35,45,专业课让一个老师开真的是太坑了，讲话没起伏小声听不见，态度随意，不在意学生的感受。
75672,3879,陈向荣,2018-03-15 04:00:37,-12,30,42,上课讲课听不清楚，瞎讲一通，很差，态度不好
76507,3879,陈向荣,2018-04-12 02:06:59,-2,34,36,嗯？？？
76508,3879,陈向荣,2018-04-12 02:09:11,9,63,54,我觉得这个老师与朴实可爱的典型电院老师不同，极爱装，讲课的状态实在难以让人接受，一边说着这是重要的课程一边把课上成念PPT，我实在不敢妄加评论老师的专业能力科研能力，但是授课水平基本上可以等同于通过这门课考试的学生。
76516,3879,陈向荣,2018-04-12 03:56:14,-2,46,48,辣鸡老师，不知道讲些啥东西
76517,3879,陈向荣,2018-04-12 04:20:44,-37,11,48,上课声音小而且模糊是一个问题，不过课下问问题感觉还是挺和蔼的，不过今年闭卷不知道会发生什么哈哈哈哈?
76707,3879,陈向荣,2018-05-08 12:29:16,-13,27,40,上课不知所云还每节课都点名
76841,3879,陈向荣,2018-05-06 01:35:02,-36,19,55,讲课真的烂，试卷还算良心
77013,3879,陈向荣,2018-05-05 06:01:58,-2,47,49,去年考完试，老师想“我都讲成这样了竟然才挂了这么点？不科学。”于是今年改为闭卷⋯⋯这样的老师，你必须得给他安排。
77017,3879,陈向荣,2018-04-28 13:07:46,-15,22,37,无话可说
77048,3879,陈向荣,2018-04-29 09:17:40,-47,12,59,好老师！语文好
77055,3879,陈向荣,2018-04-30 06:42:23,-20,18,38,bulls…文明，素质，不说了
77057,3879,陈向荣,2018-04-30 09:59:22,-20,20,40,看到2018年评论的学弟心疼一波，去年这老师做的睿智事情真是让人大开眼界
77236,3879,陈向荣,2018-05-04 05:25:05,-34,12,46,老师对学生态度挺好的 就是讲课能力实在是硬伤...
77382,3879,陈向荣,2018-05-05 07:31:39,45,68,23,能不能开卷啊，高电压真的背不下来啊，太多了
77409,3879,陈向荣,2018-05-05 12:03:25,-20,21,41,最辣鸡的老师没有之一
77441,3879,陈向荣,2018-05-05 14:44:04,-11,34,45,听课？不存在的。\n\n听课是不可能听课的，这辈子都不会听课，速记又不会，几百页ppt也记不住，只能靠瞎bibi勉强维持60+这样子。
77443,3879,陈向荣,2018-05-05 14:46:24,-18,22,40,听他一节课，劳资的铁哑铃都变成合金十字了。
77445,3879,陈向荣,2018-05-05 15:00:28,-19,20,39,讲课无聊，没有重点，教学散漫，毫无意义的闭卷考，唉
77537,3879,陈向荣,2018-05-06 10:51:37,-7,25,32,水友们，试卷真的良心吗？
78084,3879,陈向荣,2018-05-09 09:22:08,-20,20,40,大学见过最差的老师，还有语文不知道怎么学的，怎么也是文化人，点个名名字念对的用手指都数的出来
78085,3879,陈向荣,2018-05-09 09:34:43,-23,19,42,有人去听课完全是因为他点名
78088,3879,陈向荣,2018-05-09 09:51:19,-16,20,36,课水分低
78100,3879,陈向荣,2018-05-09 10:20:03,-14,21,35,人是好人，和蔼亲切，但可能不太适合教学。
78187,3879,陈向荣,2018-05-10 01:46:13,-14,24,38,讲重点的时候，声音低到麦克风都扩大不了他的声音，每次都说了解一下，结果ppt翻的比书还快，考完试全宿舍成绩爆炸！实在无语。。。
78274,3879,陈向荣,2018-05-10 10:10:46,10,32,22,还行，没挂
79096,3879,陈向荣,2018-05-22 17:03:30,-9,34,43,该老师上课不知所云，只是一直在嘿嘿嘿的尬笑，ppt十页十页的翻，根本不讲有营养的东西。上课能力有限也罢，14级考试试卷答案还给错了，答对的同学去找他，他居然不会，态度也极差。P.S.中间有两次来代课的周浩老师真的很不错，强烈建议学院安排周老师来上这门课。
87803,3879,陈向荣,2018-10-14 09:31:28,7,39,32,还可以
87804,3879,陈向荣,2018-10-14 09:31:34,9,49,40,挺好的呀
89010,3879,陈向荣,2018-11-14 00:00:06,-17,23,40,看到大家都在骂这个老师我就放心了，不是我自己的问题。不过这位老师的智商情商低到不会反思自己的，骂也没什么用……
102693,3879,陈向荣,2019-03-02 09:17:39,-10,34,44,水平实在太次，而且听同学说他以自己比较忙为借口把所有三月毕业的硕士延迟到六月了....可怕....
103743,3879,陈向荣,2019-03-05 02:26:03,-22,18,40,跪了啊
105515,3879,陈向荣,2019-04-16 02:36:21,-17,21,38,你没有能力讲课态度起码得好点吧，就这水平怎么进浙大教学的。傻    哔
106017,3879,陈向荣,2019-04-24 10:06:32,3,55,52,陈老师一到教室，所有上课的人便都看着他笑，有的叫道，“陈老师，你实验又要手写报告了！”他不回答，对助教说，“一份学生名单，要一本新华字典”，便排出九页PPT，他们又故意的高声嚷道，“你一定又上课随便翻翻PPT了！”陈老师睁大眼睛说，“你怎么这样凭空污人清白……”\n\n\n\n“什么清白？我前天亲眼见你加了几张图，拼命吹。”陈老师便涨红了脸，额上的青筋条绽出，争辩道，“讲PPT不能算翻......讲PPT......大学老师的事，能算翻么？”接连便是难懂的话，什么“你家住哪里”，什么“你考试周几门考试”之类，引得众人都哄笑起来：教室内外充满了快活的空气。
106023,3879,陈向荣,2019-04-24 10:45:45,-20,20,40,找了半天确认没有零分才给的一分
106161,3879,陈向荣,2019-04-25 10:57:31,-16,22,38,电院碰到的最差的一个老师
106248,3879,陈向荣,2019-04-26 02:42:04,-16,19,35,考试这边建议不要提前交卷哦 我们敬爱的陈老师会帮你指出做错的题哦
107646,3879,陈向荣,2019-05-08 02:52:09,-20,19,39,水平极差，所有骂他的评论都是有道理的。吐字不清，声音很低，不认识同学名字，每次必点名，除了说自己的国外经历外ppt都是以10为单位翻页的
109443,3879,陈向荣,2019-06-14 12:37:58,-21,17,38,不会讲课 那就不要讲啊
115316,3879,陈向荣,2019-07-18 11:52:18,-12,21,33,这种人是怎么当上老师的？学院考核竟然是优？
117186,3879,陈向荣,2019-09-20 05:55:01,-23,16,39,无语的感觉
122671,3879,陈向荣,2020-03-17 03:13:52,-24,16,40,这门课让人无语，上课的老师也让人无语...
122842,3879,陈向荣,2020-04-14 03:56:07,-11,22,33,老师会讲很多不在教材上的知识，一讲就停不下来的那种，因此课内内容受到一些影响。这门课内容过多，不好抓重点，学起来想处处兼顾也没有精力。
126799,3879,陈向荣,2020-10-20 11:50:33,-24,16,40,情商低sb
133201,3879,陈向荣,2021-02-16 16:16:38,16,58,42,认真负责的老师，喜欢陈老师的课，人也和蔼可亲
133232,3879,陈向荣,2021-02-20 14:41:43,14,56,42,虽常点名，但对学生很有耐心
133233,3879,陈向荣,2021-02-19 14:08:06,6,44,38,不知道之前的评价哪里来的？很好的老师被差评，难以理解😔
133245,3879,陈向荣,2021-02-20 14:12:54,11,57,46,陈老师指导的博士、硕士研究生都很优秀，每年都有获得国家奖学金的学生。
133247,3879,陈向荣,2021-02-22 11:40:18,11,56,45,讲得超清楚，态度超温和
133248,3879,陈向荣,2021-02-20 14:39:43,11,52,41,和蔼可亲讲课又有趣的好老师
133249,3879,陈向荣,2021-02-20 14:50:30,16,56,40,挺好的老师
133254,3879,陈向荣,2021-02-21 05:07:48,14,56,42,试卷很良心，通过率很高的呀！
133255,3879,陈向荣,2021-02-21 05:23:22,12,54,42,上过陈老师的课，讲课深入浅出，学到很多东西，毕业时也很快找到满意的工作，感谢陈老师的教诲
133261,3879,陈向荣,2021-02-21 14:51:52,11,50,39,认真负责吧，觉得实实在在学到了东西，测试练习会让你不能水，尤其ppt做的很好，期末发现历年考题不少他都在课上讲了，是一个好老师。
133270,3879,陈向荣,2021-02-23 00:25:12,12,53,41,超好超认真的老师！能一丝不苟帮学生改论文的老师，在公众号上有一篇陈老师学生写的文章，搞笑之余羡煞旁人
133276,3879,陈向荣,2021-02-23 09:39:38,11,47,36,认真负责，态度和蔼，没毛病
133294,3879,陈向荣,2021-02-23 14:49:03,10,45,35,非常认真的老师，态度也很好
133295,3879,陈向荣,2021-02-23 14:51:21,11,45,34,ppt增加了很多内容，得认真听呢
133302,3879,陈向荣,2021-02-24 05:43:49,9,42,33,挺好的，推荐！
133305,3879,陈向荣,2021-02-24 06:02:06,10,42,32,陈老师棒棒嗒~~上课笑口常开，男神啊！
133308,3879,陈向荣,2021-02-24 10:10:42,10,40,30,清晰 明朗 和善 幽默
133313,3879,陈向荣,2021-02-24 15:51:02,6,35,29,上了一个学期的课，个人觉得挺好的
133315,3879,陈向荣,2021-02-25 01:13:44,7,38,31,特别赞！和蔼可亲，讲课清晰，深入浅出。
133321,3879,陈向荣,2021-02-25 11:46:16,8,38,30,陈老师人品很赞！👍👍👍能看出来是在用心的培养学生，不管上课还是科研都受益匪浅
133322,3879,陈向荣,2021-02-25 12:03:36,8,38,30,讲课超级赞，认真负责，您给我100分，可我只能给您10分。
133323,3879,陈向荣,2021-02-25 12:04:16,8,38,30,讲得超清楚，态度超温和
133324,3879,陈向荣,2021-02-25 12:18:39,8,37,29,陈老师非常认真负责，和蔼可亲，很喜欢陈老师的课！
133392,3879,陈向荣,2021-02-26 15:20:13,7,36,29,感谢老师捞我，真心好老师
133411,3879,陈向荣,2021-02-27 14:58:53,6,36,30,好老师！
133680,3879,陈向荣,2021-03-03 15:20:57,2,30,28,今天第一次上陈老师的课，课堂氛围融洽有趣，专业讲解清楚精湛，期待下周的课
133681,3879,陈向荣,2021-03-03 15:26:14,7,31,24,陈老师上课很认真，有不懂的请叫他也很耐心
133760,3879,陈向荣,2021-03-04 15:01:36,4,29,25,挺好的老师
133833,3879,陈向荣,2021-03-07 14:13:13,4,29,25,大爱陈老师，实在敦厚可爱
133895,3879,陈向荣,2021-03-09 07:42:24,4,26,22,确实是个好老师。
133994,3879,陈向荣,2021-03-11 14:16:33,1,23,22,条理清楚，讲的不错
134004,3879,陈向荣,2021-03-11 15:04:57,2,23,21,人超级好，平易近人。上课幽默风趣完全没有老师的架子，就像一个和我们差不多大的学生。
134007,3879,陈向荣,2021-03-11 22:38:47,3,22,19,好老师，上课认真负责
134110,3879,陈向荣,2021-03-16 06:35:46,2,23,21,讲课差，念ppt，出题出错了不改答案https://www.cc98.org/topic/4701230
134112,3879,陈向荣,2021-03-16 06:58:45,2,26,24,喊自己学生刷分是真的牛啤
134113,3879,陈向荣,2021-03-16 07:03:48,6,29,23,东西很漂亮，卖家服务态度很好，下次还来。
134114,3879,陈向荣,2021-03-16 07:03:01,7,28,21,陈老师讲课特别好，智商没有250是听不懂的。 你听不懂就是智商不到250。  别尬黑我们陈老师。
134125,3879,陈向荣,2021-03-16 15:03:37,4,24,20,好评好评！好老师！👍👍👍下周还有课，期待。。。。
134127,3879,陈向荣,2021-03-16 15:26:25,7,28,21,极其sb
134128,3879,陈向荣,2021-03-16 15:38:35,-1,19,20,可以打0分吗
134129,3879,陈向荣,2021-03-16 15:42:45,-4,17,21,太能装了。一口一个折大学生怎么怎么差，****（某大学）的学生水平怎么怎么强。坐在扩音器下面的同学回答一下，前面，前面，前面，左面，前面，前面，你们竟然都不会？哈哈哈哈差不多得了
134130,3879,陈向荣,2021-03-16 15:49:20,-2,17,19,后面一位，后面一位，后面，再后面，旁边一位，你知道吗，你不知道，你知道吗，你也不知道，不知道，你们都不知道
134136,3879,陈向荣,2021-03-17 01:47:55,1,24,23,不备课、念PPT的老师有一些，但是像陈向荣教授这样不尊重学生、自以为是的老师我还是第一次遇到，希望陈老师早点退休，不要再祸害浙江大学的学生了。\n\n另外，陈向荣教授看不上浙江大学和浙江大学的学生的话，建议另谋高就哦！
134147,3879,陈向荣,2021-03-17 04:53:32,4,24,20,几年前的事情了，今天听一个师兄说有一个学生为了保研成绩云云的让大家给陈老师刷差评，近期上课感觉不错，这样的诋毁配来浙大么？赶紧卷铺盖回家吧
134159,3879,陈向荣,2021-03-17 09:33:02,3,21,18,这学期开始上陈老师的课了，逻辑清楚、思维严谨，支持陈老师！
134184,3879,陈向荣,2021-03-18 07:35:20,3,19,16,挺好的！
134189,3879,陈向荣,2021-03-18 11:00:43,-1,19,20,学弟学妹们一定要注意，当评价两极分化严重的时候，要结合校内某论坛来评价这个老师
134237,3879,陈向荣,2021-03-20 09:08:04,4,20,16,可以的，不错！
134255,3879,陈向荣,2021-03-21 14:29:38,1,19,18,我不知道为什么在这门课开课前一段时间，会有刷好评的现象？\n\n老师还是需要给1分的，毕竟平台限制^^_
134319,3879,陈向荣,2021-03-23 15:10:36,1,19,18,客观来说，陈老师还是很有可爱的老师，爱了爱了
134334,3879,陈向荣,2021-03-24 04:19:41,0,18,18,刚听课回来，挺好的呀！是真的学到东西了，还行的！
134482,3879,陈向荣,2021-03-30 02:09:33,0,11,11,刷好评真的没必要 给1分是因为没有0分选项
134611,3879,陈向荣,2021-04-05 11:13:04,41,53,12,陈老师，你怎么不想一想你请了这么多水军刷评分，评分还是不及格呢？
134618,3879,陈向荣,2021-04-06 03:42:08,15,23,8,17级老同志劝大家选电控方向。电自躲不过去的，hhh
134619,3879,陈向荣,2021-04-06 04:47:22,16,28,12,刷好评的真多\n\n还牛头不对马嘴的\n\n底下那个刚上完课的 时间都对不上\n\n这老师就开了一门课 \n\n课友都怎么评价的我们还不清楚？\n\n现在终于换另外一个老师上了
134655,3879,陈向荣,2021-04-08 01:00:56,15,20,5,为啥要手写实验报告
134856,3879,陈向荣,2021-04-19 07:36:37,24,33,9,陈老师请水军之前就一点几分，请大家擦亮眼睛
135018,3879,陈向荣,2021-04-27 05:54:15,-6,8,14,挺好的，认真负责的好老师
135404,3879,陈向荣,2021-05-10 02:03:04,0,3,3,好好想想为什么全是好评评分还这么低
135405,3879,陈向荣,2021-05-10 02:03:43,6,9,3,水军不少呢
135699,3879,陈向荣,2021-05-19 11:39:56,-1,3,4,把课堂变成自己学生练习讲PPT的地方
136074,3879,陈向荣,2021-06-10 16:50:49,3,4,1,呵呵呵
139652,3879,陈向荣,2021-07-19 09:55:12,0,2,2,奇葩的规章制度
141898,3879,陈向荣,2021-10-30 15:45:18,-5,2,7,客观的说，个人觉得还不错
151453,3879,陈向荣,2022-03-08 03:49:20,8,11,3,sbcxr
152434,3879,陈向荣,2022-04-11 06:07:55,1,2,1,水军别水了，要不是只有一个教学班…..
152460,3879,陈向荣,2022-04-23 02:16:57,14,15,1,给分差的不行，垃圾
153856,3879,陈向荣,2022-05-13 07:29:02,4,5,1,请陈老师认真对待教师这份工作，课不想好好教咱就别开了吧。\n\n研究生写作指导，上课读ppt，ppt还是从别人的讲座拍照截下来的，内容重复空洞，没有具体例子，课堂呈现的内容简直就是论文写作的反面例子。\n\n不过他们实验室学长的分享倒是有干货。
156672,3879,陈向荣,2022-06-20 14:47:43,1,4,3,春学期上高电压技术，讲课不知所云，翻PPT速度堪比眨眼。
156718,3879,陈向荣,2022-06-20 17:56:21,12,12,0,助教xgg洪泽林人真的好，我好爱他
161409,3879,陈向荣,2022-11-06 14:00:55,2,3,1,你是怎么当上浙大老师的?就你这能力，当初怎么通过面试的，家庭背景强大?
172787,3879,陈向荣,2023-05-07 05:10:04,0,1,1,高电压神课
172978,3879,陈向荣,2023-05-10 15:31:40,3,4,1,回来吧陈向荣老师😭，我最骄傲的信仰❤，历历在目的高电压，还有给力的给分😤
173064,3879,陈向荣,2023-05-12 07:28:13,0,2,2,原来真的有水军啊
190280,3879,陈向荣,2024-02-27 06:22:38,5,5,0,开学第一课，我们班19人到18人，隔壁班60多。
191583,3879,陈向荣,2024-04-25 10:43:33,7,10,3,老师和善，会点名，助教很好，实验很水，就是要手写报告。上课不用怎么听，考试的话多刷历年卷、把作业题搞懂就行。只是这门课比较搞心态，陈老师还是很好的。\n\n\n\n出分了，助教先在群里公示了，说是平时分都尽可能给满了，批卷也很松。草看一下班里成绩总体可以，没有人挂的，想水的就来选吧。
191595,3879,陈向荣,2024-04-25 15:10:07,9,10,1,注意是洪泽林助教好不是cxr好，而洪泽林助教快毕业了。老师上课讲的非常快，重点不清晰，问问题也不回答，都说去书上找（其实书上根本没有）。最后考试只能面向98上的历年卷和提纲背诵，课不难，老师逆天，选隔壁老师能知道自己学了什么，不然就只能到期末的时候预习了。（另外请水军刷分的老师我是第一次见，可以看看21年的评价和21年之前的评价，懂得都懂）。
157494,3962,吴立建,2022-06-23 12:34:56,0,3,3,特种电机，2次小作业，一个论文，一个海报展示，没有考试。助教gg比较负责，没交作业会不停地私戳提醒。给分还不错。
160267,3962,吴立建,2022-09-16 04:31:07,0,3,3,特种电机今年的助教gg真的好帅！给分也很好，推荐大家选这门课
160821,3962,吴立建,2022-10-14 11:56:31,1,3,2,助教gg好帅～
160822,3962,吴立建,2022-10-14 12:01:10,1,3,2,今年的助教很热心，经常深夜帮我解答问题，也时常关心我
176027,3962,吴立建,2023-06-27 12:50:01,-1,4,5,这么好的老师为什么没人来赞一个
190861,3962,吴立建,2024-03-22 04:29:42,13,21,8,CAD 讲的是屎\n\n喜欢和助教上课相亲相爱\n\n喜欢提问\n\n傻逼一个\n\n\n\n“教材在我出生的时候就在用了”\n\n“现在设计都不按这本书来了”\n\n“我想写本书，但是没有时间”\n\n\n\n“虽然不用，但是考试要考”\n\n\n\n司马玩意儿，cnmd
192719,3962,吴立建,2024-05-29 08:49:17,4,6,2,讲的不如代课老师好\n\n前面上课节奏太慢，摇人回答问题太费时间，后面节奏越上越快，缺少重点
193271,3962,吴立建,2024-06-05 13:03:31,2,3,1,没见过这么死妈的大作业\n\n布置的这么靠近期末\n\n而且这么难算\n\n这么多要迭代的\n\n死妈了我操
193335,3962,吴立建,2024-06-06 13:11:23,6,8,2,大作业逆天
193676,3962,吴立建,2024-06-15 06:13:03,2,2,0,脑瘫大作业
193716,3962,吴立建,2024-06-16 04:59:01,3,3,0,讲完才发现原来那么多点都不考\n\n虽然他重点考点全讲了，但是讲了太多无关紧要的事情，偏向于工业界\n\n详略分不清，主次分不清\n\n节奏偏慢，适合平时不去，期末3倍速\n\n然而他点名\n\n每个人都点了一轮\n\n好像没点第二轮
193835,3962,吴立建,2024-06-20 05:22:55,1,1,0,虽然大作业和讲课真是依托，但是考试不难，跟历年卷变化不大，面向历年卷复习包过的
196617,3962,吴立建,2024-07-04 09:03:22,0,0,0,呃呃\n\n给分有点点差
201668,3962,吴立建,2024-11-05 08:23:40,2,2,0,nc一个，纯纯煞笔
219762,3962,吴立建,2025-06-05 08:30:51,4,4,0,特种电机海报展示还要去西溪校区，在期末周跑去西溪。。。还要自己把学术海报打印出来！！！
78247,4022,刘磊,2018-05-10 07:19:11,2,2,0,是一个没有什么经验但是在努力的老师（新手老师真
86362,4022,刘磊,2018-09-14 03:50:03,-3,0,3,辣鸡，真踏马辣鸡
86570,4022,刘磊,2018-09-17 08:40:56,0,0,0,酷炫神奇吊炸天
117927,4022,刘磊,2019-10-12 07:46:51,0,0,0,这课听着太刺激，实在顶不住
118239,4022,刘磊,2019-10-23 12:38:47,0,1,1,吹爆《电磁场数值计算》，很有用的一门课，只是过于硬核，师强我菜……
93237,4029,张伟,2019-01-08 08:14:04,9,9,0,电子电路实验一，真的是事多。每回基本都有实验报告，因为上课进度快就多上别的内容，结果四节的实验课延长到五节课也没做完，全班就一个人做完，然后就让我们自己课后到实验室做。。。还要验收。。。还要写实验报告。。。下次上课就期末考了呀。。。。看着室友三节课就做完实验还没有实验报告，表示心很累
93382,4029,张伟,2019-01-09 08:50:16,2,2,0,老师很好，特别有耐心，有问题尽管问他不要羞涩哈哈哈，会很认真的和你解答，很暖的老师
100241,4029,张伟,2019-01-26 00:25:41,2,2,0,电路与模拟电子技术实验：这个课评分是五级制，老师会按照实验位置点名，实验报告要手写，平时实验时有问题老师都会很耐心的解答的，最后一次的随堂测试有点点难，平时的电路要好好记清楚，临阵磨枪恐怕有点困难……出分稍微有点慢？不过给的很好！我还以为自己要挂了……感谢
101154,4029,张伟,2019-01-27 23:22:26,4,6,2,小学期2.5电路实验I4.5的选手来发个言。讲道理自己一直是一个动手能力很差的人，原来转专业前做化学实验的时候各种翻车，来了之后仍旧是如此。电路实验很多次做不好，到了数电部分，自己更加糟糕。第一次做数字钟，做到了12点还没做完，后来周五来补的。还有当我遇到FPGA，实验就几乎没有做完过。我真的是菜到，老师都认识了哈哈哈。最后一个程序，其实我都没有跑完整。这里要给老师扣一分，因为最后一个fpga只有一个人按时交了，给的题目太难了。不过最后考试的时候，操作题我一下过了，老师好像有点惊讶又有点开心，最后实验没跑完，老师还安慰我们几个，说平时分差别不大，不用担心。比较温柔的一个老师吧，感觉让我重新燃起了对实验的热情。不过也有一些想让人发牢骚的地方，比如电路实验报告要求用软件模拟一遍，我经常写个报告半天就过去了。。。而且老师很佛，从来不跟我们反馈实验报告出现的问题，也没有告诉我们考试范围，建议大家自己注意吧。\n\n给后来人的建议呢，就是上课好好听好好做，实验报告认真写，电路软件用一下，这对自己以后的课程和科研都大有裨益。理论考试的话都不难，不过有vhdl的大题，语法还要背一背，还有一些元件特性，比如二极管标称值什么的。祝大家都4.5！
108750,4029,张伟,2019-06-01 09:12:50,5,5,0,电气电子电路综合设计：上课不听的话写设计报告的时候要哭了（老师建个群多好，在线问设计报告怎么写）。
110317,4029,张伟,2019-06-25 14:57:30,2,2,0,求求老师手下留情\n\n
112013,4029,张伟,2019-07-03 07:24:50,2,2,0,考试要求一点都不讲
120682,4029,张伟,2020-01-15 06:18:56,3,3,0,其实老师可以的，平时实验比较水，最后考试也比较简单，但是实验报告内容要求比较高，还有电路实验1最后一次实验会很难，而且要验收，总之老师性格没问题挺亲切，就是自己下去一定要花功夫，个人电路操作一般水平最后4.5，仅供参考
124758,4029,张伟,2020-07-08 06:30:51,2,3,1,一开始上张伟老师的电路与电子技术实验2真的难顶。要求的实验任务比别的班多，要用的软件比别的班难（别的班用TINA我们还是用Orcad，下载＋调试Orcad我用了2天）。但是按要求做，把该做的都做完是可以得到相应回报的，不仅可以真的学到东西，还能有4.5的绩点
153877,4029,张伟,2022-05-15 04:16:35,3,3,0,人很好的老师，也和蔼可亲，也乐于回答我们的问题，甚至会亲自教我们绕线，单独帮我们查电路板的问题。可能大教室上课和语调平和的关系，上课其实效率挺差的，不过好在ppt非常详细。
164863,4029,张伟,2022-12-27 03:29:00,1,1,0,电路实验1，平时只要完成实验报告就好，我们这次考试是线上，有客观题和实验题，实验题考了VHDL和JK触发器设计步进电机，几乎都是PPT里的内容。
164866,4029,张伟,2022-12-27 04:44:07,2,2,0,电路实验1，非常佛系友好的老师。
170091,4029,张伟,2023-03-01 10:37:26,8,9,1,大家不觉得老师很像高启强吗\n\n（教室追星了
170346,4029,张伟,2023-03-03 03:51:10,0,0,0,我超强哥！
172357,4029,张伟,2023-05-04 03:41:36,3,5,2,学了其他老师的各种实验课和各种要求，你会发现张伟才是yyds
172358,4029,张伟,2023-04-25 10:47:15,1,3,2,学了其他老师的各种实验课和各种要求，你会发现张伟才是yyds
172359,4029,张伟,2023-04-25 10:47:15,3,5,2,学了其他老师的各种实验课和各种要求，你会发现张伟才是yyds
172722,4029,张伟,2023-05-05 07:24:28,0,2,2,大二一年最重要的结论：\n\n电路实验只有一个神\n\n张！伟！
172810,4029,张伟,2023-05-07 15:18:40,-3,0,3,电路与电子技术实验 张伟老师 你们有人不选我都会伤心的好嘛！\n\n这个五级制的课肯定要被卷\n\n就该选事情少的 做起来最愉快的\n\n另外这种实验课是结交朋友的好机会！
183087,4029,张伟,2023-11-22 05:53:28,4,6,2,我来喷\n\n上课依托答辩，随便一个初中技术老师都讲的比他好\n\n课上有哪些实验任务也不说，全靠同学用一般疑问句问\n\n讲的完全没有营养还贼喜欢讲，三节课能讲两节课，实验时间完全来不及\n\n有一说一，看个实验教材加上做实验，两节课绝对能做完\n\n乌鱼了，不懂为什么评分这么高
207625,4029,张伟,2024-12-23 10:27:57,2,2,0,老师我不想挂科。\n\n老师很好，很佛系很水，非常非常温柔有耐心。\n\n提醒一下：电路实验1历年卷在98搜老师大名即可，考的很像，但我考完才刷到。没复习好考的好烂。
217707,4029,张伟,2025-04-15 10:32:07,1,1,0,上过老师的电路1实验，老师虽然讲的不是特别清楚，但是佛系的态度和相对比较低的要求不会让人学的很难受。另外老师的实验课应该是下课最早的。可惜老师这学期没教模电实验，现在的老师要求一下高了好多，让我甚是怀念zw
76222,4041,张建良,2018-03-29 07:41:57,-8,4,12,老师讲课贼棒，细致，耐心，10分！
93385,4041,张建良,2019-01-09 10:13:13,-10,1,11,老师超级好(≧∇≦)
115348,4041,张建良,2019-07-19 07:05:08,5,7,2,什么东西
135892,4041,张建良,2021-06-01 07:29:44,9,11,2,评分制度有点恶心，一边说是送分，一边还要拉开很大的差距
135971,4041,张建良,2021-06-07 01:57:42,9,10,1,不是 就一普通的信号课 为什么要做和爱班一样的大作业？？太毒了  建议的项目一个比一个难 难度比srtp还高得多。。评分制度还照抄爱班制度 真的有问题
136091,4041,张建良,2021-06-11 02:09:16,5,7,2,快跑！！！\n\n老师事情巨多，还有大作业，要求离谱，大作业的内容和上课内容毫无关系，很恶心\n\n评分制度恶心，故意想拉大分差，变相鼓励内卷
136996,4041,张建良,2021-06-29 09:05:10,9,11,2,制度恶心，讲课很迷，没有重点，鼓励内卷
138757,4041,张建良,2021-07-10 16:40:38,10,12,2,说说个人的一些想法吧 老师是好老师，很多时候都很认真负责，反馈也比较及时，因为是小班授课，师生交流也很多，会询问同学意见和建议，在大作业时也会提出一些指导性的建议，就老师的教学态度来看个人认为10分完全不过分。大家也不要急着吐槽大作业选题和课程联系太少，你去隔壁信号与系统这门课也是一样的情况。\n\n但信号分析这门课程不合理的地方真的很…大作业评分分差太大了，人多的小组就十分吃亏；课时太少了，而且张老师大部分时间都花费在一些无关紧要的知识背景与知识点关系梳理方面（不知道其他班是不是这样），课程重点不突出，教材课后题太少而且没有参考答案，没有历年卷，总说让我们做题复习我能复习出什么东西来？试卷过分侧重理论知识理解，有点忽略实际应用；简答题不能说难，但写起来是真心难受，理论计算也基本没有用到多少知识点；反倒是实验课程表现让人没什么意见，除了设备有些陈旧以外并没有太多槽点。\n\n不知道系统建模与仿真如何，反正这门课个人觉得只是为了凑学分，学不到什么东西，想理解知识的同学建议自己看看奥本海默的《信号与系统》。
144766,4041,张建良,2021-12-23 13:04:31,0,0,0,就回家
152267,4041,张建良,2022-04-01 01:49:15,0,2,2,不建议选
155104,4041,张建良,2022-06-08 09:46:02,5,5,0,好老师，温柔有耐心
155882,4041,张建良,2022-06-16 12:17:41,1,3,2,电工电子学实验，给分不错，好老师
156887,4041,张建良,2022-06-21 09:25:21,6,6,0,事情多是多了点，跟上了一门通识课一样，老师很臭狗，很喜欢。
157653,4041,张建良,2022-06-24 08:20:02,0,0,0,赶紧逃
174566,4041,张建良,2023-06-14 06:50:20,0,0,0,老师很热情，作为外专业的同学很喜欢老师
194913,4041,张建良,2024-06-26 02:26:10,0,0,0,坐标电工电子学实验，感觉给分不错
219981,4041,张建良,2025-06-13 04:44:59,0,0,0,电工电子学，给分一般，没口头说的好
80185,4067,张健,2018-06-21 07:14:21,-5,4,9,讲课特别好而且细致，每隔一会就会特别细心地问大家“听懂了吗？没听懂我再讲讲”，还会问前排的同学哪里不会他再讲讲……人特别温柔！特别温柔！特别温柔！选他的信号吧不亏的！
85725,4067,张健,2018-07-30 01:41:39,-6,3,9,讲课娓娓道来，思路清晰至极，为同学分数着想，把考点讲的清清楚楚，没有大作业。总之比隔壁翔基好一万倍
92432,4067,张健,2018-12-28 14:27:13,-4,1,5,好好好
102679,4067,张健,2019-02-20 07:24:11,-8,0,8,班主任萌萌哒，人超级nice
105699,4067,张健,2019-04-18 15:09:41,-2,2,4,666
106530,4067,张健,2019-04-28 04:16:56,-1,9,10,啥也不说了，信号课最好的老师
108112,4067,张健,2019-05-15 06:25:01,-4,2,6,圈粉了！！
108451,4067,张健,2019-05-24 13:31:40,0,11,11,讲课十分清晰！！！会帮同学们把前面的知识点串起来，比念ppt的老师好多了
109010,4067,张健,2019-06-05 10:52:15,-5,4,9,太好了呜呜呜，要是一开始就是这个老师我信号肯定不会学成这样
109451,4067,张健,2019-06-14 14:45:11,2,9,7,就这样吧一般
109781,4067,张健,2019-06-19 07:23:52,-2,4,6,老师讲课很认真也很仔细，会和学生互动问有没有不懂的地方，信号最好的老师！
109837,4067,张健,2019-06-19 14:39:55,-2,3,5,好老师！
110316,4067,张健,2019-06-25 14:28:18,-7,1,8,老师很好啊 信号课本来就难 老师讲的浅显易懂 各种资料作业题答案的做得很认真 总之很好
112649,4067,张健,2019-07-04 23:38:15,-2,2,4,感谢老师捞我！
114186,4067,张健,2019-07-09 03:36:34,-10,1,11,我是上的他和杨欢老师的信号分析，感觉老师很幽默，讲课也很有趣。
125474,4067,张健,2020-09-10 02:55:08,-7,1,8,感谢老师海底捞，教师节快乐！！！
137139,4067,张健,2021-07-01 12:01:19,-2,3,5,喜欢打魔兽争霸
138559,4067,张健,2021-07-09 23:30:42,-1,4,5,没有大作业！没有大作业！
175499,4067,张健,2023-06-25 07:59:46,-4,3,7,昨天早八信号今天就出分了 个人感觉老师给分很好 而且感觉老师对待课堂很认真 讲课真的超级无敌好 至于压力 我是没感受到老师很给压力 可能上课比较摸鱼吧
176451,4067,张健,2023-06-29 03:05:06,-6,1,7,难得教的好的又搞科研的老师
177006,4067,张健,2023-07-01 04:48:29,-4,1,5,讲课很清楚！！
181657,4067,张健,2023-10-25 12:48:18,4,6,2,建议上98问，不要被忽悠瘸了
184127,4067,张健,2023-12-17 04:55:39,11,12,1,产业技术前沿过来的，上课板着个破脸
189438,4067,张健,2024-01-24 07:29:53,15,18,3,工院产业技术前沿过来的，只能说课和老师一个比一个有病，上课全靠笔记多少给平时分，一共4页纸，写了差3行满4页都不给满只给7分，只有写满4页的才给7.5分😅\n\n甚至在专业相关的讲座时少写了些，给的更少，去和老师反馈，先理你一下，跟你说他也不知道你是否专业相关，只靠笔记要点给分，说有很多要点没写到。可看他上课的时候也在看自己的书，我是不相信他自己记了笔记甚至还在评分的时候一一比对😅然后继续跟他理论，就直接装死不理人。要不是最后大作业还要看他的脸色，我直接当场继续对线……
193642,4067,张健,2024-06-14 08:59:47,11,12,1,真不明白为什么这么多人夸他，上课讲的一般，压力的要死，板着臭脸，做他的研究生更是折磨，各种不给资源，纯纯压力怪，在他手下待三年真要去启真湖底捞你了
193819,4067,张健,2024-06-19 14:47:25,4,8,4,说实话讲的真不错吧，信号课细心耐心的，挺好
194089,4067,张健,2024-06-22 02:40:40,7,11,4,信号补天听了张健老师的智云，真的讲得很透彻，醍醐灌顶
195288,4067,张健,2024-06-27 15:25:51,2,3,1,工院选修电气设备健康管理过来的，每节课点名，每次下课有作业，有期中大作业和期末PPT考核，极其硬核不知道的还以为在上本科核心课😅\n\n请假直接不回消息。傻屌一个
202930,4067,张健,2024-11-15 12:02:12,2,2,0,工院产业技术前沿过来的，真的是变着花样的收作业，别的班拖堂了他不让走，一个一个的收作业，早退的就拍桌子照片，然后不收作业把作业放抽屉里，也不给分，真的做的太绝了，变着法的折磨人，真天才！
203947,4067,张健,2024-11-22 07:18:28,1,1,0,产业确定很前沿，考核确实相当落后，这老师也封建的一匹，提前一会儿走就不收了，补交也不让补交。问为什么，“哎呀，我上课巡视，看你那个位置第一节课下课就走了”我说我后面才走的，没用，他的眼睛就是尺。当老师有点权力不得了了，就拿来压学生。有人肯定就要说了，都提前走了，本身就不对。那我请问了，老师就在一个班上，其他班和上网课有什么区别，还不如上网课，上网课还能评论答疑，这个呢，答疑没其他班什么事，还有守着全部答疑完才走。我上午zjg上课，校车也来的不早不晚的，刚好卡在不够吃饭的时间，我饭都没吃就来听下午这个课，想着不迟到，写完了都多坐了那么久才打算提前走的去吃饭。饿着肚子听讲座，还得不到好处，那我以后必不可能不迟到了，屎都攒在这个课来拉。
216746,4067,张健,2025-03-24 03:28:39,-1,0,1,上信号课阴阳怪气的
219958,4067,张健,2025-06-12 06:28:31,1,1,0,信号课讲得很清晰，很推荐听他的信号
220598,4067,张健,2025-06-18 23:25:27,1,1,0,张健老师后八周的信号分析与处理讲的是真好，不看老师的智云我是真学不懂一点。个人觉得比杨欢老师讲的更好理解些。不过上课不让用电脑，平常不签到（唯一一次突击数字点名只开了一分钟，后来说是希望大家能尽量来上课，没签上的同学也没有扣分）板书写的很漂亮，信号补天很推荐看他的智云
220705,4067,张健,2025-06-19 08:57:58,0,1,1,讲课非常清楚，给分中规中矩，好老师
220790,4067,张健,2025-06-19 17:56:33,1,1,0,（信号）补个评价，上课压力是真的挺压力的（大学三年数一数二），会随机抽人，然后我们当时是说了不能用电脑，用电脑就当场叫出去。但是讲课吧，是没有太大问题的，思路还算清晰的
221694,4067,张健,2025-06-26 06:59:33,0,1,1,讲课不错，在专业课里面算顶尖了\n\n有一节课来了一次课前点名，稍微吐槽一下点名是课前两分钟开始的，后面上课也没说，不过点名没有计分，只是为了督促我们来上课\n\n个人认为平时的事项交代的不如yh清楚，作业和实验交代和布置的都不是很及时，不过期末答疑比较积极\n\n只论信号这课至少可以值9分\n\n下面的是不是理解错我的意思了，其他专业课大多数还真比不上信号吧，信号质量确实比不上数理基础课和数模电，这些又不是专业课，不好意思专业课我还真没吃过好的
221714,4067,张健,2025-06-25 11:30:48,-1,0,1,没吃过好的？这水平也能算顶尖\n\n不说和大一数理基础课比，也不必数模电的老师，隔壁信电的胡浩基老师就不能比\n\n教的一点也不深入，信号这课教的既不数学也不工程
221799,4067,张健,2025-06-26 09:43:51,0,0,0,讲课非常好的老师，但是老师私下说话有点凶，不是很和蔼\n\n总是很喜欢他的，钉钉回答问题也挺快
221936,4067,张健,2025-06-27 13:28:29,2,2,0,讲的比yh好太多，能简明扼要地把电院的这门信号讲的透彻，还是很有水平的。但除了讲课水平高以外，其它的也就一般，作业和报告布置的都不及时，有一次课前两分钟还搞了个点名，上课的时候也不说，搞得很多准点到的同学也没签上（虽然这次好像没算分，但是蛮膈应的）。不过横向对比来看，就电院的信号而言，杨欢+张健的组合似乎已经是最佳了，其它的老师多少都有点抽象。
75879,4158,李超勇,2018-03-20 14:41:26,5,5,0,高能段子手
76180,4158,李超勇,2018-03-28 09:29:55,4,5,1,系统辨识课太难，英语听不懂，但是老师给分大方，私下聊天一流风趣！
76386,4158,李超勇,2019-03-08 02:35:10,23,27,4,东北大汉，在老美工作经历：我不种族歧视。老黑是人和动物之间的一个品种。\n\n老印，厕所一样的国家。穷地跟啥似的\n\n讲课时而幽默，搞笑。还没考试
80517,4158,李超勇,2018-07-06 04:38:40,4,4,0,绝对好老师，选他选他！千万别选隔壁lmq
81095,4158,李超勇,2018-07-04 02:10:54,9,9,0,讲课比刘老师班快太多，多余时间讲老印，老黑，墨西哥，单口相声?。期末良心复习，画画重点，希望大家都过?
81697,4158,李超勇,2018-07-06 02:31:28,7,7,0,高萌段子手，讲课进度正常，隔壁太慢。希望大家都过，“不然你们明年来我讲段子的时候你们在下面‘听过啦听过啦’”2333333
81699,4158,李超勇,2018-07-06 02:32:27,3,3,0,好老师，划重点，讲课幽默，选他不要选lmq
81782,4158,李超勇,2018-07-06 07:26:21,2,2,0,点名比较多\n\n但是人很好！超好，高能段子手
85852,4158,李超勇,2018-08-22 15:36:09,1,1,0,李老师段子：任何一个大学寝室都一个怪胎，如果到现在你还没发现这个怪胎是谁，那你就是这个怪胎！?上课风趣，经常有意想不到的段子，考试给分不难，推荐！
88505,4158,李超勇,2018-10-31 11:47:02,0,0,0,有意思
89319,4158,李超勇,2018-11-18 11:08:58,2,2,0,很逗比
102773,4158,李超勇,2019-02-22 19:14:57,0,1,1,这门课怎么这么热，选两次都没选上，看看能不能补选吧！
110820,4158,李超勇,2019-06-28 09:22:49,0,0,0,段子多，划重点，据说比隔壁班好很多
134073,4158,李超勇,2021-03-15 05:18:11,0,2,2,每堂课都点名
134608,4158,李超勇,2021-04-05 06:09:18,4,4,0,幽默感一流，上课风趣好玩，名不虚传
135286,4158,李超勇,2021-05-07 14:26:17,3,3,0,好老师，不能单单用幽默风趣评价了，不谈是否赞同有些观点，但是起到了醍醐灌顶的作用
141693,4158,李超勇,2021-10-20 09:17:08,3,3,0,节节小测也太麻烦了\n\n老师确实是好老师
142015,4158,李超勇,2021-11-04 03:32:28,2,2,0,今年不讲老黑和老印了，心疼
143530,4158,李超勇,2021-11-26 04:07:35,3,3,0,还挺帅的:)
173876,4158,李超勇,2023-06-04 04:43:01,-1,0,1,1111
183290,4158,李超勇,2023-11-23 12:53:27,6,7,1,给分一般吧，上课除了段子没啥可听的，考前透露的“考点”一个都没考👍🏻
203182,4158,李超勇,2024-11-17 17:07:10,1,1,0,几乎每节课点名，给分一般
203573,4158,李超勇,2024-11-20 05:30:35,1,1,0,每节课随机点名，被卡绩了
208495,4158,李超勇,2024-12-28 11:43:23,5,5,0,21级回来评价下这课程，老师人不错，上课有趣，但考点的确也没压到，给分一般般。但在现控这门课程里，老师已经算非常不错了\n\n但助教（仅针对23年）死全家，摆着那副臭脸装什么呢
212783,4158,李超勇,2025-01-15 01:57:58,2,2,0,老师人还不错，讲课算快的，最后会有一节复习课。每节课都会随机点名，平时分构成就是点名+作业+实验报告，没有记分的小测。不过会有几次小测，题目打出来让自己做，后来看应该都是以前的考题。今年考试前复习课带着做了几个非常难算的题，和作业非常不一样，结果考试就考到非常难算的，这门课以后的趋势可能就是计算量爆炸。讲课还行吧，不过没有细听，看书学的，这种有份正常教材的课在控院大三专业课有点难得。\n\n\n\n给改作业的助教7分，不太认可作业要求全对不然扣分，同时又不提供解析，答疑也不太爱搭理这种行为。最后可以提交改错作业，或许会重新算分，这一点还算好吧。改实验报告的助教最多6分，如果是和作业同一个那我没得说。我不理解为什么实验报告能每篇人均扣两三分，是学校给了什么规定吗，实验报告就那些内容究竟有哪里让他不满意了给全班打低分。
76534,4162,陆玲霞,2018-04-13 00:32:59,1,3,2,emmmmm
79286,4162,陆玲霞,2018-05-30 04:04:35,3,4,1,好好好
79738,4162,陆玲霞,2018-06-13 07:09:11,6,7,1,老师人超好，实验课特别认真负责，还经常分享学习经验
84485,4162,陆玲霞,2018-07-13 03:15:14,3,4,1,有耐心，负责，有趣，好看，好老师
90454,4162,陆玲霞,2018-11-23 13:44:27,3,4,1,有耐心，负责认，会给予你鼓励，好看可爱萌萌哒，我还想上她的课
93419,4162,陆玲霞,2019-01-09 12:59:11,5,6,1,嵌入式满了\n\n老师真的超级负责\n\n和学生一起debug的好老师
113872,4162,陆玲霞,2019-07-07 22:34:06,2,4,2,老师人超好，特别温柔，而且给分好
123681,4162,陆玲霞,2020-06-11 10:46:12,2,3,1,老师好可爱，讲的真的好详细好认真
127994,4162,陆玲霞,2020-12-02 12:55:04,22,23,1,好老师！有耐心，有颜值，和蔼亲切。嵌入式系统实验本身不难，不出意外的话1小时内肯定能做完。不过自主探究实验如果选了困难一些的题目还是挺难顶的
136616,4162,陆玲霞,2021-06-22 03:03:57,1,1,0,老师人很好哇！
137917,4162,陆玲霞,2021-07-06 14:53:22,0,0,0,还行。\n\n老师记得每个人
137919,4162,陆玲霞,2021-07-06 14:52:35,0,0,0,挺好的。
138014,4162,陆玲霞,2021-07-07 05:15:25,-3,1,4,中规中矩
142049,4162,陆玲霞,2021-11-04 16:16:09,3,3,0,我的女神！！！
154531,4162,陆玲霞,2022-06-02 04:17:26,4,4,0,超级好！！！！！
155505,4162,陆玲霞,2022-06-13 15:53:49,0,0,0,老师人很好，非常有耐心
155595,4162,陆玲霞,2022-06-14 14:18:32,5,5,0,人美心善有耐心负责温柔，选了绝对不亏
170239,4162,陆玲霞,2023-03-02 06:35:05,2,2,0,很温柔的老师，遇到算走运了
177004,4162,陆玲霞,2023-07-01 04:46:11,2,2,0,每次实验课都能把原理讲的很清楚\n\n很有耐心很负责！！\n\n大爱电院老师
182246,4162,陆玲霞,2023-11-13 08:11:29,0,0,0,当时我在钉钉上问她一个问题，她直接给我打了钉钉电话给我讲解，有种受宠若惊的感觉
183640,4162,陆玲霞,2023-11-28 05:52:15,0,0,0,Considerate
184604,4162,陆玲霞,2023-12-22 02:30:49,0,0,0,是好老师
186852,4162,陆玲霞,2024-01-13 08:59:15,3,3,0,老师上课、对同学都很友善，讲解也很清晰，很为同学们考虑。但最后给分实在是不尽人意，也可能是因为五级制给分本来就会偏低吧
191449,4162,陆玲霞,2024-04-22 14:18:50,1,2,1,特别温柔的老师，嵌入式系统非常耐心地帮忙一起解决问题！
221047,4162,陆玲霞,2025-06-21 04:10:09,1,1,0,史课不影响我给老师10分
79500,4198,王飞,2018-06-07 07:35:26,0,0,0,沙壁吧，给分乱七八糟，之前跟我们说实验报告手写分数高，写了一段时间，某一周不手写改打印了，结果分数变高了，一对比，发现之前手写的都是偏低的，你说气人不气人
80805,4315,张晓洁,2018-07-01 09:03:56,5,8,3,上课还行
80829,4315,张晓洁,2018-07-01 14:03:00,1,3,2,还行，不怎么管
83647,4315,张晓洁,2018-07-11 02:13:57,1,3,2,给分不错。
86745,4315,张晓洁,2018-09-18 08:59:02,0,2,2,瞎写的hahaha
91415,4315,张晓洁,2018-12-09 12:32:47,0,6,6,讲的太垃圾了
111770,4315,张晓洁,2019-07-02 22:06:42,0,1,1,给分不错 背思考题有用！
111819,4315,张晓洁,2019-07-03 00:15:29,0,1,1,好好背思考题。课后选择题好好看。\n\n老师给分挺好的！
111836,4315,张晓洁,2019-07-03 00:45:15,4,7,3,你们不觉得老师很好看吗
112034,4315,张晓洁,2019-07-03 08:39:33,1,3,2,sygg真是太好了
120233,4315,张晓洁,2019-11-24 11:32:49,3,3,0,高中政治课了解一下？就是个沙比不解释
121650,4315,张晓洁,2019-12-10 11:35:10,1,1,0,课讲得不行
70999,4334,李济沅,2018-01-28 01:39:37,47,57,10,啊啊啊啊我是首评！济沅这么好的人现在终于出现在查老师上了！大家快帮他刷上高分榜！
71001,4334,李济沅,2018-01-29 08:39:41,39,49,10,男神！！
71002,4334,李济沅,2018-01-28 01:43:55,93,110,17,太棒啦！我们辅导员，简直就是全民偶像，什么国奖，唐奖都拿过，党课，团课贼6，像我们的大哥哥。
71003,4334,李济沅,2018-01-28 01:44:26,49,59,10,最好的辅导员了！特别随和，特别好。工作超级负责的，大爱济沅~比心~
71004,4334,李济沅,2018-01-28 01:45:09,21,29,8,厉害?
71005,4334,李济沅,2018-01-28 01:45:31,38,45,7,老师人超好！！送过我们生日礼物，一本书，书上还写了长长的祝语！！对我们也超级暖！！必须十分！！
71007,4334,李济沅,2018-01-28 01:46:38,10,14,4,棒棒棒
71008,4334,李济沅,2018-01-28 01:46:39,31,37,6,超级优秀！！！人生导师！！！济沅男神！！！疯狂打call！！！
71009,4334,李济沅,2018-01-28 01:47:29,15,20,5,我爱济沅！！！
71010,4334,李济沅,2018-01-28 01:47:54,11,18,7,棒的一匹，有幸成为他的学生真是幸运。
71012,4334,李济沅,2018-01-28 01:48:35,11,15,4,爱你❤️❤️❤️❤️爱济沅
71014,4334,李济沅,2018-01-28 01:49:10,12,17,5,超级棒的老师！超喜欢！男神！！
71015,4334,李济沅,2018-01-28 01:49:26,9,15,6,有点6\n\n
71016,4334,李济沅,2018-01-30 16:21:12,7,11,4,为什么还是0.00
71017,4334,李济沅,2018-01-28 01:51:28,25,32,7,真想再听一遍济沅的“悟空”。
71019,4334,李济沅,2018-01-28 01:51:56,6,11,5,哈哈哈
71021,4334,李济沅,2018-01-28 01:53:03,6,10,4,棒！非常棒！男神！
71023,4334,李济沅,2018-01-28 01:53:42,14,16,2,亲和力Max，还会在群里发红包
71024,4334,李济沅,2018-01-28 01:57:23,8,12,4,老师真的很好很好
71030,4334,李济沅,2018-03-20 08:58:49,8,11,3,评分！
71031,4334,李济沅,2018-01-28 01:59:29,7,10,3,超级好的辅导员，善解人意！！！
71032,4334,李济沅,2018-01-28 01:59:29,8,12,4,非常棒，形策也上得贼好
71033,4334,李济沅,2018-01-28 02:00:20,6,9,3,老师很6
71034,4334,李济沅,2018-01-28 02:00:31,6,10,4,济沅就是屌，不接受一切反驳
71035,4334,李济沅,2018-01-28 02:00:40,5,9,4,超级好辅导员，大爱济沅
71036,4334,李济沅,2018-01-28 02:00:53,10,16,6,帅气，牛逼，说话水平高的一批，全球最佳辅导员！
71037,4334,李济沅,2018-01-29 12:35:06,7,10,3,哈哈啊
71038,4334,李济沅,2018-01-28 02:01:25,9,16,7,给十分，不怕你骄傲
71043,4334,李济沅,2018-01-28 02:04:34,5,9,4,是辅导员也是社团辅导老师，很有把人聚在一起的力量！
71045,4334,李济沅,2018-01-28 02:05:27,7,9,2,棒棒哒
71047,4334,李济沅,2018-01-28 02:06:29,40,46,6,人类救赎，宇宙教父，博学多才，双商感人，平易近人，人格魅力，英俊帅气，天妒之才，思想红专，品格卓越，他在哪里都是光
71050,4334,李济沅,2018-01-28 02:08:22,23,30,7,济沅济沅！男神一般的存在！就是这么幽默优秀优雅！国奖唐奖什么的都拿过！上党课也贼有趣！人格魅力太足了！打十分是因为只有满分十分！
71059,4334,李济沅,2018-01-28 02:14:06,20,27,7,我没有听过李教授的课，但是他来查过寝，还把刚看了5分钟剧的我逮着了，说如果微积分绩点不到4.0就告诉家长，结果我微积分绩点真的上4了，感谢李教授的股♂励
71061,4334,李济沅,2018-02-05 14:45:26,7,10,3,0.00？
71066,4334,李济沅,2018-01-28 02:20:17,10,15,5,真的太有幸太有幸遇见这样的辅导员了，有幽默感有亲和力，关心学生认真负责，简直不要太棒！！还有各种奖学金拿到手软啊！太优秀了啊！有趣的灵魂啊！jydltqltql！
71086,4334,李济沅,2018-01-28 02:46:23,6,11,5,什么时候能像你一样优秀?
71106,4334,李济沅,2018-01-28 03:04:19,4,7,3,好辅导员，幽默风趣，认真负责
71135,4334,李济沅,2018-01-28 04:10:13,4,7,3,perfect\n\n
71529,4334,李济沅,2018-01-28 15:03:53,3,6,3,好，太好了
71530,4334,李济沅,2018-01-28 14:50:23,3,6,3,十分拿好 不怕你骄傲
71534,4334,李济沅,2018-01-28 14:56:46,15,20,5,喵的！ 我是有多幸运才能让他成为我的辅导员呀qwqqqqq 拿过学校所以的最高奖学金和奖项的巨巨巨佬 每个礼拜的团总支工作会议都能学到很多东西 经常带我们出去玩 也教会我们很多人生道理 然后皮的时候特别特别皮（还记得那个让两个男生亲上的操作哈哈哈哈哈哈哈哈哈）认真的时候又很正经嗯 生日会送礼物！状态不好会找你聊天！平时会认真记录大家的情况！（悟空也唱的贼辣辣好听）gay沅你说集体婚礼的时候你会忙死 当时大家开玩笑说你自恋233 其实心里想着：那当然啦！
71539,4334,李济沅,2018-01-28 14:59:29,3,6,3,大佬，朋友，老师
71543,4334,李济沅,2018-01-28 15:09:17,1,4,3,十分，最好的辅导员，不解释，最好的老师，不解释，并不是我懒得解释，是没必要，真的没必要
71545,4334,李济沅,2018-01-28 15:10:14,1,4,3,亲近贴心炒鸡棒!
71551,4334,李济沅,2018-01-28 15:17:14,0,4,4,男神，不必多说了
71552,4334,李济沅,2018-01-28 15:18:07,1,4,3,济沅男神，特别关心人
71559,4334,李济沅,2018-01-28 15:26:21,1,4,3,给济沅教授疯狂打call
71565,4334,李济沅,2018-01-28 15:30:40,2,5,3,世界上最好的老师 真的最好最好最好最好的 我爱他一辈子 真的 他人超级好 会在你需要的时候帮助你 会关心你 是一个真正好的老师 真的 以上济沅教授 是我最幸运的一件事之一 我爱他 希望教授越来越好！！
71581,4334,李济沅,2018-01-28 15:46:33,5,7,2,李教授对学生的关心是无微不至的。特别会为学生着想。李教授本身也是一个极其光辉的形象，始终激励着电气学院的大家。
71589,4334,李济沅,2018-01-28 16:03:30,2,5,3,超级有爱超级棒的辅导员 无比认真负责 文化素养非常高 待人非常和蔼 很高兴能成为济沅大佬的学生
71629,4334,李济沅,2018-01-28 18:37:21,10,14,4,大学有个目标，就是跟gay沅搞基！
71655,4334,李济沅,2018-01-29 00:06:43,3,5,2,棒不棒，棒
71664,4334,李济沅,2018-01-29 00:18:02,2,4,2,老师讲课简直是一种人生洗礼，太棒了太优秀了好不好！！！
71666,4334,李济沅,2018-01-29 00:18:58,-12,15,27,怎么感觉老师你对得起天下，负了我一人。打军体拳，参加合唱，遵纪守法，绩点3.3? ? ?
72043,4334,李济沅,2018-01-29 08:48:27,1,3,2,男神济沅！最好的辅导员！十项全能！样样精通！门门满绩！电气男神！！！！！
72044,4334,李济沅,2018-01-29 08:52:32,2,4,2,大爱男神辅导员！\n\n
72052,4334,李济沅,2018-01-29 09:06:49,3,4,1,超级超级棒啊
72054,4334,李济沅,2018-01-29 09:06:58,4,6,2,老师给我的人生带来了另一种可能，是他教会了我在大学的正确人生道路。他就是男神
72065,4334,李济沅,2018-01-29 09:30:20,3,4,1,特别暖的一个辅导员，很关心学生，说话还不失幽默风趣，为他打call！！！！
72083,4334,李济沅,2018-01-29 10:06:10,4,5,1,男神济沅！！！
72111,4334,李济沅,2018-01-29 11:09:17,3,4,1,秀 \n\n天秀 \n\n陈独秀 \n\n蒂花之秀 \n\n造化钟神秀 \n\n李大钊陈独秀 \n\n维多利亚内衣秀 \n\n吾何时能及汝之秀 \n\n同福客栈李秀莲的秀 \n\n我滴龟龟你怎么这么秀 \n\n李云龙老婆秀芹的秀 \n\n求求你了不要再秀 \n\n米兰国际时装秀 \n\n湖南台真人秀 \n\n中国梦想秀 \n\n山清水秀 \n\n年代秀 \n\n刘秀 \n\n秀
72121,4334,李济沅,2018-01-29 11:28:56,4,6,2,太棒了，大爱济沅
72126,4334,李济沅,2018-01-29 11:53:17,4,5,1,人超好，有这样的辅导员真是太棒了！
72133,4334,李济沅,2018-01-29 12:05:36,4,6,2,遇到济沅是三生有幸
72522,4334,李济沅,2018-01-30 09:29:22,4,5,1,老师太太太棒啦，大学霸
72530,4334,李济沅,2018-01-30 09:51:03,5,6,1,看到你们把夸济沅的话全说了，我只好在下面默默把你们全赞一遍
72573,4334,李济沅,2018-01-30 11:59:13,1,3,2,他就是我男神
72914,4334,李济沅,2018-01-31 10:23:06,1,2,1,疯狂打电话
73075,4334,李济沅,2018-02-01 01:06:53,0,1,1,不解释，男神
73162,4334,李济沅,2018-02-01 05:10:10,-2,2,4,兄弟们给力啊，争取评分超过吕强
73309,4334,李济沅,2018-02-01 09:57:41,0,1,1,十分拿走，不怕你骄傲。
73479,4334,李济沅,2018-02-01 15:46:03,0,2,2,博闻强识
73931,4334,李济沅,2018-02-03 15:21:28,0,1,1,很好的老师，听说打10分会溢出。。。我来打个九分吧。。。（但其实我真的想打十分啊啊啊）
73933,4334,李济沅,2018-02-03 15:23:32,2,3,1,不要再溢出，让我们济沅有个分
73935,4334,李济沅,2018-02-03 15:28:31,-5,0,5,最棒最棒的老师，不夸张的说可谓博古通今，讲课时诙谐幽默、旁征博引，生活里也是真诚的帮助你。李老师小小的身体大大的能量(･ิϖ･ิ)っ
73936,4334,李济沅,2018-02-03 15:35:55,0,1,1,666
73937,4334,李济沅,2018-02-03 15:47:01,-3,1,4,好的呢
73939,4334,李济沅,2018-02-03 15:55:02,0,1,1,崇拜。
73951,4334,李济沅,2018-02-03 18:47:54,1,3,2,必须十分！
73958,4334,李济沅,2018-02-04 00:21:18,0,2,2,第一个打10分的辣济老师
73988,4334,李济沅,2018-02-04 03:37:04,0,2,2,很棒，为了不溢出...\n\n
73996,4334,李济沅,2018-02-04 04:03:40,0,2,2,男神有趣
74784,4334,李济沅,2018-03-06 01:46:10,0,2,2,hhh
74815,4334,李济沅,2018-03-06 04:12:34,0,2,2,济沅天下第一☆
74934,4334,李济沅,2018-03-06 14:23:15,0,2,2,为什么是0.00呀
75062,4334,李济沅,2018-03-07 07:19:31,-5,1,6,6666667
75263,4334,李济沅,2018-03-08 08:31:40,0,1,1,怎么没分啊
75524,4334,李济沅,2018-03-13 02:25:24,0,2,2,不忍心打9分
75563,4334,李济沅,2018-03-13 10:38:48,2,4,2,从隔壁孙大雁老师那里慕名而来
75718,4334,李济沅,2018-03-15 11:31:33,0,2,2,棒棒哒
75854,4334,李济沅,2018-03-20 03:15:07,0,3,3,还有谁！！！
77375,4334,李济沅,2018-05-05 06:36:26,0,2,2,牛逼啊
79794,4334,李济沅,2018-06-13 15:43:05,0,2,2,挺好的，辅导员
80053,4334,李济沅,2018-06-19 08:32:00,0,2,2,牛逼！
81846,4334,李济沅,2018-07-06 09:56:47,1,3,2,我爱济沅
83276,4334,李济沅,2018-07-10 04:01:41,1,2,1,形策助教，疯狂打call超级棒的小哥哥\n\n
83404,4334,李济沅,2018-07-10 08:17:25,2,3,1,形势与政策，给分超好！疯狂打call
88075,4334,李济沅,2018-10-21 14:20:43,1,2,1,济沅大佬，巨优秀！很棒的辅导员啦！
88122,4334,李济沅,2018-10-22 13:20:24,1,2,1,济沅最帅了
91973,4334,李济沅,2018-12-25 06:48:26,1,2,1,强无敌，不解释，不接受反驳！
92431,4334,李济沅,2018-12-28 14:26:34,0,1,1,超级好
92875,4334,李济沅,2019-01-05 09:08:53,0,1,1,哈哈哈
92998,4334,李济沅,2019-01-06 17:20:44,0,1,1,极好的
95414,4334,李济沅,2019-01-28 09:04:05,4,9,5,求求您别在群里发成绩了，看着群里膜感觉很爽是吧khsl
103121,4334,李济沅,2019-02-26 04:47:22,3,4,1,叫李教授
104281,4334,李济沅,2019-03-16 04:01:24,23,28,5,小渣渣们看过他本科成绩单吗? ?
104791,4334,李济沅,2019-03-28 02:22:51,0,5,5,人类救赎，宇宙教父，博学多才，双商感人，平易近人，人格魅力，英俊帅气，天妒之才，思想红专，品格卓越，他在哪里都是光
104792,4334,李济沅,2019-03-28 02:23:44,0,5,5,超级好，可爱可亲的济沅老师，就是糟老头子坏点子多
104793,4334,李济沅,2019-03-28 02:23:50,1,5,4,哦呼，是初恋的感觉
104794,4334,李济沅,2019-03-28 02:26:55,-4,1,5,牛逼不解释
104795,4334,李济沅,2019-03-28 02:33:00,-10,3,13,大爱济沅！！我想安心做舔狗！！
104796,4334,李济沅,2019-06-01 11:11:54,-7,3,10,济沅牛逼
104799,4334,李济沅,2019-03-28 02:56:42,-10,2,12,炒鸡棒的济沅男神！争取刷上10分！！！
104801,4334,李济沅,2019-03-28 03:08:48,-9,2,11,辣是真的强
104802,4334,李济沅,2019-03-28 03:20:07,-7,1,8,超级超级赞
104806,4334,李济沅,2019-03-28 03:31:37,-7,1,8,男神nb
104808,4334,李济沅,2019-03-28 04:37:30,-10,2,12,特别幸运能遇到济沅男神，婚礼主持人预定
104898,4334,李济沅,2019-03-30 08:57:03,20,23,3,天天仇视cs，怨气太重
105173,4334,李济沅,2019-04-06 03:38:58,16,18,2,名不副实
105342,4334,李济沅,2019-04-10 07:24:13,11,11,0,是个弟弟
105769,4334,李济沅,2019-04-20 08:29:47,3,3,0,
107032,4334,李济沅,2019-05-01 03:08:58,19,21,2,济沅飘了
109593,4334,李济沅,2019-06-17 10:26:05,17,30,13,除了会打官腔应付大家的诉求您还会干什么？大家义愤填膺的时候您又躲起来跑到干部群里要求维稳……这还是大一大家认识的济沅吗？升了官果然不一样呢！失望……
109599,4334,李济沅,2019-06-17 11:36:58,-8,7,15,出了点问题就到处甩锅？知道些什么就到处口吐芬芳？济沅一直兢兢业业的。学院有些事不能照顾所有人不是很正常？角度不同看法不同好好交流不行？然后您就逮住机会过来疯狂键盘？
114060,4334,李济沅,2019-07-08 14:51:57,3,6,3,牛逼啊李济沅，作为同事很羡慕你
116009,4334,李济沅,2019-08-29 14:19:28,0,0,0,超级棒
116026,4334,李济沅,2019-08-31 06:16:12,0,0,0,幽默风趣
121513,4334,李济沅,2019-12-13 14:54:31,6,6,0,飘了飘了
121514,4334,李济沅,2019-12-13 14:52:58,0,0,0,ljljy
127652,4334,李济沅,2020-11-25 11:36:48,3,3,0,油油油
136347,4334,李济沅,2021-06-16 15:48:49,2,4,2,当官后就变了
145228,4334,李济沅,2021-12-28 10:40:46,-21,1,22,不是很懂你们的审美，看了一下头像，就这个样子确定男神？怕不是你们在高级黑
145293,4334,李济沅,2021-12-29 02:46:14,4,4,0,大学正式上课第一节就是李老师的思修课，虽然还没考试不知道给分怎么样，但老师人超级好，超级幽默，课也非常有意思
145382,4334,李济沅,2021-12-29 08:52:55,2,2,0,目前最喜欢的老师！
148258,4334,李济沅,2022-01-12 03:43:19,-7,2,9,摆烂3.9\n\n哈哈哈
151066,4334,李济沅,2022-02-22 13:51:21,8,8,0,上了第一节职规来评分。注意，这只包括职规课和我对老师的个人印象，他的其他方面我并不了解。\n\n我个人的印象是老师很随和，职规课的效果也超出预期。我感觉他是少数真正知道学生在想什么，知道学生的需求和烦恼的行政人员，至少单就他第一节课表达出来我能看出来这一点。我先打个10分，职规课结束之后再来好好编辑一下。
153471,4334,李济沅,2022-05-01 00:49:05,20,20,0,我\n\ntm直接10分\n\n讲课比较有含金量，虽然职规课肯定都是强调理想啊人生价值啊，但是李老师是真的了解大多数同学面临的现实意义上的问题，并会就那些问题与我们分享看法和经验。如果我在大一就选了李老师的职规那应该会解决我当年的许多困惑，可惜我大二才选，很多事已成定局。\n\n而且上课非常风趣幽默，强烈地干扰了我在课上做作业（狗头保命\n\n最后绩点也非常nice！当然可能是抱到小组成员大腿有关hhh（平时40%=签到10%+了解一个新职业10%+生涯人物访谈10%+个人简历10%；期末60%=小组展示30%+职规书30%）
153475,4334,李济沅,2022-05-01 03:59:56,-2,1,3,职规3.3，麻了，要求所有小组排出组员贡献度顺序。
153487,4334,李济沅,2022-05-01 14:48:20,8,8,0,真正懂学生的想法 知道学生的诉求 讲课有自己的见解\n\n比较随性 个人简历忘记交了 还是期末后济沅主动找我要的 \n\n主要还是看期末展示和职业规划书吧 老师不是很看重形式 不喜欢卷 只要有自己的独到的想法得分不低
153509,4334,李济沅,2022-05-03 02:07:49,1,2,1,点个赞
158331,4334,李济沅,2022-06-28 11:26:14,9,10,1,好有趣
160617,4334,李济沅,2022-09-28 07:20:18,0,1,1,老师真好
160880,4334,李济沅,2022-10-18 02:57:29,0,1,1,超级棒！
164627,4334,李济沅,2022-12-22 09:41:34,6,6,0,李老师真的～我哭死！日常摸鱼选手竖起耳朵被吸引呜呜呜～
165860,4334,李济沅,2023-01-10 06:57:16,4,5,1,从职规课来点赞👍
166105,4334,李济沅,2023-01-11 06:48:30,6,7,1,给分太好啦～
166288,4334,李济沅,2023-01-11 16:47:23,7,7,0,他真的我哭死，他上课讲的真的能给我生活一些启发，研究性学习的任务也是贴近我们大学生生活中的常见问题，他给的解答我也觉得很有指导意义，他给分也是真的好，没想到大一第一个满绩是思修，我真的哭死
170064,4334,李济沅,2023-03-01 07:40:10,2,3,1,思修课，老师讲的很有趣，关心学生，给分也不错
170071,4334,李济沅,2023-03-01 08:28:48,2,2,0,事少分高，很不错，推荐职规
176255,4334,李济沅,2023-06-28 07:22:55,-7,0,7,钉钉已读不回
176623,4334,李济沅,2023-06-29 12:51:48,9,9,0,真的好老师 上过最好的课没有之一 不仅从课堂上能学到很多 还能真正对未来的方向有所规划 谢谢李老师！
176637,4334,李济沅,2023-06-29 13:32:57,2,2,0,事少分高，好！
176640,4334,李济沅,2023-06-29 13:49:54,3,3,0,从职规课来，事真的少，给分超好，老师长得帅也讲的好，能站在我们的立场上讲课！太爱了！
176641,4334,李济沅,2023-06-29 13:53:13,1,1,0,我爱李老师！真真正正事少分高，讲课讲的特别好，能站在学生的立场去给鸡汤，强推！
181397,4334,李济沅,2023-10-17 00:06:36,1,1,0,老师好帅!体谅学生
181400,4334,李济沅,2023-10-17 02:33:35,2,2,0,讲的真的太好了🥹
181645,4334,李济沅,2023-10-25 06:24:40,1,1,0,济浣鸽鸽~
182119,4334,李济沅,2023-11-10 08:54:50,1,1,0,超级好
185729,4334,李济沅,2024-01-04 02:13:13,1,1,0,非常好的老师~
187223,4334,李济沅,2024-01-15 07:02:03,2,2,0,老师讲得真的特别特别好！听他的课真的会给人很多思考和启发！给分也超好！
187232,4334,李济沅,2024-01-15 08:35:04,2,2,0,jygg给分太好了！！我哭死
187260,4334,李济沅,2024-01-15 10:30:31,3,3,0,呜呜给分好像没有大家说的那么好，，，明明每个作业和考试都有认真完成，，甚至高中选考政治感觉期末应该考的不错啊。。。
187265,4334,李济沅,2024-01-15 10:37:28,1,1,0,超级好的思政课老师！上课讲的内容也很有意思！
187312,4334,李济沅,2024-01-15 12:39:25,2,2,0,很文雅的一位老师，讲课时侃侃而谈，而且逻辑性也很强，讲课内容很有启发性，给分也很不错
187347,4334,李济沅,2024-01-15 14:08:42,0,0,0,永远的男神！！神一样的存在!!!
187413,4334,李济沅,2024-01-16 04:11:14,2,2,0,好老师，口才好，思想很有高度，非常为学生着想，赞一个
187850,4334,李济沅,2024-01-17 14:55:59,1,1,0,虽然最后分不大理想，但还是要夸夸特别特别好的济沅gg，思修课上的超级有意思！是很开心的上课体验！
193149,4334,李济沅,2024-06-04 04:57:03,-1,0,1,李济沅老师讲课真的很幽默风趣，对学生也特别好，我思道小组成员都满绩！
196190,4334,李济沅,2024-07-02 06:02:43,-2,0,2,讲得非常好，很有深度和高度，在职规课上也请来了很多校友和hr，资源还是很广的。但是给分没想象中好，个人教育自传卷到7k多字了，小组展示也挺认真的，最后87。倒也还好，也就1.5学分，至少上课时快乐并且有收获，还是打十分
198113,4334,李济沅,2024-08-31 05:40:35,2,3,1,好好好好好好好好好
198379,4334,李济沅,2024-09-08 10:09:56,6,7,1,李老师很好，虽然没给我们上正式的课，只是我们指导员拉来宣讲，拉我们入党的，但讲的真的很好
208003,4334,李济沅,2024-12-25 07:37:41,2,2,0,给我的老师代了一节课，讲的真的好
73910,4367,陈敏,2018-02-03 13:44:58,-9,1,10,好老师～
75080,4367,陈敏,2018-03-07 08:58:54,-16,6,22,电子测量就是那种 好好上课，认真准备考试就能满的，所谓良心个性课了。 电院宝宝们选个性课千万别错过！(4.3的均绩摆在那的啊！！)
75193,4367,陈敏,2018-03-08 02:35:27,-5,1,6,还在上
79305,4367,陈敏,2018-05-30 14:09:52,8,9,1,害怕...
79674,4367,陈敏,2018-06-12 14:45:50,-15,2,17,很耐心很和善很为学生考虑的好老师
87476,4367,陈敏,2018-09-29 08:44:48,16,20,4,从来不备课，不会讲课
89090,4367,陈敏,2018-11-15 11:02:12,-10,4,14,老师上课态度很认真，但是因为实验室安排的原因最后两周七篇实验报告有点小坑。无论从哪个方面来说老师都是好老师。
89397,4367,陈敏,2018-11-19 03:10:09,11,13,2,给分坑爹啊
127360,4367,陈敏,2020-11-21 06:27:22,16,18,2,似乎叫陈敏的太多了，至少电子测量的陈敏讲课清楚，还不错，就是实验太集中了
128832,4367,陈敏,2020-12-25 17:06:41,2,5,3,电子测量太顶了，认真上课轻松4.5，兄弟们冲
135933,4367,陈敏,2021-06-03 21:07:55,4,4,0,讲课声音很小
136567,4367,陈敏,2021-06-21 06:24:08,29,30,1,其他陈敏我不知道，微机的陈敏上课声音实在是太小。平淡无奇中会突然带有一些猛烈的冲激，将你从神游中拽回，而后却又发现他只是在侃天罢了；讲到关键处却又如谈及到什么避讳之物一样支支吾吾，不由得让我联想到孔乙己面对众人调侃时的窘迫却又倔犟；节奏上仿佛把我带进了秋日午后北京的街角胡同里，实在是昏昏欲睡。是精神力攻击的一大好手。
156972,4367,陈敏,2022-06-21 13:02:50,3,3,0,网课的8周课几乎有4周麦克风没声音的，说了也不会改
172275,4367,陈敏,2023-04-24 05:39:30,1,1,0,沙币沙币
173188,4367,陈敏,2023-05-15 06:52:23,8,8,0,微机100%小测点名  讲得也依托答辩
174421,4367,陈敏,2023-06-12 05:41:30,4,4,0,浙大李老八
182530,4367,陈敏,2023-11-17 06:26:20,1,1,0,小陈敏不行，大陈敏可以水课
192194,4367,陈敏,2024-05-11 06:47:05,0,0,0,只能说逆天
193317,4367,陈敏,2024-06-06 07:30:44,8,8,0,电气学院的陈敏，上微机课的那个，真的辣鸡，讲的时候不知所云，作业布置都是乱搞，作业也很多很烂。\n\n每节课必小测点名
201428,4367,陈敏,2024-11-02 13:15:37,2,3,1,大陈敏，好老师，认真负责，电子测量考前评个分
202707,4367,陈敏,2024-11-14 02:44:18,3,4,1,大陈敏好老师，电子测量好课！
202915,4367,陈敏,2024-11-15 06:41:47,-3,1,4,电气小陈敏，电子测量非常有耐心，上课讲的也比较清晰，挺有收获的。平时同学有疑问会非常耐心的详细解答
203847,4367,陈敏,2024-11-21 13:25:45,0,0,0,电子测量好课！
78232,4445,何衍,2018-05-10 05:45:55,-15,1,16,车轱辘话一大堆，很无聊，讲课很没意思。。但运筹学又好像比较重要，很烦。。有展示30%，期末考试70%。。。
84152,4445,何衍,2018-07-12 06:51:38,1,2,1,这学期最喜欢的老师，讲的很清楚很耐心，期末给分比预想高得多
85686,4445,何衍,2018-07-25 23:19:16,3,3,0,考试很简单，但是讲的东西仔细思考真的很有用
110240,4445,何衍,2019-06-25 04:22:42,0,2,2,希望今年考得简单点
110704,4445,何衍,2019-06-28 05:02:45,11,11,0,何老师是我认识的电气学院唯二真正在做学术的老师，上课非常严谨，运筹学能学到很多东西，推荐！
124540,4445,何衍,2020-07-02 12:20:47,0,0,0,课时非常紧凑，今年增加了非线性规划的内容，课下复习和作业都花了挺多时间。老师非常喜欢问同学问题，但是大家都不怎么说话，导致上课时间更加少。
124545,4445,何衍,2020-07-02 17:45:24,-51,4,55,这老师真的垃圾，每节课都留作业也不讲，开卷考试自己出题啥都考，大作业瞎几把给分，真的想水的选千万别选，别的课随便写论文都起码80多的，这个课就60左右，别问，问就是太菜
128131,4445,何衍,2020-12-08 04:25:13,3,3,0,老师讲课很认真，能看出来是个好老师，但是讲课过程有一些些枯燥。研究生课《计算机实时控制》不点名、没有平时分，考试难度一般，成绩给的还不错。
129412,4445,何衍,2021-01-05 06:35:17,0,0,0,好老师，好评
133786,4445,何衍,2021-03-05 10:38:39,1,1,0,讲课太太太太认真了！给分太太太太好了！
139040,4445,何衍,2021-07-12 08:47:34,16,16,0,控院开的运筹学，虽然上课真的很难，但是作业留的都比较简单，考试也只是考考概念，甚至不用复习。唯一难的就是大作业看自己发挥，虽然我最后时间不够做的有很大问题，但是还是给了一个很高的分数
141595,4445,何衍,2021-10-16 07:26:05,0,0,0,认真负责，b事很少
144768,4445,何衍,2021-12-23 13:29:12,0,0,0,急急急
151925,4445,何衍,2022-03-21 03:20:27,0,0,0,好老师！
151926,4445,何衍,2022-03-21 03:22:07,0,0,0,挺不错的
157691,4445,何衍,2022-06-24 10:40:30,1,1,0,老师给分很好，比较关心教学效果
161207,4445,何衍,2022-10-31 17:42:34,17,17,0,冲着何衍老师对学生的态度，他就比任何所谓的大教授都有资格被称为一名教师，10分没商量
175182,4445,何衍,2023-06-22 07:38:18,27,27,0,23年春学期跨校区选修了老师的运筹学课程，收获颇丰。何老师的每一次课都在用心思考怎样讲授能更好让同学们理解，偶尔调侃大家选择智云是不是因为课堂不够生动，没有因为稀疏的教室而提过一句“点名”，而是在反思自身，多少老师能做到这一点。课程内容非常丰富，如果想完全消化课程内容每周时间投入也不少。春学期有期末考，大作业完成时不算用心，有点内疚（实际占比挺高，老师给分可能很好）。考试的“考点”几乎完全分布于课堂PPT和课后作业里，考完下楼时老师仍非常热情，想向我们了解试卷情况以及对平时的建议等。总评很高，应该有捞。\n\n\n\n何老师是真正的好老师。
176593,4445,何衍,2023-06-29 10:45:03,4,4,0,老师很认真！我平时作业结论里手滑打错了的小错误都被揪出来了
176984,4445,何衍,2023-07-01 03:15:33,6,6,0,何老师真的很好，找老师冲突补选的时候，老师不仅耐心指导我怎么操作，甚至帮我把申请单送到了玉泉的教学科。运筹学的很多方法都很有用，特别是最优化的方法，对于模型预测控制的学习有很大帮助，但是受限于课时，老师可能没有办法讲的太过详细，需要自己额外补充，考核方式是平时作业+大作业+期末小测，平时作业难度不大，大作业需要花时间的是确定问题以及解决问题的方法，实现的部分并不是很难，小测考概念为主，最后给分不错。
182362,4445,何衍,2023-11-15 06:50:51,3,3,0,何老师的课很硬，但是认真听讲可以学到很多东西，而且老师给分也很好，赞一个~
183302,4445,何衍,2023-11-23 14:24:47,12,12,0,授课认真，严谨治学，对学问、对学生都不打马虎眼。某院少数真正关心课程内容在学生发展和科研应用中的作用的老师，把授业解惑放在第一位而不是费心于考勤或其他的旁门左道，何老师是真正的好老师。
191419,4445,何衍,2024-04-21 08:35:37,1,2,1,教考有些分离，讲课讲的太快，根本来不及弄懂
192112,4445,何衍,2024-05-09 08:56:39,4,4,0,很认真，关心学生
193755,4445,何衍,2024-06-17 13:54:50,1,1,0,老师真的很好，希望老师捞捞wwww
195472,4445,何衍,2024-06-28 07:46:09,0,2,2,好老师，耐心细致，给分也很好www
195655,4445,何衍,2024-06-29 08:39:18,3,4,1,老师是好老师，对同学态度也非常好，允许不来上课。\n\n但个人觉得这个课程安排实在太不合理了，课程难度本身不小，但是课时实在太少\n\n少，老师感觉从头到尾在飙进度，而且是越讲越快，课后需要花费不少时间去消化。\n\n考试说实话比较抽象，需要对知识有比较深入的理解，如果仅仅是完成作业题，是远远不够的。\n\n给分的话个人感觉虽然不算差，但也算不上特别好（可能跟我期末考错的比较多有关）。
218863,4445,何衍,2025-05-09 10:28:35,1,1,0,课程量和作业量不能算少（也不能说很多，只是和大三别的课相比算多了），如果是上课阶段，我只能给8分。但课程结束了，回过头来看，老师真的很好，课也很好，能学到真东西，10分！
219855,4445,何衍,2025-06-09 03:20:30,1,1,0,何老师真是神老师，讲课很讲究进度和我们的理解，作业批改很快且有评语，无敌了无敌了
219914,4445,何衍,2025-06-11 03:07:23,2,2,0,可能是我个人在大三最喜欢的一个老师，治学严谨，待人谦和，有风度，。坦率来说运筹学并不是一门水课，但是这让我久违地感觉在课上确实学到了什么
221044,4445,何衍,2025-06-21 04:03:00,0,0,0,老师挺不错的，运筹学（控院）也是一门好课，平时任务也不重，不过期末挺难不容易拿高分，大作业找队友和选题一定要慎重，不然会比较痛苦
221797,4445,何衍,2025-06-26 09:40:30,0,0,0,老师真的真的真的非常好\n\n因为是两节早八运筹学，本人没怎么起来过，最后两节课去了一下，才感觉他讲的有多好。人非常和蔼可亲，听了他讲的课，甚至愧疚于以前没有好好学他上的运筹学。\n\n而且不点名，老师人特别特别好，给同学们说早八不一定要来（其实两节都在早八），休息很重要，看着大家犯困很心疼。还说每个人都有自己的方法，不一定要来上课。\n\n最后的考试也很好，都是概念，和两个很简单计算的附加题
70911,4576,周晶,2018-01-28 00:09:00,0,0,0,老师很有爱，不过上课的时候实验到底该做哪些东西，要记录些什么有时候讲的不是很清楚，出现的一些问题有时候老师也解决不了，记得有一次有一个问题，老师让我调试了好久都没成功，然后助教指点了一下就好了。。。。给9分吧，剩下1分希望老师也能有进步的空间\n\n不过老师真的很有爱，万圣节还给大家发糖吃！！
72230,4576,周晶,2018-01-29 15:02:53,3,4,1,老师虽然是一个新老师，但是上课很认真，而且还有小零食送给同学们，最后给分也很感人，笔芯
74171,4576,周晶,2018-02-06 03:34:59,0,0,0,认真负责，态度好，有糖吃
85806,4576,周晶,2018-08-15 02:03:23,-1,1,2,
97664,4576,周晶,2019-01-22 12:52:27,8,13,5,老师人美心善，发的牛轧糖真的很好吃，而且认真负责，给分巨好，实验报告貌似是唯一一个不用手写，电子版(支持fu zhi和zhan tie)就可以，考试的时候实验题你做错了，也会ti xing一下
98654,4576,周晶,2019-01-23 16:43:09,1,2,1,我爱周晶。感觉挺有趣的女老师。很多时候不能解答疑惑就会和她讨论，结果就是emmmm，不过老师事情少是最重要的，满分!
101531,4576,周晶,2019-01-28 11:03:21,0,0,0,老师很温柔，犯比较低级的错误也会给你详细调。讲得比较清楚，任务布置清晰。给分巨好，感恩~
108685,4576,周晶,2019-05-31 06:53:16,0,1,1,很认真
108686,4576,周晶,2019-05-31 06:53:16,0,1,1,很认真
117995,4576,周晶,2019-10-18 02:09:13,5,7,2,事情真的多，每次完成实验报告至少六个小时
118003,4576,周晶,2019-10-18 05:28:20,2,3,1,事情多
121843,4576,周晶,2020-01-22 11:22:07,2,4,2,老师温柔耐心，不过实验内容讲得不是很清楚。这学期模电实验好像总是比模电快，做实验总是不知其所以然。老师给分真的太太太好了，我期末最后的实验做得一踏糊涂，都帮我拉到3.5。对了，出成绩我才知道这门课是五级制。真的感谢周老师！
125319,4576,周晶,2020-09-06 15:13:09,5,6,1,老师不错，就是讲的其实不是很清楚，实验的时候有很多步骤不明白，又一次一位男老师来代课明显感觉清楚多了。另外，五级制实在是坑，4.5好像只有25%，没有4.5就只有3.5了！
197484,4576,周晶,2024-07-16 17:40:10,0,0,0,模电实验的这么多老师里只有她是博导诶
199602,4576,周晶,2024-09-26 07:40:18,3,3,0,实验报告事多要求高，上课是无情的ppt reader
201642,4576,周晶,2024-11-05 06:01:15,3,3,0,zjjj比较温柔耐心，指导也比较精细，PPT对实验完成很有用，但是PPTreader名副其实，主要表现为开始上课后只用10min念完PPT，然后开始做实验时我们都完全一脸懵逼，另外实验报告事很多（这估计是模电实验通病）
202723,4576,周晶,2024-11-14 04:08:29,-2,0,2,懂得都懂
208681,4576,周晶,2024-12-30 18:19:23,3,3,0,钉钉问问题已读不回……\n\n实验指导个人觉得一般，稍微提出点问题就不知道原因，只会PPT上按部就班的那些
208760,4576,周晶,2025-01-01 11:31:08,2,2,0,像人机
211463,4576,周晶,2025-01-11 13:43:09,2,2,0,考试出题确实不为难人，操作题图给的明明白白，整张卷子和历年卷相比重合度很高，而且感觉周晶给4.5给的也不少。当然她最大的不足还是PPTreader和人机行为，所以上她的课之前最好充分预习（98里能找到她的PPT）
212119,4576,周晶,2025-01-13 08:20:09,1,2,1,平时确实是ppt reader，如果想快点做完实验建议预习一下。\n\n感觉实验报告相对于其他班任务量稍多，而且较为严格。但模电实验实质上平时虽然占比多但差别不大，还得看最后考试。\n\n最后考试本以为寄了，但最后4.5了，应该是给分很好的。\n\n选上了就上吧孩子们。
79644,4623,林峰,2018-06-19 06:32:56,-10,2,12,还行吧
86463,4623,林峰,2018-09-16 12:59:41,-10,1,11,还好吧
91428,4623,林峰,2018-12-10 02:24:50,2,2,0,乱讲\n\n
102683,4623,林峰,2019-02-20 08:27:11,8,8,0,一言难尽
117318,4623,林峰,2019-09-23 02:18:26,5,5,0,不知所云
117726,4623,林峰,2019-09-30 02:37:31,1,1,0,受不了了，讲得是啥？？
118099,4623,林峰,2019-10-21 02:33:47,2,2,0,这尼玛谁顶得住啊
122293,4623,林峰,2020-02-23 03:10:15,4,5,1,控制理论乙会有几次点名，主要靠自学。老师态度还不错，就是不会讲课。
125747,4623,林峰,2020-09-14 02:31:59,16,16,0,你在说什么？？？
128989,4623,林峰,2020-12-28 03:54:51,7,8,1,老师好，我不知道您看不看查老师的评论，如果看到一下是本人的拙见。首先，麻烦老师好好上课，知识点讲清楚点，不要上课吹牛。第二，请老师注意措辞，不要随意辱骂谁谁。第三，请老师不要随意下定论，说什么“你们明年一定过的不好”等等之类的话，请传播正能量以及社会主义核心价值观，摆好三观。第四，我十分怀疑老师的教学水平，自学都比上课强。
132274,4623,林峰,2021-01-31 12:46:54,2,2,0,你是真的坑啊，考试明明都会做，考完以为满了，结果出来分数这么点。出分后还跟别人对了波答案，并没有太大问题。坑坑坑
134604,4623,林峰,2021-04-05 04:11:17,0,8,8,网安的林峰老师，人很帅。点名。上课比较平淡。
138388,4623,林峰,2021-07-09 00:52:31,12,12,0,美国舔狗，天方夜谭，不讲重点，消极怠工
138569,4623,林峰,2021-07-10 01:33:17,4,4,0,这老师太傻逼了\n\n小学期讲课话都讲不清，东扯西扯，全程下来基本上没有一点有营养的东西\n\n而且作业也莫名其妙，规矩也是一大堆，迂腐酸儒之人
138589,4623,林峰,2021-07-10 12:47:48,11,12,1,电院自动化小学期。把这老师当作被喂了无数专业历史和专业名词还没有训练好的人工智能就好了。你不会学到和matlab相关的任何东西。要是人类都跟他一样，今晚24:00前就被人工智能灭了。想想其他课应该也是一样。
140924,4623,林峰,2021-09-18 01:59:34,11,11,0,你历史老师是吧😅
148815,4623,林峰,2022-01-13 14:57:48,9,9,0,不多说，傻逼老师
148839,4623,林峰,2022-01-13 16:44:53,2,2,0,真的差，千万别选他的控制理论
149604,4623,林峰,2022-01-16 07:37:08,2,3,1,不多说，lj\n\n上课明明说了非最小相位奈氏图不考，结果考试来了一道大题；\n\n就算那道大题白给，其他的题目我都会做啊，这出来的这么点分数是什么鬼\n\n大三的绩点全给这xx毁了\n\n\n\n后悔没听去年的劝告：\n\n你是真的坑啊，考试明明都会做，考完以为满了，结果出来分数这么点。出分后还跟别人对了波答案，并没有太大问题。坑坑坑
149850,4623,林峰,2022-01-17 09:21:43,0,1,1,感觉不如yw老师\n\n。。。的PPT（乐\n\n\n\n助教很负责，每次作业都有解析\n\n做题方法纯靠自学，课上基本不好好讲题\n\n推荐结合b站DR_CAN视频与yw老师PPT学习控制理论，比听这老师上课好上太多
151043,4623,林峰,2022-02-22 07:22:12,22,24,2,计院网安课的林峰老师风评被害，网安还是可以的选的。
161036,4623,林峰,2022-10-24 12:46:55,0,1,1,傻逼老师
169348,4623,林峰,2023-02-25 13:06:46,1,1,0,你好哦
172772,4623,林峰,2023-05-06 14:09:44,3,3,0,网络安全原理与实践：小quiz一次当点名，实验课没点名，做的project给分比较高，最后满了。老师人很好，就是略闷
175501,4623,林峰,2023-06-25 08:15:40,3,3,0,sb老师 拖堂晚 还点名 作业多 天天吹自己的三区
176906,4623,林峰,2023-06-30 15:48:27,2,4,2,计算机学院的林峰老师还挺好的，网络安全原理与实践课。老师人虽然闷闷的，但是跟着他学完课程的话还是挺有收获的，问的问题也会给解答。考核方式是平时三个lab加期末考试，考试可以带a4纸。给分不错，推荐选。
181139,4623,林峰,2023-10-10 02:01:33,0,0,0,呃呃呃呃
187024,4623,林峰,2024-01-14 07:33:17,1,1,0,控制理论，darling老师没必要退，上课接受不了可以姚维启动。\n\n老师对一些概念的理解还是挺有启发性的。\n\n对考试范围和内容的把握十分准，复习课很有用。\n\n缺点是纸质点名，说话软绵含糊，助教作业不太批，平时也没答案（其他班也一样）
192470,4623,林峰,2024-05-21 10:28:05,0,1,1,司马东西
194547,4623,林峰,2024-06-24 10:05:42,-2,2,4,作为一学期都坐在离老师最近的位置而且最后拿到满绩的人，我觉得自己比较有发言权。\n\n总体上中规中矩，把该讲的都讲了，缺点是思路比较天马行空，比如有一次外面大风呼呼响，老师就跑到窗前故作沉思，说是不是山上吹下来的风，有时候还会扯到中美关系等话题，说中国以前的科技比较落后，现在发展起来了，诸如此类——虽然这些东西和课程关系不大，不过如果能跟上老师的思路，感觉还是挺有意思的，至少比三节课都在纯讲理论要好。
197299,4623,林峰,2024-07-10 13:03:21,0,2,2,如果想选控制决策系统的话冲！给分特别特别好！报告认真写即可满绩！
201065,4623,林峰,2024-10-28 06:19:55,5,5,0,我为林峰举大旗！\n\nlf因为我们期中考连着考两周，所以作业让我们考完试再交\n\nlf人还是不错的
211605,4623,林峰,2025-01-12 04:00:44,-1,1,2,会纸质点名，但最后说平时分都会给的很高；作业有点多，但是助教最后也发了解析。\n\n讲课确实不怎么样，好像也没多少人听，但是选上了也没必要退，看姚维老师的PPT和课程就行，林峰偶尔会手写补充几道题，基本是历年卷上的题目，可以听一下\n\n最后给分挺好的，这门课主要还是刷题做历年卷，分低不了
211860,4623,林峰,2025-01-12 20:09:58,2,2,0,说好的不考滞后超前矫正结果就考这个是吧😂
212135,4623,林峰,2025-01-13 08:53:04,1,2,1,讲课废话很多，但给分不错，作业可以补交，助教给写了课后题的答案也很赞，在平行班里算不错的
219483,4623,林峰,2025-05-28 08:58:28,1,1,0,计院的网安原：\n\n今年全部改革了，改成了杜文亮老师之前在美国的课程。据说明年要改成长学期，实验部分也要增加。\n\n改革之后的实验个人感觉体验非常好，指导手册和杜老师实验课的指导都很详细，深入浅出。\n\n林峰老师上的理论课比较平淡，中途点了一次名，平时可以不听，最后如果想拿高分建议智云过一遍，因为ppt里没有太多的说明。\n\n我对我的成绩还算挺满意的，但群里没有人“谢谢老师”，不知道其他人如何（也可能是出分比较晚？
221139,4623,林峰,2025-06-21 12:10:22,0,0,0,乱讲，上课不如自学
106230,4692,邵帅,2019-04-26 00:37:39,-4,5,9,还好吧
110026,4692,邵帅,2019-06-21 11:28:59,4,10,6,老子天下第一吗？
112641,4692,邵帅,2019-07-05 12:30:03,8,21,13,m*ther f*cker 浪费时间给分极差
112795,4692,邵帅,2019-07-05 03:26:09,5,12,7,浪费时间
123697,4692,邵帅,2020-06-11 15:22:08,3,4,1,管院的邵老师非常nice的！人特别耐心温柔，还很有气质！不仅会讲知识点还会讲案例啥的，感觉能学到很多东西哇！
136271,4692,邵帅,2021-06-15 02:41:28,2,4,2,分数不求是hhhhh
136272,4692,邵帅,2021-06-15 03:41:58,4,6,2,评分与实际不符 邵老师人好讲课好 课程收获大 能学到实在的东西 老师对本科生教育很放在心上
136273,4692,邵帅,2021-06-15 02:55:58,5,7,2,谢邀，上课还行，人不错。仿真作业很充实。
136287,4692,邵帅,2021-06-15 11:43:40,9,11,2,电院的邵老师好年轻好帅～上课很有活力很用心，PPT做的也很好，虽然全英文上课还有仿真作业很顶，不过确实也学到了不少东西，希望最后成绩能和老师颜值一样高
136362,4692,邵帅,2021-06-17 03:16:04,5,7,2,课程内容很充实，虽然作业小多，但不至于差评
137103,4692,邵帅,2021-07-01 07:49:50,9,11,2,好老师，吹爆，要是给分好那就更好了
137105,4692,邵帅,2021-07-01 08:02:58,15,17,2,我觉得邵帅老师很好啊，首先要不是邵老师，我可能到现在都不知道逆变器是什么，无论是原理还是控制方法都讲得很好。电创这门课，一开始邵老师给了我们近两周的时间画PCB板，还请研究生一个个帮我们看，特别细心和耐心，画出来的PCB板子给人特别安心的感觉（像隔壁班只给了两天画板子，绝缘间距也不设，做出来光板子就一堆问题，根本上不了200W，隔壁班纷纷来向我借PCB板子）。后面焊接调试的时候，邵老师基本上都是全程陪同的，晚饭也不恰来帮我们调电路，还会点KFC给我们恰。\n\n讲真的，上邵老师的课如果好好上的话，真的能学到不少东西（上了都说好，上了邵老师的电力电子技术的室友一天到晚向我展示其学到的东西，充满羡慕）
137123,4692,邵帅,2021-07-01 10:18:24,5,6,1,电创优先选邵帅
137129,4692,邵帅,2021-07-01 10:44:54,4,5,1,创新设计真的是可以和你一起debug、一起改进问题的认真老师，理论课上的知识也都很实用，向朋友一样的老师
137144,4692,邵帅,2021-07-13 10:56:21,7,8,1,挺实诚的一个老师：“ 拜托大家一件事，欢迎同学们到“查老师”网站给我和谌平平老师评分和写评论。大家学习过程中有什么感受，对本课程未来有什么建议都可以写在上面，多谢！”\n\n\n\n电创，事情比较多，老师和学生都挺辛苦，东西学到不少，也希望能拿个配得上汗水的成绩吧！
137670,4692,邵帅,2021-07-05 14:11:44,9,10,1,电力电子技术II，出分前来评一下。平心而论是电院大三排得上号的上课认真的老师，讲课水平也不错，至少讲英语也能让人听懂。对比某些整天吹b不知所云的教授光这点就至少值8分。对比其他班作业确实太多了点，但是认真做能极大巩固建模知识，对考试也有帮助。另外既然邵老师会看我就多说两句，建模方面的内容很多姚老师都在电力电子仿真课上讲过了，或许各位老师应该协调一下授课内容
138642,4692,邵帅,2021-07-10 05:41:09,5,6,1,邵帅老师真的是男神了！！帅气幽默有亲和力，笑容也很迷（魔）人（性）！电创这门课理论部分讲解很好，具体分析非常详实，而且还有很多见解能加强我对电力电子的感性认识。实验过程非常热心，会亲自帮学生焊pcb、调程序。我的pcb板设计得不够好，邵老师陪我一点一点地改进，让输出正弦波形一点一点得变好看变“正弦”！整个大三收获最大的课！
139495,4692,邵帅,2021-07-16 13:48:13,0,3,3,电力电子技术2～ 第一印象是邵老师很有绅士风度（发现电院的英国博士毕业的老师们都是很有风度的哈哈），沟通答疑也非常耐心，课程内容方面干货很多，相比于其他两个平行班，会有更多建模和控制方面的内容，好好学的话收获不错。还有一个细节就是虽然不是邵老师电创课的学生，但有一次补做实验正好邵老师在实验室，给我们这些其他老师的学生也耐心答疑PCB方面的问题。给分的话，个人认为电力电子2还不错，平时作业要求都完成了，期末考的不是太好，总评还是大大超出了预期。总之，十分推荐大家选
139504,4692,邵帅,2021-07-16 15:36:51,5,6,1,电力电子二，和研究生同上的全外文。仿真作业三个加上一次数字控制实验，workload还行。没有什么架子，看得出老师在本科教学上很有热情，也花了很多心思在作业的设计上，可以说是电信专业老师中上课水平以及对待学生态度的top5吧
139820,4692,邵帅,2021-07-28 13:51:55,6,8,2,邵老师好像有点固执，小心眼，惹到他分数就凉凉了
145276,4692,邵帅,2021-12-28 16:20:18,2,2,0,邵老师可是浙大优秀班主任、浙大优秀德育导师“双料”优秀老师！！！
150981,4692,邵帅,2022-02-21 13:34:33,2,2,0,好的呢
155531,4692,邵帅,2022-06-17 09:15:22,3,3,0,电力电子二\n\n点名多 作业更多 考试题巨多\n\n课件全英文，讲课中英混合，和研究生混课。\n\n三次仿真作业，题目都是四五页密密麻麻英文铺满，要求巨多，一个仿真作业8-15个要求，又要写计算过程又要matlab作图又要建模型，还要各种暴算各种试错。\n\n考试6道大题全英文题，每道大题包含3-5道小题，全是简答/计算/画图（只有一道选择还是个多选），题量堪称所有课程之最。光题目文本一道就是一整页铺满，然后正面还不给多少地方写，一半的答案没处写只能翻背面写。第一次见到这么出卷子的，真的无语。\n\n仅针对以上两点，和其他评论中好的评价不冲突
158946,4692,邵帅,2022-07-03 18:05:47,0,2,2,邵老师人如其名，帅气幽默！助教小哥哥也很帅，人超级热心很nice，晚上也一直陪大家到好晚，点赞👍
174480,4692,邵帅,2023-06-13 02:33:28,1,1,0,无语子
154518,4839,韩涛,2022-06-02 03:37:51,0,15,15,人品不行
154581,4839,韩涛,2022-06-02 08:17:34,0,12,12,韩老师人很好，建议参加智能车竞赛，一分耕耘一分收获
158053,4839,韩涛,2022-06-26 13:00:07,-2,7,9,很和善的小胖老师
159596,4839,韩涛,2022-08-21 14:15:30,0,6,6,韩老师对于积极备赛的同学都是很热情的，欢迎有兴趣的同学加入浙大智能车的行列。\n\n至于某支闹的不愉快的队伍，只能说要点逼脸。
173801,4839,韩涛,2023-06-03 05:35:02,0,4,4,人品太差，奇奇怪怪
76538,5171,陈宏,2018-04-13 02:41:59,28,29,1,垃圾不解释
76984,5171,陈宏,2018-04-27 05:34:12,22,23,1,态度不好
79570,5171,陈宏,2018-06-10 03:42:24,11,14,3,嘤嘤嘤
79571,5171,陈宏,2018-06-10 03:42:27,14,15,1,呜呜呜呜
79938,5171,陈宏,2018-06-15 14:07:56,12,16,4,事情贼多，呜呜呜
80114,5171,陈宏,2018-06-20 06:29:19,31,33,2,真的垃圾。0分
85511,5171,陈宏,2018-07-18 19:18:37,46,51,5,尔等皆与外卖无缘
85633,5171,陈宏,2018-07-23 06:46:26,44,46,2,老师是真的辣鸡。。。。女老师，脾气差，中年妇女，高更不解释
85667,5171,陈宏,2018-07-24 23:11:14,105,119,14,这老师控制欲极强，好像学生都应该围着她转，完全不考虑学生感受，甚至以别人做不愿意的事情为快乐，一定是个安全感极低的女人
85690,5171,陈宏,2018-07-26 04:37:52,46,49,3,垃圾小学期浪费生命\n\n
85707,5171,陈宏,2018-07-27 03:26:33,76,81,5,为什么没有零分？\n\n自以为是，态度恶劣，思路清奇，控制欲极强。\n\n目前见过的电院最差
86345,5171,陈宏,2018-09-13 15:24:12,66,70,4,傻逼 不用解释了 小学期写一万字给3.9?
87360,5171,陈宏,2018-09-27 11:28:27,43,46,3,室友的班主任，听室友形容真的是个傻逼\n\n动不动要求同学开班会，搞辩论赛，不对学生的发展操心，反而浪费大家的时间
87493,5171,陈宏,2018-09-29 14:50:48,35,37,2,不谈了，很多人都只上她的课，我怎么是她班里的啊，三年。。。吐血了
87544,5171,陈宏,2018-10-04 04:43:38,26,28,2,日常一分
87545,5171,陈宏,2018-10-04 04:45:38,20,22,2,你们都懂
87924,5171,陈宏,2018-10-18 00:50:27,72,73,1,辣鸡，强迫学生开开毫无意义的辩论会，平均每两个星期就要开一次班会，每次班会要3个小时，还总是，强迫大家去做一些没有意义的事情，完全不考虑学生的感受，还好大二不是她做班主任，解脱了。
94831,5171,陈宏,2019-01-18 09:26:02,23,25,2,我不管你写的是什么，我就问你这个Verilog代码执行到那一句了！\n\n世一大有这种蛀虫，迟早要完蛋
99776,5171,陈宏,2019-01-25 07:09:16,11,13,2,nmsl，wsngg，wmdsnmdez
103969,5171,陈宏,2019-03-08 05:24:56,31,34,3,班会真的久，每学期回来要讲寒假做了什么家务，一个一个讲
104513,5171,陈宏,2019-03-22 05:58:10,15,18,3,这老师怎么这么暴躁
104517,5171,陈宏,2019-03-22 07:00:14,70,76,6,祝病魔早日战胜老师
104591,5171,陈宏,2019-03-24 15:37:34,31,33,2,为什么这么高，谁给的2分以上
104874,5171,陈宏,2019-03-29 05:50:10,12,15,3,素质极差。建议平时多吃药。
104946,5171,陈宏,2019-03-31 16:59:50,19,19,0,男盗女娼
105123,5171,陈宏,2019-04-04 04:26:16,18,20,2,不要脸的更年期妇女
105273,5171,陈宏,2019-04-12 07:51:33,58,59,1,每次做完实验都来查老师骂一遍才能出我恶气
105274,5171,陈宏,2019-04-09 02:28:51,10,15,5,买水军biss
105279,5171,陈宏,2019-04-09 03:29:59,43,44,1,实验半小时，验收三个半小时。这老师有毛病
105280,5171,陈宏,2019-04-09 03:31:50,9,13,4,nmsl
105388,5171,陈宏,2019-04-11 07:58:39,10,13,3,整吐了
105395,5171,陈宏,2019-04-11 11:07:57,13,13,0,垃圾不能再垃圾
105401,5171,陈宏,2019-04-11 16:04:46,13,15,2,整个教室里就数她最脑残了
105419,5171,陈宏,2019-04-12 07:45:23,12,14,2,never mind scandal and liber
105449,5171,陈宏,2019-04-14 08:30:54,17,19,2,s啥都不会，就会说自己有关系，真的不b要选他的课
105496,5171,陈宏,2019-04-15 12:07:09,12,18,6,never mind the scandal and liber.
105520,5171,陈宏,2019-04-16 03:21:48,19,20,1,这老师有毛病吧？？？？
105521,5171,陈宏,2019-04-16 03:33:30,19,21,2,验收？验收尼玛呢！
105530,5171,陈宏,2019-04-16 06:42:47,22,25,3,这种老师浙大为什么不辞掉呢？做个实验，这么多人等着她验收，就不知道让助教帮忙验收一下，态度恶劣，不知变通。
105536,5171,陈宏,2019-04-16 08:46:07,16,18,2,实验半小时，验收一整天
105543,5171,陈宏,2019-04-16 11:23:34,16,19,3,脑子有问题
105753,5171,陈宏,2019-04-20 03:14:54,26,26,0,建议辞退
107818,5171,陈宏,2019-05-10 03:57:57,-112,9,121,我自认和这个老师的接触不比其他同学少，并没有觉得陈宏老师有什么值得抱有极大怨恨的地方，所以看到有人特意跑到邓焰老师下面留评论就觉得很不能理解。给分不理想实验查的严这种事哪个老师都可能有，有必要执着?难道她还会盯你一辈子?但是你人前温良恭俭让，人后恶语相向……emmm，这可不是大学的育人目标，起码不是浙大的。
108502,5171,陈宏,2019-05-27 06:06:21,16,16,0,楼下惊现圣母婊
108659,5171,陈宏,2019-05-30 14:13:16,11,15,4,楼下的楼下惊现圣母婊
108676,5171,陈宏,2019-05-31 03:33:44,17,17,0,我傻了
109770,5171,陈宏,2019-06-19 06:10:38,15,17,2,傻逼一个
113670,5171,陈宏,2019-07-07 03:01:37,17,18,1,傻逼一个
113673,5171,陈宏,2019-07-07 03:10:44,13,16,3,傻逼一个
113676,5171,陈宏,2019-07-07 03:17:01,14,17,3,捞b一个
113678,5171,陈宏,2019-07-07 03:34:33,34,35,1,10分钟讲完的讲一年，傻逼
113681,5171,陈宏,2019-07-07 03:48:16,17,19,2,让人智熄\n\n不满绩不准打游戏！
113911,5171,陈宏,2019-07-08 00:29:19,8,11,3,神奇的体验，谁知道你坐哪辆车，不能说车牌或者司机么
114354,5171,陈宏,2019-07-09 23:39:07,-46,4,50,人前谦逊人后恶语这才是凡人啊，谁没有背后面子
115040,5171,陈宏,2019-07-20 06:08:35,44,45,1,我从未发现有人如此急于的证明自己是个sb，真贱
115052,5171,陈宏,2019-07-15 01:43:34,13,15,2,墨迹的一批
115054,5171,陈宏,2019-07-20 07:42:57,28,32,4,考虑什么对象\n\n
115072,5171,陈宏,2019-07-15 07:03:40,26,27,1,认知实习介绍讲了两个小时 然后没讲任何重点 仅从这一点就可以看出这货绝壁是个憨憨
115080,5171,陈宏,2019-07-15 07:49:56,14,15,1,sb\n\n
115149,5171,陈宏,2019-07-16 07:55:09,21,21,0,第一次骂人，但是好几件事真的让我觉得她就是个傻逼
115327,5171,陈宏,2019-07-18 16:11:03,12,14,2,司马脸 态度极差
115337,5171,陈宏,2019-07-19 01:23:25,10,12,2,辣鸡老师
115340,5171,陈宏,2019-07-19 02:31:26,33,34,1,我真好久没碰到过敦煌来的老师了\n\n壁话好多
115368,5171,陈宏,2019-07-20 03:57:42,20,22,2,怎么说呢，懂的都懂，学弟学妹反正祈祷别是她做班主任吧。
115370,5171,陈宏,2019-07-20 04:35:46,23,24,1,为什么没有0分
115371,5171,陈宏,2019-07-20 04:39:29,24,26,2,下午一点开大会，现在12.40，能放我们去吃饭吗
115372,5171,陈宏,2019-07-20 04:57:31,15,17,2,nmsl\n\n
115373,5171,陈宏,2019-07-20 05:43:43,9,12,3,什么sb
115374,5171,陈宏,2019-07-20 05:46:35,11,14,3,tmsl
115375,5171,陈宏,2019-07-20 05:53:27,15,15,0,差的一比
115376,5171,陈宏,2019-07-20 05:55:54,22,24,2,不重要的事情讲三遍。
115380,5171,陈宏,2019-07-20 08:08:50,36,38,2,敦煌壁画 顶我上去
115382,5171,陈宏,2019-07-20 08:17:07,27,30,3,铁five，工地缺个抬杠的我看你骨骼惊奇不如去抬杠建设祖国吧
115390,5171,陈宏,2019-07-21 00:36:46,16,18,2,ee生辉还专门对她做了访谈你能想到？
115427,5171,陈宏,2019-10-23 03:23:38,33,37,4,傻逼傻逼傻逼傻逼傻逼傻逼傻逼傻逼傻逼傻逼傻逼傻逼傻逼傻逼傻逼傻逼傻逼傻逼傻逼傻逼傻逼傻逼傻逼傻逼傻逼傻逼傻逼傻逼傻逼傻逼傻逼傻逼傻逼傻逼傻逼傻逼傻逼傻逼傻逼傻逼傻逼傻逼傻逼傻逼傻逼傻逼傻逼傻逼傻逼傻逼傻逼傻逼傻逼傻逼傻逼傻逼傻逼傻逼傻逼傻逼傻逼傻逼傻逼傻逼傻逼傻逼傻逼傻逼傻逼傻逼傻逼傻逼傻逼傻逼傻逼傻逼傻逼傻逼傻逼傻逼傻逼傻逼傻逼傻逼傻逼傻逼傻逼傻逼傻逼傻逼傻逼傻逼傻逼傻逼傻逼傻逼傻逼傻逼傻逼傻逼傻逼傻逼傻逼傻逼傻逼傻逼傻逼傻逼傻逼傻逼傻逼傻逼傻逼傻逼傻逼傻逼傻逼傻逼傻逼傻逼
116191,5171,陈宏,2019-09-06 02:28:07,2,6,4,真的差
116192,5171,陈宏,2019-10-23 03:23:42,19,21,2,傻逼傻逼傻逼傻逼傻逼傻逼傻逼傻逼傻逼傻逼傻逼傻逼傻逼傻逼傻逼傻逼傻逼傻逼傻逼傻逼傻逼傻逼傻逼傻逼傻逼傻逼傻逼傻逼傻逼傻逼傻逼傻逼傻逼傻逼傻逼傻逼傻逼傻逼傻逼傻逼傻逼傻逼傻逼傻逼傻逼傻逼傻逼傻逼傻逼傻逼傻逼傻逼傻逼傻逼傻逼傻逼傻逼傻逼傻逼傻逼傻逼傻逼傻逼傻逼傻逼傻逼傻逼傻逼傻逼傻逼傻逼傻逼傻逼傻逼傻逼傻逼傻逼傻逼傻逼傻逼傻逼傻逼傻逼傻逼傻逼傻逼傻逼傻逼傻逼傻逼
116678,5171,陈宏,2019-09-13 02:39:29,9,11,2,人是挺傻逼，给分意外的还行
116724,5171,陈宏,2019-09-14 06:35:17,3,6,3,小学期给分还行，老师嘛…确实有点…
116771,5171,陈宏,2019-09-15 12:42:22,24,25,1,头一遭看见人傻逼给分好的...
117216,5171,陈宏,2019-09-20 11:54:42,3,8,5,人是傻逼，给分挺好
122873,5171,陈宏,2020-04-16 02:54:55,16,16,0,不打一分的都是托
134711,5171,陈宏,2021-04-11 14:17:01,3,4,1,傻逼。
134739,5171,陈宏,2021-04-13 04:23:20,5,5,0,想吐槽的东西挺多的，不知道从何说起，就骂句傻逼好了。
139119,5171,陈宏,2021-07-13 02:49:12,11,12,1,臭傻逼
139751,5171,陈宏,2021-07-23 07:22:29,4,5,1,事情很多
152034,5171,陈宏,2022-03-23 14:34:07,2,4,2,蚌埠住了
152049,5171,陈宏,2022-03-24 05:52:54,13,14,1,电信专业学生实验的最大阻碍
152387,5171,陈宏,2022-04-07 12:20:10,6,9,3,更年期的煞笔玩意
152389,5171,陈宏,2022-04-07 12:20:39,18,21,3,我说真的你差不多得了😅你自己低能不要带着学生在这陪着你😅问你点啥你都是不知道，不学无术的典型😅然后事又这么多😅你一次实验让我们一组拍两百多照片当结果你自己想想这是人干的事情吗😅唯一可取的是疫情防控水平较高，你是全电院唯一一个进实验室必须戴口罩的😅果然和电院是一脉相承
152461,5171,陈宏,2022-04-12 07:48:13,8,8,0,不能打0分吗，按着自己良心打下1分
152693,5171,陈宏,2022-04-18 11:14:43,2,5,3,非常乐色
155283,5171,陈宏,2022-06-10 06:55:38,3,5,2,画模数实验版图画不下去了再来骂一遍，艺颜陈宏，鉴定为寄
158372,5171,陈宏,2022-07-01 03:00:33,6,8,2,你他妈是不是傻逼
158645,5171,陈宏,2022-07-01 03:18:28,4,5,1,垃圾老师
158647,5171,陈宏,2022-07-01 03:34:08,2,4,2,你们去过玉泉吗
158648,5171,陈宏,2022-07-01 03:22:50,4,5,1,你们去过玉泉吗
159094,5171,陈宏,2022-07-06 05:30:56,2,5,3,真的傻逼
159095,5171,陈宏,2022-07-06 05:30:50,2,5,3,真的傻逼
159337,5171,陈宏,2022-07-13 14:36:24,2,3,1,傻波一个，我真的无语死了
159344,5171,陈宏,2022-07-14 05:13:57,3,6,3,一个认识实习，报告+ppt展示，展示完还要同学提问，一大堆屁事，给分还垃圾，总是能让学生去做一些尬的要死的事。
165053,5171,陈宏,2022-12-28 18:22:27,3,5,2,SB傻逼傻逼傻逼SB傻逼傻逼傻逼傻逼傻逼傻逼傻逼
168480,5171,陈宏,2023-02-18 06:14:32,16,16,0,sbsbsbsbsbsbsbsbsbsbsbsbsbsbsbsb\n\n和吴建德老师形成鲜明对比
168491,5171,陈宏,2023-02-18 13:09:34,8,10,2,ntnt
168492,5171,陈宏,2023-02-18 13:15:58,8,10,2,受不了了，什么玩意儿啊
168792,5171,陈宏,2023-02-22 08:51:30,7,8,1,111
169903,5171,陈宏,2023-02-28 09:19:01,7,9,2,电信奇葩共赏
171006,5171,陈宏,2023-03-14 03:50:47,9,9,0,真傻呗
171009,5171,陈宏,2023-03-14 05:06:40,14,14,0,完全没有学术能力，做实验遇到问题别指望她
171017,5171,陈宏,2023-03-14 06:52:46,10,11,1,鲨臂吧
171224,5171,陈宏,2023-03-19 12:04:55,14,15,1,很无语的老师，没有水平却有点自负。上课混乱。实验课讲绪论，实验操作，实验原理什么也不讲。实验器材原理她自己也不知道。真离谱。就这么离谱的老师还出了本实验书，强制学生预置教材，强买强卖，毫无底线。书和她上课一样烂，还为自己出书自鸣得意，定价很高很不合理。实验书前面大部分都是没有的东西，到有用的实验部分她又写的乱七八糟。连实验目的实验操作都写不明白。
171308,5171,陈宏,2023-03-21 09:12:30,22,25,3,建议我国把死刑改为上ch实验课
171314,5171,陈宏,2023-03-21 11:18:36,12,12,0,通信原理的破箱子和电脑能不能更新维护一下，体验太差了\n\n能力极差态度更差，助教都比这人靠谱，实验课纯坐牢
171546,5171,陈宏,2023-03-28 07:28:06,14,17,3,“老师你真聪明”\n\n“你是在讽刺我吗”\n\n“不不，老师，是我太笨了”\n\n——电信上单强势开团
171586,5171,陈宏,2023-03-29 13:00:23,19,23,4,“老师你比较聪明，我太笨了。”\n\n“你是在讽刺我吗？”\n\n战地记者回忆版 电信上单还是有说法的
171785,5171,陈宏,2023-04-05 09:40:35,14,18,4,祝病魔早日战胜老师
173678,5171,陈宏,2023-07-16 03:44:44,5,7,2,短学期上的真好啊呵呵
175639,5171,陈宏,2023-07-13 01:25:50,16,17,1,年年短学期都是这个活化石 截止目前1.21分，多出来这0.21还是冤枉她了
175919,5171,陈宏,2023-06-27 06:48:54,23,26,3,为什么强制我们参加一个和专业技能完全无关的比赛？
177185,5171,陈宏,2023-07-02 04:28:48,7,8,1,不是好老师
177372,5171,陈宏,2023-07-03 05:15:10,1,6,5,呵呵，，，，
177373,5171,陈宏,2023-07-03 05:15:10,6,6,0,呵呵，，，，
178510,5171,陈宏,2023-07-13 05:09:39,7,8,1,为什么不提早十分钟到！😄 纯傻逼
178717,5171,陈宏,2023-07-19 15:52:39,11,12,1,这个人真的是我见过最傻b的人，纯纯nm脑残，我不知道浙大聘请这种老师干哈，不想骂人但是真的憋不住，每年短学期看见她就像是眼里糊了一坨屎
179169,5171,陈宏,2023-08-29 05:52:07,4,7,3,老师来带对外交流项目，不知道为什么这么喜欢集体行动，29多个人在城市里集体行动，别太蠢了哈哈，管理能力过于低下
179320,5171,陈宏,2023-09-10 08:31:52,2,3,1,实验验收非常折磨人，我上课的时候，一个学生直接怼她了
180727,5171,陈宏,2023-09-25 11:21:33,5,7,2,纯纯的闹潭
184259,5171,陈宏,2023-12-14 06:21:19,8,9,1,纯cs
184264,5171,陈宏,2023-12-14 11:00:14,8,9,1,人品和专业能力俱低
184265,5171,陈宏,2023-12-14 11:01:08,7,10,3,中午1:50的实验，1:45通知我们回去带电脑，今天要交三份实验报告，三份实验报告要在课上写完
184272,5171,陈宏,2023-12-14 19:01:46,21,22,1,到底是谁打了＞1的分？
184273,5171,陈宏,2023-12-14 19:53:05,6,7,1,这位老师行为不符合一般逻辑，上其实验课简直就是折磨自己，建议坚决远离，快跑啊傻孩子们！
185420,5171,陈宏,2023-12-29 05:37:28,6,7,1,出生玩意
185846,5171,陈宏,2024-01-05 01:30:47,11,14,3,上陈老师的课到现在，我觉得她大概还是对自己教的东西有认识的，但是绝对不知道怎么上课。她只会列举按哪个按钮、测哪个频谱，但是为什么测、测出来的数据有什么意义却完全不讲，甚至讲错。\n\n\n\n本来很简单的一些实验，被她搞得毫无逻辑，变成了测测这个测测那个的小学生实践课。而且课前课后还不提供PPT，不提供原理图，请问老师，难道要我们自己对实验PCB做逆向工程吗？\n\n\n\n很不想背后发老师的牢骚，但是实话说老师已经把
190632,5171,陈宏,2024-03-12 09:30:43,7,9,2,要上ch老师的实验课，上课前一周食不知味，夜不能寐，不如直接让我去寺
190947,5171,陈宏,2024-03-25 10:35:24,16,17,1,美国五星上将麦克阿瑟评价道：如果上帝让我去上ch的实验课，那么我宁愿去干掉上帝
191220,5171,陈宏,2024-04-12 13:49:22,14,14,0,陈宏被查！
191221,5171,陈宏,2024-04-12 13:56:50,15,19,4,上尼玛比陈宏的实验，比日了狗还难受一万倍\n\n验收验收，验收你大爸呢
191223,5171,陈宏,2024-04-12 14:07:17,13,13,0,陈宏真是傻呗吧
191224,5171,陈宏,2024-04-12 14:16:00,30,32,2,如果陈宏和希特勒在一个房间里，我有两发子弹，我会枪毙ch两次
191225,5171,陈宏,2024-04-12 14:20:08,15,16,1,原理是讲不清的，实验是说不明的，验收是折磨人的，效率是恶心人的，五星上校麦克阿瑟对此评价道，如果让我在把枪指向上帝和在陈宏那做实验中选择，那么我会毫不犹豫地把枪指向ch（）
191230,5171,陈宏,2024-04-13 16:50:05,18,20,2,求求你们别说它傻逼了，傻逼是用来形容人的
191257,5171,陈宏,2024-04-15 12:27:08,18,21,3,不是我就有一个问题，这个sb学历也不高，也没留过学，之前就是一个卖摩托罗拉手机的，他怎么进浙大的？？？
191273,5171,陈宏,2024-04-16 10:06:36,4,4,0,屎屎屎
191290,5171,陈宏,2024-04-17 16:21:55,10,11,1,笑稀，屎到淋头了才想起来，于是强迫助教发两条文字挽回脸面哈哈哈（bushi），做你的助教也真是前半辈子赔掉了。你TM终于也知道看不见学生背后的辛苦哈，行，老子也没说打算给你看我的实验报告。偏要整个周四去你那303破刷怪笼单独交，交你妹呢！
191392,5171,陈宏,2024-04-19 05:31:53,7,7,0,抽象到最后开始大谈人类历史了，服了。
191393,5171,陈宏,2024-04-19 05:33:11,2,5,3,天命陈宏~降而生电~宅电信茫茫~\n\n电气闻讯而来，含泪bd
191532,5171,陈宏,2024-04-24 10:43:31,6,8,2,宏师慈悲，我佛无量。授电信学子九九八十一难，呜呼，宏哉！
192605,5171,陈宏,2024-05-24 16:59:15,6,9,3,海院观光团前来围观电院詹舒越
192610,5171,陈宏,2024-05-25 02:52:48,12,13,1,海院er前来围观电院詹～shu～yue～
192828,5171,陈宏,2024-05-31 02:35:59,5,7,2,傻逼老师，电院最没用的老师，没有之一
193836,5171,陈宏,2024-06-20 05:24:20,3,4,1,依托史
195474,5171,陈宏,2024-06-28 07:53:59,7,9,2,上她的短学期，去某汽车企业参观，没有任何问过我们的意见就莫名其妙被她安排去参加某汽车企业举办的PPT大赛，上面那些形容词我觉得都不能够形容
195551,5171,陈宏,2024-06-28 17:33:22,3,5,2,垃圾老师，短学期依托勾实，有你真是电信专业的福报
195999,5171,陈宏,2024-07-01 05:32:06,2,4,2,？？？
196004,5171,陈宏,2024-07-01 05:47:57,6,7,1,纯逆天nt
196156,5171,陈宏,2024-07-02 01:59:42,17,19,2,短学期不上陈宏，就像玩游戏不玩原神，看四大名著不看红楼梦，吃方便面不吃白象，买手机不买华为，看电影不看吴京，只能度过一个相对失败的人生。
196160,5171,陈宏,2024-07-02 02:12:58,36,38,2,我直接在这里拉屎\n\n⠀⠀         ⣀⣤⣤⣀\n\n⠀⠀⠀⠀⣠⠟⠁⠀⠀⠀⠀⠙⣆\n\n⠀⠀⠀⣴⠁⠀⠀⠀⠀⠀⠀⠀⠀⢷\n\n⠀⠀⠀⡇⠀⠀⡴⠀⠀⡴⠀⠀⠀⠀⡆\n\n⠀⠀⠀⡇⠀⠀⠀⠀⠀⠀⠀⠀⠀⠀⠇\n\n⠀⠀⠀⢿⠀⠀⣤⣀⣀⣤⠀⠀⠀⣼\n\n⠀⠀⠀⠀⠳⣀⠀⠀⠀⠀⠀⢀⡴⠁\n\n⠀⠀⠀⠀⠀⠈⠛⠶⡆⠀⠀⢿⠀⠀⠀⠀⣀⣀⣀⣀⣀\n\n⠀⠀⠀⠀⠀⠀⠀⣴⣴⠛⠃⠀⢻⠀⠀⠸⡀⠀⠀⠀⢀⠇\n\n⠀⠀⠀⠀⣠⣴⡿⠋⠀⠀⠀⠀⠀⣇⠀⠀⡇⠀⠀⠀⢸\n\n⠀⣴⠟⠛⠉⠀⠀⣠⣶⠋⠀⠀⠀⢹⠀⠀⡇⠀⠀⠀⢸\n\n⢠⠃⣶⠶⣺⡿⠿⠶⠾⣦⡀⠀⠀⠀⣇⠀⡇⠀⠀⠀⢸\n\n⠘⠳⠾⣯⠁⠀⠀⠀⠀⠀⠀⠀⠀⠀⢹⠀⡇⠀⠀⠀⢸\n\n⠀⠀⠀⣿⠀⠀⢸⣀⠀⠀⠀⠀⠀⠀⡾⠀⡇⠀⠀⠀⢸\n\n⠀⠀⠀⣿⠀⠀⣿⣰⠾⠿⠿⠿⠿⠿⠶⢦⣷⣤⣤⣤⠞\n\n⠀⠀⠀⡟⠀⢠⠃⣇⠀⠀⠀⠀ ⠀⠀⠀⠀⠀⢠⠃\n\n⠀⣠⡶⠃⠀⣿⡄⠈⢲⠀        ⡟\n\n⢠⣿⣿⣿⣿⣿⣿⠀⡏⠀    💩 ⠀⣸\n\n⠀⣿⣿⠀⠀⢿⣿⣸⠀⠀⠀⠀⠀⠀⠀⠀⠀⢀⠃\n\n⠀⠙⠁⠀⠀⠘⠋⠛⠒⠒⠒⠒⠒⠒⠒⠒⠒⠋
196318,5171,陈宏,2024-07-03 01:17:07,6,6,0,sb一个
196320,5171,陈宏,2024-07-03 01:26:53,2,4,2,sb plus
196355,5171,陈宏,2024-07-03 04:59:33,2,4,2,一眼顶针评价为逆天
196993,5171,陈宏,2024-07-06 10:21:28,2,3,1,试试而已。
197306,5171,陈宏,2024-07-10 16:12:42,5,7,2,上了她的课，我这辈子是不是有了😋
197311,5171,陈宏,2024-07-11 01:07:22,21,23,2,彻底解决了电信学子短学期过的太舒服的问题
197354,5171,陈宏,2024-07-11 08:10:47,17,18,1,司马玩意迟到2分钟总评扣十分（五级制降档）。参观华为，华为领导站着讲话，她在第一排坐着打电话。
197355,5171,陈宏,2024-07-11 08:22:33,11,14,3,无敌了陈宏，太傻逼了，人家华为的高层在台上宣讲，她坐在第一排打电话，nt\n\n一个，基本的尊重都没有
197499,5171,陈宏,2024-07-17 10:16:08,1,5,4,垃圾老师
197549,5171,陈宏,2024-07-18 12:44:42,10,11,1,认识实习小组展示，要求一个组所有人上台，除了讲的人，其他人都站旁边一起坐牢，太抽象了
197666,5171,陈宏,2024-07-26 00:56:24,3,4,1,真垃圾吧
197725,5171,陈宏,2024-08-05 03:01:29,11,12,1,傻逼傻逼国家的才子都被你带坏了，不懂人情世故，狗屎一个，自以为是，猪狗不如，我家的狗都比你好🤭
197847,5171,陈宏,2024-08-15 14:07:30,3,5,2,"-1"" OR 2+869-869-1=0+0+0+1 --"
198806,5171,陈宏,2024-09-12 00:11:56,2,3,1,you're a failure
199240,5171,陈宏,2024-09-19 17:07:52,3,4,1,唯一真史
199304,5171,陈宏,2024-09-20 15:02:24,10,10,0,司马老师 认识实习乱给分
200554,5171,陈宏,2024-10-19 02:15:15,2,3,1,迟到干嘛
200555,5171,陈宏,2024-10-19 02:15:24,4,4,0,666
201229,5171,陈宏,2024-10-30 12:47:18,4,4,0,不想说什么了
201239,5171,陈宏,2024-10-30 14:41:21,4,5,1,实验报告催这么紧干嘛，搞不明白了，真就留一天时间，所有人整天都干你的任务好了。。给我好闺蜜逼的没时间一起玩了
201395,5171,陈宏,2024-11-01 15:14:00,7,7,0,这是见过最没有专业知识的。。。，懒得喷
203699,5171,陈宏,2024-11-20 14:26:26,4,6,2,怎么还没收敛到1？ 毕业了一年了还觉得这个人是个sb
203888,5171,陈宏,2024-11-21 20:38:43,2,4,2,宽带技术，什么都学不到
204355,5171,陈宏,2024-11-25 11:41:41,18,20,2,在应电楼里，有一个叫303的传奇实验室，据说几乎没有人能笑着走出这个实验室。在这个实验室里.....
204564,5171,陈宏,2024-11-26 17:41:34,6,8,2,宽带技术属实顶级折磨，提前上课延后下课，讲的东西和做的毫无关系，一问就回答要多试。\n\n哥们又不是章北海，哥们只是想顺利结课拿到学分。
204699,5171,陈宏,2024-11-27 11:57:48,2,4,2,无言以对
205445,5171,陈宏,2024-12-06 10:54:10,2,4,2,一废物
206047,5171,陈宏,2024-12-13 04:05:02,5,5,0,一坨石
206439,5171,陈宏,2024-12-15 06:23:09,25,25,0,毕业许多年，看陈老师的评论区是令我最开心的事
208262,5171,陈宏,2024-12-26 11:48:25,5,6,1,意义不明的老师，教的东西和存在的意义都不明
210455,5171,陈宏,2025-01-09 07:51:37,-31,3,34,抛开教学水平不谈，陈老师人还是很好的
213998,5171,陈宏,2025-01-22 15:42:50,2,4,2,萨比萨比大萨比
215332,5171,陈宏,2025-02-25 07:37:07,1,1,0,太烂了
216178,5171,陈宏,2025-03-11 14:01:40,6,6,0,每次上她的实验课，感觉就像经历一场奇妙的冒险。还有经典名言，“不要拿自己的U盘插到实验室的电脑里”。对了对了，还有各种唐氏操作，比如认知实习的时候让所有人都参加一个跟实习完全无关的byd公司的汽车设计比赛，再比如在钉钉挨个给学生发私信说让大家参加一个人工智能的实验课，唯一能得到的是英伟达发的一张培训证书。
216563,5171,陈宏,2025-03-18 12:44:16,1,1,0,没话说
216742,5171,陈宏,2025-03-24 00:25:39,2,2,0,也是体验到电信上单的实验课了，只能说感谢前辈救苦救难，不然怕是要死在303了
216802,5171,陈宏,2025-03-26 01:31:41,6,6,0,这玩意是关系户吗 出生成这样还能在电院混
217065,5171,陈宏,2025-04-01 05:51:27,3,3,0,诗人我吃
217110,5171,陈宏,2025-04-02 03:44:40,6,6,0,电院教师之下限
218251,5171,陈宏,2025-04-22 08:18:38,-1,0,1,平心而论，还不太清楚
218450,5171,陈宏,2025-04-23 15:41:35,3,3,0,我自杀了绝对会回来找你的
218947,5171,陈宏,2025-05-14 15:40:51,2,2,0,解决了电信学子过的太好的弊端，你永远想不到她的脑袋能灵光一现出什么东西，私信英伟达培训，不如我上dy找点证书
218961,5171,陈宏,2025-05-15 07:13:21,2,2,0,只能说懂的都懂
220732,5171,陈宏,2025-06-19 11:09:26,1,1,0,无法评价
221663,5171,陈宏,2025-06-25 07:01:37,4,4,0,简简单单十分钟的介绍能讲俩小时 就是纯撒被
101838,5202,杨树,2019-01-29 08:44:50,8,14,6,90后美女博导
123859,5202,杨树,2020-06-15 07:03:59,5,10,5,美女 太温柔了555爱了爱了
151859,5247,严晓浪,2022-03-18 05:51:40,0,0,0,汉芯，
129408,5249,韩祯祥,2021-01-05 06:15:16,3,3,0,没有人评价吗？
178452,5249,韩祯祥,2023-07-12 03:13:09,3,3,0,第24任校长处打卡
191928,5249,韩祯祥,2024-05-05 13:07:30,2,2,0,老校长一路走好！🕯
191947,5249,韩祯祥,2024-05-06 03:55:34,7,7,0,老校长 一路走好
192003,5249,韩祯祥,2024-05-07 08:49:52,3,3,0,老校长一路走好！
194409,5249,韩祯祥,2024-06-23 16:46:02,1,1,0,韩老校长千古！
206622,5249,韩祯祥,2024-12-16 15:52:06,1,1,0,韩老校长把蠹僵疯带走吧！求求您了，它不配！
158674,5270,万灿,2022-07-01 08:26:07,9,16,7,讲课到后面有点高深，但作业少，给分高
174377,5270,万灿,2023-06-11 07:48:13,14,17,3,人工智能这门课，两个大作业，一个个人的，一个三人组队的，都要你编程，要你一个电院的从零开始编出各种算法，关键上课只讲这些算法的逻辑，一行代码看不到。作业还给不出一个具体规则，就说要你做，报告要求什么内容，展示又要展示什么什么都没有。真别说自己一个选修课不给大家增加负担这种话了好嘛?
194733,5270,万灿,2024-06-25 06:56:15,4,4,0,事情略多，给分一般
221788,5270,万灿,2025-06-26 09:02:57,1,1,0,人工智能与电力大数据：上课没怎么听，但是第一节课点了好多人起来（导致一大堆人退课），没有正式签过到，但是会压力他觉得面生的同学。两个编程作业要求一直讲不清楚，搞得人迷迷糊糊的。作业的话，2025年了，靠下ai帮助挺简单的，有相关基础的同学应该更轻松。如果不考虑老师个人因素的话，这门课还算推荐的，任务量较轻（可能不熟悉代码的做起来有些困难，需要自学或者ai）。给分应该还算不错的，毕竟没啥考试，全靠报告和老师主观印象
221960,5270,万灿,2025-06-28 02:20:34,0,0,0,人工智能与电力大数据，每节课都去了，给分还不错。今年第一次课对着名单点名劝退好多人，但是后续基本不会对着名单点，而是逮着几个面熟的前排听课的同学提问，偶尔随机点后排的同学。上课不太拿话筒，讲的内容感觉还是比较粗糙。今年是两份作业，都是风电功率预测，个人作业需要手搓BP，另外小组合作的作业各种机器学习、深度学习方法都可以（一般都弄LSTM等）。\n\n他作业要求一如既往很不明确，建议不是很忙的话每节课去刷个脸熟，万一讲到作业要求了可以记一下。\n\n给分有10%的平时表现分，今年是在某一节课上讲的，要写一个对课程的建议放在个人作业的实验报告里面，作为到场上课的依据。其他的是代码和报告的评估。\n\n现在有AI辅助，这门课的大作业其实不算难，但是作业内容还是比较实用的。小组作业感觉大部分都是一个大腿负责主体的代码，剩下一两个人做其他修补的工作，也有solo的，身边统计学来看，大作业展示的时候老师比较认可的话，负责主体部分的同学基本都满了，其他被带飞的基本也有4.2，4.5，所以给分真还不错。
182527,5500,钟文兴,2023-11-17 06:21:41,0,0,0,很好的老师，压力不大
127570,5572,冀晓宇,2020-11-24 12:58:51,8,9,1,上课很有意思，是我见过的最像大学课的课程了，老师很喜欢和同学交流，讲的内容也都是他们研究的新内容。
133457,5572,冀晓宇,2021-03-23 04:38:41,21,22,1,老师年轻帅气！讲的很好。物联网安全这门课的实验包括基础实验和探究性实验。基础实验都挺简单的，但是探究性实验一定要水过去，一定要水过去，一定要水过去！我当时在上面花了很多时间，以至于期末都没时间复习了。结果发现探究性实验给分大家都差不多。。。
178080,5572,冀晓宇,2023-07-07 03:08:44,0,3,3,期末开卷考+基本都是历年卷，感觉大家期末卷面分都差不多，但是最后给分并没有很好（甚至有点烂），靠平时分硬拉总评（平时分只有82 orz）也是少见。\n\n再给我一次机会的话，我一定不选这门课，保研边缘人如是说。
178780,5572,冀晓宇,2023-07-22 13:00:36,9,11,2,《物联网安全》这课讲的东西还是挺有用的，给分个人感觉也还行
195603,5572,冀晓宇,2024-06-29 03:40:20,2,2,0,为数不多的上课有意思的好老师，很希望和同学们交流，《物联网安全》这门课学的东西都挺有意思的，今年还加了大模型相关的前沿知识，为数不多的建议上课听课后不用花多少心思的好课，期末半开卷基本都是历年卷，最后给分也很好，满昏
197151,5572,冀晓宇,2024-07-08 07:18:09,1,2,1,上课讲课很好，《物联网安全》是真能学到东西的
216862,5572,冀晓宇,2025-03-27 07:47:56,1,1,0,非常非常非常好的老师！！！
218997,5572,冀晓宇,2025-05-17 13:08:28,3,3,0,《物联网安全》\n\n挺好的课程，课上能了解到很多前沿的研究内容，实验也不难，对新手很友好
122958,5652,耿光超,2020-04-26 01:41:59,8,11,3,觉得不错，挺好的老师
126186,5652,耿光超,2020-09-18 15:45:52,-14,2,16,给分一般？不明白计算方法为什么只有4.2
157003,5652,耿光超,2022-06-21 14:07:25,2,2,0,期末PPT救命，感谢老师
172718,5652,耿光超,2023-05-05 04:44:26,0,0,0,给分很不错，老师不点名，可以自己合理安排时间
191638,5652,耿光超,2024-04-26 11:07:48,0,0,0,好老师，讲课清晰
192688,5652,耿光超,2024-05-28 09:15:01,3,3,0,很厉害，同时也很热心的老师，无论是在上课，还是在指导学生参加科研竞赛上
221703,5652,耿光超,2025-06-25 10:32:30,0,0,0,好老师！！
133471,6074,徐超炯,2021-03-01 04:49:27,3,7,4,怎么说呢
134318,6074,徐超炯,2021-03-23 12:21:15,6,11,5,关心学生的10分副书记
137179,6074,徐超炯,2021-07-02 03:01:03,4,4,0,非常棒的老师 选他没错
137322,6074,徐超炯,2021-07-03 07:46:55,3,3,0,给分还行，上课水水，作业不多
142138,6074,徐超炯,2021-11-07 12:29:35,0,2,2,人很好，职规选他没错
142192,6074,徐超炯,2021-11-08 11:34:09,1,1,0,关心学生
149138,6074,徐超炯,2022-01-14 13:47:12,0,0,0,上课可以水，也可以认真卷，徐老师是不在意的，但好看的分数也不好拿，不过职规嘛，懂的都懂，一般人还是水水过去得了。
150282,6074,徐超炯,2022-01-21 10:44:41,0,0,0,一般。
160723,6074,徐超炯,2022-10-07 07:54:54,1,1,0,呸呸呸
127895,6101,史婷娜,2020-11-30 02:19:28,16,19,3,电机与拖动，满了。老师讲的不错的，但是主要还是要靠自己把作业题一道道都弄懂，推荐！
182250,6101,史婷娜,2023-11-13 08:57:00,2,2,0,给分实在
191554,6101,史婷娜,2024-04-24 18:00:36,0,0,0,讲课很认真
204438,6101,史婷娜,2024-11-26 02:07:05,0,0,0,超级好
125037,6115,王云冲,2020-08-17 07:48:24,2,3,1,给分还算厚道
136658,6115,王云冲,2021-06-22 12:57:53,1,1,0,还不错
139274,6115,王云冲,2021-07-14 03:53:39,-5,1,6,智能控制一言难尽，老师给分挺严格的。会有一次或两次大作业，matlab改进水箱模型。考试计算题超级多，简述题有的在课件上找不到答案，最后差点没写完。这个课的考核比较硬核……
151382,6115,王云冲,2022-03-02 02:21:45,0,0,0,老师很认真，考试题目有点难，给分还比较厚道
195279,6115,王云冲,2024-06-27 14:40:49,0,0,0,好老师。
178559,6165,李知艺,2023-07-14 12:46:41,12,18,6,超级好的老师，海底捞
191679,6165,李知艺,2024-04-27 14:12:18,7,8,1,一年前上的发现今天老师没人评分\n\n我想说老师当时给分相当不错\n\n当时就李老师和吴立建老师俩人\n\n比隔壁班高了不少捏\n\n讲的也不难\n\n点名2+1，第三次点名到了加2分\n\n课程是人工智能与物联网
194258,6165,李知艺,2024-06-23 02:33:26,8,9,1,平时有签到加分，加的还挺爽，老师讲课完全听不懂
194283,6165,李知艺,2024-06-23 06:00:03,8,8,0,爹爹爹爹爹爹爹您太捞了，捞王，真捞王，爸爸！
220791,6165,李知艺,2025-06-19 18:04:05,2,2,0,（人工智能与物联网）补个评价：老师上课很轻松，一点不压力，人也很好。上课ppt印象中是英文的，berkeley公开课之类的？签到是加分制的，两次都没签上（比较摆），但最后还有89，所以给分个人感觉也是不错的。要是算上签到加分（两次就是4分）就更可观了。
220886,6165,李知艺,2025-06-20 09:13:20,2,2,0,给分真的很好，一共两次签到会提前通知，讲课还可以，这门课建议考前刷一遍智云就问题不大。一共就三次作业（第二次和第三次会把答案也发出来，据我所知比另一个cyj老师的平行班少一次），题目可是使用ai回答（虽然老师说要善用ai自己确认正确性，但是感觉大家平时分应该挺高的）。\n\n这门课的期末卷子是两个平行班的老师分别出的，往年据说lzy班上会难一些，但是今年感觉难度差不多，主要是老师应该狠狠捞了，给分今年和前几年都说很好。\n\ntips：考试的时候可以自己打印资料一页A4纸，注意两个班的内容有一定差异，不要打印错了（我就是hhhhh）
183940,7027,周永智,2023-12-04 08:57:36,11,17,6,要求巨多 讲座课要求写笔记
184124,7027,周永智,2023-12-10 06:54:38,3,9,6,纯nt老师，听个讲座还要记笔记，不提前到还扣分，无语
190725,7027,周永智,2024-03-21 04:49:27,-1,5,6,很有趣的老师
191250,7027,周永智,2024-04-15 03:27:03,3,8,5,压榨、不把学生当人
203928,7027,周永智,2024-11-22 05:22:35,3,5,2,谄上骄下，小人也
209941,7027,周永智,2025-01-07 13:37:15,1,3,2,严于律人，宽以待己。善于给学生各种警告加码，但是对自己学生很护短。
172979,7210,张哲任,2023-05-10 15:29:15,1,5,4,张老师第一次教高电压\n\n老师人很好，也很和善，消息秒回，下课从不拖堂，从不点名\n\n最后一节课可以提前回去复习其他科目比如说暂态\n\n而且出分很快，老师不仅熬夜批卷子非常辛苦，而且所有人的卷子都看很多遍，确定不会有错判\n\n张老师确实是个不可多得的好老师\n\n\n\n\n\n\n\n但是期末卷面平均分比隔壁cxr班低10分\n\n这让我很难接受
217687,7210,张哲任,2025-04-15 06:12:17,1,1,0,老师人很不错不点名，上课讲的比较清晰但是因为课程原因，听的人不多，老师就比较羞涩，也没用话筒，到最后声音越来越轻…但老师确实人很好
217949,7210,张哲任,2025-04-18 08:23:20,1,1,0,高电压技术这门课就是靠背，知识点比较多，不过老师人很好
221741,7210,张哲任,2025-06-25 23:50:26,0,0,0,老师人很好
185843,7279,罗皓泽,2024-01-05 01:17:58,6,9,3,高频电子线路。看得出老师很想和大家互动，动辄花十几二十分钟问一些其他课程的学习情况，把这门课搞得像什么综述一样。但是课程本身的逻辑乱七八糟，实验和理论也没什么联系，让人完全不想和他对话。\n\n\n\n至于作业安排之类的，已经不重要了，老师在最后一周的最后一节课布置了大作业。另外实验老师是ch，不多说了。
185854,7279,罗皓泽,2024-01-05 06:26:36,8,10,2,不是老哥，虽然第一次开课情有可原，但你有没有好好读懂校方的开课规则？前面说什么不布置期末大作业，结果考试周给你一回马枪，还附带一学期ch陪你做8次实验——每周都有实验啊喂！“你们平时都用手机吗？”“你们还用摩托罗拉吗？”“你们都没学过XXX吗？”“你们都不是党员吗？”（选负责收期末大作业的同学）……“好，行，行，行”。我真的无法评价，引用某美国五星上将的话：“当我来到lhz的课堂，我就知道，被那个女人支配的恐惧，又回来了。”
207771,7279,罗皓泽,2024-12-24 07:59:25,2,2,0,好奇宝宝\n\n\n\n老师很喜欢问问题，也不仅仅包括课堂知识的问题，也会问我们在其他课程的学习情况。\n\n讲的内容感觉像是导引，没有很深入也没有细讲原理，喜欢在讲的时候抛出一些问题，如果同学们回答不上来或者回答有偏差，老师会继续引导我们思考和回答，但！！！重点是他不告诉我们最终这个问题的答案啊😭😭很多时候都是说让我们课后再思考思考，太吊胃口了\n\n\n\n所以总结下来，这门课上下来没有很大的收获，但课也水水的，在第四周左右就布置了大作业（这点真的听了上届的意见），实验虽然是ch带，但也还好吧，ch不懂原理只会让我们这测测那测测，好在到点了大家就都走人了（两小时不到），实验报告也是两次实验合一起交
212111,7279,罗皓泽,2025-01-13 07:50:22,0,0,0,挺水的
212171,7279,罗皓泽,2025-01-13 10:02:44,0,0,0,老师上课是很抽象的，在课上不要抱着太大的学东西的想法了（起码不是专业课的学法），实验课ch更是抽象完了，但是还好她不懂，测点数据就好。考核方式是节节点名+实验+大作业。至于给分，想着拿这门课刷高分的就不用选了，想水过去的还是不错的
134530,7796,赵江萍,2021-05-27 05:58:40,0,9,9,这个老师刷新了我对于师德底线的认知，这辈子都忘不掉
134556,7796,赵江萍,2021-04-01 09:45:45,7,17,10,脾气很差，有问题也都让我们自己解决，最令人无语的老师
135995,7796,赵江萍,2021-06-08 13:09:01,8,13,5,不太行啊😓
136621,7796,赵江萍,2021-06-22 03:54:35,14,18,4,我觉得事实就是事实，赵老师虽然有那么一些负责，但是人品总归是差了那么一些，而且他的负责总让人觉得是出于对同学的同情，而不是那种真心的教学，如果有大佬想体验一下赵老师的课，我强烈建议他报选，但是如果课业负担比较大或者博雅已经有着落的，强烈建议不要选他，上他的课总归是不那么舒服。
136811,7796,赵江萍,2021-06-25 03:48:57,7,10,3,可能他在工作态度上可以称为一个好老师，但是我不喜欢他
136940,7796,赵江萍,2021-06-28 11:26:36,2,3,1,以后再也不想选这种实验课了
139877,7796,赵江萍,2021-08-07 00:00:07,5,6,1,都什么时候了，还用五级制，一正太就是2.5，满绩也只有4.5，大家别选
140635,7796,赵江萍,2021-09-14 13:46:08,2,7,5,在我看来老师只是对同学们的要求比其它的平行班高，希望同学们能够真正学到东西，并且这点他自己也说过。那些喷他师德有问题的人还是好好反思一下自己写实验报告的态度有没有问题吧！
140855,7796,赵江萍,2021-09-17 02:00:58,0,0,0,。 。
141536,7796,赵江萍,2021-10-13 12:08:07,2,5,3,强烈不建议选
145676,7796,赵江萍,2021-12-31 06:12:38,7,12,5,赵江萍我好爱
145677,7796,赵江萍,2021-12-31 06:12:51,2,6,4,很和蔼
147435,7796,赵江萍,2022-01-10 14:28:09,2,7,5,真的好老师，强烈推荐电工电子工程训练通识课。对于动手能力的提高很有帮助，结课还能拿回一个自己焊接拼接的蓝牙小音箱。没有期末考和大作业，平常的实验报告认真完成就好了啦。安利一波　∧_∧　啪啪啪啪\n\n（ ・ω・)=つ≡つ\n\n（っ ≡つ=つ\n\n`/　　)\n\n(ノΠＵ
150912,7796,赵江萍,2022-02-21 04:35:56,4,8,4,第一节课就让我很讨厌了😬态度奇差
153044,7796,赵江萍,2022-04-24 07:50:09,0,5,5,是一个很热情很耐心的老师呀\n\n有同学上课明着摆烂也很耐心的对他讲话\n\n选课之前看到这么低的评分很是担心\n\n但是上课真是惊喜到了\n\n很详细很温暖的老师！
153179,7796,赵江萍,2022-04-26 12:22:10,6,11,5,很好很耐心负责的老师
156303,7796,赵江萍,2022-06-19 07:04:57,1,6,5,真的好老师，他只是要求严格希望你水平能够真的有所提升。但是浙是三点水江也是三点水，后面还有一个“大”。。。所以一部分学生可能会因为这老师和我校校风不符而感到不快
156345,7796,赵江萍,2022-06-19 07:12:26,2,9,7,不要被评分误导了 赵老师是真的好老师！上课讲授的很仔细 自己实验遇到困难时老师也会很耐心的讲解 要求严格一点也是为了让我们真的掌握知识
156370,7796,赵江萍,2022-06-19 08:51:00,1,6,5,上课非常认真，可以说我在电工电子学上没听懂的东西在实验课上他讲的一清二楚，实验错误一眼就能看出来！赵江萍！你是我的神！
156458,7796,赵江萍,2022-06-20 00:52:49,26,31,5,臭傻逼，我室友考试，他给了我室友错误的芯片，导致他一题都没完成，然后满嘴答应给他加分，最后把他挂了
156598,7796,赵江萍,2022-06-20 11:18:46,5,9,4,这几把课也能挂人？？？？？？？？？
156635,7796,赵江萍,2022-06-20 12:43:26,1,4,3,没能力做引路人可以不当绊脚石吗😓
156724,7796,赵江萍,2022-06-20 22:07:54,4,6,2,建议预置的退了选别的老师
160208,7796,赵江萍,2022-09-15 04:17:32,2,2,0,不适合水的同学……甚至不让人水
165426,7796,赵江萍,2023-01-05 02:15:34,6,7,1,你如果追求课堂体验，那么没问题，他比较和善，但是追求绩点就算了。他实验报告给分很迷，提前根本没有说哪些要点是必须的，辛辛苦苦写半天，给分就....，当然，也是本人太没本事，无法准确把握他对于每个报告的要求。而且实验指导ppt学在浙大上的跟上课用的不完全一样，有些东西他只上课说要测量或者不要测量，实际做的时候又容易忘，很容易搞混掉，到时候又扣分，真的很脑瘫。每次交待事情不说清楚，很多东西只是让人意会，去揣摩他的意思，我服了，这是一门实验课啊，不是理论课啊。
166612,7796,赵江萍,2023-01-13 04:01:41,5,5,0,老师还不错啦，问问题回答的也挺负责的。主要电学实验课评分体系太繁琐了，而且又是五级制，所以平时压力会比较大，漏了一个视频之类的就要扣分，绝对不水，提早要有预期，多关注学在浙大。
169737,7796,赵江萍,2023-02-27 15:08:12,2,2,0,怎么说呢，赵老师讲课还是挺好的，就是课程本身的难度较高，有时候可能要想很久才能想出来怎么接电路而已。
173035,7796,赵江萍,2023-05-11 14:33:31,1,2,1,老师总体而言是比较负责的...但是要求略高，对实验操作部分讲解也不太够...
173055,7796,赵江萍,2023-05-12 05:46:56,3,4,1,实验报告总是莫名其妙扣分
177187,7796,赵江萍,2023-07-02 04:40:06,4,5,1,电院实验课就是一坨大便，关老师什么事。赵老师人还是很好的，平时多跟老师交流，得到的反馈也是很不错的。上课能认识每一个学生，我认为已经算是一个很不错的老师了。并且实验报告给分标准已经很清晰了好吧，实验数据处理是重点，老师也一直在强调。真的可以学到很多，特别是在实验报告数据分析处理的地方。
177206,7796,赵江萍,2023-07-02 07:29:04,1,1,0,讲的很仔细，给分不错
182106,7796,赵江萍,2023-11-10 03:36:30,1,2,1,电工电子工程训练这门课蛮好的，老师挺负责，挺好。
182674,7796,赵江萍,2023-11-19 10:41:22,3,4,1,通识课真的很好玩。
185925,7796,赵江萍,2024-01-06 05:22:43,1,1,0,上他的课感觉压力很大。。。
186273,7796,赵江萍,2024-01-10 09:42:15,4,4,0,绩杀慎选
193877,7796,赵江萍,2024-06-20 11:53:55,7,7,0,今年一些机缘巧合之下，我不得不补选电工电子学实验，此时只有赵老师的课我有时间上\n\n一学期下来，我的感觉就是赵老师真的是个很负责，很和蔼的老师，有什么问题不会大胆的问无论是线下还是钉钉\n\n赵老师大多时候可以做到快速回复，而且也十分耐心。\n\n老师真的挺不错的，课程设置的合理与否与老师无关
202280,7796,赵江萍,2024-11-11 07:18:32,7,7,0,这个秋学期我选了老师的电工电子学概论，感觉老师讲课很有激情，但我选这门课就是因为它属于博雅技艺，感觉干货很多，中间一两节课真的还要用智云课堂补，太硬核了，重要概念必须狠狠掌握，不然太难了，对我本人药学专业来说，我还是大一小灯，真的很难理解电路的一些概念，即使高中选过物理，因为毫无关系
202499,7796,赵江萍,2024-11-13 02:22:26,3,4,1,不想说话 3.9 慎选🌚
202835,7796,赵江萍,2024-11-14 17:17:52,12,13,1,很难评，千万不要选博雅技艺那个电工电子学概论，绩杀
202849,7796,赵江萍,2024-11-15 01:17:42,-5,5,10,电工电子学概论平常上课好好听写完作业，考试前复习一天，最后4.8。老师人挺好，有问题都积极解答。
202864,7796,赵江萍,2024-11-15 02:31:38,11,12,1,开通识课也不知道出点简单的卷子真的是无语了题目难得要死这怎么做得出来
203260,7796,赵江萍,2024-11-18 13:26:16,2,2,0,工程训练这个课其实不算水，也就没节上课认真听一下不然不知道在干啥，课下只要写一个实验报告其实没什么，总体来说不是很辛苦，毕竟是通识课。虽然只有3.9但是还是告诫后面选这门课的同学狠狠卷实验报告吧，字数越多越好，字数越多打分越高。老师人还是很好的，基本上问问题都会认真回答，通识课要想拿高分还是得下点功夫
204752,7796,赵江萍,2024-11-27 15:31:13,6,7,1,电工电子学概论，绩杀，快逃
205308,7796,赵江萍,2024-12-04 07:07:50,2,4,2,通识课电工电子学概论，建议没接触过模电数电的慎选，本人高中选了技术，也学过一点物竞，所以学起来还算轻松，最后绩点4.8，老师讲课还可以吧，至少没那么差
210530,7796,赵江萍,2025-01-09 10:04:40,0,0,0,电工电子学实验老师很有耐心，讲实验也很细致，学校规定优秀率30%一个班二十个人绝大多数同学都是良好，五级制确实恶心，但老师还是挺好的，期末实验考做的很烂最后也给了良好
218122,7796,赵江萍,2025-04-21 09:20:07,4,4,0,老师人很好啊，讲课逻辑也很清楚，节奏也慢，为什么评分这么低啊？好离谱
218237,7796,赵江萍,2025-04-22 07:06:42,1,1,0,电工电子学实验上了一半来打个分，老师上课认真，实验遇到问题问老师也是耐心解答，感觉现在的分数太低了点吧
124019,7797,季瑞松,2020-06-20 14:02:56,1,3,2,...
157110,7797,季瑞松,2022-06-22 02:57:38,1,1,0,老师挺好的，很耐心
157553,7797,季瑞松,2022-06-23 16:55:32,1,1,0,老师很好，很有耐心认真指导学生
175410,7797,季瑞松,2023-06-24 15:55:05,-1,1,2,电工电子学实验给分很好！大爱！
185885,7797,季瑞松,2024-01-05 10:59:36,0,1,1,关于硬件电路设计基础与实训，学期结束回来总结一下。这门课首先是进行一个电路板的焊接训练，然后是全过程设计一块电路板，包括从器件选型、原理图设计、PCB设计、软件设计、电路调试的全过程，最后进行一个测试报告的展示。对于电类同学来说，这门课学到的知识可以说是以后学习相当有用的铺垫；对于非电类同学来说，也是一门独特的技术。而且，两位老师都很有耐心，人很好。总之，能学到真本事，也不占用多少课外时间，建议是无脑冲。
186844,7797,季瑞松,2024-01-13 09:54:01,1,1,0,关于硬件电路设计基础与实训，等级制很不友好谢谢
187154,7797,季瑞松,2024-01-15 00:23:04,2,3,1,等级制感觉给分不是很好，课程内容有点多。求是的讲对于没有专业基础的不建议选不然全程只能靠老师捞
190621,7797,季瑞松,2024-03-12 02:43:10,1,1,0,两位老师人很好，但是硬件这门课也是真的硬，一门博雅技艺上出了通核的强度，完全没有基础的只能靠自学&老师捞捞，需要学的东西这么短时间内根本搞不定，另外等级给分制真的很不友好，除了做得很好的同学4.5，然后再往下正态一个等级只能到3.5，没有基础的同学慎选，不在意绩点的随便选，老师很耐心，外专业是真的能学到点东西的。
193136,7797,季瑞松,2024-06-04 03:18:56,1,1,0,老师非常好，有耐心，课程内容很丰富，干货很多，等级制给分不是特别友善，但是对有点C语言、嵌入式、电路、焊接技术基础的同学，积极和老师沟通，是能拿到A的
195799,7797,季瑞松,2024-06-30 03:25:45,0,1,1,硬件电路设计基础与实训，这课太硬了，总体感觉和一门工科的专业实验课差不多，下半学期课外时间去了三四次实验室才把最终成品弄好，作为一个还算有点基础的同学学起来都好累，而且最后给分还是五级制，只能说慎选
217389,7797,季瑞松,2025-04-09 11:11:32,-3,0,3,电工实验纯出
219307,7797,季瑞松,2025-05-24 13:10:31,0,0,0,信号实验，老师人很好，指导很耐心，讲解清楚，实验难度也不大\n\n体验比模电实验好多了
142219,7904,任娜,2021-11-09 02:20:27,2,7,5,研究生课点名，交思考题，叫人起来回答问题，该有的花头都有了，对了平时分30%
180276,7904,任娜,2023-09-21 02:29:56,19,20,1,上课纯读教案，板书字小得离谱，令人生疑电院到底怎么招老师的？
181107,7904,任娜,2023-10-09 01:18:00,15,17,2,西电柴长春：6
185259,7904,任娜,2023-12-27 11:38:21,-18,0,18,讲课很细致
190864,7904,任娜,2024-03-22 07:18:06,2,2,0,别上研究生器件。。。真无语。。。
190865,7904,任娜,2024-03-22 07:19:56,2,2,0,123
199037,7904,任娜,2024-09-14 08:50:03,8,8,0,抄了柴常春老师的内容，能不能再抄一下讲课方式啊
199157,7904,任娜,2024-09-18 08:41:07,13,13,0,上课内容是全盘照抄西电柴长春的，上课隔三差五就要放一堆抽象视频的，PPT都读不明白，就这样上课还有多的时间空出来让我们写作业，作业布置的也是一坨。
199416,7904,任娜,2024-09-23 07:13:16,13,13,0,1.抄柴常春，但远远不如。2.ppt。3.作业。
199557,7904,任娜,2024-09-25 10:10:40,12,12,0,你一节课能讲柴常春四五节的内容，这么快的速度是急着投胎吗
200714,7904,任娜,2024-10-21 08:19:21,21,21,0,别的课都是把研讨课的内容在开学就布置下去了，半导体物理就不同一点，第七周才来告诉我们考试周搞研讨课，要在一周内完成分组分工写完报告再上去讲
200922,7904,任娜,2024-10-25 00:14:36,8,8,0,很急哦
201352,7904,任娜,2024-11-01 04:18:45,4,7,3,重开吧，这辈子活够多了
201404,7904,任娜,2024-11-02 02:19:46,1,21,20,希望任娜家人的遗照也和考试的图一样模糊呢
201468,7904,任娜,2024-11-03 12:38:43,3,8,5,上课不点名，感觉人还不错，就是讲课纯读ppt
201555,7904,任娜,2024-11-25 14:32:07,14,16,2,上课迟到，两次，可以说是非常敷衍
201710,7904,任娜,2024-11-11 06:07:06,18,21,3,讲的太差了，试卷也是乱出的，给分也差，据说均绩2.4
201837,7904,任娜,2024-11-07 01:05:37,47,48,1,本来看上一届的均绩，以为最多上课体验差点，但是可以拿个高分，结果给分是真nm不做人啊，太烂了\n\n上课干巴巴，念PPT，授课内容是书本的删减版，经常跳过一些内容，并且对原理的解释很不清晰，导致容易听的一头雾水。前面的那些评价虽然话说的比较难听，但是其实比较忠于事实了\n\n重点非常不突出，让我们记“不太复杂的公式”，实际上考了各种乱七八糟的概念\n\n开学的时候说，认真学，很多同学能拿到高分，有些同学可以拿到满绩。实际上，个人觉得自己已经非常认真在学了，成绩还是被妖魔试卷薄纱......\n\n临近考试，才仅仅提前一周通知要做小组pre，开学的时候只字未提。在大家都要被各种实验报告埋没的时候搞这出，真的绝了，打分还有小组互评\n\n上课总共迟到两次，习题课迟到了五十分钟，并且进来之后说她认为习题课是我们学生自己复习交流的课......有人问她作业能不能给个答案，她说“大学生作业哪里还需要答案的啊”最后有同学发现助教在学在浙大推荐了满分作业，算是凑上一个答案。只能说是真无语，作业跟白做一样\n\n总的来说，感觉老师对本科生非常不重视吧，不论是上课体验还是给分，反正我个人是感觉半导体物理这门课毫无体验可言，又难受给分还巨烂\n\n前面有同学说老师怀孕了要体谅一下，我只能说，我已经尽量在体谅了，但是老师哪怕怀着孕也是真不打算积点德啊\n\n最后记录一下，开学的时候老师的评分是4.2左右，现在跌到2.7，懂的都懂
201839,7904,任娜,2024-11-07 01:01:40,2,2,0,。。。
201851,7904,任娜,2024-11-07 02:36:52,12,13,1,对老师攻击力有待加强
201861,7904,任娜,2024-11-07 04:02:00,-10,3,13,感觉讲课其实还好，就是今年可能老师怀孕了，出了一些问题，然后希望试卷能改改
201869,7904,任娜,2024-11-07 05:15:07,8,8,0,我是史学家，这就是史
201906,7904,任娜,2024-11-07 09:36:30,4,4,0,这课真的有人满绩吗
202483,7904,任娜,2024-11-13 01:48:30,10,10,0,建议直接去b站听柴长春老师的课，因为任老师纯念PPT，而且速度很快，想听懂不太可能。考前提前两周复习，8份PPT上的内容认认真真理解、记背了至少两遍，自以为复习充分，但考卷内容极其不合理，填空简答作图题题量很大，答题占据了大量时间分数却只占一半，导致最后50分的计算题时间非常赶。最后的绩点也是出乎意料的低，之前学了这么多比它难的专业课也没有拿过这么低的分数。只能安慰自己已经尽力了，考完就算了吧。
202729,7904,任娜,2024-11-14 04:42:33,8,8,0,我是真的服了，怀了还不积德，这门课从头到尾没有展现出哪怕是一个的闪光点，我丢根骨头给我家的狗上面还能带点肉呢
205372,7904,任娜,2024-12-05 07:28:48,4,4,0,电院真正的高手，可谓无一可取之处。能到此地步，亦是一种成功。
205387,7904,任娜,2024-12-05 11:31:00,3,3,0,化学er前来围观电院潘慧霖（综合一下她的表现实际上比潘慧霖的两倍还逆天）\n\n另外翻了翻半导体物理的智云\n\n首先就找到了那个名句“都大学生了，作业还要答案吗”\n\n其次她但凡把自己用来穿着打扮所花的精力的一半用来好好打磨一下这门课都不至于让这门课这么离谱
207486,7904,任娜,2024-12-22 10:17:49,0,0,0,下届的学弟学妹们有福咯
211931,7904,任娜,2025-01-13 02:03:19,0,0,0,极其优秀，我现在想到还想回来骂几句。\n\n任老师自己怀孕还来折磨我们，何其有幸啊！祝下届换老师吧
211961,7904,任娜,2025-01-13 02:56:35,0,0,0,懒得喷
216177,7904,任娜,2025-03-11 13:54:46,0,0,0,极致的傻呗
169791,7914,胡鹏飞,2023-02-28 02:09:15,7,7,0,这哥们怎么第一节课点名啊
171007,7914,胡鹏飞,2023-03-21 08:04:29,7,10,3,没有办法理解这个老师为什么可以来上电力电子技术课，我奶奶念的经都比他好听，简直就是上了一坨shit
174053,7914,胡鹏飞,2023-06-06 03:13:49,-3,2,5,太好了这个老师！
177378,7914,胡鹏飞,2023-07-03 05:35:38,0,3,3,依托答辩
177388,7914,胡鹏飞,2023-07-03 06:05:06,-1,2,3,给分好好
177389,7914,胡鹏飞,2023-07-03 06:05:08,0,2,2,给分好好
177730,7914,胡鹏飞,2023-07-04 13:29:06,7,7,0,感觉给分好差啊，是直接给的卷面分吗，很难理解
178082,7914,胡鹏飞,2023-07-06 16:39:26,1,1,0,给分离谱，比隔壁班差太多，如果大家都低分也就算了。。这样真的很不好
196614,7914,胡鹏飞,2024-07-04 08:55:04,2,2,0,胡老师可能有所改过自新了\n\n年轻老师有点忙可以理解，介绍一下他的几大特点：\n\n1、上课确实像奶奶念经，读完一遍之后还要再读一遍表示强调\n\n2、作业会批一点，但是给的都是“阅”\n\n本次期末考确实难，都是没出现过的题型，常出的触发同步什么的都没出现，后面谐振环流考了也贼难\n\n我是尽力把能写的都写上去了\n\n感觉老师确实还可以，尽力捞了\n\n实验考试不担心，主要难的应该是抽到实验一的
222091,7914,胡鹏飞,2025-06-29 15:42:43,0,0,0,还行吧
133131,7945,李焱鑫,2021-02-09 12:03:04,7,10,3,老师人很好很耐心绝对i！
136370,7945,李焱鑫,2021-06-17 04:11:17,3,5,2,老师人很好很耐心绝对i！
145128,7945,李焱鑫,2021-12-27 14:46:12,19,20,1,哈哈哈哈哈，大学第一次遇到上课叫同学认真听讲不要玩手机的老师。\n\n同学，你是不是在打王者荣耀啊，这个操作很6冒。
145379,7945,李焱鑫,2021-12-29 08:37:31,3,3,0,人耐心，很求是，讲得很好，下次不许再讲了😅
148408,7945,李焱鑫,2022-01-12 11:15:59,5,5,0,首先，感谢李老师使劲捞我，模电勉强过线。其次，他确实讲的很好，只是我自己的问题导致听不懂。谢谢李老师，模电再见！
156342,7945,李焱鑫,2022-06-19 07:02:40,6,6,0,老师真的很好 王者打的贼溜\n\n爱了爱了
161778,7945,李焱鑫,2022-11-13 04:38:16,0,1,1,选修课 点名 不捞，慎重
170668,7945,李焱鑫,2023-03-08 02:07:16,0,1,1,感觉讲课水平一般，他似乎很自信他讲的我们都会，很多就直接一句“这个你们也要会算”就过去了，他的模电自学量很大
174192,7945,李焱鑫,2023-06-07 07:31:49,0,0,0,讲的还行 点名\n\n课件不错
185935,7945,李焱鑫,2024-01-06 07:05:16,3,3,0,讲的中规中矩，课件很好，人很耐心，每年有在改进课件和备课
187012,7945,李焱鑫,2024-01-14 06:54:17,2,2,0,我期中过后模电部分听不懂摆了，期末考完第二天老师就钉钉私信捞我。感谢老师从海底捞我。
187192,7945,李焱鑫,2024-01-15 04:04:46,1,1,0,李老师太好啦
187199,7945,李焱鑫,2024-01-15 04:35:32,1,1,0,老师真的有在很用心地上课，讲课速度是比较快的。最后一节课还发了平时作业的答案帮助我们复习，人真的很好！出分很快，给分较求是，但不影响我给他10分的评价~
187216,7945,李焱鑫,2024-01-15 05:56:25,1,1,0,我靠我都能捞起来？？跪谢
203315,7945,李焱鑫,2024-11-19 05:48:39,0,0,0,很好的老师
207425,7945,李焱鑫,2025-01-14 00:36:39,0,0,0,很关心落后学生，在他的班上都不太好意思摆烂挂科
211271,7945,李焱鑫,2025-01-11 05:54:46,0,0,0,上课很认真的老师！学期末会发本学期作业答案（甚至会给你打印好），非常细致，PPT很全面。会讲亿些考试不考的东西做补充（笑）代价是经常拖堂（尤其周五）
211305,7945,李焱鑫,2025-01-11 07:21:04,0,0,0,很好的老师！期中考完之后会钉钉私信问模电部分能不能跟的上，问问题基本都是秒回，上课内容真的很充实，能学到很多东西，本人期中太差了后面模电也是一知半解，被老师海底捞了😭！跟着老师一步步走不会错的。
137378,7964,赵建勇,2021-07-03 14:54:49,13,13,0,赵老师超级和善！对学生和实验的态度都超级超级好！强烈推荐选他！（虽然也没办法不选/doge
157002,7964,赵建勇,2022-06-21 14:04:57,3,3,0,认真负责的好老师
194164,7964,赵建勇,2024-06-22 09:57:30,2,2,0,实验课老师，很棒的。讲得清楚，考得简单
196615,7964,赵建勇,2024-07-04 09:00:24,1,1,0,好老师，实验原理什么的讲的很清楚，帮忙调试很耐心，最后的实验考试也简单
197780,7964,赵建勇,2024-08-12 14:07:39,1,1,0,非常和善的老师，而且非常风趣幽默，性格非常好
216884,7964,赵建勇,2025-03-28 03:09:56,2,2,0,老师人太好了，耐心讲解实验，之前有一次大家都做好了，而我们小组搞得一塌糊涂，几乎都到老师下班时间了，老师还是耐心手把手的教我们。
135923,7980,王晓菲,2021-06-03 09:41:21,17,20,3,用两个字形容王老师那就是：天使！可能是我上大学以来遇到的最温柔，最有耐心，最体贴人的老师，毕业设计有王老师指导真的太太太太幸运了！祝王老师永远年轻！永远快乐！
138446,7980,王晓菲,2021-07-09 08:49:46,13,13,0,和蔼可亲
185921,7980,王晓菲,2024-01-06 04:48:14,3,3,0,老师人超好，很耐心温柔
193007,7980,王晓菲,2024-06-02 11:34:41,3,3,0,超级棒
194734,7980,王晓菲,2024-06-25 06:56:40,3,3,0,好老师！
198158,7980,王晓菲,2024-09-03 05:50:02,3,3,0,超级好的老师，人非常温柔善良！
200227,7980,王晓菲,2024-10-15 03:41:42,6,6,0,老师人超好
200653,7980,王晓菲,2024-10-20 14:23:48,3,3,0,菲姐人太温柔了
204130,7980,王晓菲,2024-11-24 13:57:53,3,3,0,又温柔人又好！认真为学生着想与答疑
210782,7980,王晓菲,2025-01-10 02:52:02,1,1,0,好老师！
217248,7980,王晓菲,2025-04-06 12:34:15,1,1,0,怎么会有这么温柔善良漂亮体贴的老师，王老师必须10分。
141081,7985,叶承晋,2021-09-23 03:07:58,2,6,4,听不懂听不懂听不懂
145380,7985,叶承晋,2021-12-29 08:38:37,1,1,0,老师年轻，讲得挺耐心，就是听不懂
161493,7985,叶承晋,2022-11-07 15:36:12,0,1,1,没毛病，挺不错的一个老师，友善
163865,7985,叶承晋,2022-12-16 09:39:02,2,4,2,老师人好，事少，讲的也不错
181865,7985,叶承晋,2023-11-02 16:28:43,7,8,1,讲得相当好，非常认真负责，好老师，力推！！！
182453,7985,叶承晋,2023-11-16 06:29:56,0,1,1,讲的太好了，上浙大以来认为上过课体验最好的一个老师！！！
182521,7985,叶承晋,2023-11-17 03:07:28,2,3,1,貌似是新老师，23年上的他的课，觉得讲的很好，会讲例题，作业不多，还会提前下课
187200,7985,叶承晋,2024-01-15 04:38:10,2,3,1,讲课很好，知识点很清晰，讲重点，对应试还是有很大帮助的，而且几乎每次都会提前好早下课，轻松且给分好！
199538,7985,叶承晋,2024-09-25 05:32:53,0,2,2,宝藏老师，居然没多少人，力推
200017,7985,叶承晋,2024-10-11 04:03:32,2,3,1,不点名，平时分给的高，题讲得清楚，每节课都可以提前半节课下课，真的牛逼
200650,7985,叶承晋,2024-10-20 13:52:41,2,3,1,事少分高，讲的不错，上课氛围比较轻松
204327,7985,叶承晋,2024-11-25 09:17:09,0,1,1,简洁高效不多事的好老师
204478,7985,叶承晋,2024-11-26 06:42:26,0,1,1,老师特点：摆烂不点名\n\n每次听智云真的很爽
161037,8146,夏杨红,2022-10-24 12:47:49,2,2,0,非常好的老师，对学生很认真负责
170880,8146,夏杨红,2023-03-11 08:40:14,2,2,0,对学生真的很有耐心，平易近人
175766,8146,夏杨红,2023-06-26 13:15:34,7,7,0,1. 从科研的角度，夏老师是非常负责也是有能力的本硕博指导者，有创新思维，能力强，善于且乐于指导学生。\n\n2. 从师德师风的角度，夏老师能理解学生的发展需求，积极和学生沟通，支持学生的发展理想。\n\n3. 从亦师亦友的角度，夏老师并非刻板和严肃的形象，一直和学生以平等的身份沟通，所以整个实验室的氛围都很不错。
177468,8146,夏杨红,2023-07-03 10:58:09,0,0,0,夏老师上课非常认真，能与学生能积极沟通，获益匪浅。给分也非常好！
178228,8146,夏杨红,2023-07-08 09:22:22,2,2,0,课上得认真，但是考试卷子出得很逆天，2个小时的考试，现场手推直流电机单闭环、双闭环的完整传递函数还要求稳定条件，30%的占比不至于\n\n平时分因事请假两次、大作业展示也因事请假，最后和同组的差了10分\n\n说是我期末考试也有点差，但只占比30%，所以是什么扣这么多，我想应该是平时分\n\n所以这老师的课一定不能请假，不然平时分往死里扣
159746,8167,沈远,2022-08-27 13:45:34,6,7,1,非常关心学生，军训时让我很感动。并且会认真听学生的意见，给10分！
159838,8167,沈远,2022-09-05 15:10:11,6,6,0,【q·w·q】沈指导同志超级关爱士兵们，必给11分\n\n                  敬礼！！！
159852,8167,沈远,2022-09-06 05:11:31,5,6,1,非常好的指导员，关心学生，还总让我们提前回寝休息，就算我们不遵守纪律也从来不对我们发脾气，总之10分都算少啦\n\n军训遇到他是你的幸运！
159870,8167,沈远,2022-09-07 06:03:00,6,6,0,沈远老师军训时非常和蔼，跟我们说有不舒服一定要打报告，总之遇到他真是我的福气啦，希望给分也高一点哦。
159880,8167,沈远,2022-09-07 14:13:18,-2,1,3,呃呃呃
159933,8167,沈远,2022-09-09 07:14:29,8,8,0,真的一点架子都没有，平易近人
159947,8167,沈远,2022-09-09 12:07:34,2,2,0,沈远老师人太好了，非常关心学生，10分！
159951,8167,沈远,2022-09-09 15:02:35,1,1,0,军训的时候是真的好
159954,8167,沈远,2022-09-10 02:39:11,6,6,0,沈老师真的太好啦！一直跟着队伍自己都被晒黑了hhhh最后三团四连牛逼！
160067,8167,沈远,2022-09-12 16:46:29,1,1,0,老师很好，我很喜欢
160078,8167,沈远,2022-09-13 04:23:58,0,0,0,军训 可 不会刁难
160147,8167,沈远,2022-09-14 00:48:41,1,1,0,体贴学生，很不错
160190,8167,沈远,2022-09-14 13:33:16,1,1,0,远哥~~~我的超人！！！
160293,8167,沈远,2022-09-17 06:39:36,1,1,0,没卡绩！
164090,8167,沈远,2022-12-18 02:47:00,1,1,0,十分不解释！！！大爱沈指导！！！
179272,8175,张欣,2023-09-06 07:46:45,20,24,4,简直不配称为老师，根本没有师风师德，自私自利，以迫害学生为乐，从不反思
193768,8175,张欣,2024-06-17 15:53:15,5,5,0,讲的一坨
193920,8175,张欣,2024-06-20 19:09:41,2,2,0,水平一般
193985,8175,张欣,2024-06-21 07:53:29,0,0,0,讲的不太清楚
194948,8175,张欣,2024-06-26 04:39:34,1,1,0,给分超好
197874,8175,张欣,2024-08-18 07:13:51,1,1,0,人工智能，上课很有耐心
171819,8177,夏梦,2023-04-06 12:13:44,0,0,0,夏梦师姐可爱捏 先给个10分
170747,8178,王珩宇,2023-03-09 03:50:28,4,8,4,王老师tql
190682,8178,王珩宇,2024-03-14 07:41:22,7,12,5,老师我听不懂啊…
210457,8178,王珩宇,2025-01-09 08:04:11,2,4,2,王老师太强了
218992,8178,王珩宇,2025-05-17 05:09:54,4,4,0,看到院长开课选的，但基本是王老师在上，年轻老师第五年讲课了，很认真对器件的理解也很深刻，会像学长一样很细致的回答你的问题，站在学生角度考虑，讲课前一节课讲的不清楚的地方，后面几次课还会再反复去强调，给分也很好
219570,8178,王珩宇,2025-05-30 02:04:44,1,1,0,非常好！
131127,8268,阎彦,2021-01-26 05:09:52,7,12,5,老师人很好，就是课太难了
147749,8268,阎彦,2022-01-10 16:13:04,4,5,1,电机真的好难懂 但老师都会很耐心重复好几遍（但还是听不懂orz）最后的结果就是进度太慢（于是考试少了一些内容hhh）老师人很好的 平时分基本给满 考前会划重点
160241,8268,阎彦,2022-09-15 14:43:06,3,4,1,是这样的~
161073,8268,阎彦,2022-10-25 19:10:14,6,6,0,老师很好，但是课我不明白，实验我不明白，作业我不明白，好像学了个寂寞，我真的学不明白。
161348,8268,阎彦,2022-11-04 11:08:50,6,6,0,老师很好，但可以上别的还是不要上电控了QAQ
161369,8268,阎彦,2022-11-05 08:34:50,6,6,0,老师很好 但是自动化的同学 电气控制技术基础真是一门纯初生课程
162088,8268,阎彦,2022-11-16 17:16:56,1,1,0,老师很好也很幽默就是这门课太………
162538,8268,阎彦,2022-12-09 12:51:16,4,6,2,老师人很好，给分不错，不过电气控制技术这门课是真的难
164156,8268,阎彦,2022-12-18 13:15:20,0,0,0,老师很好，就是课太难了，老师已经很努力想让我听懂了，不是老师的问题，是我的问题
171155,8268,阎彦,2023-03-17 05:21:12,2,5,3,想学知识就来阎彦老师的课，想拿高分去隔壁徐习东班。事情巨多，不但课程内容更复杂，而且比徐习东班多一个大作业，多3个实验，每次实验都要求实验报告。期末考试没有历年卷，去年的题目占比和今年完全不一样，而且完全不捞。希望后来的同学们能明确利弊，谨慎选择，要不到期末了都是泪
171203,8268,阎彦,2023-03-18 12:03:44,3,7,4,阎彦老师我的神，这都能捞起来，神，爱
171209,8268,阎彦,2023-03-18 14:48:10,-2,1,3,老师真的神中神 上课讲的好 考试海底捞
171394,8268,阎彦,2023-03-23 08:30:01,0,1,1,想过的同学会捞，想拿高分去xxd班
183244,8268,阎彦,2023-11-23 05:38:33,1,2,1,说白了，都是电路老师的锅，是这样的~
183737,8268,阎彦,2023-11-29 11:24:25,-11,3,14,整个大三上学期体验最好的课
183747,8268,阎彦,2023-11-29 13:47:45,4,5,1,老师人不错，讲课很好。但是课太难了，给分很求是，一点也不捞，想学知识的同学可以来，想拿高分的同学慎选。
203477,8268,阎彦,2024-11-19 17:40:47,13,13,0,给分也太差了点
203478,8268,阎彦,2024-11-19 19:03:20,7,7,0,给分太离谱了吧，这课事情又多有难，期末考难度感觉算是正常难度也不算很偏，也基本都写出来，怎么会只有3.6
203562,8268,阎彦,2024-11-20 04:52:28,8,8,0,虽然捞人是情分不捞是本分，但是这个成绩也太辣眼睛了吧，电气控制技术压缩了电院近15学分的专业课，极其硬核，学习过程很痛苦，最后来个大绩杀。\n\n而且看了98上的回忆卷，感觉完成的并不差，得到的成绩却远低于预期，和投入的时间与努力完全不成正比，不知道问题出在哪个环节。\n\n自动化的同学慎重乃至尽量别选这课吧，先进控制类的学分建议选后面的水课凑齐。
203706,8268,阎彦,2024-11-20 15:41:34,12,12,0,2.5学分的专业选修课，压缩了电气几个主要板块的内容，上课难度极大，实验能跟随课堂进行，可以说收获非常大，对于电气专业一些板块的核心知识都有所涉猎。但是我奇怪啊平时那么一个温和的老师最后给分给成这样？实验报告精心做，作业精心准备的课，少有的不点名我却几乎不翘课的课，最后期末只有几个填空没准备到的课，最后给了81/3.6？？？？？？；老师你在做什么？你对得起我们的努力吗？保研边缘人吐血。\n\n凡后来者，务必慎重考虑选课。对知识感兴趣可以旁听。尤其是对于需要成绩的同学。你知道一个几乎全力准备的2.5分的专业课拿到3.6是多么打击人的一件事吗？现在我知道了。保研的压力更大了。
203757,8268,阎彦,2024-11-21 02:48:45,-9,1,10,虽然被卡绩了但还是来刷个分，老师讲课很好也很认真，唯一不足的就是助教答疑已读不回，确实是自动化大三为数不多挺有收获的一门课，综合来讲给个九分吧
203846,8268,阎彦,2024-11-21 13:22:27,-8,1,9,老师答疑很认真，而且是少数会发作业答案的老师了
135087,8269,谌平平,2021-04-29 17:14:57,6,9,3,比陈宏好多了
137024,8269,谌平平,2021-07-01 12:05:13,1,2,1,很好，
137130,8269,谌平平,2021-07-01 10:46:04,4,5,1,实力很强，也比较会讲，很在意学生是不是能够真正理解知识
137574,8269,谌平平,2021-07-05 07:02:07,10,11,1,很耐心，能看出她真心希望学生能够学到更多的知识，比隔壁某恶臭老师好一万倍
138008,8269,谌平平,2021-07-07 05:02:28,1,1,0,zssrnsy
138017,8269,谌平平,2021-07-07 05:28:05,18,18,0,谌老师和陈宏那个**的争端都快影响到正常教学了，学院不管管的吗。。。
139503,8269,谌平平,2021-07-16 15:30:53,3,3,0,电创实验老师，人好的没话说
159312,8269,谌平平,2022-07-12 06:28:11,5,5,0,好老师，体谅学生
197395,8269,谌平平,2024-07-12 10:22:05,0,0,0,老师很温和可爱，很容易沟通交流，也很为学生和课程着想。
202912,8269,谌平平,2024-11-15 06:40:33,1,1,0,好老师，电子测量实验会很耐心帮助遇到困难的同学，也很鼓励同学进一步思考，很有收获
220310,8269,谌平平,2025-06-17 08:08:39,0,0,0,严厉但是耐心，真心希望学生学到本事的老师
133325,8381,王玉芬,2021-02-25 14:48:35,-3,4,7,我最爱的王老师，女神！么么哒
135544,8381,王玉芬,2021-05-13 06:38:29,6,8,2,大作业极其不合理，几乎不考虑学生感受
141212,8381,王玉芬,2021-09-26 12:24:13,2,5,3,形式主义
181353,8381,王玉芬,2023-10-15 15:13:54,5,6,1,额。。。老师是时间管理大师，总共五个论点，下课讲了两个好厉害，靠着拖堂的半个小时讲了剩下三个，牛牛牛！！！
193908,8381,王玉芬,2024-06-20 14:01:16,1,2,1,给分超好，海底捞，感谢王老师和zb姐姐
220068,8381,王玉芬,2025-06-14 12:36:33,1,1,0,形策给分那么低的意义是？？？？？？
181097,9029,兰东辰,2023-10-08 10:58:08,0,3,3,很好的老师
193753,9029,兰东辰,2024-06-17 13:35:18,0,0,0,跟光电的狄大卫老师合作很多，但是不知道为什么反而去了电院
141310,9049,陈艳姣,2021-09-29 07:47:46,17,23,6,天使姐姐，认真负责讲课清楚人美心善，不愧是清华毕业的水平，人工智能这课也是很有意思，从具体而有趣的案例出发讲各种算法，像一门能在国外的好大学听到的课。总之非常推荐选。
145142,9049,陈艳姣,2021-12-27 16:41:17,-21,8,29,rnm退钱
153705,9049,陈艳姣,2022-05-09 02:38:33,6,7,1,要最大化自己的utility哦，大赞
154065,9049,陈艳姣,2022-05-22 05:08:37,4,5,1,陈姐姐，超棒的小老师!
155045,9049,陈艳姣,2022-06-08 01:46:26,9,11,2,表白助教djy小哥哥，人很耐心，巧克力很好吃！
156166,9049,陈艳姣,2022-06-18 04:03:54,3,5,2,很热情活泼的老师，就是人工智能这门课在电院开多少有点衔接不上了，大部分都没学过ds，平时作业coding的内容很少。不过不影响老师讲课很好，考试也很正常，和平时作业差不多。
156325,9049,陈艳姣,2022-06-19 05:38:44,1,3,2,同楼下，老师人很好，课程体验佳，但是需要有ds基础，不然略吃力；\n\n\n\n要补充的一点是给分很求是，平时两次作业占40%，稍微错一些可能总评就4、5分没了
168471,9049,陈艳姣,2023-02-17 13:23:11,-18,3,21,上课有点做作 给分还行
168700,9049,陈艳姣,2023-02-21 07:35:46,2,4,2,陈老师备课很认真，上课风趣幽默，对学生很好，还是清华港科多大大神！
170661,9049,陈艳姣,2023-03-08 01:11:04,0,2,2,灰常nice
181520,9049,陈艳姣,2023-10-21 02:58:37,0,0,0,wwwww
181593,9049,陈艳姣,2023-10-24 01:05:38,2,2,0,姐姐上课很好，菜是我的问题
182360,9049,陈艳姣,2023-11-15 06:41:17,2,2,0,冲给分巨好的人工智能与安全（新开的）还有老师这么温柔，打满分
186068,9049,陈艳姣,2024-01-08 06:35:39,0,0,0,强推人工智能与安全
191049,9049,陈艳姣,2024-03-30 08:17:23,0,0,0,很温柔
193858,9049,陈艳姣,2024-06-20 09:34:40,0,0,0,www，大爱陈老师，满昏！
193862,9049,陈艳姣,2024-06-20 10:14:05,6,6,0,老师每天上课都很有精气神，很容易被感染到！每节课纸质点名，课间传点名纸。人工智能与物联网不知道为啥非得要用英文ppt，直接看ppt很难懂，但是老师讲的特别好，听完之后易如反掌。助教老师出的作业题也很有意思，最后考试一页开卷，可以带计算器，出的题型基本和作业题差不多。作业题会在课上由助教讲习题课。陈艳姣老师和两位助教老师人都很好，答疑很快。啥也不说了，咔咔选！
194110,9049,陈艳姣,2024-06-22 04:40:01,0,0,0,虽然我是废物，但老师强啊hhhh
194486,9049,陈艳姣,2024-06-24 06:21:16,1,1,0,好！都给我来选老师的人工智能与物联网！
196283,9049,陈艳姣,2024-07-02 22:34:11,2,2,0,伟大，无需多言
196911,9049,陈艳姣,2024-07-06 01:20:36,0,0,0,导师，神
197358,9049,陈艳姣,2024-07-11 11:03:06,0,0,0,确实好老师，上课非常有活力
198007,9049,陈艳姣,2024-08-23 09:20:59,0,0,0,陈老师人超级nice，还很强。。。
202063,9049,陈艳姣,2024-11-09 01:55:54,1,1,0,我的女神啊啊啊老师真的很耐心很尊重同学，水平特别高，给分也好神
202860,9049,陈艳姣,2024-11-15 02:24:43,2,2,0,人工智能与安全：一门集齐跨专业（非电气学院）、国际化、个性化三位一体的性价比极高的课程，给分也巨好，十分建议。\n\n分数占比为：点名（手写签到）30%、课程展示40%、阅读报告30%。\n\n第三周选课尘埃落定后会每节课点名。\n\n老师会给出可供选择的论文，选择感兴趣的一篇进行课程展示，一篇写读书报告，展示和报告可以是同一篇论文\n\n展示用英文，原本也应该用英语展示的，后面老师体谅学生改成了中英皆可，但PPT还是得英文。\n\n读书报告会给模板和封面。\n\n实际课程得分点和老师要讲的没太大关系，即使不听也不太会影响你的最终成绩，但对人工智能感兴趣的同学来说，陈老师水平很高，可以与之讨论相关问题。老师平常生活也很好讲话，请假一请一个准（
219167,9049,陈艳姣,2025-05-22 15:01:41,0,0,0,超可爱好看的老师，能不能结婚
219410,9049,陈艳姣,2025-05-26 16:22:09,1,1,0,坐标-人工智能与物联网\n\n老师人美心善！！这学期没有强制点名，每周一个小反馈问卷就作为考勤分了，很通情达理！\n\n关于课程学习，一开始看到英文课件，感觉是自学不友好型，结果听了智云之后发现恰恰相反！老师讲的深入浅出，举的例子也很容易听懂，属于是听过一遍课之后基本就能知道问题怎么解决了，非常适合智云2倍速自学！\n\n虽然现在还没到考试出分的时候，但先来打个10分好评~很喜欢听老师的课！（虽然是线上hhh）
219452,9049,陈艳姣,2025-05-27 15:50:15,0,0,0,老师人太好了
219976,9049,陈艳姣,2025-06-13 02:56:00,2,2,0,陈老师是非常可爱的好老师，讲课属于中规中矩，但是非常认真负责，并且AI & Lot 这门课对于我这样初学的同学来说，全英文课件和知识不太友好的关系才会听不懂，课后智云2倍速回顾总结的话学习效率还是很好的，陈老师和她的助教都非常认真严谨，为同学们着想，大家可以多和老师交流问题，老师只要有空都会和你积极交流的，没空也会抽时间回答。需要注意的是出分速度极快，当天改完当天出分@^@
220046,9049,陈艳姣,2025-06-14 05:33:26,-3,0,3,老师人很好，作业和课件都有很多很有趣的题目，考试大题部分对补天的同学还是比较友好的，前面的选择判断需要平时多积累
154881,9051,向鑫,2022-06-06 12:02:38,1,4,3,打破惨案
199616,9051,向鑫,2024-09-26 09:05:33,1,2,1,“同学们尽量不要迟到，因为会影响我的发挥”\n\n“就比如，你今年说我爱你三个字，和明年说我爱你三个字，概率是不一样的”
200037,9051,向鑫,2024-10-11 13:57:13,8,11,3,唐人一个
200039,9051,向鑫,2024-10-11 13:58:49,9,11,2,唐完了
200829,9051,向鑫,2024-10-23 05:33:26,3,7,4,讲课有点不太清楚，会反复重复一个概念，但人的性格还是不错的，比较务实而不形式主义。\n\n希望上课的班u理性评价，一味人身攻击会让查老师平台失去意义。
201361,9051,向鑫,2024-11-01 06:01:24,1,2,1,讲课比较有意思，有点幽默感
203619,9051,向鑫,2024-11-20 07:31:35,3,5,2,就问一句，电信的专业课老师，到底有几个上课不是纯朗诵ppt？为什么我到现在一个都没遇到过？半导体如是，控制理论如是，信息理论亦如是。。。为什么你们讲课能这么辣鸡？不想给本科生上课可以不上
210396,9051,向鑫,2025-01-09 05:22:34,1,2,1,好老师，上课认真
213732,9051,向鑫,2025-01-19 10:49:28,-1,0,1,111
214778,9051,向鑫,2025-02-18 01:35:03,0,1,1,老师比较有意思，讲课比较幽默
173675,9054,杨永恒,2023-06-01 01:31:35,17,21,4,ppt大王
174200,9054,杨永恒,2023-06-07 08:44:13,9,12,3,作为文转码来补电气的离散的，杨老师的离散是真的友好，讲课很清楚很耐心，作业不难，PPT也是我见过所有数学课程里最齐整且重点突出的（会把要求掌握的部分总结在每一块知识点后），今日得知考试半开卷，直接先10分送上
175001,9054,杨永恒,2023-06-21 02:21:52,1,3,2,好老师，但我以为我会了，其实没有…考试做不出还来不及TT 事实证明只做作业题是不够的朋友们…
176926,9054,杨永恒,2023-07-01 03:49:19,-1,3,4,永远的神！！！给分巨好啊啊啊啊🥺🥺🥺
176934,9054,杨永恒,2023-06-30 20:36:36,2,3,1,电院新开的离散数学，作业次数多但每次内容少，有两个疑似用来凑分数的综合作业（调研杨辉三角，对离散数学的感受），期末a4纸半开卷，考试内容较简单，一般在快下课的时候雷达点名
177270,9054,杨永恒,2023-07-02 13:08:37,0,2,2,我以为我会了 但其实并没有…考试好多不会做且时间来不及😭\n\n但还是很喜欢杨老师 他真的巨温柔巨可爱脾气超级好 像那个大白一样
177723,9054,杨永恒,2023-07-04 12:08:50,3,4,1,ppt蛮清楚的，上课也基本上就是读ppt\n\n其实课下自己看ppt也足够理解\n\n平时作业一周两次，频率比较高\n\n最后期末考试也不是很难\n\n可能是因为两次综合作业水了水，导致最后绩点不是很高
195557,9054,杨永恒,2024-06-28 17:51:47,0,1,1,讲课基本上是念PPT，但是也都能听懂，老师是好老师，是我太菜了
197350,9054,杨永恒,2024-07-11 06:56:12,13,13,0,今年离散数学判卷超级严格，题目说“写出”，评分标准却要求过程，答案正确可能也会因此扣分。
198600,9054,杨永恒,2024-09-10 07:28:23,8,8,0,绩杀 改卷标准奇怪
205124,9054,杨永恒,2024-12-02 02:40:54,5,5,0,黑化了
218266,9054,杨永恒,2025-04-22 08:59:34,2,3,1,好老师好课，ppt做的很好，平时分拉满，考试半开卷，考的也比较基础，事少分高！
218293,9054,杨永恒,2025-04-22 11:09:31,2,3,1,修跨专业的可以选这课哈哈 很友好
218315,9054,杨永恒,2025-04-22 12:55:10,1,1,0,我室友的老师黑化了，但我的老师黑化了
160805,9090,董山玲,2022-10-13 03:25:38,9,13,4,lj老师
162089,9090,董山玲,2022-11-16 17:21:43,11,13,2,老师这学期是和何老师一起上现控（因为一开始董老师的教师资格证还没下来），由于是新老师讲课enmmmm还有待加强吧，感觉也比较紧张，但出分了给分还是不错的
181766,9090,董山玲,2023-10-31 06:56:44,11,12,1,年纪轻轻就成为了一名PPT Reader.........
181965,9090,董山玲,2023-11-06 15:49:39,6,6,0,上课是一名标准的pptreader，语速极快，对于我这种人真的听不了一点。\n\n每节课都小测，刚学完就小测，简直无法理解\n\n真的这是我大学的噩梦，慎选，大学最后悔的一节课
183006,9090,董山玲,2023-11-21 11:46:51,8,9,1,你知道隔壁超勇哥哥一次都没小测吗
183253,9090,董山玲,2023-11-23 07:31:01,3,3,0,......
204396,9090,董山玲,2024-11-25 15:30:15,-5,0,5,现控出分来评价一下，dsl老师给分有一说一很好，实验作业给分相比其他班都是挺高的，老师人也很好，会耐心解答你的问题，但是也有一些缺点，就是dsl老师的课推荐自学能力强的人选，老师可能是才教过两三年的现控，讲课水平确实有限，挺多地方都讲得不太清楚，所以自学能力差的同学会很痛苦，而且老师讲课极快，课程进度到后面会比其他班快出两节课左右，我基本上都是看其他老师智云学的，课上听的很少；老师平时讲课讲完之后喜欢小测，但其实都是充当点名，只要交了就行，然后小测题都是历年的期末考题，题目都是挺不错的。不管怎么说，我觉得老师还是挺好的，起码在对学生上绝对是满分的！
170743,9144,陈淑涵,2023-03-09 03:23:34,0,1,1,cshnb
197583,9144,陈淑涵,2024-07-20 07:42:20,1,1,0,老师人很好，会请优秀的学长学姐分享最新的科研动态，给分也不错，课下也愿意讨论问题，是很nice的老师，总体还蛮推荐的
195716,9208,潘锴锴,2024-06-29 17:35:17,3,5,2,神，给我捞了一档绩点\n\n讲课也非常好
196753,9208,潘锴锴,2024-07-05 03:23:19,1,3,2,听不懂一点，还不如助教讲的
184218,9250,宋鹏,2023-12-13 08:05:17,7,7,0,老师人很好，实验帮忙调试很耐心
208538,9250,宋鹏,2024-12-29 05:57:05,1,1,0,超级耐心的老师！！！
217688,9250,宋鹏,2025-04-15 06:22:03,1,1,0,带了我三门课的神秘老师（认识实习，电机实验，微机实验），人很好很和蔼，给个10分
174715,9251,吴赞,2023-06-16 07:15:30,27,31,4,电院最好的老师，没有之一，院长挖回来的，实力又强，对学生又好，我真的哭死，翘一节课我都想把自己宰了
191231,9251,吴赞,2024-04-14 05:36:11,11,11,0,十分不解释
191277,9251,吴赞,2024-04-16 10:56:16,8,8,0,非常好的老师 不必多说 特别有耐心
194543,9251,吴赞,2024-06-24 09:53:52,4,5,1,上课和作业批改都很认真，课后问问题的时候也非常热情，期末还帮大家打印好两百多页的 ppt，神，无需多言
195173,9251,吴赞,2024-06-27 04:30:25,1,1,0,十分不解释
196240,9251,吴赞,2024-07-02 12:09:15,0,0,0,“选这个课那大家就是朋友了”
197900,9251,吴赞,2024-08-20 10:03:59,0,0,0,无敌我赞哥
201377,9251,吴赞,2024-11-01 08:45:09,4,4,0,上学期选的老师的课，学的时候很头疼，但最后竟然满绩了！还愿有点晚了。之前看査老师和98评论区一片溢美之词还以为是搞阴阳，现在来严词证明：原先的评论还是保守了，我大赞哥无敌！
202065,9251,吴赞,2024-11-09 02:29:04,0,0,0,太棒了！
171925,9252,许霁玉,2023-04-12 15:06:00,7,9,2,事情巨多，慎选，破通识每节课都有作业，中间还要做人物访谈，最后一周布置了5000字生涯报告和小组表演。
172159,9252,许霁玉,2023-04-21 02:00:00,1,1,0,别选！
172674,9252,许霁玉,2023-05-04 05:31:48,0,2,2,老师每节课之后都会布置一点作业，不过也不算多，包括有职业性格测评、个人成就分享这样的。其实做下来对我来说是蛮有效果的，会帮我更了解自己的不足和优势。但是不得不说老师的课程学习真的需要很社牛，在课堂上我一度不敢发言，常常因为组内的沉默感到尴尬，对社恐人不太友好但熬过去也就还好。大作业的话我个人认为其实还好，一个是人物访谈，一个是生涯规划书。前者的话做好组内分工就还好，每个组员都积极参与进来，发生过一点小意外但最后也努力弥补了，最后的结果虽然不算太完美但也已经是尽力而为了。生涯规划书的话老师其实没有要求字数，只是说在五千还是三千字以内就好，我貌似只写了两千差不多，对着之前的职业性格测评做了一些学习前后的对比和未来的大概想法就提交了。
173013,9252,许霁玉,2023-05-11 08:07:36,1,2,1,事情较多，给分还可以
191142,9252,许霁玉,2024-04-08 07:07:13,3,3,0,傻逼老师，每节课都点名，上课事巨多，天天互动，每节课都有丰富的作业
192136,9252,许霁玉,2024-05-10 00:59:29,0,0,0,老师每节课都讲的很认真！还会分享自己学院同学的一些职业生涯困难，讲的很生动而且很贴合我们之后可能的求职道路，给分也很好！
192145,9252,许霁玉,2024-05-10 03:21:23,0,0,0,老师讲课其实蛮不错的，事情稍微多了一点，但是简单做一做也能拿一个很不错的分数~
196776,9252,许霁玉,2024-07-05 05:41:08,0,0,0,老师很好，职规这个课任务是会多一点但是不是不能接受，给分也很好！
204843,9252,许霁玉,2024-11-28 05:58:41,0,0,0,老师还是很好的
183709,9504,曹彦飞,2023-12-02 01:49:33,13,13,0,点名很多，大作业很搞，实验很多，实验报告要求很多，讲课一般，人很负责。
185445,9504,曹彦飞,2023-12-29 11:08:40,7,9,2,老师事情很多，比其他班的要难很多，要花费特别多的时间。考试也很难，内容范围比其他老师大很多。\n\n喜欢点名，专门挑早八点名，还会雷达点名。\n\n如果是想学到知识的可以选，想水过去或者是想要高绩点的慎选。
185617,9504,曹彦飞,2024-01-07 12:05:03,8,10,2,八次试验八次报告，还有一个自主的SPI实验+报告，以及一个必做+一个选做大作业。最后实验考试内容范围很广。\n\n据我所知，隔壁班的任务量应该会小很多。\n\n希望最后的考试结果会好。
186479,9504,曹彦飞,2024-01-11 09:20:59,21,22,1,“这个我们后面还会讲到，大家了解一下就好了”
188799,9504,曹彦飞,2024-01-23 04:44:17,6,7,1,成绩不是出了吗？不是发到教务网上了吗？你们看不到啊，那我回去再让助教检查一下？
189010,9504,曹彦飞,2024-01-21 08:24:49,9,9,0,考完一年了不出分
189620,9504,曹彦飞,2024-01-26 04:00:49,-2,5,7,给分还行，算是对得起一个学期在实验上的这么多付出
189623,9504,曹彦飞,2024-01-26 04:30:03,-16,4,20,曹老师上课是按照课本来的，上课的时候讲的东西可能比较多，第一次听的时候可能抓不到重点。平时上课需要注意结合原理加代码中寄存器的配置；我到冬学期才发现这门课真正的重点是dsp各部分元件的配置（寄存器的配置）而不是c语言本身，希望明年的学弟学妹们注意。总体来说曹老师是非常认真负责的老师，今年是第一年上课可能有些不习惯，可能接下来会有所改进；老师给分很好，虽然这门课感觉东西很多，但是期末结合复习课有针对的复习，搞清楚原理和寄存器的配置，也能取得一个不错的成绩，我还是非常推荐选曹老师的课的。
190329,9504,曹彦飞,2024-02-28 05:58:04,4,4,0,点名很多，专挑下雨天点名：大作业很搞，什么设计电路图电路板，画原理图；实验很多，比隔壁班多一大坨，还难，要提前看程序，一看就是一个下午，还看不懂；实验报告要求很多。讲课一般，比较负责，很push。\n\n\n\n出分了，再来补一些。出分很慢，可能不太熟悉规矩，花了很多时间学，才88，比较不满意\n\n\n\n给学弟学妹们的建议：提前联系学长要实验课改好的例程，平时实验课互帮互助，实验考试用的例程可以问前辈要，最后考试不算难
190450,9504,曹彦飞,2024-03-04 13:10:29,5,5,0,很Push，事情很多，喜欢点名，大作业有点繁琐，最亏本是考试教的跟隔壁不一样但是学的占分跟给隔壁差很多（汇编占几十分但是CAN等就没几分），只能说选上的快逃去隔壁xxd老师的班
190520,9504,曹彦飞,2024-03-07 01:11:21,8,8,0,想拿绩点的，去xxd班。期末考试就是默写往年回忆卷，背熟了一个小时就能考完\n\n想学到知识的，也建议去xxd班。反正在两个班认真听课，都学不到啥东西\n\n更何况本班几乎搜不到回忆卷\n\n隔壁班一大半人提前好久就交卷；本班只有一两个人提前交卷，还是临近结束的时候。难度一目了然
214237,9504,曹彦飞,2025-01-30 09:46:02,7,7,0,发现作业和实验明显比xxd班多：😡\n\n听说隔壁考试简单：😡😡\n\n微机一直不出分：😡😡😡\n\n看到成绩：对不起之前说话有点大声了😋\n\n任务相比隔壁繁重应该是公认的事实，考试或许也比隔壁麻烦些。不过参考老师复习课讲的内容和有限的回忆卷还是可以取得不错的成绩，平时实验课的负责老师对小作业和实验也会很负责耐心地提供帮助。
194753,9543,杨贺雅,2024-06-25 09:09:53,2,3,1,讲课挺好的，不知道出分怎么样，出分后回来给反馈
195051,9543,杨贺雅,2024-06-26 13:55:29,6,6,0,非常认真负责的老师\n\n（姐姐好好看～捞捞我～
195439,9543,杨贺雅,2024-07-03 04:39:31,9,9,0,老师上课认真负责 助教也认真负责 出分了 比想象中的好 不擅长这方面的学习 但努力也有收获 谢谢老师和助教一学期的付出
196295,9543,杨贺雅,2024-07-03 00:21:10,9,9,0,人美心善，没有点名，小测提前通知，助教也很负责
197058,9543,杨贺雅,2024-07-07 03:57:28,1,1,0,我真的不知道老师究竟是怎么把我捞到79的，给分真的太好了，我期末啥都不会
197186,9543,杨贺雅,2024-07-09 01:06:16,4,4,0,非常好
197242,9543,杨贺雅,2024-07-09 18:30:29,2,2,0,感觉超级好
198851,9543,杨贺雅,2024-09-12 07:20:32,5,5,0,出分狠狠捞了，太好了
219429,9543,杨贺雅,2025-05-27 05:30:35,0,0,0,讲课很认真，但讲得非常一般
221898,9543,杨贺雅,2025-06-27 08:43:53,0,0,0,出分了，老师给分真的超好，大爱老师
194705,9601,于彦雪,2024-06-25 03:55:01,2,2,0,于彦雪老师是我们第三届高校电气电子工程创新大赛的负责老师，真的很负责，为学生着想。\n\n我们作品遇到了一些问题，需要修改，老师每天去跟总部的负责老师交流，催促，也很关心我们，真的很难再见到这样负责，替学生着想的老师了
206673,9618,陈烨楠,2024-12-17 04:25:11,2,5,3,好好好
217936,9838,燕磊,2025-04-18 07:17:53,1,1,0,只上了一节课来评价一下，这位更是点名之神，冲着隔壁爱点名想开个盲盒选这位，后悔。。
218226,9838,燕磊,2025-04-22 06:22:33,1,3,2,我是上一个评论，之前太闲了评论了一下，来澄清一下其实老师挺好的，点名也不扣分
218037,9846,黄莹,2025-04-19 13:13:15,-5,0,5,非常差
190491,9908,吴旭,2024-03-05 15:30:43,1,1,0,带我走吧😭
198050,9953,张晓军,2024-08-26 14:54:44,3,3,0,是很有耐心、开朗乐观的一个师兄
211511,10014,刘俊宏,2025-01-12 00:45:23,3,3,0,上了老师的电路设计，老师的ppt非常详细！上课讲解也很仔细！而且会很耐心的帮忙找电路连接中的问题！期末考试最后一道设计题我没有写完整，但老师还是给我捞到了良好，谢谢老师！（ps：我猜老师家里应该是有个小朋友，每次给我解答的时候都像在给小朋友循循善诱哈哈哈特别温柔
211522,10014,刘俊宏,2025-01-12 01:00:24,0,0,0,刘老师的电路与电子技术实验一太爱了，老师事少还非常耐心，非常温柔的老师，要是能接着开二的实验就好了
218798,10014,刘俊宏,2025-05-06 05:32:45,-1,0,1,上课一大堆废话，任务很多，讲课不清晰，上实验课非常难受
220984,10014,刘俊宏,2025-06-20 14:49:29,0,0,0,老师很耐心，任务也是选做还好（至少比隔壁zyq少），但是架不住期末考太差了就落到3.5了
217945,10229,李祖毅,2025-04-18 07:45:55,-1,0,1,Fellow无需多言，学术能力极强
197883,10240,包铭磊,2024-08-19 01:25:45,0,3,3,新老师感觉不错
216414,10248,孟萃,2025-03-16 08:49:24,7,7,0,每周小测，讲课不行，还有小组展示、小组讨论，事情很多
216723,10248,孟萃,2025-04-03 08:38:03,7,7,0,春七周，改个评价\n\n上课水平一般，喜欢一直叫人站起来回答问题直到有人回答出来为止，基本上上课是没人听的，感觉周围的人都在听lyl的智云hhh\n\n点名方式丰富多彩，一开始的几周是对着名单随便念几个人的名字点名，今天则是对着名单所有人一个个点过去\n\n事情很多，作业+小组任务+调研报告，小组任务这种其实大家都是水过去但就是会耗费你一些时间，不知道意义在哪里\n\n很喜欢讲自己的科研经历，或许老师在科研上确实水平很高吧，作为电院为数不多的专门搞电磁场方向的，我相信学校引进她是对她科研能力和成果的肯定，但是教学方面真的...一言难尽\n\n噢对了，听说作业给分貌似是按分数划分等级然后给分的，这也比较难评...\n\n总而言之，建议听lyl的智云
216791,10248,孟萃,2025-03-25 16:02:20,7,7,0,讲课水平一般，各种乱七八糟没有意义的考察方式倒是很多，喜欢一直点名直到有人回答出来。老师可能在科研领域比较有水平但是讲课的话真的很不推荐
217070,10248,孟萃,2025-04-01 06:18:29,4,4,0,很难评吧
217200,10248,孟萃,2025-04-04 02:55:04,4,4,0,古法点名拼尽全力无法战胜
219493,10248,孟萃,2025-05-28 14:44:10,3,5,2,给老师的不重样精致套装加一分
220348,10248,孟萃,2025-06-17 11:46:45,0,0,0,补天要似了
220567,10248,孟萃,2025-06-18 14:04:55,0,2,2,孟老师不太会讲课，不会强调重点，也不懂会考什么，会讲一些很偏不考的东西，应该基本是做科研的而不是教学，所以对于题目不熟悉，平时琐碎的任务有点多，固定小测，偶尔点名，除此之外没啥缺点，是性格很好的很可爱的老师，上课建议听智云课堂
220720,10248,孟萃,2025-06-19 09:50:11,3,3,0,同为“mc”，不如MineCraft
221305,10248,孟萃,2025-06-23 00:17:29,0,0,0,交大院校代码处打卡
221910,10248,孟萃,2025-06-27 11:09:48,6,6,0,讲课是一坨，ppt是一坨，给分是一坨，平时上课到理论推导是稀里糊涂的，好不容易碰到例题是喜欢一个个人下去阎王点卯的，她说小测不计分但是平时分是照扣不误的，期末考试前是出差交流的（虽然这个不怪她），问她考试内容和复习方向是一头雾水的，总而言之就是避雷避雷避雷，无论是是xsm lyl ysy都比她要好太多了。。。\n\n完全看不出她具备上本科生这种专业课的准备和能力（可能有努力但是完全不在点上）。。。最让我无语的就是她给分还特别特别求是。。。感觉我们班均绩比其他平行班低了0.6左右。。。\n\n快跑！！！
221911,10248,孟萃,2025-06-27 11:15:12,4,4,0,首先横向对比事情是四个老师里面最多的，有小组展示、小组学习、调研报告等作业，平时上课可能自己的ppt也没看懂，碰到理论证明或者讲练习题的时候就会说“就是这样那样就做出来了”，只能说说教学水平不敢恭维，平时上课还喜欢阎王点卯，就喜欢叫一堆人回答问题，一直叫到有人会为止，并且平时经常出差有事，最后几周更是人都见不到（虽然是来代课的yyy比她讲的好多了）。最后总复习的时候问她考试范围是不知道的，让我们去问其他老师的，问历年卷是不能给的，上课还总喜欢讲一些自己的研究方向，根本不知所云。\n\n如果被预制她的课，建议退掉补选，能选上lyl、ysy就最好，选不上的话xsm也比她强多了。
221919,10248,孟萃,2025-06-27 11:58:20,3,3,0,这学期上下来最煎熬的一门课，，
221921,10248,孟萃,2025-06-27 12:07:07,1,1,0,没有弃修你的工磁是我这学期做过最错误的选择，哈哈一学期白干
221923,10248,孟萃,2025-06-27 12:16:44,1,1,0,真吴迪了 斯密马赛老师 是我太菜了orz
221924,10248,孟萃,2025-06-27 12:57:00,1,1,0,给分巨差无比，事情很多，两星期测一次，每天拿着那个慕课的破题给我们做，sjb，快跑！！
221969,10248,孟萃,2025-06-28 05:50:58,1,1,0,助教哥哥是大好人\n\n至于mc么，emmmm
215866,10659,ABHISHEK KUMAR,2025-03-06 06:37:08,0,1,1,很有意思的一个印度老师，喜欢摇滚和二次元。虽然是英文授课，但是也会先爱我们听不懂的地方放低语速和用简单英语解释。（至于口音，我个人觉得完全能接受）\n\n\n\n智能电网这门课没有期末考，主要是一次个人英文展示和一次小组项目，还有会穿插几次很简单的、英语阅读级别的小测。
217571,10659,ABHISHEK KUMAR,2025-04-13 13:26:02,0,0,0,智能电网作业量巨大，慎选
