评论id,老师id,老师姓名,发表时间,点赞减去点踩数量,点赞量,点踩量,内容
7473,64,万慧进,2015-09-14 14:47:10,-2,8,10,呵呵
8587,64,万慧进,2015-09-23 01:07:40,27,30,3,挺好的，不刻板，有思想\n\n
9006,64,万慧进,2015-10-09 00:14:02,2,4,2,总觉得她说话说不清楚
9046,64,万慧进,2015-10-11 08:23:55,20,21,1,还不错的，有思想的老师
9549,64,万慧进,2015-10-30 03:24:55,-3,4,7,烦烦烦烦烦烦
10936,64,万慧进,2015-11-23 11:12:54,27,28,1,我觉得老师挺和蔼的 就是上课不让我们玩手机. 也没什么.
12143,64,万慧进,2015-12-22 04:46:25,4,6,2,挺好的很喜欢和她交流嘞
12266,64,万慧进,2015-12-22 15:42:46,40,44,4,讲起她儿子来历历在目犹如昨日
13094,64,万慧进,2015-12-25 00:54:04,9,11,2,有思想，高效率
13095,64,万慧进,2015-12-25 00:57:26,12,13,1,负责的好老师，还会秀\n\n
13296,64,万慧进,2015-12-26 09:18:10,2,4,2,万老师人很好 上课讨论棒棒哒
14374,64,万慧进,2016-01-06 14:23:13,-2,1,3,事很多
15030,64,万慧进,2016-01-21 09:01:01,7,8,1,很棒的老师
15186,64,万慧进,2016-11-13 05:50:21,-14,2,16,傻逼玩意
17941,64,万慧进,2016-01-21 04:33:48,-3,1,4,略无聊吧
17942,64,万慧进,2016-01-21 04:34:24,4,6,2,老师很有思想，虽然事情较多，不过给分确实好
17947,64,万慧进,2016-01-21 04:40:25,8,9,1,给分不错，也不红不专。
17956,64,万慧进,2016-01-21 04:47:56,2,2,0,老师很好有想法有用心
17972,64,万慧进,2016-01-21 05:02:26,3,3,0,听故事，蛮不错。老师挺和蔼的
18460,64,万慧进,2016-01-21 16:13:01,1,1,0,给分很好，上课不错
18507,64,万慧进,2016-01-22 00:48:25,3,3,0,不错，老师很好，上课需要积极发言，经常扯她儿子当教材
18850,64,万慧进,2016-01-22 15:35:46,1,1,0,老师人很好 很有自己的想法
19051,64,万慧进,2016-01-23 06:47:46,7,8,1,她儿子有很多故事
19632,64,万慧进,2016-01-25 03:35:57,2,2,0,给分真的好
19749,64,万慧进,2016-01-25 08:24:38,0,1,1,好老师 破事多 但是给分好
20199,64,万慧进,2016-01-26 13:41:33,6,7,1,我思修得了4.8，谢谢老师对我思想的教育！
21437,64,万慧进,2016-02-29 00:36:44,2,2,0,不能水手机一定要记住吖
21820,64,万慧进,2016-03-01 07:22:16,11,12,1,老师萌萌哒！作业不多，说了好多次要点名后来都作罢hhh。老师挺好的，给分也不错，不红不专挺实在的老师。蛮喜欢听她的思想的。\n\n话说没有微电影哦！这个真心好！
23143,64,万慧进,2016-03-19 14:43:05,1,1,0,给分好
34356,64,万慧进,2016-10-06 07:07:43,1,1,0,老师很好，讲了很多事，感觉自己学到了很多。
36213,64,万慧进,2016-11-11 05:49:10,3,3,0,老师一直会去关门。\n\n感觉人还好，不知道评分怎么样。\n\n不要给她看到在玩手机哈哈。
40068,64,万慧进,2016-12-29 05:05:05,0,1,1,老师有思想，有很多很多鲜活有趣的例子，打破我对思想政治这类课的死板看法，真的很棒。有些人说老师事多，我只想说这真的很轻松了好嘛。。。老师的确不让玩手机，不过上课本就不该玩手机不是吗？
40977,64,万慧进,2017-01-21 09:45:25,1,3,2,老师很可爱，上课有时候戴个毡帽。\n\n发言机会也很多，我只是平时发言比较多，小组的作业真的划水了，给了4.5，棒棒哒
44677,64,万慧进,2017-01-18 06:04:53,1,1,0,上课会分享很多她知道的事，认真听还是很有趣的，对事情有自己的看法。
44918,64,万慧进,2017-01-18 13:43:46,1,1,0,事少给分好讲的棒 还能更好吗><
44920,64,万慧进,2017-01-18 13:47:37,0,0,0,很不错啦
44971,64,万慧进,2017-01-18 16:31:32,2,2,0,老师挺好挺和蔼的啊，只要上课多发言几次，小组展示上上心，老师会看到你的努力的。给分也很好，整个小组都4+
45007,64,万慧进,2017-01-19 05:03:24,-1,2,3,给分太烂了，上课扯什么也听不懂
45021,64,万慧进,2017-01-19 00:06:36,0,1,1,上课听好多好多故事完全可以不水手机呢
45025,64,万慧进,2017-01-19 00:13:26,2,2,0,不让玩手机，事情特别少
45063,64,万慧进,2017-01-19 02:12:37,0,1,1,很不错，有思想，上课很有趣，完全不会觉着枯燥无聊。给分也不错的。事情算是很少了，不怎么麻烦的。总之推荐大家选~~
45085,64,万慧进,2017-01-19 02:58:17,0,0,0,偶尔会被老师塞狗粮，分析的例子很有意思
45196,64,万慧进,2017-01-19 06:30:39,1,1,0,作业不多真是清流，想多得分平时多发言，期末刷刷选择题库吧\n\n
45270,64,万慧进,2017-01-19 08:42:36,0,0,0,老师看出了我心中的党性
45433,64,万慧进,2017-01-19 14:19:49,0,0,0,老师上课很有趣 给分也挺好但可能是我平时分比较高吧 感觉笔试爆炸了 除了上课不让玩手机没什么其他的了 偶尔会不让你写作业 只要小组展示积极点 分不会差
46093,64,万慧进,2017-01-20 15:07:51,0,1,1,老师上课很认真，也会经常给我们讲很多故事道理，给分也很好。认真做小组展示结果一定不会差。
46362,64,万慧进,2017-01-21 10:50:57,0,1,1,老师上课有趣，给分好
47325,64,万慧进,2017-01-25 08:58:41,0,0,0,不红不专，讲的东西挺听得进去，不过这课还是挺水的，事情真心不多，给分很不错！！
48592,64,万慧进,2017-03-08 03:50:57,0,1,1,上课很无聊很水还不能玩手机...老师人挺好的我觉得还是蛮红专的啊....事情少然后给分还不错的。如果要水的话可以去...上课讲的感觉没什么营养....会走下来看你到底在做什么然后有时候全班就把其他书刷的一下放下去。
49189,64,万慧进,2017-03-29 02:26:41,0,1,1,赞赞赞
60734,64,万慧进,2017-10-29 01:24:36,-8,1,9,能再他妈五毛些吗？见过的最差的老师，没有之一……
65873,64,万慧进,2018-01-10 00:04:53,0,0,0,很能理解学生
66589,64,万慧进,2018-01-17 11:55:15,2,2,0,挺好的，不红不专挺实在的
67456,64,万慧进,2018-01-21 08:39:45,2,2,0,事情不多，给每个人重点发言的机会，想进步的可以准备，也可以偷懒。老师的评论也很有见地，赞
67459,64,万慧进,2018-01-21 08:48:35,3,3,0,真的是   全程划水   期末考前补一波选择\n\n4.5绩点   感谢老师     我还以为思修会很低   史纲还没出来不知道绩点多少  史纲我可是很努力的
67462,64,万慧进,2018-01-21 08:55:15,0,0,0,给分很好，基本上没发过言，不过小组展示有认真准备。考试的时候符合社会主义核心价值观就不会出太大问题。
67513,64,万慧进,2018-01-21 11:21:21,1,2,1,标准理工科学生表示思修居然是唯一一节我从来没睡过觉的课！！！超级吸引人！！！老师超棒的，给分爆炸好（对于一个20分大题只答了4行的人来说……真的超棒了。。）
67515,64,万慧进,2018-01-21 11:37:32,1,1,0,感觉选上就是赚到了
221807,64,万慧进,2025-06-26 11:01:32,0,0,0,最垃圾的就是这个鸟人，还配当老师？故意挂人科，也不看看自己教的是什么垃圾内容。更抽象的是，挂了科打电话给这厮，电话里怕你搞事情，说没事，你重修我的课我给你高分。结果下学期第一次课还把你赶出教室，让你选其他人的课，如此卑鄙无耻，真尼玛恶心。万hj去死吧。
2290,68,舒泽虎,2015-04-16 10:38:35,6,59,53,该老师很水，大家快选他！
5984,68,舒泽虎,2015-07-10 06:25:26,-5,12,17,很有趣的老师
6309,68,舒泽虎,2017-12-25 14:10:25,31,48,17,经常点名！乱上课！绩点奇低！千万不要选！
6319,68,舒泽虎,2015-07-13 02:55:20,77,98,21,笑面虎！依据自己的偏好主观判断！
6352,68,舒泽虎,2015-07-13 07:25:12,14,23,9,差
6450,68,舒泽虎,2015-07-14 04:24:31,24,33,9,该老师脾气奇怪，给分奇低，不要选择
9432,68,舒泽虎,2015-10-27 03:59:26,0,17,17,课很有趣
13871,68,舒泽虎,2016-01-01 10:58:25,21,29,8,千万别选\n\n
14001,68,舒泽虎,2016-01-03 14:01:26,18,27,9,老师脾气奇怪，评分都好根据自己的主观判断。乱点名，给分很差
15366,68,舒泽虎,2016-01-14 04:58:53,-2,4,6,一般
15463,68,舒泽虎,2016-01-14 13:19:13,29,38,9,呵呵哒。展示有一半都不符合他的要求，那你早说啊！坐等看最后成绩，为什么之前有人说他好的
19736,68,舒泽虎,2016-01-25 07:58:24,13,20,7,极度不负责任，分数基本靠小组组员内部决定。可以想象，组长的分数就算什么都不做会有多高，btw是给个平均分，扣你的给其他人这样。给分奇低，千万别选
20273,68,舒泽虎,2016-01-27 01:25:50,31,39,8,从未见过一个老师思想如此偏激，脾气如此古怪。\n\n批评批得莫名其妙，要求多端
23258,68,舒泽虎,2016-03-23 04:44:00,-7,12,19,老师讲课明明蛮有意思的嘛，大家能不能把给分讲课一分为二看！\n\n
23339,68,舒泽虎,2016-03-25 03:10:25,10,13,3,呵呵呵
23340,68,舒泽虎,2016-03-25 03:12:27,-4,7,11,讲的挺有趣，但思想有些偏激
23341,68,舒泽虎,2016-03-25 03:20:32,5,10,5,呵呵\n\n
23342,68,舒泽虎,2016-03-25 03:32:13,8,15,7,差劲偏激
25531,68,舒泽虎,2016-06-23 09:02:49,8,13,5,。。。
25785,68,舒泽虎,2017-03-29 01:57:13,-5,16,21,他的观点可能在某些人眼里看着偏激，尤其是没怎么学过经济学的人。但是非常客观，并非瞎说，大部分都非常有道理，并且能颠覆你的原有思考，interesting。思想性很高，不水，只能说你没听懂。工科生尤其要慎选。
27327,68,舒泽虎,2016-06-25 02:24:23,-3,3,6,反正我觉得作为毛概课的老师他还是不错的，因为他上课作业比较水=。=
30555,68,舒泽虎,2018-11-26 08:33:56,17,25,8,这老师挺煞币的 真的 别选 给分奇低 三观不正 特别偏激
30558,68,舒泽虎,2016-07-02 02:55:24,4,8,4,给分差的要死
30588,68,舒泽虎,2016-07-02 04:21:05,0,13,13,给分不能算到老师头上，毕竟平时成绩制度是一起的。上课有些油滑，讲的东西很多没凭没据的，有些胡扯。好的一面是不刻板，给了一种新思维吧
30595,68,舒泽虎,2016-07-02 04:33:38,5,9,4,给分超级差。
30608,68,舒泽虎,2016-12-21 15:02:24,5,17,12,mdzz 不想说了  中共一身黑
30660,68,舒泽虎,2016-07-02 07:07:10,4,8,4,给分奇低
30792,68,舒泽虎,2017-06-07 11:21:24,4,20,16,毛概课题组上课最有趣的老师，没有之一，好好做调研和报告，分数不低。
34337,68,舒泽虎,2016-10-04 03:21:26,8,17,9,有一次在课上宣扬一夫多妻制，真好奇经常还能来教毛概。给分全凭自己喜好，如果他不喜欢无论你做得有多好给分都奇低。  建议退课都不要选
35043,68,舒泽虎,2016-10-31 07:34:25,-1,7,8,超级能侃，不是所有观点都很好，但上课绝对不无聊。
37798,68,舒泽虎,2016-11-21 06:15:33,7,10,3,满口胡扯
39570,68,舒泽虎,2016-12-25 08:56:50,9,12,3,一学期展示下来，他对所有组的展示都不满意
40572,68,舒泽虎,2017-01-22 08:00:53,1,7,6,老师让我确信自己还是一个文科生。老师让我知道，即使过程不太好，结果也可以让人满意的。不管啦，我再也没有思政课啦。毛概课挺迷醉的，大家都要加油啊啊啊！
41119,68,舒泽虎,2018-03-14 06:01:20,1,14,13,我不是舒老师班上的，但说句良心话舒老师上课真心有意思，比其他毛概老师好太多了
41214,68,舒泽虎,2017-01-10 08:18:31,8,14,6,从未见过如此不负责任而且不讲诚信的老师，自己的错误偏认为全班都错，血的教训，
41216,68,舒泽虎,2018-11-26 08:34:04,56,70,14,xjb扯，老师自相矛盾，出尔反尔，毫无诚信可言，刚愎自用，整个学期没有一组的展示让他满意，观点偏激，全班都记得他关于小组展示的规则是2-3次，他非说是大于3次，还认为全班都记错了，QTMD什么鬼老师
41221,68,舒泽虎,2017-01-10 05:58:41,18,22,4,课程考核自搞一套，但又出尔反尔，而且自己搞不清自己的要求，传递给学生的课程要求不明确，最后自己看着办。上课风格不做评论，大家各有喜好，但是对数据的真实性在此保持怀疑。
42606,68,舒泽虎,2017-01-14 14:32:22,4,6,2,这老师就是个坑
43967,68,舒泽虎,2017-01-17 07:15:11,4,7,3,为什么会有这种老师，大男子主义
46451,68,舒泽虎,2017-01-21 15:08:16,2,5,3,苛政猛于虎\n\n
46583,68,舒泽虎,2017-01-22 03:14:13,-6,4,10,满分，给分超级好
46713,68,舒泽虎,2017-01-22 08:04:32,0,8,8,我们组有一次大课的发言被上大课的老师弄错了，没有计入成绩，老师还帮我们联系那个老师，帮我们把平时分加上去了，人挺好的啊！给分也挺好的吧！
47184,68,舒泽虎,2017-01-24 10:45:27,-2,4,6,老师可能观点有时偏激了点自我了点但平时真的很水就算展示要求高但最后整体给分也都不差 从没想过思政课能这么高分 明明是给分很好的老师哇
47261,68,舒泽虎,2017-12-29 10:17:32,5,13,8,选舒老师的课想得高分的条件(我感觉老师已经给我们充分利用了正太分布的比例):首先，每周的两节短课必须要去，老师会点名，一次不到扣总成绩3分，冬学期的第一次短课必须去，不到扣10分，迟到扣2.5分，注意是最后总成绩。那其实到最后，老师把需要正太的同学已经选出来了。发言需要注意，大于等于3次，这个很重要，少一次平时分少6分，再之后就是小组展示不要水过去，调研报告认真写(很重要)。考试三观端正写写满，那怎么着也有4了。高分，看运气，老师喜欢分会很高。那些说给分奇低的估计点名已经被扣的惨不忍睹了。
48423,68,舒泽虎,2017-03-03 05:02:05,9,12,3,到教室的时候发现他在叫组号，好像是一一核对名单吧，然后我在我们群里问是不是点名了也没人回答（作为第一个上去展示的组，组长都不站出来说话，出门讨论都聚不齐，能指望么）然后我又问周围同学，很多人也说不清楚自己来晚了。我觉得问来问去坐后排很多同学也都不知道，有点浪费时间了，所以下了课之后我去问老师是不是按组点名了，结果呢，他眼睛看着别处，先做了半天发呆状之后，转过头了看了看我，跟我来一句：“什么意思？你去问同学啊。”（绝对原话毫不夸张呵呵）woc我要是问到了还用得着问您么……直接告诉我会怎么样啊？我也是很萌比然后又说我之前没问到，现在下课了人也都走了，然后他又来一句：“我不知道，这种事情以后你问同学，不要来问我。” 服气，真是服气。我客客气气地问您，您就算不想回答，觉得我哪里错做了，作为一个老师，好言好语地指出来不行吗？？那个语气和那个眼神我也是觉得很醉。。
48709,68,舒泽虎,2017-03-10 02:00:53,4,7,3,白痴一个
48722,68,舒泽虎,2017-03-10 04:05:23,1,8,7,不管怎样  老师滔滔不绝讲两个多小时 还是很不容易的啊
48797,68,舒泽虎,2017-03-13 06:55:04,3,6,3,就凭他只凭林洙一面之词而论断污蔑林徽因，这个老师令人不喜
48856,68,舒泽虎,2017-03-15 03:02:18,-5,7,12,没选他的课，不过他给我们班讲了一次。不想为他洗白，但感觉3点多确实低了，6或7还是可以有的。他有很多新的观点，不论对错，是许多人不敢说的。缺点大概就是论据比较少，难以使人信服。关于展示就不太清楚了
48868,68,舒泽虎,2017-03-15 07:04:39,-6,4,10,讲得挺好的
48874,68,舒泽虎,2017-03-15 08:19:08,12,15,3,自己从来不说清楚还他妈自以为是说同学不认真听。问他问题从来就是一副你不知道你活该的表情，展示要求神多还自吹自擂以为自己多么有个性有人格魅力。恕我直言，这笑面虎确实有个性，但是从没有见过那个有魅力的老师会是这种个性。一句妈卖批送上！！！
48877,68,舒泽虎,2017-03-15 09:13:22,4,8,4,只能说那些说老师好的都不是他班上的，展示要求奇多而且还是展示前一节课提出来搞得我们组全部重新做，脾气古怪，看了以前学长的展示给分也低
49196,68,舒泽虎,2017-03-29 06:20:46,3,4,1,每周带你一起地域歧视?
49279,68,舒泽虎,2017-04-01 07:19:31,5,6,1,就是一个坑
49415,68,舒泽虎,2017-04-11 06:35:28,5,6,1,恐怖，强烈建议退课！
50388,68,舒泽虎,2017-05-02 14:39:35,2,3,1,谁上谁知道
50904,68,舒泽虎,2017-05-08 08:31:50,5,8,3,非WCNM四字不能泄愤
51151,68,舒泽虎,2017-06-23 00:55:50,-4,4,8,不是舒老师班的，但他眼光犀利语言幽默，听他的课真是非常有趣的体验
51170,68,舒泽虎,2017-05-22 06:38:58,13,15,2,为什么没有负分选项。。。此人为什么这么极端呢？我试着分析一下，根据他上课透露的信息，他大学很多同学颇有成就，而他本人工资不上不下，平时也就上上课，也没能像思政部其他老师那样捞到出去讲课的外快。因此颇有怀才不遇之感。据他本人透露，他女儿多次抱怨家境不如“叔叔们”(应该就是他的同学朋友们)。因此思想偏激，怨天尤人也可以理解。这种老师我在浙大颇遇到几个，再一个比较出名的就是化学系的谢玉群，我估计他要是认识舒泽虎肯定会有相见恨晚之憾。
51296,68,舒泽虎,2017-05-28 12:48:03,4,5,1,性格乖僻，喜怒无常，思想偏激，难以忍受
51949,68,舒泽虎,2017-06-29 14:11:32,3,6,3,可惜没有零分这个选项，该老师对展示的要求苛刻且奇葩，我是理解老师的良苦用心，但是他根本不结合实际。上理论课满嘴胡话瞎扯淡，讲社会进步的动力是炫富，呵呵哒，好像其他专家都是白痴。说话不留情面，自己开心去吧，记得某位毛概老师委婉说，你们这个舒老师搞得他们是不懂。不论最后给分如何，该老师给我的印象极差
52200,68,舒泽虎,2017-06-16 01:19:32,3,6,3,极其不负责任，展示没有一组让他满意，不管你展示什么，他都问，你觉得你们的展示符合我们的课程要求吗？要是你回答符合，他就问，你对我们课程的要求是怎么理解的？平常对学生的问题爱理不理，在自己班上课的时候可以干自己的事，让班级沉默一小时。
52217,68,舒泽虎,2017-06-16 03:43:14,4,4,0,真的是笑面虎。逻辑不清，经常点名。
52518,68,舒泽虎,2017-07-05 07:29:09,2,3,1,嗯，确实按他的要求来估计分数是可以的，不过老师的要求…滑稽:-D
52520,68,舒泽虎,2019-06-19 08:55:09,4,10,6,垃圾，zz
52576,68,舒泽虎,2017-06-21 07:24:31,3,5,2,忍不住来评一下吧，要是很看中这门课，认真去做每一件事(虽然确实事情和要求很多)，分数不会差的，老师也不会难为你。可能我作为理科生，没有很看重这门课，只是中规中矩地完成任务，老师的要求就有点多了。。。。。。
52581,68,舒泽虎,2017-06-23 00:55:37,-4,3,7,老师给分真的很好
52672,68,舒泽虎,2017-06-22 05:26:52,3,5,2,大学以来唯一一个这么讨厌的老师，喜怒无常，三观不正，根本不把学生当学生来看。
56205,68,舒泽虎,2017-07-03 08:55:09,0,1,1,呵呵哒
56227,68,舒泽虎,2017-07-03 09:39:40,1,2,1,看你听不听他话咯
56235,68,舒泽虎,2017-07-03 10:01:54,3,4,1,喜怒无常...但按照他的要求来给分还是可以的..
56483,68,舒泽虎,2017-07-04 01:32:06,5,5,0,思政课，上到这样算可以的，展示怼人比较厉害，但给分还不错的。可选！
56904,68,舒泽虎,2017-07-05 03:03:48,0,0,0,emmmmm.....看个人吧
57826,68,舒泽虎,2017-07-16 05:25:20,1,6,5,考核标准很客观，虽然给分严但最后还是给每个组平时分加了十分，给分并没有不客观公正。展示要求确实比较严，但给出的意见也都很好，对于我们抓住问题实质和要点也都有帮助，专题课上也是上课有意思的不多的老师之一。那些觉得老师给分不好的反省一下自己的态度吧，不认真不想学不想有收获我也没办法。也许某些人眼里 学生什么都不做还给高分的老师才是好老师。
71165,68,舒泽虎,2018-01-28 05:24:20,3,5,2,什么jb老师 点名发言都到，最后这jb分数?呵呵了，求别洗了，真是笑面虎。\n\n
71905,68,舒泽虎,2018-01-29 05:22:40,1,4,3,老师上课干货很多，听的很爽
76997,68,舒泽虎,2018-04-28 01:12:09,-2,3,5,舒老师估计看过很多野史、人物传记等。他的讲课完全颠覆了我对毛概课的认识。我个人是喜欢听一些新的观点的，至少比纯粹的讲思政那一套更能接受一些。\n\n而且感觉他蛮和蔼的。\n\n\n\n
78888,68,舒泽虎,2018-05-16 08:06:59,-1,5,6,小胖虎 真可爱
79373,68,舒泽虎,2018-06-01 06:05:08,4,7,3,垃圾老师 要求贼多，天天说什么具体具体，觉得全面就是不具体，很少骂人，但这个人我必须送上一句煞笔尊敬一下。
79427,68,舒泽虎,2018-06-04 10:16:10,4,5,1,我就静静看啥时候分数能趋近于1
80448,68,舒泽虎,2018-06-26 14:36:17,3,4,1,我年轻的长得可帅了，好多小姑娘追我来着就是现在发福了
80449,68,舒泽虎,2018-06-26 14:44:12,8,10,2,还没出分，先评一分\n\n对于自己的观点极为自信，上课全程瞎逼逼\n\n“我年轻时可帅了，好多女孩子追我…”\n\n“我考试一直都考的特别好，好的不能再好的那种…”\n\n“我的字写也是很好看的…”\n\n展示要求奇多…调研报告也很迷…\n\n
80907,68,舒泽虎,2018-07-02 14:48:10,3,4,1,三观极不正，他的观点感觉都是建立在什么中华小故事，世界小故事汇编上的。\n\nPS我把你卖了你还是得给我数钱，不然你就辜负了我的善良
82775,68,舒泽虎,2018-07-09 06:01:12,3,4,1,请他自生自灭吧
82779,68,舒泽虎,2018-07-09 06:51:35,5,9,4,说这个老师知识面广的同学，你读过书吗？就他一张嘴，就证明了夏朝不存在，解决了史学界百年争端。然后瞎扯什么美洲以前之所以落后，是因为形状是长的?你告诉他哪里有一点文化素养了?他中文系出身简直是侮辱了中文系，完完全全的盲流。拿分，全靠恶竞吧。
82785,68,舒泽虎,2018-07-09 06:32:07,-2,0,2,一般般吧，有理无据，空口无凭的道理。迟到了或者什么的没有挽回的空间，不过上课想干啥都行，三次点名都要去，否则扣分很严重。
82786,68,舒泽虎,2018-07-09 06:33:19,-4,3,7,老师知识面很广的，会听到很多新奇的分析角度，然后老师是中文系的，所以对展示和调研报告的要求很语文。选的人少吧可能，所以老师给分超好，平时分给的很高，然后小组内自己按组员贡献正态分配的
82819,68,舒泽虎,2018-07-09 07:32:14,2,5,3,客观给6分，事情少（一次调研带报告和展示，外加一次展示，4次课堂讨论，都是小组一起做的，想问下楼下为什么觉得多？），课讲的好不好不知道（因为没听）但是油腔滑调的不无趣，（私以为本学期大课里小潘讲的最无趣还不让用电脑），毛概的考分也只能靠自己了和老师没什么关系，平时分已经尽量给了，出分均绩也比别的班高。
83424,68,舒泽虎,2018-07-10 09:04:06,0,3,3,分数还是不错的！平时分能体现出平时努力这个必须要赞一个！不过考试之类的就随缘了
86719,68,舒泽虎,2018-09-18 06:10:53,3,4,1,垃圾般的感受
87689,68,舒泽虎,2018-10-10 05:21:56,6,9,3,原地爆炸谢谢，要求超级高，居然连课也不来上了。邮箱不回，手机是空号。
87691,68,舒泽虎,2018-10-10 05:50:33,7,9,2,不说内容  面对这样的嗓音  我选择死亡
87898,68,舒泽虎,2018-10-17 07:03:45,1,2,1,蛮有意思的
87901,68,舒泽虎,2018-10-17 07:33:50,-1,1,2,差劲，不知道哪句真哪句假
88345,68,舒泽虎,2018-10-29 06:12:15,0,1,1,可以的
89897,68,舒泽虎,2018-11-21 07:32:29,-1,0,1,不好，人品啊。。。
93035,68,舒泽虎,2019-01-07 05:17:47,-6,3,9,舒泽虎就是个垃圾，从没见过这么出尔反尔的老师
93741,68,舒泽虎,2019-01-12 13:47:47,8,12,4,展示分出来了，先过来打10分，7组里3组上了90，最高95，平均分89.57，听老师说期末还会有额外的小组奖励分可以加。现在展示不怼人，就静静听完整个展示，整个学期就冬学期第一周点一次名，声音不好听是真的，但是至少不无趣。感觉好多评论是有人故意刷出来的，比如11月的几个高赞评论，老师明明一开始都说了是4次，自始至终也没变过，也不知道是谁想要故意搞舒老师。想要高分推荐舒老师，不管他以前怎样，2019年秋冬的舒老师值10分。
95327,68,舒泽虎,2019-01-19 08:17:13,-1,3,4,刚刚考完，这是我目前遇到的，也相信是我这一辈子遇到的最垃圾最垃圾的老师。垃圾，呸！
96300,68,舒泽虎,2019-01-20 17:13:21,6,9,3,我觉得查老师的评论时间可能有问题，我不理解为什么19年秋冬学期还有人给舒老师不好的评价，如果有，那这些老哥可能有点欠了。说真的，19年秋冬学期的舒老师没啥黑点反正就是水，作为一个毛概课我只能说上得很舒服，无论讲课还是展示给分。
97500,68,舒泽虎,2019-01-22 09:32:09,9,12,3,舒老师还好是还好，就是说话有点不算数啊，说好今天出分的。。。
98155,68,舒泽虎,2019-01-23 06:31:13,3,3,0,咕咕咕咕咕
99236,68,舒泽虎,2019-01-24 13:12:48,1,2,1,有点过分了
99495,68,舒泽虎,2019-01-25 01:10:10,3,5,2,老师这学期还算不错吧。\n\n给分比较好，任务也比较水。\n\n最重要的是上课讲的还算有趣。
99504,68,舒泽虎,2019-01-25 01:32:11,4,6,2,19年秋冬学期还可以的 真的 给分出来了也不错 大家真的不要着急退课 事情也是真的不多 要用发展的眼光看问题呀
99510,68,舒泽虎,2019-01-25 01:43:48,3,4,1,事情少比较水，但是卡绩不调有点难受..
100336,68,舒泽虎,2019-01-26 03:14:30,3,5,2,五分给上课很水，平时91，考试你要抱着虽然都复习了也写满了但是给分还是3.6的觉悟。
100937,68,舒泽虎,2019-01-27 07:04:01,-69,2,71,9分 扣一分是因为期末总评94分不调
101291,68,舒泽虎,2019-01-28 03:27:43,-4,1,5,舒老师讲课真的好！认真听课，有收获的！
101911,68,舒泽虎,2019-01-29 15:37:36,2,4,2,我觉得某些人不能因为自己的分高就无脑吹，这里我想说舒老师你如果没有能力完成就不要轻易许诺，不管是平时分出分还是总评分出分的时间都比你承诺的要晚，我觉得这就是一个不好的地方。
102471,68,舒泽虎,2019-02-03 06:02:08,2,5,3,\n\n（不高不低客观良心评价）老师这学期很水，只有两次小组展示。要求不多感觉很佛系。 老师比较随意很受主观喜好影响，虽然这学期克制了很多。 还有就是出分比许诺的晚了。（也没晚多久，可以接受的）（其他确实没什么黑点了，你还想老师给你表演上天吗？）想拿高分小组展示好好做。大课多发言。   A组给分很高，90+一大把，（羡慕脸）抱个大腿组吧。\n\n
104432,68,舒泽虎,2019-03-20 08:59:22,0,2,2,服了 同学做个展示连标题里有副标题都要diss\n\n他咋这么牛逼呢
104620,68,舒泽虎,2019-03-25 07:52:15,1,1,0,我是隔壁班的，舒老师上大课（在这里只评价大课）。\n\n老师是读经济的，在解说红专的政策时都能很具体地举出事例，讲得也很好大课气氛也很好。\n\n但是老师的讨论题是提前准备不了的！
108028,68,舒泽虎,2019-05-13 07:28:22,0,3,3,垃圾人
108371,68,舒泽虎,2019-05-22 06:11:34,0,2,2,单纯听老师讲的大课还蛮有意思的，不念PPT，拓展得很宽。
109707,68,舒泽虎,2019-06-18 15:11:08,-1,3,4,不明白为什么分那么低？挺不错的一个老师啊 最后一节课点名 没来的人都没记 说只是想认识一下同学
109796,68,舒泽虎,2019-06-19 08:49:49,27,35,8,打扰了，我不知道是老师痛改前非了还是怎么的，我只能说现在给分超级高，当然你需要每样任务都完成，前面说任务多的，我了解过，每个班都一样多，说点名的，我从来没见他点过名。反正我上他的了觉得很轻松。2019年春夏学期留，在我这个时间点之前的就不用和我杠了，我只相信我自己看到的，最后，前面还有一条评论说给分全靠组内随意分配，然后用这个理由喷，我只能说这样的评论都有人点上？哪个班不是组内随意分配？跟风黑真的过分。言尽于此。
111648,68,舒泽虎,2019-07-02 10:11:44,1,1,0,出分了吗
113516,68,舒泽虎,2019-07-06 22:16:06,-2,3,5,理想中的思政老师
113744,68,舒泽虎,2019-07-07 07:19:06,-2,7,9,别信他的话，狗改不了吃屎
114256,68,舒泽虎,2019-07-09 11:23:55,-1,5,6,垃圾。
120917,68,舒泽虎,2020-01-18 17:46:35,5,15,10,拿了4.8开心，舒老师人很好，问他问题都很耐心。讲课很有趣，给分也是在满足正态规定的前提下尽可能多给分，事情也少，就点过一次名，考前还会教授考试技巧和要点，难以想象为什么以前评价这么差？
123250,68,舒泽虎,2020-05-26 06:24:29,-5,3,8,上课奇差无比，作业瞎xx乱布置
124572,68,舒泽虎,2020-07-03 06:09:31,-12,7,19,事少，可以水，给分差\n\n平时分90+，组长，考试有好好复习+答题，最终成绩83，要被气死了
125753,68,舒泽虎,2020-09-14 03:06:46,6,9,3,老师人真的挺好的，事少给分正常
132228,68,舒泽虎,2021-01-31 06:43:10,-1,1,2,咋还没出分。。。
133562,68,舒泽虎,2021-03-02 07:04:47,-6,3,9,"不吹不黑，老师讲课还是可以的，还比较有趣，一节课下来能不间断地讲很久。但是一学期下来真的理解了楼上的""笑面虎""是什么意思:表面上跟你十分的客气，平常钉钉发消息跟同学都用的是敬语，但是实则冷漠，对同学提出的问题没有耐心。学期累计发言次数是班上最多的，最后小组平时分也只是平均数而已，可见老师根本没有按照开学初的评分标准来，武断专行好物章法可言"
133704,68,舒泽虎,2021-03-04 04:15:11,10,10,0,前面的同学说到小组发言最多，但是老师说了取四次成绩，实际上发言多也不能提高成绩，只是保证了你们组取成绩的四次是最好的四次。
138601,68,舒泽虎,2021-07-10 02:53:50,-2,2,4,挺好的老师
139046,68,舒泽虎,2021-07-12 09:13:05,-5,0,5,课还可以啊，努力一点，不要划水，给分会很好
139076,68,舒泽虎,2021-07-12 15:50:08,5,7,2,老师给我多少分，我给老师多少分😄
139691,68,舒泽虎,2021-07-20 04:45:27,-3,3,6,十分！舒老师讲课很有意思，思辨很强，有内涵有深度，听来如沐春风，只要认真，不用担心期末成绩。（以前的风评不用看了，误导性太强，老师现在很好的）
140053,68,舒泽虎,2021-08-24 07:48:09,-1,3,4,已经改了很多很多了，考前好好看书，调研报告好好做，给分不会差的
141225,68,舒泽虎,2021-09-27 01:12:45,1,2,1,懂哥一个
143380,68,舒泽虎,2021-11-24 13:16:54,-1,3,4,不管怎么说吧，改过自新就是好老师
143874,68,舒泽虎,2021-12-10 01:59:06,5,7,2,真是笑面虎，平时都用敬语，对学生提的问题却不予理睬
144712,68,舒泽虎,2021-12-23 09:05:28,1,5,4,绩杀一个
146904,68,舒泽虎,2022-01-08 03:31:49,1,3,2,跑跑跑
147625,68,舒泽虎,2022-01-10 10:29:20,22,42,20,舒泽虎老师现在到底咋样昂。觉得好赞一下觉得菜踩一下吧|･ω･｀)
149869,68,舒泽虎,2022-01-17 11:20:09,13,15,2,已经改过自新，不卷，而且给分还行
149929,68,舒泽虎,2022-01-18 00:42:22,8,11,3,哈哈，分数一出学期绩点直掉0.15，主修绩点掉0.03，思政课算主修是什么离谱规定
150447,68,舒泽虎,2022-01-25 11:28:20,6,8,2,老师还不错主要看期末，期末考试备考的时候好好把与习有关的重点章节都背下来分数就会不错
152639,68,舒泽虎,2022-04-17 02:48:56,-2,0,2,。。。
153185,68,舒泽虎,2022-04-26 12:40:45,0,2,2,最低就1分
157751,68,舒泽虎,2022-06-24 15:59:15,5,9,4,老师真的已经改过自新了，虽然毛概分出的慢但其实是在捞人，平时分88的被捞到4.8，虽然可能是我期末考比较好。发言的话是按照顺序的，不卷。老师比较鼓励调研展示的时候，有新意有创意，比如拍摄啥的，但是如果就普通的调研ppt展示，也没关系，老师只是想锻炼我们（不想我们太死板），选！
157962,68,舒泽虎,2022-06-25 23:06:56,3,5,2,虎虎yyds
158375,68,舒泽虎,2022-06-29 00:47:33,7,11,4,虎虎yysd！！上了老师的毛概和习概，给分都很好，完全不卷，快选！
160018,68,舒泽虎,2022-09-12 01:09:08,2,2,0,给分比其他老师低一档
160058,68,舒泽虎,2022-09-13 03:43:07,-3,0,3,嘿嘿嘿
166814,68,舒泽虎,2023-01-13 16:37:48,10,12,2,经典笑面虎，快逃。出分慢又不捞人。课堂展示体验奇差。
167415,68,舒泽虎,2023-01-16 06:54:05,8,8,0,给分很求是，出分很慢，慎选！
167416,68,舒泽虎,2023-01-16 06:56:01,6,6,0,给分依托答辩
167422,68,舒泽虎,2023-01-16 07:19:13,9,10,1,有一说一 事确实不多 但真的不调分 秋冬这次考的这么细 卷面分都比较低 拖了十天左右出了个没调过的分 成功吃鸡毛概出分 还是别信什么改过自新吧 思政的课还是选个好老师最重要 不然干了一堆恶心的活还要被分数恶心
167432,68,舒泽虎,2023-01-16 08:29:28,-7,2,9,毛概：\n\n1.考核内容：三次点名，两次展示，一份调研报告，期末闭卷考试。\n\n2.给分：比我预期高一点，卷子太难答得比较差，估计没调分，平时分97，总评89。
167456,68,舒泽虎,2023-01-29 05:43:20,7,7,0,思政课都得都懂，给分玄学，很大程度看老师，很不幸预置了szh的班，辛苦一学期，分数比另一个老师班摆烂一学期的室友还低，快逃吧
167482,68,舒泽虎,2023-01-16 14:42:01,2,2,0,给分不能说很差，只能说没捞\n\n主要是出分太慢
167519,68,舒泽虎,2023-01-17 03:04:08,6,6,0,毛概快跑
167525,68,舒泽虎,2023-01-17 04:06:39,3,3,0,垃圾老师，出分慢不捞
169590,68,舒泽虎,2023-02-27 04:36:11,-8,0,8,给分挺好的
170951,68,舒泽虎,2023-03-13 07:18:29,3,17,14,啊？女权主义是吃饱了撑的？？？？male别太离谱😅😅😅
171052,68,舒泽虎,2023-03-15 05:29:04,5,5,0,真有你的
172951,68,舒泽虎,2023-05-10 10:04:22,2,2,0,非常不负责任的老师，上课随意，讨论课就干坐着，钉钉完全不看消息。遇到问题在和老师说明情况之后又会摆出一副无可奈何的样子扬言自己的那什么破原则。
173975,68,舒泽虎,2023-06-05 10:27:23,1,1,0,答辩老师
174348,68,舒泽虎,2023-06-10 08:10:25,4,4,0,私信已读不回，在群里问问题也已读不回。在第一节课布置完作业具体要求也不讲清楚，第七周才说大作业的要求和毛概一样。那么毛概的要求是什么，让没有选毛概的同学情何以堪？
175358,68,舒泽虎,2023-06-24 07:41:54,2,2,0,依托答辩，平时分给的好低，还额外多加一个个人作业，作业要求不清不楚，钉钉消息永远不回
177173,68,舒泽虎,2023-07-02 03:45:08,1,1,0,给分一般。
177996,68,舒泽虎,2023-07-06 05:30:17,1,1,0,只能说和组内其他老师相比，很不推荐
177998,68,舒泽虎,2023-07-06 05:43:20,1,1,0,上的老师的毛概课，毛概事情确实多，老师喜欢脱稿、切入点小的展示，一学期小组至少发言五次。会不定期点名，且不接受钉钉请假(哭 切实地讲，老师在中国历史上很有见地，认真听颇有收获。不过出分确实慢了点，27号考试今天出的分哈哈哈哈哈哈。但我个人觉得，认真听清楚要求并照做，发言次数达到，点名基本不缺席(老师期末给了一次补请假的机会，把平时分抓住，分数总体其实还行哈哈哈哈哈哈
178484,68,舒泽虎,2023-07-12 10:22:49,4,4,0,每次讨论课都点名，可以接受。处分慢给分差，可以接受。和其他老师相比，要求更多（会特地长篇大论要求你演讲脱稿，，反反复复地强调自己的各种要求），可以接受。但是捏m的你的要求敢不敢直接点，做个大作业要求东要求西，钉钉问你你还要跟个谜语人一样，“要求创新”“这个形式不太好”然后又回到你那形式要求上。最后懂了，你就要个形式，不要思考，不要创新，大家背点空话就好啦。真的是，泰酷辣！
179872,68,舒泽虎,2023-09-20 02:31:11,5,6,1,真的别听那些说什么改良的，别信！这学期秋学期第二周上课就要求交小组调研报告进行展示。他有没有考虑过有些人低定来的第二周才能开始上课，结果一上课就要交调研，而且调研25分？？？\n\n快跑快跑，低定也快跑！除非你想要秋学期第二周和冬学期第一周就交小组调研，上课缺席1次扣5分，迟到扣2分，然后钉钉请假也一概不理。\n\n这个真不叫改过自新，真的，要求搞成这样非人性化的我在zju真的第一次见。快跑！
180745,68,舒泽虎,2023-09-25 15:08:56,14,14,0,这个老师比较严格。几乎每节课都有课堂讨论，每组还要抽代表作汇报，比较忙的一节课，水不得，逃不得。作汇报要打分，脱稿才能评上ab，相当严格了。至少目前是这样的。我给他打1分，因为他今天没有拖堂
188878,68,舒泽虎,2024-01-20 11:02:04,-6,5,11,这老师应该是痛改前非了，我承认之前对他声音大了点。虽然被卡绩了，但是比我预想中的要好。平时只是按部就班的完成了指定的任务，最后也有一个正常的成绩。对于我来说真的很满意了
189153,68,舒泽虎,2024-01-22 07:52:52,9,9,0,打卡上班
190136,68,舒泽虎,2024-02-23 13:32:35,-3,5,8,事少分高
193001,68,舒泽虎,2024-06-02 08:50:28,1,1,0,老师给分有点低，人挺慈祥的
196322,68,舒泽虎,2024-07-03 01:31:21,-2,2,4,事少分高。老师超级好！！！
197343,68,舒泽虎,2024-07-11 05:37:08,3,3,0,23年秋冬习概，给分感觉还是很不错的，然后确实有些比较有“个性”的规矩，如不接受钉钉请假（需要期末拿证明销掉缺勤记录，但是印象中就点了一两次名），课前展示需要脱稿、不然评分会很低等等，总之不在乎这些的话可以放心选
199115,68,舒泽虎,2024-09-18 02:07:44,4,6,2,别选……
199119,68,舒泽虎,2024-09-18 02:30:33,12,15,3,搞不懂展示课硬要求脱稿是什么操作，不脱稿给你评分变低，感觉和个土皇帝一样，独裁全凭他自己心情
199122,68,舒泽虎,2024-09-18 02:37:26,5,7,2,感觉不如玩原神
199288,68,舒泽虎,2024-09-20 11:56:52,0,2,2,快跑
205599,68,舒泽虎,2024-12-10 03:50:50,2,3,1,快跑。。
212915,68,舒泽虎,2025-01-15 09:00:27,1,2,1,不错的
222092,68,舒泽虎,2025-06-29 15:45:29,0,0,0,不喜欢老师的风格
5652,92,张永华,2015-07-09 03:38:59,-9,13,22,喜欢！！！
5949,92,张永华,2015-07-10 03:27:23,-6,10,16,老师不错，给分低
6125,92,张永华,2015-07-11 05:09:21,16,25,9,给分低
9277,92,张永华,2015-10-20 01:42:52,-7,8,15,感觉还不错
9370,92,张永华,2015-10-25 10:37:28,14,19,5,泪目，～
10279,92,张永华,2015-11-18 01:23:59,25,40,15,给分超级差 在所有行策老师中给分最差 差评
22855,92,张永华,2016-07-06 12:54:06,17,30,13,我虽然只是听说老师把绩点3以上的同学提了分，但至少我身边的同学都没逃出这个规律。我也不希望浙大会有这种老师，但事实就是事实，没到3的都没调分。你给分低可以，甚至在同学的抱怨中你能坚持自己的给分原则，我敬你。但是你现在这么做，我看不起你。至少作为一个老师，你没资格，你不配。
28834,92,张永华,2016-06-28 17:33:49,-8,12,20,喜欢这个老师  虽然形策老师都是瞎逼逼  然而我就是觉得他很有魅力
29252,92,张永华,2016-06-29 13:43:00,12,23,11,辣鸡老师，就知道瞎逼逼，给分超级低！
29253,92,张永华,2016-06-29 13:41:58,11,16,5,能不选他就别选了
29255,92,张永华,2016-06-29 15:00:24,13,18,5,给分差
29257,92,张永华,2016-06-29 14:03:14,11,21,10,辣鸡老师，大绩杀
29262,92,张永华,2016-06-30 11:19:39,16,26,10,辣鸡老师
29265,92,张永华,2016-06-29 13:53:23,18,29,11,全背出来了，78分，你咋不上天？
29266,92,张永华,2016-06-30 13:58:51,22,29,7,调了分
29278,92,张永华,2016-06-29 14:07:45,13,19,6,给分低，经常让助教来上课\n\n
29281,92,张永华,2016-06-29 14:11:48,11,19,8,腊鸡老师，瞎给分，瞎逼逼。毁我青春，坏我前程。
29288,92,张永华,2016-07-05 16:17:24,7,16,9,不是很懂，说分数核错了，你们说是助教给分，那么为什么只有上三的被调了？难道只有上三的核分出现失误？这未免太巧了吧？虽然本人是双周班的后来分数也被调高但是对于这种现象仍然不是很理解，如果我们当初不在群里发牢骚，成绩是不是就这样不变了？你们说不是老师给分，那老师就一点责任都没有了吗？难道助教给分就不需要经过他的审核吗？可能双周班有的同学话语的确有些偏激但是单周班你们既然没有扯进这个事情里就别在那站着说话不腰疼，这件事情放在你们身上你们也未必能很淡然吧，老师的确不错可是给分坑也是事实，只是希望下一届看清楚这些，没有了.
29297,92,张永华,2016-06-30 07:34:23,11,17,6,垃圾，3以上的都提一两档，3以下就随便了，md师德呢，给分那么随便
29307,92,张永华,2016-10-23 07:56:43,11,18,7,神经病
29318,92,张永华,2016-06-29 15:05:58,30,40,10,给大家讲个鬼故事，我形策老师张永华
29348,92,张永华,2016-06-30 14:32:35,12,24,12,老师讲得挺好的，平时只有一次作业，每堂课都要签到，绩点就看你期末考了
29364,92,张永华,2016-06-29 15:45:10,5,14,9,垃圾老师浪费我时间背形策 真的别选他 给分不要太差 垃圾老师毁我时间
29371,92,张永华,2016-06-29 15:50:17,-6,10,16,讲课很有深度，赞
29375,92,张永华,2016-06-29 15:53:43,-8,11,19,为什么都说给分低 明明我们班很多上4的 个人觉得他给分还是合理的 虽然我只有3.3（我好多都没背出…只能怪自己…）
29376,92,张永华,2016-06-29 15:53:54,13,19,6,给分低到爆炸
29380,92,张永华,2016-06-29 16:00:22,12,19,7,妈的，死老师，千万别选
29387,92,张永华,2016-07-01 10:34:56,21,26,5,同学普遍反应给分太低，助教就说分给错了，然后就把绩点3以上的都调高了一档，3以下的呢？？自生自灭？？？没见过这么随便的给分！！！没见过这么乱来的助教！！！
29396,92,张永华,2016-06-30 05:36:28,-5,13,18,给分两个班有差异是不是跟批卷的助教有关？虽然后来调分了但感觉不应该……老师讲的挺好的
29399,92,张永华,2016-06-29 16:27:17,-6,11,17,给分至少给我比较好！
29425,92,张永华,2016-06-29 18:44:52,6,12,6,绩点低到可怕，不幸是他的课的同学赶紧退课。
29437,92,张永华,2016-06-29 23:16:43,17,23,6,要传纸质表签到。给分目瞪口呆。为什么全部都背出来了仍然这么低？只有3？我还是文科生
29448,92,张永华,2016-06-30 00:03:40,8,14,6,给分太特么坑了，各种背也白费，平时根本就没设计什么考核，根本不给得高分机会。
29450,92,张永华,2016-06-30 00:10:54,13,15,2,没有作业，给分低，单周班亲儿子，双周班捡来的。\n\n我也是气话，大家不要太在意
29473,92,张永华,2016-06-30 00:36:02,6,11,5,平时成绩不知道怎么计算的，除了签到还有一个作业，很不透明。老师总让助教来上课，最后复习了很久，分数还是很低，很伤心。
29474,92,张永华,2016-06-30 00:37:45,2,9,7,额，给分是有点低，不知道为什么。但是老师的素质和情怀绝对不差，可能平时比较忙吧
29477,92,张永华,2016-06-30 00:48:51,-9,12,21,张老师讲得很好啊，就算真是给分不好，也不能忽略他讲得好的事实啊！哦，老师给分低就被骂，给分好的话不管讲得好不好都受欢迎，理智点行吗？给分再低的老师，分数也是基本符合正太的，班上总有人是高分的，你要是真的优秀，照样拿高分。
29480,92,张永华,2016-06-30 00:51:44,3,13,10,怎么 你得了高分就说明你认真复习了？我们就没认真复习？如果自己真的没有努力得了低分也没有人觉得这么委屈这么有底气地给老师差评吧 之前我一直觉得老师上课讲得不错 但是给分…真的，我不信我答卷答得比那些所谓的认真复习了的人答得差…一个人两个人倒还说得过去 这么多人都这么低不说明点问题？呵呵 就你认真复习了是吧  我们背了课也上了 分数低 就否定了我们所有的努力？就你认真复习了 呵呵
29485,92,张永华,2016-06-30 05:52:30,-5,5,10,知错能改，善莫大焉
29643,92,张永华,2016-06-30 06:01:04,6,9,3,呵呵哒，60分，怎么不直接让我挂了呢？这是逼我退学么
29703,92,张永华,2016-06-30 08:09:11,-4,8,12,单周班的表示不是很懂什么情况……给分挺好啊 难道是助教不一样？？
29768,92,张永华,2016-06-30 09:52:34,0,7,7,大绩杀！一个一学分还上了一整年的行策课给分还这么低是干毛啊！每节课都去，期末也背了，每道题写的跟小论文似的你给我70？阿西吧去死吧！
29820,92,张永华,2016-09-19 15:20:36,-5,8,13,老师上很好！给分也很好！认真背肯定上4！
29839,92,张永华,2016-06-30 11:30:42,-6,7,13,4.5其实还不错
29951,92,张永华,2016-06-30 14:41:13,0,5,5,我只想骂人。为什么评分没有负分。几乎不来上课，来上课总是进行一些无聊又毫无意义的吐槽，吐槽我们大学生各种不是。给分超级低。每次上课都来，期末考认真的背了，考试时简答题好论述题几乎都会。你**的给分这么低。
30302,92,张永华,2016-07-01 08:23:45,12,14,2,我都不敢说老师的好话，怕被踩到明年。
30682,92,张永华,2016-07-02 07:59:32,0,0,0,。。。
30791,92,张永华,2016-07-02 13:38:30,7,10,3,到底有多少人不知道这种课根本不是老师打分的？没搞清楚状况就来着吐脏字？只能说双周班的助教太奇葩，建议举报。\n\n还说老师瞎逼逼，搞的好像真有听过课一样。\n\n至于那些说单周班说风凉话的，自己调了分后还不是一个德行……
31178,92,张永华,2016-07-03 10:51:58,5,6,1,老师有水平，结果被助教的给分黑了……
31545,92,张永华,2016-07-04 05:57:48,-4,3,7,给分低就拼命踩，有些人不如主动去查分。
31553,92,张永华,2016-07-04 06:17:24,5,6,1,这里戾气真重……老师其实挺不错的，但不管成绩。助教之一太乱来，在意成绩的还是慎重吧。
32747,92,张永华,2016-07-12 07:54:19,1,2,1,我还是要说句公道话，我是双周班的，我之前认真背了，考试题目基本全会，最后4.2，张老师感觉还是上课挺认真的，讲得也不错，但看群里的反应似乎确实有助教乱给分的情况
52837,92,张永华,2017-06-23 06:52:05,5,6,1,这肌霸真的绩杀啊，一个班的成绩被搞得鬼一样。就想问问有没有专业班级偏见，真的服气啊
52839,92,张永华,2017-06-23 07:05:09,2,3,1,。。。
52842,92,张永华,2017-06-23 07:15:57,2,3,1,助教来上课 给分差\n\n
52848,92,张永华,2017-06-23 07:25:15,3,4,1,鬼知道什么体验。。。
52849,92,张永华,2017-06-23 13:42:00,2,3,1,看到分数完全懵逼 刷新历史最低 感觉虽然不是最好的学生但是也算认真 不知道为什么 现在很悲伤 老师还是挺好的 但是分数太差了作为一个不理智的人我只能给老师一个及格分
52853,92,张永华,2017-06-23 07:55:14,3,5,2,张老师我求求您不要当个瞎几把老师了，你这个给分低到没有良心可言，我有一句mmp我现在就要讲！就想问为什么没有0分选项！可把我气死了这辣鸡老师
52860,92,张永华,2017-06-23 08:10:47,3,4,1,你的给分是看心情的吗？好的就算是助教给的分你做为任课老师课让助教上，给分情况也从不过问，这又是什么意思？还法学院的委员，我一个法科学生都为你感到羞耻，呵呵
52866,92,张永华,2017-06-23 08:43:37,0,1,1,逃过了大英 逃过了JAVA载死在行策上
52867,92,张永华,2017-06-23 08:50:13,4,4,0,老师其实蛮不错的，但给分确实低了点啊啊啊啊啊啊！
52868,92,张永华,2017-06-23 08:57:40,4,4,0,老师课上得挺好的，可是给分真的低。。。不够优秀还是别选吧
52882,92,张永华,2017-06-23 09:58:25,4,4,0,形策平时思考题写得跟小论文一样，引经据典思考人生，考前通宵背了几天，填空题不算做得很好，但简答题认认真真回答，都背出来了，结果连3都不上，绩点马上掉了0.3，气得想哭。。这是我第一次这么气愤地来查老师评论
60597,92,张永华,2017-10-25 01:48:23,6,6,0,不照念ppt，学工部出身，法院，还是很有思想的。只听了第一节课感觉挺不错，至于给分啥的还未经历过。个人有个人看中点吧
62441,92,张永华,2018-11-19 14:40:45,1,3,2,给个宏大的命题，两个星期后交，还没有字数上限，纵容恶竞.....上他的课心很累
83960,92,张永华,2018-07-11 15:22:34,5,6,1,看到很多人骂老师，其实看下去就会知道，起因是有一次调分出现问题。但是除了那一次，至少在我上学的这一年，感觉老师还是不错的，事情不多。作为思政课，其实不需要老师有多优秀吧？难道你真的想去形策课堂学到很多知识吗？至于最后评分，除了浙大很常见的正态，别的其实就看你的认真程度，平时上课好好交作业，期末复习认真看老师给的考试范围书，卷面整洁一点，给分还是不错的。
83964,92,张永华,2018-07-11 15:24:48,0,1,1,老师上课不念PPT，这点还不错\n\n最后那个小组作业毫无意义，平时上课点名就是写小论文，两星期断一回手\n\n这么说吧我缺了两次课（脑子抽了忘了）之后拼命背课后思考题，结果考试有很多是思考题感觉很赚，最后给分也没大家说的那么惨\n\n最后希望助教给力一点，回回学生信息，谢谢
83991,92,张永华,2018-07-11 16:06:06,1,2,1,给分相对其他行策老师偏低，但是高分（4.2 及以上）也有好多个。毕竟还是要靠背 ，以及，期末考试前复习是不能省略的。上课的时候比较轻松，不过每节课后需要写一下感想，如果不缺勤不少交的话，平时成绩是会不错的。
84003,92,张永华,2018-07-11 16:54:30,0,3,3,每节课都会有最后的一个课堂测试变相点名，期末写了大概一千字作业，不是组长，考试背了给的课堂测试总结，好好答了4.2运气挺好的吧，老师其实人还行，事情也不多
84028,92,张永华,2018-07-12 01:16:47,1,3,2,这是我第一次写长评。真的是醉了，我自认为对行策这门课是问心无愧的。从来不缺课，从考前一个礼拜就开始复习这门，ppt和书都仔仔细细背了两遍。考试的时候所有题都答出来了，重点是选择题我考完还记得的都去网上搜了答案，论述题考的那几个我都背过，而且考试的时候都还记得，所以都答出来了。我考完感觉很好，觉得没有4.8好歹还有4.5。结果，呵呵，3.3。cnmb。我是不相信那些拿了4+然后在群里炫耀，说什么能力决定成绩的傻逼真的考的很好。毕竟这个老师有调分的前科。总之，这是我见过的努力和成绩最不成正比，运气因素占比最大的一门课。
84935,92,张永华,2018-07-14 12:27:31,6,6,0,张永华老师人很好，讲课也很好，我很喜欢听他讲形策，所以形策课我从不缺勤，作业全交。2018年起形策没有填空题后，给分整体好了很多。但我觉得最后你得分到底怎样，可能跟你写字好看与否有些关系吧。总而言之，我个人而言，是很喜欢这个老师的，虽然我形策背了复习了也只有3.6，但并不影响我喜欢这个老师。
85248,92,张永华,2018-07-16 13:42:32,1,1,0,反正给分比较一般吧
102786,92,张永华,2019-02-23 05:30:09,-4,0,4,老师上课课堂氛围轻松 \n\n
104936,92,张永华,2019-03-31 12:13:44,5,6,1,查老师这个应该增加0分选项，及其不敬业，说是傻逼绝不为过，不尊重学生还强迫学生尊重他，真的呕吐，说话语气洋洋自得，不知道他觉得自己牛逼在哪里了，就是很烦一老师，非常烦，我非常讨厌他，他的课简直就是噩梦，希望学校还是不要有这种经常不来上课，随便骂学生，给分还很差的人了，不配当老师，没有道德，简直垃圾
113044,92,张永华,2019-07-05 20:15:21,1,1,0,给分辣鸡\n\n
113377,92,张永华,2019-07-06 12:50:57,1,2,1,老师人还可以啊，形策讲课也还不错啊感觉大多数形策老师都差不多课是和另一个老师搭班讲的。助教小姐姐好美！！！！！
139207,92,张永华,2021-07-13 08:32:36,3,3,0,不管上课水准怎么样，用管高中生的方式来上大学的课，实在有些迂腐了
157093,92,张永华,2022-06-22 01:44:01,2,2,0,老师是学哲学出身的，课上有意无意也会灌输一些哲学理念。他确实会对我们这样的学生有所不满，但是尽管这样老师讲课还是很好的，每次认真听都能有很多收货，是那种深层次的升华。最后期末给分也并没有很绩杀，我考试的时候很不在状态，很多记得的都没有写上去的情况下还有91。而且老师也基本上没有任何作业，真的挺不错的。最后夸一下助教qyy小姐姐，声音超好听，长得也很美，对我问问题态度也特别好~
217452,92,张永华,2025-04-10 13:47:37,0,1,1,话说的漂亮，事干的卑劣。大概这是学马列的共性吧！
2250,129,王心月,2015-04-13 16:13:49,-25,12,37,老师挺好的，课堂很开放，自由，不过没办法，毕竟是通识课
3163,129,王心月,2015-05-18 06:38:11,31,59,28,史钢课经常点名是一种怎样的体验
3318,129,王心月,2015-06-01 05:23:22,44,90,46,没有思想自由与四辩。没有历史，全是自相矛盾。
3947,129,王心月,2015-06-17 10:54:42,-1,8,9,一般
4090,129,王心月,2015-06-17 16:39:47,-28,12,40,其实听听他对于人物的介绍还是挺好的 上课不会点名
4361,129,王心月,2018-08-27 02:33:27,890,972,82,谁能想到“王心月”是个河南口音的大汉。。。
4429,129,王心月,2015-06-23 01:50:03,23,49,26,可水可听，其实也没啥可听的，讲的东西和课本不符的，想拿高分也不难，论文别太差，两次小组展示好好整，期末答的别太水就可以了。
4809,129,王心月,2015-06-29 05:41:40,9,26,17,毛吹
5269,129,王心月,2018-12-27 13:06:24,122,188,66,上课铃响，闭眼，，下课铃响，睁眼，走人。
7226,129,王心月,2015-09-11 12:50:47,-15,13,28,听听对历史人物的评价还是挺有意思的
7526,129,王心月,2015-09-15 02:04:56,5,27,22,渣
7538,129,王心月,2015-09-15 02:53:11,3,12,9,不是一个特别好弄的老师
7579,129,王心月,2015-09-15 05:28:09,41,129,88,第一次上他的课 就觉得他很会装逼，还先小人后君子，完全看不出他是个君子。而且非常自我，如果你觉得你脾气好，可以考虑选他的课。要不准会被气死。
7582,129,王心月,2015-09-15 05:43:16,2,10,8,无语
7941,129,王心月,2015-09-16 07:23:28,5,20,15,满天胡扯。。。
8069,129,王心月,2015-09-17 01:33:13,28,50,22,煎熬。。。而且给分不好 老师在布置作业的时候还经常自相矛盾
8848,129,王心月,2015-09-29 02:15:38,29,57,28,卧槽太差了，跟课本有什么卵关系，补觉课\n\n
9066,129,王心月,2015-10-12 05:52:30,23,39,16,就会吹牛
9081,129,王心月,2015-10-12 11:49:47,-23,9,32,很不错！
9091,129,王心月,2015-10-13 01:28:36,5,11,6,不解释
9165,129,王心月,2015-10-15 02:58:23,19,34,15,无聊，腔调怪
9393,129,王心月,2015-10-26 05:29:16,-1,5,6,课上抽人回答问题。
9394,129,王心月,2015-11-03 05:19:27,2,28,26,自以为是 爱装逼
9395,129,王心月,2015-10-26 05:51:45,40,59,19,记得带一本微积分
9426,129,王心月,2015-10-27 02:35:30,3,12,9,无语了 让你记一堆东西ppt还不放在群里 醉了 讲着讲着就会到大学生应该怎样怎样 史纲在哪里
9518,129,王心月,2015-11-03 05:35:32,2,12,10,太能扯，作业多、坑，对学生要求苛刻，一点也不通情达理
9626,129,王心月,2015-11-03 08:58:43,1,14,13,爱损人。 不通情达理
9668,129,王心月,2015-11-04 06:01:26,4,20,16,喜欢瞎BB
9747,129,王心月,2015-11-08 01:50:20,2,19,17,太烂了，要求还死多.....
9768,129,王心月,2015-11-08 13:31:52,-17,6,23,不错哦
11026,129,王心月,2015-11-24 02:10:58,-1,8,9,感觉还不错
11102,129,王心月,2015-11-24 07:25:57,11,28,17,为了上课买了个充电宝
11314,129,王心月,2015-11-27 00:01:59,3,19,16,讨论课题目乱七八糟\n\n
11801,129,王心月,2015-12-16 02:42:57,2,7,5,我们浙大的学生从来都是不点名的 你们不点名不行
11803,129,王心月,2015-12-16 02:30:04,2,7,5,口音重
11804,129,王心月,2015-12-16 02:31:38,1,17,16,不同课的说的话是矛盾的
11805,129,王心月,2015-12-16 02:31:49,-3,10,13,SB一个
11806,129,王心月,2015-12-16 02:41:40,1,8,7,煎熬，听不懂，口音独特
11808,129,王心月,2015-12-16 02:55:56,4,14,10,‘城院的就是要点名！浙大的就是不点！’呵呵，论文重复率一下子百分之三十，一下子百分之二十，他布置的作业反正是没法完成的。不讲道理强词夺理。我要变成历史学家了。
11835,129,王心月,2015-12-17 03:56:10,0,5,5,真是醉了\n\n
11843,129,王心月,2015-12-17 11:05:10,2,19,17,一副不可一世的样子，近代史教的真是枯燥的不能再说了。与学生之间的关系不好，貌似不懂得如何相处
12106,129,王心月,2015-12-22 00:29:38,1,6,5,呵呵呵呵\n\n
12114,129,王心月,2017-01-21 10:19:43,-9,11,20,跟狗屎一样
12145,129,王心月,2015-12-22 05:10:09,1,9,8,GCD的重视拥护者
12150,129,王心月,2015-12-22 05:39:55,1,14,13,辣鸡课，口音恶心人，给分还超低。
12247,129,王心月,2015-12-22 14:11:52,-2,8,10,老师人其实还是挺不错的。
12421,129,王心月,2019-11-13 00:44:05,0,25,25,上课像吃了屎一样的吹毛，为了鼓吹毛泽东贬低其他伟人，还有做人太苛刻，作业从来不给学生机会补交
12565,129,王心月,2015-12-23 13:28:43,-10,12,22,这是我大一上学期见过的最好的老师！\n\n
12607,129,王心月,2015-12-23 15:17:14,3,8,5,呵呵哒
12731,129,王心月,2015-12-24 02:48:12,3,7,4,不咋地
12936,129,王心月,2015-12-24 11:01:13,3,12,9,给分乱七八糟
13292,129,王心月,2015-12-30 02:15:47,-1,10,11,真-SB老师
13459,129,王心月,2015-12-28 06:37:48,1,10,9,还好，人还是挺好的，给分也公道，上课就那样，听不听都一样。
13474,129,王心月,2015-12-28 08:23:55,9,24,15,还是蛮可爱的老师，群里各种暖
13581,129,王心月,2015-12-29 12:42:55,-4,14,18,看不出来哪里装逼，对共产党的评价也很客观，承认过去的功绩抨击如今的腐败，不讲文革是因不考在史学研究上也是敏感话题。没交作业不怨自己反倒怪老师不延期你们也是够了
13666,129,王心月,2015-12-30 09:14:05,6,16,10,爱老毛  爱吹牛  爱等等  爱点名  要早到  不然占不到后排的位置  以上。
13735,129,王心月,2015-12-30 12:50:47,71,94,23,不明白为什么有人黑。虽然我绩点也不高，但是我觉得老师人很好呀。
13742,129,王心月,2015-12-30 13:27:38,-2,7,9,蛮温和的老师
14153,129,王心月,2016-01-05 04:57:09,0,12,12,这个老师给分很好呀，看平均分已经差不多是史纲最高的了
14156,129,王心月,2016-01-05 05:41:05,-4,2,6,课上人去
14159,129,王心月,2016-01-05 05:52:22,0,4,4,受不了
14346,129,王心月,2016-01-06 12:35:29,-1,6,7,喜欢他的给分方法，讨论课上表现好了给分不会差
14547,129,王心月,2016-01-07 14:15:42,-2,8,10,老师人挺好的，这种课一般都比较乏味，但是给分还不错，比一般老师强。还是挺负责任的一个老师。
14620,129,王心月,2016-01-08 03:25:34,-3,3,6,一般吧
14722,129,王心月,2016-01-24 07:18:30,3,10,7,死板，无趣。自我感觉过于良好。
14940,129,王心月,2016-01-11 06:42:52,1,9,8,非常辣鸡  qq 邮箱 手机不回  下个星期再交作业就不算分!
15044,129,王心月,2016-01-11 15:59:54,-1,7,8,给分还可以吧，就是事情比较多，每次展示完会给一二名的展示人发书感觉还是可以的
18771,129,王心月,2016-01-22 13:25:36,-1,5,6,老师人真的很好
19462,129,王心月,2016-01-24 09:32:04,-7,10,17,老师给分超好，不要信上面同学的瞎bb，考试前看一下绝对分不会低。\n\n
19476,129,王心月,2016-01-24 10:17:21,-1,4,5,还可以
19494,129,王心月,2016-01-24 11:19:55,1,6,5,很无语，就这样\n\n
19517,129,王心月,2016-01-24 12:57:20,-4,4,8,老师讲的不错 给分很好
19577,129,王心月,2016-01-24 22:40:03,1,14,13,你们不要黑他，虽然讲课确实无聊但是王老师人还是不错的，有很多观点认真听会发现很有道理。
19694,129,王心月,2016-01-25 05:57:15,1,7,6,扯，乱扯，装……还正态
19704,129,王心月,2016-01-25 06:25:45,1,15,14,别以为当班长会加分，一天天累成傻逼管各种事，结果到头来。。。
19720,129,王心月,2016-01-25 07:15:24,-2,5,7,过程水，给分好
19739,129,王心月,2016-01-25 08:05:50,2,10,8,发绩杀，死坑！！！
19744,129,王心月,2016-01-25 08:16:59,2,8,6,呵呵哒
19819,129,王心月,2016-01-25 10:28:26,0,8,8,老师上课讲课本比较少，讲社会问题讲历史故事比较多，还是挺有意思的。老师比较严厉，不是那种特别好说话的，个人觉得给分公平，主要看讨论课，讨论课搞好了分肯定不低。
19852,129,王心月,2016-01-25 12:15:58,2,10,8,给分极其不公平
19898,129,王心月,2016-01-25 14:12:56,2,7,5,sad
19914,129,王心月,2016-01-25 14:21:10,3,9,6,因为这一门课，成绩排名降低了10%，呵呵。
20047,129,王心月,2016-01-26 02:59:34,0,11,11,他给分挺好的啊
20147,129,王心月,2016-01-26 08:40:10,2,6,4,0分…\n\n
20161,129,王心月,2016-01-26 10:41:41,2,7,5,睡觉课
20246,129,王心月,2016-01-26 16:03:38,-2,4,6,不评论老师人怎么样。就课而言，他会刚开始一直瞎扯淡，到最后五六节才开始好好讲课。听不听是自己的事，后半段听了没坏处。前一段，自己看着办。
20549,129,王心月,2016-01-28 09:57:14,3,6,3,打分太随意，教课态度不行
20797,129,王心月,2016-01-31 16:11:13,36,52,16,老师还是挺负责的，键盘侠们嘴下留德。上课认真听还是很有收获。给分比较公平
20924,129,王心月,2016-02-04 07:30:08,1,5,4,啥比体验
21040,129,王心月,2016-02-13 07:03:03,4,11,7,给分其实还可以
21161,129,王心月,2016-02-23 11:08:01,-1,6,7,老师不是挺好的啊，给分还可以，人也不错。
21729,129,王心月,2016-03-01 02:09:25,0,2,2,睡睡睡
21919,129,王心月,2016-03-01 15:49:52,7,17,10,挺好的老师
22019,129,王心月,2016-03-02 05:56:42,-3,7,10,傻逼老师。毁我青春。
22041,129,王心月,2016-03-02 06:49:30,16,27,11,著名大学的著名教授，他说他做到了……
22087,129,王心月,2016-03-02 09:55:21,-2,1,3,除了无聊还是无聊
22224,129,王心月,2016-03-03 03:59:29,2,3,1,~~~
22497,129,王心月,2016-03-07 03:06:28,1,5,4,就知道扯淡
22897,129,王心月,2016-03-14 11:00:06,1,6,5,烂，分低
22931,129,王心月,2016-03-15 02:39:15,-2,3,5,自信满满地灌输他奉为真理的价值观。不敢苟同。
22962,129,王心月,2016-03-15 07:20:46,3,5,2,坑死你
23472,129,王心月,2019-10-24 06:30:13,226,325,99,为什么这么多人黑他，难道只有什么都不管才是好老师吗？经常点名，不允许补交作业，从学生的角度来说，这是他严格，从老师的角度来说，这是他负责任，作为一个学生，成绩差永远不要怪老师！说好听点是用功不够，说难听点是你无能。浙大没有差老师，也没有故意为难学生的老师。ps:当班长分数还那么低的，是你努力不够，说老师是狗的那个，你也配当学生，配当浙大人。。。
24026,129,王心月,2016-04-25 14:14:36,0,4,4,我觉得老师人还好吧…虽然我上课也没怎么听。。点名又不是老师的错
25333,129,王心月,2016-12-22 10:01:46,-1,9,10,虽然老师作业多，观点又极端。但是不耽误他傻逼呀。
25509,129,王心月,2016-05-24 03:23:18,-1,4,5,呵呵呵呵  别选
25514,129,王心月,2016-05-24 06:56:12,-1,3,4,差差差
26247,129,王心月,2016-06-16 11:33:28,3,7,4,超级世俗，价值观不敢苟同，张口闭口钱权。
27620,129,王心月,2016-06-27 05:20:03,2,4,2,小组展示做不好就直接狗带
28460,129,王心月,2016-06-28 09:06:12,3,4,1,嘿嘿，作为王老师来我浙大教的第一个史纲班的学生......反正我差点挂了
28880,129,王心月,2016-06-29 02:24:16,-4,3,7,恕我直言，他就是个辣鸡
31637,129,王心月,2016-07-04 10:22:02,-1,4,5,现在已经悔改了，不是绩杀。我作为思政课渣渣，思修3.3，这门居然4.5⊙_⊙
31956,129,王心月,2016-07-05 08:31:39,47,64,17,是一个很善良很善良的老师啊…
32241,129,王心月,2016-07-06 04:41:23,0,1,1,哈哈哈哈
32497,129,王心月,2016-07-07 06:49:34,3,11,8,给分还不错啦 很崇拜毛 很喜欢黑蒋 不喜欢他的价值观就上课做自己的事吧 反正班里都几乎没人听 思政课水水过
32821,129,王心月,2016-07-16 04:05:24,2,15,13,老师给分超级好、只要认真写论文，完成小组展示，完全不懂历史的理科生都能接近满绩
32943,129,王心月,2016-08-14 08:57:36,0,5,5,挺好的一位老师
33248,129,王心月,2016-09-16 14:34:03,-2,2,4,口音重
34030,129,王心月,2016-11-07 03:46:14,-7,4,11,声音怎么会这么恶心
34034,129,王心月,2016-09-26 02:47:41,-2,2,4,神一样的腔调\n\n\n\n
34057,129,王心月,2017-01-11 15:03:44,4,6,2,呵呵哒，史纲课让他上成了史纲课
34105,129,王心月,2016-09-27 05:18:00,2,4,2,偏心啊
34109,129,王心月,2017-03-10 02:15:42,1,5,4,一只喋喋不休的大鲸鱼
34416,129,王心月,2016-10-10 05:19:18,-2,0,2,啦啦啦
34464,129,王心月,2017-01-15 03:45:38,16,25,9,老师很尽责。
35550,129,王心月,2016-11-10 07:26:32,2,5,3,评分的的确确不是很用心。上他的课学不到什么非常有价值的东西。觉得不如高中文科老师讲的生动。
35759,129,王心月,2016-11-10 08:04:19,-1,2,3,搞形式
35868,129,王心月,2017-04-09 10:59:46,-1,3,4,挺好的，史纲老师反正都不按书讲的
35883,129,王心月,2017-01-16 07:21:15,-6,3,9,无聊，睡觉，耍手机，没有得到历史的乐趣，他是中国共产党的忠诚的信奉者，呵呵
36022,129,王心月,2017-01-21 03:17:24,15,27,12,好老师，要求非常严格。期末的给分很好，超出了我的预期。
36168,129,王心月,2016-11-10 17:54:44,0,4,4,客观地说：其实老师还是挺用心的 有点河南口音。但讲得很平淡也很死板，学生很少认真听。很爱说：“等等...”
36741,129,王心月,2017-01-21 03:11:25,0,7,7,给分超级好！
36796,129,王心月,2016-11-16 05:17:00,-1,3,4,千万别选！！
36810,129,王心月,2016-11-16 06:25:09,-1,3,4,简直逼了狗了
37030,129,王心月,2016-11-17 07:08:55,1,9,8,代过一次课，觉得还好。讲课确实没有很有趣，且喜欢灌鸡汤，但真的有认认真真的在讲课，是值得尊敬的好老师。
37758,129,王心月,2016-11-21 01:24:04,-3,1,4,呵呵，这是史纲吗 完全是老师的吹牛奋斗史，老师似乎对在浙大很不满意啊，讨论课也是 同学们的意见不重要 老师的意见最重要 呵呵
38592,129,王心月,2016-12-11 03:02:33,-1,2,3,哈哈呵呵
38852,129,王心月,2016-12-19 14:41:24,3,6,3,很水的课，一般用来写微积分\n\n你要是喜欢，写线代也行啊
38882,129,王心月,2016-12-19 15:49:46,5,10,5,虽然很多地方不尽人意，自相矛盾，想法不能说服人，很多为了政治正确而毫无深度，甚至有些地方甚至有愚弄的嫌疑等等，但本心不坏，还是比较为了学生好的老师
38905,129,王心月,2016-12-19 21:43:06,2,6,4,很好的老师
39064,129,王心月,2016-12-21 03:14:10,-2,4,6,上课喜欢吹逼以后要在一流大学当一流教授，原来贵校在您眼中是如此不堪，不知道为什么浙大会招这样的老师。P.S期末作业非常多而且难
39385,129,王心月,2017-03-08 12:32:23,1,9,8,给分很好的一个老师\n\n
39594,129,王心月,2017-01-21 05:45:19,-1,3,4,给分超级棒，只要讨论课认真做，拿到好名次。\n\n
39596,129,王心月,2016-12-26 02:36:47,-4,2,6,水课啊
39633,129,王心月,2017-01-11 15:21:28,110,130,20,不太明白为什么那么黑他，我觉得一个考试前一天晚上十一点还提醒大家要带什么，怎么答题的老师很好。作业要求高怎么了？来大学是养老吗？我觉得这样一个有自己思想的老师是值得尊重的。不后悔上了他的课。虽然绩点是低了点。
39791,129,王心月,2016-12-27 14:13:05,-3,5,8,讨论课：同学的意见不重要，老师的意见比较重要
40388,129,王心月,2017-01-03 06:41:37,15,22,7,并不是很为难学生 本来看评论很担心其实并没有
41264,129,王心月,2018-01-23 00:54:35,173,216,43,在查老师上面有很多人说王老师的坏话，但是，平心而论，这是一个很好的老师，说老师没有按照教材上的同学，我承认，的确没有按照教材来上，但是和书上的顺序没有过多的差别，而且史纲课的老师有哪个是按书本上的?说老师给分不公平的同学，想问一下，是真的不公平还是你只是对成绩的不满，如果是不满，请问问你自己，你是不是真的认真对待这一门课了，有没有认真写论文，准备展示，准备考试?说给分不公平的，我只能说每个老师都不会乱给分，而王老师在课前就已经定好了给分的标准。说老师展示课不尊重同学意见的，不好意思，我也是和你一个班的，展示课的时候，有多少同学在认真听讲，有多少同学在认真给分，一个自己讲了别人话题的组在指责别的组讲了他们的话题，那我也只能说呵呵，估计语文是体育老师教的，理解水平差，还说如果只讲他们的部分那就没有东西可以讲，那不是老师的问题，那是你们组自己水平不够！况且老师很少改最后的小组排名，只有在很离谱，学生打分不公平的情况下才修改的，而且就算修改，也最多只修改过1个组。在大一上半学期，上了很多的课，但是只有王老师的课是最让我印象深刻的，他的严格要求是让我们能够成为更好的人，对于不努力的同学，放养无异于是一种慢性自杀。很感谢王老师的教导，您的课让一个看见历史就头痛的人变成了一个对于历史有兴趣的人，上课时候讲的一些话也能让我受益一辈子，谢谢您！
41381,129,王心月,2017-01-11 07:24:09,2,9,7,还行吧，老师知识挺丰富的，要求比较严挺负责任的，
41403,129,王心月,2017-01-21 06:38:44,2,7,5,老师挺负责，给分还好，可能能力不够强，
41407,129,王心月,2017-01-11 10:48:00,-4,1,5,한국인 안돼 이 쌤꺼 듣지마
41412,129,王心月,2017-01-11 10:57:59,2,4,2,退就一个字。。上课太水，要求太严格，态度很差！
41833,129,王心月,2017-01-13 03:36:56,-2,3,5,简直上辈子造了孽才选到他的课...预制他的学弟学妹一定要换一定一定要换！
41870,129,王心月,2017-01-13 06:08:28,7,14,7,不管怎么样，学生对老师还是应该有起码的尊重吧
46146,129,王心月,2017-01-30 14:30:42,0,5,5,帅比一个
46224,129,王心月,2017-01-21 03:16:51,18,27,9,好好准备好好复习给分不会差的，讨论课的方式也比较公平。真的很想说，那些能用脏话骂老师的人，你们真的认真听过老师讲的课吗？说老师共产党重视拥护者的，你没听过他抨击国家的一些做法吗？只是他比较老实不敢说的太多政治敏感的东西而已
46240,129,王心月,2017-01-21 04:33:46,58,78,20,老师其实很负责辣，逢年过节还会有祝福，就凭这一点，敢问浙大有几个老师能做到这一点？
46243,129,王心月,2017-04-15 12:34:59,48,61,13,有人说他讲的很好，有人嫌弃他的口音。\n\n\n\n可是真的有人认真听史纲？\n\n王老师在改了，也会照顾学生成绩了，还是不错的。
46252,129,王心月,2017-01-21 04:57:12,-2,1,3,挺好的。。感谢老师给我高分
46253,129,王心月,2017-01-21 04:57:22,-2,0,2,给分炒鸡好 谢谢老师 祝老师鸡年大吉
46287,129,王心月,2017-01-21 06:41:36,-1,2,3,真的是一个很负责很负责的老师啊
46318,129,王心月,2017-01-21 08:23:38,2,8,6,这类课你还想要什么呢?非发表点反政府言论才可以？老师给分良心，还说什么？
46375,129,王心月,2017-01-21 11:14:32,-1,2,3,给分出乎意料。平常虽然严苛。但还是不错的老师。没有想象中的那么可怕
46378,129,王心月,2017-01-21 11:41:00,-2,1,3,老师很重的河南口音，但是上课和作业都挺认真的，还会在节日里发祝福，最后给分也还好！
46381,129,王心月,2017-01-21 12:02:56,14,24,10,其实老师真的很负责任。可能大家觉得史纲就是来水的，可那样你为什么要来学习。你考浙大就是为了来玩玩而已的吗？那三本玩的更舒服啊。希望有些同学不要把自己的错误强加在老师身上，甚至爆粗口。
46444,129,王心月,2017-01-21 14:39:54,-2,4,6,事情确实不少，但是讨论课好好准备，论文好好写，点名都到，给分非常好，接近满绩了。
46590,129,王心月,2017-01-22 03:26:42,-4,2,6,老师知识面很广，讲课没有趣，要求严格，给分公平，我打7分
47123,129,王心月,2017-01-24 03:09:22,-2,3,5,有开国大典电影看\n\n
47191,129,王心月,2017-01-24 11:09:20,-2,5,7,不知道为什么评分那么低，感觉讲的还好呀。
47309,129,王心月,2017-01-25 07:26:10,1,6,5,老师上课很认真，有自己的思想，讨论课也很棒，老师也都会认真听。给分很不错，还有电影看，美中不足的是老师口音重了点，但不影响听讲。
47386,129,王心月,2017-01-25 17:21:55,10,19,9,老师讲课确实死板 也不好听 但是给分确实是按照小组展示和论文的分数给的 那些分数低的人 你们可以想想你们真的认真对待了作业和小组展示了吗 如果没有认真对待 又怎么能说给分差呢 老师每次提醒都发三次 过节日都有祝福 黑他讲课可以 但用侮辱性的词汇真的能对得起浙大人这个称号吗
47603,129,王心月,2017-02-06 12:26:17,4,5,1,真的很坑，没大腿还是别报了
47772,129,王心月,2017-02-24 07:47:34,-2,2,4,老师还是挺好的。我觉得。
48060,129,王心月,2017-02-28 08:01:23,7,17,10,其实老师很好啊，只要认真对待分数不会低的。我们小组三次展示都是提前一天才准备，全凭抱组里一大神的大腿，最后分也挺好的。论文一篇我写了四天写了一万多字，另一篇是摘抄浙江精神那个书的。最后4.5，老师给分很客观啊只要愿意认真对待就没问题的。今年老师还把90+的人数增多了，增到范围最大了，其实不绩杀的。
48556,129,王心月,2017-03-07 07:36:43,0,3,3,老师人还是不错的
49246,129,王心月,2017-03-30 14:43:51,-3,0,3,挺好的，哈哈哈哈
49530,129,王心月,2017-04-18 03:07:47,13,16,3,等等，等等，等等等等
49590,129,王心月,2017-04-19 12:40:22,0,7,7,王老师上课挺好的，人很和蔼，只要讨论课认证做好，最后的绩点就不会低，期末考试什么的大家都一样。点名的话，因为有很多外国留学生帮忙垫底，所以完全不会被正态。讨论课我们组是两次第一一次第二，最后人人绩点4.2+\n\n
50000,129,王心月,2017-04-28 09:50:22,-2,2,4,你上课想水就水，但是讨论课一定要认真对待，论文不太水，期末正常水平，上4还是很容易
51767,129,王心月,2017-06-09 08:20:41,2,7,5,挺水的 点名全到 展示三次有一次倒一一次倒二 老师考试前会跟我们说选择题全选ABCD果真好用 用心写论文 大题多写点字 最后4.8 比组长还高
51862,129,王心月,2017-06-13 01:58:27,1,2,1,有水平，自以为是
52099,129,王心月,2017-06-14 17:46:51,-3,0,3,挺负责的……
52373,129,王心月,2017-06-19 07:48:33,4,6,2,这个老师的评分标准极不科学，基本以小组讨论成绩定成败，个人感觉出题审题迷醉、霸王条约、唯课本主义、对于不同的意见接纳度很低、党性强。如果想要高分的话，最好期望同组的都是热爱看课本、ppt制作水平高、展示技术强、党性高的神队友
54304,129,王心月,2017-06-29 04:29:23,-3,0,3,老师人挺好的，上课不按课本，但是这是史纲老师的习惯，好好准备展示基本就好了。
56311,129,王心月,2017-07-03 13:01:15,0,2,2,现在来看老师给分不错，事情也相对算少的，态度也不错，很好了。
56332,129,王心月,2017-07-04 06:07:24,0,3,3,河南口音矮大汉，坚定毛吹思想很正，老爱说自己以前的事。三次小组展示，抄1000字浙江精神，一篇个人论文
56333,129,王心月,2017-07-03 13:47:01,-3,1,4,给分超好，爱您
56630,129,王心月,2017-07-04 06:15:35,5,9,4,首先，老师其人和名字相差的确很大...真的是河南大汉。然后老师优点就是对学生很好，很负责，不绩杀。缺点呢，一，思想很正统，别想从他那听来啥新东西。（他很推崇毛和习，还批判过长者一番233）二，事情比较多，三次小组展示加一篇4000字论文。\n\n总之如果预置了就别换了，毕竟史纲这种课...都懂得
58871,129,王心月,2017-09-18 07:13:14,3,4,1,一定记得带一本微积分
58966,129,王心月,2018-01-30 09:10:13,-3,3,6,满了满了
58977,129,王心月,2017-09-19 03:30:27,2,5,3,为什么不下课……
58985,129,王心月,2017-09-19 03:44:56,2,3,1,不按常理出牌！下课无规律！
59056,129,王心月,2017-11-28 06:24:09,-3,2,5,还不错的老师
59057,129,王心月,2017-09-19 08:49:22,2,3,1,不要信好评的。已被坑
59751,129,王心月,2017-09-26 14:33:01,-3,1,4,不认真听，当然乏味。但深入其中，必有一份收获\n\n
60098,129,王心月,2017-10-10 06:51:38,6,6,0,讲课很容易跑题，还不如自学
60548,129,王心月,2017-10-24 01:42:55,14,16,2,嗯，自从上了王老师的课，我的睡眠质量也变好了，微积分和线代的作业也可以按时完成了，挺感谢王老师的o(^o^)o
60549,129,王心月,2017-10-24 01:52:14,6,7,1,怎么说呢…平常自习的时候都画不下工图…心总是静不下来…可是…我竟然可以在史纲课做完所有工图作业！！！
61025,129,王心月,2017-11-07 05:59:57,0,2,2,呵呵呵
61094,129,王心月,2017-11-08 11:34:41,-5,0,5,很好的老师\n\n
63909,129,王心月,2017-12-19 05:30:29,-3,0,3,觉得老师很好啊\n\n
64280,129,王心月,2017-12-22 07:56:10,-1,1,2,课是有点乏味了但是可以用心做自己的东西。老师也很好很用心。没有必要黑老师我觉得老师很不错了。
64728,129,王心月,2018-01-11 01:47:34,-1,1,2,老师是一个很好的老师，公平公正而且公开
65161,129,王心月,2017-12-29 16:23:46,0,1,1,在期末考前为老师打一下分\n\n单就他上课而言 这门课的确很水 如果你历史素养好的话听着可能会难受（工科男表示听他侃大山莫名有趣）\n\n口音较重\n\n讨论课一定要明确问题 一定要找一个靠谱的临阵不慌的人做报告\n\n（讨论课做得好的组老师会发小礼品的）\n\n至于分数只有5.4的原因嘛...可能等学期结束我就知道了（
65432,129,王心月,2018-01-04 02:08:17,2,4,2,很讨厌那种拿学生ppt讲课 还讲不出东西来的老师
65755,129,王心月,2018-01-09 04:04:22,2,3,1,巨坑啊
65885,129,王心月,2018-01-10 02:22:23,-1,1,2,有他的展示课让女生上不会被怼\n\n
66129,129,王心月,2018-01-12 04:00:49,1,4,3,作为一个组长，上他的课从来都是做微积分，除了讨论课做PPT累点，其他的都很水吧
67772,129,王心月,2018-01-22 07:02:50,-2,2,4,作为一个对历史不感兴趣的人，我无法评价老师的课究竟讲的怎样，我只知道一个认真负责的老师值得所有人的尊重，那些评价老师不行，自己成绩不高的人想过自己真的按照老师的要求做了吗？
69969,129,王心月,2018-01-26 00:58:01,-2,2,4,表白组长dl
69992,129,王心月,2018-01-26 01:45:23,-2,1,3,王心月超级可爱，超级喜欢他，上课也是上的超级生动，大爱河南大叔。
69994,129,王心月,2018-01-26 01:52:28,-4,2,6,王老师真是太可爱了，我要给你生猴子
70914,129,王心月,2018-01-28 00:10:03,-4,1,5,其实还行，没说的那么差。
71710,129,王心月,2018-01-29 01:34:01,-4,0,4,好的很
71937,129,王心月,2018-01-29 06:19:31,1,3,2,老师挺好的啊，就是处分出的死慢，超级慢。
71947,129,王心月,2018-01-29 06:27:29,2,3,1,分数，，怕是出不了了吧
72406,129,王心月,2018-01-30 06:51:15,2,5,3,出分慢是老师在调分吧 希望大家都有个好分数 小组展示认真做了论文好好写了卷子写满很稳啊 上课还会放电影 还细心的各种提醒考试的相关内容 非常负责认真的老师啊 大一上最高绩点了 觉得老师很公平 是个好老师
72409,129,王心月,2018-01-30 05:28:29,3,10,7,老师给分超级好啊，几次讨论课全靠组内大神，事情也不多啊，一个学期只要写一篇论文就好了，感谢老师
72415,129,王心月,2018-01-30 05:33:35,5,13,8,偶尔会点名，老师为人有准则的，是个很负责的人。会给大家放电影。研究性学习一定要好好做，复习的时候发现书上的内容搜集资料的时候都看过一遍了2333\n\n论文写了4000字但很用心写了，老师很好不以字数定优劣。4.8，大一上最高绩点，感谢老师。
72418,129,王心月,2018-01-30 05:39:50,-2,3,5,王老师是一个很赞的老师。可能有些人觉得老师布置的任务有点多，但是都是小组一起完成的，所以平均下来量也不是很大。会告诉我们哪些是历史上的重心，以及史学的一些思想，期末还会告诉我们让我们自己至少花时间过一遍课本，划一下问句之类的。总之，给了满绩的老师当然要给个赞（其实我挺混的。。。
72422,129,王心月,2018-01-30 05:52:18,2,5,3,我觉得王老师挺好的，小组展示每次排名都不好但是论文认真写，期末开卷然后多写就好 给分挺不错
72423,129,王心月,2018-01-30 05:56:56,6,16,10,为什么有那么多人给心月打低分？？？？我4.8第一个不服！
72426,129,王心月,2018-01-30 06:01:41,6,18,12,4.8，我也不知道为什么，谢谢老师
72430,129,王心月,2018-01-30 06:11:41,-2,3,5,老师给分挺好的呀，也没什么作业～
72431,129,王心月,2018-01-30 06:11:53,-4,1,5,这学期上了老师的课，虽然事情是有点多（但是史纲课都是这样的呀），但是三节讨论课真的让我学到了特别特别多的东西。关键是，老师给分超好啊！太感动了！浓浓师生情！！！
72436,129,王心月,2018-01-30 06:26:44,-2,3,5,要求严格（小组展示会很直接地讲不足），给分好（尽量给高分），抄写作业很水（字好看工整就行），评分标准很明确并经常强调，考试前反复提醒我们注意事项和考试技巧。
72439,129,王心月,2018-01-30 06:28:58,-4,2,6,超级好的老师 给分好 上课的内容也好
72443,129,王心月,2018-01-30 06:43:45,-4,1,5,王心月老师超好的！要求确实严格，但是只要每次小组好好讨论，论文标新立异，肯定可以拿到高分的！谢谢王老师?！！！
72444,129,王心月,2018-01-30 06:46:10,-2,3,5,平时稍微认真一点做做展示，考试认真写，一定要写完，然后写好一点，绩点很稳
72450,129,王心月,2018-01-30 06:55:18,7,20,13,我4.8第一个不服
72451,129,王心月,2018-02-02 01:30:24,1,6,5,看到这么多4.8的满绩的，4.5的渣渣飘过。老师给分很好，不知道为什么评分这么低。
72452,129,王心月,2018-01-30 06:59:47,-1,5,6,其实老师还是个很负责任的老师，打分也很客观，只要认真写论文，分就不会差，只是讲课中规中矩，可能有时候没有意思，不过总的来说还是不错的
72454,129,王心月,2018-01-30 07:01:28,2,8,6,其实还不错啦，看自己的态度啊。说实话吧，上课听不听差不多。。。。但是老师讲的很多东西都是用心在讲，很有思考力度，对于广大工科生来说听一听本就不错，提升自己的素养。至于说他给分低。。这也许是部分现象吧，每次展示我都好好准备，虽然展示排名不高。论文也会花时间写，考试时多多益善。。。这些大家都懂，可是这么做的人有多少，大家都是上课不听，展示课不听，准备资料啥的随便百度一下，就冲这这份态度还想拿高分。。
72455,129,王心月,2018-01-30 07:03:11,-1,3,4,给分超棒哇
72462,129,王心月,2018-01-30 12:59:15,-1,3,4,真的别把老师黑这么惨…这次绩点向上爬高了，虽然有两个班长没上90，老师也表示遗憾替他们抱歉……而且老师在群里重要的事情都是说三遍，上课的课件也是自己亲自做的，不听课的同学也不要这么黑他吧…其实课上是能学到东西的，即使和课本讲的有差别，但这也提现了老师讲课的用心不是吗？
72479,129,王心月,2018-01-30 08:07:17,-1,4,5,给分超级超级好
72484,129,王心月,2018-01-30 08:22:12,-2,2,4,没有评论说的那么差，总体感觉还是可以的，预置就不要换了。\n\n
72486,129,王心月,2018-01-30 08:25:40,-3,2,5,对，这是维绩点论的天下。我分不高，但还想给老师高分，一日为师终生为师。老师人不错，要求严格，但讲课内容能更灵活些就更好啦。学校维绩点主义的风气希望能改改。
72503,129,王心月,2018-01-30 08:56:45,-4,1,5,讨论课要努力
72509,129,王心月,2018-01-30 09:15:06,-2,2,4,给分超级棒der 虽然事情多 但是学有所得。
72511,129,王心月,2018-01-30 09:16:19,1,9,8,好老师!绩点高!不绩杀了!
72531,129,王心月,2018-01-30 10:06:27,-3,4,7,老师和蔼可亲，，给分棒，，满绩，值得一选呀
72582,129,王心月,2018-01-30 12:40:21,-3,2,5,非常好的老师！
72586,129,王心月,2018-01-30 12:50:02,-1,4,5,非常好的老师，考前多次在群里提醒大家要带的东西，出分慢了一点但是在为每一位同学争取一个较高的分数，强推！
72607,129,王心月,2018-01-30 13:27:19,1,9,8,老师给分真的超好！虽然3次讨论课任务较大，但收获很多。出分慢但带来了惊喜。大学第一门满绩，非常感谢老师！
72658,129,王心月,2018-01-30 16:09:46,2,8,6,看了大家的评论 才过来自己评论\n\n给分方面 老师出成绩确实慢 但是原因是因为给大家调了一个很好的分数 事实证明大家都拿到了不错的分数 \n\n讲课方面 老师的讲课节奏稍慢 比较容易让人睡着 关于历史的理解也确实不够深入 观点比较浅显 但是没有错的想法和观点 适合科普给工科生 \n\n老师比较崇敬毛 导致有人误解他无脑维护毛的各种行为 实际上对于毛的评价也比较客观\n\n王老师对待同学真的很好 不仅作业少 考试给分高 而且我有一次去询问老师关于论文的问题 老师也很耐心地回答了我 包括论文格式和内容 要知道他这个学期我只是九百多个学生中的一个 真的是很好的老师
72718,129,王心月,2018-01-31 03:19:35,-1,6,7,首先老师的给分真的不低，反正我是挺高的。其实平时讨论课和论文，老师都是公平公正的打分，所以只要你努力去做了，分都不会低。其实我觉得老师的上课也能学到很多东西，本来是史纲课的老师，就没有几个是按照课本讲的，而且王老师的讲课思路十分清晰，每节课选的要点也非常的好，与课本有一定联系，并且在某些方面深入探讨问题。再者，老师平时基本上不怎么管，作业也比较少，讨论课的话，只要小组配合的好，也不是问题，还能学到很多以前不知道的知识。虽然期末考试题目没有做完很遗憾，但绩点也并不低(可能是很多人都没做完的缘故)，并且老师一再提醒我们多多益善。所以综上，作为一个理工科的学生，我觉得王老师的史纲课是非常适合的。
72732,129,王心月,2018-01-31 03:57:42,-3,2,5,还是很有收获的 讲课都有认真记笔记 碰到重点他也会强调然后要求记下来 考试开卷 写的越多越好 最后两道论述题写满了 绩点4.8非常满足了
72790,129,王心月,2018-01-31 05:37:10,-3,1,4,好好好
72855,129,王心月,2018-01-31 08:00:19,-3,2,5,感觉老师给分很ok，只要根据老师说的认真做给分就不会低。
73009,129,王心月,2018-01-31 14:29:08,-3,3,6,老师上课感觉有比较浓的个人情感色彩，不太适应，但是很认真负责，最后给分也很不错，考试好好准备作业认真写成绩不会差
73399,129,王心月,2018-02-01 13:38:59,2,8,6,绩杀可能是过去式了，从上一届开始好像就不绩杀了…绩点出来的时候我还惊喜了一下（因为讨论课不好），然而一看大家绩点才发现是我太天真…作为一名学过历史的同学，个人感觉王老师是一个非常努力认真的人，包括上课、请教论文问题等等方面，这让我非常尊敬他。然而他的史纲课，讲得不是很清晰，声音催眠，缺乏带动性，这是不足之处。希望老师还能进一步改进教学方式，做得更好，教学相长。\n\n
73567,129,王心月,2018-02-02 03:47:24,-3,5,8,我理科生，历史一窍不通，但最后4，5感觉不错，给了89，应该是老师调的，老师真的很好。
74202,129,王心月,2018-02-06 13:53:20,-4,0,4,
74291,129,王心月,2018-02-09 13:11:51,-6,0,6,勉勉强强
74374,129,王心月,2018-02-15 17:24:44,-3,2,5,水一水 展示好好弄 论文别太烂 考试前看看书保证抄对地方 4.5左右
74522,129,王心月,2018-03-03 01:58:08,-1,1,2,老师特别好
74579,129,王心月,2018-03-04 03:03:33,-1,2,3,课好，，分高，强推
74833,129,王心月,2018-03-06 05:24:20,-2,1,3,很可爱的老师
74975,129,王心月,2018-03-07 01:57:51,3,10,7,老师超级负责。有三次小组展示，让班长把小组分好，文理男女搭配，相对来说很公平了。而且每次小组展示的前三名，老师自己掏钱买书奖励学生，这一点就很难得了。老师对每个小组展示都很认真听的，会提建议，非常负责。而且老师很可爱，在群里每个重要的事都说三遍。老师看起来也很和蔼，总是笑眯眯的。很喜欢毛泽东，但也没有盲目崇拜吧。课可能没那么有趣，但肯定是精心准备了的。最后给分也不错的呀！
75211,129,王心月,2018-03-08 04:59:58,0,5,5,首先老师学识真的很渊博，讲东西很有条理，那些说老师不好的是你们自己的问题，只要用心最后给分都会不错，论文好好写，展示好好准备，期末考试努力答题，完全可以得到很好的绩点，绩点低根本不怪老师好吗
75320,129,王心月,2018-03-09 02:19:50,1,4,3,老师很贴心，上课可以水水，只是讨论课有点多。
77837,129,王心月,2018-05-08 05:04:09,-1,2,3,至少现在不是技杀了，但是事比较多，有讨论展示课，展示有排名
78822,129,王心月,2018-05-15 10:45:49,11,12,1,上课太过随意\n\n常常上周课布置了什么任务下周课就忘了
79030,129,王心月,2018-05-21 06:08:04,19,20,1,评分规则太混乱了，让学生来制定……有点过分注重公平了，让人失去了积极参与的欲望。不说课堂，老师还是很负责任的，心灵鸡汤灌的很多。PS老师也上查老师哦
79227,129,王心月,2018-05-28 05:27:34,2,6,4,说没上过大学的人是卑贱的人。。。
80045,129,王心月,2018-06-19 07:33:40,0,4,4,这个老师已经做的很好了!
80396,129,王心月,2018-06-26 05:10:55,0,5,5,上课看得出来很有自己的思想。\n\n十六次课只有一次点到。\n\n展示课后还会发奖品，老师自己去买的。很可爱的老师！不要错过啊！
81307,129,王心月,2018-07-04 15:27:41,0,3,3,还行其实
84361,129,王心月,2018-07-12 15:48:11,0,3,3,老师很好的 事少给分好 讲的也不错
84865,129,王心月,2018-07-14 06:09:18,-4,1,5,上课还不错，事少给分好
84882,129,王心月,2018-07-14 07:24:06,-4,2,6,老师竟然调分了，很感动。不评论课堂教学质量，毕竟是水课
84883,129,王心月,2018-07-14 07:31:35,-1,3,4,真真的事少给分好哇！！！！
84884,129,王心月,2018-07-14 07:37:10,-5,2,7,老师人真的很好，打分都为我们着想的，平时事情也很少，一学期就点一次名
84895,129,王心月,2018-07-14 08:56:04,-3,4,7,老师真的是很认真负责的老师，不明白为什么评分这么低\n\n这门课得到的分数和付出的还是有相当大的关系的\n\n拿到了第一个满绩，非常感谢老师。
86358,129,王心月,2018-09-14 02:09:51,-3,1,4,老师可能没那么吸引人，但是课程难度不大，而且评判公正\n\n
86678,129,王心月,2018-09-18 02:31:58,-3,2,5,很好?
87028,129,王心月,2018-09-20 04:01:04,0,2,2,希望绩点给高点，学得很努力的……
87107,129,王心月,2018-09-20 10:15:35,0,3,3,师者  不严何以敬
87313,129,王心月,2018-09-27 03:03:30,-7,5,12,不懂为什么这么多人黑。。老师很尽责，成绩的评定也很标准很透明。考试之前还会提醒带什么带什么，每逢节假日还有祝福，真的很好了，大学第一门满绩，很感谢老师了。
87359,129,王心月,2018-09-27 11:27:14,5,5,0,等等等等哈哈哈哈哈
87667,129,王心月,2018-10-09 15:10:34,13,17,4,第二天上课，前一天晚上九点才留作业，上课第一天就告诉我们，你们谁和我熟我就给谁高分，真的，这老师你们选一下就知道了。
87845,129,王心月,2018-10-15 13:57:55,17,17,0,等等等等 啊 等等～
88196,129,王心月,2018-10-24 01:09:28,21,26,5,老师从来不按课本讲课，上课讲的让人一头雾水？(第二节课居然吹了一整节的曾国藩)普通话极其不标准，有强烈的地方口音，会听的你头皮发麻。还有就是，老师不怎么理解学生的学习压力，每次上课都会布置几本书让学生看，学生抱怨，老师就会拿自己“一天写五千字，每个星期看书，省下来的钱都买书，家里有好多书”等装逼理由回绝。这难道不是卖弄学识？虽然得承认老师的确有自己的想法，但是过分个性真的好么？
88444,129,王心月,2018-10-31 04:08:38,14,14,0,老师讲课有自己的观点，但是不太考虑学生的接受和与课本的关联。
88822,129,王心月,2018-11-09 02:51:29,62,74,12,为甚么你们要在这评论我呢？等等啊等等～
88831,129,王心月,2018-11-09 09:02:08,-6,7,13,老师严格，虽然看起来让人怕怕的，但是三观超正，人超级好，讲课也很棒，虽然我自己并没有节节课都认真听，但是听得出来王老师是一个专于自己所学并希望大家也可以过好自己的人生的人。平时过节还会在群上发祝福。把自己推荐的书的电子版全都发到微信群上。真的很好！
90082,129,王心月,2019-01-30 02:16:53,-3,12,15,4.8，来纪念一下。
91429,129,王心月,2018-12-10 03:12:58,-5,2,7,很好啊
91741,129,王心月,2018-12-19 04:39:22,5,5,0,无聊死了
91746,129,王心月,2018-12-19 07:31:18,18,18,0,讨论课毫无意义，浪费时间
92004,129,王心月,2018-12-25 10:38:15,-2,3,5,认真负责
92008,129,王心月,2018-12-25 11:17:16,-1,5,6,说实话史纲这门课大家心里都懂，没人愿意听的。我觉得有人给低分就是因为自己分数低吧？其实王老师给分标准第一堂课就说过了，很透明。老师给分认真，某些人就水不了了，只能来这抱怨，自己心里都没丶b数？
92213,129,王心月,2018-12-27 05:13:16,7,11,4,建议非文科学生课上谨言慎行\n\n否则会被一句一句专业用语嘲讽得无地自容
92388,129,王心月,2018-12-28 07:46:32,6,12,6,预置的老师本来看到低分很害怕，但是一个学期上下来觉得老师真的很好啊，虽然可能讲课内容上有些无聊，水一水也就过去了。但是每次讨论课把自己评分占比放在和其他同学一样的位置，上完课还会给讨论课前两名的组买书，还会把自己推荐的好书的pdf发在群里给大家共享，平心而论老师不差的。没出分就来评了，不知道怎么给分。
92390,129,王心月,2018-12-28 07:54:05,25,29,4,不知道该怎么说……讨论课没有任何标准可言全凭同学们的观看体验来打分，形式越多，大家看的越开心，分就会高一点…反正我花了一下午查了也就十几篇论文准备的讨论，最后我们组倒数第二……嗯，展示形式和内容哪个重要看来是我没拎清，对不起我的错
92495,129,王心月,2018-12-31 09:47:11,40,49,9,各位同学晚上好。明天就是2019年啦，祝大家新年快乐万事如意。同时也祝您的父母亲人身体健康万事如意。顺便提醒，如果方便，请给您的父母打一个电话或视频聊一下生活。新年快乐
92889,129,王心月,2019-01-05 10:56:44,1,5,4,怎么说呢，老师学识确实很渊博，事儿也不是很多，特别是对浙江精神和浙江发展只摘抄1000+，但展示的主观性很强，如果能有更多的时间准备就好了
92953,129,王心月,2019-01-06 08:14:47,-9,3,12,老师挺好的呀，我来拯救一下评分
93262,129,王心月,2019-01-08 12:46:52,-6,3,9,海星!
93337,129,王心月,2019-01-09 05:12:12,-12,4,16,很萌，知识很广博。虽然有时候会无聊地找茬满足自己的存在感，但是真的很体贴，而且可以看到展示当中实实在在的东西，而不仅仅囿于演讲者的语言。给分不错！
93729,129,王心月,2019-10-25 06:52:40,-77,88,165,真的是受不了“浙江精神与浙江发展”这本书了。浙大在浙江本地招生过半导致“生源平均质量严重下降”就不说了，还强迫所有人学什么“浙江精神与浙江发展”，简直是一本神书，把“浙江人”吹得上天，字里行间透露出的莫名优越感，还要弄个“精神”别人一起学习！说句不好听的，作为一个外省人，你浙江精神和我有个屁关系？！谁给你的勇气把它弄成必修？学你mb，你要学自己学，开成选修课，我tnd这里屁都不放一个。思修书内容还不够吗？还要你这本烂书来占用我的复习时间？真是mmp了，脏话都是都是对其赞美，真希望有些人能长个脑子
93737,129,王心月,2019-01-12 12:21:35,-1,1,2,666
93780,129,王心月,2019-01-13 14:18:31,39,41,2,其实小组展示每次老师、助教的打分都不太差。但其他评分的同学并不认真，一般都是低头族，基本上只会在ppt展示结束后听老师和班长问了几个问题，如果小组被问的问题多就认为这个组讲得不好，评分就低，并且这一旦形成惯性就很难改变，理论上很美好，实际上同学的听讲问题造成一定程度上的公平了。同时，从小组判断个人努力的机制实际上也并不完全合理，有些小组里的成员不出力，却有特别优秀的大神可以抱大腿，使得这一组成绩很优秀，小组展示是优秀了，但小组好个人也好的推论就不成立了，我想这是与老师要求分工合作的初心相悖的。不知道老师能否看到，小组展示的规则一开始就定下了，这是没有意见的。可是希望期末评分的时候，老师能看到展示成绩不理想小组中的个人在论文与考试里体现出的努力，现实而言，绩点对展示优秀与否的小组里的同学都很重要，拜托拜托。
93820,129,王心月,2019-01-14 02:19:51,43,48,5,展示课因为这种神奇的打分制度而毫无意义。我们小组前两次中规中矩准备，全拿了倒数第一；最后一次我们小组讲两弹一星，我在开头拿裸照打了个比方，剩下内容都是百度上抄的，居然还拿了第二。整个班里没人会在意你讲了什么内容，有什么史学素养、研究方法等等，只要你能够吸引眼球和注意力，你就能拿高分，结果这个分数还直接计入期末分数，试问这样的展示还跟史纲这个“史”有什么关系？？最后一节课上还在最后公布分数阶段临时修改规则，说“我认为这两组其实”如何如何，自己定的规则自己又改是什么道理？老师在第一节课就说这不是一节历史课而是一节意识形态课，但是在讲台上发表的一些言论真的让人浮想联翩。还有人提到老师节日祝福、提醒考试等等，我想说这只能说明作为一个人，他比较关心他人，但不能说明这个教师的职业技能有多高超；换句话说，我也可以做到在微信群里给同学们发祝福，也可以半夜十一点半甚至凌晨一两点提醒大家接下来考试的注意事项，那我是不是也可以在浙江大学执教了呢？
94561,129,王心月,2019-01-17 08:17:35,7,8,1,希望楼上冷静一点，我们小组的展示，比你们的成绩更不好一些。不公平是客观存在的，但毕竟规则是一开始就定下的，展示过程中的不合理目前来看也是无能为力的。希望老师能多多关注其他方面的表现。
95723,129,王心月,2019-01-20 02:45:37,23,25,2,为什么有展示课第四名变成第二名的情况 \n\n还有那一组原本打零分的，老师主动故意提问题帮忙完善答案的，这已经不单单是他们的思考成果了吧。老师还说作为嘉奖把他们变成第一名，这是什么逻辑，原先他们的说法根本不成熟，还硬说是共识!制造噱头吧 难受
96468,129,王心月,2019-01-21 04:41:12,1,3,2,啊啊啊啊啊，考完史纲的我疯掉了，这些都是什么神仙题目。可能我太渣了，作为一个小班长，我可能要凉了。老师，多给点分吧，求求你了，我字写的也很乱，但是没办法呀！我虽然是文科生，但是，写这些字手也快抖了
96844,129,王心月,2019-01-21 10:31:53,-2,2,4,平心而论老师还是可以的，很实在，是多少就是多少，以后有的老师花里胡哨地弄了一堆事情，然后告诉你说这些都是帮你们提高最后绩点，还弄什么满分通道，到最后你都不知道你的分是怎么没的，而且个人感觉那些事情的评分也不甚公平……这个老师起码付出是有回报的。还是不错的。
96879,129,王心月,2019-01-21 11:28:59,11,12,1,目前五六分是对这个老师最好、最真实的评价。老师怎么样，自然会受争议。史纲课，跟思修课上下来什么感受，任谁都知道。不可否认的是，绝大多数同学会把老师最后的绩点给的多少作为对他的评价。目前我的成绩还没出，但是我的感受仅限于其言语“选择题，你别想拿分！那些题就是给我做，我有的也做不对”“谁写的满写的多我给的分就高”“字写的好看的我直接给90+”“三次展示都在第四第五六名的直接在80分以下”“他们邀请我去，我才不去呢！都什么…”诚然，他说的在一定程度上符合事实，比如史纲就是拼手速看谁写的多，但是这样的言语态度我很不能接受。史纲课几乎没听过，偶尔听个几句，觉得讲的还可以，具体的研究观点什么的我不太清楚。对于楼上几位一直在争议什么小组展示成绩的，不太了解情况，也许老师对某一观点、某一学生略有偏爱也是正常的吧，但是改分的做法确实欠佳。
96885,129,王心月,2019-01-21 11:45:00,7,7,0,同楼上，老师有些话言语态度难以接受。展示课机制冷酷。
97808,129,王心月,2019-01-22 18:16:23,22,26,4,大家别这样，趁着成绩没出，我想为老师说几句。我觉得老师人其实挺好的，知识也挺渊博的，可能在语音表达上稍有欠缺。我史纲课有认真听的，很喜欢他讲曾国藩先生和解放战争那部分，我觉得有些内容还是挺有意思的。老师其实也有用心之处，比如我每次去上课时，老师都还没去吃饭，在为同学答疑，老师会自己看一遍检查分数，让助教和他一起改论文，每个人改一次，在这两天，老师还让我们班长把成绩表校对统计，打印签名了给他等等。老师也说会照顾我们的均绩，不会随便绩杀。在展示课改名次上和部分语音表达上可能略有不妥，我个人也极其不赞成，但是我觉得老师还有有用心的，不是随随便便应付的。老师也是认真做PPT的，他不会为得到项目谄媚讴歌，我在课后也看见他说要帮忙一个男同学修改PPT，和他一起探讨问题。所以不希望下一届学弟学妹们看见这一边倒的评论，在上课前怀有太多偏见。
97848,129,王心月,2019-01-29 23:10:13,7,13,6,每次讨论课都是后三名…但是最后绩点上4了…谢谢老师TAT
97912,129,王心月,2019-01-23 01:39:41,-3,3,6,我觉得还可以吧
97987,129,王心月,2019-01-23 03:23:53,0,3,3,真的人很好
99330,129,王心月,2019-01-24 14:54:19,2,7,5,王老师的讲课水平确实挺好的，对一些历史史实有自己独到的见解，而且感觉他对学生挺负责任的
100071,129,王心月,2019-01-25 13:40:29,6,27,21,浙江精神与浙江精神就是傻逼书，搞得好像全中国就你浙江有精神似的，然后居然还是必修，我怎么没见到北大有什么北京精神与北京发展，复旦有什么上海精神与上海发展呢？
101528,129,王心月,2019-01-30 15:45:10,4,8,4,老师人很好，但是班长评分很水，评分时玩手机，写作业……给分虽不高，老师人很好，讲得细！
101544,129,王心月,2019-01-28 11:45:58,5,8,3,趁成绩还没出先客观评价一下老师吧。怎么说呢……老师其实有优点也有缺点。听课堂其实可以看出老师是一个肚子里有货的人，是一个平时喜欢读书也有比较高文史内涵的人。但是有时候真的上课节奏太慢了，而且基本不按课本来，上课精神很容易飘掉。讨论课注重公平公开是好的，但是我觉得让学生打分这个其实是有一定bug的，毕竟上讨论课我看到认真去听并且去打分的真的不多，老师的提问其实占了很大影响，我记得我们组就曾因为老师个人的一些点评而被献祭。希望可以越来越好吧，不过其实也跟我没什么关系啦。希望绩点可以高一点吧！
101739,129,王心月,2019-01-29 03:06:37,-44,0,44,不明白为什么只有4.8
101916,129,王心月,2019-01-29 16:06:35,2,3,1,难受啊
101917,129,王心月,2019-01-29 16:11:26,19,19,0,凭什么我干的活最多却只有3.3
101920,129,王心月,2019-01-29 16:25:20,-13,3,16,我吹爆王心月！！两年没学历史，史纲4.8成为本学期最高绩点！被微积分拉下的均绩有救了呜呜呜
101921,129,王心月,2019-01-29 16:50:04,6,8,2,呵呵这个老师我是真的服了。讲课质量一般，关键是他的评分体制真的不敢恭维。平时成绩占的比重较大，但是我想说的是，一个大班分为三个小班来评判，其实每个小班的水平真的不好说是都相似吧；三次小组展示，评分基本由学生决定，其实说实话听的人注意的主要还是展示者的语言是否流畅和吸引人，里面的内容反而没那么重要了，那我们组员的努力呢，完全没有意义了吗；另外这位王老师对每个小班展示第一名的小组的奖励，我印象中好像也只奖励了展示者吧？我承认做展示的同学的确很辛苦，但是这样是否也太不公平。此外就是还有一篇论文，这个我无话可说，我写的确实不多，质量还好。然后我还被卡绩了。果然绩杀。三观不合。
101940,129,王心月,2019-01-30 00:10:24,18,24,6,讲课，不多做点评，个人觉得一般，课堂上讲的东西，我想说，我都知道，高中老师还讲的更多更有深度。关于展示课，确实很多纰漏。比如秋学期一节，冬学期几乎连着两节，虽然中介间插了一节看电影的课，但是史纲最后一节课还拿来展示，这是不是安排的有点不合理？而且评分确实...看命，看运气。我们组第一次相对比较水，百度百科上找的，然后小组第二。后面两次可以说很认真的了，花大力气找论文，结果倒数？？同学打分说实话确实很没水准。只要你足够吸引眼球，那就是高分，管你内容怎么样，是不是有史学素养在里面。我是理科班的，和一群人文社科的一起上，老师一直提醒我们理科工科生要上点心，不然很可能被正态。这点老师还是挺好的，督促我们。开始很怕会因为自己理科班而被区别对待，但最后绩点也上4了，虽然又被卡绩。。还有评论里骂浙江精神的，虽然我也不喜欢这个东西，但我是浙江人，你在这里骂这个就不太好了吧？？浙江人就是优秀啊！无可厚非！没有浙江每年缴纳的这些税，国家拿什么去扶持中西部？浙大生源中省内的学生多是因为，作为一个经济大省，就一所985高校，就一所相对拿得出手的学校，政策当然要往省内倾斜一些，不然也对浙江人太不公平了吧。看看江苏上海，好学校不要太多诶！还有说我们浙江人降低了浙大的生源质量，我tm..！不行不行不能说脏话，要有素质。好像搞得我们是老鼠屎一样，坏了你们一锅好粥。是是是，你们外省的都是大佬，就我们渣，rbq rbq。但是话说回来。要是没我们给你垫着，你来垫？开心吗？(浙江人别打我我们还是很优秀的)真搞不懂，地域歧视搞到这里来了，变成外省的看不起省内的了。都是浙大人，一起进步不好? 要是我去清北，如果有什么北京精神，我也愿意学啊，多了解一点有什么不好呢？而且考试也不用怎么复习这门啊，考试的时候都能找到喂，平时当课外读物也就行了啊。不懂为什么喷子这么多！溜了！
101942,129,王心月,2019-01-30 00:16:59,0,5,5,我觉得老师做得够用心了，够了，至少在我的心里觉得不错了。老师调分调了那么久，把均绩提高，但是正态机制下的牺牲者是不可避免的。还有对于班长那一点，不知道其它班的班长如何，至少就我而言，我是不水手机，认真听讲的，认真打分的。那条曾国藩和解放战争的评论也是我的，大家多做个有心人，有做得不够好的，也请大家多多包涵。
101943,129,王心月,2019-01-30 00:45:39,25,26,1,小组展示3次ppt都是我苟的，最后一次甚至没人理我，谢谢老师的3.3！出分非常慢，是为了筛选谁是欧皇，谁是像我一样的非洲小可怜吧（笑哭，但是又真的心酸）！老师，下次至少把组内分工统计一下吧，你忙吧，我吃柠檬，我是真情实意地酸了！
101948,129,王心月,2019-01-30 00:54:53,-24,0,24,这给分也太好了吧！水了4.8！！
101952,129,王心月,2019-01-30 01:08:15,15,15,0,三次展示都是后三名，果然3.3～(￣▽￣～)~
101956,129,王心月,2019-01-30 01:13:30,8,13,5,说实话不太喜欢王老师的上课风格，没按书本讲，方式也难以接受。但是毕竟王老师给分好啊，史纲课本身意义不是很大，拿4.8挺满足了。事也不算多，因此史纲选王老师没啥问题吧。\n\n可前面地域黑在这里喷浙江精神与浙江发展的是什么毛病？首先，这本书是史纲规定要学的，为什么来这里喷一个老师？其次，当下国家都宣传要文化自信的前提下，我们讲浙江文化有什么不对吗？北大、复旦有没有讲自己的文化，你不是那里的学生你也不知道；而且我觉得北京、上海的文化对中国影响已经够大了，不学也罢。一本开卷的书，考试前可能都没怎么复习，你就怨气这么重了？
101963,129,王心月,2019-01-30 01:27:48,-3,1,4,老师非常好，上老师的课能知道很多东西，很有见解，谢谢老师！
101990,129,王心月,2019-01-30 02:31:15,6,11,5,怎么说呢，史纲课老师讲课我基本没听，讨论课我们组真的很用心准备啦（应该很多组都非常努力吧），但是成绩很不如人意，两次倒数第二一次倒数第一，像很多同学说的那样，我觉得讨论课评分机制应该要有所改进，毕竟分数占比挺大的。写论文的时候一直泡在图书馆，写了6000多一点点，浙江精神的抄写字写的非常好?，期末考没怎么复习，凭着高中的知识储备考的，选择题像老师说的那样一个题都没做。我一直觉得史纲成绩要凉凉啦，虽然对讨论课的成绩挺不甘心的，但我也很无奈啊。今天早上看了绩点，4.2，有点不敢相信，可能是论文之类的写的比较好吧。还是很感谢王老师的。以后选王老师课的同学们讨论课还是要努力做好的，如果真的没办法，也不要灰心，其他的可以加把劲，?。最后想向那个不满浙江精神的同学说几句，作为浙江人我为浙江感到自豪，既然你来了浙江来到浙大，希望你能尊重我们的文化，我们不一定要得到你的认可，其次希望你能把书名说对，谢谢！
101991,129,王心月,2019-01-30 02:33:04,-3,2,5,认真完成讨论课，认真写作文，应该给分还可以。
102001,129,王心月,2019-01-30 03:25:31,8,10,2,老师其实还好。毕竟史纲这门课本身无论上课还是考试都几乎没意义，让老师讲意义其实很难。只是讨论课由小组互相评分，真的，太容易不公平。评分的人是随机选的，很多人其实根本不会听，分也是随便打的。谁能想到一个史料详实、全程脱稿讲解的会比念ppt的人排名往后呢？除了讨论课评分之外，其它的部分，这个老师还是可以的。
102004,129,王心月,2019-01-30 03:29:00,-8,16,24,大家别把那条骂浙江精神还有骂浙大生源的那几条评论给顶下去啊，那条骂浙江生源不好的评论我翻了好久才看到，大家多给他们点赞，让他们到前排来，看看这些人是多么的没素质，就不能理性的思考吗？最后一句话，我是浙江人，我骄傲！咋滴！
102005,129,王心月,2019-01-30 03:30:36,4,8,4,评分机制极其不公平，说白了，将学生带回了大锅饭的年代。获利者得了便宜还卖乖，失利者叫苦连天。这不是学生的错，也不是老师的错——这门课程的设置本身就有点问题。
102357,129,王心月,2019-02-01 07:06:25,23,26,3,5分真的非常客观，老师很有干货，事儿也少，也就是三次讨论+一篇论文，但评分机制贼恶心不按课本教。。。另外我是外省人，可能这个课强制嵌入浙江精神与浙江发展有点儿偏题，但老师只让我们在上面摘抄1000字，并没有让我们整什么读书报告之类的啊，而且这儿是浙大啊，这本书再怎么说也是积极的内容啊，讲求本土的浙江优秀文化也是理所当然的事儿啊。都9102年了怎么还在开地图炮窝里斗啊，来浙大的最后有很多都会留在浙江，最后甚至在浙江安家立业，为啥非得和这一本书过不去呢，浙江精神这本书把政治书顶上取其精华去其糟粕批判继承古为今用这个理论弄成了成品，怎么还会有人骂
102626,129,王心月,2019-02-14 11:04:13,-1,4,5,非常差
102765,129,王心月,2019-02-22 14:39:00,-1,4,5,很烦的老师
102792,129,王心月,2019-02-23 05:58:33,0,3,3,其实老师心还是很好的，确实作业和展示要求高。可惜展示因为各种缘由没有预期效果，还好最后绩点不错。
103248,129,王心月,2019-02-27 03:20:36,10,11,1,一切句子的结尾都是：等等，对不对啊
103271,129,王心月,2019-02-27 05:53:27,7,9,2,地域黑没有意思，优越感这种东西也最好不要有，都不利于自身发展，眼光长远一点，格局大一点，走出这片天地会发现自己的渺小。入乡随俗，无可厚非。
103280,129,王心月,2019-02-27 06:30:16,1,3,2,敲可爱(๑• . •๑)，反差萌\(//∇//)\
103345,129,王心月,2019-02-27 11:23:05,2,3,1,其实老师很好的呀，认真完成任务是容易高分的！
103402,129,王心月,2019-02-28 02:29:09,1,2,1,很棒的老师啊
103404,129,王心月,2019-02-28 02:34:14,0,3,3,是个好老师！
103405,129,王心月,2019-02-28 02:34:30,1,2,1,事多，但是很用心!!!
103410,129,王心月,2019-02-28 03:02:55,1,3,2,如之前的同学所说，事多，最后三周安排两次讨论课的神仙操作。小组展示打分主观性强。点名就一次吧大概。上课比较无聊。给分还算好。想水的带哥们强烈建议选。
103431,129,王心月,2019-02-28 05:28:01,6,6,0,“就是甚么nei”
103602,129,王心月,2019-03-02 06:11:10,2,2,0,课堂展示博人眼球即可
103850,129,王心月,2019-03-06 09:58:16,-3,10,13,我觉得那个说浙江精神的并没有太大错啊，最多语言偏激了一点，凭什么把他压下去。
103878,129,王心月,2019-03-07 02:19:52,1,5,4,我不明白，一个马克思主义学院的教授，如何解释不清楚唯物主义和唯心主义，甚至师心自用，完全沉浸在自己的想法中
103884,129,王心月,2019-03-07 02:53:40,4,4,0,对不对咧
104018,129,王心月,2019-07-10 12:39:14,-4,5,9,给分低且玄学
104212,129,王心月,2019-03-14 04:07:17,32,36,4,在浙大上过这么多门课，还是第一次从老师口中听到浙大不如上交复旦的观点。
104463,129,王心月,2019-06-30 22:06:53,12,12,0,恋爱害人  蒙蔽双眼\n\n这就是为什么您谈家时候只说您姑娘仿佛您老婆不存在吧？\n\n理性带师  佩服
104466,129,王心月,2019-03-21 05:57:42,10,11,1,等等，等等…
104467,129,王心月,2019-03-21 06:30:47,17,18,1,"1.每节课只要你记下老师的每一句重要的话，然后反反复复诵读参悟，二十多年后你的地位一定比我高。\n\n2.学经济/政治(?记忆模糊)的，只要你把中国这些年来的……大会（记忆模糊）所有的文件认真研究通透，你一定能成为这个领域顶级的专家。\n\n3.数学家在研究""1+1""为什么等于2，我们所以为的如此简单的问题，事实上却有这么深刻的内涵。（事实上，哥德巴赫猜想“1+1=2”的1和2并不是数值的意思…)\n\n总结：当老师他讲到""没有调查就没有发言权""时，我真的抑制不住吐槽的冲动…\n\n上课时打出来的…"
105130,129,王心月,2019-04-04 05:51:38,12,13,1,为什么这老师老以为自己讲的很好？？？
105409,129,王心月,2019-04-12 02:27:04,0,1,1,。。。
105794,129,王心月,2019-04-20 14:52:51,-1,4,5,小组展示给分，极不求是，当同学评选出高分的时候，他打出了最低分
105810,129,王心月,2019-04-21 05:49:33,2,5,3,好老师，真的。
107784,129,王心月,2019-05-09 14:16:53,-9,13,22,哈哈，给楼上老哥点个赞。估计点踩的都是浙江学生吧，咱外省的人数还是远远比不过浙江本地学生啊
108412,129,王心月,2019-05-23 06:46:54,10,15,5,作为一位共产党党员，此人完全合格;\n\n作为一名历史学家和历史课的讲师，至少以目前的史料来看，此人相信并向同学们灌输的大部分是政治正确的历史，完全没有资格作为一名理性研究历史的学者。\n\n
108637,129,王心月,2019-06-30 22:04:00,13,16,3,政治观点太过激进，要是他做国家主席，第三次世界大战就要来了
109350,129,王心月,2019-06-13 07:29:27,7,10,3,老师人可以啊，没有刻意的压低分。小组展示论文啥的不就是思政课的常规操作吗……第一次讨论课展示，老师给的评分虽然和同学们的结果差很多，助教姐姐说要不把老师的权重改高点，他还说不要这样，不公平(对比往届现象，算是知错就改吧)在学习、政治观念上，确实有古板的地方，但是也没必要苛求每个老师的观念都和我们年轻的学生同步，不喜欢就不接受这种思想，左耳朵进右耳朵出就好了，反正上课没多少人听，老师也没有要求课堂纪律……有时候觉得老师在上面讲的慷慨激昂，下面的同学不是睡觉就是低头做别的事情，是挺不尊重人的，如果真的看课堂表现，我们又能得多少分呢？
109816,129,王心月,2019-06-19 11:50:31,5,6,1,我觉得，真的是用心、热爱的老师
109873,129,王心月,2019-06-20 03:00:12,2,4,2,我佛了
109897,129,王心月,2019-07-10 12:38:37,-21,3,24,吃柠檬吧，柠檬熟了
110035,129,王心月,2019-07-10 12:39:04,-5,5,10,nmd屁话真多
110890,129,王心月,2019-09-15 07:05:18,6,7,1,老师很好，中间会点名，别翘课，给分也棒。
111498,129,王心月,2019-07-01 23:03:36,5,6,1,老师人挺好的啊。。。为什么黑他？\n\n
111908,129,王心月,2019-07-10 00:21:28,7,10,3,10分，主要是史纲简单，从没翻开过书，考场现学4.5
114027,129,王心月,2019-07-08 11:29:28,7,8,1,趁着没出分给老师打个10分，老师真的很可爱了！（我怕我出分了打不出10分）
114280,129,王心月,2019-07-09 17:15:00,3,3,0,希望老师能够越来越好!
114287,129,王心月,2019-07-10 12:38:48,-4,3,7,老师给我的分数让我十分惶恐\n\n因为我史纲啥事都没干\n\n和隔壁通核刚好相反\n\n各种报告 展示都准备很用心 结果突然被卡 害\n\n只能说老师们打分的时候都是闭着眼睛的嘛
114363,129,王心月,2019-07-09 23:48:23,3,3,0,终于熬过一个学期了，天天划水，最后还是要感谢老师不杀之恩
114368,129,王心月,2019-07-09 23:58:53,3,5,2,老师很有上进心，有自己独到的看法
114381,129,王心月,2019-07-10 00:26:55,6,10,4,小组展示基本倒数  但最后4.5 ?
114402,129,王心月,2019-07-10 01:03:27,-4,3,7,老师讲课真的不错，也很照顾同学们的感受！给分也很好啊！啊啊啊啊啊为什么分数这么低？？？10分拿去拿去，顺便吹爆！
114450,129,王心月,2019-07-10 12:38:27,3,6,3,不知道这门课为什么要正态分布，期末考看的就是写的多写的少，比字数那还有什么考试的意义？就靠字数区分每个人的努力？腊鸡史纲，不知道要这门课干什么。
114502,129,王心月,2019-07-10 08:26:47,0,3,3,老师真的很好了，不明白为什么分那么低
114543,129,王心月,2019-07-10 12:38:17,-1,3,4,给分好
114559,129,王心月,2019-07-10 16:51:42,12,16,4,这人水平差，而且自大，你提出不同观点他就会居高临下的教育你，自己还觉得在循循善诱，其实知识还不如一些同学。知识不足也就罢了，其思想还十分落伍，具体也不方便说，而且公然宣扬战争。另外，还喜欢假扮公正，你自己屁股歪就算了，还要说「A如何B如何其实如何」，实际上他自己支持A，非得搞得他很客观一样，又比如吹嘘他心中那个大人时非得先说一句「是人不是神」，好像别人还没从造神里走出来，靠他启蒙似得，接着就是一顿吹嘘。还有迷惑性。而且面对同学展示，明明自己不懂也要鸡蛋里挑骨头，讲述今上思想时其他不敢说了也要指责PPT页面上「浙闽」顺序错了（谁说一定要按时间排序的？）上课认真吗？我不觉得，他确实会滔滔不绝，但是离教育这两个字差的远，怕是单纯自己口嗨而已。口嗨时不断重复使用「等等，等等」「对不对啊，对不对啊」，话也说不好，还总是说「我就讲」，接着说一些常识乃至错误的话，而搞得好像是他独创的真知灼见一样（说实话一个学期下来他说的话我觉得一句独到的也没有）。给分可能不算特别差，但很玄学，就是莫名其妙的。
114994,129,王心月,2019-07-14 01:03:13,-1,2,3,挺好的！
115066,129,王心月,2019-07-15 05:00:07,5,7,2,老师书虽然教的不咋么滴，但是人还是非常好的，很实诚，给分相对于其他史纲老师来说算很好了，用老师的原话来说我虽然书教的不好，但是我会给你们高分的，反正人很好就对了，比医学院沈姓老师人品好多了，大家千万别选进化的大脑与偶成的意识，浪费时间！
115549,129,王心月,2019-08-03 02:08:06,1,3,2,给分超级赞?
115813,129,王心月,2019-08-20 12:01:55,1,3,2,很好啊
116064,129,王心月,2019-09-02 03:32:40,1,3,2,隔壁刘召峰班发来贺电，当初脑子进了水才退了他的课改成刘召峰，然后错过了一个给分不错的老师?
116077,129,王心月,2019-09-03 03:38:27,-6,0,6,给分很好！高中学过历史的毫无压力！
116245,129,王心月,2019-09-06 13:59:29,2,4,2,很好的老师 不知道为啥这么低
116592,129,王心月,2019-09-12 02:45:09,2,3,1,没怎么听过课，感觉老师也不太管。小组展示做好，论文写好，期末考试大题填满，绩点还不错_(:3」∠ )_
117084,129,王心月,2019-09-19 05:24:49,12,14,2,为什么不允许藏族同学做组长
117907,129,王心月,2019-10-09 07:37:39,4,4,0,讽刺国庆回家的同学是什么意思？？？都tm在图书馆看书在食堂吃饭您就满意了？
118258,129,王心月,2019-10-24 03:20:56,2,2,0,...服了，自己的语言组织能力真心不咋地，讲任务18个组长没有一个组长听得懂...还要我们锻炼语言表达能力.....盆友，咱们稍微关注下自己的实际情况呗？
118259,129,王心月,2019-10-24 03:24:27,3,4,1,你有什么资格说胡老不好？当时中国不跟美国叫板是胡老不想吗？是国力限制。没有胡老专心内政，搞发展，提高民族凝聚力，力排众议要引进航母，现在的中国有能力叫板吗？习主席也说功成不必在我，胡老不过是没在任期内等到那一天而已。
118268,129,王心月,2019-10-24 06:31:46,1,2,1,好多ppt，好多讨论了呦～问一句怎么查重，就骂我功利？？？
118707,129,王心月,2019-10-31 02:30:49,10,10,0,展示实在是很多。烤柿粥之前要准备一周突如其来的展示，时间非常紧张。听的同学是很少的，这样的展示课实际上是浪费时间。课后根本没有时间完成展示，这样匆忙的交作业只能是浪费时间，根本没有实际效益。老师本身的课程讲的是很好的，但是太看重大家打分了，况且这样的打分没有那么客观。
118720,129,王心月,2019-10-31 07:21:14,1,1,0,就这样吧。。
119302,129,王心月,2019-11-12 03:33:29,1,2,1,确实不负责任
120537,129,王心月,2020-01-12 08:49:41,-2,1,3,Nice！
120960,129,王心月,2020-01-21 03:05:59,10,11,1,以下是出分以后群里一位同学的回复，看完很感动，复制在这里：\n\n老师辛苦了！谢谢老师一学期的用心！每次有通知都会重要的话说三遍，“您”“谢谢”“对不起”等等礼貌用语让人倍受感动，小组展示效果和排名不好但在老师一针见血直言不讳地指出问题后茅塞顿开，不管是为了买书在拼多多上砍价还是老师自己做出来的一个个图表都很难忘，还给我们去机器人小镇参观的机会哈哈。虽然成绩很一般，也知道自己的学习欠缺很多，但还是很钦佩老师，再次感谢！祝老师新年快乐，身体健康，工作顺利！
121216,129,王心月,2019-12-27 15:54:49,2,2,0,王老师是一位很认真，很可爱? 的一位老师
121592,129,王心月,2019-12-12 09:41:03,3,3,0,挺好的，虽然课有点水，而且不按教材上课，但是感觉老师很负责任，并且也有很多的拓展，只是好像在上思修课一样。。。
121676,129,王心月,2020-01-20 17:15:05,4,4,0,给分真的蛮好的
121685,129,王心月,2020-01-20 23:42:34,1,5,4,这个老师说自己不在意查老师评分，但是不在意又怎么会反复提及呢？这个老师上课什么的我不作评价，但是对于展示课，他的思维逻辑真的很混乱，每次都不知道他想要干嘛，出分慢，绩杀，不解释。
121692,129,王心月,2020-01-21 01:55:33,4,5,1,老师很好啊，事情不算多，挺推荐的
122178,129,王心月,2020-02-19 07:34:49,3,3,0,其实老师挺好的  重视讨论课也是给我们锻炼自己的机会  虽然有些课上的观点咱不敢苟同  但是老师还是很关心学生挺不错的  给分也挺可以
122200,129,王心月,2020-02-20 02:43:32,7,8,1,从上课的内容和对展示的点评来看，老师的水平还是足够高的，基本上都能多方面的指明问题和关键，能侃侃而谈，有深度的分析问题（像听百家讲坛qwq）。在群里面也十分和蔼（虽然长时间掉线qwq），作业和展示只要认真准备就会有一个好结果，期末考前看一遍书就可以了。给分十分合理，感谢王老师！
122309,129,王心月,2020-02-24 02:19:39,1,3,2,我觉得王老师人还不错，讲课也还行，不过我基本没怎么听。小组展示一次倒二，一次第一（大概6个组一个小班，在小班内的排名），还有一次展示不知道排名，但可能不是很好，被分配到的展示选题挺重要的，我们的配的选题太难讲了。给8分吧。老师说过几次要点名，但后来都不了了之。ps老师会给展示的同学买礼物.88卡绩了有点难受
122421,129,王心月,2020-02-27 02:32:28,4,5,1,王老师真的很好，很可爱的老师，快要结束了有点遗憾没有很认真的去听他的课，我觉得老师真的很有水平，认真看看PPT，听听课会有很多启发与收获，小组展示尽力去做，好好展示，我们组得了一本论语，我要去了，真的很喜欢，还有就是要认真去写论文，题目很宽泛，任选，我当时定题就想了很久，查找资料，初稿，改稿，定稿，真的弄了很久，一个论文我写了好几周，（当然我比较菜），开始还比较担心，因为查老师之前说给分迷，但是出分4.5非常非常非常惊喜，我觉得老师是很认真负责的，不是说拿了很满意的绩点才来这样说，即使不达到预期我也会有这番评论，希望同学们放心选，选了就认真去做。
122539,129,王心月,2020-03-03 11:52:31,0,3,3,其实老师给分还是蛮好的。水水课展示做的一般也有4.5
122724,129,王心月,2020-03-26 09:57:29,0,1,1,老师上课还可以，就是绩点正态分布，而且课前演讲评分说是让学生评定，实际上还是以老师的评价为主
123492,129,王心月,2020-06-09 06:55:39,0,1,1,讲的是不咋样，水过去就行
123829,129,王心月,2020-06-15 01:02:38,-1,1,2,上课很烦，整天互评展示，展示做得不好直接来个绩杀
124089,129,王心月,2020-07-03 10:26:03,3,5,2,不管怎么说，给分还不错
124392,129,王心月,2020-06-30 04:51:01,1,1,0,大帅比一个，人不错。
124575,129,王心月,2020-07-03 06:51:58,3,3,0,事情很少，老师讲的很认真，给分也很好~
124579,129,王心月,2020-07-03 07:52:57,-3,1,4,我以为要凉，没想到4. 8可能是疫情期间大家准备考试比较难？
125821,129,王心月,2020-09-14 13:03:29,0,0,0,感觉有点自大，不按照书本讲，但是讲的故事还是蛮有意的
126922,129,王心月,2020-10-28 07:57:20,1,1,0,给一分和评分机制等无关，单纯觉得他上课的内容很糟糕，自我矛盾，而且政治立场非常激进，观点的表达没有论证过程，这一点跟高永水平差太多了。以及，人文社科根本不能以论文数辆来评价学术水平的高低。
128068,129,王心月,2020-12-06 04:18:49,-1,1,2,哎，3个小时，既没有课间还拖堂，膀胱炸了啊，草。想着快下课了熬一熬。结果拖了半小时。草了。草了啊
130982,129,王心月,2021-01-25 12:57:57,4,5,1,来，同学们帮老师砍一刀
151226,129,王心月,2022-02-25 03:33:45,3,3,0,在食堂听其他老师说王心月不在浙大了
44,282,梁清华,2015-03-14 15:31:37,4,46,42,思修给分不好。
498,282,梁清华,2016-09-21 03:22:36,9,119,110,事多 给分太坑
555,282,梁清华,2015-03-15 04:54:26,4,20,16,事情比较多不过也还好 认真做了就有中上的分数。没有传言那么可怕我觉得
1161,282,梁清华,2015-03-21 16:22:16,5,15,10,活动多但安排的好，不会在期末。挺好的呀
1435,282,梁清华,2018-01-20 12:57:47,5,129,124,一门思修比通核还烦
1856,282,梁清华,2015-03-26 02:19:48,2,12,10,事多 不过还好
1929,282,梁清华,2015-03-26 08:54:59,7,33,26,事情多
2558,282,梁清华,2015-05-04 14:04:49,19,35,16,只要作业按照要求完成就好啦 并不绩杀啊
2599,282,梁清华,2017-06-13 16:19:50,11,25,14,认真负责的好老师
2600,282,梁清华,2015-05-04 16:26:53,6,22,16,作业挺麻烦的
2658,282,梁清华,2015-05-05 03:42:54,6,49,43,思修太坑。一个小思修作业那么多。还有很多课外的任务。去年思修刚上3把绩点拉死了！
2737,282,梁清华,2015-05-06 13:08:41,137,162,25,嗯，比较看重平时分，对于不想要复习考试的我来说是一大优势。参加了毅行，印象深刻，收获颇多。
2865,282,梁清华,2015-05-09 11:59:15,10,36,26,虽然不点名但是就是经常会叫一整个小组上去回答问题基本节节课都有，跟点名没什么区别，然后就是事情真的特别多
2881,282,梁清华,2015-05-10 08:35:53,3,17,14,事多给分坑
2882,282,梁清华,2015-05-10 09:27:24,0,9,9,事情很多，但是都认真做的话分也不会低
2884,282,梁清华,2015-05-10 10:09:01,-4,42,46,超级恶心的老师，事多，给分超不好
3049,282,梁清华,2015-05-13 07:17:15,8,23,15,梁老师很好求不黑
3062,282,梁清华,2015-05-13 10:13:47,26,44,18,梁老师的法基课挺好的～四次作业得分加起来就是总成绩这也挺合理的，而且作业也并不是很难做～
3173,282,梁清华,2015-05-19 01:03:44,-16,6,22,神烦
3517,282,梁清华,2015-06-17 01:26:09,74,102,28,比梁老师更耐心负责的好老师不多了～～
3568,282,梁清华,2015-06-17 01:36:04,0,5,5,很不错的哦
3684,282,梁清华,2015-06-17 02:14:27,39,60,21,你们这些人啊，too young sometimes naive!
4022,282,梁清华,2015-06-17 14:08:19,2,11,9,作业多了点，但是认真完成的话给分很好
4042,282,梁清华,2015-06-17 15:13:46,1,8,7,坑比
4086,282,梁清华,2015-06-17 16:37:06,0,13,13,思修给分像屎一样。
4189,282,梁清华,2015-06-18 03:52:47,5,20,15,事情多比较烦
5705,282,梁清华,2015-07-09 07:42:13,275,323,48,这么负责的老师很少见了，说麻烦的同学都是自己不愿脚踏实地干事的！
6504,282,梁清华,2015-07-14 13:16:39,1,8,7,事情是真的多，很看重平时，不过老师是真的有意思
7902,282,梁清华,2015-09-16 05:01:48,5,10,5,事情稍微多些，但给分没有别人说的那么恐怖…讲真
7926,282,梁清华,2015-10-22 06:14:45,12,22,10,挺不错的
8333,282,梁清华,2015-09-18 12:01:06,1,7,6,事情有点多，简直通核一样。。。给分还可以，老师人还不错
8695,282,梁清华,2019-09-11 01:26:45,584,734,150,你们的大学生活就只剩绩点了吗？仔细听听他的课，收获真的很多。你们嫌事多，如果没有她的活动，自己的生活也只剩下寝室，教室跟图书馆了吧。
8836,282,梁清华,2015-09-29 00:04:32,95,120,25,虽然平时事儿多，但认真做收获还是很大，老师也很认真负责！
8875,282,梁清华,2015-09-29 07:01:58,-4,9,13,作业超级烦，而且不下课
9061,282,梁清华,2015-10-12 02:57:23,-3,6,9,zuo死的老师 真能折腾
9114,282,梁清华,2015-10-13 08:24:26,3,11,8,超棒，超负责，能学到很多东西。真的听了她的课后，会觉得所谓绩杀也无所谓！
9126,282,梁清华,2015-10-14 00:33:44,-3,8,11,个人见解，勿喷，事多的要死，花样太多给分烂\n\n
9339,282,梁清华,2015-10-22 08:07:51,3,43,40,事儿太多…shuoshenme不考期末考…现在才发现，还不如考试呢…
9572,282,梁清华,2015-11-02 01:30:01,2,14,12,老师我叫你一学期的爹 拜托别那么多B事儿行不行？
9614,282,梁清华,2015-11-03 02:25:02,0,3,3,事特多，不过我们不期考
9814,282,梁清华,2015-11-10 06:40:32,25,36,11,很负责的老师，难得！！！
9815,282,梁清华,2015-11-10 06:41:29,-1,6,7,推荐学弟学妹们上她的课
9819,282,梁清华,2015-11-10 08:01:23,6,9,3,老师很用心，也很累哎……
9820,282,梁清华,2015-11-10 08:03:29,4,7,3,事超多……不过老师真的用心良苦，很负责，认真按要求做，会收获很多东西。
9854,282,梁清华,2015-11-11 08:06:38,4,5,1,课上的是蛮有意思，就是事多
9863,282,梁清华,2015-11-11 10:54:02,13,17,4,认真负责地上课，都是上课没有什么高低贵贱，凭什么大家对待其他课认真对思修不认真呢？认真，严谨，这才是想变强的我们该做的。
9927,282,梁清华,2015-11-13 00:22:43,10,15,5,平时事情超级多，但是锻炼了我们的能力，认真做的话总会有收获
10202,282,梁清华,2015-11-17 10:56:16,1,3,2,还不错啊
10487,282,梁清华,2015-11-19 05:52:41,0,5,5,烦得要命\n\n
11018,282,梁清华,2015-11-24 01:18:48,0,3,3,锻炼人的能力，包括思辨和执行
11153,282,梁清华,2015-11-24 17:03:37,12,15,3,一个很好的老师。我们是不是太苛求老师了，本身就该是尊师重教，认真学肯定有很多的东西的，例如毅行例课外的实践
11605,282,梁清华,2015-12-07 12:02:54,2,5,3,不喜欢
12591,282,梁清华,2015-12-23 14:29:02,46,55,9,老师其实人很好，给我们布置的作业也是真心为我们好，培养我们各方面的能力，课上的也很有趣，踏实去做得分不低的
12608,282,梁清华,2015-12-23 15:19:49,2,6,4,事情多 给分坑 上课水 烦到不行
12645,282,梁清华,2015-12-23 18:35:40,0,5,5,思修事情多到死…不允许同学有不一样的看法 老是打断同学 自认高明
12911,282,梁清华,2015-12-24 09:42:27,3,7,4,事多 人烦 分低
12981,282,梁清华,2015-12-24 12:26:45,59,71,12,期末不考试，但是相应的平时就有挺多任务，要做志愿服务写报告，但是感觉老师真的很负责认真，真性情的老师。
13062,282,梁清华,2015-12-24 16:32:26,0,6,6,事多给分差\n\n
13245,282,梁清华,2015-12-25 14:49:41,0,9,9,我给了1分，嫌多
13380,282,梁清华,2015-12-27 12:15:58,1,4,3,好老师啊好老师
13381,282,梁清华,2016-01-26 13:27:15,11,14,3,平时的作业很多，老师看上去事情很多很烦人，但是，当别人都在准备思修考试而你却有时间准备其他科目的时候，你会庆幸选了这位老师的思修。给分公道。
13531,282,梁清华,2015-12-29 03:31:33,2,9,7,一学期五篇报告  我就笑笑不说话
13591,282,梁清华,2015-12-29 16:54:34,-2,4,6,噩梦一样的大妈，事情比别的任何一门课都多，超级麻烦，超级糟糕的体验
13677,282,梁清华,2015-12-30 09:59:51,0,4,4,绩杀！！慎选
13722,282,梁清华,2015-12-30 11:59:00,2,6,4,B事那么多，可你无可奈何！不过认真听还是挺有意思的.但是B事多！\n\n
13800,282,梁清华,2019-01-29 14:42:53,-219,10,229,就是一条狗 其他不想说什么
13825,282,梁清华,2015-12-31 15:06:48,0,3,3,事多，但是有很多收获，也为将来积累谈资经验和阅历，有些作业可以以后接着用的
13925,282,梁清华,2016-01-02 11:25:07,20,35,15,事确实挺多，交文章的数量是大一秋冬学期所有课里最多的。不过今年起不用期末考试了，不用过多去关心书本上的死知识。就当是补偿了。
13926,282,梁清华,2016-01-02 11:42:53,49,56,7,给了10分。不解释。一个老师的评价取决于你看她的目光
13962,282,梁清华,2019-01-19 06:53:45,33,44,11,老师人很好 负责 给分透明 只要努力 就能拿高分 最后拿了96 现在老师还是朋友圈的朋友
14161,282,梁清华,2016-01-05 06:12:20,4,6,2,非常好，赞一个
14165,282,梁清华,2016-01-05 06:21:00,2,4,2,是个负责的人
14531,282,梁清华,2016-01-07 12:25:56,1,3,2,老师很好很负责啊，布置的任务不算多，很值得去做
14878,282,梁清华,2016-01-10 14:18:58,-2,2,4,我评分打10分是为了积德攒人品。
15199,282,梁清华,2016-01-12 15:04:25,3,4,1,很好的老师，不教思修就好了
15223,282,梁清华,2016-01-14 05:42:58,-1,4,5,顶顶顶
15645,282,梁清华,2016-01-16 03:04:42,1,5,4,讲的很好，收获很大，想水过去的人别选，想学东西的人选\n\n
15962,282,梁清华,2016-01-16 23:54:40,7,9,2,"再接着写：还有，她还比较敢说话，""非常性感的丁字裤""""你们现在还都是处男处女，等你们大三大四，我看还有几个是""。。。"
16327,282,梁清华,2016-01-18 02:51:06,-3,2,5,ooo
16423,282,梁清华,2016-01-23 15:11:31,10,13,3,梁老师的课超级棒，给分也特赞
16476,282,梁清华,2016-01-18 07:27:09,-4,3,7,差劲！
17697,282,梁清华,2016-01-20 15:56:55,5,6,1,老师讲的很认真，我们这届也是免考试点。当然那些想把思修水过去的就算了，老师那些作业虽然费时间，但也能锻炼人
17760,282,梁清华,2016-12-21 01:51:15,74,86,12,从头刷到尾，只有一个想法。到了大学，真的自由么。我们真的了解老师么，看到她的付出了么，我们有我们的苦衷，她呢？自由是什么，是基于平等的，希望大家能想清楚。
18008,282,梁清华,2016-01-21 05:53:49,7,11,4,梁老师比较负责啊。我是上思修的，作业认真写写，成绩还好吧。
18434,282,梁清华,2019-10-30 05:24:20,37,43,6,不要用作业多，给分不好这种理由去评价一个老师， 要看你学到了什么，总之我虽然没学到什么专业的知识，但却有了很多其他的感悟 支持梁老师
18480,282,梁清华,2016-01-21 18:00:21,0,4,4,嘛，给分一般般，老师挺有想法的，弄了不少活动，讲课水平嘛有待提高。毅行挺有意思，和学婊，绿茶，土豪组队，颇有西游记的赶脚。
19104,282,梁清华,2016-01-23 09:15:36,3,6,3,棒！！
19108,282,梁清华,2016-01-23 09:19:03,2,5,3,负责的老师
19109,282,梁清华,2016-01-23 09:19:07,0,3,3,老师讲得好 事情虽然确实比较多但是给分实在太好
19120,282,梁清华,2016-01-23 10:06:50,86,95,9,老师人挺好的，绝对的良心！那些说事多的到了考试周估计早就不这么想了，思修的教改非常成功，也收获很多。只要认真完成每一项作业，给分不会差！关键看自己！
19124,282,梁清华,2017-09-08 04:54:00,27,32,5,我觉得很好呀，为我们申请免考试点，上梁老师的思修是真的是在思修
19127,282,梁清华,2016-01-23 10:05:30,2,5,3,老师很有意思会让你上台讲话 其实给分不错 只要每次作业都认真完成
19128,282,梁清华,2016-01-23 10:07:33,3,6,3,怎么说呢 我们这个班没有期末考试 平时事情比较多 但老师还是很认真负责的 最终给分也不低
19134,282,梁清华,2016-01-23 10:18:17,4,6,2,事情挺多是真的orz 但基本上认真完成了给分就挺好的
19138,282,梁清华,2016-01-23 11:22:03,4,5,1,老师事情比较多，不过志愿活动还是很能够提高我们的社会参与度的，在实践中学习。最重要的是没有期末考试哦！
19139,282,梁清华,2016-01-23 10:31:29,-10,4,14,最烂。最烂。没有之一的老师。别被不考试所吸引。你会明白考试de好处。不然竟吓给分
19140,282,梁清华,2016-01-23 10:36:25,17,19,2,上课不按照书本，有自己的想法。作业多 不用期末考试 我感觉在期末少一门考试绝对是件好事。老师给分也很好，只要作业认真完成。关键是那么用心的老师实属难得啊！
19141,282,梁清华,2016-01-23 10:42:04,2,6,4,梁老师真的很负责，虽然有时候觉得作业真的蛮多的 但是这学期给分真的很好啊！
19142,282,梁清华,2016-01-23 10:44:08,-3,4,7,要不是没有零分这个选项
19143,282,梁清华,2016-01-23 10:45:24,-3,4,7,选上了。别犹豫。赶紧换
19145,282,梁清华,2016-01-23 10:54:22,-10,2,12,要不是没有零分
19200,282,梁清华,2016-01-23 13:16:39,13,19,6,没有考试，也不绩杀啊，老师很负责，作业好好做给分很好的呀～\n\n
19336,282,梁清华,2016-01-24 01:59:46,-8,2,10,言而无信，网络作业说好的绩点出分时候降了0.6
19342,282,梁清华,2016-01-24 02:27:48,11,13,2,上课认真，事情较多，不用期末考很好。之前在学习帝上看还以为是绩杀，其实人挺好，都是因为学校制度的关系，这老师能给高就给高的
19469,282,梁清华,2016-01-24 09:48:59,1,3,2,老师很棒啊，虽然事情多，但是只要认真按要求做收获就挺大，给分也会挺好的。
19499,282,梁清华,2016-01-24 11:34:13,-9,4,13,烂到没话说
19555,282,梁清华,2016-01-24 16:23:18,0,5,5,老师还好。。。课友坑爹
19729,282,梁清华,2016-01-25 07:36:44,-1,3,4,不考试，论文稍多，但是分在一学期的各个阶段就不觉得压力很大了 给分也很好 尽可能的给高分
19733,282,梁清华,2016-01-25 07:48:55,0,2,2,666
20151,282,梁清华,2016-01-26 09:16:36,3,6,3,事情不少，而且老师似乎很喜欢两性关系…自己最后拿到了没想到的高分，这样看来，也不是完全的绩杀吧
20231,282,梁清华,2016-01-26 15:23:58,0,1,1,负责的老师
20309,282,梁清华,2016-01-27 03:21:54,1,2,1,事情多，不过最后给分好不错，关键不用考试。
20343,282,梁清华,2016-01-27 05:31:27,-1,1,2,真心负责用心的好老师，知识渊博，有自己见解。而且勇于尝试教改，很成功。认真参与，思修分不会低
20351,282,梁清华,2016-01-27 05:55:17,0,2,2,良心好老师
20661,282,梁清华,2016-01-29 13:16:00,0,3,3,不用考试。平时经常在微信群转发一些法律相关的东西给我们看(尺度有时候还挺大的。。)最后的得分高低还是要看平时的投入，虽然一门2.5分的课投入的精力确实偏多了
21059,282,梁清华,2016-02-20 08:11:58,55,60,5,若不是真的为学生考虑，为什么要推行免考教改给自己增添反复设计实践作业的负担，改改卷子不是更轻松吗？最后给分也很良心公正，希望大家能看到老师的用心。
21084,282,梁清华,2016-02-16 08:38:30,1,3,2,作业多，但挺好用的～
21144,282,梁清华,2016-02-21 08:02:22,-1,2,3,收获大
21219,282,梁清华,2016-02-26 10:49:26,0,2,2,老师认真负责，给分没有那么不好的⋯⋯
21338,282,梁清华,2016-02-28 05:30:25,0,3,3,负责，但是水平太差，我思修和职规都是她教的，虽然上的很认真但真的很让人讨厌
21379,282,梁清华,2016-02-28 11:14:06,1,3,2,老师挺有想法的，不用考试，但是有很多实践作业用来综合评价，基本上一个月一次。
21576,282,梁清华,2016-02-29 08:25:52,5,6,1,事真的多，讨论-报告-讨论-报告。。。。但能学到很多东西的。还是建议大一上的同学不要轻易选。。。毕竟需要时间在大课上拉绩点
21595,282,梁清华,2016-06-30 07:37:36,2,5,3,挺正经的，研究报告读书报告课堂讨论都有，不过做好就ok，绩点和努力挺成正比的，而且老师确实很认真！
21661,282,梁清华,2016-02-29 12:53:03,-2,3,5,思修4.5，老师人很好，上课很有意思
23166,282,梁清华,2016-03-21 01:37:12,0,2,2,事是真多啊。。。
23505,282,梁清华,2016-04-02 06:37:09,-1,1,2,王章燕平
23512,282,梁清华,2016-04-03 00:57:37,-1,3,4,大学遇到最好的老师之一 她的给我了职业生涯规划满分 觉得事多就是因为大家贬低通识课的存在 完全是谬论
23902,282,梁清华,2016-04-20 12:17:04,0,2,2,老师人超好，思维严密，不选后悔
24316,282,梁清华,2016-04-29 10:21:19,0,2,2,职业生涯规划:每次上课都有作业，最后有一份职业生涯规划书。只要认真完成，成绩就不错。上课很有趣，老师真的很负责，也有一颗包容的心。
24789,282,梁清华,2016-06-20 06:16:26,1,3,2,很不错的老师 除了作业实在多 但很实在 好老师 给分也好
24794,282,梁清华,2016-05-03 16:23:12,-1,1,2,职规课值得一上，内容丰富，且给分好
24801,282,梁清华,2016-05-03 23:03:19,-1,2,3,职规的平时作业之类挺多的，上课要求参与度高，不过，如果作业认真的话，分还是很高的。认真做作业的话，确实对职业生涯规划有帮助
24811,282,梁清华,2016-05-04 00:56:34,-3,1,4,事多 给分也一般 不喜欢
24818,282,梁清华,2016-05-04 01:59:03,0,2,2,事情多但是给分也好，认真做就有收获
24825,282,梁清华,2016-05-04 02:22:42,0,3,3,事情是肯定多的，给分是可以的，有没有学到东西这种事情，大学里嘛，是靠自学的。\n\n
24852,282,梁清华,2016-05-04 05:04:48,1,4,3,强烈推荐梁老师的法律基础。\n\n课有意思，能学到东西；推荐的书也很棒；给分也很不错!!\n\n她的其他的课没上过，打算去选她的职规!
24862,282,梁清华,2016-05-04 05:36:23,1,3,2,老师很好，全心全意为学生着想，法学基础讲的很好，给分也不错，重要还是自己认真
24908,282,梁清华,2016-05-04 09:33:07,1,4,3,法学基础讲的不错，有案例有分析，还会给链接什么的，认真学会有很大收获。老师还找了刑警给我们讲东西。比较注重平时，给分还不错。
24909,282,梁清华,2016-05-04 09:46:55,-1,3,4,_(√ ζ ε:)_老师很负责
24922,282,梁清华,2016-05-04 10:38:47,-2,3,5,哎觉得不值得
25019,282,梁清华,2016-05-05 01:22:19,0,1,1,好好好
25185,282,梁清华,2016-05-07 08:49:05,0,1,1,事情确实多，烦，但我也因为负责做了很多事情最后得分还不错。总体来说，推荐！
25290,282,梁清华,2016-05-09 09:08:00,1,3,2,职规事情多 但给分也很好～～其实水一水也无大碍，但真正投入进去，用心完成作业，得到的收获是不一样的
25674,282,梁清华,2016-06-01 13:29:43,-1,3,4,每个人都有自己的一套方法啊 老师这么认真负责 讲课也很生动 就算没有好的绩点也不至于骂出一些那样的话把  不晓得说出那话的人素质在哪
25959,282,梁清华,2016-07-03 16:13:15,2,6,4,坚持下来就好啦，，主要是给分很好的
26110,282,梁清华,2016-06-16 00:20:50,2,3,1,骂她的人自重 请表现出一副念过书的样子好么\n\n分数低的人 你扪心自问她布置的作业是不是你都好好做了
26313,282,梁清华,2016-06-17 00:29:50,0,1,1,挺好的，不能水。
26432,282,梁清华,2016-06-27 16:08:23,-1,1,2,不正态的通核，超赞的！一个组四个A一个A+～
26468,282,梁清华,2016-11-26 15:03:17,28,30,2,大一的时候预置了梁老师的思修，那个时候梁老师貌似在学习帝上评分很低，然而一学期上下来可以说自己完全不后悔。老师给我们联系志愿者项目，参加毅行志愿者收获很多，其他的职规书，小组作业也都是很有含金量的，而且并没有微电影这些特别麻烦的事情。老师上课大大方方地谈同性恋问题，努力想把浙大学子状告铁路局的案子放到浙大来公开庭审（虽然最后没能实现）。思修最后给分也是不错的。
26485,282,梁清华,2016-06-19 03:16:12,0,0,0,并不是绩杀！讲得超好！给分也不错啊！
26526,282,梁清华,2016-06-20 01:53:22,1,1,0,法学基础，很有收获，事情的确有点多。每周都有讨论，读书交流会和主题讨论交替，一篇1500字小论文，一篇3000字读书报告，怎么说呢，我觉得还不错，还没出分，只评价课程
26620,282,梁清华,2016-06-20 11:39:56,292,308,16,大一上刚进学校的时候，处处小心翼翼，处处担心，军训、选课、室友、作息等等都要求自己做到极致。当有学长跟我说，“梁清华祝好运”的时候我是想换的，迫于课表不太好动，又有个学姐说“梁清华其实还好”，我就抱着试试的心态留了下来。三节课之后我就庆幸自己幸亏没有退掉她的课。她在课上大方利落、直接露骨地谈同性恋问题，谈快播案，谈淫秽问题，没有一丝尴尬和违和感，而且对各种事实信手拈来；她思修课给我们安排毅行，给我们申请免考，法学基础课给我们找刑警、找法官讲课。而且绩点方面：说她绩点不好的，主要是她平时任务比较多，而且考试比较难，觉得付出和收获不成正比所以抱怨。我15级是她的思修，因为免考全看平时分，我们那个班均绩绝对比大部分思修班高；而且作为通识的法学基础和职业规划，均绩都上了4。这在通识课里是很少见的！当然，如果你要是想一学期八节课水7节课手机，而且想下课之后什么也不做还想要高绩点的就请绕开她。你用心，她就肯定你。大爱梁清华
26842,282,梁清华,2016-06-21 09:15:33,-1,0,1,事情多
27013,282,梁清华,2016-06-22 07:30:28,0,1,1,说能有收获的，想知道你们收获了什么。。。
27135,282,梁清华,2016-06-23 06:50:49,0,0,0,职规事多了点
27156,282,梁清华,2016-06-23 08:44:17,1,1,0,很有收获
28047,282,梁清华,2016-06-28 08:02:14,-1,1,2,只要认真听，必然有收获，学到的都是自己的，给分也很好
28440,282,梁清华,2016-06-28 08:59:53,0,1,1,有意思
28536,282,梁清华,2016-06-28 09:58:04,0,1,1,事多但是都很有用了，法基课还是很好的
28999,282,梁清华,2016-06-29 05:45:27,1,2,1,思修没有期末考哈哈哈。考试周少了很多鸭梨。事不是很多。给分也不错
29589,282,梁清华,2016-06-30 04:25:23,3,3,0,我不管，反正我选上J类课了，hhh
29632,282,梁清华,2016-06-30 05:40:45,-1,1,2,听课不错的
29689,282,梁清华,2016-06-30 07:43:12,0,1,1,上课要听也能听到不少 作业相比其他课是会多些 但法基没有正态！完成作业给分就挺好的
29843,282,梁清华,2016-06-30 11:33:48,0,1,1,法学基础给分还是不错的，就是要看书写点东西，没有期末考也是棒棒哒！
29902,282,梁清华,2016-06-30 13:21:37,1,2,1,活动多，但真心是很好的锻炼机会
30020,282,梁清华,2016-06-30 22:14:04,-1,1,2,有意思\n\n
30116,282,梁清华,2016-07-01 02:50:54,-2,0,2,事多给分坑爹
30182,282,梁清华,2016-07-01 04:48:27,0,1,1,职业生涯规划课，讲的很好，有很多讨论或者分享活动。老师本身也是极认真的人。不过打分是等级制不是百分制，感觉付出的多的和付出的少些的最后得分一样，还是希望老师能改成百分制
30265,282,梁清华,2016-07-01 07:05:54,1,2,1,职规学期学分多的话就千万不要选她的课，最后的职业生涯规划书真的会让你哭的宝宝。这个学低学分感觉上这门课还充实吧~~~绩点低，难道我是水过去的么(´･_･`)
30485,282,梁清华,2016-07-01 16:49:01,0,1,1,法基课确实了解到很多以前完全不懂的东西，也思考很多以前完全不去理会的问题，收获很大！如果关心成绩，是助教打分的，只要完成作业就没问题，因为是等级制，不存在正态。
30745,282,梁清华,2016-07-02 10:57:32,1,2,1,上课稍微有点水，到看你自己要不要，感觉还是能学到一点东西的。而且只有认真完成作业给分还是超棒的。
30981,282,梁清华,2016-07-03 05:40:42,2,3,1,给分超级好 我们组4.5 平时比较忙 但是还不错
31285,282,梁清华,2016-07-03 14:12:41,-1,2,3,非常棒
31332,282,梁清华,2016-07-03 16:15:18,11,11,0,适合认真的人，水学分的人请绕行
31379,282,梁清华,2016-07-03 23:43:05,2,2,0,职业生涯规划有收获，每周都有作业但做好思想准备后发现其实也没有多少。期末的模拟面试和职业生涯规划书好好做，平时作业提交一定看仔细了有没有交成功，满绩很轻松的
32952,282,梁清华,2016-08-18 01:35:25,2,2,0,上了老师的思修课 感觉收获了很多
33119,282,梁清华,2017-01-04 01:45:24,3,3,0,老师很犀利，you are actually learn something.但是她也会经常指出你的不足。
33649,282,梁清华,2016-09-21 00:21:27,3,5,2,至少是一个有现代精神，互联网思维的老师！
33947,282,梁清华,2017-01-16 07:37:03,1,3,2,没有考试蛮不错的哟。
34347,282,梁清华,2016-11-14 08:53:09,2,4,2,无聊的水课，给分差
35259,282,梁清华,2017-03-01 07:56:03,0,4,4,雷厉风行的奇女子，想选法学基础没选上?
35340,282,梁清华,2016-11-08 15:24:09,-7,2,9,事多，自视甚高，课件陈旧。说充实了大学的人真的不是本来自己就是很无趣的人吗？
36228,282,梁清华,2017-01-16 11:34:36,0,4,4,上她的思修觉得很幸运哎！！不用考试~为了我们少一门考试搞试点，全看平时，老师很负责，作为试点班也尽力给我们高绩点~~
36434,282,梁清华,2017-01-17 03:58:42,0,2,2,好老师，有思想，为学生考虑
36767,282,梁清华,2016-11-16 03:03:04,1,1,0,很受启发!
37213,282,梁清华,2016-11-18 02:19:38,-1,0,1,很不错
38495,282,梁清华,2016-12-07 05:56:32,0,2,2,老师真的太棒 认真负责 布置的作业虽然多但是都很有意义 做完很有收获 给分非常好 只要认真做基本都有4.5
39032,282,梁清华,2017-01-03 04:54:33,0,1,1,很深刻，好老师\n\n
39221,282,梁清华,2016-12-21 15:48:26,1,1,0,干货满满！这才是大学生！
39254,282,梁清华,2017-01-19 02:24:55,-1,1,2,不用考试的思修\^O^/
39812,282,梁清华,2016-12-28 01:12:05,0,0,0,虽然事情多但不用考试～事情就是做志愿服务
40174,282,梁清华,2016-12-29 16:14:53,0,2,2,在她身上，我感受到的更多是作为知识分子的社会责任感
40182,282,梁清华,2016-12-30 00:18:36,1,2,1,对这么好的老师就这里分，我觉得相当不合适。老师是十分和蔼可亲的，上老师的课会有很多收获选到就赚到，不要看评分，不要看评分，
40233,282,梁清华,2016-12-30 11:05:13,0,1,1,超级好
40338,282,梁清华,2017-01-03 03:37:08,1,2,1,真的很棒很棒，看重平时\n\n\n\n还好没退她的课，爱她❤️
40406,282,梁清华,2017-01-03 07:29:10,-1,1,2,法基真的超棒！\n\n
40850,282,梁清华,2017-01-06 03:16:17,0,1,1,梁老师，非常好，虽然平时事情可能会比较多，但是认真听收获会非常大，而且到期末的时候你会感谢你修的思修课是梁老师（ps:没有期末考试的思修课）。
41021,282,梁清华,2017-01-08 09:56:42,14,15,1,天哪，这么好的老师。。分竟然不高。。\n\n确实，平时的事情还是有点多了，但是基本是有意义的啊，职业规划是难写，但期末学院的职业规划就不用写了。而且期末没考试，不用背书，真正的课堂教育，多好。\n\n而且分了小组之后，事情分摊一下也不是很多，期末复习的我。。感慨的马上过来给了个10分。
41107,282,梁清华,2017-01-09 07:46:42,0,1,1,美滋滋
41118,282,梁清华,2017-01-16 10:06:03,-2,2,4,给了我满绩
41819,282,梁清华,2017-01-13 01:46:16,1,2,1,超好的老师，听她的课绝对是一种享受。能学到很多的东西，收获不一样的课堂体验。梁老师已经在改变中国的课堂互动方式，选到她的课算你运气好到爆。期末也没有老师，但是志愿服务报告一定要认真做。把书面没有营养的知识变为了志愿服务，多好啊。
41927,282,梁清华,2017-05-02 15:38:41,2,4,2,老师很好，给分看助教
42945,282,梁清华,2017-01-15 13:04:09,-1,2,3,mdzz
43194,282,梁清华,2017-01-16 03:20:17,0,1,1,老师非常认真负责，思想观念非常开放，喜欢梁老师!
43223,282,梁清华,2017-01-16 08:40:58,0,3,3,第一门满绩的课，感人感人，梁老师讲课也棒棒的，点赞点赞
43251,282,梁清华,2017-01-16 04:50:36,1,2,1,付出有回报满了。总比考试强
43293,282,梁清华,2017-01-16 05:33:29,1,2,1,她的思修是我想象中的真正的大学通识课的样子。讲时事 放手让我们自己选题 很包容很开放。没有考试，时间分配得合理的话，事情也没有那么多。
43311,282,梁清华,2017-01-16 06:29:20,-1,0,1,老师超级好，上课很好玩的，很多案例。还可以带我们去五四宪法纪念馆!期末给分也很棒呐。
43312,282,梁清华,2017-01-16 06:29:35,0,0,0,蛮不错的
43313,282,梁清华,2017-01-16 06:30:30,-1,0,1,
43314,282,梁清华,2017-01-16 06:31:02,-5,1,6,只要你认真做 成绩还会下4就去跳启真湖吧
43318,282,梁清华,2017-01-16 06:40:10,0,1,1,打低分的什么心态？？老师超好超负责，上课模式很先进，还带我们出去参观纪念馆。期末考还减轻负担……你还要求什么？？？再次感谢老师助教!!爱你们(ɔˆ ³(ˆ⌣ˆc)
43321,282,梁清华,2017-01-16 06:43:08,1,1,0,超级棒！！能够出去现场教学，志愿服务也让我学到了很多。还可以在别人思修期末考的时候认真复习微积分，老师讲的也不是鸡汤，都是很现实很有用的东西！
43322,282,梁清华,2017-01-16 06:44:19,-1,0,1,好哇啊啊啊啊
43324,282,梁清华,2017-01-16 06:46:39,2,2,0,好，作业多了一点但是有价值，而且没考试。看着他们去考试好爽。
43326,282,梁清华,2017-01-16 06:51:23,0,1,1,老师讲的很好的。而且没有期末考，平时作业虽然有点多认真做还是有收获的。大爱老师，给分很好。
43332,282,梁清华,2017-01-16 07:01:53,12,13,1,梁清华的课才是真正的思修课 这句话是真的 但要细评她的课的话 上课不是很水 也并谈不上很有意思 事情是很多 什么职业规划 志愿报告 论浙大的恶性竞争 就在她的作业上完美体现 总有人比你做的还要认真 5页可以写完的报告偏偏要写20页 只能说付出和回报成正比 想起了学长说的一句话：思修不考试不一定是好事 其实我也不是劝退流 只能说她是一个有风格的老师 最后 绩点不坑（有个长得很帅的室友拿了5.0）\n\n
43334,282,梁清华,2017-01-16 07:05:54,0,2,2,我上的是老师的思修课程，老师讲课很有意思，特别是案例分析很吸引人，平时作业多点，但形式很多样，也都是有意义的作业，用心做真的有收获，第一科满绩.
43339,282,梁清华,2017-01-16 07:10:22,1,2,1,事虽多，给分是绝不会亏待同学们的，思修无期末考试。
43346,282,梁清华,2017-01-16 07:24:41,-1,2,3,老师很不错，敢于尝试教学创新不拘泥于课本教条内容，善于通过身边案例讲解课程内容，注重实践。P.S.出分快，大学第一门满绩，让正在看线代的我有了继续刚下去的力量。
43356,282,梁清华,2017-01-16 07:37:39,-2,2,4,非常愚蠢的听课体验
43357,282,梁清华,2017-01-16 07:38:46,0,1,1,老师给分真是太棒了。不但不用考试。还能有动力体验志愿者。赞
43363,282,梁清华,2017-01-16 07:42:57,0,1,1,美妙！
43367,282,梁清华,2017-01-16 07:49:07,1,3,2,老师是真心好，平时分占100%，授课非常好，重视思想。
43412,282,梁清华,2017-01-16 08:28:44,-1,3,4,梁老师教学水平高的，还会带我们出去参观五四宪法纪念馆，真的是位好老师，感觉她很博学，上她的课真的很有趣！
43417,282,梁清华,2017-01-16 08:45:17,-1,1,2,给分很不错，平时好好做作业是最重要的，傻室友都满绩了
43430,282,梁清华,2017-01-16 09:05:23,0,1,1,。。。
43450,282,梁清华,2017-01-16 09:46:32,0,2,2,老师人超好，助教也好，给分更是好
43465,282,梁清华,2017-01-16 10:05:31,-3,0,3,很棒的老师 但一定别忘了 交作业 否则 下场就是我这样的了。
43520,282,梁清华,2017-01-16 12:11:52,0,1,1,有收获给分好
43660,282,梁清华,2017-01-16 16:55:09,2,4,2,她的课跟鸡汤文似的，可能不管什么老师上思修都差不多。但给分具良心，只要你作业ok，你上课干啥都没事
43682,282,梁清华,2017-01-16 23:07:18,1,4,3,虽然事多，但是没考试啊。只要把事情都好好做了就能拿高分。老师真的是好老师，会有很多收获。
43687,282,梁清华,2017-01-16 23:23:51,-2,1,3,老师的课是有秘密的，很神奇，真的，当其他同学还在拼命复习的时候，哈哈，我们不用，报了老师的课再自行体味
43901,282,梁清华,2017-01-17 05:53:00,-1,3,4,给分超级好的，思修平时四个大作业，没有期末考\n\n
44327,282,梁清华,2017-01-17 15:12:15,0,3,3,上课真的有意思，实践活动也很有意义，最后也没有考试而是交报告，虽然最后被正态但还是强推梁老师的课~
44504,282,梁清华,2017-01-18 01:53:45,0,1,1,很认真的老师，喜欢～
44519,282,梁清华,2017-01-18 02:19:48,1,2,1,非常好\n\n
44911,282,梁清华,2017-01-18 13:14:53,3,6,3,力推梁老师，没有期末考试虽然还是有正态。。。但是在考试周里面少一门闭卷考试的科目是多轻松的事情啊！只要平时作业好好做，分不会低。秋冬学期各一次研究性作业，三次课堂讨论，期中读书报告加期末志愿服务报告。其实也不算多啦，好好做，好好展示，我每次都A，绩点4.5，作为一名理科生，思修居然最高。。。平时本来就不是很忙，而且作业时间给的也非常充足，期末作业开学就布置了，什么时候写都可以啊还没有字数限制，如果真的嫌事情多那也没办法了。。。
46510,282,梁清华,2017-01-22 01:33:04,1,3,2,点名提问有点点恐怖，其他满满都是爱。上的思修，因为是试点班所以没有考试，志愿服务报告算期末成绩。平时任务相当不轻，如果你是你们小组的笔杆子担当就要做好一定准备，不过好好写，写长长长，抓住机会做展示不要羞涩刷存在，给分也会很喜人的。老师虽然看起来有点严肃，不过其实超级超级好，上课也很有实料，从来没想到思修法基能学到这么多有用的东西，很享受。
46731,282,梁清华,2017-01-22 08:38:56,1,2,1,期末不考试，代价是平时事比其他班多。主要就是职业探索，读书报告，志愿者和一些小组作业，整体来说还是可以接受的，毕竟少一门考试也是好事。平时作业给分也不低，所以最后均绩会比其他班高一些。总体而言还是比较推荐吧
47366,282,梁清华,2017-01-25 12:44:21,-11,1,12,给分差 瞎搞正态 差评
47763,282,梁清华,2017-02-24 02:51:31,2,2,0,真的是个好老师
48116,282,梁清华,2017-02-28 13:59:26,-1,3,4,如果你上了她的思修课改班，不要慌！有可能是机遇！梁老师上课很有启发，让你对思修刮目相看！虽然作业要求多，但是把每次（是每次哦）作业都认真完成拿到好成绩真的不难！真的！
48908,282,梁清华,2017-03-16 04:10:53,0,1,1,感谢梁清华老师让我认识到了何为真正的思修教育
50224,282,梁清华,2017-05-01 13:34:07,4,5,1,法基课不错，均绩很高。但是我认真对待却成绩一般。想不通
50269,282,梁清华,2017-05-02 05:42:44,0,2,2,法官进课堂真的很有意思，老师平时上课也很风趣，会找时事进行案例分析和讨论。虽然平时任务有点多，但也不离谱，小组讨论收获也很大。更别说给分也超级棒。
50425,282,梁清华,2017-05-03 00:47:34,1,1,0,觉得很棒！
50474,282,梁清华,2017-05-03 05:47:45,0,0,0,上了职业生涯规划课，还算有收获吧，不会强制你做事情，不过都做了感觉最后的成绩都不会差。
50648,282,梁清华,2017-05-04 05:03:08,1,1,0,老师的法律基础讲的很好，认真做的话绩点不会差
50744,282,梁清华,2017-05-05 00:44:36,1,2,1,J类的职业生涯规划，带着你把规划书的绝大部分都做了，感觉真正学到了东西。因为听室友说她作业多所以做好了心理准备，但其实真的没多少，每周的半个小时以内就能搞定。规划书认真做，模拟面试好好准备，我是满了的
51057,282,梁清华,2017-05-15 13:01:30,-1,0,1,求已经上过这门课的大佬给建议。???
51218,282,梁清华,2017-05-24 12:07:05,0,0,0,很庆幸选了这门课，、老师很负责很用心，平时作业认真做，真的很有收获啊
51290,282,梁清华,2017-05-27 13:18:09,1,1,0,明明花了很多心思做法基作业，找资料，上台展示，甚至还问了法学专业的同学。最后给分实在对不上自己的努力。真想去问问差在了哪里!不过话说回来，整体均绩还是很不错的。
51426,282,梁清华,2017-06-05 10:42:48,0,1,1,很棒的，干货满满\n\n
51681,282,梁清华,2017-06-08 08:55:41,1,1,0,事多，但认真做真的有收获！
52763,282,梁清华,2017-06-22 13:59:23,2,3,1,觉得老师怼人有点随意，欠沟通。
53121,282,梁清华,2017-06-26 02:55:37,-1,0,1,老师很不错的，负责任，关心学生，很为学生着想，不过事情很多，如果你不希望事情多的话，慎选，真的慎选。
53157,282,梁清华,2017-06-26 05:25:42,-15,2,17,满绩路过……
53789,282,梁清华,2017-06-27 14:22:00,0,0,0,老师认真尽责，专业认知优秀，而且为学生考虑
56559,282,梁清华,2017-07-04 03:35:04,4,8,4,一门职规每周都要花半天时间写作业？事实在这里就是这样的，要选这门课的注意了，如果你感觉周末时间花在专业课上更重要，这老师请果断跳过。我已经不想说什么了，对于以专业课为中心的我来说，这种课简直占用我专业课复习时间。
58945,282,梁清华,2017-09-18 16:31:57,0,1,1,不错 感觉在思修
59315,282,梁清华,2017-09-21 00:22:50,2,3,1,事太多
59377,282,梁清华,2017-09-21 05:35:10,2,3,1,很认真，很有思想。
60948,282,梁清华,2017-11-04 16:14:13,0,1,1,挺好的 收获多  但是事情确实不少
61955,282,梁清华,2017-11-22 02:31:11,3,4,1,很温柔的老师，娓娓道来，对待事物观点和态度很正不偏激\n\n
62861,282,梁清华,2017-11-27 07:22:18,1,3,2,课上得不错，也没期末考试，就是事情贼多
63060,282,梁清华,2017-11-28 05:39:39,1,1,0,不仅是上课，考核方式也是很好的
63719,282,梁清华,2017-12-13 11:36:15,-9,2,11,破事真多
64281,282,梁清华,2017-12-22 08:01:15,-1,0,1,梁老师上课非常好 下课的小组讨论也非常有趣 挺喜欢她的风格的
64941,282,梁清华,2017-12-28 04:07:47,0,0,0,很有意思的课
64958,282,梁清华,2017-12-28 05:09:38,8,9,1,我玩一会手机就觉得玩不下去了，还是听课有趣.
65417,282,梁清华,2018-01-03 17:31:54,1,1,0,没理由不给满分，好老师，不用解释。
65439,282,梁清华,2018-01-04 02:53:27,2,2,0,哈哈好
65781,282,梁清华,2018-01-09 06:03:35,0,1,1,好好好好好好
65993,282,梁清华,2018-01-11 01:12:23,5,6,1,之前总觉得老师事情好多，但是现在看看，一个能够容忍三观歪掉的同学的大言不惭和给扁桃体发炎的同学送药的老师还是不多见的。
66473,282,梁清华,2018-01-17 02:14:04,2,3,1,好老师 真的好老师 不给满分心里过意不去
66603,282,梁清华,2018-01-19 07:24:25,8,8,0,梁老师的思修课特别棒尤其是法律那一块，讲的很有见地。\n\n课程压力不能说小，但也不大，最重要的是让人很有收获。特别是职业生涯规划，认认真真做了以后会对自己和未来有很清晰的认识。志愿者和书评认真做，最后成绩不会差的。给梁老师打call哇⊙ω⊙
66672,282,梁清华,2018-01-18 06:11:06,3,3,0,大爱梁清华~
66799,282,梁清华,2018-01-19 06:03:34,-4,1,5,虽然作业比较多，但是老师讲的很好，作业也很有意义，人生第一个满绩，开心
66810,282,梁清华,2018-01-19 06:52:26,14,14,0,要是我大学的老师都能像梁清华一样认真负责、讲话不讲废话，切身关爱学生，有独特帅气的观点，不爱点名，爱给高分…就好了
66811,282,梁清华,2018-01-19 06:53:21,5,5,0,梁老师超级好，平时作业虽然比其他班多但也不是特别多，而且期末不用考试，这点真的超赞，认真完成老师的任务给分也超赞！大爱ヽ(*´з｀*)ﾉ
66817,282,梁清华,2018-01-19 07:07:59,1,1,0,挺棒的，给分也挺好
66820,282,梁清华,2018-01-19 07:16:59,1,1,0,虽然平时事多了点，但是很有意义，上课讲课也很有趣，很棒的老师。
66824,282,梁清华,2018-01-19 07:20:41,18,18,0,是真正的思修课，通过志愿者活动懂得了很多。梁老师上课随便大家听不听，但其实我们还是听得很认真的，说是平时事多，但其实感觉也还好，而且老师会在一月初把所有事情弄完，完全不影响考试周，超棒！最后4.2还算是可以的成绩吧
66827,282,梁清华,2018-01-19 07:21:30,13,13,0,好老师！真的好老师，三观正，课上内容认真听还是很有意思的，平时作业虽然稍微多点，但是不用考试啊！而且给分超好！拯救了我的绩点！梁老师女神不解释
66829,282,梁清华,2018-01-19 07:22:31,3,3,0,好老师 给分好
66832,282,梁清华,2018-01-19 07:25:08,2,2,0,分好课堂有趣事情多但是能接受
66836,282,梁清华,2018-01-19 07:26:03,4,12,8,梁清华爸爸……翘了无数节课……但还是给满了……
66837,282,梁清华,2018-01-19 08:37:37,18,19,1,我觉得就老师这个人来说，她给人的感觉是十分舒服的。虽然自己平时大多都在水课……不过像是职业规划志愿服务报告等大作业都还是认真去完成了的。尤其是志愿服务报告吧，真的还是给了自己很多机会和体验的。我并没有选择最后的什么个人展示，平时也没有什么发言，一开始觉得不期末考试有点虚，不过至少现在成绩出来了还是不错的嘛。
66842,282,梁清华,2018-01-19 07:29:38,1,3,2,老师很负责很好 带我们去宪法博物馆参观 课堂有意思 给分好
66843,282,梁清华,2018-01-19 07:29:55,5,6,1,超棒的老师，虽然我不是很喜欢思政课，但老师讲得特有意思，原本还担心自己被正太，没想到竟然有4.2，激动！！！
66847,282,梁清华,2018-01-19 07:30:54,13,13,0,没有期末考，给分高，只要平时分都基本拿到，小作业认真去做。课挺有意思的，老师人又很有意思，上课水一水也无大碍，重视志愿服务，只要不浪，稳稳的高绩点。
66848,282,梁清华,2018-01-19 07:34:07,0,1,1,虽然事情有点多，但是真的很棒，感觉看清了很多东西吧，有了目标吧，最重要的是没有考试哈哈哈谢谢老师o(^o^)o
66851,282,梁清华,2018-01-19 07:38:11,19,19,0,没期末考，平时事情略多，但也不会比其他班级多到哪里，本来觉得要被正态，但最后竟然有4.2，很惊喜，本来还想选老师的职规课来着，可惜没选上，唉唉唉，好老师
66854,282,梁清华,2018-01-19 07:39:36,1,1,0,超棒给分也很好
66861,282,梁清华,2018-01-19 07:46:08,0,1,1,上课可以不听的其实。。。平时作业虽然多但是好好做就没问题
66862,282,梁清华,2018-01-19 07:47:52,1,1,0,虽然不考试，但是老师还是讲课很认真，认真听还是很有收获的。
66863,282,梁清华,2018-01-19 07:48:43,6,6,0,要真觉得平时事儿多，那可能是同学真的连这门课都不想去上吧。梁老师的思修课本来就是不考试的，我觉得留一点作业也没什么。
66864,282,梁清华,2018-01-19 07:49:41,2,2,0,平时是事情虽然多，但是都是些极有意义的志愿者服务之类的，而且期末没有考试，给分超级好
66866,282,梁清华,2018-01-19 07:51:52,2,2,0,太好了\n\n
66868,282,梁清华,2018-01-19 07:52:02,2,2,0,真的很好
66869,282,梁清华,2018-01-19 07:55:32,0,1,1,大爱梁老师！
66871,282,梁清华,2018-01-19 07:56:43,1,1,0,好老师，负责任，给分好，力挺！！！
66872,282,梁清华,2018-01-19 08:00:04,1,2,1,给分很好
66877,282,梁清华,2018-01-19 08:06:57,3,3,0,梁老师的课真的很有意义，我们是实验教学班的，就没有很多的理论，志愿活动也做了很多，给分也超好！很幸运选到了老师的课
66878,282,梁清华,2018-01-19 08:09:11,-1,1,2,老师会讲很多事例，上她的课也不会觉得无聊，给分也非常好。
66880,282,梁清华,2018-01-19 08:18:36,4,4,0,emmm很客观的说，平时事情比较多，让你大一的上学期非常非常充实。上课讲的还可以，没有期末考试。
66882,282,梁清华,2018-01-19 08:20:54,3,5,2,老师很棒，平时事不多还不用考试，有个好的组长轻松4.5
66885,282,梁清华,2018-01-19 08:22:12,4,6,2,老师讲课内容很丰富，试点班不考试通过志愿服务来实践教育我认为很好！没想到自己大学第一门满绩是思修！
66887,282,梁清华,2018-01-19 08:23:10,2,6,4,人生当中第一次满绩 都没有考试的 老师超棒!
66889,282,梁清华,2018-01-19 08:24:00,1,4,3,没有期末考，给分也很好啊。上课很有趣的，你认真听会收获很多的。我上课就背背英语单词，水水手机，还给了我挺高的分数。平时小作业挺多的，但都很有意思，只要你认真写了就没多大问题了。
66890,282,梁清华,2018-01-19 08:24:28,5,6,1,平时有很多的活动，像职业生涯规划，志愿者服务，小组讨论，写法律故事……很充实，老师的课也很有趣。虽然平时会累点，但是是没有期末考的。上课也可以自修，只要平时认认真真做。给分也很棒，满绩哦。
66895,282,梁清华,2018-01-19 08:32:16,0,3,3,梁老师真的超棒啊，不仅没有期末考试，而且给分超级好，也是人生第一个满绩啊，感觉好几堂课没有好好听有点对不起老师，主要还是在赶别科的作业，绝对不是老师讲的不好，课堂是很有趣的，还有优秀学长学姐送经验，红会培训，禁毒大会，内容很丰富啊！
66896,282,梁清华,2018-01-19 08:33:44,3,4,1,真的很棒的老师，虽然没有期末考，但是真的希望大家能认真听听老师的课，老师真的很棒啊。
66897,282,梁清华,2018-01-19 08:34:22,2,4,2,上课没咋听 作业不应付 绩点4.2 不考试真的非常舒适
66899,282,梁清华,2018-01-19 08:36:58,3,4,1,梁老师真的很不错!如果只是进行期末考试的话思修课就几乎学不到什么真的东西了。但我通过完成她布置的研究性学习与志愿服务报告收获了许多。绩点也很高，感谢梁老师!
66900,282,梁清华,2018-01-19 08:38:32,4,4,0,好老师，助教也很棒。虽然平时事情有点多但是看别人期末考我们不用考。而且给分还很高，估计比其他老师要高吧？
66902,282,梁清华,2018-01-19 08:44:41,0,1,1,老师很好，课程内容很充实，很庆幸选上她的思修班，志愿活动法律研讨，这才是真正的思修。绝对优秀，满分！
66907,282,梁清华,2018-01-19 08:57:17,-2,1,3,认认真真做志愿者，报告写了别人的三倍字数，给了个均绩，喵喵喵？
66908,282,梁清华,2018-01-19 08:59:25,1,2,1,虽然事情多了点，但没有期末考试和给分很好。真的很nice！为她打call～
66911,282,梁清华,2018-01-19 09:08:59,-1,1,2,免考政策真的很好，真的是为了学生着想，虽然事多了点，但是给分还挺不错的。10分
66913,282,梁清华,2018-01-19 09:12:48,0,1,1,超级棒
66916,282,梁清华,2018-01-19 09:27:25,3,3,0,老师太赞啦 出成绩超级快 平时任务会有点多 但是都不难做 期末没有考试还是很棒哒
66919,282,梁清华,2018-01-19 09:53:59,0,3,3,老师上课很好，不过恶竞很累/微笑中透露出一丝疲倦.jpg
66924,282,梁清华,2018-01-19 09:51:24,-6,1,7,人生第一个满绩 但觉得平时不是很认真(๑•ั็ω•็ั๑) 老师太赞了!!!
66929,282,梁清华,2018-01-19 10:06:09,12,13,1,？自觉什么都没少做 绩点低 求大佬不秀
66930,282,梁清华,2018-01-19 10:10:48,1,1,0,老师的课挺生动的，挺有意思的，还有各种活动，有学长学姐经验分享，特别好
66933,282,梁清华,2018-01-19 10:24:59,-8,2,10,给分超级棒，第一次满绩
66934,282,梁清华,2018-01-20 12:12:47,2,2,0,老师讲课很用心，上课气氛很活跃，很有趣，平时作业不是很多，认真就有收获
66938,282,梁清华,2018-01-19 11:07:55,3,3,0,好老师，有收获
66944,282,梁清华,2018-01-19 11:43:26,4,4,0,期末没有考试，重在平时表现
66945,282,梁清华,2018-01-19 11:44:05,2,2,0,绝对好老师
66946,282,梁清华,2018-01-19 11:46:37,1,1,0,zsbd
66949,282,梁清华,2018-01-19 12:00:58,11,14,3,怎么说呢。我想很负责地来评价一下这个老师。\n\n如果你觉得讲道理思修就是门水课，请绕开她，再次提醒，绝对绕开她。因为事情真的非常非常非常多，超30小时志愿服务、一般恶竞到六千字的职规报告、四五千字志愿服务报告、七八千字小组讨论作业、偶尔写些小论文、小课题，事情有时候多到我真的不想上了。\n\n课到底如何，可能每个人有不同感受，但是有一点，老师很负责，传达出来的思想很正，讲法律那块很有意思，会给你讲很多案例和故事。除此之外，出分很及时，没有期末考试。\n\n如果你这些都好好做（ejing）绩点不会低。\n\n所以是否要选这个老师，请自行权衡，希望每个人都遇到自己喜欢的老师。
66956,282,梁清华,2018-01-19 12:32:48,-1,3,4,老师上课超有意思，讲课很好，上课可以干自己的事情，任务还可以，给分超级好，没有参加展示但还是收获了人生第一个满绩，为人气女神打call
66963,282,梁清华,2018-01-19 13:02:39,1,2,1,很好的老师，不懂为什么有人黑，这学期事情可能比起其他思修老师会多点，但是其实讨论报告什么的认真做就不会低分，而且不用考试呀
66970,282,梁清华,2018-01-19 13:11:46,10,11,1,我们这个班是用期末志愿服务报告来代替考试的。个人觉得这样的收获其实比考试要大（室友也有参加考试的，我有和ta交流过），而且因为我这个学期认认真真地做过几个志愿服务项目，还当过负责人，所以觉得志愿服务报告很好写，最后分给的也挺高。
66971,282,梁清华,2018-01-19 13:14:23,2,2,0,良心老师，给分完美
66973,282,梁清华,2018-01-19 13:17:39,2,2,0,老师给分超好！虽然平时事情有点多，但是考试周没考试啊！
66982,282,梁清华,2018-01-19 14:21:49,9,9,0,是我到大学第一门真心喜欢的课。老师虽然不年轻，但是思想与时俱进，不会端长辈的架子死板地看问题。讲的案例都很有趣来自现实生活，三观也很正。跟学生交流也是非常有趣。尽量别在课上水手机，这样有趣又有深度的课不多。
66987,282,梁清华,2018-01-19 14:47:54,-1,3,4,梁老师的思修课真心不错，虽然事情有点多，但一件件认真做下来收获都是自己的，关键是没有考试哈哈哈～满绩飘过
67006,282,梁清华,2018-01-20 01:03:16,4,4,0,很喜欢的一位老师
67019,282,梁清华,2018-01-20 03:15:59,5,5,0,讲的很有水平的
67021,282,梁清华,2018-01-20 03:48:31,-6,1,7,给分迷?
67050,282,梁清华,2018-01-20 07:08:31,3,3,0,思修：等到考试周才发现少一门思修是多么令人喜悦的事，而且如果真的全身心投入志愿、发自内心地喜爱这份事业的同学，其实选择梁老师的课真的是太明智了。因为思修试点班反而给予我们更多志愿服务的机会，很开心。平时事情是略多，而且并非每一件都真正有收获。(但死记硬背思修书收益也不是很大吧)老师思想挺好的，不过上课并不是很有趣。以及，有些同学的恶竞现象真是令人无奈。自认为对待每一个任务都非常认真，绩点还行，但自以为应当更高。可能是我不太擅长恶竞和主动刷脸吧。但这不影响我对于老师的评价。
67055,282,梁清华,2018-01-20 07:27:38,0,1,1,至少期末不用考试啦，都说平时作业比较多，但是其实还好，就每个短学期一次大作业，其他都是讨论的东西了，上课不定时点名。但是讲的东西都很好哦，虽然我经常水水过了。。。
67128,282,梁清华,2018-01-20 10:06:56,0,1,1,老师讲得很好，也很幽默，收获很多\n\n
67151,282,梁清华,2018-01-20 10:34:35,1,1,0,梁老师人挺好的啊，上课会开小玩笑，很前卫，虽然事情有点多，但是没有期末考，给分超好的，还给我们提供志愿者服务的机会。
67152,282,梁清华,2018-01-20 10:36:49,1,1,0,试点班给分真的很好，感觉满绩很多啊
67210,282,梁清华,2018-01-20 12:57:21,1,2,1,事少，有意思，老师特别有学问
67281,282,梁清华,2018-01-20 14:55:07,2,2,0,偶尔点名。这学期大概两三次。期末不考试，以志愿服务报告作为结尾。感觉不错啊，老师给分也挺好的，推荐o(≧v≦)o
67288,282,梁清华,2018-01-20 15:09:44,2,2,0,上课内容很吸引人，很好的老师
67343,282,梁清华,2018-01-21 01:24:50,3,3,0,期末不用考试，但是平时作业是要多一些。偶尔会点名哦。
67408,282,梁清华,2018-01-21 06:33:37,2,3,1,不水 有收获 给分好
67421,282,梁清华,2018-01-21 07:15:54,-3,1,4,棒！满绩！开熏！
67473,282,梁清华,2018-01-21 09:35:09,1,2,1,老师很认真，负责，总体感觉良好
67577,282,梁清华,2018-01-21 14:44:43,2,2,0,收获很大!思修不用考试，福利好大!平时的任务认真做，事情也不算很多，做起来还是挺有意义的!给分也更好！上课讲的比较有意思，也可以水一水，非常不错!
67637,282,梁清华,2018-01-22 03:03:57,0,3,3,很好的老师，拿到了大学里的第一门满绩，对社会现象的评价也很客观，听她的课很有收获。
67745,282,梁清华,2018-01-22 06:26:35,2,3,1,很理性的老师，分析问题客观公正。给分很不错，只要作业认真完成绩点就不会低。
68149,282,梁清华,2018-01-22 15:45:04,3,4,1,老师，我喜欢志愿者服务报告，但是不喜欢职业规划报告，医学生的痛……给分真好，但有恶竞，建议上课还是要发言，尽管不加分，记住你就是4.5+啦。
68269,282,梁清华,2018-01-23 02:08:53,1,2,1,老师挺好的? \n\n很喜欢 \n\n给分也很好\n\n平时上课没发过言\n\n绩点也有4.5
68381,282,梁清华,2018-01-23 05:37:30,0,1,1,老师是典型的独立有主见的新时代女性，尊重每一个人的发言，带大家去宪法陈列馆实地教学，取消期末考试等等，课外作业学到了很多。
69146,282,梁清华,2018-01-24 09:00:25,-1,1,2,期末不考试，看上去作业多其实还好，课堂内容有意思，认真完成作业积极展示分不会差的，组里两个满绩3个4.5呢。
69202,282,梁清华,2018-01-24 10:02:18,0,2,2,感谢老师！水了一学期的课！没有认真听过一节课！小组讨论体验极差！只做了一次志愿服务！期末志愿服务报告认真做，绩点依然上4！
69681,282,梁清华,2018-01-25 08:08:16,0,2,2,梁老师课讲得很好，给分也好。她的课程趣味性很强也不用期末考试，平时事有点多但也不是很多。而且老师的作业从来没有字数要求。\n\n而且老师人很好。\n\n说梁老师的事多的，你怕是没有上过鲁老师的管理学吧？\n\n老师是真的好，能在她的班上学习是幸运的。只有认真一定会有好报的。
70011,282,梁清华,2018-01-26 03:03:10,1,2,1,大爱梁清华老师，女神！上课真的不错，大家少水手机，法律故事挺多的，老师很有个性。
71423,282,梁清华,2018-01-28 12:05:55,-1,1,2,虽然平时事情比较多，但是给分挺好的。上了一个学期的课，我真的收获了很多。浙大的最好的老师之一。
71762,282,梁清华,2018-01-29 02:50:05,-3,2,5,老师超级超级好，认真写写作业会有满绩，事也不是特别多
71889,282,梁清华,2018-01-29 05:08:43,1,3,2,有付出就有回报，你的努力老师会看在眼里，志愿者也是很好的体验，我是我们小组的组长，我们组两个5.0，最低4.5，大家平时都很积极，用心做了就不会差，表白老师，笔芯~~
73629,282,梁清华,2018-02-02 06:55:34,3,3,0,事多是真的，不过收获很大。不是那种课本里的知识点而是一种领悟，反正不考试记什么知识点嘛。给分正常，作业不要水水过成绩不会低的。
73759,282,梁清华,2018-02-03 05:12:17,0,4,4,一节课都没认真听过，平时从不发言，只做了一次志愿服务，上课就是水手机。挺无聊的，枯燥无趣，小组内也特不默契没有配合。我很佩服这位老师，但课程内容和部分作业真的让我提不起兴趣。期末志愿报告认真写了还是有4.5。ez
73799,282,梁清华,2018-02-03 06:12:00,9,10,1,如果你思修选上了这个老师，那么恭喜你!点名一学期只点那么一两次，而且最重要的是，没有期末考试！！！但如果要高绩点的话平常就要多回答问题（会有记录），有展示就多上去做展示，小组合作的工作最好找靠谱的同学组队，因为会有很多次小组讨论的主题。主要的大作业就是职业规划、志愿者服务报告了，还有数次课堂小作业（类似于画图、问问题之类的）。我觉得只要平常认真做了，经常上台混个脸熟，都是OK的。像我们组，基本每节课都回答问题，最后的课堂展示几个人都上去了（老师已经知道我们的名字了）然后我们组的绩点都4.5hhhh
74161,282,梁清华,2018-02-06 02:53:04,2,4,2,事情很多，如果作业认真做，给分很好
74468,282,梁清华,2018-02-27 00:21:41,4,5,1,老师真的超级好啊，让我们学到了很多知识。平常作业虽然略多，但是认真去做就会有很多收获，很幸运能选上老师的课。
75202,282,梁清华,2018-03-08 02:55:17,3,5,2,大一的时候上她的思修 当时叫苦不迭 现在回头看看 其实真的还不错 给分也好
75568,282,梁清华,2018-03-13 10:59:42,-5,4,9,所有的课都水，期末志愿报告认真做照样上四。我很佩服老师但是课堂无趣，作业量不多但是让人没什么做的积极性。
76387,282,梁清华,2018-04-06 11:11:38,3,3,0,在咯系咯咯
77089,282,梁清华,2018-05-02 00:28:26,6,6,0,老师人超棒呀(=^▽^=)，上课很有节奏感，就是一个组必须坐一起感觉好尬...
78130,282,梁清华,2018-05-09 12:32:20,-28,3,31,思修为什么那么多4.5。5.0的啊，不用正态吗......，我4.2，拉低均绩了，果断差评
78251,282,梁清华,2018-05-10 07:44:54,2,3,1,很好的老师
78347,282,梁清华,2018-05-11 04:08:06,4,4,0,梁清华老师务必了解一下(σ･ω･)σ
78485,282,梁清华,2018-05-12 09:14:27,1,1,0,收获非常多，在一定程度上能够帮助我们全方面认知自己。
78628,282,梁清华,2018-05-14 03:29:23,1,3,2,给分迷
78639,282,梁清华,2018-05-14 05:46:57,4,5,1,认真做收货挺大，多做些组长队长什么的，很看重志愿者活动，付出和汇报是成正比的，最后5.0，小组全体4.5以上！\n\n笔芯老师ヾ(❀╹◡╹)ﾉ~很有思想
78680,282,梁清华,2018-05-14 11:36:52,7,9,2,酣畅淋漓，思维的碰撞，收获满满。老师的任务虽然比较多，但真正用心去做，在完成任务的过程中自己也收获了很多。课堂上关注老师的内容，能感受到老师的落落大方及真诚真实，连着老师的思修，法学基础，职业生涯规划一起上了，十分享受她的课堂。
79250,282,梁清华,2019-01-16 06:02:53,-57,3,60,可太垃圾了
79649,282,梁清华,2018-06-12 09:34:29,2,2,0,思修最好老师吧。没考试，给分好
79775,282,梁清华,2018-06-13 12:26:17,2,2,0,非常非常好的一个老师，选完了她的三门课，简直完美，喜欢！！！！！
85480,282,梁清华,2018-07-18 09:37:41,2,2,0,老师很负责
86500,282,梁清华,2018-09-17 02:08:58,3,4,1,为毛我们这届开始又志愿活动又考试
86628,282,梁清华,2018-09-17 13:37:24,0,1,1,非常的爽
86785,282,梁清华,2018-09-18 23:42:30,1,1,0,老师超慈祥，听她的课很舒服，很快乐
86832,282,梁清华,2018-09-19 03:24:16,3,3,0,很好的老师，学到很多\n\n
86951,282,梁清华,2018-09-19 13:53:01,1,3,2,好负责 好温柔 喜欢
86960,282,梁清华,2018-09-19 14:57:28,2,2,0,是个真性情的人
87411,282,梁清华,2018-09-28 10:48:11,9,9,0,很认真负责！很认真负责！很有思想！很有思想！想着法子让学生真正能够“受教育”而不是单单学习具体的学科知识。很为学生着想，很有行动力曾经努力把法庭搬进学校让学生体验法，想带学生去参观法院和戒毒所(๑>؂<๑）\n\n关键是力推取消期末考，不想给学生增加不必要的负担，可以说很贴心了！
87482,282,梁清华,2018-09-29 12:12:44,0,1,1,真舒服啊
87698,282,梁清华,2018-10-10 07:09:27,1,1,0,绝对不后悔！
87869,282,梁清华,2018-10-16 10:33:56,5,5,0,梁清华老师真的超级好！思修课最佳老师无疑！上课绝对不会打瞌睡！
88219,282,梁清华,2018-12-03 16:13:29,11,12,1,灵魂有香气的女子
88709,282,梁清华,2018-12-13 10:38:26,11,11,0,很有思想，严于律己，关心社会，思想比较开明。她的课很有意义，但是，作业是真的很多(与上其他老师思修课的室友相比)
91580,282,梁清华,2018-12-14 03:29:47,2,2,0,虽然我没听课 但是免考是真好
91921,282,梁清华,2018-12-25 02:49:14,3,4,1,认真负责到极致，还会听取同学意见!必须赞!
92299,282,梁清华,2018-12-27 14:12:55,4,4,0,付出很多\n\n有的时候有些理想化\n\n但是在现在这个世界也是很难得了
92373,282,梁清华,2018-12-28 05:45:18,6,6,0,很有收获，没有考试，说实话积极完成老师布置的任务比考前背书收获多得多。
92383,282,梁清华,2018-12-28 07:11:29,9,11,2,梁老师的作业量算不上多，都会提前很长时间布置，认真做的话收获很多，合理分配下时间，完成作业还是轻松的。\n\n思修是大一上的最好的课之一了，没有期末考试的压力，平时课堂干货满满，希望有所收获而且态度认真的同学一定不要错过呀。
92593,282,梁清华,2019-01-03 05:14:16,7,8,1,真的是想让学生能够学到东西的好老师
92859,282,梁清华,2019-01-08 08:40:59,10,10,0,老师是真正的师者
92964,282,梁清华,2019-01-16 06:50:05,8,9,1,老师授课好，有价值，给分高！\n\n
93295,282,梁清华,2019-01-09 01:28:17,27,29,2,不明白楼上两位为什么要骂梁老师，你们好歹是浙大的学生啊，就这么高分无德？没素质？匿名评价就是让你们无所顾忌地骂老师？不说梁老师不要你做问卷发红包，读书报告，职业规划，志愿者活动报告还都不限字数，还不用考试，已经够好了，还不满意？讲课又讲得好，哪这么容易遇到这样的老师。真为你们感到羞愧！
93302,282,梁清华,2019-01-09 02:26:40,17,18,1,梁老师真的是我遇到的最人性化的老师，听她的课就能感受到梁老师每节课都非常认真的讲，而且顶着压力为我们申请免考，非常感动！
93919,282,梁清华,2019-01-19 11:47:04,24,26,2,每次拿着线代微积分过去，都会因为听课而放下手中的笔和手里的书。
94257,282,梁清华,2019-01-16 05:03:00,8,9,1,幸运地选上了她的思修。她超级好！平时作业除了职业生涯规划和志愿服务报告以外和其他老师差不多，而这两个作业（开学初就布置了）布置得很有意义，我们应该本着对自己的人生负责而不是对思修课绩点负责的态度来完成这两个作业。此外，她上课也很精彩，关于人生还有法律那一块讲了许多真实时效性强的例子，讲课贴近生活，也擅长和同学们互动。最后，她上课很宽松允许同学做私活。
94261,282,梁清华,2019-01-16 05:28:16,3,3,0,啊啊啊课上的好人也好绩点还高真的(//∇//)
94263,282,梁清华,2019-01-16 07:12:20,16,19,3,超级好的老师，感觉平时作业也不多啊，除了职业生涯规划和志愿者报告也没有多少作业，而且感觉也不是很难写，免考，绩点高，很好的老师。\n\n
94264,282,梁清华,2019-01-16 05:34:46,3,3,0,事情多，给分好，但让我们做的事情都挺有意义的，上课也挺有意思，课堂无处不在，最重要的是没有考试！\n\n
94265,282,梁清华,2019-01-16 05:35:41,4,4,0,老师的课真的很棒！
94267,282,梁清华,2019-01-16 05:36:40,4,6,2,事虽有点多，但绩点感人，且不用考试。
94268,282,梁清华,2019-01-16 05:36:44,7,7,0,老师上课超级有趣，给的案例特别好，十分有趣！！！\n\n平时小组讨论很多，报告有点多，但是给分好\n\n能学到很多东西，果断满分
94269,282,梁清华,2019-01-16 05:37:01,5,6,1,啊啊啊啊啊我真的爱死梁老师了。梁老师的课，其实你想水也可以水，只要不翘课，认真听讲的话也会收获很多。平时的事情也不是很多，但是因为免试要交的作业还是认真对待！最后给分真的超级高！
94270,282,梁清华,2019-01-16 05:38:54,1,2,1,真的棒！
94271,282,梁清华,2019-01-16 05:39:14,8,8,0,培养的真的是思想
94273,282,梁清华,2019-01-16 05:40:17,2,3,1,老师真的很棒，绩点一出马上过来。老师上课讲的课真的很好，而且整个学期有教学实践。我去了法院旁听，看了一个完整的流程。老师讲的课都很用心。\n\n个人比较喜欢老师讲课时候举的例子，比较容易理解。\n\n这学期的课我懂了很多，超级感谢老师的。
94274,282,梁清华,2019-01-16 05:42:44,5,5,0,老师人超好！是个非常注重实际锻炼的老师，取消考试把比重加在志愿者服务上真的很人性化很有想法了。平时有很多很有意思的活动，参观监狱、戒毒所，带学生去法庭听审，请优秀学长来分享，收获满满。
94275,282,梁清华,2019-01-16 05:43:13,2,2,0,老师人超好上课有趣给分也超好哇，能选上老师的课真的是一种幸福！！！
94276,282,梁清华,2019-01-16 05:43:25,10,10,0,！老师真的超好！\n\n总之，我是整个寝室唯一一个能听进去思修课的人，因为老师讲的真的很有意思！更何况老师还有很多很多实践课，比如去戒毒所参观之类的～\n\n所以我一节梁老师的思修课都没有翘过～每一次作业也都很用心地做了～\n\n真的真的收获很大，真的真的很感谢老师～\n\n在这个别人都准备去考试的时候，发现自己的思修满绩了～\n\n对于我这个小菜鸡，在考试周欲哭无泪的时候，真的是莫大莫大的安慰和幸福( ´ ▽ ` )ﾉ\n\n\n\n谢谢老师～也推荐大家都去上老师的课～
94277,282,梁清华,2019-01-16 05:44:13,4,6,2,感觉老师人很好，虽然作业比其他班多，但是没考试，只要作业用心，绩点就不错
94279,282,梁清华,2019-01-16 05:45:58,6,6,0,十分好，有点点感动，几点真的高到我了。
94280,282,梁清华,2019-01-16 05:47:47,12,12,0,给分高，与其说作业多，不如说作业比较复杂。志愿服务和职规报告一开始让人感觉无从下手，但一个学期的志愿服务以及认真做一份职规对自己（脱发量）的提升非常大！能用一个社会人的眼光反省自己！非常难得！另外不用考试是真爽，现在同学们在考思修我在评查老师∠( ᐛ 」∠)＿
94281,282,梁清华,2019-01-18 02:42:31,23,25,2,我爱梁清华\n\n我爱梁清华\n\n我再说一遍\n\n我爱梁清华\n\n听她的课真的很有趣\n\n老师对法律与道德的理解很深刻 很正\n\n给我们分析了很多有意义的案例\n\n本来想上课玩手机的 听着听着就不玩了\n\n虽然作业多\n\n但是不用考试啊\n\n多好\n\n（就是期中作业是职规有点仓促 其实作业量也算正常 我一个作业拖延症赶着赶着不也写完了）\n\n
94282,282,梁清华,2019-01-16 05:49:19,6,6,0,绝对是良心老师。\n\n怕事情多的你大可不必报她的课(其实好像事也不多)\n\n积极申请免考，鼓励我们做志愿服务，组织各个实践活动，上课还讲得很有趣(我没有一节思修不听的)\n\n只要你肯做，绩点也不低。\n\n这样的好老师不多了
94283,282,梁清华,2019-01-16 05:49:44,3,4,1,在丰富多彩的社会现象和鞭辟入里的人性本质里体悟生活，身边的生活，遥远的生活……\n\n总之，超级赞啊啊啊啊
94284,282,梁清华,2019-01-16 05:51:28,3,4,1,老师肚子里有很多东西，不为完成任务而上课，绩点也很好，思修课从不觉得水，收获满满！大爱梁老师！
94286,282,梁清华,2019-01-16 05:53:47,12,12,0,第一门满绩，上课有趣，案例充实，干活超多，最最重要的是，在别人还在准备思修期末考的时候，我们就出成绩了，吃鸡
94288,282,梁清华,2019-01-16 05:58:29,4,4,0,吹爆梁老师 上课有意思 给分也很好(✪▽✪)
94289,282,梁清华,2019-01-16 05:58:30,-13,2,15,观点比较老
94290,282,梁清华,2019-01-16 05:59:17,7,7,0,不点名也不会翘的课
94291,282,梁清华,2019-01-16 06:00:02,3,3,0,我吹爆梁老师！！！就是我的女神！！不用考试给分还这么好！！！我爱梁老师呜呜呜呜
94292,282,梁清华,2019-01-16 06:01:57,5,6,1,偶尔点名。非常棒的老师，讲的案例很有趣，还会组织一些活动，群里也会分享一些实事，为老师打call
94294,282,梁清华,2019-01-16 06:03:21,4,4,0,老师特别好特别好！！！上课超级有意思！！期末不考试不考试思修不考试！！！！给分超级超级超级超级好！！！我爱梁老师！！！
94295,282,梁清华,2019-01-16 06:03:25,2,4,2,梁老师特别特别好 爱死她了
94296,282,梁清华,2019-01-16 06:03:46,2,2,0,绝对的好评
94297,282,梁清华,2019-01-16 06:04:08,10,10,0,梁老师真的人超好，一个学期下来满满的干货，带我们去参观了戒毒所，还给我们普及了很多知识，最重要的是事情没有特别多，总共只有两次大作业和两个小组讨论，只要认真就能有好成绩，刚才绩点出来的时候开心坏了！！！感谢梁老师！梁老师是女神啊！！！爱您！
94298,282,梁清华,2019-01-16 09:46:46,9,10,1,绩点高当然是开心的啦。不过梁老师本身也是有东西的，上课可以水，但没必要。
94299,282,梁清华,2019-01-16 06:04:40,3,3,0,梁老师确实不错
94300,282,梁清华,2019-01-16 06:04:53,4,4,0,不仅免考完而且给分还好！！！而且老师还带我们去参观监狱、戒毒所、法院等等 真的很为学生着想 真的是很好的老师了！！！！大爱梁老师！！！
94301,282,梁清华,2019-01-16 06:05:17,37,37,0,1.免考 虽然今年思修课程改革了，但老师还是顶住压力继续推行免考制度。当考试周别人苦背的时候，我们早就把思修课本扔开了。\n\n2.作业 没有考试，但相应的平时事情也会多。主要就是职业规划和志愿服务报告两个大作业比较繁琐复杂。可以选择认真做，这样确实很有意义…也可以选择搭好框架然後拼拼凑凑水水过，反正痛苦个一两天就过去了…总之我在这门课上真正学到了怎么水作业。\n\n3.上课 个人认为梁清华算是讲得最好的思修老师了，在这种课上依然能讲出许多很大胆很前卫的观点，老师很敢讲，而且论述也很有力。她课上分享的很多故事也都很有意义。点名次数也很少，最后期末那两节课她还承诺了不点名。\n\n4. 给分很好。看上边的均绩就知道了。不用多说。\n\n5. 我觉得老师个人的环保意识和生活态度是很值得学习的。很了不起的是，老师的思修课绝不只是嘴上说说和ppt上写写，而是把很多东西内化为自己的行为和意识。
94302,282,梁清华,2019-01-16 06:05:21,3,4,1,个人感觉似乎课堂表现占分不多，我自己上课没怎么发言最后也能上4，作业什么的认真对待，小组讨论要参加就好了，志愿服务报告是关键
94303,282,梁清华,2019-01-16 06:08:03,11,11,0,想补作业的话还是不要来了（不经常点名）因为，你来了之后会不知不觉的听课丝毫不知疲倦。老师讲的就是这么好。收获颇多。作业一定要认真对待。
94304,282,梁清华,2019-01-16 06:09:02,6,6,0,嗷嗷嗷嗷吹爆梁老师！！人真的特别好！思修这么无聊的课被她讲的也很有意思！虽然平时作业有点多但是不用考试真的非常幸福！待人也很亲切温和！总之好就完事儿了！
94305,282,梁清华,2019-01-16 06:10:21,6,6,0,今天别人思修期末考试然而我们成绩已经出了，看到不少人吐槽有点不明白。感觉任务也不是很多而且考试周前一段时间基本上都可以完成了。如果不是思修要求我应该会和很多人一样不会去接触志愿服务。至少我觉得做志愿服务让我能够走出去看一看去做点什么。老师是法律专业的，最后几堂课讲法律的时候我和不少同学一样，写作业都停下来听她讲，稍微用心听应该都能感受出水平来。
94306,282,梁清华,2019-01-16 06:10:38,7,7,0,吹爆梁清华老师！！！！！！真的是一个特别特别好的老师，感觉自己真的是太幸运了能预置上梁老师的思修课。特别注重各种实践，带同学参加很多活动，都特别有教育意义。讲课也非常有意思，这个学期的思修课真的学到了很多，各方面的，非常开心和满足。
94307,282,梁清华,2019-01-16 06:13:11,8,8,0,会给我们找各种各样的机会去感受学校外面的社会，会用很科学开放的眼光来给我们分析社会大事，会鼓励我们自己通过实践作业去自主学习…真的真的是很好很好的老师!思修的教改真的很成功，我真的从中学到了很多很多TT能在大一就碰见梁老师真是太好了!!\n\n【此时，别的班的同学都去思修期末考了，而梁老师班的我抱着满绩幸福地哭了…
94308,282,梁清华,2019-01-16 06:13:19,2,2,0,真的很棒
94309,282,梁清华,2019-01-16 06:13:19,1,2,1,梁老师敲级好啊(*^◎^*)\n\n
94312,282,梁清华,2019-01-16 06:14:50,2,2,0,超级超级好的老师，人非常和善，上课也很有意思！
94313,282,梁清华,2019-01-16 06:16:56,0,1,1,很nice的老师！
94315,282,梁清华,2019-01-16 06:18:44,5,5,0,超级棒啊！！而且没有考试！没有考试！
94316,282,梁清华,2019-01-16 06:19:28,3,3,0,刚开始觉得梁老师不如传闻那么好 上完一学期 真的快乐！！ 绩点也超开心！
94318,282,梁清华,2019-01-16 06:21:17,9,11,2,呜呜呜刚刚小伙伴们都去考思修了我一个思修免考的抱着刚刚出的满绩在值班室笑出了声哈哈哈哈哈哈哈真的超级感动哇虽然平时作业比别人多但是不用考试是真的幸福而且老师上课也不会根据教材来讲很多都是自己和身边人的实例真的很有趣而且只要两个大作业（职规和志愿服务报告）认真做小组讨论（一组交一个word）就ok给分也是真的好呜呜呜看看上面的均绩就知道了真的吹爆学弟学妹们话不多说梁清华我的爱❤️❤️❤️
94319,282,梁清华,2019-01-16 06:22:07,10,10,0,梁老师的思修 实事求是 课上还是很多同学在水的（我自己经常也是这点我承认）但是每当老师讲到精彩的案例的时候我都会认真听的 梁老师不吹不黑上课认真听的话还是有意思。    除此之外 最重要的事课外 我是我们小组的组长 事情真的不多 平时作业的职业生涯规划硬逼着我这个脸皮薄的人去找学姐学长访谈 志愿服务报告和鞭策我积极参与志愿活动 而这些活动让你能接触很多的人和事  同时 梁老师还会给大家去监狱 戒毒所 法庭的机会 还会邀请企业大牛给大家做演讲 这么好的老师哪里找！！！而且是我这个不是那么积极的同学今天成绩出来是4.5！！很不错了！
94320,282,梁清华,2019-01-16 06:23:15,3,4,1,看到绩点的我高呼我的天 我爱梁老师
94321,282,梁清华,2019-01-16 06:24:24,1,1,0,如沐春风
94322,282,梁清华,2019-01-16 06:25:16,5,6,1,梁老师是真的好老师，认真听她的课会有很多收获，案例多，课也不会那么无聊，提交这么多字的报告来帮我们免考的老师还能说什么！绩点也很满意，我觉得只要认真完成平时的任务叭，说平时的作业多，其实我觉得海星，而且能在烤柿粥少考一门多么幸福哇！我爱梁老师！！
94323,282,梁清华,2019-01-16 06:25:47,1,2,1,老师也太棒了！
94324,282,梁清华,2019-01-16 06:26:08,4,4,0,很好，真心教课，学有所获，绩点nice
94325,282,梁清华,2019-01-16 06:27:06,-1,3,4,虽然被正态了，还是给个满分
94326,282,梁清华,2019-01-16 06:28:42,4,4,0,不考试高绩点你值得拥有
94327,282,梁清华,2019-01-16 06:29:11,4,4,0,给分很好！上课比较轻松收货也很多！虽然平时作业有点小多，但是压力分散到平时还是很不错滴
94328,282,梁清华,2019-01-16 06:29:48,5,5,0,做梦都没想到思修这种课绩点能上四1551\n\n我爱梁老师
94329,282,梁清华,2019-01-16 06:29:49,3,4,1,啊啊啊老师真的很好哇！我是冲着老师去选的课，还退了原来的思修课。上课会有讨论，还会不定期的有一些活动，比如法庭旁听，参观监狱（可惜我有事没去成），等等。老师还会在群里发一些志愿者活动，估计我们参加。最最最重要的是没有期末考！（本来这学期开始说要有了，最后老师去争取来的！），一般做的认真一点绩点很好！
94330,282,梁清华,2019-01-16 06:29:50,4,4,0,梁清华老师真的讲得特别好，从来不避讳一些敏感话题，讲得很直接客观。对实事真的很了解，让大家做的讨论很有意思，最重要的是，只要听听课，认真做作业，均绩上四没问题，我在其他同学考思修的时候就知道了我的绩点，简直不要太开心。
94332,282,梁清华,2019-01-16 06:35:51,4,4,0,有思想，很好，虽然觉得我的分数不该是这样的。。。
94333,282,梁清华,2019-01-16 06:38:04,6,7,1,梁清华老师真的值得满分，为我们争取免试，请学长进课堂，带我们去校外参观监狱旁听开庭，老师真的是做实事的人，也很有想法，体谅学生尊重我们的想法。只要平时的任务认真完成成绩不会差的。遇到这样的老师非常幸运?
94334,282,梁清华,2019-01-16 06:45:10,2,3,1,听老师的课就是开眼看世界啊！真的是认真负责又有社会责任感的老师。在梁老师的课上第一次当众说出了自己扶老人的那点小心事，老师给的鼓励肯定和安抚真的让人很感动很开心！！！预置梁老师的课真的事莫大的幸福啊٩(˃̶͈̀௰˂̶͈́)و
94335,282,梁清华,2019-01-16 06:40:51,2,4,2,本来思修课想水过去的，但听梁老师讲了几节后感觉老师讲的很好，以后就每次都认真听课，一学期下来收获满满。还有就是志愿服务既提升自己，又能免考，最后给分也很不错，真的好评!
94336,282,梁清华,2019-01-16 06:42:22,1,2,1,非常好！！
94337,282,梁清华,2019-01-16 06:43:18,3,4,1,只点过一两次名字，我上的是她的思修，平常会有作业，还不少，但是没有期末考试。老师上课，你是可以水的，但是我是一般水不下去的，因为讲的很有意思！我平时都到课，但是没有回答过问题，平时作业认真做但也没觉得自己做的好，最后4.5我高兴坏了。
94338,282,梁清华,2019-01-19 06:38:35,25,32,7,我挺同情前面那个骂老师的孤儿的，毕竟从小缺爱嘛
94339,282,梁清华,2019-01-16 06:52:49,6,8,2,不自觉的停下写作业的手，当我开始看向梁清华时，这节课便转瞬即逝。
94340,282,梁清华,2019-01-16 06:53:56,6,7,1,大爱梁清华！！很有意思！没有考试！！在别人考试的时候就出自己的成绩了！！！课堂也超棒！感觉事也不多！反正认真就能满！！！多做志愿者受益一生！
94342,282,梁清华,2019-01-16 06:57:29,7,9,2,梁老师真的太好了！给分也超级好 只要你认真完成几个报告 分肯定不会低的！！啊 吹爆梁老师 当别人还在考思修的时候你就能看到热腾腾的成绩啦！贼拉拉开心
94343,282,梁清华,2019-01-16 07:02:32,5,9,4,梁老师人超好! 课超好! \n\n我上的是她的思修，周一34节，妥妥周指活\n\n可能很多老师的班的情况是思修这种课就应该睡过去水过去，但是梁清华老师的课你是能学到东西的，体验也很好\n\n不拘泥于单调的读课本，而是每一个知识点都有自己的想法，自己本身素质也相当硬\n\n而且经常会请优秀的学长学姐、专家等等进课堂，也会组织很多活动(像参观法庭监狱戒毒所等等)，绝对是难得而且难忘的体验\n\n\n\n她的课的特点是互动多，事情多，这次她帮我们申请到了免考，全看平时分，【平时的作d业d量l可能是其他班的两倍以上】，而且【要求参加长期志愿服务】，如果是【真正想要上思修这门课并且想学到东西的】，绝对推荐!!\n\n但是如果想【水思修这门课】的，【千万不要选梁老师】，互动和任务会很多，虽然可能“免考”有吸引力但是水完课裸考会比上她的课轻松很多很多，分数也不一定会低!
94344,282,梁清华,2019-01-16 07:04:43,3,4,1,超级好的老师！！！没有期末考试平时任务多点也很开心啦嘻嘻嘻！夸爆！
94346,282,梁清华,2019-01-16 07:09:09,0,2,2,我感觉我作业做的挺水的都能上4。。。不管你想不想水绩点这门课都是极好的选择，有硬核的思想，也有好水的绩点。
94347,282,梁清华,2019-01-16 07:10:14,2,3,1,怎么会有这么好的老师
94348,282,梁清华,2019-01-16 07:10:14,5,6,1,老师的课不水，但只要认真做，最后一定会有好的结果的。讲课超级有意思哇！！！\n\n绩点很高！绩点很高！绩点很高！
94350,282,梁清华,2019-01-16 07:12:40,0,2,2,水也有绩点，不水也有收获
94352,282,梁清华,2019-01-16 07:16:16,5,6,1,在18级的同学们还在考思修的时候默默来评个分嘿嘿嘿\n\n超好的老师（不用思修期末考）\n\n给的绩点也很棒\n\n大家基本都在4.2以上\n\n快乐
94353,282,梁清华,2019-01-16 07:21:36,3,5,2,呜呜呜成绩出了太感人了，尽情pick梁老师，超级好超级有想法，吹爆她的给分
94358,282,梁清华,2019-01-16 07:37:36,6,7,1,大不自多，海纳江河
94360,282,梁清华,2019-01-16 08:03:45,-2,3,5,吹爆这个老师\n\n不点名\n\n不考试绩点也特别好\n\n贼养生
94362,282,梁清华,2019-01-16 08:09:11,1,2,1,老师上课很有趣啊，思想开放，在讨论不会说因为关系到不良话题，就跳过。\n\n
94364,282,梁清华,2019-01-16 08:15:32,1,4,3,虽然没满绩(思修满绩的人真的超多)，但老师真的是很有水平很好的老师了！
94365,282,梁清华,2019-01-16 08:16:28,10,11,1,梁清华老师很好，不会死磕书本上的东西，会给我们讲志愿者经历，会邀请优秀学长给我们讲如何发展自己，会在课堂上和我们讨论身边的道德和法律案例。事情也不算多，最后给分超级棒！老师人也非常有意思，可以说是有收获不后悔的思修课了！而且免考看着别人考试还挺美滋滋emm
94367,282,梁清华,2019-01-16 08:19:49,3,3,0,非常好
94370,282,梁清华,2019-01-16 08:22:17,-7,5,12,其他班的表示不服 居然可以规避正态?
94371,282,梁清华,2019-01-16 08:32:37,2,3,1,上课有东西，给分小能手，当然平时认真是前提啦
94397,282,梁清华,2019-01-16 09:53:17,10,12,2,我不是因为高绩点来夸老师的，梁老师身上那种开明精神，对待实践教学的负责态度，还有作为法律专业人士的严谨，身教带给我们的内容甚至超越课程本身
94408,282,梁清华,2019-01-16 10:34:25,2,3,1,事多给分好
94409,282,梁清华,2019-01-16 10:34:51,6,7,1,只要用心听，认真写论文，分数不会低
94424,282,梁清华,2019-01-16 11:54:08,3,3,0,肥肠好
94431,282,梁清华,2019-01-16 12:23:08,0,3,3,老师非常好，关键是给分高！！！水一水都能上4
94435,282,梁清华,2019-01-16 12:36:29,4,5,1,平时虽然作业多但能让学生真正受用，能让超迷茫的大一新生少迷茫一点点。平时在群里经常发一些很好的文章，希望传达一些自己的想法，老师真的用心在对待我们了！好好听课不会后悔滴！（认真做作业了就有4.5嘻嘻嘻
94452,282,梁清华,2019-01-16 13:25:15,4,6,2,梁老师太好了我吹爆\n\n上课真的很多干货很多故事超有趣能学到超多\n\n为我们争取思修免考\n\n打分也是正态下尽量往高里给\n\n是给我人生第一个满绩的老师\n\n只要用了心老师真的就会看见\n\n真的是很负责也很有水平的好老师啦
94455,282,梁清华,2019-01-16 13:33:11,4,4,0,下学期要选老师的职规了 希望能改变现在的情况
94460,282,梁清华,2019-01-16 14:08:29,1,2,1,很有收获，给分很好，关键是没有期末考试！！！
94492,282,梁清华,2019-01-17 01:38:36,2,4,2,哇啊啊老师是女神！超级好，而且我觉得事情也不是特别多，认真去做都会有好结果的！可爱！学到了很多！很开心的思修课！也是人生第一个满绩耶！选她的课简直是神仙待遇嘤嘤嘤
94512,282,梁清华,2019-01-17 04:02:36,1,2,1,我爱梁老师！！梁老师的思想真的很深刻！！
94593,282,梁清华,2019-01-17 09:49:16,7,9,2,梁老师是一位特别好的老师，思修里的名师，也是我大一的第一位通识课老师。她给了我非常好的上课体验，会很自由的跟大家一起讨论社会热点话题。\n\n  最后的给分真的是相当好，感觉大家基本上都是4.5左右，还有好多5.0的。我个人认为只要按部就班的交上所有报告，论文就能让你最后的绩点很高～还有老师上课是不点名的，但是一学期会有几次点名回答问题，上课体验很轻松很快乐，还是尽量不要翘课吧～
94645,282,梁清华,2019-01-17 13:56:14,0,2,2,能预置上梁老师的课真的好幸运！
94740,282,梁清华,2019-01-18 04:38:23,-1,2,3,感觉真的收获了很多
94825,282,梁清华,2019-01-18 09:17:52,0,2,2,她上的思修太有意思了
95013,282,梁清华,2019-01-18 14:55:22,0,3,3,作业真的不算多，给分极好，老师上课也特别好
95056,282,梁清华,2019-01-18 15:44:47,1,2,1,上课很好，作业刚开始觉得多，但是后来也发现其实思修课作业都差不多的，认真做的话给分会很好。
95090,282,梁清华,2019-01-18 18:57:17,15,16,1,哭了…为什么不同老师之间思修差距这么大
95522,282,梁清华,2019-01-19 14:03:41,2,5,3,态度决定绩点，给分超好
95731,282,梁清华,2019-01-20 02:54:36,9,30,21,第一，我不是梁老师的学生。\n\n第二，梁老师思修期末不考试，这对于其他班的学生公平吗？\n\n第三，别选钟为民。
95911,282,梁清华,2019-01-20 08:11:46,5,9,4,梁老师的思修有低于4的吗
96327,282,梁清华,2019-01-21 00:17:58,3,10,7,我本学期选了梁老师思修课，我想说我们没有考试并不代表着坐着等满绩好吗？平时有很多需要投入大量时间和精力完成的作业，志愿报告，职业规划，读书报告，小组讨论等等，这些作业的完成度很大一部分决定了成绩的好坏。一份付出一份收获。我之前对待读书报告不认真，我期末成绩就没有别人那么好。老师给分是公平合理的，不可能人人都满绩点，不用考试固然小了很多压力，但是也可能导致很多人跟我一样不重视平时的作业，觉得太多太烦，反正也不考试，最后也会影响到成绩的。最后，感谢梁老师这一学期的思修讲堂，我收获了很多。感谢负责的助教，一直提醒大家的作业。感谢~
96360,282,梁清华,2019-01-21 01:11:22,1,1,0,非常赞
96689,282,梁清华,2019-01-21 09:08:33,-1,1,2,梁老师超好，课堂内容有趣，作业也很合理，朋友圈很有价值，给分很好诶\n\n
96853,282,梁清华,2019-01-21 10:47:56,2,3,1,具有思想，很爱志愿服务，改变我对志愿服务的看法，做职业生涯规划也让我对大学学习方向有了更清晰的认识。很重实践的老师。
97376,282,梁清华,2019-01-22 08:27:20,1,2,1,收货很足，有很多小组讨论，给分超级友好，10分好评。
97481,282,梁清华,2019-01-22 09:17:51,2,3,1,真的好
97803,282,梁清华,2019-01-22 17:33:02,6,10,4,按部就班上交作业就能很好绩点的的那位同学，别的班的同学就不是这样吗，选上梁老师课的各位可真幸运，没有垃圾正态。。。\n\n
98547,282,梁清华,2019-01-23 14:41:29,6,11,5,下面那个上了别的老师的思修课觉得梁老师班不考试不公平的人，有问题怎么不找教务处反应？不管公不公平，你上的不是梁老师的课，投诉平台不是梁清华的查老师页面，这里是写“上老师的课是什么感受？”的。叫嚣也有点脑子ok？
99156,282,梁清华,2019-01-24 10:40:07,-5,1,6,没有体验，但是绩点很高
99344,282,梁清华,2019-01-24 15:09:47,5,6,1,大家好我是别的班的，我想说，lbwnb，我没有开挂！\n\n
100050,282,梁清华,2019-01-25 13:20:16,5,6,1,我觉得 思政类的课绩点多少有点佛的吧 更重要的是收获了多少。很多人都在说没有考试，没有正态，给分好(虽然我的成绩并没有到预期..但也确实是一分耕耘一分收获？)，而我更想说的是，老师的思修听听真的很有意思啊，你不想水的话是可以学到一些东西有一些感悟的啊。另外老师也是个相当开明的人，有想法，也不惧于表达。非常欣赏！
100310,282,梁清华,2019-01-26 02:45:03,3,6,3,老师讲得很好，最重要的是没有期末考试л̵ʱªʱªʱª (ᕑᗢᓫา∗)˒绩点普遍4以上
101985,282,梁清华,2019-01-30 02:13:10,1,2,1,讲课挺有意思，不是书上的知识点，而是一些实例和自己的见解
102296,282,梁清华,2019-02-01 00:43:51,0,2,2,课堂内容很丰富，小组讨论也很有趣
102304,282,梁清华,2019-02-01 01:19:55,-3,5,8,老师超级好啊啊啊啊啊啊啊\n\n免考真的牛X！！！\n\n最后绩点还4.5！强推好吗！
103044,282,梁清华,2019-02-25 15:16:50,0,1,1,真心赞，老师完全不拘泥于课本，关注当下社会热点与现状，提出自己的看法，注重实践
103222,282,梁清华,2019-02-27 01:59:11,11,12,1,如果有可能，所有思政课我都会选梁清华老师
103313,282,梁清华,2019-02-27 08:33:36,-15,5,20,事多 形式过于娱乐化
103478,282,梁清华,2019-02-28 10:20:32,0,2,2,很有见地的老师，能学到东西
105472,282,梁清华,2019-04-15 03:35:35,4,4,0,那个骂梁老师的评论你能不能不要这么酸，真是煞风景！
105661,282,梁清华,2019-05-01 01:59:31,2,3,1,给高分就是娘
106277,282,梁清华,2019-04-26 05:38:37,2,3,1,法学基础，事少，给分好，能够学到真东西，老师上课真真真真的很有意思啊，确定不选吗
106325,282,梁清华,2019-04-26 10:32:39,2,2,0,老师是真的好
106328,282,梁清华,2019-04-26 10:37:01,3,3,0,老师上课不拘泥于课本，有自己的见解，能够引发大家的思考，积极组织大家讨论，能学到很多东西。事情也不多，有3次小组作业，还有一篇个人读书报告，是一门付出和成绩成正比的课，老师给分超级好！！！强烈推荐
106362,282,梁清华,2019-04-26 16:46:06,1,2,1,老师也太好了? ? ? 职规虽然每周都有作业但作业量不大，最后给满了呜呜呜谢谢老师！！
106376,282,梁清华,2019-04-26 23:36:17,1,1,0,职规每周有作业但比较轻松，还行吧
106378,282,梁清华,2019-04-27 00:06:50,-1,4,5,大早上起来看到职规满绩的我笑成了傻子！一开始我也是好担心的，因为听说事情多，其实就是几乎每周都会有一份课后总结的作业要完成，认认真真地完成了交作业了 绩点不会差。还有就是老师请了大牛HR来给我们做讲座，真的收获满满，包括写简历和面试方面都有了一定了解。
106379,282,梁清华,2019-04-27 00:10:10,1,2,1,职规事情多不假。但是这门课只要你认真对待，用心做作业，一定会有收获而且分数一定会很好的。不像有的课努力了也不一定会有好结果。大爱梁老师和助教小姐姐！
106385,282,梁清华,2019-07-06 09:57:39,17,17,0,法学基础事少给分好不正态10分吹爆梁清华老师?
106426,282,梁清华,2019-04-27 09:48:29,-2,6,8,首先，我上的是梁老师的职规\n\n事情平心而论不多，也没有期末考试\n\n但是课堂上感觉恶竞比较严重，最后我虽然作业都完成了，绩点却只有2.5…………\n\n其实我感觉，梁老师不太会上这门课……讲课的内容真的比较枯燥，比较乏味
106614,282,梁清华,2019-04-28 10:46:52,4,4,0,老师上课超好，不正态，想高分就做展示
106641,282,梁清华,2019-04-28 13:52:28,7,8,1,我上的是梁老师的法学基础通识课。虽然事情有点多(三次小组讨论+读书汇报抽讲+期末读书笔记)，但我觉得是真真切切能从里面学到很多。老师三次讨论的主题都是让我们全部同学投票选的，结合了近年的一些法律热点，讨论前也会给我们一些讨论的方法和方向。梁老师还会找一些法律工作人员走入我们的课堂，课堂形式十分多样化。老师平时也很平易近人，会在微信群上和同学们讨论一些新的案子。只要你认认真真地完成老师的任务，绩点是不差的(我是A+)。
108826,282,梁清华,2019-06-03 03:06:37,1,1,0,老师还是很不错哒~~平时事有点多，认真完成就没问题
108963,282,梁清华,2019-06-04 17:17:09,2,2,0,自由思想！lqh万岁！一直加着老师微信，看她的pyq都可以学到很多
109191,282,梁清华,2019-06-11 10:52:13,0,0,0,特别好！！！
109645,282,梁清华,2019-06-18 06:27:25,2,2,0,快乐！
113065,282,梁清华,2019-07-05 22:18:48,2,2,0,我法学基础的课，在这里你甚至可以讨论鸡你太美，事儿不多但干货很多，也很有收获，给分也超棒啊，最后因为输进去不符合正态分布特地在群里告知我们，吹爆吹爆！
113196,282,梁清华,2019-07-06 01:27:16,3,3,0,梁老师的法学基础。课上讲了法律的价值追求，还有法的运行之类的，本人工科生，没有感觉上的很吃力，老师都是结合案例讲解的。每次课前两节老师讲，最后一节小组讨论（这学期讨论的内容有cxk给b站的律师函，视觉中国版权案，以及同性婚姻合法化）或者小组展示（第一节课建立学习小组，老师会先推荐一些书，一学期就读这本书，看相同书的人分在同组），展示内容就是作一次读书报告。没有期末考试，期末作业是读书报告，占50%（好像），一学期还会有一次“专家进课堂”，这个学期邀请了一个派出所所长，讲了一些防诈骗的内容，近几天98上有人说遇到了“网贷注销”诈骗被骗去了几万，而这个诈骗方法所长就有讲到。最后给分等级制，无正态，但优秀（A以上）有限制，本人A-，还算满意。
113246,282,梁清华,2019-07-06 02:39:39,0,1,1,真的很喜欢梁老师，是那种很为学生考虑的好老师，很有气质，自带风骨，给分也很不错哦
113397,282,梁清华,2019-07-06 16:35:57,1,1,0,直到现在，老师还会在群里发布志愿者信息，分享一些有趣或有意义的文章消息。\n\n因为思修做了志愿者，因为做志愿者，认识了新朋友。很喜欢。
115921,282,梁清华,2019-08-26 07:20:23,1,1,0,思修没有期末考试！！！只用写志愿服务报告就好啦！课程很轻松很有趣。只要每一项工作都认真做了就会有好绩点哦！
116965,282,梁清华,2019-09-18 01:09:05,0,0,0,梁老师的思修不用期末考试哦～
117196,282,梁清华,2019-09-20 07:42:00,2,2,0,梁老师超级负责，超级和蔼，经常会带学生到外参观，还不用期末考试
117971,282,梁清华,2019-10-17 07:14:39,0,1,1,老师的思想境界非常高，听这位老师的课，会觉得神清气爽，真的非常有意义。老师温柔大方，博学多识，认真负责，是一位非常好的老师！
118973,282,梁清华,2019-11-08 17:28:27,-1,2,3,怎么说，很多人说老师的作业有帮助，其实我个人而言，我觉得她的那些看似“有趣”的活动，大多过于形式主义（尤指思修课），不是说事多或者怎样，如果一件事情我做了对我有帮助，那我自然乐意去做；但如果它费时费力还基本无卵用…我真是…只能说为绩点而做了。\n\n另外，梁老师本人上课中提出的的一些观点本人也是不敢苟同。
119031,282,梁清华,2019-11-09 20:39:51,1,1,0,非常好
120965,282,梁清华,2020-01-19 05:01:46,-1,2,3,我觉得志愿服务替代思修考试实际上更有意义，但是我们这届是最后一届了，学校那边暂停这种“实验”了。老师真的很棒，三观很正，思维也不固化，敢于尝试。老师的思修课相对于别的课来说作业会多一些，但是也还好，在承受范围之内，每个作业在ddl前认真做掉也不会占太多时间。最后满绩了，真的很感谢老师。
120978,282,梁清华,2020-01-19 06:32:33,-16,5,21,做得这么认真的职规报告和志愿服务报告，最后输给了恶竞，还有恶心的小组作业，虽然我知道这些课都要分小组，但还是能感觉到深深的无能为力，fine…我到现在还没参透梁老师给报告打分究竟看什么？？有的人写策划社团组织活动也能算志愿服务？？职规做成ppt分就比别人高？？以上就当前车之鉴吧，做得好不一定能得高分，可能还不如写流水账去恶竞
120987,282,梁清华,2020-01-19 07:36:13,3,3,0,太强了。直接满绩
121005,282,梁清华,2020-01-19 08:31:05,1,2,1,思修不考试的最后一届前来发言，本人读书报告和志愿服务报告什么的都没有写很多，也实在不懂大家对恶竞的定义，志愿服务报告也就是把自己参加的每一样活动罗列了写了一些心得，如果因为参加的活动多写的多这就属于恶竞，我也是无话可说，我感觉老师还是看重参加的活动的水准的。很多作业都属于小组作业，也没有特别大负担。比起某些思修课以课代表或组长身份给分，个人感觉梁老师的给分合情合理。对了，为了大多数同学的好处，给分用的五级制，我4.5，满意了。在大一上就参与了很多志愿活动，收获了很多，这远大于一个5.0绩点。
121052,282,梁清华,2020-01-19 10:33:10,0,1,1,吹爆梁老师！！！给分太好啦！！！\n\n但理智发言，不想干活只想水的同学，建议不要选，不然你会很痛苦!!!\n\n老师说这是最后一年免考了，我也有点难过，说实话，我认为老师的志愿服务比考试有意义多了！理想启航的大作业做的很痛苦，但也确实帮我清晰了一些前行的方向。\n\n如果愿意去做这些事情，并且投注真心的完成作业，我相信你会收获很多！绩点也出乎意料!
121149,282,梁清华,2020-01-20 01:12:34,4,5,1,梁老师是个敢于争取和付诸实践的人，免试试点、实践教学，优秀率过高不满足正态分布还不嫌麻烦向本科生院递材料写申请。下一届没有免试了，还好抓到了免试的尾巴。
121406,282,梁清华,2019-12-16 10:23:42,0,0,0,平时会有一些调研性质的作业 但老师的学识真的很渊博 她特别强调培养一种法律思维 这种思维在将来也会一直伴随着你 主要是 没有期末考试
121553,282,梁清华,2019-12-12 12:16:42,1,1,0,思修教改不能更成功，比其他的背书考题好得多；老师真的不能更好，真的在为我们着想，无论是志愿服务的推荐，还是各种课外拓展，都是怀着以德育人的心去做的。
121765,282,梁清华,2020-01-21 17:50:05,1,2,1,没上四，但还是给了满分
122194,282,梁清华,2020-02-20 01:38:29,4,5,1,抓住了思修免考的尾巴，志愿服务真的比考试有意义，小组讨论也不烦，老师很好，会提供志愿服务及外出参观的机会，收获比纯课堂教学要多
122498,282,梁清华,2020-03-02 12:27:22,-1,1,2,超棒的老师，开放宽容，上课很有意义
122606,282,梁清华,2020-03-07 08:47:59,3,4,1,绝对的好老师，不像其他的思修课只剩下了考试背书。
122812,282,梁清华,2020-04-09 06:45:30,2,2,0,志愿工作真的比考试，背书好...只可惜以后没有了......
123082,282,梁清华,2020-05-08 16:52:02,0,1,1,10分必须的，真正的关注思修内涵的老师
123936,282,梁清华,2020-06-17 05:28:07,5,5,0,巨好无比
124258,282,梁清华,2020-06-28 05:52:00,7,8,1,梁老师的法学基础真的让我学到很多很多，是我第一门满绩，这一门课我是真的有付出，最后一节课名师进课堂还写了新闻稿，读书报告期间真的学到很多感兴趣的知识，防性侵手册真的有很认真的在做，很开心，努力都有了收获，谢谢老师，每一个作业都很有意义，事也不多，加油去做就很好了
125714,282,梁清华,2020-09-13 12:15:22,3,5,2,19级大一秋冬学期上的她的思修，讲课很棒，还经常有组织参观垃圾场、旁听法庭、参观戒毒所等活动（虽然很多因为我课程冲突没能去）。另外讲真志愿活动真比期末临时抱佛脚的考试有意义多了，希望学校后面能同意继续这样的评分制度
125873,282,梁清华,2020-09-15 07:01:01,1,3,2,老师上课很有意思，事情确实比较多，但做起来不无聊，好好做真的很有收获，给分也很好，一分耕耘一分收获。
126004,282,梁清华,2020-09-16 11:44:29,2,2,0,很好的老师！讲的好，给分也好！
126800,282,梁清华,2020-10-20 14:45:12,2,2,0,好得不得了
128642,282,梁清华,2020-12-25 02:07:44,9,9,0,老师超级认真，不讲课本，而是结合时事介绍思想观念，还会组织很多课外实践，参观艺博馆，垃圾焚烧厂，戒毒所等等。没有论文和读书报告，只有志愿服务。\n\n满分老师o(^o^)o棒棒哒！
129192,282,梁清华,2020-12-31 04:25:05,0,2,2,10分必须的
129232,282,梁清华,2021-01-01 15:15:15,-13,5,18,事情很多，分还很低，比我微积分事情还多
129368,282,梁清华,2021-01-04 15:48:21,0,0,0,啥也别说，梁老师只有恁个好了！
129423,282,梁清华,2021-01-05 07:50:26,1,1,0,老师很好，课也很有嘻嘻。
129613,282,梁清华,2021-01-08 15:36:51,-1,0,1,非常好的老师
129827,282,梁清华,2021-01-12 16:04:05,3,3,0,老师超级好，太棒了!
129898,282,梁清华,2021-01-13 10:01:05,9,10,1,提到在浙大还在“育人”的老师，我第一个想到的就是梁老师。实践活动落到实处，毫不虚浮；课程复习指导细致，简洁有效。除了没有赶上免考，梁老师的思修课，我没有遗憾了。
129959,282,梁清华,2021-01-14 06:28:48,1,1,0,学到很多，是很生动的思修课!
130121,282,梁清华,2021-01-17 12:52:37,16,17,1,课上的好，而且就冲她对不提前放假说的话，就值得十分
130876,282,梁清华,2021-01-25 05:25:55,1,2,1,梁老师！好！
131998,282,梁清华,2021-01-30 02:07:08,2,5,3,三观正，给分好，今年考试还满绩了！就是小组作业鹅颈有点严重...
132000,282,梁清华,2021-01-30 02:13:31,3,4,1,这都没有10分？？
132003,282,梁清华,2021-01-30 02:19:11,3,5,2,为评分趋向10做出微薄贡献！！！
132016,282,梁清华,2021-01-30 02:57:25,8,9,1,怎么说呢，给分也没有想象的那么好，主要是等级制度打分差距有点大。学弟学妹门看到的有的评价都是高分大佬发的，老师的部分观点我也是不赞同的，比如她对某些教师用餐券一下子买几十个馒头导致学生没有吃不上的做法持肯定态度。当然总的来说，梁老师还是很不错的。
132062,282,梁清华,2021-01-30 05:03:48,0,1,1,好好好
132068,282,梁清华,2021-01-30 05:33:14,7,7,0,（思修）平心而论，清华姐人确实很不错。喜欢带学生去课外实践，带我们学到了很多课外知识；看重志愿活动，自己也是个优秀的志愿者；支持免试，有自己的教育理念；关心学生，平易近人……\n\n就成绩方面而言，班上应该是有很多高分的，不过自己分并不高，没太搞清老师的评分方法
132509,282,梁清华,2021-02-02 05:03:14,4,6,2,梁老师的思修，绝对值得一上，浙大好老师
132787,282,梁清华,2021-02-03 15:09:28,0,4,4,梁老师的思修让你真正感觉到在用心培养学生的素质，而不是枯燥的形式。我在志愿活动中学到很多～\n\n顺便想回楼下一句：梁老师并不是对教师家属持许多餐劵买馒头持肯定态度，只是不赞成部分学生对此事件作出的不理性/粗鲁行为
132883,282,梁清华,2021-02-04 10:18:54,1,2,1,老师的思修课很好！
133021,282,梁清华,2021-02-06 10:45:12,-1,0,1,谢谢老师
133486,282,梁清华,2021-03-01 07:29:29,0,1,1,爱了！！
135157,282,梁清华,2021-05-05 11:39:07,2,4,2,职规a\n\n感觉挺失望的。没有评论说的那么好。客观说，职规作业很多，但意义不大，课堂也没有与众不同之处。做了展示，大作业也写了很多，但成绩一般。可能在正态的背景下，老师在给分上的区别也没有特别大吧。查老师的评分也是仅供参考罢了。\n\n\n\nPS：一直很疑惑，在有正态的背景下，职规的均绩是怎么接近4.5的～
135265,282,梁清华,2021-05-07 07:12:08,4,5,1,上梁老师的思修，经过统计，报告字数越多分越高，卡在下限以上的同学没有上四的。这也许是鼓励卷吗，只不过没有明示而已。讲课很不错，不按照书讲，梁老师自己也是优秀的志愿者和观鸟大佬。不怕卷的同学放心选
136359,282,梁清华,2021-06-17 02:53:46,3,4,1,我上大学和师兄师姐交流课程，他们跟我说的第一句话就是：“梁清华，好老师！”
137738,282,梁清华,2021-07-06 02:45:40,3,5,2,有人说老师给分没那么好，可能是不知道今年优秀线只有百分之20了吧。去年思修的时候还有百分之30的，去年的思修成绩和其他同学比起来真的是太幸福了。
137760,282,梁清华,2021-07-06 04:23:59,4,6,2,“所以我们采用了对大家更有利的ABC等级评分制，只有优秀率不超过20%的要求。”
137773,282,梁清华,2021-07-06 05:37:18,1,1,0,很负责
139911,282,梁清华,2021-08-17 11:00:32,4,5,1,超赞！
140720,282,梁清华,2021-09-15 10:23:53,0,3,3,还行，但说实话思修这种课程本身就没啥意思\n\n真正的思想道德素养在这种课里体现不出来也没法得到什么提升
142751,282,梁清华,2021-11-16 01:33:46,2,2,0,有见地、认真负责
143355,282,梁清华,2021-11-24 03:33:00,2,3,1,太爱了⁄(⁄ ⁄•⁄ω⁄•⁄ ⁄)⁄
144616,282,梁清华,2021-12-22 17:02:23,3,3,0,老师很负责，不仅仅只是讲书本上的内容，课程生动有趣，我很喜欢听她的思修，确实能让我学到很多东西
144736,282,梁清华,2021-12-23 11:10:24,5,5,0,很好！
146221,282,梁清华,2022-01-06 02:02:28,1,2,1,非常认真负责的老师\n\n很幸运在大一的时候就遇到这样一位老师
146842,282,梁清华,2022-01-07 15:10:22,2,3,1,事情比较多，但是都比较有意义\n\n老师思想很正，也很有志愿者精神
146956,282,梁清华,2022-01-08 07:12:20,8,8,0,好好好
147827,282,梁清华,2022-01-11 03:07:23,2,3,1,啥时候出分捏
148012,282,梁清华,2022-01-11 10:13:12,7,7,0,对抗正太！！！纯纯好老师！
148159,282,梁清华,2022-01-11 16:32:57,3,4,1,必须给十分，无论成绩如何，我在梁清华老师这里学到的知识真的很多，老师人也特别好，很负责，很认真，就是这该死的正态分布太可恶了
148510,282,梁清华,2022-01-12 17:21:30,2,2,0,通情达理的好老师！老师上课很认真，讲课很有趣，给分也很好！真正的志愿者，身体力行。感谢老师！
148511,282,梁清华,2022-01-12 17:23:13,2,3,1,好老师！更是一个好志愿者！善良、尊重学生、有师德，水了一学期的课深感抱歉，考试也没认真准备，唯一认真搞了的应该就是志愿服务吧。老师真的是好老师，会在群里介绍各种志愿者资源，有幸做了支教活动，收获很大！
148519,282,梁清华,2022-01-12 19:24:36,1,1,0,mua梁老师真好
148555,282,梁清华,2022-01-13 01:09:17,11,13,2,吹爆好吗，对抗正态第一人，虽然可能还是被限制住了，人超级好，课也很有趣，我们班因为去过艺博馆，被隔离在宿舍，一直在群里关心我们，解封后还给我们发了红包，吹爆，选她，不亏！！！
148574,282,梁清华,2022-01-13 02:02:49,0,1,1,太喜欢梁老师了，上课好，给分好，关心学生！
148768,282,梁清华,2022-01-13 12:37:54,-1,0,1,超级超级超级超级超级超级好的老师
148846,282,梁清华,2022-01-13 17:22:27,0,1,1,给分好棒好棒😄
148860,282,梁清华,2022-01-13 19:33:08,0,0,0,思修课最好的老师
148863,282,梁清华,2022-01-13 23:35:30,1,1,0,梁老师真的超级耐心，关于作业什么不懂的问题都可以问，梁老师都会耐心回答，期末也会捞人，太爱了！！！
148926,282,梁清华,2022-01-14 03:23:13,1,1,0,哈哈哈。
148961,282,梁清华,2022-01-14 04:36:50,3,3,0,梁老师给分真的很好，老师其实对正态也很无奈，谢谢老师的海底捞！！听梁老师的课能学到很多，了解到很多有趣的法律案例。从老师的言行可以看出她是真的热心于公益事业，对我影响很大。
148984,282,梁清华,2022-01-14 05:49:05,1,2,1,冲就是了
149090,282,梁清华,2022-01-14 11:10:25,2,3,1,被正态了，呜呜呜(┯_┯)
149202,282,梁清华,2022-01-14 18:01:07,-2,2,4,被正态了，不想多说什么。。。明明也认真做了。。。
149443,282,梁清华,2022-01-15 10:59:18,6,6,0,不用说太多了，就是好老师。
149724,282,梁清华,2022-01-16 14:29:41,3,5,2,课程：思修\n\n打分：10/10\n\n老师的课怎么说，确实不错。不过全天下的思修老师大概都不怎么讲课本（叹气），作业挺多的（有职规报告、志愿服务报告等等）上课有一次讨论（在学在浙大发帖），但是删掉了读书报告，把读书报告的分数换到了志愿服务报告上，不错。最后考试30%，就，考试周补天康康吧。
150675,282,梁清华,2022-02-11 13:47:40,-1,1,2,被正态得明明白白，虽然老师是一位好老师，但是思修的给分实在是很迷
150813,282,梁清华,2022-02-19 01:50:08,0,1,1,好老师，一级棒
150840,282,梁清华,2022-02-19 10:02:55,0,1,1,好好好
150919,282,梁清华,2022-02-21 05:17:44,3,3,0,梁老师讲思修课真的很有趣！强推！\n\n还把读书报告合并到了志愿服务，对于我这种不爱写文章的人来说这一点很友好！\n\n但是老师时间观念非常强，我是个完成作业有强迫症很拖拉的人所以这个可能有影响...绩点就比较一般。\n\n老师给分本来很好，但是限于正态调分，也是无奈之举。
151317,282,梁清华,2022-02-28 10:49:39,4,4,0,给分好!讲的也好 不会说教 很生活化
152607,282,梁清华,2022-04-15 15:27:04,8,8,0,emmmmmm\n\n可以说，她让我并不讨厌思修课，给分也挺好的
152759,282,梁清华,2022-04-19 09:21:55,4,4,0,好老师。上课不水。会有很多课堂之外的课程，重在让你学到东西！虽然因为一些作业原因我还被扣分了～但是认真，分数绝对不低。
153153,282,梁清华,2022-04-26 07:31:05,10,10,0,来评职规\n\n跟其他老师比事情少了很多，没有小组作业，也没有奇奇怪怪的讨论，只有一次成就故事撰写一次生涯人物访谈一份简历和期末的职规书\n\n上课的内容相对平淡了一些，但是老师很愿意听同学们的分享\n\n最后用的是通核的给分方法，给分很好\n\n大家放心选！！！
154604,282,梁清华,2022-06-02 11:26:28,10,11,1,梁清华老师真的超级超级好，朵朵十大常驻选手，对很多社会敏感问题敢于发声，真的用心想要上好思修课！
155410,282,梁清华,2022-06-12 08:56:37,2,3,1,非常好的老师，对学生负责，思想很开放
161198,282,梁清华,2022-10-31 14:34:31,0,1,1,很好！
162815,282,梁清华,2022-12-06 14:25:59,1,2,1,非常好的老师！
163685,282,梁清华,2022-12-16 02:56:12,10,10,0,梁老师这里真的有超级多的活动资源和信息！她本人也是植物动物爱好者，朋友圈经常分享一些自然知识！虽然文字作业可能和常规的有所不同，但是都没有字数要求，很看重实践作业，她的目的是让你真正有所收获！认识梁老师非常幸运！
164754,282,梁清华,2022-12-25 09:29:03,1,2,1,好好好
165640,282,梁清华,2023-01-09 05:47:22,2,2,0,老师挺好的，很多事情都会叫我们去做，可能过程中会有些麻烦
166124,282,梁清华,2023-01-11 07:17:41,18,19,1,梁老师每次提交分数之前都会和学校拉扯好几回，就为了给你们多几分。说卡绩的也体谅体谅人家吧
166816,282,梁清华,2023-01-13 16:48:35,2,3,1,老师很好，教会了我们许多，很负责，给分也超好的!
166832,282,梁清华,2023-01-14 00:57:41,-1,1,2,太好了
166857,282,梁清华,2023-01-14 02:53:13,3,3,0,能上到梁老师的德法课绝对是一种享受！
166862,282,梁清华,2023-01-14 03:21:55,-10,4,14,满绩！谢谢梁老师！
166898,282,梁清华,2023-01-14 07:13:53,1,1,0,点名会提前通知，给分好，负责任，老师还很正，满满正能量，还会帮助同学做人生规划，非常棒
167152,282,梁清华,2023-01-15 04:25:22,8,9,1,梁老师的课真的能学到很多，她布置的作业都是有实在意义的，思修取消了读书报告，老师给分也很好！大爱梁老师！
169298,282,梁清华,2023-02-25 09:30:30,0,1,1,感谢梁老师
169438,282,梁清华,2023-02-26 07:12:37,9,9,0,“慕强不是爱，爱是平等”
169517,282,梁清华,2023-02-26 15:06:44,5,7,2,选过梁老师的思政课的懂的都懂，绝对的满分
169711,282,梁清华,2023-02-27 13:00:53,0,5,5,梁老师真的很好，思修原本是一节水课，但是听她讲真的会被吸引，然后或许她比较反卷？我的志愿报告、职业规划、小组报告字数都超多（没有在卷，就是真的很想写好多），上课回答问题也特别多，但是没满...但是不影响给老师打10分，职规也选了梁老师的！
170551,282,梁清华,2023-03-06 10:39:40,1,2,1,认真的好老师
170580,282,梁清华,2023-03-07 03:04:52,3,4,1,救命，法学基础事好多 \n\n但是还想给老师10分！
170876,282,梁清华,2023-03-11 05:21:27,1,2,1,不用多说，就是好
171789,282,梁清华,2023-04-05 12:52:48,-4,5,9,法学基础也太不专业了吧
171976,282,梁清华,2023-04-14 14:39:54,9,9,0,我真的吹爆这个老师。梁老师上课的时候能用非常平静的语气剖析一些社会热点问题，在谈论性和婚姻这种话题的时候也是毫不避讳。还有她非常打动我的一点是她真的又在身体力行啊！我在浙大的一个鸟群（关于观鸟和鸟类生态保护的群）看见她的时候我真的破防了，必须给10分！
172576,282,梁清华,2023-04-30 13:06:21,-7,3,10,4.2居然在平均绩点以下😳，凭什么给我4.2
173185,282,梁清华,2023-05-15 06:14:53,1,3,2,无脑十分
173464,282,梁清华,2023-05-25 12:03:00,4,4,0,法学基础：老师讲得例子很多，很清晰；事有点多；在小组讨论上遇到很坑的组长，体验感不是很好；但是老师给分真的很好
174651,282,梁清华,2023-06-15 06:04:04,0,2,2,有一说一，老师人还是不错的，讲得也很好，认真听还是会很有启发的（可惜我对法学没啥兴趣，就没认真听）。期末也没有考试。\n\n不过事情其实也不太少，必须水水读书报告和讨论报告，每节课都有任务。\n\n而且虽然不点名，但是是小组讨论，你也不好意思每一次都不来……
174808,282,梁清华,2023-06-18 09:12:03,2,3,1,非常非常好的老师!
174904,282,梁清华,2023-06-19 13:26:11,2,3,1,没发过言，思考题和论文都很水，最后4.8，夸爆老师
174956,282,梁清华,2023-06-20 12:03:29,3,4,1,好好好
175548,282,梁清华,2023-06-25 12:43:46,2,3,1,长叹一口气
175629,282,梁清华,2023-06-26 03:10:30,3,4,1,法学基础，老师讲的很好，能学到很多有用的东西，小组作业和读书报告认真完成得分就很好，很推荐这门课
175635,282,梁清华,2023-06-26 03:32:08,-4,6,10,没想象中的好..平时作业和期末论文写的还算比较认真，最后只有4.2
175668,282,梁清华,2023-06-26 06:53:34,-1,1,2,好，不解释
175669,282,梁清华,2023-06-26 06:53:52,1,3,2,给分还可以，也是一位挺好的老师。
175674,282,梁清华,2023-06-26 07:15:07,0,3,3,职规的书面作业相较其他班级还是比较多的，还有一节课来模拟面试，老师讲课还是很有意思的，给分中规中矩。
176683,282,梁清华,2023-06-29 16:48:46,9,11,2,“慕强不是爱，爱是平等”这辈子都忘不了
176743,282,梁清华,2023-06-30 03:31:45,4,7,3,上的职规，老师不鼓励鹅颈，我成就故事、简历制作和职规书写得比较用心，发言一次没有，总评94，感恩。
179565,282,梁清华,2023-09-18 08:45:58,-2,0,2,过来补一个好评
180030,282,梁清华,2023-09-20 07:03:54,2,3,1,当为人师
180570,282,梁清华,2023-09-23 03:06:42,5,8,3,怎么说呢，上的职规，课上说的很多不计入总成绩的任务其实和总评都是挂钩的（印象分很重要），仅仅做好规定计入总评的任务是拿不到高分的，我上学期职规就只拿了4.2
180858,282,梁清华,2023-09-27 08:32:39,7,9,2,23级大一新生表白：\n\n清华老师人真的太好了\n\n今天是第二次上我德法课\n\n本来是小组发言让大家认识各人\n\n结果闹钟坏了睡过头\n\n直接迟到将近一小时\n\n到教室之后从后门溜进\n\n和同组成员一起坐在前排\n\n内心无比煎熬\n\n已经措辞好反思了\n\n然后下课找老师自首\n\n结果  结果  清华老师直接说\n\n“没事，我没记你”\n\n大学牲的感动就在一瞬间啊😭
181588,282,梁清华,2023-10-23 23:19:55,-1,0,1,无论如何，事情多，讲的确实好
183789,282,梁清华,2023-11-30 06:28:55,-1,0,1,最好的思政老师\n\n自己给我们组织清理一枝黄花的志愿活动，还给我们分享志愿活动\n\n上课也很有意思
185054,282,梁清华,2023-12-26 04:38:15,0,1,1,真的好老师
187927,282,梁清华,2024-01-17 23:55:52,0,1,1,没有读书报告的思修课，老师还会组织大家在上课时间去校外进行有意义的参观
188036,282,梁清华,2024-01-18 05:08:46,2,3,1,不点名，没有读书报告，重在实践，老师让我们真正在课堂内外去领悟思想道德与法治的真谛，期末还没出分，先给10分。
188179,282,梁清华,2024-01-18 10:53:23,1,3,2,没有读书报告和调查类作业，研究性作业很有意思（职业规划对个人很有用，而且小组讨论也了解不同专业的职业规划方向），老师比较重视志愿活动，而且会提供很多志愿活动服务的途径（就是不太好抢），比起其他班的志愿活动要更好找。给分很好，还被捞了（感觉自己志愿服务做的不够多）。老师上课也比较有意思，亲和力很强。冲就完了。
188254,282,梁清华,2024-01-18 13:35:19,-1,1,2,十分注重志愿服务和社会实践，在梁老师的思修课上可以去到人民法院、宪法纪念馆、环保公司等各种可以收获真知识，得到真体验的地方，没有繁琐的读书报告和小组展示，给分也超级超级好，拿到了人生中第一个满绩，快快选之！
188258,282,梁清华,2024-01-18 13:41:31,0,1,1,感谢老师让我思考了很多之前从没考虑过的问题，最后给分也特别好
188278,282,梁清华,2024-01-18 14:26:05,-1,2,3,事太多了有点受不了
188369,282,梁清华,2024-01-18 23:27:54,0,1,1,还没出分，但给10分💖💖
188456,282,梁清华,2024-01-19 04:35:45,0,1,1,yyds
188573,282,梁清华,2024-01-19 09:35:47,3,7,4,梁清华老师的德法课出分了，想留下自己的一点痕迹供后人参考。\n\n不可否认，梁清华老师是位好老师，从大家对她课堂形式的改革中便可窥见一斑，梁老师不是很喜欢点名，一般是应上级要求会点名，而且会在课前提醒同学哪节课要点名，然后作业形式是一次职规作业，一次志愿者服务报告，一次研讨性学习。上课不会拘泥于课本而是根据课本知识点去讲相关案例和内容，意于价值观层面引导我们，对于认真听课的学生来说是不可多得的好课。\n\n至于给分方面，看个人目标，基础目标都能完成就有4.2。至于高分，就从本人的情况来说吧。我的总评和期末都是87。因为本人比较傻，不知道思修的行情，但我也上了另外两门类似的课，都有4.5，都是每节课到场无论是否点名，作业都比较用心完成，所以可能有点牢骚。期末分数对我这个纯理笨蛋来说是很满足了。平时分具体分不知道但觉得有点偏低。一方面，从课堂参与来说，有点悲哀的是梁老师的课上听讲的人比较少，相应的发言的人比较少，老师说分数组成时没说课堂参与和分数的关心（所以我就…）我去了解了一个同组发言展示比我多的同学有4.5，感觉课堂上发言还是比较重要的，以后这种文科方向的课要多发言。然后，从作业来说，凭心而论我的两个个人大作业是用心投入的，没用gpt，都是自己查资料了解后自己完成的。职规作业从布置之初我就计划去做了，老师设置了一些加分项但由于时间缘故未能完成。志愿服务要求完成4次，我完成了十余次累计40余小时（虽然不太多，但对作业是超额完成了）内容常规应该是85左右的水平，（从一些要求写文章的课程中看出）因为电脑比较烂，平时不怎么用，因此可能作业的形式会差一点，所以相应的分低一点，还有课堂参与比较低，老师没法捞你。\n\n所以总结一下如果想要拿到高绩点，在提高课堂参与度的前提下（上课真的没什么人发言）把作业的格式弄好，一些明确列出的加分项去完成。
188690,282,梁清华,2024-01-19 14:30:26,-2,0,2,老师上课一般不点名，偶尔点名会发通知，课上事也不是很多，期末绩点4.5，挺不错的
188732,282,梁清华,2024-01-19 17:43:24,1,2,1,点名的课会提前通知，事少分多，没卷过发言除了一次意外被点起来分享，和熟人组的小组效率很高，作业也完成的很棒，最后4.8，老师我爱你❤️
188911,282,梁清华,2024-01-20 14:19:45,-1,1,2,yyds！
188976,282,梁清华,2024-01-21 03:55:08,3,5,2,梁老师真的是非常好的老师，她让我第一次感受到德法思修课，也不是那么枯燥与乏味的。梁老师给我们推荐很多志愿者的群，介绍很多志愿者活动给同学们；她也会努力的去争取带带同学外出实践，去垃圾场、去法庭，都是梁老师努力与外协调争取到的机会。梁老师鼓励我们在实践中去获得知识，她将读书报告的作业替换成职业生涯规划，这对于刚入大学的我们，是一次很好思考自己未来的机会。梁老师的课堂上会讲很多事例来引导我们对这个世界、对自己的人生有更深的思考，她还会请优秀的学长学姐带来经验分享。印象很深的一次是梁老师在群里说有同学在法院庭审时却在玩手机，她感到非常的难过，因为这次机会本就是非常难争取到的，她不知道以后对方还会不会愿意让浙大的同学再次走进法庭。那一刻，我真的感受到了梁老师的良苦用心，为此非常的感到...All in all，梁老师真的是很好的老师！
189864,282,梁清华,2024-01-31 11:21:17,1,5,4,怎么说呢，人挺好的一老师，但是给分好像都给的89……，有点平均了，这个老师好像不太喜欢给高分，但也不会给太低分
191764,282,梁清华,2024-04-30 01:47:41,1,3,2,法学基础课，事有一点，3个小组报告和一个期末3000字读书报告，但给分确实很好，听老师分析法理和案例也挺有收获的。
191906,282,梁清华,2024-05-04 12:39:50,4,6,2,第一次当通识课的组长，老师知识面很广，上课真的很爱提问，回答的同学似乎总是那几个人，大多数同学都比较i，第一堂课很有意思，老师让同学们自己组队，最后一节课的职业生涯规划书报告也不是很卷，有人准备了精美的ppt，有人就是单纯念一下，最后给分似乎应该不是很大。很棒的课，美中不足的是，这门课程给我一种感觉，那就是，总有一种象牙塔里的老道士给小道士讲外面的世界的感觉，
192645,282,梁清华,2024-05-26 13:09:22,-3,3,6,上学期上的梁老师的思修，纯理科生，绩点4.8(94)，我觉得不存在楼下说的老师不愿意给高分的情况。不过这种课程本身就随机性较大，梁老师上课幽默风趣，点名提前通知，作业不为难同学，我觉得真的很好了~~ 10分送上
192971,282,梁清华,2024-06-01 11:22:53,1,2,1,很好的老师
196570,282,梁清华,2024-07-04 05:57:34,2,3,1,良心老师，作业迟交了一次还有90分，平时上课也基本没听过
198475,282,梁清华,2024-09-09 06:45:50,0,1,1,梁老师有事先说，替学生考虑
199451,282,梁清华,2024-09-24 02:39:38,3,4,1,很棒的老师。虽然我对道法不感兴趣，课也没有很认真地上，但也能感觉到老师讲的不错。此外，老师会提供很多志愿咨询，也会发很多有意思的资料（虽然我基本不看…）
199625,282,梁清华,2024-09-26 10:39:48,-1,0,1,讲课很有趣
200680,282,梁清华,2024-10-21 02:53:59,0,2,2,带我秋游必须给十分
200682,282,梁清华,2024-10-21 02:54:34,2,3,1,老师上课会组织社会实践，很好
201364,282,梁清华,2024-11-01 06:27:26,2,3,1,这真的没得喷，我喜欢你！！！！！！！！！！！！！！！！！！！！！！！！！！！！！！！！！！
205606,282,梁清华,2024-12-10 05:42:35,2,2,0,非常好
205891,282,梁清华,2024-12-12 13:04:45,4,4,0,妈妈！
207859,282,梁清华,2024-12-24 14:02:24,3,3,0,老师超级好，讲了很多一般老师会避之不谈的东西，作业虽然有点多但是认真做真的会很有收获，狠狠表白梁老师
210061,282,梁清华,2025-01-08 04:55:10,3,4,1,老师非常好啊！\n\n老师说话很一针见血，思想也很开明。\n\n德法课用更多的志愿者分数替换掉了读书报告，感觉收获很大。\n\n请学长学姐做讲座，组织学生外出参观，分享时事热点，给分也很人性。\n\n选到就是赚到啊！
211653,282,梁清华,2025-01-12 06:06:56,1,2,1,真的人生导师。在这种“大水课”，老师的作业和其他班不一样，不用写读书报告，写了一篇生涯规划报告，一篇志愿服务报告和一篇法律学习的报告。事情可能是比其他老师多，但是作业认真做的话还是挺有意义的。在一定程度上这节课也达到了它本来的目的了。
211869,282,梁清华,2025-01-14 07:45:00,-5,4,9,老师点名会提前通知，给分无敌好，平时作业认真搞搞，考试的时候尽量写满，老师会看到你的努力的，最后97，仅供参考
211872,282,梁清华,2025-01-13 00:58:06,3,4,1,出分了，课一点没听，作业我是认真写的，考试大家都一样，会翻书就行，最后拿了4.5，仅供参考。而且老师会想法设法去搞一些活动，志愿者的要求比较高但只需要参加老师提供的活动也可以完成，总体而言是一个很好的老师。
211877,282,梁清华,2025-01-13 05:06:37,0,6,6,给分不好
211878,282,梁清华,2025-01-13 01:02:45,2,2,0,老师很好，强力推荐
211880,282,梁清华,2025-01-13 01:05:15,2,2,0,思想道德与法治:梁老师上课会讲很多有用的知识，不限于课本，涉及面很广，课后事情也不算多，要点名会提前通知，给分也非常好
211897,282,梁清华,2025-01-13 01:22:00,2,2,0,就是好！
211900,282,梁清华,2025-01-13 01:24:13,4,4,0,梁老师的课特别有意义，会和我们讲很多真实案例，也会组织学生参观宪法馆等等，给分也特别特别好，qhqh我们喜欢你！！！！
211918,282,梁清华,2025-01-13 01:50:18,0,2,2,坦率而温柔，博爱而深刻。
211923,282,梁清华,2025-01-13 01:55:11,1,1,0,老师超好。。上课内容非常有意义呜呜呜虽然事情会有一点但是认真做就会有回报，最后4.8了满意离开🥹
211950,282,梁清华,2025-01-13 02:40:38,1,1,0,总的评价就是很好一老师
212000,282,梁清华,2025-01-13 04:17:00,2,2,0,老师上课很有趣，打破了对思政课的刻板印象。错过一次大作业的ddl，分数拉低均绩，但是还是很满意了。
212002,282,梁清华,2025-01-13 04:18:39,-1,0,1,点名提前通知，讲课超级有意思，给分很好很好，作业好好做就行
212011,282,梁清华,2025-01-13 04:30:11,1,1,0,很好的老师，给分感觉主要看你究竟为社会做了什么。我志愿活动14h最后4.5，室友志愿活动20h+最后5.0。课堂不局限于空洞的内容，而更注重对社会的贡献。
212063,282,梁清华,2025-01-13 06:31:50,1,1,0,上课蛮好的，虽然我也基本没听（bushi），点名会通知，作业量稍微有点多，但是都还算有点用吧，最后89，不知道捞没捞。\n\n比较推荐（虽然是大概率是预制），10分
212070,282,梁清华,2025-01-13 06:46:05,2,2,0,讲的很好，虽然不怎么听上课学微积分的选手，要是作业用心一点也有4.8，好评
212423,282,梁清华,2025-01-14 03:40:40,1,2,1,思想道德与法治\n\n取消掉其他老师所谓的“读书报告“，老师真的非常务实，这点直接10分\n\n上课大家都一样，期末抄抄书(老师说之前还取消掉了纸质考试，现在加回来了她也不理解哈哈哈哈哈)\n\n老师人真的非常好，给分应该也算挺好
212809,282,梁清华,2025-01-15 03:17:37,2,3,1,很有理想信念的老师 是真的在希望我们做一些有意义的事情
213244,282,梁清华,2025-01-16 12:51:49,1,1,0,挺好的，讲课很水，都会画重点
214146,282,梁清华,2025-01-25 11:10:55,-4,0,4,人生的第一个满绩！伟大无需多言！！！\n\n给分很漂亮欸，我不是组长也没感觉自己很费心思写平时作业
214576,282,梁清华,2025-02-13 12:45:27,2,2,0,给分巨巨巨巨无敌好，爱死梁老师了！！！
214926,282,梁清华,2025-02-19 06:33:39,3,3,0,很好的老师，她很喜欢志愿活动，大学第一个5.0，真正的分高事少有意义
217944,282,梁清华,2025-04-18 07:43:33,4,5,1,老师确实上课很认真，很有意义\n\n但就是分数确实没有达到预期
217947,282,梁清华,2025-04-18 08:12:15,2,3,1,个人感觉法学基础给分不如预期吧，每项任务也都认真完成了，但是一门通识课的成绩甚至不如硬课。追求高绩点的话还是再考虑一下，如果只是喜欢法学知识的话可以选。
217961,282,梁清华,2025-04-18 11:39:23,1,1,0,感谢老师 这门课想要满绩要把作业写好 上老师的课实实在在可以获得很多知识 收获满满
219754,282,梁清华,2025-06-05 07:16:27,0,0,0,蛮好的老师，给分好
219798,282,梁清华,2025-06-06 12:17:14,0,1,1,职规，事挺多的。印象最深刻的是某天晚上要求展示，但是当天早上才通知，我那天还是满课……
220628,282,梁清华,2025-06-19 03:50:05,2,2,0,法学基础，满了，小组作业小组长很给力，个人作业好好写，小组分数都很高！
220755,282,梁清华,2025-06-19 14:04:57,1,1,0,老师讲课特别有意思，法学基础最后论文认真写了也得到了自己满意的分数
221368,282,梁清华,2025-06-23 05:51:03,0,0,0,大一绩点德法、职规全靠梁老师拯救，可以选择水，愿意听也可以学到东西
29,291,浦永春,2015-03-14 15:28:43,-11,20,31,这些讲的挺好的。给分也是辣手无情的。
2032,291,浦永春,2015-03-29 18:42:36,105,141,36,讲一大堆空话。。。。又不能水。。。否则问题答不上来要扣分。。。
2101,291,浦永春,2015-04-01 11:10:33,17,37,20,上课简直是煎熬
2870,291,浦永春,2015-05-09 15:35:13,40,66,26,给分低 破事多 讲得差 还点名
3131,291,浦永春,2015-05-16 01:41:53,7,23,16,从未见过有如此
3353,291,浦永春,2017-08-28 01:19:46,82,106,24,没有重点。。只顾自己讲得欢。。听课的感觉就是。。大哥你真的好吵。。。太煎熬。。。
3595,291,浦永春,2015-06-17 01:46:14,3,19,16,学养很深，但上课会扯得太开，没有系统逻辑感，听着累累的
3638,291,浦永春,2015-06-17 01:56:52,20,33,13,明明是话剧课老师好不好，爱讲就自己讲吧还提个破问题提问
4097,291,浦永春,2015-06-17 16:52:14,-5,4,9,哦
4273,291,浦永春,2015-06-18 13:41:36,28,41,13,讲的什么玩意儿
4363,291,浦永春,2015-06-19 13:40:26,-9,9,18,屁事少 上课不管 讲的还是很有意思的 比较水的一个老师
4549,291,浦永春,2015-06-24 08:56:12,-8,9,17,虽然事多，但给分貌似不坑
4612,291,浦永春,2015-06-25 03:27:31,26,44,18,呵呵。当年跟教务举报过他。
4680,291,浦永春,2015-07-10 07:13:35,24,41,17,以为自己很厉害的老师
4712,291,浦永春,2015-06-26 12:05:11,-8,10,18,挺好的老师，如果好好听还是很有收获的
5277,291,浦永春,2015-07-06 09:02:19,20,32,12,浪费生命
5671,291,浦永春,2016-06-21 13:48:10,6,15,9,无聊
5736,291,浦永春,2015-07-09 08:21:13,74,109,35,一是毫无党性，这在思政课上绝对不允许。二是毫无计划性，前六周都是导论，七到十四周讲哲学。三是表达极不连贯，废话多，达到无人听课之境界。应立刻退出教学一线。
5778,291,浦永春,2015-07-09 10:23:28,-5,9,14,好
6634,291,浦永春,2015-07-16 15:33:09,-8,12,20,给分良心啊
7039,291,浦永春,2015-08-31 15:19:10,-9,11,20,老师的学术水平挺高的，但是主要集中在西方哲学，对马克思主义可能不是很认同，是右派分子。
8110,291,浦永春,2015-09-17 05:13:43,6,13,7,垃圾老师
8698,291,浦永春,2015-09-24 07:14:56,0,5,5,不让做其他事
8719,291,浦永春,2015-09-24 11:26:24,2,7,5,老师真逗，废话一大推
9137,291,浦永春,2015-10-14 05:03:20,4,10,6,差到爆。讲的不好还不让做其他事情
9541,291,浦永春,2015-10-29 11:12:46,5,12,7,上课讲的很散，很乱，感觉总是自己讲得很欢，别的不管了
10635,291,浦永春,2015-11-21 05:07:56,0,5,5,不知道为什么讲哲学的老师逻辑会这么差，有问题的话，会迂回乱讲其他废话，不知道学到了什么
11183,291,浦永春,2015-11-25 05:13:31,8,16,8,上过课的最差的老师！ 与思政课无关，仅就是他讲课实在烂！从未畏惧和反感过上某课，但他的课会让你这样。
13507,291,浦永春,2015-12-28 16:33:49,-1,5,6,傻逼老师
14012,291,浦永春,2016-09-16 02:42:57,3,39,36,我觉得讲的挺好的啊~为什么得罪了这么多人？！
14013,291,浦永春,2016-01-03 15:56:08,-5,7,12,上课挺好的
14023,291,浦永春,2016-01-04 00:25:33,0,4,4,还好吧
14144,291,浦永春,2016-01-05 02:37:02,17,28,11,从小到大对必修思政课毫无兴趣但浦老师也是……平时一篇论文一次课堂展示，比较水但讲课真吵还找不到点，还要随时留意免得他一提问不知道问的什么扣你分【只求给分好点】
17714,291,浦永春,2016-01-20 16:58:56,5,11,6,浦公知。
17769,291,浦永春,2016-12-01 07:21:01,-37,7,44,这个老师可以水发言加分，虽然大家给他评分都那么低，但我还是满绩了。
17811,291,浦永春,2016-01-21 02:07:16,48,57,9,此人只应天上有，人间难得几回闻。
17852,291,浦永春,2016-01-21 02:44:30,4,10,6,小组展示做得好的话给分还是很不错的，还有就是《马克思为什么是对的》那本书看一看对这门课还挺有帮助的～
17853,291,浦永春,2016-01-21 02:46:29,0,3,3,无语啊
19133,291,浦永春,2016-01-23 10:16:50,20,26,6,上课不让干别的，讲得乱七八糟，还叫人回答问题，给分一般般，也不是很坑
21682,291,浦永春,2016-02-29 15:27:53,-13,3,16,好好好，满记了
21684,291,浦永春,2016-02-29 15:26:43,-7,2,9,给分超好
22006,291,浦永春,2016-03-02 05:40:10,-8,2,10,觉得挺好的啊
22713,291,浦永春,2016-10-30 22:21:09,21,32,11,感觉自己上了好久的形势与政策。……
23487,291,浦永春,2016-03-31 10:56:33,6,10,4,说话思路太令人费解，不全神贯注根本听不懂他的主题
23646,291,浦永春,2016-04-11 12:55:45,-1,3,4,我觉得还可以啊，只不过上课不讲马原，讲哲学史
24540,291,浦永春,2016-05-01 09:46:08,-16,4,20,下面有好多烂人，难道老师点名或者叫你们回答的是错了么
24797,291,浦永春,2016-05-03 16:38:03,-9,1,10,客观的讲，老师造诣算很深，只是授课的方式太一般了。
27310,291,浦永春,2016-06-24 15:04:01,11,16,5,看得出来很像把哲学讲好，上课还算用心，不过水平不敢恭维，讲课真心烂，太能扯。一个话题讲着讲着就开始离题万里。个人不建议选。
27833,291,浦永春,2016-06-27 19:39:34,-1,1,2,给分低，事情特别多
28188,291,浦永春,2016-06-28 08:14:14,-8,1,9,很好，每节课都有收获！
30504,291,浦永春,2016-07-01 23:02:25,-5,0,5,还好吧
31302,291,浦永春,2016-07-03 15:18:31,4,8,4,上课烂，课都讲不完，还给分差，本来不是这老师的课被调剂过去的，坑！
31310,291,浦永春,2016-07-03 15:39:56,0,2,2,给分极低。只喜欢一些毫无意义的打卡发言。
31388,291,浦永春,2016-07-03 23:57:25,13,17,4,简直了，讲得不仅差劲，给分还不好。他还每次上课满肚子牢骚，真是老师有差别啊，这学期碰上他……算倒霉
31408,291,浦永春,2016-07-04 01:09:46,10,16,6,老师可能是哲学太厉害了，或者是脑袋拎不清，反正胡话一番，跟课本无关，乱吠行空，我也是醉了。。。此外，节节课认真听的我被正太了，我只能说保留意见，呵呵~想学点东西，建议远离~
31437,291,浦永春,2016-07-04 02:11:12,4,5,1,真的心好累 差 不想多说什么
31467,291,浦永春,2016-07-04 02:56:10,0,1,1,给分挺好的
33671,291,浦永春,2017-01-23 01:32:20,16,18,2,讲的不咋样，但是只要按他的要求，每次任务都认真做，给分还是蛮好的
34178,291,浦永春,2018-09-17 09:20:34,20,34,14,海宁人加三分
34188,291,浦永春,2017-01-04 05:39:42,22,29,7,看到这么多人骂他我就放心了
34489,291,浦永春,2016-10-12 02:28:39,6,6,0,这种辣鸡…让我怀疑浙大挑选老师的标准…或者审查老师质量的标准…浪费所有人的时间
34490,291,浦永春,2016-12-21 09:37:07,0,2,2,不想写三个字
34502,291,浦永春,2016-10-12 06:12:44,6,7,1,这老师忒差呀。。讲的和课程基本没什么关系，浪费时间与精力，我也是醉了
34585,291,浦永春,2016-10-14 16:28:34,4,4,0,翔一样的上课体验！
34750,291,浦永春,2016-12-22 06:24:35,5,5,0,这老师讲话太没有条理了，还自大无比，听过的课讲的最糟的老师之一
35159,291,浦永春,2016-12-29 13:11:24,38,49,11,提问的时候不知道问题扣一分，没来上课的给零分，这给分方式也不是一般的傻逼才能想出来的
36776,291,浦永春,2016-11-16 03:22:15,2,3,1,呵呵…
37099,291,浦永春,2016-11-17 11:49:58,22,30,8,哎，作为浙大老师，这么大岁数的人了，要靠学生的课堂参与度提升自己的存在感，不论其教学水平，只是境界太低...
38019,291,浦永春,2017-01-22 15:23:08,10,21,11,给分如何不能改变教得烂的事实
38104,291,浦永春,2017-12-25 12:52:29,24,37,13,说话毫无逻辑，还有些不明所以的转折和停顿，即便你好好听课也不见得听懂…也毫无党性，没有上马原课的基本素质，就知道吹思辨，还自我感觉良好，秋冬学期跟一个傻不拉叽的东北口音的同学一直唱二人转
38113,291,浦永春,2016-11-24 11:53:56,1,1,0,无聊死
38373,291,浦永春,2016-12-01 05:49:44,1,1,0,想死哦
38375,291,浦永春,2016-12-01 06:03:12,8,8,0,神一样的体验
38499,291,浦永春,2016-12-07 06:57:01,3,4,1,竖子安敢妄言！\n\n傻逼老师
38747,291,浦永春,2016-12-16 13:32:21,-8,0,8,良心好老师
38748,291,浦永春,2016-12-16 14:56:52,-16,0,16,这个老师是真正把这门课作为哲学课来上的，他本人也是政治哲学出身，讲得很好。加分的机会有很多，基本上点名就是给加分机会的，回答一次问题加3分的那种，不论好坏，很慷慨。
39408,291,浦永春,2016-12-22 13:18:14,6,6,0,让老师公示平时分也不公示；交作业给课代表，不管是网上打印答案还是自己做的都是一样的分数；上课也不讲跟课程内容有关的内容，只有期末了会讲一点；邮箱和摆设一样，发了邮件基本不看…………\n\n  我觉得他对这门课不上心
39906,291,浦永春,2016-12-28 06:58:21,0,0,0,自以为是，不懂还乱扯。
40089,291,浦永春,2016-12-29 06:29:06,7,9,2,一分不能更多了，从第一节课开始到现在一直试图营造出一种我是一名很有趣很民主的老师，我和其他那些妖艳贱货并不一样，然而，点人起来回答问题，说不能重复问题的话就扣分，被人重复出来了问题但只是说了一句我是文科生对物理不太了解所以我不知道，这老师上来就那我要扣分了。好好好您扣您扣，你的课你讲的开心就好了。
40137,291,浦永春,2016-12-29 11:51:09,2,2,0,大概是一种煎熬吧
40155,291,浦永春,2017-01-22 04:24:51,-7,3,10,老师给分超级超级好～
40162,291,浦永春,2016-12-29 13:48:29,0,0,0,老师神烦....上课自习也要管，学生展示基本不听，就让课代表主持
40519,291,浦永春,2017-01-04 02:56:58,5,9,4,想给负分。自以为学识上天入地。为了让同学听他讲课不择手段，总是拿平时分乱来。一个学期下来对他说过的话的印象只有“我讲得这么好你们竟然不听，太为你们感到可惜了”抱歉我真的听不下去
40570,291,浦永春,2017-01-04 06:10:32,1,2,1,一分不能更多
40576,291,浦永春,2017-01-22 04:57:20,16,20,4,给分不错的呀……毕竟考试都没有复习……老师很仁慈了 平时事情不多 也就下班学期一个展示一篇论文
40757,291,浦永春,2017-01-05 08:47:09,5,6,1,无事生非，不知所云
40964,291,浦永春,2017-01-07 01:32:51,2,3,1,只想说 平时分加分机制有点随便吧 ...完全随心情加三分...
41248,291,浦永春,2017-01-10 08:14:52,1,1,0,迷……上课完全不知道在干嘛
41359,291,浦永春,2017-01-11 04:38:31,2,3,1,3分不能再多，极品
41914,291,浦永春,2017-01-13 08:20:38,2,3,1,我大概是在假浙大
42251,291,浦永春,2017-01-14 03:12:36,0,1,1,只会吹牛
42503,291,浦永春,2017-01-21 00:44:16,1,2,1,出分好慢。。。。
42779,291,浦永春,2017-01-15 05:21:50,-2,2,4,我是那个不知道问题被扣了一分的，我给他十分。没来的被给0分自己看看应该打多少分吧！
44953,291,浦永春,2017-01-22 00:42:45,6,12,6,马原分数出乎我的意料，谢谢老师了！
45043,291,浦永春,2017-01-19 01:24:32,9,9,0,已毕业，知道现在有这个平台特地回来补个评论。 上课内容与课纲不符，提问不合他意倒扣分（没来听课的倒是不扣分），当年跟教务处刘向东老师举报过这个人。
46484,291,浦永春,2017-01-22 00:55:59,-3,1,4,给分不低但是没有我预期的高...毕竟期末考试每道题目我都跟小论文一样作答的...上课有机会的话多回答问题～然后就差不多了～虽然老师上课讲得有些不知所云...但是反正我不听思政类的课，所以，也还好啦～
46486,291,浦永春,2017-10-18 03:09:18,-13,9,22,可以看得出浦老师是一个很好的老师，只不过是学生有一些水而已
46514,291,浦永春,2017-01-22 01:37:10,8,12,4,事情少，给分好
46522,291,浦永春,2017-01-22 01:47:26,8,13,5,给分真的不错，上课从来不听讲（说他吵的不要听做自己的事不就行了？？），考试前水一水，本来没报太大希望，结果老师给了4.5
46539,291,浦永春,2017-01-22 02:17:41,21,26,5,浦老师上课真的有些听不懂，但是给分挺好的，平时发言加三分，形式逻辑作业都做了加六分，成绩与自己表现呈正比的。
46551,291,浦永春,2017-01-22 02:39:50,-7,13,20,浦老师给分超级好，平时上课也很风趣……满分?
46553,291,浦永春,2017-01-22 02:41:06,-6,3,9,人挺好的，给分也不错。尊敬一下考试吧
46554,291,浦永春,2017-01-22 02:41:14,1,4,3,喜欢脱离书本讲逻辑，知识渊博
46557,291,浦永春,2017-01-22 02:47:22,16,18,2,上面同学说的都对，但是事情不多给分还好，哪里找这么水的马原老师去\n\n
46561,291,浦永春,2017-01-22 02:52:12,2,5,3,上课感觉老师在乱讲，但是仔细听老师讲的还是很好的，认真回答问题，分分钟上4，老师也挺辛苦的，呼吁大家好好听课
46563,291,浦永春,2017-01-22 02:54:48,-5,5,10,其实老师挺可爱的呀，就是不上正课，不过思政课确实也没人听。老师就一直说自己上课上的好可惜没人听，不知道为什么觉得有点萌(๑• . •๑)
46566,291,浦永春,2017-01-22 02:58:48,-4,4,8,老师真的挺好的不懂分为什么这么低  上课很萌啊～而且讲得也很好不像其他思政课那么无聊～
46596,291,浦永春,2017-01-22 03:30:17,4,6,2,想高分的同学上课一定要多发言
46598,291,浦永春,2017-01-22 03:34:27,2,6,4,老师还是可以的，给分的话我是不知道我考前认真看书还每道题都认认真真写为什么这么低
46599,291,浦永春,2017-01-22 03:38:03,0,3,3,思政课就是sb\n\n不如多修cs
46601,291,浦永春,2017-01-22 03:40:09,2,5,3,说真的，老师上课确实不讲马原的东西，听得乱七八糟，但是给分是真的好。附加作业形式逻辑做一下，上课发言一次，很容易把分数拉到前面。本来以为马原炸了，意外给了4.5。总结就是上课在我看来真心不想听，想得高分还是很有希望的！
46614,291,浦永春,2017-01-22 04:05:36,0,4,4,我觉得老师蛮好的，在很多马原老师里算是事情少的了，而且给分也很不错啊，
46636,291,浦永春,2017-01-22 04:35:58,3,5,2,我不知道是马原老师都这个样还是什么，能不能好好按照课本推进，一些要求能不能讲清楚点。
46643,291,浦永春,2017-01-22 04:52:19,1,3,2,不知道自己做了什么竟然4.5
46660,291,浦永春,2017-01-22 05:40:32,-22,2,24,明明炒鸡认真，上课不水，作业完成，展示很好，考试还刷了很多套卷子，结果只有4.5。好生气
46789,291,浦永春,2017-01-22 10:18:56,1,2,1,给分不错，讲课爆炸体验
46805,291,浦永春,2017-01-22 10:59:13,3,3,0,上课没啥逻辑...但只要论文认真写...小组展示差不多....分还是可以的，而且事不是很多，还算水
46844,291,浦永春,2017-01-22 12:39:10,20,24,4,相比其他老师事挺少的，平时不想发言的有一份形式逻辑的课后作业做完可以加六分(其实网上都有答案)，考前把选择题题库刷一遍，考试题基本都是题库里的，最后拿了4.8，感觉应该是选择题的功劳。。。
47562,291,浦永春,2017-01-31 06:45:46,0,1,1,额……
47833,291,浦永春,2017-02-26 02:28:41,1,2,1,不知所云，但是给分极好啦！
48742,291,浦永春,2017-03-11 03:34:52,-2,6,8,浦老师知识水平很高，为人也很有风度。平时事情不多，认真对待的话给分不错。
49227,291,浦永春,2017-03-30 04:12:20,-1,1,2,辣鸡\n\n我只想说，人贵有自知之明
49601,291,浦永春,2017-04-20 04:04:32,3,4,1,从未见过问个问题没人知道然后把所有叫到的人全都扣分的老师\n\n
51590,291,浦永春,2017-06-07 10:51:55,2,4,2,在马原老师里面算好了
54853,291,浦永春,2017-06-30 10:17:41,1,5,4,给分真心不错，期末考成那样子还能上四\n\n老师凭良心说真心不错\n\n可能有的观点确实不是主流的\n\n上课也不按照课本来\n\n但是有什么关系呢\n\n给分好就行了啊\n\n其实细细听课还是会有一些收获的\n\n没必要那么功利主义
54954,291,浦永春,2017-06-30 13:17:53,2,4,2,其实老师很希望我们多听听课
58172,291,浦永春,2017-08-14 10:09:51,7,11,4,浦的问题在于修养不够却自以为饱学，简而言之就是自大。他喜欢对自己不了解的东西发表评论，颇有民科的做派。但是从另一个方面讲，浦也还算有一点知识分子的气概，至少还有点自由的精神，对待争论的态度也还像个老师。\n\n总的来说，这种人活在自己谬误的、狭小的世界里，已经没有什么改变的余地了，上他的课，就权当去认识一类新的人吧。
59158,291,浦永春,2017-09-20 03:57:42,2,4,2,听得困死
59191,291,浦永春,2017-09-20 06:46:09,2,3,1,事情少
59206,291,浦永春,2017-09-20 07:30:33,0,3,3,简直可怕，如听天书。。。。杀了我吧
59209,291,浦永春,2017-09-20 07:35:27,-2,1,3,一堂课水完手机居然还写了五门课的作业。。。。。。
59785,291,浦永春,2017-09-27 03:13:29,4,7,3,讲的什么东西!拜托你讲马原好吗？简直浪费生命在忍受他毫无主题毫无逻辑的瞎扯，把能掐会算和九章算术混为一谈的老神棍，拜托浙大清理下这样的老师行吗？给跪了简直
59792,291,浦永春,2017-09-27 03:49:10,3,6,3,老师，我觉得您可以去竞争一下诺贝尔哲学奖?
59820,291,浦永春,2017-09-27 07:49:19,1,3,2,听他讲课真是煎熬，一顿乱扯，还不如不听。要被逼疯了。
59879,291,浦永春,2017-09-28 03:26:25,1,3,2,讲的什么东西？？和马原没有一点关系，就是自己怎么开心怎么讲，动不动就问一些没营养的废话问题查学生家谱，真的是服了
59905,291,浦永春,2017-09-28 06:15:24,0,2,2,"思维十分凌乱，想到哪讲哪，无语O__O""…\n\n"
59911,291,浦永春,2017-09-28 06:38:19,2,3,1,你秀的我头有点晕
60119,291,浦永春,2017-10-11 04:07:46,3,7,4,看不起中国，妄自菲薄，不去调查就乱下结论，中国大学中的毒瘤
60175,291,浦永春,2017-10-12 06:14:14,2,7,5,一个人的狂欢，一群人的寂寞。
60179,291,浦永春,2018-03-22 06:08:31,18,25,7,怎么说呢，自己的观点为什么要强加给别人。一个同学不过是正常表达自己的观点。还轻蔑地问同学大一还是大二，不喜欢自己的课可以退，一次次想挽回面子？反正本人为这个被怼的同学不平。
60182,291,浦永春,2017-10-12 07:49:26,5,10,5,上课和马原毫无关系，讲话一点逻辑性没有。同学观点不同敢站起来反驳他非说别人是逆反，强行扭曲别人的意思说别人说他没素质。自己讲得烂就知道拿扣分压同学。每次课必发一次火。恕我直言，谁没素质你心里没点13数吗？？？
60185,291,浦永春,2017-10-12 09:16:25,1,4,3,点人回答问题 大家面面相觑（讲这么烂 谁知道你半个钟头前自言自语的疑问是啥）点了十多个人都不知道问的问题是什么 然后全扣了一分（脸可是真厚 这么多人都不知道还要接着一个一个问下去）有趣的是 点人的时候要是人没来啥事没有 人来了回答不上来的全扣分（这种给分方式也不是一般人能想出来的 没错 他说到这种方式的时候十分得意）想想可能是没法退课了开始这样 要不然第一节课人就退完了岂不尴尬 还有封杀所有和他不一样的观点的楼下说了就不赘述了
60348,291,浦永春,2017-10-18 03:08:22,3,6,3,很痛苦
60362,291,浦永春,2017-10-18 06:28:50,9,12,3,哲学课上出菜市场的嘈杂感\n\n不喜欢听取别人的意见和建议\n\n就像菜市场卖菜的小贩计较菜价一样\n\n上浦老师的马原课\n\n不得不说人生的格局小了很多
60657,291,浦永春,2017-10-26 05:53:22,2,6,4,上这个老师的课是我这学期选课最大的错误
60658,291,浦永春,2017-10-26 06:07:17,3,5,2,毫无逻辑的一派胡言
60660,291,浦永春,2017-10-26 06:27:53,1,4,3,为什么不能打0分
60677,291,浦永春,2017-12-21 07:33:08,7,14,7,给助教满分，这助教挺好的
60905,291,浦永春,2017-11-02 05:31:56,1,3,2,与课本毫无关联
62438,291,浦永春,2017-12-27 06:13:45,0,5,5,你是来浙大搞笑的吗
62576,291,浦永春,2017-11-26 03:54:14,11,13,2,老师喜欢给自己加戏，看个电影自己扮演旁白
63209,291,浦永春,2017-11-29 07:52:50,1,7,6,今天老师讲了哲学基本框架，老师讲课很认真，喜欢想到哪讲哪，但我不能认同评论里多数人说的毫无逻辑。主干观点，老师是按照逻辑顺序来阐释的，但有时会出现一些无关紧要的观点。至于说毫无逻辑的，你可能是没跟上，因为你听着听着就忘了刚刚在说什么。不足之处，听课难受，部分观点偏激，作业和提问意义不大。
63533,291,浦永春,2017-12-06 06:25:43,7,10,3,蒲永春浙大是有很多名气小功底扎实的好老师，但绝对不包括你
63578,291,浦永春,2017-12-07 07:45:34,5,6,1,现在感觉自己选的不是马原课? \n\n除了框架在PPT上之外，不就是想到哪里说哪里？这能说有逻辑？?
63938,291,浦永春,2017-12-20 02:29:31,4,6,2,我只能说，为师者自己不能讲到吸引学生，为什么要怪学生不听你的课。
63983,291,浦永春,2017-12-20 12:00:54,1,1,0,不是太糟
64130,291,浦永春,2017-12-21 04:49:45,-3,1,4,挺好的啊。。。
64159,291,浦永春,2017-12-21 06:38:18,11,12,1,此人上课体验极差，知道一点东西就急急拿出来给学生看，实际上半桶水叮当响，却又非常自我陶醉。不符合他的观点的就是错误，就要扣你分，不给人任何辩驳空间；按照他的要求做了展示，就说我们是一群不懂得创新的弱智，逻辑感人素质更感人。还有，在马原课上讲一些牛鬼神蛇的东西真的没问题吗，马克思的棺材板都按不住了。天天发火说我们不听课不听讲，也不想想为什么自己的课没有人听，永远沉浸在自己世界里的老师是不会有学生认可的，1分都是打高了。
64185,291,浦永春,2017-12-21 08:36:56,1,2,1,很不好，不要选
64600,291,浦永春,2017-12-25 12:27:17,0,0,0,很好的老师
64768,291,浦永春,2017-12-27 05:32:37,0,2,2,想刷低绩点的请便。
64782,291,浦永春,2017-12-27 06:18:56,6,8,2,没遇到过声音这么尖讲话还这么吵的老师！对耳朵不好！真的！
64982,291,浦永春,2017-12-28 06:24:12,7,8,1,我求求你不要讲那些你根本不懂的数学物理宇宙了…
65008,291,浦永春,2017-12-28 07:45:29,6,7,1,只听说过上课回答问题答对加分，从未听说过答错扣分，长见识了
65020,291,浦永春,2017-12-28 08:33:53,0,2,2,我是及其后悔那时候没有退掉这门预置课去选别的课了 这个人啥事都要不懂装懂发表一通 然后说话毫无逻辑 反正我认真听过几次基本没听懂他在讲什么  上课还吵 坐在最后一排还是吵 之前的课是不会讲跟课程有关的内容的 只有最后几节课放一下ppt上的大纲然后继续自顾自讲 最大的问题还是不尊重学生 学生提出自己和他不同的观点就是逆反… 还记得有一节课他居然说“你是学生我是老师你没有资格建议我”这种话 呵呵
65318,291,浦永春,2018-01-03 03:30:38,0,3,3,这老师上课就知道吹逼，扯些有的没的的什么哲学，上课点名回答问题答得一般般直接扣一分，回答一堆就算和题目对不上的哲学什么的，直接加三分，真特么厉害
65324,291,浦永春,2018-01-03 03:55:17,0,1,1,不爽  写不下去作业
65349,291,浦永春,2018-01-03 07:49:05,2,2,0,至少他知道很多实例
65895,291,浦永春,2018-01-10 03:42:14,1,2,1,其实老师讲得还好啊 大家不听怪谁
65941,291,浦永春,2018-01-10 11:39:52,24,30,6,在浙大上了这么多课，说真的，这是第一个让我反胃的老师。\n\n真的没见过自我感觉这么好的人，对于一些最普通的科学常识都没有了解，就感觉自己是个科学小天才。估计是看了几集科教片就能和你大谈量子力学，其实都是扯淡。感觉自己好像很厉害一样，很喜欢站在一种全知的视角看别人。\n\n然后给分方面，虽然我很讨厌他，但是平时分给的机会还是挺多的，总有一些莫名其妙的机会给分，比如用方言朗诵一首诗....然而我还是很讨厌这种对于分数的草率的态度。我辛辛苦苦写一大堆形式逻辑作业才得六分，你一次方言朗诵就三点是不是太随意了点？还搞得你好像很开明，课堂很生动一样。
66028,291,浦永春,2018-01-11 04:15:37,1,1,0,呵呵呵
66034,291,浦永春,2018-01-11 05:43:48,2,3,1,有脾气  有意思  酷啊
66102,291,浦永春,2018-01-11 16:39:41,2,3,1,老师人还是不错的，课么……我好几本书都是马原课上看完的。
66935,291,浦永春,2018-01-19 10:37:15,1,2,1,没上过，但从同学那扒来了老师整理的复习资料，比打印店的资料好很多
68351,291,浦永春,2018-01-23 04:42:27,3,3,0,浦永春的秀
68513,291,浦永春,2018-01-23 09:44:58,2,2,0,话贼多
69066,291,浦永春,2018-01-24 07:57:50,3,3,0,助教超级好，老师没啥作用
69359,291,浦永春,2018-01-24 14:14:18,0,2,2,不错，老师很可爱
69360,291,浦永春,2018-01-24 14:14:49,1,2,1,老师人还蛮好的说真的
69382,291,浦永春,2018-01-24 14:48:42,2,5,3,讲真我觉得评论戾气好重啊……\n\n我觉得老师上课的时候一些地方确实不太合理，比如做了很久的形式逻辑作业只加6分，课上有的时候站起来读首诗就能加3分(虽然是为了鼓励听课，但是对于不太喜欢当众发言的人来说确实蛮糟心的……心理极度不平衡)。讲课的时候会经常发散出去，听起来就会显得有点乱，但是也算不上逻辑混乱。emmmm老师有的时候确实会让人感觉有点过于主观，但是也没有像有些评论说的那样不允许学生有自己的观点吧。\n\n个人感觉老师人还是蛮好的，助教也棒棒哒，虽说提问不知道问题会扣分，但是其实分数很容易补回来，不想发言也可以做书面作业，班里的人平时分基本都蛮高的，说给分差的真的不是自己没下功夫么=_=
69390,291,浦永春,2018-01-24 14:58:01,2,2,0,给分超级好，这老师说到做到，不看脸给分坑人，我喜欢！
69415,291,浦永春,2018-01-24 15:31:15,2,2,0,给分吼啊，考试不会，平时分来凑啊。举个手随便多扯几句就有三分呀！
69438,291,浦永春,2018-01-24 16:05:13,3,3,0,觉得老师挺好的，当然助教更加棒棒的。\n\n平时加分机会挺多的。课堂上扣分不是因为回答错，而是因为不知道老师的问题；只要回答了就加一分，回答的好就加三分。平时事也不多，一个学期一个组两次展示，个人自愿完成形式逻辑作业。另外觉得马原这种东西，老师再好，要想高分，还是要靠自己去背书。
70453,291,浦永春,2018-01-26 15:51:20,1,2,1,上课不来0分，来了1回答不出问题扣1分……用方言读首诗加三分……把平时分当儿戏。
70614,291,浦永春,2018-01-27 09:49:20,1,1,0,我因为是后来补选所以没分到组，小组展示就没做，我写了两份读书报告再加上形式逻辑作业最后3.9，还可以
70661,291,浦永春,2018-01-27 10:41:05,2,2,0,上课发个言，再做个形式逻辑作业，再有个好组长，你的平时分就满了
70685,291,浦永春,2018-01-27 11:33:29,4,8,4,人生第一次满绩，马原这种课，如果想学哲学，出门左拐，基本上没有马原老师能满足你。如果想刷分，并且想事少的，浦老师是个不错的选择。\n\n当课代表，形式逻辑作业做了，每节课争取发言，期末提前一个月左右刷选择题，最后一周背一背论述题。\n\n然后，满绩get
70691,291,浦永春,2018-01-27 11:45:21,3,4,1,浦老师其实是想教我们哲学的，最起码他不想照本宣科单把马克思一家的观点讲给我们听。上课是通关吗？满绩攻略？受教。
70712,291,浦永春,2018-01-27 12:22:14,1,1,0,助教人很不错！老师讲课就emmmmmm
70773,291,浦永春,2018-01-27 13:41:19,-2,4,6,坦白的说 刚开始上课的时候很讨厌他 后来感觉还好 水几个问题拿拿平时分然后不听就万事大吉了 最后出分5.0还是很感动的 话说主要也是期末考准备的早多背了几天 助教给分很高 平时分一大片的满 后来发现其实我可以不用做形式逻辑的...平时分早就溢出了 至于对老师个人的评价嘛 就是个啥都略懂些皮毛的逼逼了 话说只有我一个人觉得老师声音很好听吗emmm
71544,291,浦永春,2018-01-28 15:09:19,5,5,0,虽然老师讲得比较玄妙，但是助教哥哥特别棒！还会帮我们整理复习资料！全靠助教哥哥的逻辑框架，给助教打call！
71597,291,浦永春,2018-01-28 16:23:20,5,5,0,仔细想了想，觉得老师可以说是事少分好了，还会给很多回答（口头和书面都有）加分的机会。上课经常无奈地说让我们听他讲，发出一些奇怪的象声词？？real心疼又觉得搞笑，其实老师讲的有些东西还是挺受用的啦！最后，表白葛助教！读书报告给分好！
72000,291,浦永春,2018-01-29 07:45:48,2,2,0,形式逻辑认真做，考前认真看助教发的提纲，再刷些书店卖的习题，保准分数很高
72129,291,浦永春,2018-01-29 12:00:27,2,4,2,在理科老师的留言下面，总有“老师水平确实很高，但是我不懂”，文科老师的留言下面却从来没有。
72502,291,浦永春,2018-01-30 08:51:19,4,6,2,满绩 表白负责任的助教小哥哥
73033,291,浦永春,2018-01-31 16:48:24,3,4,1,这个小老头脾气有点差哈哈哈\n\n最后马原绩点4.5\n\n当个课代表，考试前刷刷题库，就差不多了~\n\n上课多发言，和助教搞好关系，分数不会差，不用太听课
73489,291,浦永春,2018-02-01 16:19:27,16,16,0,上课用话筒，音量开得大，说话一惊一乍，震耳欲聋。表达不连贯，毫无逻辑，不知所云。与课程相关的内容讲得很少，不讲与考试有关的内容，期末全靠自己预习。上课抽一组学生按序号点名回答问题，没来的、不知道问题的、回答得不好的统统扣平时分。\n\n最后，给这学期的助教一个大大的好评，非常负责！
73553,291,浦永春,2018-02-02 03:09:47,8,10,2,讲课极水，任务极少，给分极高
73869,291,浦永春,2018-02-03 09:31:13,6,6,0,给分挺高 要是你们认真听课并常常交作业
73878,291,浦永春,2018-02-03 09:46:20,10,16,6,浦老师语录（炒鸡可爱≧∇≦）：\n\n1.你们不要盲目地相信外界的评价，应该多听一听那些有学识，有真知灼见的老师的课，比如浦永春老师。他们不汲汲追求各种头衔和职称，低调沉潜，不慕荣华，这一点和浙大很像。（类似这个意思）\n\n2.我在今天上午的那个班把上星期已经上过的内容又上了一遍，而且竟然没有一个人提醒我！！。。。。我先原谅我自己吧。\n\n
74981,291,浦永春,2018-03-07 02:06:05,1,2,1,一节可以水的课
76039,291,浦永春,2018-09-18 06:32:55,-5,9,14,科学开始的问题便是哲学。\n\n超有文化的老师！\n\n一个新的世界会被开启
76151,291,浦永春,2018-03-28 03:45:16,10,11,1,要点名抽问都没问题，要讲思辨扩展学生视野也可以，但是求对这门课负责吧！既然是马原课就多讲马原啊，不要说马原就是靠自学什么的，如果这样何必开课直接考试行吗？讲课是真没有逻辑，也许强行解释可以找到一点。但是既然可以简单明了就不要弄的生涩复杂好嘛？我是学生负责全勤答题写作业考试，老师你负责把课讲好行不行(▼皿▼#)？
76201,291,浦永春,2018-03-29 02:22:48,1,1,0,有点不好
79971,291,浦永春,2018-06-17 15:02:22,6,6,0,开篇千言，离题万里
79986,291,浦永春,2018-06-18 10:18:47,7,7,0,给老师打五分，给助教打十分！
80168,291,浦永春,2018-06-21 02:24:56,1,3,2,体验极差
80567,291,浦永春,2018-06-28 03:08:41,1,2,1,很垃圾
81089,291,浦永春,2018-07-04 00:40:38,-1,1,2,这个老师有点烦，或许知识有，但教学水平真的高不到哪里去。。
81136,291,浦永春,2018-07-04 06:18:28,3,3,0,有些人鹅颈真无话可说
81256,291,浦永春,2018-07-04 12:49:25,11,12,1,助教小哥哥超可爱！
81920,291,浦永春,2018-09-10 05:12:20,6,8,2,老师不评价了，反正我给1分。助教是我见过最良心的
85078,291,浦永春,2018-07-15 08:56:45,5,5,0,其实也挺好的
86360,291,浦永春,2018-09-14 03:11:28,3,3,0,给分超好
86999,291,浦永春,2018-09-20 02:09:26,4,5,1,梨吼辣么大声干什么嘛，辣你去找物管啊，随便你
87855,291,浦永春,2018-10-16 02:41:49,-1,2,3,别选他
87900,291,浦永春,2018-10-17 07:10:32,-6,4,10,不是举报过了吗？？？怎么还在这里教书？？？这种人怎么可以当老师？？？
91438,291,浦永春,2018-12-10 08:02:57,4,4,0,好好好
92609,291,浦永春,2019-01-03 06:07:28,-3,1,4,烦死我了我就不该选他的课
93059,291,浦永春,2019-01-21 12:14:50,-1,3,4,上课不知道在讲什么
93289,291,浦永春,2019-01-09 00:44:16,8,8,0,想给助教小哥打一百分！！！！！均分85的马原课！！！老师其实也挺有趣的嘿嘿
96675,291,浦永春,2019-01-21 08:57:16,8,8,0,10分给助教\n\n助教人超好\n\n
96909,291,浦永春,2019-01-21 12:15:46,10,10,0,怎么会有这么好的助教?
96921,291,浦永春,2019-01-21 12:30:52,7,12,5,老师和其他人说的一样，讲课确实不讲课本，但是呢，我觉得匿名系统那些骂老师的，你自己掂量一下自己，没用心去复习没用心去听课，那你还能怪老师吗?虽然老师讲课很少讲书本的东西，但是老师讲课的时候把书本的原理和很多有用的知识都讲了，还怪老师嘛?\n\n老师说他明年就退休了，可能大家已经上不了老师的课了。不要说老师水平不行，那也只能怪你自己水平不行。\n\n学马原，一是背题库，二是把书上的知识点去背一遍!助教给了53页的知识点，你自己不去背，怎么可能考得好?好分数是自己凿出来，不是靠老师给出来的。\n\n十分感谢助教，助教是我上过课的最好的助教了!
96934,291,浦永春,2019-01-21 12:50:23,6,6,0,助教人很好，努力给大家提分，不卡绩
96938,291,浦永春,2019-01-21 12:57:04,15,15,0,助教哥哥，他会魔法！把一张不及格的卷子，化成超好的成绩！（不过不知道他还当不当助教了）
96941,291,浦永春,2019-01-21 12:59:46,7,8,1,助教真的很负责 很努力 很用心了\n\n成绩不高只能怪自己了
96945,291,浦永春,2019-01-21 13:05:22,2,2,0,还好啦，平时不怎么听课
97186,291,浦永春,2019-01-21 23:58:53,3,5,2,骂老师的简直搞笑，平时分就算你不回答问题自己去看看助教给的分数明细表绝大部分的人平时分百分制下都有90+。期末考就是背背书的事情，当然对文科生来说以前学过相比理科生压力没那么大，但不背你想期末考的好吗？60分简答题呢。
97687,291,浦永春,2019-01-22 13:35:14,3,3,0,几乎完全没听过课，对授课内容就不评价了。给分超好，平时确实有提问但都是按名单提问的，不容易答不上来而扣分，平时分班级评均97多，自己平时就主动发言了两次，论文正常写，最后平时成绩也给满了。老师确实不怎么讲课本也不教做题，不过考前自己看看也够了，不关心是否学到马原知识的不用因为老师评分低而担心…
97721,291,浦永春,2019-01-22 14:12:03,2,4,2,助教真的很认真很负责 老师上课也很好啊  虽然讲的不是课本的内容 但是有自己的授课体系
97770,291,浦永春,2019-01-22 15:41:05,-1,2,3,老师超可爱的。给分也很好！
98316,291,浦永春,2019-01-23 10:08:55,2,5,3,一开始看评论以为很恐怖……但是其实上了一个学期感觉还不错？老师讲课方式比较跳脱，乍一听没按照书来讲，但是其实相关度还挺高的，也挺有深度。平时上课事情少，有时候提问会点名但是问题并不难，按自己理解回答就行了。助教非常负责，超级好。说实话不太懂打低分的人什么心态。
118653,291,浦永春,2019-10-30 05:23:38,4,4,0,让人想怼他\n\n个人成就你还想评价个高低贵贱？？？？\n\n搞咩呀
118661,291,浦永春,2019-10-30 06:26:51,4,4,0,嗓门大，哈哈哈，煎熬
119454,291,浦永春,2019-11-13 02:28:17,3,3,0,垃圾
119511,291,浦永春,2019-11-13 07:11:33,2,2,0,讲课天马行空的同时还要求同学时刻跟上他的思路，我太难了(T ^ T)
120852,291,浦永春,2020-01-17 21:58:37,3,3,0,4.8
3536,307,廖亦宏,2015-06-17 01:29:41,16,26,10,烂的不行。。每节课一直让学生pre。。根本不讲课。。。没有提过一个字的书
3667,307,廖亦宏,2015-06-26 02:21:00,9,17,8,你还能在坑点吗，考前还得弄你的大作业，麻吉
4322,307,廖亦宏,2015-06-19 03:43:22,5,10,5,呵呵
4930,307,廖亦宏,2015-07-01 07:04:15,1,28,27,请大家能对老师有最起码的尊重。客观来讲，廖老师很负责，会带动大家的积极性，记录有价值的发言。如果今后能把展示向上半学期集中就更好了~ps:点不点名是看班长的。
4937,307,廖亦宏,2015-07-01 07:30:13,-1,21,22,感觉老师超级认真啊，每次学生发言都会做笔记，适当的时候还会总结升华一下（毛概课你懂得）。展示案例好像和别的班要求差不多。
6017,307,廖亦宏,2015-07-10 08:30:11,-5,1,6,这不好说
9350,307,廖亦宏,2015-12-03 01:07:07,37,55,18,迂腐，小组presentation只能说好的，积极的，不能说坏的，连提建议式的展示都不那么支持，脑子还在上个时代的模式。
14980,307,廖亦宏,2016-01-11 11:38:22,-2,3,5,一般般
18563,307,廖亦宏,2018-09-20 08:11:48,-58,6,64,唯一一次点名没到，扣了5分，最后绩点4\n\n党性高，与老师无关\n\n
19880,307,廖亦宏,2016-01-25 13:14:05,2,6,4,两次点名没到…
31595,307,廖亦宏,2016-07-04 08:54:03,13,15,2,只能说不要选
34718,307,廖亦宏,2016-10-19 05:55:26,10,16,6,想骂人了，提问就提问吧我忍了，你问朝鲜六大哪一年开是几个意思？？？猜五年前十年前二十年前都不对！36年前鬼知道啊！
48414,307,廖亦宏,2017-03-03 03:17:11,26,29,3,老师上课一直抽学生起来回答问题啊，提心吊胆的整堂课，手机时刻开着浏览器?
49570,307,廖亦宏,2017-04-19 03:09:38,17,18,1,非常红专
49572,307,廖亦宏,2017-04-19 03:22:56,-6,3,9,有些红专，不过总的还不错啊
50223,307,廖亦宏,2017-05-01 13:16:21,0,3,3,请问平时分大家相差大吗？比如组与组之间。期末考怎么复习呀
50772,307,廖亦宏,2017-05-05 06:18:10,3,3,0,老古董
52211,307,廖亦宏,2017-06-16 03:04:28,-6,3,9,总有一些课需要人讲的，老师很为同学考虑，脾气也是磨练过的，很耐心。课前先布置好问题是为了给每个组展示的机会。
52800,307,廖亦宏,2017-06-23 03:15:39,4,6,2,非常坑的一个老师，最后一节课了，点了一节课的名。又不是只有你一门课考试
53476,307,廖亦宏,2017-06-26 16:57:35,2,5,3,老师以前大概是毛泽东语录读多了，洗脑超严重。上课提问也真是无语，一直问xxx事件/会议/讲话是在几几年，记年份是想说你比我们活得多吗。。无语
56556,307,廖亦宏,2017-07-04 03:30:44,3,4,1,被正态 呵呵超级气
56597,307,廖亦宏,2017-07-04 05:21:40,13,15,2,垃圾老师居然还往下调绩点的，这么多年我算是头一次见
56610,307,廖亦宏,2017-07-04 05:39:23,9,11,2,考完了，感觉小组内分数有一定份量，但是对正态影响最多的还是期末考。期末考选择题过得快一点，反正不会的还是不会，后面的论述辨析还有大题什么的多写一点，尽量写满，不用多学术，写作文一样就好。选择大部分是时事，刷题用处不大，但是可以刷刷感觉，书上的内容选择题也不多，但是也可以坚持看看熏陶党性。多选实在确定不了就全选吧。辨析看书还是比较有用的。
56664,307,廖亦宏,2017-07-04 08:00:02,3,4,1,好好听课 好好考试 好好准备 分数低的要死 气死我了
56703,307,廖亦宏,2017-07-04 10:21:15,9,10,1,给分差差差
57057,307,廖亦宏,2017-07-05 10:02:23,3,5,2,迀腐 陈旧 极左 神坑！
57389,307,廖亦宏,2017-07-07 07:15:55,-7,1,8,没想到给分不错的 我最后考试真的啥都不知道全是十六大什么的
57939,307,廖亦宏,2017-07-18 01:36:07,5,5,0,好紧张，政治专业性很强，不看新闻不关注时事的学生上课很痛苦，提心吊胆，心情差到极点。
57940,307,廖亦宏,2017-07-18 01:36:30,4,4,0,点名提问然后不然你回答就管自己讲啊讲 站得尴尬症都犯了
60719,307,廖亦宏,2018-04-17 08:31:09,12,15,3,本来不是他的课，现在毛概合班上课轮到他的课跟吃屎一样难受。本来要讲课根本不讲，三节课全都是小组展示，该他讲课他不讲，然后别人替他讲就在下面不停插嘴，自己说着说着还激动了，兴奋了，点名回答一波问题。自己又不讲，别人讲还指指点点，要是讨论课只要上也就算了，大班上课还这样搞，那你教学的意义又是什么呢？
60828,307,廖亦宏,2017-10-31 02:20:39,3,3,0,廖子承上的太烂了
64937,307,廖亦宏,2018-09-20 08:12:10,0,5,5,垃圾建议分类回收，像这类的不用回收直接焚化
65391,307,廖亦宏,2018-01-03 14:32:49,3,3,0,烂到爆！
70645,307,廖亦宏,2018-01-27 10:27:08,2,3,1,天天让展示，抽人回答问题，屁事多给分还差，辣鸡
70682,307,廖亦宏,2018-01-27 11:23:36,-5,2,7,老师人很好，给分也好
74920,307,廖亦宏,2018-03-06 11:56:19,5,6,1,比较会调动气氛，不断提问的。上课讲课内容较少，给了一串的任务分配给各个小组，后面上课基本都是同学轮流上台讲。感觉给分很随意的，我上他的课从无缺席，积极回答提问，小组作业中贡献也很高，期末答题都很完整，论文都是自己的论点，无任何抄袭，结果他给了我一个垫底的分，好气奥，同小组里的做小组作业时没出力的同学分比我高十几分，他们的论文我也看了措辞和论点上无明显优势。但是分高的同学偏向积极的赞美领导人，我的论文是分析当前利弊，优劣都写了，结果我就拿了低分，让我说什么好呢，遇上这么不开化的老师。
76481,307,廖亦宏,2018-04-11 00:58:59,2,2,0,真没讲多少课。课堂展示的时候一直不停打断别人的展示和问答，感觉很不尊重学生的劳动成果……只能说，体验真的不好
80224,307,廖亦宏,2018-06-22 03:53:12,1,1,0,点名是必须的 手机浏览器开着也是必须的 哦对 视频也是必须的 爱看视频不爱听bb?
80455,307,廖亦宏,2018-06-26 16:40:03,0,2,2,怎么能把这个老师搞下台？\n\n
83623,307,廖亦宏,2018-07-11 00:19:00,-2,1,3,老师其实还好，个人觉得大课选主题让分组准备相应的块上去以视频、PPT等方式展示，自己再串联，其实还不错，反正比其他大课内容又枯燥啥的来的好
83625,307,廖亦宏,2018-07-11 00:24:30,0,1,1,节节课抽点，不过最后上4了还好
83690,307,廖亦宏,2018-07-11 04:05:56,0,2,2,真的差评  完全看期末考当不当组长完全不加分
83805,307,廖亦宏,2018-07-11 08:48:35,-1,0,1,为什么讨论课只算他自己的那几次的展示的分数
83999,307,廖亦宏,2018-07-11 16:32:08,0,1,1,垃圾老师
87730,307,廖亦宏,2018-10-11 02:41:35,0,1,1,抽学生回答问题，给分不咋滴，大嗓门想摸鱼都不行，x性很强。
100639,307,廖亦宏,2019-01-26 13:03:38,-1,0,1,。。。
104759,307,廖亦宏,2019-03-27 06:53:10,3,4,1,：中央已经决定了，就由你来背书。\n\n廖老师当时就念了两句诗：苟利国家生死以，岂因祸福避趋之。\n\n后来背书吧，背了三件事，一件事就是全面建成小康社会，一件事就是北京要开冬运会了，还有一个就是党代会一律不准迟开，这和党的命运是有很大关系的。主要就是这三件事，一点微小的贡献，谢谢大家！
105145,307,廖亦宏,2019-04-04 11:19:33,1,2,1,可以驱逐这位老师吗，很渣很功利的人根本不配做老师
108985,307,廖亦宏,2019-06-05 05:35:22,0,0,0,辣鸡就完事儿了
108988,307,廖亦宏,2019-06-05 05:57:20,0,0,0,为啥没有0分....上了一节课我就受不了了..._(´ཀ`」 ∠)__
108989,307,廖亦宏,2019-06-05 05:57:37,1,1,0,全靠同学展示撑起三节大课的内容，靠展示吸引注意力，提一些奇奇怪怪的问题，本身上课没什么意思
115479,307,廖亦宏,2019-07-27 16:54:39,1,1,0,唯有呵呵二字
218825,307,廖亦宏,2025-05-07 05:46:03,0,0,0,讲的很差，想睡觉
639,352,马建青,2015-03-15 09:30:11,115,148,33,老师的这门课好像有个国家奖，我觉得有点过誉了
1352,352,马建青,2015-03-22 00:42:12,29,32,3,个人觉得讲课不够有深度
3104,352,马建青,2015-05-14 07:41:27,69,87,18,讲课很无聊 全是小学生知道的知识。课程作业坑死组长 给分自己看吧
5049,352,马建青,2018-02-01 08:24:44,58,69,11,既然说回答问题加分和期末考试，那么每个人分数应该有差别，那么为什么一个组分一样就不得而知了，每组之间差异怎么评定也不得而知了。这分数给的让人难以忍受。
6107,352,马建青,2015-07-11 02:07:52,-26,8,34,老师人好
6731,352,马建青,2015-07-20 05:40:30,42,48,6,作业繁杂且无意义，上课无聊还盯着你认真听，给分毫无道理
6877,352,马建青,2015-07-28 09:02:31,-30,11,41,老师人很和蔼很牛，给分也不错，就是作业有点多
8173,352,马建青,2015-09-17 08:43:54,-9,3,12,挺搞笑的\n\n
9586,352,马建青,2015-11-02 09:02:32,49,55,6,作业烦死人，期中作业是拍微电影，浪费几十小时时间
10255,352,马建青,2015-11-17 23:54:38,5,8,3,呵呵呵呵呵呵
10265,352,马建青,2015-11-18 00:45:47,14,17,3,上课很无聊 给分没道理
10877,352,马建青,2015-11-23 08:03:38,27,29,2,第一节课就吹了一大堆自己这课的牛，上完就知道没什么深度，作业多，给分基本全班集中在83，84
10986,352,马建青,2015-11-23 15:13:21,16,18,2,呵呵呵（不要问我为什么多打一个呵因为至少要三个字）
11465,352,马建青,2015-12-02 08:50:35,32,38,6,老师用行动诠释了这门课\n\n没 有 意 义
12138,352,马建青,2015-12-22 03:39:28,30,32,2,临近期末还要腾出空来写他的教学案例和四千字的什么研究报告，组长表示呵呵。。
13549,352,马建青,2015-12-29 07:10:33,25,36,11,我们的思修课是这样的：每节课会指定部分同学演讲，然后演讲一节课以上，他再总结两句然后就下课了，所有同学都演讲过后就是研究性作业展示，直到学期结束。
14475,352,马建青,2016-01-07 08:20:23,9,17,8,给3分，不能再多了。事真的超多，也没什么意义…上课也挺无聊，不停向学生甩锅orz…
14574,352,马建青,2016-01-07 16:54:15,5,7,2,差评，无聊
15755,352,马建青,2016-01-16 08:30:43,5,6,1,比较无聊
16029,352,马建青,2016-01-17 04:51:52,12,13,1,差评!
16074,352,马建青,2016-01-23 03:30:09,7,8,1,完全无语了
16438,352,马建青,2016-01-18 05:46:38,12,13,1,极差极差\n\n
17900,352,马建青,2016-01-21 03:34:07,11,12,1,事情很多，组长很惨。
17929,352,马建青,2016-01-21 04:12:03,2,3,1,我就没听过
18571,352,马建青,2016-01-22 04:43:24,7,9,2,课业繁重。。。
18947,352,马建青,2017-09-28 10:18:13,4,10,6,这老师讲课是无聊，可是给分比我想象的好很多，成绩出来的时候还是很开心的
18949,352,马建青,2016-01-24 04:51:48,9,12,3,课程作业 期中微电影 期末案例分析和研究报告各四千吧 算挺多的作业吧 给分比想象中好 感觉期末考只占百分之三十但是也很重要吧 因为平时分大家不会差很多
18952,352,马建青,2016-01-23 00:27:13,7,8,1,给分低，没干货
18997,352,马建青,2016-01-23 02:33:08,7,9,2,给分超低
19179,352,马建青,2016-01-23 11:46:54,7,9,2,思修这课吧，确实没意思。但比起卢军霞来上的有的意思。有人上去演讲还可以翻翻杂志看看剧，考试占30%，可靠瞎哔哔，反正看了也没用。不过助教不错。
19304,352,马建青,2016-01-24 00:33:15,-18,2,20,上课真心无干货，作业和其他思修老师大多相似，绝对没有梁清华多。给分一堆3.9。
20898,352,马建青,2016-02-03 08:34:18,13,15,2,为什么没有零分
22026,352,马建青,2016-03-02 06:07:25,7,8,1,呵呵呵
23886,352,马建青,2016-04-20 06:06:46,-10,1,11,思修上的也不是很无聊，大学生心理健康的课让我觉得很受益。
25051,352,马建青,2016-05-05 04:10:22,2,3,1,听课没什么收获 浪费时间 作业倒是不多 绩点我反正很差
25084,352,马建青,2016-05-05 08:07:42,-24,2,26,绩点不错，作业也挺少的啊，可能这学期变了，没有前面评论里的微电影啥的，都是打打字发过去就行了，挺好的一门课
25100,352,马建青,2016-05-05 09:03:40,25,27,2,学弟学妹们，这课能换的话换老师
28635,352,马建青,2016-06-28 11:21:16,6,7,1,不好，恶心
34198,352,马建青,2016-09-28 08:18:24,6,7,1,自己就这么点水平，从头到尾提问提问。也没有什么实质性的东西。
34506,352,马建青,2016-12-07 06:05:46,16,18,2,贼tm事多
34632,352,马建青,2017-01-24 08:21:26,13,14,1,差评差评，事那么多给分那么差
36245,352,马建青,2017-01-24 10:39:12,-10,4,14,给分慢是老师的认真负责，想想看，四个班有这么多学生，打个分很复杂的，应该体谅
38510,352,马建青,2016-12-29 10:52:46,7,10,3,期中期末一堆作业，还不讲清楚，群里问从来不回答
38990,352,马建青,2016-12-20 09:47:05,51,60,9,超级垃圾，上课叫人轮流演讲，一讲一节课，上课内容智障。作业超级多！微电影要搞超久，还有1500字网课观后感，个人报告，4000字小组报告，全部是毫无意义的作业，浪费时间，能换老师的赶紧换吧，非常拖期末后腿！这种老师根本不体谅学生，觉得天底下就只有他这门课牛，不知道是不是能通过布置那么多作业获得掌控感？我只能说智障。不能给0分，给了1分。
39101,352,马建青,2016-12-21 07:19:54,7,9,2,乱给分，作业神烦，上课读word，放十年前的视频，还逼着你认真听，活见鬼。
39465,352,马建青,2016-12-23 02:47:53,4,6,2,作业多 好恶心
40088,352,马建青,2016-12-29 06:28:25,17,19,2,吹的自己很牛，辣鸡作业一大堆，从没想过思修会这么坑，这么麻烦，微电影，1500观后感，4000研究型论文，还有期末考试，能换的赶紧换吧，我只想说呵呵
41357,352,马建青,2017-01-11 04:25:55,3,5,2,烦 后悔
45135,352,马建青,2017-01-19 04:34:52,5,6,1,讲的没有吸引力，给分超级慢
47151,352,马建青,2017-01-24 05:24:03,14,15,1,倒数第二科出成绩还能拉低0.04均绩 我还能说什么
47159,352,马建青,2017-01-24 06:47:31,3,4,1,事多，无聊，出分慢，垃圾。
47172,352,马建青,2017-01-24 08:57:21,3,6,3,为什么没有0分
47424,352,马建青,2017-01-26 08:00:16,9,10,1,屁事特别多，微电影观后感研究性报告，一个都不少，思修真的是醉了，最后给了3.9，感觉不值，上课就去签到，完全不听
48401,352,马建青,2017-09-19 06:45:37,3,5,2,……事情多，认真做也给分低而且没高分（原话是:要低一起低，否则对绩点低的不公平）
49720,352,马建青,2017-04-24 18:37:11,-9,1,10,心理健康课上得还不错呀
52316,352,马建青,2017-06-18 08:39:04,5,7,2,给分可以说是非常垃圾了，每节课都到，莫名其妙被正态，事情还死多，出成绩最慢，看到分数的时候简直了。
53314,352,马建青,2017-06-26 10:36:20,6,6,0,我该怎么讲……复习了两遍，结果绩点还没我微积分高?
59163,352,马建青,2017-09-20 04:23:03,7,7,0,建议不选
60193,352,马建青,2017-10-18 08:04:00,11,12,1,无语了
60194,352,马建青,2017-11-04 14:06:57,10,12,2,不解释，坑
60196,352,马建青,2017-10-12 15:01:22,16,17,1,无语凝噎
60556,352,马建青,2017-10-24 04:44:10,5,5,0,太坑了 人那么少还要拍微电影 太坑了 千万别选
60707,352,马建青,2017-10-27 09:29:34,1,5,4,一起的费老师很好，我的女神(๑ºั╰╯ºั๑)
60841,352,马建青,2017-10-31 05:41:45,6,6,0,用血的教训告诉你不要选
60885,352,马建青,2017-11-01 11:18:19,14,15,1,骄傲自大，一点都不体谅学生，自己怎么方便怎么来，还是教心理的，一点情商都没有
60890,352,马建青,2017-11-01 12:05:18,20,22,2,上课让同学放思修微电影，自己看着看着睡着了也是无敌了
63031,352,马建青,2017-11-28 03:14:25,44,47,3,不说马建青老师了，费兰兰老师就是我的奶奶，给我最最慈爱的关怀，我就是费兰兰奶奶最最听话的乖孙子\n\n
64679,352,马建青,2017-12-26 08:03:20,8,8,0,留很多华而不实的作业，拍微电影，考试周前几天还留任务，无话可说，必须一分，给两分都是假的。
65209,352,马建青,2017-12-31 10:17:12,6,7,1,讲的也还像个样子，可是事太多了。微电影，演讲，论文，还有期末考试，而且还专挑临近考试的时候，真的累人啊！
65543,352,马建青,2018-01-05 16:24:42,4,4,0,这个老师事情好多
65545,352,马建青,2018-01-05 16:28:11,8,9,1,按小组坐，变相点名。不允许开小差。作业超多。但就算评一分思修还是思修，精品课还是精品课。如非心理咨询必要慎选。
65546,352,马建青,2018-01-05 16:47:20,2,3,1,讲课无聊   非常想睡觉   作业多到炸还布置的很晚   能不上他的课就别上了
65551,352,马建青,2018-01-06 00:44:04,10,12,2,一点一点地放出任务，我不知道这是不是套路。
65564,352,马建青,2018-01-06 05:29:01,7,9,2,没有0分的吗？
65565,352,马建青,2018-01-06 05:29:57,2,3,1,真的事多，作业不停还一个比一个麻烦，占太多时间了，比专业课作业多得多，专业都要没时间学了
65567,352,马建青,2018-01-06 06:57:03,9,11,2,当初看评论，想不至于到一定要退课吧？所以没退。现在真是悔不当初，特别是还作为组长真的要累死了。以后被预置了这节课的同学们还是退了吧。忠告。
65735,352,马建青,2018-01-08 15:18:45,6,7,1,这个查老师怎么没有零分我就想问，无奈只能给一分，感觉都给高了。什么国奖，都是过奖。上课无聊不说，自以为是，作业巨多，如果能重来我一定选梁清华老师的。
65919,352,马建青,2018-01-10 08:07:26,-18,2,20,其实任务也不是很重了，我室友是梁清华老师班的，感觉事比我们多很多，拍微电影比较容易的，不到2天就能轻松搞定，其他的东西，就是随便搞搞就好了，其实如果你真的是有想法，马老师的这点作业不算什么的，思修课就是这样的吧。但是讲真，一起的费老师真的好，超级喜欢她！！(ღ˘⌣˘ღ)
65936,352,马建青,2018-01-10 11:07:16,10,10,0,相信我，一定要退课！！！不然你都不知道期末其它科是怎么挂的！！！
66241,352,马建青,2018-12-14 09:25:10,13,13,0,真的恶心 事情巨多
66798,352,马建青,2018-01-19 06:01:13,2,3,1,事多的要死，尤其是期末
67510,352,马建青,2018-01-21 11:08:38,5,5,0,我上课的唯一体会就是听同学的演讲，看小组的展示……
70028,352,马建青,2018-01-26 04:12:33,2,3,1,期末才布置大作业 最后一节还要准备展示最后给分 呵呵
70033,352,马建青,2018-01-26 04:25:09,-6,1,7,不管之前，反正这个学期很不错，辩论赛收货很大\n\n\n\n
70073,352,马建青,2018-01-26 05:24:03,6,6,0,给分低，尤其是思修课和其他老师对比来看，不想多说什么，完成了这么挤时间的任务还要来接受分数的嘲讽，呵呵
70087,352,马建青,2018-01-26 05:39:06,3,3,0,垃圾 垃圾 一堆事 给分也不怎么滴
70109,352,马建青,2018-01-26 06:15:07,12,12,0,老师上课事情多无聊我也认了，平时各种作业真的有很用心做，自认为期末考也没差到那种程度。莫名其妙给我低绩点。我恨这个老师
70803,352,马建青,2018-01-27 14:13:42,2,2,0,上课无聊，给分坑
71329,352,马建青,2018-01-28 09:55:12,1,1,0,给分尚可，没有那么差吧。不过事情是真的多，微电影演讲写作文emmmm多到炸裂
72893,352,马建青,2018-01-31 09:26:31,11,12,1,上课固定座位，每节课查人，你去同时段其他班看看吧，哪个班不是自由坐。上课内容极其无聊，视频用的都是10几年前老的掉渣的全都是马赛克的视频，演讲完拍电影，拍电影完演讲，演讲完论文，论文完考试。对了，想要高绩点吗？当组长吧，我目前只想到了这个。
73130,352,马建青,2018-02-01 03:29:03,20,24,4,我是组长，绩点2.1。报告论文ppt微电影所有的作业都要亲力亲为，大大小小的任务都承担一半工作。组员都4+了我组长还玩个屁。这个马教授不知道为什么名头这么大。碰到就退吧，真的。退课保平安。
73469,352,马建青,2018-02-01 15:13:51,-12,3,15,我觉得海星
73579,352,马建青,2018-02-02 04:11:34,6,7,1,本来期中想退他的课，结果怕以后安排不好犹豫了。期末给分极不合理，奉劝各位别选，选了的也赶紧退。不然期末会很惨。
74114,352,马建青,2018-02-05 09:12:12,5,7,2,任务挺多的每个人都有至少一次课堂演讲，还有小组的微电影和研究性学习报告，给分不高，小组长的事情最多分还一般不高于平均分，不建议当组长
75228,352,马建青,2018-03-08 05:54:16,4,5,1,2333
84401,352,马建青,2018-07-12 18:42:12,-1,5,6,大学生心理健康，两个老师合上的，举手发言比较重要，事情不是很多，用认知心理学分析自己字数1000+，看电影当堂写观后感，最后开卷考六十五分的判断，其他是案例分析，还有写上课感悟什么的。上课比较积极，点名都在，作业好好写最后给分还是不错的。
87420,352,马建青,2018-09-29 00:33:38,8,8,0,差极差，就是在讲什么都不知道
88415,352,马建青,2018-10-30 11:22:28,14,15,1,上课真的也别水，自己很牛逼，但是教的一般中的一般，作业一大堆，微电影5个人十几天拍中国梦这么大的主题，简直要死
88425,352,马建青,2018-10-30 15:19:14,6,6,0,沙雕，又沙又雕，千万不要被学院老师蛊惑选这个课了，有课赶紧退
88783,352,马建青,2018-11-08 01:30:35,8,8,0,\n\nhh微电影
92583,352,马建青,2019-01-03 04:14:30,2,2,0,上课挺无聊的没什么艺术
94079,352,马建青,2019-01-15 06:31:39,7,7,0,组长无话可说，只想猝死
95397,352,马建青,2019-01-19 10:26:06,1,1,0,一般般吧
96087,352,马建青,2019-01-20 12:37:39,7,8,1,学了这门课心态炸了
97705,352,马建青,2019-01-22 13:53:37,2,2,0,呵呵呵
98670,352,马建青,2019-01-23 17:40:53,-3,2,5,深夜出分，翘了好几节课，然后我本人也没做太多事，成绩与我估计的一样，总体感觉还可以吧
98672,352,马建青,2019-01-23 17:54:24,7,7,0,给分贼慢还不好 上课还要按小组位置坐 微电影论文很费时间 能换老师就换吧 不喷了...
98677,352,马建青,2019-01-23 18:34:25,7,7,0,这个人的思修课真的没有任何意义，他的讲课也配叫讲课，讲的话全是彻底的套话，屁话，说话又慢，又词穷到一种境界，无聊透顶。如果不选择退他的思修，上课还是水手机或者做点别的什么吧，意义更大一些，不过这人上的班好像只有不到40人，要按小组做到前面，做别的事情记名很容易，唉(当然无视掉也行吧。。)。最后，感谢老师让我知道了评2分的老师是有什么样水平了?
98685,352,马建青,2019-01-23 21:48:51,-6,2,8,良心评分  我给五分\n\n我只想说   其实老师给我多少分在我预料之内  因为我预制了这个老师的课  也没换  看了查老师之后我本身做了心理准备   大家高中的老师也有好有差痘得受着不是么  我说点不太爱听的其实绩点不是瞎给的   如果你私下和老师接触的话会发现他很公道  不太亲切  但是很公道那种  我们小组的微电影  论文   我觉得我们小组全都在很努力的做   非常明确  非常认真   思修水但是很难满绩  可能很多人因此轻视它   但它是三学分的科目啊   即使不在专业课内   而且说实话后面学法律我还因此查了一些资料   真的了解法律主要还是看自己吧   所有的事情我们都是转化成热爱去做的  至少我是  我希望我的组员也是  这半年来大家相处的真的很愉快  他们非常可爱(嘻嘻)  老师讲课结合他这个人我给五分算多的  但我劝劝已经选上的学弟学妹们   如果你想满  趁早做准备
98687,352,马建青,2019-01-23 21:56:30,-2,3,5,这个老师感觉总体来说还好吧，肯定没有评分看起来那么可怕。我自认为付出了很多，但分数不是很让我满意，也许真的是能力问题吧，也不怪老师给分低。
98690,352,马建青,2019-01-23 22:51:38,-3,2,5,思修课大概都差不多吧，作业的话，期中要拍个微电影，期末有个研究报告，都是小组作业，然后上课的时候看过一个短片，写了观后感，任务量不算最大的，最后给分正常吧，应该说。
98692,352,马建青,2019-01-23 23:07:42,5,5,0,极度无聊
98696,352,马建青,2019-01-23 23:26:07,5,5,0,emmmm不按书上的讲。。但其实你听不听没啥区别的，内容水。。还不如看书。。但他分小组坐，所以你的到课与否又很直观\n\n  作业不说多，只是繁杂。两次研究性学习，一次上微电影拍摄，很费时间。一次是PPT展示加写一份研究报告。。。。\n\n  都有很用心去做，结果，呵呵，没上4，还卡我绩点。。。被预置上的同学，最好选其他老师的，衷心相劝，言尽于此
98697,352,马建青,2019-01-23 23:33:22,7,7,0,一门思修拉这么多均绩，简直绩杀
98698,352,马建青,2019-01-23 23:33:45,8,8,0,给我多少绩点我就打几分好了 3.6 所以我打3分呢 而且完美卡绩 慎选
98717,352,马建青,2019-01-24 00:18:53,16,18,2,本质上讲 老师不坏；个人感觉他布置的作业的确有一定他的道理 但从课堂教学的更新度来讲 的确欠考虑了；至于绩点 这是一门不由自己掌控的课（恶竞都不一定有用）
98720,352,马建青,2019-01-24 03:30:37,18,21,3,思想道德修养与佛系基础
98761,352,马建青,2019-01-24 01:59:41,8,8,0,之前在查老师里有看评论...所以对这老师的绩点还是有点数的....反正刚出成绩 比我想象中要稍微好点（可能我对自己的要求太低了） 但还是建议大家慎选
98798,352,马建青,2019-01-24 02:50:23,10,10,0,绩杀，付出与收获不成正比，反正我不想谢谢老师，出成绩最慢，分最低，退课保平安。一节课都没有翘，论文和微电影也很认真，不知道为什么绩点3.3，真的不值得
98810,352,马建青,2019-01-24 03:17:25,5,6,1,垃圾老师，赶紧退掉，退不掉默哀吧
98816,352,马建青,2019-01-24 03:31:01,3,3,0,打一分是因为没负分的选项? \n\n开学的时候就应该拼着大一上不上思修了也罢这位老师的课给退了
98883,352,马建青,2019-01-24 04:30:56,2,4,2,上课无聊是确实无聊，没上过其他老师的课，不知道思修会不会都这么无聊。然后有点心疼老师，其实绩点在3.3及以上，我jio得对我来说都可以接受...可能每个人追求不同？可能因为我英语绩点比较低，对低绩点承受能力变强了？hhhhh还是回归正题，马老师给我感觉还行，就是事情多，微电影、论文展示这些，这就比较看团队合作了，我们组每个小伙伴都很棒，没有划水的童鞋，可能是这个原因，最后绩点不差。还有是费兰兰老师，超棒的，讲课很有趣，鸡汤灌得一点都不生硬，竟然让我有点想继续喝。哈哈哈，可惜她只给我们上三节课。就这样吧~
98976,352,马建青,2019-01-24 06:08:49,-1,2,3,马老师上课还是认真的，只是绩杀而已啦
99251,352,马建青,2019-01-24 13:35:29,2,3,1,补充，还会发言加分，下课后微信群统计名单。于是恶竞者天天举手说些无意义又智障的话。这个老师显然十足的傻逼。
100158,352,马建青,2019-01-25 16:08:43,2,2,0,点名：按小组坐，没来看得出\n\n逼事：微电影，论文，展示，上课发言\n\n绩点：不到4\n\n感受：上课没有任何内容，所以我一个学期没听，思修课没有任何思修内容，期末考试就是考前翻了翻书，考试内容就是单选乱选，多选题全写ABCD，大题流水账，上课每天睡觉玩手机，从来没有参与过快乐答题，大部分分数来源应该是展示论文和微电影。马老湿真的很严格，如果你选上了这门课还没退一定要祈祷能分到一个好的小组（按学号的），小组的给分是一样的，不会因为你多或少的贡献给你高分。
100192,352,马建青,2019-01-25 18:03:15,0,1,1,不负责的老师，绩杀。给分很迷，努力了一学期，最后3.3，无力吐槽！！
101681,352,马建青,2019-01-29 01:01:07,1,1,0,老师真心没水平，上课也很凑合，给我一种感觉他自己也想早点下课，一打下课铃绝对马上就走，不管课完成没有，完全没有一点责任心，给分也。。。主要我个人觉得如果是个好老师，给分差点也没关系，但是这位连老师都算不上，浪费时间，上他的课简直是在浪费生命，学生不是傻子，看得到您的敷衍。最后希望老师早日停课，不要再浪费学生的时间和精力了，也不要再拉低浙大教师的平均水平了。
103341,352,马建青,2019-02-27 11:08:41,2,2,0,今天第一次上这个老师的课，果然和评论的各位说的一样?
103362,352,马建青,2019-04-10 12:37:02,-2,5,7,收回我之前的评论，就凭老师帮助别人做心理咨询挽救了很多人，我要给老师一个好评
104608,352,马建青,2019-03-25 05:11:06,0,0,0,真垃圾
108953,352,马建青,2019-06-04 15:57:39,2,2,0,上课水平不及格，p事儿多
111155,352,马建青,2019-06-30 05:55:58,2,2,0,垃圾一个
116507,352,马建青,2019-09-11 02:48:14,1,1,0,就这样
117048,352,马建青,2019-09-19 00:10:38,3,3,0,开创者我去你大爷的
117545,352,马建青,2019-09-26 00:07:28,3,3,0,分nm的组
117954,352,马建青,2019-10-17 01:04:23,2,2,0,tmsl
118248,352,马建青,2019-10-23 14:44:44,3,3,0,…………上课分组坐，微电影tmd……个人报告水掉大半堂课，在下面瞎转悠，还抓玩手机写微分的…sbsbsbsbsb
120432,352,马建青,2019-12-05 00:31:17,6,6,0,无聊至极
120433,352,马建青,2019-12-05 00:31:17,0,0,0,无聊至极
120922,352,马建青,2020-01-18 22:24:39,2,2,0,我们整个小组努力一学期给我3.3？全家暴毙
120944,352,马建青,2020-01-19 00:58:20,5,5,0,成绩出来绩点掉了1.3，至于上课...如上所述，绝无虚言!
120945,352,马建青,2020-01-19 01:12:03,3,3,0,事多 上课没水平 分低
120956,352,马建青,2020-01-19 02:58:14,3,3,0,上课很烂，胡说八道.给分很差，对不起我们对每一次作业的付出
121168,352,马建青,2020-01-20 02:04:56,3,3,0,不点名但我按小组坐呵呵\n\n绩杀  事多  坑\n\n没有费奶奶一半有意思\n\n上课就是炫耀自己干过啥得过啥奖啥时候拿了嘉奖认识了什么大佬，我会稀罕？？？？
121343,352,马建青,2019-12-19 02:24:40,0,0,0,就很惊讶居然有100多人选了他的课，为大家的勇气点赞
123543,352,马建青,2020-06-09 13:56:12,0,1,1,就这? 平时事多 上课么扯皮吹自己有多厉害拿过多少奖 去过什么重要会议？？一点内容也不会讲，整个个人汇报，微电影，出来分数就这么点？对得起这名号吗？
123886,352,马建青,2020-06-15 17:42:15,2,2,0,pre勿超时，微电影立意新一点，内容细化一点，制作精良一点
123918,352,马建青,2020-06-16 08:02:32,1,2,1,还好，我们的微电影粗制滥造，鬼畜剪辑，论文东拼西凑，够字截稿，我得了89？是因为组长加分吗？不过组长是真的累，组员爱理不理，论文全靠自己。
124053,352,马建青,2020-06-22 14:49:48,1,3,2,不想骂人 所以我无话可说
124933,352,马建青,2020-07-21 13:26:42,0,1,1,就这就这就这
127969,352,马建青,2020-12-02 00:04:58,7,8,1,别的老师开学就布置读书报告，你十二月一号才布置八号就要交？？一个礼拜让我读完书再写两千字？？我别的事情不要做了？？
127970,352,马建青,2020-12-02 00:24:48,1,3,2,垃圾老师给爷爬
128054,352,马建青,2020-12-04 12:16:12,5,6,1,呵呵子   马老师真不愧是他，太绝了。一周内交读书报告就离谱。话讲，为什么我觉得他讲话有点像马保国马老师？？2333
128763,352,马建青,2020-12-25 07:35:12,-1,5,6,很好的老师
129531,352,马建青,2021-01-07 01:19:15,1,5,4,说实话，觉得马老师谈不上多么好，但绝对比评分高。虽然布置作业比较紧急，但会听取学生意见进行调整，而且人确实很和善，平时任务也不多，会要求上课认真听，作为老师也无可厚非吧。而且马老师的确有很多心理辅导的经历，帮助了很多大学生，还算是一位好老师。
129798,352,马建青,2021-01-12 12:43:40,6,6,0,马老师，发生肾摸事了
132736,352,马建青,2021-02-03 12:04:44,4,7,3,之前看评论，感觉学长学姐眼里的马老师似乎给分不好。\n\n但是后来想想，相遇则是缘分，缘分自当珍惜。\n\n然后在课上认真听之后我才发现，其实老师更注重培养我们的综合能力和思考方式，虽然因为年纪比较大可能举的例子会有些陈旧，但是总体上来说还是比较有\n\n感触的。\n\n很多同学都把思政课当水课，从不认真听，然后期未得了个不好的绩点就开始觉得老师不好。\n\n本人亲测，理科生平时认真听课，作业好好完成，绩点也可以到4.5，所以何必为自己的不认真对待找老师给分不好的借口呢？\n\n另:组长肯定是有加分的，不过的确要以身作则带动大家，我们组长就是我们小组最高48哦(当然她也很感激有我们这几令志同道合且积极配合的组员哈哈)。
132769,352,马建青,2021-02-03 13:38:24,4,5,1,第一次看到评分我是有点惊吓的，但一个学期上完感觉没有那么不堪，感觉还可以吧
132831,352,马建青,2021-02-04 03:35:56,4,5,1,客观公正地评价一下马老师：\n\n马老师的思修课跟别的老师比起来任务应该算比较轻了，每人两次演讲（2～3分钟），一篇读书报告，一份研究报告（小组合作）。总得来说这门学分3分的课没有占用我太多的时间。如果每样任务都认真完成分数基本不会低。马老师的上课内容都是围绕书本知识的，虽然没有讲得很仔细，但案例都很有趣，比较喜欢让学生思考交流，而且会对学生的发言表示肯定。如果平时认认真真完成了，考前花点时间背一背知识点，分数就不会低。总而言之，我认为马老师不应该有这么低的分数，愿意认真学思修的同学还是可以选马老师的课的，只想水课的同学我无话可说
134930,352,马建青,2021-04-23 02:29:29,1,1,0,还行吧
142923,352,马建青,2021-11-17 11:23:20,1,1,0,感觉负面评价比较多，说说自己的看法，大家的关注点主要是给分，我觉得分数和个人表现有关，如果作业好好做，期末好好考试成绩一般不会差。给分慢也主要是在认真细致反复核实的成绩。马老师的课会更多的是启发式的，促使我们去独立思考，这点很受用。
143930,352,马建青,2021-12-13 08:26:10,2,2,0,师兄来给个中肯的建议：快逃！事多无聊分低，如果能换老师千万别嫌麻烦，要不然麻烦的就是你自己！
150833,352,马建青,2022-02-19 08:25:59,6,7,1,上的是老师的思修，感觉老师和以前一些学长学姐说的不太一样。\n\n老师的任务我对比过，是算比较少的，比较轻松的。最后我的分数还不错，不过不知道其他人如何，所以给分这块我不太好说。
167630,352,马建青,2023-01-18 02:32:31,7,11,4,周三1，2节思修，个人体验非常好。\n\n首先有幸能和奥运冠军同班，听她讲奋斗的事迹。\n\n另外大班上课有一节许亚萍老师来上，也是近距离接触。\n\n老师人很和善，事情不多，规定字数上限，不要求恶竞。当然最好写的内容充实一点，体现出一点思政修养是最好，读书报告现场教学什么我个人感觉能结合一点思政因素会比较不错。\n\n老师自己上课可能会用一些较为陈旧的事例，但老师很多话还是能给人思考，上课也很认真，也很关心学生，因为疫情，最后一节课展示非展示成员甚至可以不上线。老师也是笑眯眯的，看上去也是一个富有知识的学者。小组报告老师真的听得很认真，还会指出一些小问题，措辞也很委婉。\n\n至于给分，一开始看平时分觉得有点杀（学在浙大电脑端成绩分析））：60分以上8人，以下33人。后面加上期末，90以上3人，80以下3人，80-90分35人。\n\n但是，这个分数不知道是老师还是助教后面调过了，连我自己也多了2.5分。\n\n最后得分比例：90以上12人（正态要求的极限），80-90分28人，80以下1人，我觉得这个给分其实无可非议了，另外当组长应该是会好一点，但要带领组员一起奋斗。\n\n利益相关：组长，98/5.0\n\n当然也可能是今年线上开卷的原因，我的期末考非常高，如果以后还是闭卷最好还是浅浅背下书，尽量不要裸考。（开卷考我之前也是把书过了一遍的，打字的时候着实有点看手速）
167644,352,马建青,2023-01-18 03:27:09,2,5,3,首先，不点名，如果是大班教学课，大班的老师也不点名。\n\n其次，事多，我不知道是不是只有马老师的课需要读书笔记，志愿服务，课外学习活动报告这些都齐全，事实上这是我大一上学期事最多的一门课。\n\n最后给分，今年线上考是六道大题选四道作答的形式，应该说判的很松，期末考试给分挺高，平时分据说是很一般，不过当组长给分会高不止一个档。\n\n总之就知识而言老师讲课很不错的，不过扪心自问，这门课大家真的是奔着知识来听的吗？一般都是预置，我的评价是，如果预置了马老师的课，就既来之则安之，奔着绩点来的就积极一些，想摆......也很难摆的起来。
173809,352,马建青,2023-06-03 07:21:55,1,2,1,真的很不错，老师人很好！
174497,352,马建青,2023-06-13 07:20:43,3,4,1,多写一点多做一点，\n\n老师也愿意给高分。\n\n然后注意不要忽视期末考试就是。\n\n老师很和蔼，人很好，愿意因为疫情延后ddl，关心学生。
175069,352,马建青,2023-06-21 10:58:27,2,5,3,从最近两年看来，\n\n事不太多，给分也变好了，\n\n90+也变多了，至少可以打到正态上限。\n\n但退课的多了，可能好评刷上来也难吧！\n\n当组长，背背书，多写点字数，结合思政元素，分数不会低。\n\n评分这么低感觉不至于，中等分数应该还是有的。
179784,352,马建青,2023-09-20 00:13:39,5,5,0,第一节课就迟到 6
179786,352,马建青,2023-09-20 00:22:04,1,1,0,第一节课迟到20分钟……..
180095,352,马建青,2023-09-20 09:41:21,1,5,4,老师虽然作业多但是还是很有意思的
180825,352,马建青,2023-09-27 03:18:04,1,4,3,像是给幼儿园、小学生讲课一样……总是能从一些很小的事情中自以为是地得出一些自以为很深刻的“哲理”，还自以为是地觉得自己擅长思考。毫无深度、毫无益处。第一节课规定上课不能用手机，还说这是学校思政课的统一安排……请问你信吗？问了其他同学，根本没这傻逼规定……反正就一个无语
189356,352,马建青,2024-01-23 11:10:05,3,3,0,给分一般，随机性大，上课比较无聊
192300,352,马建青,2024-05-14 08:55:09,-10,1,11,老师人还是挺好的，认真上课能学到东西！
199215,352,马建青,2024-09-19 09:09:53,2,2,0,为什么不让用手机？上课就是读ppt
204371,352,马建青,2024-11-25 13:27:25,2,2,0,lj
210184,352,马建青,2025-01-08 10:10:55,-2,1,3,快逃！
210200,352,马建青,2025-01-08 10:51:37,0,1,1,给分好，超爱这个老壁灯😍
210202,352,马建青,2025-01-08 10:53:24,-1,0,1,给分可以
210883,352,马建青,2025-01-10 05:57:32,1,2,1,好老师，给分好（没当组长没发言，开卷考，喜提4.5）评分不应该这么低，不点名
211857,352,马建青,2025-01-12 17:39:48,0,3,3,凭心而论现在的评分有点太低了，一开始预制他的课看到评分这么低也有点害怕，偷渡未遂上了几节课之后发现也还好，老师讲的内容雀食有点old，但我们这个班很长一段时间是跟其他班拼成大班上的，马老师讲课的机会也不多，作业量中规中矩，小组展示的时候老师很和蔼，作业考试认真做给分不低的
218448,352,马建青,2025-04-23 15:13:35,0,1,1,上了心理健康，给分不错的，就是因为他新出了电子教材，作业有点多，评分这么低真不至于
218688,352,马建青,2025-04-29 03:07:42,1,1,0,上的是《大学生心理健康》，对比我上的另一门1.5学分的心理课，作业和课程参与度都要求更多，而且近期在出电子教材必须购买。不过给分好像不错，我给教材找了十几处有问题的地方，最后拿了4.8，可能是平时作业比较敷衍，都是AI简单改改就交了（据说有十几个满绩的？）
4674,356,潘于旭,2015-06-26 04:07:20,1,10,9,棒！
5135,356,潘于旭,2015-07-04 14:52:23,-6,8,14,还可以……
6046,356,潘于旭,2015-07-10 12:53:04,20,43,23,很好很负责任的老教师，大家都关心的给分问题更是好的没话说，轻轻松松4+
6242,356,潘于旭,2015-07-12 09:39:05,37,53,16,其实没听过，考前刷了一天题效果奇佳。马克思的思想还是很深刻的，挖掘出了很多本质问题，后悔没认真学。考前认真看书的时候才发现自己根本没有思想。
7909,356,潘于旭,2015-09-16 05:38:10,-11,7,18,好死板
8633,356,潘于旭,2015-09-23 11:25:30,-4,6,10,只能呵呵
9759,356,潘于旭,2015-11-08 11:10:54,0,8,8,我要学好马克思主义思想
10315,356,潘于旭,2015-11-18 05:14:52,-1,8,9,要求真多
11992,356,潘于旭,2015-12-21 12:40:54,-2,5,7,听不懂
13024,356,潘于旭,2015-12-24 14:17:22,-1,6,7,课挺无聊的
15007,356,潘于旭,2016-01-11 13:13:02,-3,4,7,一般吧\n\n
17740,356,潘于旭,2016-01-20 23:17:52,39,58,19,"人挺善良的，专业知识很强(所以我不怎么听得懂也没怎么听。。)，但思想有些传统。考前讲了几次""你们谁觉得自己考试那天起不来的，尽管告诉我，我一定打电话叫到你醒"""
17747,356,潘于旭,2016-01-20 23:42:12,14,17,3,老师给分挺良心的
17822,356,潘于旭,2016-01-21 02:16:31,4,7,3,非常，求是，的老师。至于给分嘛哈哈哈哈。。。。
18165,356,潘于旭,2016-01-21 08:28:27,1,4,3,老师挺认真的，不过上课比较无聊，给分还行~
18339,356,潘于旭,2016-01-21 12:56:22,12,16,4,给分666666
18407,356,潘于旭,2016-01-21 14:36:22,-4,4,8,讲什么都不知道
19291,356,潘于旭,2016-01-23 23:27:15,18,23,5,老师很负责 论文都是自己改还有评语 给分也很好 上课略无聊 不允许做其他事
19896,356,潘于旭,2016-01-25 14:12:20,3,6,3,给分好\n\n
23265,356,潘于旭,2017-01-15 09:04:49,-26,8,34,这个老师有点毛病的，上课各种瞎逼逼
25788,356,潘于旭,2016-07-02 00:21:58,3,5,2,给分不能再好了
26524,356,潘于旭,2017-12-23 14:28:48,37,41,4,马原这门课本身不是很能引起人的兴趣，但是这学期分小组展示加讨论还是很有意思的，大家提出的问题会得到老师非常认真的解答，论文的话每个人在正式提交之前都会得到老师的查阅和指导，这一点很不容易，上课专业性很强，认真听的话会有收获。课堂纪律应该是马原中比较好的。还没有出分就来评价了，主要我觉得评判一个老师好坏其实不能看自己得了怎样的分数，因为分数最终还是靠自己
28046,356,潘于旭,2016-06-28 08:01:57,1,2,1,人好和蔼
28694,356,潘于旭,2016-06-28 12:27:36,21,24,3,非常尊重学生，也希望学生尊重他，上课认真负责，脾气也好，温文尔雅，学识渊博。虽然这种课上我也难免会做其他事情，但我觉得不应该因为他的合理要求而评低他。
30471,356,潘于旭,2016-07-01 16:18:21,83,98,15,比起其他按人头入座的马原课，我觉得我们按小组入座还是很宽松的嘛～马原老师课上普遍也都不允许干其他事的。    虽然认真听的只有前两节课（因为我实在对这种东西毫无兴趣啊啊啊为什么世界上有思政课这种东西存在QWQ），感觉潘老师讲的蛮生动朴实的，挺容易听懂，也不是特别无聊（是的对我而言容易思政课听懂又不是超无聊是一个很高的评价），并没有特别生僻艰涩的感觉。   每个小组要做一次展示，大家好能讲，都做一节课多的时间。论文是期中交，老师会给你评价然后考前把修改好的发给他。    老师人蛮亲切的，比较平和中立吧感觉。这个学期发生了一件很感动的事，一个展示的同学群攻了穆斯林，班上一个新疆穆斯林妹子第二节课专门做了展示介绍新疆，老师也很鼓励。听完那个妹子温柔的展示我简直要哭了，觉得有这么一个地方，这样一个人，真诚地面带微笑地欢迎我们去她的家乡，让我们明了如何平等地真实地看待世界真是太好了。
30496,356,潘于旭,2016-07-01 18:17:16,46,55,9,到浙大来之后第一个手写给几百个学生改论文的老师，负责给分也良心。
30522,356,潘于旭,2016-07-01 23:59:17,2,4,2,思想行为方式可能比较conservative，但给分好到爆！
30526,356,潘于旭,2016-07-02 00:10:09,1,3,2,老师人还是很好的，比较和蔼，上课不允许做其他的事情，不过估计所有马原课都是这样吧。只是感觉老师很厉害呀，上课的时候讲的理论例子都很深奥，不太能听得懂，估计是我水平太渣的缘故。论文会有反馈，会叫你不断修改。期末其实还好啦。
30528,356,潘于旭,2016-07-02 00:29:50,7,12,5,按小组坐查的不严，一次展示即可，上课的时候其实还是可以做其他事情的。一篇论文，老师会帮你修改。给分真的良心，不能再好了。如果说有什么不足，就是上课有点乏味（毕竟马原）
30535,356,潘于旭,2016-07-02 00:46:27,3,6,3,给分超好
30537,356,潘于旭,2016-07-02 01:02:04,1,4,3,业界良心不解释。浓浓师生情
30538,356,潘于旭,2016-07-02 01:02:57,5,6,1,给分太感人了，怒赞
30539,356,潘于旭,2016-07-02 01:19:03,1,4,3,给分良心
30563,356,潘于旭,2016-07-02 03:18:41,-21,6,27,不明白楼上怎么想的。我觉得神坑，上课不允许做其他事，写个作业都让你收起来。可能和我三观不和，我觉得又红又专，没有思想和情怀，照本宣科。给分正常，给我3.4可以理解毕竟没准备
30565,356,潘于旭,2016-07-02 03:26:07,3,10,7,老师很有知识，上课很负责，有一次小组展示，每人写一篇论文，期末考也不是很难，不懂为什么评分比较低…个人很推荐他的马原～
30572,356,潘于旭,2016-07-02 03:52:58,1,3,2,给分666
30596,356,潘于旭,2016-07-02 04:34:08,5,8,3,课程本身内容就是蛮无聊的...但是小组展示这个环节还是很不错的。我们每次一个小组都能讲将近一节课，大家提问题，然后不同思想的碰撞还是蛮有趣的。虽然我上课真心不咋听（水手机党）但是期末还是要好好看看书的（毕竟闭卷），写好老师布置的论文，就足够啦～老师给分真的很好，轻轻松松就4+（?马原期末第一题是马克思出生地...一脸懵逼）
30727,356,潘于旭,2016-07-02 10:20:29,0,4,4,要求到课率，不允许做其他事，事情少，给分也不错。
30739,356,潘于旭,2016-07-02 10:50:40,2,3,1,挺不错的
31236,356,潘于旭,2016-07-03 12:28:54,1,1,0,还好吧，虽然自己并不想听
32920,356,潘于旭,2016-08-01 16:36:37,-11,5,16,给分烂到家
33026,356,潘于旭,2016-09-10 06:50:22,1,3,2,老师很和气，给分很给力
33049,356,潘于旭,2016-09-11 07:33:41,1,2,1,棒棒哒
34422,356,潘于旭,2016-10-10 06:36:26,-13,3,16,给分差，要求多。
40577,356,潘于旭,2017-01-04 06:29:39,-10,5,15,我拷贝？拷**！
40634,356,潘于旭,2017-01-04 11:49:08,34,36,2,天气预报说今天有雨，潘老师一上课，天气晴朗。
43142,356,潘于旭,2017-01-16 00:46:34,1,2,1,马原是思政课中最喜欢的一门(矮子里面拔高个，哲学毕竟使人深刻)\n\n他是大学思政课里最喜欢的一个老师
46157,356,潘于旭,2017-01-20 22:32:40,3,4,1,老师人超级好，论文他真的会一个个看过来还会给你写意见，给分也真的很不错，本来都不抱希望了，成绩出来以后真是让人很感动
46176,356,潘于旭,2017-01-21 00:54:01,1,1,0,很不错的老师啊，论文改得很认真
46216,356,潘于旭,2017-01-21 02:57:15,8,10,2,老师人特别好 很善良 给分也很好  很体贴的老师   论文改得特别认真特别好 很负责任 讲课虽然有点枯燥但也是挺好的  就记得论文期中发下来 他就说 很多同学的论文并不是自己的 都是借鉴别人的观点  然后他感到很抱歉 觉得是自己的责任 没讲好 对不起 当时就觉得老师真的太好了 希望同学们都好好学老师给分真的很好的 我和我舍友都上4了！
46656,356,潘于旭,2017-01-22 05:35:06,1,1,0,给分真的好
47344,356,潘于旭,2017-01-25 10:45:54,2,2,0,很负责，很认真，但是我听不进去他上课讲的内容，但是给分好好啊，已经做好下四的准备，结果4.5炒鸡棒啊。
48369,356,潘于旭,2017-03-02 10:59:46,0,1,1,感觉还不错e
49450,356,潘于旭,2017-06-28 12:50:00,-42,9,51,为什么不能打0啊？ 虽然讲课很卖力，但课堂真的是让人一下回到小学（不要看别的书，手机不要看，认真听讲不要睡），这是大学啊 爷爷 要不要这么多规矩，一个通识课我对你讲的内容没有兴趣，你还为什么非要压迫听你的。知道给分好，但 要求不要太多
52173,356,潘于旭,2017-06-15 10:34:56,5,8,3,真的是很好很负责很慈祥的老爷爷，上午考试起不来告诉他会叫你起床。每次展示课都在大家评完分后才会评价好和不好的地方，说不想因为自己的看法影响那个小组的分数～（每次听到都觉得潘爷爷人好好）\n\n但是作为马原真的好严，展示课一个小时不能做别的事，不适合想水过的同学………
52295,356,潘于旭,2017-07-03 04:25:27,1,2,1,超级负责的老师！给分巨好
56053,356,潘于旭,2017-07-03 03:43:07,2,2,0,老师人很好，给分也不错，马原这个东西，自己的悟性很重要，如果不够的话，千万别考试前一天才看
56061,356,潘于旭,2017-07-03 03:58:01,4,4,0,老师上课很认真，还会一篇一篇的指导你修改论文，给分也超赞，上课很有深度，绝无仅有的好老师。
56063,356,潘于旭,2017-07-03 04:15:55,1,2,1,刚出分必须来评论一波。老师给分真的超级好，人也非常好。论文发给老师，老师会认认真真看完给出意见，询问问题老师也非常耐心而中肯。感觉马原虽然会有些无聊，但想要认真学，也会获益匪浅。
56069,356,潘于旭,2017-07-03 04:22:24,2,2,0,老师特别认真负责，虽然上课比较枯燥（思政课都一样，讲不出什么花来），但是老师会认真看每个学生论文并很负责地写很多修改意见。难得的好老师
56087,356,潘于旭,2017-07-03 04:49:16,1,3,2,想水的人慎选
56089,356,潘于旭,2017-07-03 04:53:43,2,2,0,给分挺好的真的！推荐选！
56102,356,潘于旭,2017-07-03 05:17:25,1,1,0,老师好棒，今天出成绩超级感动，给分很好，也富有学识，对每个同学都挺关心。大家一定要好好上马原啊，虽然听不进去但是老师讲得很好的！
56115,356,潘于旭,2017-07-03 05:59:16,2,2,0,十分儒雅的老师 知识也很渊博 认真听会有很大的收获 问问题也会很耐心地解答并给出详细的建议
56161,356,潘于旭,2017-07-03 07:11:54,3,3,0,老师超棒的！人也很和蔼可亲 上课会把课本知识跟社会中的事例结合起来讲～（虽然我没有听过） 论文很认真地看了一些书写的 发给老师修改过再交～考前刷了题库 效果极佳！最后给分很好
56719,356,潘于旭,2017-07-04 12:24:11,1,2,1,很认真的老师，绩点稍微给的一般，但不影响人很不错。
57453,356,潘于旭,2017-07-08 05:24:29,5,5,0,老师真的很有气质，讲课很深，很有内涵，而且推荐了超棒的哲学入门书《哲学的邀请》真正的好老师，就是这种启发学生，带领学生进入新世界的！
66209,356,潘于旭,2018-01-13 08:26:45,0,1,1,很棒的
66993,356,潘于旭,2018-01-19 15:40:37,0,0,0,老师很认真很负责。
67702,356,潘于旭,2018-01-22 05:31:55,1,1,0,老师很和蔼很负责 论文会让我们交终稿之前先发给他一遍 并且给一些修改意见 平时事情也不多 就一个小组展示一篇论文 十分十分
67705,356,潘于旭,2018-01-22 05:34:40,0,0,0,给分超级好，也会很负责地给你批改论文，考前把该看的看一遍，出分的时候真的好感动。
67711,356,潘于旭,2018-01-22 05:39:16,1,1,0,开心～ 出分了很不错哦，老师会给修改论文的意见，这点炒鸡棒了！总之收获很多，谢谢老师?
67715,356,潘于旭,2018-01-22 05:46:08,1,1,0,课堂纪律比较严，给分不错
67721,356,潘于旭,2018-01-22 05:54:58,6,6,0,是那种知识渊博有些守旧的老先生的感觉~认认真真地亲自修改每位同学的论文，在邮件开头叫我小X同学，末尾还祝我新年快乐~给分也太好了！感谢老师这一学期的教导ww
67726,356,潘于旭,2018-01-22 06:03:07,0,0,0,很认真负责的老师了！
67729,356,潘于旭,2018-01-22 06:05:41,0,0,0,认真负责的好老师
67733,356,潘于旭,2018-01-22 06:11:01,1,1,0,上课一定要到 但是可以在下面做自己的事情 但是不能用电脑 感觉老师对于大家都不听课也尽力想改进吧 大家偶尔抬头看到大家都埋头做自己事情老师在上面看的也很绝望吧 不过真的是认真负责的老师 给分很感动！
67735,356,潘于旭,2018-01-22 06:12:18,1,1,0,老师超棒的哟～会认真帮你改论文，论文ddl也很宽泛～声音也蛮好听的～大家积极选哈。
67742,356,潘于旭,2018-01-22 06:22:11,0,2,2,给分超级好
67781,356,潘于旭,2018-01-22 07:09:21,0,2,2,.....
67858,356,潘于旭,2018-01-22 08:20:23,1,2,1,给分好到炸裂！
67900,356,潘于旭,2018-01-22 09:20:38,1,1,0,真的是很负责很认真的老师，很幸运在浙大碰到这样的老师，感谢！
67942,356,潘于旭,2018-06-19 06:59:40,8,9,1,老师三观很正，人也不错，会给提分。然后给大家推荐一下，owakado确实是极品，NTR也很好，小志乃酱很漂亮  ，团子也很厉害。本人价值观以及取向正常，热爱生活热爱和平。祝家马原高分。\n\n
68054,356,潘于旭,2018-01-22 14:16:39,1,2,1,给分良心
68571,356,潘于旭,2018-01-23 11:16:59,1,1,0,老师很棒的，很尊重每位同学，而且论文批改很仔细，课无聊是马原的锅，不是老师的问题。
68574,356,潘于旭,2018-01-23 11:29:05,1,1,0,事少给分好，会叫我们提前交论文，他给我们修改过以后再给你发回来，你可以二次修改，考试前二次上交就可以了，很负责的老师。最重要的是给分好啊！真的！
69442,356,潘于旭,2018-01-24 16:11:47,9,11,2,平时没怎么听课期末拿了4.5，期末复习才发现马克思主义思想的深度，后悔没认真学
71781,356,潘于旭,2018-01-29 03:04:08,1,1,0,非常认真、负责、敬业的老师。虽然事情有点多，对展示要求比较高，但讲课是我上过思政课里最有思维含量的，好好听下来对哲学和马克思主义会有一些感悟的。给分也不错！
74814,356,潘于旭,2018-03-06 04:10:53,1,1,0,老师真的超级棒，给的意见很用心和负责\n\n
76735,356,潘于旭,2018-04-19 12:32:33,0,0,0,哎我不喜欢这么严格
77557,356,潘于旭,2018-05-06 13:04:18,1,1,0,老师会很和蔼地给你提出论文的意见，是一个好老师
82613,356,潘于旭,2018-07-08 17:20:52,1,1,0,非常非常好的老师。上课要求有一些严格，但是一定是一个负责又亲切的老师，给分也非常好，论文会仔细看然后给出修改意见，我没发言，论文一般，考试一般，小组展示一般，最后4.5，真的是非常谢谢老师了
82738,356,潘于旭,2018-07-09 04:50:59,1,2,1,给分无语又当组长又发言马原的基础原理高中就认真背了好久(文科生)给分完就解散群，我想质询一下的机会都不给。
83011,356,潘于旭,2018-07-09 13:01:36,0,0,0,我觉得老师讲的还是很好的，就是可能自己没那么感兴趣所以不能每节课都听。and老师给分真的不错！
83064,356,潘于旭,2018-07-09 14:52:53,0,5,5,马原卡绩4.5，可能这门课就不存在更高的绩点吧哈哈哈。老师人真的很不错，最后一节时间紧，一次课讲完了2章，还跟我们多次抱歉时间没安排好，讲粗略了，平时论文和小组展示要求还是挺高的，但最后给分很好，马原其实还是最后考试比较关键，相比思修史纲其实还有挺有意思的哈哈。
87487,356,潘于旭,2018-09-29 13:04:22,4,6,2,无聊，全程理论，没例子
87955,356,潘于旭,2018-12-27 08:06:04,1,10,9,不太明白这老师的评分为什么这么高...
88278,356,潘于旭,2018-10-25 13:30:13,3,3,0,死亡马克思
93692,356,潘于旭,2019-01-12 00:48:11,13,13,0,凌晨四点还能收到老师的论文修改意见，感动哭了 老师真的是一个认真负责的好老师
97819,356,潘于旭,2019-01-22 22:40:39,10,10,0,潘老师太认真了，不仅仅是上课，课后对待我们的平时作业也十分认真，会收到凌晨两三点的论文反馈，真的很感动。觉得老师应该要早点休息爱惜身体才是！！！
97837,356,潘于旭,2019-01-22 23:39:42,6,6,0,给几百个学生挨个批改论文，然后发email提出修改意见也太良心了吧
97870,356,潘于旭,2019-01-23 00:35:57,1,1,0,哇塞，老师太辛苦了
97896,356,潘于旭,2019-01-23 01:19:37,0,0,0,挺好的，可能我咋听，但还不错！！\n\n\n\n
97909,356,潘于旭,2019-01-23 01:35:47,2,2,0,是一个非常慈祥可爱的老师，会很认真的给每一位同学回复论文修改意见的邮件。平时上课按照小组坐，一次展示一篇论文，课上不能玩电子设备，没有什么太多的事情。不过课上要积极举手发言，考试好好准备，老师一定会很公平给分哒！
97994,356,潘于旭,2019-01-23 03:29:07,2,2,0,老师挺负责的，也很认真，一直希望我们好好听课不要摸鱼划水做作业但是也没管住。。。挺和蔼的，讲课我觉得一般，没什么意思（可能我对这种不感兴趣吧）第一个会反馈论文情况的老师，发邮件的时候已经大半夜了，论文允许合作完成蛮好的，给分挺好！
98015,356,潘于旭,2019-01-23 03:58:36,0,0,0,虽然我听不懂，但是好评
98016,356,潘于旭,2019-01-23 03:59:14,2,2,0,老师超级认真负责，会认真看每篇论文然后给出意见。虽然课有点听不进去(工科生表示很痛苦)，但只要认真准备展示和论文，考试前好好复习，绩点一定不会低的!
98111,356,潘于旭,2019-01-23 05:31:20,0,0,0,给分超好，论文很认真的修改，老师人很好！
98112,356,潘于旭,2019-01-23 05:31:25,1,2,1,老师挺好的，改论文很认真，最后给分也挺好的
98150,356,潘于旭,2019-01-23 06:24:50,1,1,0,上课适合发呆，思考人生；论文，又制造了一篇学术垃圾…；老师会刷夜看论文；好好的哲学课上成了政治课
98151,356,潘于旭,2019-01-23 06:25:27,-2,2,4,主要自己期末考试要考的好，论文也要好好修改。小组展示没怎么参加，上课从没有发言，上课正常到。最后成绩4.5，不过卡绩了。
99483,356,潘于旭,2019-01-25 00:44:02,0,0,0,老师其实可讲的还行，不过马原课这种性质也摆在那里了，大家都不怎么听。小组展示要好好准备，发言最好有一次，交了论文以后老师还会提出修改意见，可以修改。期末考好好准备，选择题刷刷题，书本知识大致浏览一下就可以了。老师给分还是很不错的
100876,356,潘于旭,2019-01-27 03:51:20,1,1,0,老师很负责，论文好好写，期末好好背，就没问题
100920,356,潘于旭,2019-01-27 06:16:47,0,1,1,要发言、期末好好考——我都没做到所以我凉了。其实平时有认真看马克思的原著，只不过没法体现出来而已╮(╯_╰)╭，虽然只有3.9，还是感谢老师对我论文的意见啦，并且在看原著的时候和老师不时的讨论也让我获益匪浅。
112156,356,潘于旭,2019-07-03 17:52:20,0,2,2,挺好的 给分很好
112180,356,潘于旭,2019-07-03 19:15:19,1,4,3,老师态度很认真，但给分确实不如其他老师，从均绩比有的老师低了0.3就能看出来。期末复习刷题了一天最后才3.6，可能是因为我太菜了吧。
112209,356,潘于旭,2019-07-03 22:59:31,0,0,0,老师很可爱啊。非常喜欢
112340,356,潘于旭,2019-07-04 02:14:43,3,3,0,给分好好，上课没发言，论文感觉也写的一般，期末也没有复习很久。最后能有这个分数很满意了。老师很认真，批改论文也很用心。
112373,356,潘于旭,2019-07-04 03:11:50,3,3,0,老师太棒了！！就发言了一次 小组还超级不负责任 但最后给分超级好哇！！可能考试和论文比较重要？
113086,356,潘于旭,2019-07-05 23:00:39,0,5,5,平时没有提问及回答，期中论文因发送失败迟交半个月，潘老师真的很好啦，具体情况都是前几个评论里所说一直不变的，反正我上4就很开心啦，考前刷题很重要，背一背提纲什么的。
117912,356,潘于旭,2019-10-10 05:24:43,2,11,9,不让开电脑！不让玩手机！不让睡觉！又是坚生晦涩的水课！三个小时！我还有展示要准备呢不开电脑我死了，早知道不来上课，不来上课点名！wr....
118035,356,潘于旭,2019-10-19 04:17:12,6,8,2,不让干别的事挺讨厌，其实讲课的时候我也就自己想干啥干啥了
121012,356,潘于旭,2020-01-19 08:41:01,2,5,3,爷佛了，认认真真努力学了一学期马原，提前一个月开始背书，给爷卡绩3.9
123684,356,潘于旭,2020-06-11 13:07:12,1,1,0,毕竟网课 前几节没怎么认真听\n\n后来偶然一天碰巧稍微停了一下\n\n天呐 哲思实在是太精妙了\n\n后来每周四都期待着潘老师的马原课\n\n深入浅出\n\n虽然不是每一句话都能很明确的了解到\n\n但是整个意向一个又一个丢过来\n\n启发着我看待周边的世界的不同角度\n\n是可以反复听回放的老师\n\n太喜欢潘老师了\n\n谢谢老师！
123742,356,潘于旭,2020-06-13 07:27:51,0,0,0,老师给分超级棒！
127427,356,潘于旭,2020-11-23 02:58:08,2,2,0,老师对学生很好，区别于其他思政课，课堂活跃，老师们联系生活展开思政教育。推荐。
130096,356,潘于旭,2021-01-17 02:13:39,0,1,1,已读不回
131522,356,潘于旭,2021-01-28 01:48:52,1,1,0,爬老师人很好！给分超级棒！前来捧老师！
131563,356,潘于旭,2021-01-28 04:30:19,3,3,0,划水选手被给分惊喜了，虽然不是很高但投入收获比很值了……虽然马原课不能干别的事，但有次我睡着了老师也只是提醒了下我没说什么，谢谢老师
131589,356,潘于旭,2021-01-28 05:55:28,3,3,0,老师人挺好的，看两遍论文提修改意见任劳任怨是很让人敬佩的事情，讲课方面我觉得主要是马原这门课燃不起来，老师讲的我确实没听进去，期末稍微准备了一下，成功上四，感谢老师没有压我绩点。
132825,356,潘于旭,2021-02-04 02:04:47,1,4,3,已读不回的大绩杀
140985,356,潘于旭,2021-09-19 09:12:15,3,4,1,发论文给老师，老师很认真的回复了反馈和解答，教学态度没得说
142040,356,潘于旭,2021-11-04 12:08:43,1,1,0,不要连着上课，打铃就下课休息，o不ok？
145580,356,潘于旭,2022-01-10 03:11:06,5,6,1,在楼上的抽烟的，除了这个老师就只有韩国人了
146416,356,潘于旭,2022-01-06 14:14:09,-2,1,3,虽然上课很催眠，但希望能给分高一点
147424,356,潘于旭,2022-01-10 03:12:20,0,4,4,绩杀，上课讲的很催眠，各种事情一大堆，本来体验就很差，还来个绩杀，最差的老师
147427,356,潘于旭,2022-01-10 03:17:58,1,2,1,给分毫无下限
147636,356,潘于旭,2022-01-10 10:44:30,2,2,0,帽子不错
147729,356,潘于旭,2022-01-10 14:39:46,3,3,0,马原上课不知道 也没听过\n\n 老师态度很好 论文也会写评语 \n\n一点没卷 几乎啥事没干 成绩也还行\n\n思政课事少 展示省事 给10了
149118,356,潘于旭,2022-01-14 12:49:37,1,2,1,感觉还好，开始可能严厉（古板？）一点，但后来管的就很松了，他站后面看我划水也没说什么，不过一定记得要带书。\n\n关于成绩，期末考试全是客观题老师也不好捞人，所以考前一定要看书（上课认真听最好不过，虽然我也没怎么听过），这种课规规矩矩地讲起来，难免有些枯燥，如果实在听不下去了，上课翻翻马原书也挺不错，亲测有用👍
149895,356,潘于旭,2022-01-17 15:25:28,0,0,0,奇奇怪怪的课堂纪律比较多，不让用电脑平板，不让做其他课程作业\n\n上课讲理论确实比较无聊，有时候好像也有点“鹿”的味道……\n\n不过给分还可以的，事情也不算很多
149981,356,潘于旭,2022-01-18 06:59:36,1,1,0,一般吧
151202,356,潘于旭,2022-02-24 11:44:30,2,2,0,马原课真的太无聊了，也不是哪个老师的问题
154210,356,潘于旭,2022-05-26 05:12:24,4,4,0,感觉老师很认真负责 先给个10分
155681,356,潘于旭,2022-06-15 07:39:29,6,6,0,老师上课很认真，而且给每位同学的课程论文纸质版都写了评语。而且老师人真的好好啊呜呜，平时都不怎么听课 后来有一次坐到前排就听了一下，老师看我一直抬着头看ppt看他，讲完一个知识点的时候特别小声特别温柔地问了我这样能不能听懂，考完交卷的时候也很温柔地问我做完了呀，最后和他说老师再见的时候他也微微鞠了个躬呜呜呜呜呜呜呜老师人好好，虽然没出分但是也要给他打十分（听老师自己说应该挺求是的）
156134,356,潘于旭,2022-06-18 02:01:40,1,1,0,老师人很好，讲课也很负责，会手改论文写评语
156456,356,潘于旭,2022-06-20 00:44:22,-3,1,4,给分太好了
165548,356,潘于旭,2023-01-08 08:48:36,0,0,0,老师为人挺和善的，可能有人觉得他一直强调带教材还会下来检查有点麻烦，其实没什么关系
165801,356,潘于旭,2023-01-09 18:14:41,0,0,0,潘老师讲课讲的挺好的，事情也不多，就一个小组展示一个读书报告（好像还有小论文？记不清了）最后考试。结课以后碰到过他，还很和蔼的打招呼
166703,356,潘于旭,2023-01-13 09:09:48,0,0,0,潘老师人真的很好很好，上课很耐心，非常和蔼可亲，虽然笨人对思政课不是很感兴趣平常也不是很活跃，但是老师还是狠狠捞了
171040,356,潘于旭,2023-03-15 02:21:14,0,0,0,思政课人生第一个4.8，谢谢潘老头（狗头）
198480,356,潘于旭,2024-09-09 07:20:31,0,0,0,为什么要这样对待你的家里孩子与学生？🥹
10295,362,傅夏仙,2015-11-18 03:03:41,-2,20,22,特别无聊
14452,362,傅夏仙,2016-01-07 06:57:27,0,18,18,莫担心！老师人超级好！
18781,362,傅夏仙,2016-01-22 13:49:17,8,17,9,坑惨了
29236,362,傅夏仙,2016-06-29 13:05:08,13,34,21,给分…呵呵呵呵呵呵呵呵
29240,362,傅夏仙,2016-06-29 13:14:37,-10,11,21,老师非常认真，打分极度客观公道，考出来多少，平时表现多少，最后就是多少分。建议水的同学三思。
29263,362,傅夏仙,2016-06-29 13:51:23,7,16,9,给分极差，上课只会给人洗脑
29662,362,傅夏仙,2016-06-30 06:56:21,0,9,9,全班那么多人，没有一个过90的，你们体会一下？\n\n
29669,362,傅夏仙,2016-06-30 07:08:43,6,17,11,巨坑，给分极低。说公道的一定是自己分数高才说公道。那我们这些平时努力考试好好考为什么都这么低，这么多人说坑总有道理
30048,362,傅夏仙,2016-07-01 00:57:49,0,7,7,平时分96，依然不能上4
30315,362,傅夏仙,2016-07-01 08:41:56,0,11,11,老师人真的很好啊
32096,362,傅夏仙,2016-07-05 15:18:03,13,23,10,老师其实挺萌的，我相信成绩是客观公正的，以及成绩放水不是老师的本分。但要是给分好点就更好了，哭。
32832,362,傅夏仙,2016-07-16 11:02:46,-2,5,7,给分科科 平易近人倒是不假
34856,362,傅夏仙,2016-11-29 11:32:24,-2,5,7,腊鸡腊鸡腊鸡毁我青春的腊鸡更年期学生也跟着倒霉
38735,362,傅夏仙,2019-01-05 08:03:44,-29,12,41,大班点名，臭傻逼
38736,362,傅夏仙,2016-12-16 02:52:44,-3,2,5,上大课点名，不许用电脑
38761,362,傅夏仙,2016-12-18 08:28:46,-1,3,4,大班也点名，有毒。还建议其他老师也点名
48871,362,傅夏仙,2017-03-15 07:24:56,-3,0,3,上大班课对自己班无敌偏心没原则超随便简直了
48979,362,傅夏仙,2017-03-20 07:20:09,9,12,3,傅大仙的班怎么上课发言这么积极??
49202,362,傅夏仙,2019-06-16 08:14:22,-1,7,8,感人至极，我吃过的屎你们怎么能不吃_(:з」∠)_
51255,362,傅夏仙,2017-05-26 01:32:42,4,5,1,很看脸
55399,362,傅夏仙,2017-07-01 12:25:07,3,8,5,我的平时分算是比较好的了，但因为没有充分准备，考试考的一团糟，可能是大家都考的不好，最终给分相当让我满意....  之前说绩杀吓我差点退掉，现在看来还是得看自己.....
55416,362,傅夏仙,2017-07-01 12:50:42,5,8,3,很好的哇
55422,362,傅夏仙,2017-07-01 13:05:26,1,9,8,傅老师很好，很和善，只要平时认真，期末多看书，多背背，会有个好结果的。老师长得很可爱啊
55426,362,傅夏仙,2017-07-01 13:10:48,-1,6,7,为什么那么多差评....傅老师毛概课给分很好呀，平时分组和组之间不会差得太离谱，差不多都90以上，而且也很温柔，会给有建设性的意见，划的重点也挺准的。
55542,362,傅夏仙,2017-07-02 01:04:52,3,8,5,上课很萌很可爱\n\n给分也还好哇\n\n完全看自己努力程度\n\n
55682,362,傅夏仙,2017-12-22 15:37:52,9,20,11,感觉老师平时分给的挺好的基本每组都在90上下 并没有说的那么不好…
55932,362,傅夏仙,2017-07-02 16:27:48,6,10,4,老师给分还挺好的呀 平时分每组都是90上下，考试当然是要看自己好好准备了
61213,362,傅夏仙,2017-11-12 07:51:28,-12,8,20,迟到两分钟，正在点名。我名字排的靠前，已经点过去了，点完当场跟她解释也不听，直接算我那节课没去。给分超级底，这一门课直接把总绩点从4.1拉到4.0
69196,362,傅夏仙,2018-01-24 09:57:07,-1,4,5,不知道为什么评分这么低，我和我室友对比来看，这个老师平时分绝对给的很慷慨，最高的组有94，别的班有90起打的。最终我4.5，考试态度端正一点，多写一点还是稳的。
69216,362,傅夏仙,2018-01-24 10:19:08,0,4,4,考试情况不知道，毕竟卷面是自己做的，但对比其他老师，平时成绩真的给的很好了
69222,362,傅夏仙,2018-01-24 10:25:24,0,0,0,还可以
69380,362,傅夏仙,2018-01-24 14:47:56,-1,0,1,老师好可爱，上课很有趣。给分很高。
74190,362,傅夏仙,2018-02-06 11:45:22,-3,0,3,负责 认真
75943,362,傅夏仙,2018-03-22 09:32:33,-3,3,6,傅老师人真的很好，给分也很好，平易近人
82740,362,傅夏仙,2018-07-09 05:02:34,6,9,3,讲真，给分超级低。
82749,362,傅夏仙,2018-07-09 05:33:29,2,7,5,恕我说一句laji
82754,362,傅夏仙,2018-07-09 05:18:46,-1,7,8,老师蛮萌的~毛概其实主要还是看平时发言和期末考试吧 感觉老师给分还是挺好的 没有楼上说得那么不堪 期末多背背书 细节要多注意一下 有顿号的句子多背一下 答题的时候不会做的靠政治觉悟蒙一下 大题注意归纳每章节的大点 问题不大哒\n\n(｀•ω•´)
82755,362,傅夏仙,2018-07-09 05:20:16,-2,4,6,老师并没有像有些评论说的点名啊...小组平时分真心说比其他老师高了，每个组都有90上下（思政课啊）。老师有点可爱，但是的确上课什么的没办法思政课嘛有点无聊，选哪个老师无所谓啊反正是轮流上课的。
82762,362,傅夏仙,2018-07-09 05:26:18,1,6,5,分低是有原因的
82763,362,傅夏仙,2018-07-10 10:58:35,1,5,4,谁要是想证明自己党性够高可以选一选上面这位老师，感觉很难上90
82764,362,傅夏仙,2018-07-09 05:30:13,12,14,2,平时分还是看的过去的，就是期末卷面给分低一点。。。
82780,362,傅夏仙,2018-07-09 06:17:51,0,7,7,我总算是明白了，毛概这门课主要靠的就是选老师。而如果你选了上面这位，那恭喜你你毛概绩点已经凉一半了。其他老师期末简答题几乎看都不看差不多都给满，上面这位会严厉地批阅让你享受浙大最公平的给分机制，享受毛概期末大题接近0分的快感。
83411,362,傅夏仙,2018-07-10 08:37:53,1,7,6,别选，绩杀，4学分大课，轻轻松松毁掉别人梦想
86569,362,傅夏仙,2018-10-06 02:40:08,0,1,1,宇宙真理
96378,362,傅夏仙,2019-01-21 01:37:35,-1,3,4,老师说话很可爱， 给分还不知道 不过平时分是给的挺高基本90以上，考试的话除了选择和辨析是死的，其他老师都会尽量给分。
96522,362,傅夏仙,2019-01-21 05:28:36,-1,3,4,感觉老师给分不错啊，只要平时分够高，然后期末考试前多背一下重点感觉还是可以考高分的，而且老师人也很好，除了选择题和辨析题实在没办法，其他的题目还是会尽量给分的。
96523,362,傅夏仙,2019-01-21 05:29:40,-1,3,4,老师挺可爱的? 给分也还不错，绝对比查老师上这分要高，给老师点个赞?
96619,362,傅夏仙,2019-01-21 07:59:47,-5,3,8,毛概课讲课我觉得都差不多吧，我们这一组老师来说，傅老师算其中比较和蔼可亲的了。平时分其实给挺高的了，考试给分也没有那么差吧，只要写满写的好一些，绩点还是不错的。
96678,362,傅夏仙,2019-01-21 08:58:11,-1,5,6,傅夏仙就是垃圾，课上的傻逼，还卡绩点
103831,362,傅夏仙,2019-03-06 07:13:03,1,2,1,这老师有毒 不下课
106494,362,傅夏仙,2019-04-28 01:53:48,-2,2,4,架子大，脾气差
107510,362,傅夏仙,2019-05-06 05:50:44,3,8,5,不是她班学生 因为轮流上课所以听了她的课\n\n言论真的笑死人：\n\n“皿煮好不好对你们来说毫无意义”\n\n“在我们这残疾婴儿都会被捡起来送医院养大”\n\n“你觉得皿煮是西方模式的那你就是被洗脑了”\n\n不给一分愧对所有教过我的正常老师
107511,362,傅夏仙,2019-05-06 05:55:00,-1,4,5,上课洗脑学生 反过来说学生被洗脑????\n\n\n\n妙语连珠金句女王 “皿煮其实对我们是没有什么意义的” “书读多了迂腐了才觉得皿煮是超阶级的” ……………………………………
108115,362,傅夏仙,2019-05-15 06:46:37,-1,5,6,社会垃圾，这种思政课都是街上随便找个老太婆来上吗
110555,362,傅夏仙,2019-06-27 12:25:24,-1,3,4,我觉得傅老师超级好...说话幽默风趣！语调自带喜感......我说我要请假出国一趟...她叫我去吧去吧...交流是好事...超级喜欢?虽然今天毛概炸了（判断题全写了正确据说直接0分）但是很幸运选择了傅老师...还记得刚开学有人叫她夏老师哈哈哈哈哈
111267,362,傅夏仙,2019-06-30 23:06:27,-1,3,4,求问，毛概期末辨析题都错了，绩点3.9是亏是赚啊……
111751,362,傅夏仙,2019-07-02 18:16:19,1,2,1,呵呵呵
111921,362,傅夏仙,2019-07-03 02:53:18,5,6,1,纵使平时分高到爆炸 \n\n期末给分真的是呵呵了
111965,362,傅夏仙,2019-07-03 04:52:01,4,4,0,老师批卷无比硬核，快跑
111970,362,傅夏仙,2019-07-03 05:05:15,1,1,0,真的平均分很低，别看评分是5分，给分平均都很不行，毛概的老师，玄学，
117505,362,傅夏仙,2019-09-25 07:37:24,1,1,0,傻逼老师，偏袒自己班，不尊重另一个班组的劳动成果，就这还当思政老师，你对得起社会主义核心价值观么？
117751,362,傅夏仙,2019-09-30 07:35:20,0,0,0,二哥，
117824,362,傅夏仙,2019-10-03 16:39:44,1,2,1,有病，每次讨论课的题目都要上课前一天给出来，我们是只学您这门课吗?提前发个题目很难吗?
120382,362,傅夏仙,2019-12-02 01:40:03,1,2,1,老式教学
124036,362,傅夏仙,2020-06-21 13:14:42,2,4,2,老师年纪大了，极不适应网上上课，一问三不知，朝令夕替，问多了就不耐烦。\n\n打分没有讨论的余地，只能说后悔线上教学学了这位老师。
125940,362,傅夏仙,2020-09-16 02:15:27,6,18,12,无语了。毛概这课太tm变态了。第一节课事情就这么多，光介绍这门课什么东西就用了一下午，还不让看电脑，什么沙雕玩意儿。不就是看学生们看着这5学分的绩点吗，拿着鸡毛当令箭了。。这老师也无语，学在浙大上好好个课表、课程安排之类多居然只给预览特不方便，太tm的sb了。上课净讲些沙雕内容，比如无脑说国内好国外不行的，自己孩子还不是去国外了。。上课氛围搞得跟传销一样。。建议要出国的学弟学妹们眼光长远些，不为绩点折腰，思政能水则水，出国也不看这个的，把时间花到学习科研上。或者直接放大四修。
125942,362,傅夏仙,2020-09-16 02:23:35,1,1,0,呵呵呵
126267,362,傅夏仙,2020-09-21 07:34:57,5,8,3,符合对思政课老师的一切差评
127908,362,傅夏仙,2020-11-30 05:36:28,3,4,1,阔怕恐怖😱
127914,362,傅夏仙,2020-11-30 07:36:58,5,6,1,为啥能有4.3
127915,362,傅夏仙,2020-11-30 07:38:05,4,4,0,思考题目说改就改，不讲5的
127989,362,傅夏仙,2020-12-02 10:07:22,1,2,1,想出国的朋友不要听她忽悠
128797,362,傅夏仙,2020-12-25 11:35:12,4,6,2,选课前来评价一波她的毛概。\n\n上的课反正就是烂的无法直视，据说上个学期线上毛概考试还bb了一整场考试，真的有毒。老太婆真的乱讲一大堆东西，前后完全没有任何逻辑，真的随便拉一个人就可以上台讲毛概了，真的气人，5学分的大课啊！！！\n\n据说给分也差，但是鉴于毛概给分各个班级差距不大，也听说她的班级就是一个班级里的大家的差距都不大，不会像别的班级会有4.8的，但是她的班里很少很少
131419,362,傅夏仙,2021-01-27 12:04:58,-5,2,7,dont have mama
131501,362,傅夏仙,2021-01-27 18:43:57,1,5,4,习概这种拍马屁课除了恶心学生意义何在？
133331,362,傅夏仙,2021-02-26 01:21:45,1,4,3,考试成绩感觉就没调分，成绩太难看了，5分的毛概你们自己掂量吧
133563,362,傅夏仙,2021-03-02 07:13:47,24,36,12,开课第一句话就是性别歧视，第二句话就是专业歧视，第三句话就是身份歧视，真有精神！
133643,362,傅夏仙,2021-03-03 06:08:58,2,6,4,她也配当思政老师？
134151,362,傅夏仙,2021-03-17 06:13:46,4,7,3,这什么玩意儿
134335,362,傅夏仙,2021-03-24 05:25:16,9,11,2,H = Hard
135497,362,傅夏仙,2021-05-11 23:51:10,4,8,4,自以为是，无才华无内涵，不学无术，还没有耐心
135875,362,傅夏仙,2021-05-31 11:45:40,1,5,4,虽然思政课一般没人会听，评价思政老师都看作业和给分，但是我还是想讨论一下这位老师的课：\n\n这是985老师的眼界？？？
135993,362,傅夏仙,2021-06-08 10:39:38,3,7,4,虽然讲课讲的很是不行，但是包装自己的能力超一流，在利用学生免费劳动力方面登峰造极
138178,362,傅夏仙,2021-07-07 20:31:55,0,2,2,H课的毛概，偶尔点名吧。讲课也就那样，但是最后给分的时候挺好的，没有卡绩，而是把我向上捞了一个档次。总之，我感觉老师给分挺可的，但是讲课emmm
138187,362,傅夏仙,2021-07-08 00:09:47,3,4,1,给分真的挺好的，上课也没什么别的事情，给个好评，不像别的班那么卷
138195,362,傅夏仙,2021-07-08 01:22:18,6,8,2,老师事少给分高，偶尔点点名，毛概得到了思政课最高的成绩，感谢老师！
138212,362,傅夏仙,2021-07-08 03:15:35,7,9,2,课程是毛概H，点名要点，不来需要请假。 平时每周连着三节的最后一节讨论课，课前报名，按顺序发言，连着两节课的时间用于展示，每小组春夏学期各一次展示，平时分给的在93-97之间；期末改卷应该给分挺高的，虽然毛概书的小知识点很多没有看到。身边同学高分真的很多\n\n听下来后，真的收获蛮大的，傅老师“整组”老师的水平还是挺高的，虽然从一开始真的很担心这门课的成绩TAT。（虽然觉得同学们还是更看重成绩orz
138251,362,傅夏仙,2021-07-08 07:19:58,0,2,2,傅老师真的很好很好！人超超超超可爱，会跟学生聊天，而且今年给分真的真的真的真的很不错！
138509,362,傅夏仙,2021-07-09 15:06:49,0,2,2,呵呵，呸！
138772,362,傅夏仙,2021-07-10 18:36:25,1,5,4,傅老师人很好呀，平时分靠自己跟小组努力，期末考试全校统一出卷没必要说老师。我们小组最低都是4.2，还有同学满了
140777,362,傅夏仙,2021-09-16 03:42:09,0,2,2,我先放个1分在这里\n\n老师充满了高傲的气息
141047,362,傅夏仙,2021-09-22 07:02:18,0,1,1,不说别的，张口就来清平乐(le)六盘山
146082,362,傅夏仙,2022-01-05 11:50:36,-2,1,3,真的无语
148386,362,傅夏仙,2022-01-12 10:03:35,3,5,2,一整个学期没有点名，期末错了一大堆最后还4.5了，老师班上也不怎么卷～
148891,362,傅夏仙,2022-01-14 01:46:51,2,3,1,保佑下学期毛概H
150973,362,傅夏仙,2022-02-21 12:18:32,-1,4,5,讲浙江的乡村建设时说要不这样的话你哪有乡愁，巴不得逃出去。。。\n\n这都物质成什么样了？这居然是思政老师?
151044,362,傅夏仙,2022-02-22 07:30:38,-1,2,3,不知所云
151114,362,傅夏仙,2022-02-23 06:24:21,0,4,4,无聊到窒息，而且说真的现在可能是想和同学亲近一点，摆出一幅我其实挺了解你们年轻人想法和文化的姿态，实际上根本就没什么交流。
151266,362,傅夏仙,2022-02-27 05:46:58,-7,2,9,第二天展示前一天通知\n\n真的伞兵
152640,362,傅夏仙,2022-04-17 02:52:28,-7,0,7,。。。
153744,362,傅夏仙,2022-05-10 03:20:55,40,59,19,上的H课，老师从来不点名，班里有很多同学没来的时候也会说是在线上上课。另外展示的东西感觉也没有鼓励过内卷，看到有小组卷的时候还开玩笑说你们怎么这么卷啊。打展示分的时候瞄了一眼她打分都是92+左右。讲课算不上好，但也绝对不是这个评分。
153789,362,傅夏仙,2022-05-11 05:45:59,-8,2,10,大傻逼
154520,362,傅夏仙,2022-06-02 03:44:33,4,9,5,人来的那么少，老师从来没用真的生气过，不知道为什么分这么低。课程怎么样都是统一设置的
156124,362,傅夏仙,2022-06-17 16:23:48,-2,2,4,各种安排课代表要给力一些吧，其他的其实都还不错的
156714,362,傅夏仙,2022-06-20 17:37:34,0,1,1,希望得到个好成绩，拜托了！
157041,362,傅夏仙,2022-06-21 17:15:52,9,11,2,今年给分很好，捞人力度极大，点名次数也不多，放心选\n\n\n\n老师人很好，很多时候只有不到一半人在教室，还有好多同学在玉泉，老师也从不生气\n\n讲课无聊了点，但是并不干涉同学们使用电脑等，没有举手发言，完全不卷，大部分组都在摆，比马原体验好太多（马原嗯卷，平时满了，总分却低一档）\n\n满分不解释
157046,362,傅夏仙,2022-06-21 17:25:24,7,9,2,不知道以前是什么样，但是老师这个学期真的很不一样。整个人就是非常和蔼的形象，努力给你讲东西。不过这些政治的东西，每个人都有自己的理解。深刻的思想想要讲开本来就不是这节课能做到的。虽然不排除老师对一些比较新的app功能不太会（比如点名）。后面的同学可以放心选，至少不像之前所说的一样那么差的。
157054,362,傅夏仙,2022-06-21 18:21:28,2,4,2,傅老师给分超级好！！！！（指H课） 选就完事了xdm
157059,362,傅夏仙,2022-06-21 19:43:07,-1,1,2,感觉浙大毛概都一样的风格，傅老师已经算比较认真负责的老师了，也会体谅学生们的难处，有时候“因为疫情”就不常点名了。老师的课上H课也不怎么卷，老师给分也挺高的，很满意这个成绩了
157075,362,傅夏仙,2022-06-21 23:36:44,-1,1,2,太能捞了，真的太能捞了，我愿称之为捞王
157077,362,傅夏仙,2022-06-22 00:00:32,3,6,3,太能捞了！\n\n但还是建议平时发言和展示好好做，这样平时分能高一些，感觉最后的总评和平时分挺接近的
157087,362,傅夏仙,2022-06-22 01:16:06,3,5,2,推荐，老师平时和蔼，而且给分真心还行（毛概h），我平时分90出头，4.5
157135,362,傅夏仙,2022-06-22 04:21:01,3,7,4,傅老师没啥不好的啊…一开始有被评论劝退，后来发现上课不卷、老师口音可爱、给分也不错（h课）…思政课的内容就是这样了，也不能怪老师…毛概h事情少、不卷、给分可（相比之下马原h事情多上课发言蒽卷给分也就那样…
157169,362,傅夏仙,2022-06-22 06:59:06,-1,1,2,好好好
157174,362,傅夏仙,2022-06-22 07:14:51,-1,1,2,H课给分不错，事少。
157550,362,傅夏仙,2022-06-23 16:52:38,4,4,0,上课不太行，喜欢东扯西扯，知识点不具备系统性。师德很好，关心学生，不鼓励内卷。
157623,362,傅夏仙,2022-06-24 04:46:21,0,2,2,傅老师人很好，很乐于和同学交流，也能够站在学生的角度思考问题。个人觉得不至于这么低的评分。
157813,362,傅夏仙,2022-06-25 02:53:41,1,3,2,老师真的挺不错的，不知道为什么分这么低
157914,362,傅夏仙,2022-06-25 13:25:41,0,2,2,好的呀 没评论那么可怕
159390,362,傅夏仙,2022-07-15 15:50:26,8,9,1,捞分捞得厉害！\n\n不管以前怎么样，这学期老师给分超好，任务很少。课题堂经常没几个人，人来的那么少，老师人超好，一点都不生气。\n\n很主动地跟学生套近乎，有点卑微的感觉。\n\n平时分87，最后90多。太意外了。\n\n同学缺勤多次，最后92分 \n\n让人摸不着头脑风了。
159614,362,傅夏仙,2022-08-22 05:13:32,8,9,1,风评逆转\n\n人真的很好了现在
162269,362,傅夏仙,2022-11-18 15:03:14,3,4,1,真的是超级和蔼的老太太\n\n爱了爱了
165023,362,傅夏仙,2022-12-28 11:43:59,-145,3,148,给分一般般吧， 拿了4.2， 拉低了巨多均绩:(\n\n当然我的确考的也烂
165999,362,傅夏仙,2023-01-10 16:12:18,10,11,1,老师人挺好的，真的很耐心，也有尽量在捞人了（比如说我）。毛概这门课的问题，老师评分是值得更高的。
167688,362,傅夏仙,2023-01-18 09:58:40,2,5,3,五分毛概h，应该是最后一次开课了。\n\n点名四次占3.6分，课上在线小测3次占9分。这是课程组要求的平时个人成绩。\n\n小组任务主要是每周发言和两次展示，占47.4分。展示大概会安排在滴4周左右和第12周左右。小组成绩给分很好很好，这一次大多在95—99，和其他大多数老师相比算很好了。\n\n期末占40分，看得出老师应该是在努力捞人。\n\n原先的差评中的现象已经不存在了，期末最后一节课还顶着羊了的嗓子给我们梳理教材。
171886,362,傅夏仙,2023-04-11 02:40:30,1,2,1,点名还玩狼来了
174479,362,傅夏仙,2023-06-13 02:23:03,2,2,0,很久没遇到这么“传统”的思政老师了^ ^
177128,362,傅夏仙,2023-07-02 00:40:29,-3,0,3,评分不应该这么低，但感觉也没有给分很好
177221,362,傅夏仙,2023-07-02 09:44:29,4,5,1,3学分的毛概H。上课比较无聊，老师是俄粉。第三节课展示。一个组十个人，两周就轮一次，感觉次数还是比较多。会有视频观看并评论、现场教学、经典研读等环节。\n\n期末考试居然不是考理解而是考背诵，感觉考砸了结果给分还行。
177264,362,傅夏仙,2023-07-02 13:01:52,0,0,0,平时事不是很多，三分毛概H，给分比起五分时代来说不是很好
181006,362,傅夏仙,2023-10-02 05:14:00,1,5,4,老东西的思政水平在高中生之下
184806,362,傅夏仙,2023-12-23 02:53:09,1,5,4,为了自己评奖，周末早上折腾学生，早上八点从玉泉拉到紫金港，特意买了个横幅拍照，学生当背景板，太有实力了，特意来给1分。
188432,362,傅夏仙,2024-01-19 03:43:36,4,4,0,参观红旗渠巡展是为了给同学拉平时分额外做的活动啊。虽然有点烦，但是下一周正课就没有上啊，还补上了小组少的平时分，这不还蛮好的么。
188447,362,傅夏仙,2024-01-19 04:23:48,2,2,0,其实老师挺好的，周日那个是全年级统一的，而且还有加分，不想去也可以不去的啊，楼下在瞎抱怨什么?
188547,362,傅夏仙,2024-01-19 08:19:11,-3,2,5,毛概：\n\n讲课水平无需多言，学不到东西，对期末的帮助约等于0，也没有其他班级的划重点的课\n\n平时分是小组分配式给分，组内大家都差不多，组间就看谁能卷，要么展示特别强，要么就拍情景剧喽，fxx是会拍照的哦\n\n总的来说给分不如其他老师，也不算捞。期末和室友一起复习，我们掌握程度差不多，平时分也差不多，但室友班的老师给分好，最终总评差两个档\n\n后来者自行判断哦，如果实在换不到更好的老师，就嗯卷展示，期末狂背，也是能拿高分的（就是性价比低，而且和其他班比不平衡）\n\n希望有帮助到你们
189259,362,傅夏仙,2024-01-22 15:43:36,1,1,0,感觉还可以，其实老师本身对绩点制度也是有意见的，也希望我们都能尽量高分
189330,362,傅夏仙,2024-01-23 09:04:45,4,6,2,毛概：\n\n1. 课程本身毫无价值，平时课程也没有听的意义，讲课水平无所谓。\n\n2. 平时分主要是组内分配，平时事情一大堆几乎每周一个思考题，也有个人的感想啥的用来加平时分的。\n\n3. 老师人还是不错的，给分也就那样，这种浪费时间的思政课也不要抱什么期待了。
190145,362,傅夏仙,2024-02-23 17:13:59,7,8,1,傅老师年高德劭，算是风格比较“老牌”的老师。\n\n前面看到其他同学的一些评论，我觉得也许是“仁者见仁，智者见智”。总体而言，傅老师人还是不错的；但她教授的这类课程具有一定的特殊性，有些问题可能是课程本身就无法避免的，比如期末要考背书以及搞小组展示等。
193028,362,傅夏仙,2024-06-02 16:30:14,-8,2,10,喜欢把自己看作凌驾于学生之上的一个至高存在，陶醉在自我的世界里
194000,362,傅夏仙,2024-06-21 09:51:01,11,11,0,虽然还没有毛概期末考，但是来帮老师点个个好评！感觉朵朵上好评比较多。\n\n小组分的给分真的挺好的（至少我们组是这样的，最后小组分高到以为老师算错了），虽然对展示的内容会指出漏洞，但是听助教说，老师给每个小组打分都是90+的，看到同学互评很低还会提醒他们打高一点，成绩好看。\n\n老师经常说因为自己平时分给太高，不满足正太，系统不让她提交成绩。\n\n性格上：感觉老师没什么架子，直肠子，挺好的！就是感觉像比较熟的朋友一样，会怼你一下的那种，但能感觉到没有什么恶意，点名也都是会通知的。不知道怎么形容，感觉就是没啥坏心思的，直来直往的那种老师。
195709,362,傅夏仙,2024-06-29 17:15:05,5,5,0,这几年老师还可以，完全可以选fxx老师课了。平时分每组都相对而言还是高的，然后总评成绩也不错，实话实说老师值得更高的分数，唯一就是课有点点无聊。
195745,362,傅夏仙,2024-06-30 00:59:01,6,6,0,老师人还是不错的，平时分也打的很高，期末虽然难但还是被狠狠地捞了\n\n唯一的问题是老师的毛概相对于其他老师事情比较多，介意这点的慎选
195801,362,傅夏仙,2024-06-30 03:30:24,7,7,0,给分好，上课几乎不点名，和学生的距离近，有耐心，不知道为什么评分才五点多
195803,362,傅夏仙,2024-06-30 03:34:04,8,8,0,我觉着老师还是非常好的，平易近人，期末给分也挺好的。毛概课程任务其实不算多，因为毛概课程本来就需要多次小组讨论展示、经典研读等，但是老师平时分也会给的挺好，而且有几周我们还是线上的课，总之十分推荐！
196113,362,傅夏仙,2024-07-01 16:33:02,4,5,1,老师人很好~感觉喜欢和学生讨论\n\n课程上，其实正课一共只上八九次，有一节读书报告展示，有一节课外实践展示，最后一节分分数，课外实践会有一周不上课，我们由于节假日还少了一节，然后我们是有一节课去艺博馆，属于是给大家加分的，小组展示两周一次的话，一共是3次（因为节假日少了一节课所以避免各个小组展示次数不一样）。\n\n其实工作量上来说，应该是只有课外实践和读书报告是比较辛苦的，因为一个组有10~11人，分工一下的话会好很多
196178,362,傅夏仙,2024-07-05 12:56:37,4,6,2,多亏查老师这个不起眼评分，使得我在浙江大学彩票系统中有机会选上这位好老师（以及好助教）~~真的大捞特捞
196239,362,傅夏仙,2024-07-02 11:58:25,8,9,1,很好的老师，学弟学妹们不要被评分给骗了\n\n对学生很有耐心也很为学生着想\n\n海底捞！
198305,362,傅夏仙,2024-09-06 12:03:22,5,5,0,哈哈，评分低没人选挺好
201985,362,傅夏仙,2024-11-08 03:10:24,2,2,0,懒洋洋..嘿嘿..我爱懒羊羊😍😘
207679,362,傅夏仙,2024-12-23 16:37:21,0,0,0,事情太多了
210109,362,傅夏仙,2025-01-08 07:14:51,3,4,1,毛概H的神，这里给个低分保护，能捞尽捞，平时分慷慨的，可以冲！
210232,362,傅夏仙,2025-01-08 13:11:02,0,0,0,低分保护（x）\n\n毛概H，事少分高。本人从未到过课，思考题 GPT，社会实践线上参观，期末裸考（辨析全错）也能上 4，已经相当满意了
210283,362,傅夏仙,2025-01-08 17:13:07,1,1,0,24-25秋冬毛概h给分很好，上课人很少也不点名，平时分几乎95左右，体验还是很好的。
211017,362,傅夏仙,2025-01-10 10:44:45,-8,0,8,what can I say 这就是玉泉H班吗\n\n讨论表是组员GPT的，读书报告是solo然后三天速通的，实地调研是参观了一圈回来只写了报告的，最后平时分据说全班最低但是96（（（\n\n考试的话2425秋冬只需要背2346章，一晚上搞定 神
213143,362,傅夏仙,2025-01-16 06:10:20,1,2,1,好老师，来个低分保护
220210,362,傅夏仙,2025-06-16 09:54:45,1,1,0,点名有通知，这课还挺好的，也不用听，平常上课干什么也不管。而且老师真的在讲课，不是随便吹水，如果有兴致听听讲也没问题
220926,362,傅夏仙,2025-06-20 11:05:33,1,1,0,坐标毛概H，有点名和小测，但比较松，小测没到的话还可以补测，最终给分还可以，跟我预想的差不多（间接说明可能没怎么捞orz），傅老师人不错的，每个组展示给分都在95左右，考试不划重点的问题也可以通过看别的班补足（用的是一张卷子）
220951,362,傅夏仙,2025-06-20 12:35:32,0,0,0,毛概的神！！！低分保护一手
220973,362,傅夏仙,2025-06-20 14:02:13,0,0,0,寝室三个人一个分数，有点神奇
221011,362,傅夏仙,2025-06-20 17:01:48,2,3,1,坐标毛概H，神仙老师！！不管是上课体验还是给分都非常无敌！\n\n讲课方面，能感受到老师的用心（一学期全在写别的作业感觉有些抱歉T T，老师上课前会让同学们把电脑收一收但并不强制）。点名和小测同步进行，一学期两次，都是在知到app上，会提前通知，并且可以请假补测（五一的那节课前老师还专门在群里发消息说假期快到了可能有同学有自己的事，提醒大家一定要请假，她真的）。小组平时分好像也都拉得挺高（看到评论里有说95左右的，反正我们组确实是这个分）。刷网课和提交思考题的任务在期末前提醒了我们很多次一定要做。最后，期末考情况肯定也是影响给分的，但个人体感改卷还是比较友善的，本人高中纯理平时不学考前突击2小时速背，考场上努力拼凑记忆写了一些七七八八的，也最终得到了92/4.8的成绩T T真的很出乎意料了，非常感恩老师给我这学期惨淡的菌剂往上捞了一把……\n\n（个人感觉这门课考试是有技巧的，纯裸考可能确实不好拿分，但只要挤出一小点考前时间来看就能有不错的提升。我因为考毛概那天早上还有一门专业大课考试，根本没时间匀给毛概，就没看书，考完中午直接到98上找了3份资料来记：提纲（好像是份经典资料）+大题答题条目简要梳理+选择题重点，主要是背大题，多次过这份资料的间隔里看提纲和选择这样，最后上考场前再在脑子里刻了一遍活的灵魂和三大法宝6个词。感觉仅凭这2小时就已经可以让我做到，选择题的题目/选项有不少都是见过的，大题基本都有作答思路这样了。总之就是，如果有时间的话多看看书肯定能复习得更充分，像我这样的，一两小时抓紧背一背也是很有用的！最后就是大家中学阶段中都知道的，答卷的时候字写清楚一点，分点列好1234，把脑子里能联想到的知识点写完之后，再结合材料使劲编，能编多少是多少，一直写到交卷时间hhh）\n\n我的感想就这样，希望能帮到大家！祝愿大家都能在这门课中取得满意的成绩！最后再狠狠感谢一下老师！！！
221617,362,傅夏仙,2025-06-25 02:50:06,0,0,0,给分还行\n\n上课很无聊
221996,362,傅夏仙,2025-06-28 10:14:51,0,0,0,毛概H很好。在我上过的思政课里，傅老师的评分是最低的，但给分却是最好的，感谢老师。
5971,599,杨冀辰,2017-05-08 10:58:55,-116,30,146,老师简直业界良心！唯二点名一次没到居然还有90！
6285,599,杨冀辰,2017-01-06 03:40:11,38,70,32,哎\n\n
19483,599,杨冀辰,2016-01-24 10:54:11,-7,10,17,认真，就有收获
30044,599,杨冀辰,2016-07-01 00:54:01,20,28,8,给分不太好
30055,599,杨冀辰,2016-07-01 01:12:23,-7,7,14,在毛概课上算不上能给同学收获的老师，但能水过；冲这也该点个赞。
30195,599,杨冀辰,2016-07-01 05:03:25,-4,10,14,强行挂科 垃圾老师 不要选
31840,599,杨冀辰,2016-07-05 03:56:45,-1,10,11,最多给3分，给分极坑。
32959,599,杨冀辰,2016-08-30 12:02:39,0,5,5,老师很认真，回答问题认真听课就能高分
46455,599,杨冀辰,2017-01-21 15:16:28,9,13,4,还不错的 平时分有考虑到同学的恶性竞争了
46466,599,杨冀辰,2017-01-21 18:28:29,4,11,7,创造了思政课的成绩最高纪录。估计运气成分还是有点大。老师对我们的要求倒是不高。不过那个唯一一次点名不到要扣五分的场景也是令人影响深刻。挺好的老师
46798,599,杨冀辰,2017-01-22 10:40:11,0,2,2,给分差，水。
51095,599,杨冀辰,2017-05-17 01:33:06,1,3,2,老师人很好啊\n\n不知道给分怎么样
52204,599,杨冀辰,2017-06-16 02:29:02,3,3,0,点一次名5分是有点恐怖啦……但是老师人很好的，说话也很有条理，成绩也是能给高就给高，平时成绩也很追求公平了，会让大家互评，很喜欢老师～
52205,599,杨冀辰,2017-06-16 02:43:00,9,11,2,作为思政课的老师话不多，事也少，最后一节课很早就下课表示很爽
53117,599,杨冀辰,2017-06-26 02:35:36,6,9,3,作为毛概老师我觉得算不错的了，可水过，对学生也不错。唯一要注意的是他会突然点名，一次点名分值挺高，上课最好还是去吧。
55079,599,杨冀辰,2017-06-30 20:09:32,0,5,5,平时分包括组长自己的分数全部组长一人分配，会有不公平现象
55139,599,杨冀辰,2017-07-01 01:50:20,16,18,2,我们这届上课有两次点名，老师人很好，很温文尔雅，对班级同学也很和蔼耐心。但是毛概不仅看考试成绩，平时成绩的话，当当组长和课代表有加分。
55178,599,杨冀辰,2017-07-01 03:21:30,1,2,1,老师人很好啊
55179,599,杨冀辰,2017-07-01 02:56:19,1,2,1,老师很有男神气质
55188,599,杨冀辰,2017-07-01 03:11:30,5,7,2,社会我杨哥，事少话不多。
55244,599,杨冀辰,2017-07-01 05:31:30,3,4,1,老师有几分像陶然男神 有木有
56701,599,杨冀辰,2017-07-04 10:09:50,3,4,1,给分不错的 会考虑到恶性竞争  平时参加竞争  考试考好也能拿不错的绩点
57754,599,杨冀辰,2019-05-30 05:04:52,4,6,2,给分还不错，考试认真看书准备一下，选择题多拿点分就不会被正态分布了。
58822,599,杨冀辰,2017-09-18 03:48:17,7,9,2,老师很好啊，讲课很耐心的，我觉得给分其实不怪老师，平时分组长给的，展示也是各个组长给打分，剩下的是自己考试啊。思政课里我见过的最好的老师了
59897,599,杨冀辰,2019-01-05 04:58:47,13,17,4,不到二十分钟，讲了161个“是吧”，口头禅很有趣，估计下课后正字画满一张纸。
60832,599,杨冀辰,2017-10-31 03:27:55,0,1,1,点小组很随意，没有任何原则可言
60833,599,杨冀辰,2017-10-31 03:30:53,7,9,2,政治观点中立，不会让人听着很不舒服，正反分析，综合立场，是个不错的政治课老师。
69588,599,杨冀辰,2018-01-25 04:32:47,3,3,0,思政课就那样随便选个拿个学分走人
69600,599,杨冀辰,2018-01-25 04:59:01,9,15,6,有个口头禅怎么了？真好奇统计人家说了几个口头禅的人，得有多闲？\n\n说实话，马原毛概虽然课很水，但是如果认真读，会发现里面的思想其实十分深刻，我们觉得枯燥是编写教材的人的锅
71125,599,杨冀辰,2018-01-28 03:45:47,3,4,1,给分贼好，感觉周围很多4.5+
71307,599,杨冀辰,2018-01-28 09:18:59,1,2,1,老师还不错，很有气质
72943,599,杨冀辰,2018-01-31 11:57:25,0,0,0,小组坑也没办法 组队很重要啊
74580,599,杨冀辰,2018-03-04 03:16:02,-1,1,2,hi 陈小花
82408,599,杨冀辰,2018-07-08 06:18:18,5,6,1,出分前对老师进行评价~老师很认真，很儒雅绅士，教学方式我很喜欢，尊重学生。从他身上能够感受到很多的学识与涵养。
83207,599,杨冀辰,2018-07-10 02:30:03,1,4,3,我觉得给分还是可以的？最关键是，老师把毛概讲的很客观公正，感觉是个很讲道理的老师啊。
83213,599,杨冀辰,2018-07-10 02:39:53,-4,2,6,事情贼多。道貌岸然。
83215,599,杨冀辰,2018-07-10 04:35:31,0,0,0,...
83281,599,杨冀辰,2018-07-10 04:08:35,13,15,2,老师挺不错的，反正这种课都是轮着上，没什么大的价值。这种课就没有意义存在
83292,599,杨冀辰,2018-07-10 04:39:23,2,3,1,老师人好，但是给分不好。
83689,599,杨冀辰,2018-07-11 04:03:05,8,10,2,老师人很好\n\n课程事情少\n\n随机点名一次\n\n感觉平时分对成绩影响不大\n\n亲测期末只要前一天看完毛概书的重点章节\n\n背一背，绩点上4没问题\n\n
88327,599,杨冀辰,2018-10-28 16:31:18,0,0,0,呵，，
89174,599,杨冀辰,2018-11-16 10:36:43,3,4,1,是吧，对吧，是吧，对吧……
97890,599,杨冀辰,2019-01-23 01:10:11,3,3,0,老师还挺好的，给分也可以的
98108,599,杨冀辰,2019-01-23 05:25:43,2,2,0,好好好好好好好好好好
98655,599,杨冀辰,2019-01-23 16:44:06,0,1,1,人很好，给分不错，但也仅此而已
99146,599,杨冀辰,2019-01-24 10:22:24,3,4,1,老师很有气质，上课也挺好，小组是自由组队的，平时还是靠自己多贡献，考前复习也要自己努力。唔别的就是感觉老师平时分给的有点点低？（对比我所知的另一个老师），不过毛概这课主要还是看期末吧。
99931,599,杨冀辰,2019-01-25 10:05:14,6,6,0,老师很好，很儒雅，对比来上课另外几个老师不知道好到哪里去了！  给分挺良心的，班里最水的组分数也不会很差。
111934,599,杨冀辰,2019-07-03 03:34:28,2,2,0,老师人还是很好的，温文儒雅很舒服的气质，对比室友感觉平时分给的也还是比较高的，就是感觉出分有点慢，还在惶惶不安的等待毛概分数(ʃᵕ̩̩ ᵕ̩̩⑅)
112218,599,杨冀辰,2019-07-03 23:24:27,5,9,4,给平时分的这种规则的确很不公平。如果你的组里有不在乎成绩的，只要过了就好，那他就舍己为人了，把自己的平时分降到60左右，其他成员平均每个人就能多得3分！！这对于其他组低年级的同学简直是伤害！如果组里有两个这样的人，没错，一个10人的大组里只要有两个这样的人，其余8人的平时成绩都可以90+甚至95+；如果组里没有这样的人，大家就只好都八十几，最后一起被砍。所以既然是小组活动，小组成员就要一个分数，人家马原就是，你们不是，你们应该向他们学学。
112258,599,杨冀辰,2019-07-18 10:18:01,-29,10,39,组队的时候各取所需，中国学生提供资料和辅导帮留学生及格，留学生想任务少一点，组队就明确说明小组任务不做的人分数方差就会非常大，参与进来分数也就不会那么低。按照毛概课给分原则赋分，占据了平时分高分段也意味着承担了低分段，选择新的帕累托最优点按照游戏规则来玩没有不合理的地方吧。最后高平时成绩的人也不是全部4.5以上也有不到4的。你觉得不合理，无非是觉得自己小组有人不怎么干活还不好意思分掉他们的分数最后自己分数也上不去，那我觉得你应该在给分的时候有点魄力提前制定下学生手册内容。骂街？没必要，均贫富的话不如取消平时分大家一起考试比高低吧，毕竟楼下有点干涉他国内政的感觉哦
114397,599,杨冀辰,2019-07-10 00:44:24,33,37,4,楼上杨冀辰18-19春夏学期紫金港班国贸专业某组跳出来叫嚣了？平时分应该是对小组真实水平的反馈， 敢问你们小组8个人的98分平时成绩水平真的比我们其他组的同学都优秀那么多吗？其次班上哪个小组都和你们一样有两三个划水不干事的同学， 但大部分小组都做不到给这些同学如此低的分数， 否则那些划水同学也不会同意签字，记得你们在讲台上给老师说你们组有两个交换的同学只要总成绩过了就行，所以你们就给他们60多分的成绩，呵呵，很多组组内平时分极差也就是7、8分。如果平时分可以这样分配的话， 那以后毛概课每个组大可以招几个保研没有希望/交换生等对分数不敏感只要60分万岁过了就行的同学， 然后把他们的分数用在其他人的分数提高上。两个六七十分的同学就可以给其他组员的平均分加上六七分， 别占了便宜还来这骂街。
115315,599,杨冀辰,2019-09-09 07:09:22,3,4,1,张口闭口x大大?
123954,599,杨冀辰,2020-06-17 15:12:03,3,4,1,恶竞之源毁人不倦，篇篇报告破万字，一共十几个报告
124492,599,杨冀辰,2020-07-02 02:27:11,13,13,0,老师是好的。可是。成绩令人沮丧
126082,599,杨冀辰,2020-09-17 08:17:08,-5,3,8,就硬舔
133482,599,杨冀辰,2021-03-01 06:26:55,-5,3,8,体验：\n\n1、表格狂魔，大事小事都弄成表格\n\n2、形式主义，小事能说半天
145241,599,杨冀辰,2021-12-28 11:45:23,0,0,0,。。。
149581,599,杨冀辰,2022-01-16 04:44:30,2,2,0,评分细则都非常认真地列好，在钉钉群一份，学在浙大一份，各种资料也都好好归纳在学在浙大一搜就能看到，考前还特地整理了自己部分的ppt发给同学们，平时分给得好，很有帮助
150824,599,杨冀辰,2022-02-19 06:04:37,0,0,0,。。。
154937,599,杨冀辰,2022-06-07 03:32:53,2,2,0,老师是挺好的，但是分数得靠自己的
166314,599,杨冀辰,2023-01-12 02:22:22,6,6,0,毛概平时分给的挺好，都是90+，但是考试感觉一点没捞
166375,599,杨冀辰,2023-01-12 06:01:32,4,4,0,我爱老师，我爱老师，我爱老师。\n\n本来以为要挂掉了，竟然及格了，谢谢老师！！
166500,599,杨冀辰,2023-01-12 12:04:31,3,3,0,老师给分真的蛮好的
177597,599,杨冀辰,2023-07-04 01:47:28,1,2,1,老师给分不错！
181376,599,杨冀辰,2023-10-16 05:43:23,0,0,0,都怪楼上让我数口头禅……我停不下来了
186042,599,杨冀辰,2024-01-08 03:50:06,3,3,0,刚上完最后一次课，趁着还没考试评价一下。老师很儒雅随和，而且回复同学都非常非常认真用心！好老师，真的对学生非常用心！
188059,599,杨冀辰,2024-01-18 06:26:06,2,2,0,老师要退休了，老师是马院为数不多的好老师。
843,609,陈小英,2015-03-17 23:31:56,4,7,3,很关心学生的一位老师
1314,609,陈小英,2015-03-21 23:47:01,12,30,18,挺好的老师\n\n
1813,609,陈小英,2015-03-25 08:37:01,44,89,45,人很好，给分也好
2896,609,陈小英,2015-05-10 14:28:40,3,6,3,给分真心好，讲的也不错
2932,609,陈小英,2015-05-11 09:39:18,7,23,16,老师讲课很风趣
3066,609,陈小英,2015-05-21 02:22:47,3,5,2,特别棒~\(≧▽≦)/~
3449,609,陈小英,2015-06-15 14:52:42,15,31,16,老师讲课很霸气，也很有意思，很棒的老师⊙▽⊙
3562,609,陈小英,2015-06-17 01:34:52,50,73,23,和陈老师出去不会挨欺负
4104,609,陈小英,2015-06-17 17:26:21,3,8,5,少数人刷分的乐园
4110,609,陈小英,2015-06-17 18:18:59,3,7,4,水
4139,609,陈小英,2017-09-20 23:20:44,12,29,17,给分好，课有趣，不过要高绩点需要你发点言
4316,609,陈小英,2015-06-19 03:08:17,43,64,21,老师法学出身，功底很扎实，其它知识比如财会也很丰富，老师人也很好不为难学生，给分好。认真听其实能学到很多法学知识。
5355,609,陈小英,2015-07-07 02:52:29,3,13,10,老师真的特别棒的那种！一定要选她的课！
6089,609,陈小英,2015-07-10 22:58:16,6,13,7,只是非常渊博 膜拜
6602,609,陈小英,2015-07-16 06:37:03,7,15,8,听了她的法学基础后爱上了哲学 感恩
6612,609,陈小英,2015-07-16 10:21:50,3,4,1,讲的很棒，知识很丰富。给分很厚道
8244,609,陈小英,2015-09-17 23:56:41,3,12,9,听课变成一种享受。
8264,609,陈小英,2015-09-18 01:56:02,3,10,7,陈老师好牛逼
8345,609,陈小英,2015-09-18 16:17:29,5,13,8,最理想的思政老师
8385,609,陈小英,2015-09-21 01:27:13,7,13,6,非常好
8737,609,陈小英,2015-09-25 03:11:34,5,13,8,好老师\n\n
13244,609,陈小英,2015-12-25 14:46:17,12,25,13,课上得好，人也好，多提问能加平时分
14030,609,陈小英,2016-01-04 01:39:09,4,4,0,666
17379,609,陈小英,2016-01-20 06:56:05,3,3,0,陈老师真的好厉害
17512,609,陈小英,2016-01-20 10:18:09,3,3,0,好好好
18769,609,陈小英,2016-01-22 13:19:45,7,13,6,虽然思修课还是蛮无聊的，但老师人很好，法学讲的不错，平常任务也少，给分也很好！
18793,609,陈小英,2016-01-22 14:19:23,6,17,11,辣鸡课  劳资啥也没学到
18800,609,陈小英,2016-01-22 14:32:20,7,12,5,很和蔼很温柔，永远笑呵呵，是真的想让我们有所思考，顺着老师的指点思考，生活会不一样哦
18801,609,陈小英,2016-01-22 14:33:02,3,4,1,超级超级棒的老师
18816,609,陈小英,2016-01-22 14:54:14,1,3,2,能把思修讲的这么好也是没谁了
18818,609,陈小英,2016-01-22 14:56:05,2,3,1,老师很好
18824,609,陈小英,2016-01-22 15:15:11,3,7,4,冷门大类活该被正态？？
18827,609,陈小英,2019-03-04 06:19:23,1,4,3,给分超级棒
18858,609,陈小英,2016-01-22 15:50:10,1,3,2,老师法律部分讲的很好很好，是真厉害，给分好，极好极好，上她的课很爽
18860,609,陈小英,2016-01-22 15:53:55,8,27,19,水水哒，分高高哒，只有一次秋学期小组作业(研究性学习)再加三篇不限字数的小作业，小组展示也不急，冬学期过了好久才展示的，棒啊啊啊啊啊
18939,609,陈小英,2016-01-22 23:52:19,2,3,1,见过最棒的老师之一。(^з^)
19009,609,陈小英,2016-01-26 16:06:02,2,4,2,庆幸自己这么幸运碰到了好老师。
19016,609,陈小英,2016-01-23 04:18:16,2,3,1,老师很好，给分也好！讲课功底一流！
19029,609,陈小英,2016-01-23 05:40:08,2,3,1,给分超好 教的好人也好
19099,609,陈小英,2016-01-23 09:03:00,2,3,1,人好，给分好。
19240,609,陈小英,2016-01-23 15:49:26,4,8,4,分数：9\n\n硬件：法学大牛\n\n软件：奶奶般的授课方式、体制内\n\n课堂：分小组，但坐后排基本不管你在干嘛；思修部分水，法基部分有干货\n\n给分：自认为比较良心
19246,609,陈小英,2016-01-23 16:02:42,2,3,1,谢谢陈老师
19764,609,陈小英,2016-01-25 08:53:36,3,5,2,功底深厚，很有气质的老师。
19822,609,陈小英,2016-01-25 10:30:44,5,13,8,讲课应该不错吧(没怎么听过)，给分挺好的，上课都是水过去的，代表小组做了次展示，最后4.5hhh
20045,609,陈小英,2016-01-26 02:56:41,1,2,1,完美的
20569,609,陈小英,2016-01-28 13:11:44,3,3,0,认真听陈老师的课收获很大啊特别是法学那一块，给分也是棒棒哒
20872,609,陈小英,2016-02-02 18:23:13,0,4,4,思修好老师，但满绩很难，她随便分的组导致我的组友水水的，平时我抱不到大腿
21259,609,陈小英,2016-02-27 15:12:12,0,2,2,给分好  人也好  不过课无聊  但……思修就这样
21415,609,陈小英,2016-02-28 15:58:52,0,6,6,老师人很好，尤其法律部分很精彩，给分挺好的，主要看队友(本队略坑)。上课还被老师抓到水手机两次，也是没谁了
21646,609,陈小英,2016-02-29 11:52:28,-1,4,5,抱大腿了（主要党性好），思修一直水，差点就4.8。老师很实在，很热情，案例讲的挺有意思
21817,609,陈小英,2016-03-01 07:19:26,0,2,2,很棒的老师！！！给分超级好！！！讲的也好…
22949,609,陈小英,2016-03-15 05:43:00,0,3,3,真的不是一般的棒！！
24866,609,陈小英,2016-05-04 05:51:38,0,3,3,必须满分
24886,609,陈小英,2016-05-04 08:21:21,0,2,2,很好的老师，上课会讲很多例子，给分也很赞
25103,609,陈小英,2016-05-05 09:15:39,1,3,2,给分很一般
25413,609,陈小英,2016-05-17 14:47:33,228,298,70,很水的一门课，每次的一二节都是给那些想加分的同学拿来提问的，第三节讲课。\n\n在这里，以我惨痛的教训提醒大家，攻略如下：\n\n1.认真听课没有用，你要做的是一去随便提个问，然后就可以无视老师，做自己的事了，下课记得去登记提问次数。（并没有那么多人诚实，你会发现很多没问的人也上去了，但如果你和答主原本一样诚实，请慎重）\n\n\n\n2.一定要问清楚最后报告非常具体的要求（如果你是补选的，第一节课错过了，不知道公邮，一定要厚脸皮去问）答主因为补选上的，第一节课没去。后来也尝试问过陈老师报告的要求，然而她回答得非常随便，答主也就没有再追问，最后成绩出来追问她，她又告诉我别的要求，excuse me?\n\n附带答主结局：按时上课，课后阅读了相关书籍，认真完成报告(但不知道那个非常具体的要求，根据大概要求写的)，最后绩点3.3，排在正态95％以外。尤其回忆到交报告那天，有个同学只交了一张排版密密麻麻的纸作报告，那也就是说，最后我和他的成绩是一样的，我内心就很崩溃。\n\n唉～法学老师说“没有绝对公平，能做的只有按照程序来”\n\n然而，成绩是对一个学生学习成果、付出、取得收获的一个衡量。如果程序都有问题，谈什么合理？\n\n另者，调查处理中强调程序合法，回顾这门课，先不说加分过程可能出现的纰漏，对于报告的特殊要求，任课老师也未尽到多次强调的职责。\n\n如果，一个学生付出相当努力，也确实学得小有所成，却因为该任课不合理的评价体系而得一个很低的分数，试问这门课的成绩意义何在？\n\n再者，如果所有学生都去迎合这种老师的评价体系，循序我上面的两条建议去水一个高绩点，而学不到真东西这门课的意义有何在？\n\n难道就一定要让我们残酷的说，这也是一课——“这就是社会”？
33395,609,陈小英,2016-11-19 10:16:28,3,7,4,垃圾，超水
35416,609,陈小英,2016-11-24 02:31:32,0,2,2,超级棒噢
35547,609,陈小英,2017-01-16 13:57:24,0,2,2,很好。
35570,609,陈小英,2016-11-10 07:28:23,0,2,2,很有收获
35671,609,陈小英,2016-11-10 07:42:16,0,0,0,水水水
35782,609,陈小英,2016-11-10 08:08:17,0,2,2,很有趣的一门课，能学到蛮多东西的
35904,609,陈小英,2016-11-10 08:49:01,2,3,1,两个字，佩服
35914,609,陈小英,2016-11-10 08:51:53,1,2,1,挺好的，让我一个对法律无感的人对法律产生了浓厚的兴趣
36075,609,陈小英,2016-11-10 11:37:26,2,2,0,嗯，声音洪亮，讲得很好
36100,609,陈小英,2016-11-10 12:27:23,0,1,1,不会水课会爆炸
36126,609,陈小英,2016-11-10 13:12:58,1,2,1,很棒很亲切的老师。
36177,609,陈小英,2016-11-11 00:47:48,1,2,1,可以，最好多提问
36296,609,陈小英,2016-11-11 14:41:09,1,2,1,已经这么多人顶了，我就也打十分顶一下好了！
36313,609,陈小英,2016-11-11 15:41:09,1,2,1,内容很丰富，大多数是书本外的知识，老师真的很好哟~推荐。
36456,609,陈小英,2017-02-25 17:30:48,1,4,3,老师很棒很可爱
36515,609,陈小英,2016-11-19 16:18:04,0,1,1,hhh
37503,609,陈小英,2016-11-19 07:09:21,3,8,5,法学基础课其实没什么内容，基本就是问问题。。。事情少，给分不错，但是每次都要抢提问有点心累，还会有很多人明明没提问也去签
37513,609,陈小英,2016-11-19 08:10:45,4,5,1,虽然分也不低，但感觉与我的付出不符。
37519,609,陈小英,2016-11-21 01:15:42,2,4,2,如果你想水水过，就选法学基础吧，还能拿一个相对不错的绩点，如果你想认真上课拿个高绩点，建议还是洗洗睡吧
37524,609,陈小英,2017-01-17 03:51:00,0,2,2,上课水水哒\n\n给分棒棒哒\n\n任务少少哒
37553,609,陈小英,2016-12-09 03:04:56,2,4,2,给分好
37558,609,陈小英,2016-11-19 12:21:48,1,2,1,老师人很好，不点名。作业也少，一篇报告一篇不需格式的小论文。给分最后也很好……每节课都有问答和案例讲解
37629,609,陈小英,2016-11-20 01:23:36,0,1,1,老师上课会讲很多有用的基础法学知识，通过回答问题解决疑惑，作业就一篇读书报告一篇论文，上课发言，论文认真写，给分很好！
37652,609,陈小英,2016-11-20 02:46:48,-1,3,4,事情少，一个读书报告加一篇法学论文，给分不错……其实并不一定要提问的，感觉占的比重并不大，因为我没有提问过。当然，也没有去加过提问次数，也不是法学专业学生，也有4.5……重点还是认真写报告和论文吧?
37685,609,陈小英,2016-11-20 06:24:37,1,2,1,老师回答问题挺有意思的，认真写读书报告和期末论文就行，上课尽量能发言，有加分的，具体知识看自己兴趣学就好了
37686,609,陈小英,2016-11-20 06:30:16,1,2,1,感觉学到很多东西，生活上可以用法律保护自己
37690,609,陈小英,2016-11-20 08:04:02,15,29,14,老师人很好，我不太擅长发言，也不会作假去签发言次数，认真完成两篇论文分也不低。
37823,609,陈小英,2016-11-21 08:39:30,3,3,0,发言制度有待更新
37840,609,陈小英,2016-11-21 10:26:03,0,0,0,选两次上课坐到第一排问两个问题，读书报告和期末论文好好写轻轻松松4.5
37875,609,陈小英,2016-11-21 13:05:38,0,2,2,老师人真的很好，知识丰富，认真听的话收获很大，提出的问题都会尽力解答。提问也没什么，平时找点相关时事看下上课提两个问就可以了，这个小学期好像没有点名。给分挺好。
38165,609,陈小英,2016-11-25 06:24:09,1,2,1,老师人很好，平时问问题都会很认真地回答，虽然上课内容不多，但讲得不错，基本概念解释很清楚，是思路很清晰的人，给分也不错哦。
38507,609,陈小英,2016-12-07 08:39:47,1,2,1,真的推荐（很博学的一个老师 而且思想很前卫 可以一直水下去\n\n）
38856,609,陈小英,2016-12-19 14:53:50,0,1,1,无敌水
39411,609,陈小英,2016-12-22 13:29:16,0,1,1,很好很水
39641,609,陈小英,2016-12-26 11:25:15,1,2,1,给分很好，上课也很有意思，强推
39863,609,陈小英,2016-12-28 04:59:31,3,7,4,上课水，不同意之前几位的绩点很高\n\n之前回答过两三个问题，读书报告和期末论文好好写，结果没上4
40554,609,陈小英,2017-01-04 04:38:05,3,4,1,上思修课 后半学期相当于法律基础！！强烈推荐！会讲她的不少精力和案例。事情少！
41171,609,陈小英,2017-09-20 23:28:15,-4,12,16,1分是没0分…超级难说话…课也没意思
43677,609,陈小英,2017-01-16 22:40:14,1,2,1,人好 给分好 太棒啦
43769,609,陈小英,2017-01-17 02:46:50,0,1,1,还不错的一个老师，虽然水了一个学期的思修
43809,609,陈小英,2018-09-20 00:08:02,37,47,10,讲课逼你睡觉，睡觉她还不让
43812,609,陈小英,2017-01-17 03:54:50,3,4,1,先是老早交了作业然后说我没交，然后又被正态了...
43826,609,陈小英,2017-01-17 04:32:37,0,3,3,点过一次名，讲课不错。然后可能还是课堂发言比较重要吧。
43884,609,陈小英,2017-01-17 05:30:54,8,16,8,布置的作业还好，小组展示＋个人作业三篇感想（没有字数，格式限制），上课发言有记录。给分好，上课一次发言都没有居然还给了我4.5，惊呆！
43890,609,陈小英,2017-01-17 05:43:50,4,6,2,老师人特别好，很体谅学生，思修的任务跟其他老师比真的少太多了，而且给分很好，上课很有趣，知道很多人选不上法学基础就在思修课上讲了很多法律的知识，专业功底很深厚，教学理念也一点都不古板，非常喜欢陈老师！！
43908,609,陈小英,2017-01-17 06:07:41,1,2,1,陈老师人很好，讲课很有意思，给分也好
44003,609,陈小英,2017-01-17 07:51:03,7,10,3,特别好的老师，法学知识绝对深厚，而且还看各种小说！！！给分儿挺好的，只有一个研究性作业与三篇个人心得，对于思修来说已经很少了，老师已经尽力在减少作业了
44179,609,陈小英,2017-01-20 01:27:57,1,2,1,作业少，给分好，干货多，最后看均绩你就知道该不该选了∩_∩
44240,609,陈小英,2017-01-17 12:48:49,3,5,2,思修这种思政课大家自己没兴趣不能怪考试 老师很棒 上课认真听还是很有收获的 作业的话三次个人作业 和别的读书笔记比起来比较少 但是其实写的字数是差不多的 但是不限主题真的很棒 然后上课很多人会为了平时分刷发言 但是内向的同学也不要方 一次都没发言作业认真写 考前浏览了一次书最后4.5 思修这门课 主要还是 看 三 观
44377,609,陈小英,2017-01-17 16:34:20,1,2,1,开心啊
44379,609,陈小英,2017-01-17 16:41:56,0,1,1,棒呆 从没想过思修绩点破4.5  耶\n\n\n\n
44430,609,陈小英,2017-01-17 23:41:07,1,2,1,给！分！超！好！
44517,609,陈小英,2017-01-18 02:17:59,0,1,1,给分很不错
45037,609,陈小英,2017-01-20 05:30:32,4,6,2,不点名的时候我兢兢业业每次到点名恰巧就迟到了哎\n\n
46060,609,陈小英,2017-01-20 14:03:22,1,1,0,给分赞
46151,609,陈小英,2017-01-20 17:45:55,5,6,1,思修课\n\n【课程作业】小组作业（秋学期一次调研并在冬学期展示，冬学期一次公益实践只求心安）、个人作业（三篇不限字数不限主题只记录成长）\n\n【课程体验】有两节课关于法律的部分认真听过，多数课上只听过了有趣的案例，大多数时间划水玩手机\n\n【课程付出】小组中不是组长但是付出了很多心力，大家也都看在眼里；三次个人作业倒是反思整理的聚集，内容构思了很久，用了三个小时打字，评论每篇1200字；爱课网12月中旬才注册了帐号，看过头尾两段不知道有没有帮助（成绩上的），但是视频课确实给人启发，讲新生适应的确实早看为好；考试前刷了三个小时900道选择，碰到了为数不多的原题，不超过十个。\n\n【课程收获】一般，可能我自己太水，小组合作太不成形，全靠我们组一位大佬最后刷夜丰富了论文、重做了PPT、做了很充实生动的现场展示，团队合作的能力没有具体提升，仅仅意识到了这个问题；听老师分享记了几本书名还从没看过\n\n【绩点4.2】过程中发言一次，个人作业按时提交三篇（多交也只记三篇），不知道组长给了我多少评分和小组作业其他组给我们的评分。总成绩87.\n\n
47845,609,陈小英,2017-02-26 08:13:22,1,1,0,讲真上课偶尔听听，大部分在干别的事情，回答过一次问题，其他按老师要求完成报告啊小组合作什么的，最后考试就很简单啊，反正我觉得老师给分真的很好。我是感恩的有4.5、可能期末政治功底还蛮重要的。
49576,609,陈小英,2019-01-08 16:08:37,10,17,7,바이두 긁지 말고 직접쓰면 4.0은 넘는거 같습니다. 긁으면 2점대 입니다
49716,609,陈小英,2017-04-24 15:40:40,-1,0,1,给分\n\n太好！！！！！！！！！！！！
49729,609,陈小英,2017-04-25 02:34:06,0,0,0,上课水，要提问题，报告什么的随便写的，最后89
49789,609,陈小英,2017-04-26 04:46:08,4,6,2,【法学基础】给分好老师，点过一次名。\n\n一二节课主动提问，第三节课认真听讲，读书报告好好写，最后有一篇关于法学的论文。我4.5
51167,609,陈小英,2017-05-21 15:59:58,2,2,0,讲得很好。
59321,609,陈小英,2017-09-21 01:28:16,0,2,2,一个耿直的如郑强的老师 心理很年轻 幽默\n\n
59331,609,陈小英,2017-09-21 02:22:20,1,2,1,哈哈哈\n\n
59476,609,陈小英,2017-09-29 00:37:11,0,2,2,给九分只是因为老师比较好，否则就这种政治课谁喜欢上。\n\n
59494,609,陈小英,2017-09-22 02:21:26,2,2,0,哈哈哈
61068,609,陈小英,2017-11-12 14:37:14,-1,1,2,很好，很好
63785,609,陈小英,2018-01-24 15:18:21,-22,0,22,翘课三次居然4.2?老师也太nice了吧
64475,609,陈小英,2017-12-24 10:57:45,-3,1,4,不组织参加活动，别人去实地参观我们就没去，没意思。
65123,609,陈小英,2017-12-29 03:57:19,-4,0,4,这怕是任务最少的思修老师了
65514,609,陈小英,2018-01-18 05:35:56,-3,0,3,超级棒
67005,609,陈小英,2018-01-20 00:32:55,-3,1,4,老师很和蔼，人巨好，问的问题都会给你耐心解答，又负责，不给10分给几分？
67188,609,陈小英,2018-01-24 14:14:24,-5,1,6,思修，绩点高到令人惊讶。不知是我的党性好，还是平时分高。
67497,609,陈小英,2018-01-21 10:52:32,3,3,0,哎，提问加分这个不太完善啊，
67884,609,陈小英,2018-01-22 08:46:24,0,1,1,上课你可以选择做作业，老师不会管，你也可以选择听课，老师讲法律知识讲得很好?
68956,609,陈小英,2018-01-24 07:04:46,0,1,1,给分很好，回答问题比较照顾女生，上课超水，事不多。
68962,609,陈小英,2018-01-24 07:18:03,-2,2,4,不错，上课玩手机被拍下来还有4.5\n\n
68967,609,陈小英,2018-01-24 07:20:07,0,2,2,老师超级好，人见识特别广，给分也超级好，是最理想的思政课老师了，爱老师！( •̀∀•́ )
69000,609,陈小英,2018-01-24 07:37:52,4,5,1,上课认真听也积极提问，小组任务也积极完成结果也只有3.3何必呢
69077,609,陈小英,2018-01-24 08:03:38,-2,0,2,话不多说，大爱小英老师
69080,609,陈小英,2018-01-24 08:03:58,-2,1,3,任务少: 3篇+(上不封顶)的感想 字数不限，一次小组展示。\n\n给分好:平时要积极发言 考试靠三观和常识\n\n我最后4.5
69084,609,陈小英,2018-01-24 08:04:38,0,1,1,老师是一名很有经验的律师，在讲法律相关方面时会很详细，上课和同学交流也很多，事情比较少，给分也很好
69095,609,陈小英,2018-01-24 08:18:11,0,1,1,给分好
69096,609,陈小英,2018-01-24 08:18:31,0,2,2,给分太好了，选吧选吧
69113,609,陈小英,2018-01-24 08:39:45,0,2,2,思修1、只有秋学期一次小组调查作业，外加三篇不限字数小作业。\n\n2、上课需要提问或者回答问题，课后去登记名字。\n\n3、上课可以认真听也可以不认真听，但老师多少还是会管一管不听课的同学。\n\n4、期末刷一刷题就好了，考试主观题三选二，多写点高分。平时背了书期末可能会轻松一点，但没有多大作用。\n\n5、偶尔点名，有时也会自己签到，但别帮别人签到，人数不对老师会很生气。\n\n6、老师学法律的，法律知识非常强大，上课不会很无聊。
69148,609,陈小英,2018-01-24 09:01:25,0,1,1,老师给分很好，就是课程本身比较水，不怪老师
69154,609,陈小英,2018-01-24 09:05:50,-9,1,10,老师很风趣，课堂很活泼，水水对绩点影响不大，不过认真听也很有意思呀！不过最后卡绩4.5，大概是问题问的太少了。鄙视那些不问问题却打钩的银！自觉抵制骗活跃度！
69197,609,陈小英,2018-01-25 01:10:19,3,4,1,莫名奇妙，正事全干了，还上课回答过问题，思修题库也做了，3.3？Are you kidding？
69204,609,陈小英,2018-01-24 10:06:36,-7,1,8,陈老师，奶奶一般的教导！超耐心，知识也超级丰富，每次回答同学问题都特别细心！而且绩点也非常好！谢谢陈老师！\n\n感觉和陈老师出去不会被欺负
69213,609,陈小英,2018-01-24 10:17:08,-2,0,2,给分真的好
69228,609,陈小英,2018-01-24 10:32:15,4,6,2,不知道发生了什么只有3.3?和想象中不一样。。也许是期末考太垃圾了？
69254,609,陈小英,2018-01-24 11:13:30,4,6,2,莫名其妙给了3.3，小组展示好好弄个人三篇文章也好好写了。。。。怕是期末考爆炸了
69255,609,陈小英,2018-01-24 11:14:21,-3,0,3,作业比较少，给分也不错
69260,609,陈小英,2018-01-24 11:27:04,6,9,3,3.3分不懂为啥。作文早就完成了，小组展示也很好，上课也发言过，期末考试也复习刷过题。真的不太明白分是怎么给的。
69293,609,陈小英,2018-01-24 12:15:00,-1,0,1,人好，课好，给分好，就是好~
69330,609,陈小英,2018-01-24 13:06:33,3,6,3,没发过一次言，期末4.5，认真完成，内向的同学也是能够高分的。
69514,609,陈小英,2018-01-25 01:59:03,0,0,0,老师上课上得很好，上课积极发言的话给分也很好。
69683,609,陈小英,2018-01-25 08:08:52,0,0,0,非常好
70262,609,陈小英,2018-01-26 10:13:14,0,1,1,事少给分好 快选快选
70346,609,陈小英,2018-01-26 13:25:24,-2,1,3,思修老师很有水平，讲课能吸引人，很风趣，给分很好，鄙人4.5哈哈哈，虽然被卡绩，但还可以。
70386,609,陈小英,2018-01-26 14:22:49,0,0,0,老师给分超好的 法律知识很渊博呐
70752,609,陈小英,2018-01-27 13:07:28,-3,0,3,事少，分高，法律部分有干货，值得听，老师人也很好。不过一定要记得公邮，仔细看公邮里面的作业要求（本来也不多）。
74186,609,陈小英,2018-02-06 09:02:27,0,0,0,比较轻松，思修要及时查看公邮里的作业通知，小组作业认真完成，考试的时候多写一点，最好多发言，少发也没什么大问题（比如我），给分很好
74776,609,陈小英,2018-03-06 01:16:51,-5,0,5,温文尔雅，娓娓道来
75816,609,陈小英,2018-03-19 05:53:39,1,1,0,不对啊，法学基础怎么半学期了一直在上思修的内容？
76445,609,陈小英,2018-04-09 11:52:52,0,0,0,
76790,609,陈小英,2018-04-23 12:07:01,1,1,0,不下课也不提早下课
76799,609,陈小英,2018-04-23 13:31:28,0,0,0,讲得很好 收获很大
77158,609,陈小英,2018-05-03 08:19:51,0,1,1,法学基础每学期点一次名，这学期开始不算发言平时分，讲课很好。但是我可能因为点名那天有事迟到了会儿，就卡绩点了……85分
77216,609,陈小英,2018-05-04 01:54:57,6,7,1,讲的很差 …
77229,609,陈小英,2018-05-04 04:22:25,-2,0,2,还是很不错的，讲课很有意思，作业也不多，分数还好
77280,609,陈小英,2018-05-04 10:05:37,0,0,0,讲的不知道怎么样，没好好听过，可以水过去，适合想水水作业的同学吧。只有两个论文。给分也ok。
77295,609,陈小英,2018-05-04 11:49:08,0,0,0,给分不是很好，上课没听过，两篇论文自己看着办
77438,609,陈小英,2018-05-05 14:29:08,-2,0,2,非常棒的体验，给分也很好
77467,609,陈小英,2018-05-06 01:28:10,5,5,0,课很水，上课打瞌睡，事多，体验不好
87379,609,陈小英,2018-09-28 01:06:07,7,8,1,为什么不下课？？？？？
87555,609,陈小英,2018-10-05 06:32:32,0,0,0,好好好
88163,609,陈小英,2018-10-23 07:36:45,0,0,0,明年要毕业了来写一下，从大一到现在我一直没忘的两个事例是她讲的，一个是思考许久得出生命无意义坚决地寻死的学长，另一个是在山路上被男友杀死的学姐，生命都还年轻鲜活，却走到了终点
91800,609,陈小英,2018-12-20 12:10:46,0,1,1,不好意思 我吴行健满了\n\n
93491,609,陈小英,2019-01-10 04:22:46,0,2,2,老师讲的内容很有趣，喜欢听的人当然可以认真听，想要做作业当然老师也不管你hhh。老师人特别特别好，可以在上过来这么多门课里，思修是我最喜欢也最轻松的课。但是期末复习当然自己就要更努力啦hhh，老师上课的内容和期末可能有关，但确实实用性没那么大，最终还是靠自己看书刷题叭。
94428,609,陈小英,2019-01-16 12:10:35,10,16,6,感觉这个老师有时候讲话就不是很尊重学生 管的比高中老师还多 一点都不会变通 很死板 比如迟到一分钟也硬要给你记迟到 很记仇的一个老师 斤斤计较
94972,609,陈小英,2019-01-18 14:04:25,1,1,0,基本不讲教材内容，感觉还可以，能学到一点东西。
95452,609,陈小英,2019-01-19 16:18:06,5,6,1,绩杀，给分不合理
95500,609,陈小英,2019-01-19 13:13:24,-1,1,2,老师讲的不错，有的案例挺有意思的，也会联系时事，但是上课也没怎么认真听，也没发过言，可能是读书报告或者志愿者报告还行，给分很不错，非常满意
95514,609,陈小英,2019-01-19 13:36:12,2,4,2,吹爆!!!!!\n\n上学期思修棒棒哒\n\n下学期还选小英老师的法学基础!!!
95547,609,陈小英,2019-01-19 14:42:40,6,7,1,凭什么认真听讲回答问题的人最后成绩不如一直水的人，对哦，这是随机给分的思修课
95823,609,陈小英,2019-01-20 06:00:08,4,4,0,水课，不怎么样。就是被卡绩点了，很难受。\n\n我觉得水课就该有个水课的样子吧！
95824,609,陈小英,2019-01-20 06:00:08,-7,0,7,水水也可以拿高绩点
95844,609,陈小英,2019-01-20 06:18:35,1,3,2,真的很水，可以自己干自己的事，上课没回答过问题，就交了两次小纸条，一个读书报告，一个志愿报告，志愿报告还迟交了，小组展示分数全班中下，还要4.2超开心。但是要记着那些作业的时间，老师不会提醒的，而迟交了就记迟交的。\n\n我觉得老师思想很正，每次我觉得没什么道理没什么好讲的东西，老师就能列出很多理由，还很让人信服，可能这就是思修老师吧。。。
95849,609,陈小英,2019-01-20 06:22:16,-4,2,6,老师的法律素养很高 虽然课很水老师是很好的 大家都说发言很重要 其实认真写读书报告完成实践活动志愿活动分数是不会低的 我没发过一次言最后也有4.8 真的感谢老师
95854,609,陈小英,2019-01-20 06:29:00,8,9,1,3.3
95878,609,陈小英,2019-01-20 11:58:53,0,2,2,老师三观很正，法学知识很渊博。平时读书报告志愿活动好好做成绩还是不错的，没发过言最后4.5飘过
95955,609,陈小英,2019-01-20 09:27:07,0,1,1,老师超好的，虽然课真的有点水，但这和老师没关系。课上的确有恶竞，各种瞎举手乱回答，但其实你回答次数少问题也不大的。只要好好写论文，好好参加小组研究，期末考试写的认真点，绩点就不会低的。(比如我上课就一次也没回答，但最后差一分4.8)
95997,609,陈小英,2019-01-20 10:51:55,0,2,2,老师很可爱，只要好好做平时作业，分数不会低的。
96018,609,陈小英,2019-01-20 11:31:05,0,1,1,课水事少给分好，随机点名两堂课，展示不要迟到即可
96044,609,陈小英,2019-01-20 11:58:58,0,1,1,运气超好老师超棒给老师花花
96053,609,陈小英,2019-01-20 12:05:12,-1,0,1,事挺少的，只要按她的要求做了，给分会很好的。
96059,609,陈小英,2019-01-20 12:07:46,3,3,0,一定要注意交作业的时间，不是最后一节课，迟交了直接卡到3.3...这学期的均绩凉了。但是不犯这种错误，作为思修课还是可以了。就，一般般。
96065,609,陈小英,2019-01-20 12:13:16,57,72,15,好老师 我一学期一共就去上了3次课 期末得了3.3 平均一节课得1.1 值了！
96109,609,陈小英,2019-01-20 12:59:58,5,6,1,老师讲课还可以，三观很正。本以为是一个仁慈的老师。其实很严格。有一次查迟到堵在后门让同学写名字。但是给分很迷。我3.3直接把均绩拉了下来。除了一次专业面试没请假缺课了一次，上课发言了四五次，读书报告写的也不少，志愿活动总结也交了。考试三大页白纸全写满了。给老师发了邮件也要不回个解释。结果最后得分跟楼上那个一学期一共去了3次的同学一样。
96184,609,陈小英,2019-01-20 14:08:00,0,1,1,很有收获。考试不太好做。
96191,609,陈小英,2019-01-20 14:11:45,3,3,0,成功被正态，绩点3.0 平时少去了几次课 上课也没有回答过问题 作业认真做 考试空白的全部写满 研究性课题小组分数最高也没有任何卵用 打分很真的很迷
96197,609,陈小英,2019-01-20 14:17:11,4,5,1,常常点名 想水别选 睡过头旷课一次 其他作业全交 考试复习且写满 绩点3.3 均绩被拉死 苦啊
96198,609,陈小英,2019-01-20 14:17:23,0,0,0,老师很好很耐心 期末考试有点小难来着最好还是多看一下....
96237,609,陈小英,2019-01-20 14:48:13,2,3,1,思修，上课不发言，但是作业有认真完成，小组组长，真的做了很多付出很多，管理六七个人的小组真的很辛苦，期末感觉自己考的还过得去，绩点4.2 觉得和付出不对等...
96245,609,陈小英,2019-01-20 14:54:44,-5,0,5,嗯，最后绩点超过预期，平时发过两次言，考试前刷了一些选择题➕看书最后4.5。谢谢老师啦！虽然觉得自己思想深度不太够，平时也没怎么听过…但是还是很感谢啦
96279,609,陈小英,2019-01-20 16:05:41,0,2,2,老师真的真的人很好?！
96285,609,陈小英,2019-01-20 16:19:10,-2,0,2,老师的课很有趣，老师也很和蔼，给分也很好。上课要积极发言，考试认真对待，老师是真心好。
96418,609,陈小英,2019-01-21 02:53:32,-10,2,12,只要不旷课，作业按时交，最后分数就会很好的
96610,609,陈小英,2019-01-21 07:43:36,3,3,0,在一些事上确实没有强调，最后还是要自己负责的，当然，如果可以，换老师。
97038,609,陈小英,2019-01-21 15:11:24,-4,1,5,老是知识很丰富，课堂气氛也很好，给分也很赞?
97177,609,陈小英,2019-01-21 23:42:33,2,3,1,没感觉这门课意义在哪里
98266,609,陈小英,2019-01-23 08:53:24,-2,7,9,陈老师给分贼好，非常公道，某些人不来上课，还嫌3.3太低，真是醉了……老师上课干货很多，把思修这样一门水课讲的让人兴致勃勃
99337,609,陈小英,2019-01-24 15:02:49,21,25,4,有点不负责，绩杀?
99729,609,陈小英,2019-01-25 05:53:09,11,13,2,垃圾\n\n思修居然是我绩点最低的一门课\n\n也是服了\n\n
100196,609,陈小英,2019-01-25 20:02:06,-8,2,10,水到最后4.5，嘻嘻嘻，可能是小组作业被大佬带的吧。别的就不说了
102419,609,陈小英,2019-02-01 15:47:15,1,1,0,上课比较有深度，是个不错的老师，但是思修课上的发言自己登记实在太坑了，感觉缺乏公平
102912,609,陈小英,2019-02-25 02:50:34,8,8,0,呵呵，正态真好玩
103501,609,陈小英,2019-02-28 14:56:57,3,3,0,思修课上得很好，有关法律的部分讲的很完美。小组互评的算法有点问题，居然不去最高低分，成功被人钻了空子。
103639,609,陈小英,2019-03-03 08:53:02,10,11,1,丝毫感觉不到大学老师的风度。
103780,609,陈小英,2019-03-05 12:18:01,0,1,1,。。。。。
106867,609,陈小英,2019-04-30 05:43:11,-8,1,9,还挺好的，讲课其实不错的，上的法学基础，说的提问发言占20分，但没发言过，读书报告和小论文字数都在要求字数左右，两三千的样子...最后4.5 很满意啦
106887,609,陈小英,2019-04-30 07:03:55,4,9,5,上课是真的水，但也是真的?杀。认认真真花了两天，一天书评，一天论文，字数比要求的字数多了3倍，结果创造通识课绩点最低记录，而且卡?了，真难受，多4分可以多0.6个绩点。上学期一门都没卡? ，这学期一下子卡两门。真是吔屎了，不知道这评分咋这么高的。。。
106906,609,陈小英,2019-04-30 07:58:20,2,3,1,法学基础：认真读书写报告，给分迷离
106958,609,陈小英,2019-04-30 12:18:25,-2,2,4,挺水的，给分还可以
106968,609,陈小英,2019-04-30 13:00:05,-8,2,10,事少给分好 （交论文的时候看见班里好多同学厚厚一沓 我字数刚到2000 都有点方 不过最后4.5 很满意了
106985,609,陈小英,2019-04-30 14:04:08,8,9,1,上课认真听了 读书报告和论文认真写了几天...不知道为什么3.9还卡?
107109,609,陈小英,2019-05-01 15:38:01,4,5,1,凭啥正正态我 论文写一万个字就一定是抄来的？我本来很喜欢您的speechless
107169,609,陈小英,2019-05-02 04:15:06,0,1,1,上课贼水，修一晚上的读书报告，加一晚上的小论文，最后4.2，适合上课不发言，喜欢水课的人
107212,609,陈小英,2019-05-02 09:15:38,4,4,0,哭了 给分不好啊…论文读书报告写的认认真真
107320,609,陈小英,2019-05-03 14:09:15,4,5,1,很怀疑老师是不是区分了什么是恶竞抄袭，什么是认真写读书报告论文的？不明就里的给分随意，说实话让真正认真的人有点寒心
107596,609,陈小英,2019-05-07 10:15:49,-7,4,11,这个老师可好了，不点名，随便水水就能满?。想知道为什么吗？不用恶竞字数，不用看质量，上课也不用参与，只需人品好，轻轻松松拿高分！强推！
108476,609,陈小英,2019-05-26 08:14:20,-1,2,3,老师讲的干货是真的多，请大家不要一味追求字数而没有自己的思考，即便没有抄袭也跟抄袭没区别了。
108851,609,陈小英,2019-06-03 07:20:03,-2,1,3,好啊好
115840,609,陈小英,2019-08-21 02:04:36,3,3,0,?? ?? ??
116429,609,陈小英,2019-09-10 12:22:05,-6,2,8,老师非常好！
116430,609,陈小英,2019-09-10 12:22:03,-4,3,7,老师非常好！
116431,609,陈小英,2019-09-10 12:22:03,-8,2,10,老师非常好！
118696,609,陈小英,2019-10-30 23:39:38,2,2,0,好好好
119681,609,陈小英,2019-11-15 00:19:35,5,5,0,老师上课及其催眠，讲的并不好，而且喜欢喷口水，我已经深受其害。
122312,609,陈小英,2020-02-24 03:34:57,25,28,3,浙江选考历史政治第一次就双满选手。每节课都去，点名也没错过。读书报告超认真写了，字数超了1000(本意不是恶竞，列好大纲精简了写完就这么多，致歉)，期末提早一周开始复习，考试自认为蛮简单，大题也条分缕析写得很满。但是，分到的那个小组除了我都是同班的，那个组长不知为何第一次见面就非常排斥我(真的很迷)，所以绩点3.3。出之前其他几门课均绩4.6。别问，问就瑞思拜。对了，组长是老师分配的。不当组长的话，慎选吧还是。但其实讲得也就很一般，上课反正没什么人听，思修就这样。但是绩杀到哭出来。
122339,609,陈小英,2020-02-24 12:16:53,10,11,1,发言制度莫名其妙，问了她自己也说不清。搞得钉钉群里面一堆人天天问些莫名其妙的问题，明明自己百度就能搞懂的问题还非要问出来让老师解答，不知道这个制度有什么存在的意义。还占20分，真的无语。上网课老师一直念ppt，听得想睡觉，没办法真的受不了。
122369,609,陈小英,2020-02-25 16:04:44,15,16,1,思修，组长，劝大家不要做看不见的努力。小组的研究报告我自己一个人改了一星期，语句的用词、逻辑，语句，整体结构，重新查了资料，补了论据，最后的报告我真的很自信是有深度有思考的。最后才知道，研究报告的分数完完全全是presentation同学互评的，同学们看热闹所以搞笑情景剧最高分呗，还被同研究主题同学恶意打低分了：）老师平时上课就是不用PPT自己讲，语调比较魔性。志愿者活动我找的，读书报告认认真真自己写的，期末考试认真复习了也很有把握，付出了很多心血最后3.3，唉。最后，不要迟到，管得很严。
122971,609,陈小英,2020-04-27 05:41:22,5,5,0,选的是法学基础。\n\n老师上课时讲话的语气可能会让人觉得不是很舒服，发言机制不太合理，因为网课嘛，只要登上去发个提问就溜就可以水分数，文不对题也没有关系……\n\n好处是不咋点名，作业只有一篇读书报告，只要求精读两三章，认真读好好写就行\n\n期末是一篇论文，2000字不多，但是要求不怎么明确，可能影响评分吧\n\n最后我4.2，主要是发言少
124047,609,陈小英,2020-06-22 08:54:15,-10,1,11,思修，给分还是不错的
127119,609,陈小英,2020-11-09 06:16:47,20,22,2,思修单单听课来讲，不喜欢老师，没有大学老师的风度和格局。
127252,609,陈小英,2020-11-17 07:13:59,14,14,0,点名很多
128570,609,陈小英,2020-12-24 04:19:13,14,16,2,死板右右人
130690,609,陈小英,2021-01-24 08:04:02,23,25,2,笑死我了 见过最无语最绝情的老师了 钉钉最爱的就是已读不回 每节课都点名 别选她好吗 姐妹兄弟们 她的分是怎么这么高的？
131732,609,陈小英,2021-01-28 15:28:26,7,8,1,就不知道之前分怎么那么高的。平时分低的离谱
131733,609,陈小英,2021-01-28 15:37:57,3,3,0,被卡绩了，气死我了
131734,609,陈小英,2021-01-28 15:40:25,4,5,1,79完美卡3.3
131738,609,陈小英,2021-01-28 16:01:55,10,11,1,上的思修，不知道为什么之前评分那么高，可能给分好？反正我没感觉到。说说我上她的课的体验吧：1.每节课都会点名2.很死板，不太体谅学生，作业截止时间之前不会提醒学生，也不让补交，所以上她的课，必须记好各种ddl（划重点），不然没法补救。3.钉钉经常已读不回，有什么问题，和她解释，她是不会通融的。总之，我不推荐这个老师，如果上她的课，也不用太担心，每节课都去，作业记好ddl，不理会她的阴阳怪气，可能还是不错的。
131741,609,陈小英,2021-01-28 16:14:57,-1,1,2,分不低，就是卡绩了，85分3.9就很难受。老师人不错，我几乎不回答问题，有两次回答也没登记。讲课还是蛮有意思的，卡绩有点难受(也许因为两次回答没登记的缘故？不过老师那时也没提醒。。。）所以打了九分
131745,609,陈小英,2021-01-28 17:13:19,19,21,2,节节课点名不说，这是我见过最死板，最不通人情，最一根筋的老师。ddl之前从不提醒，仿佛就在ddl上蹲好了，超一秒钟算一个。年底期末事情多，大意错过提交或者其他电脑原因造成的提交失败，对于一次作业来说，真的这么不值得原谅吗。求情数小时丝毫不接受不开放补交，也许这就是 北大法学 吧。对于思修这门课而言，只要能多帮学生考虑考虑，理解学生的难处，就足够成为学生心目中的好老师了。不知道老师都快退休了还这样 死板，图个啥。。。
131915,609,陈小英,2021-01-29 09:56:05,4,7,3,1.每节课浙大钉签到（我都在宿舍签的）\n\n2.pre纯看小组互评，不太合理\n\n3.ddl限制很严，晚一秒都不行\n\n4.老师人还可以的
132813,609,陈小英,2021-02-03 23:42:09,-2,1,3,每节课都得点名，作业ddl要记好，给分还行
133507,609,陈小英,2021-03-01 11:05:17,-1,2,3,老师讲课水平可以，干货很多（在我看来）。但是给分确实有问题，不太合理。
133684,609,陈小英,2021-03-03 17:24:08,7,7,0,垃圾ddl
133840,609,陈小英,2021-04-15 05:47:53,10,10,0,我觉得死板
134099,609,陈小英,2021-03-16 02:58:31,7,8,1,无语，真的无语
134283,609,陈小英,2021-03-23 01:11:16,10,10,0,yygq第一人
135024,609,陈小英,2021-04-27 09:23:01,6,8,2,我给老师打十分，因为她在第一个学期让我知道了ddl的恐怖可怕，我现在通识课都是提着脑袋赶ddl，怕再碰上一个陈老师，最后思修没挂，2.7，哈哈哈哈老师超催眠，我在角落里偏安一隅地睡觉，时而听听觉得老师说得蛮有道理的
135243,609,陈小英,2021-05-06 17:26:51,4,5,1,奇差无比
135251,609,陈小英,2021-05-07 00:47:24,2,4,2,呵呵，这么认真上课写作业，就给这么一点好意思吗
135252,609,陈小英,2021-05-07 01:03:07,0,2,2,上的法学基础\n\n每节课都会点名，老师对不来的同学抓的很严，特别是最后一节课。作业是一篇1500+的读书笔记，期末有一篇2000+的论文。感觉老师给分很不错~论文写的很不好，但是每节课都去，最后4.2。
137019,609,陈小英,2021-06-29 12:21:00,-10,1,11,陈小英我的女神，法律基础牛牛牛
137527,609,陈小英,2021-07-05 02:56:54,14,19,5,上陈老师的思修，体验较为一般。老师人还不错，但是给分机制说实话我不是很懂。有一次课生病了跟老师请假没有批，后来又去找老师说明原因、求情，最后还是被记了旷课。小组展示要是摊上不负责的组员真的很难顶。认真写书评、做小组作业，最后不知道是因为哪一项出了问题，绩点只有3.3，有点小难过…
138025,609,陈小英,2021-07-07 05:46:02,0,5,5,老师讲的东西认真听的话会学到很多，千万不要错过ddl!!!
141860,609,陈小英,2021-10-28 03:11:39,-13,1,14,绝对女神！讲话风趣，并且干货很多，尤其有很多贴合生活的道理什么的
142502,609,陈小英,2021-11-12 09:39:45,-9,2,11,老师很好，问她问题秒回
143866,609,陈小英,2021-12-09 08:49:21,5,5,0,就一节课请个假给我整那么多手续破事，真闲的
144615,609,陈小英,2021-12-22 17:02:52,7,9,2,给分真的不行，事情也很多，每节课点名
144800,609,陈小英,2022-01-13 00:31:03,18,20,2,事情多，给分差
145196,609,陈小英,2021-12-28 07:11:28,4,4,0,老师比较注重上课发言，占比也挺高的，对于像我这种不太擅长发言的同学可能不太友好，小组作业还是看组员吧，估计我要被正态了
145465,609,陈小英,2021-12-30 01:12:10,1,1,0,法学基础事少分高
145788,609,陈小英,2022-01-02 09:51:51,17,18,1,每节课都点名，一个学期下来没有学到实质性的东西\n\n像大部分同学一样，没发言过\n\n估计要被正态了
147299,609,陈小英,2022-01-09 12:28:51,3,3,0,法学基础\n\n事少 每节课固定课前雷达点名但课可以划 一篇读书报告（1500-3500字）一篇论文（>2000）无期末考\n\n想学也可以认真听课 老师上课方式是讲的同时同学可以自由提问提多少都没关系
147794,609,陈小英,2022-01-11 01:01:34,2,4,2,点名实在太狠了
147800,609,陈小英,2022-01-11 01:12:30,1,7,6,思修，必点名，上课还行，可也看出老师自身知识渊博，给分还行
147828,609,陈小英,2022-01-11 03:11:17,5,6,1,上课讲自己的传奇故事的传奇老师
147853,609,陈小英,2022-01-11 05:33:13,11,11,0,无聊，给分太差
147888,609,陈小英,2022-01-11 05:54:50,-11,1,12,给分好嗷
147910,609,陈小英,2022-01-11 06:56:14,0,4,4,我上了陈老师的法学基础和思修，思修课坐在前排，老师讲课其实知识还蛮丰富的，不读PPT，就是聊天。关于思修也有一定的不合理之处，比如小组互评，就有其他小组把分数全都往低了大，我也很无奈。但法学基础比起思修课，说老实话，就水了很多也无聊很多，有点到，读书报告和论文，感觉没花多少时间，给分还不错。
148106,609,陈小英,2022-01-11 13:39:36,-13,3,16,从陈老师口中得知，她思修的打分上限是4.5，最后思修4.5，也算是很满意啦~
148675,609,陈小英,2022-01-13 07:47:52,33,34,1,【思想道德与法治】\n\n陈小英，第一节课会将她是海子的同学、李克强的校友，让你感觉“whoa还不错诶”，但是千万不要被迷惑，浙大比她好的思修老师多了去了，清北出身的优秀老师真的很多，也没有几个真的上课就是来炫耀自己的学历的。\n\n她的课堂仿佛从未备课的茶话会，时长不够就放慢语速，或者simply随便多提几个脑残问题让同学们回答。\n\n正常来说，最后一节课老师们都会稍微讲些期末考的注意事项或者发些参考的公众号文章，或者划些重点，而她“好的你们要记得在学在浙大上给我评分哦……教材的评分也是算在我头上的……你们对学校的意见也是算在我头上的……那么我们这学期的课就草草收尾吧”\n\n虽说划重点对于思修考试来说真barely makes any difference，但是就这态度，我很难认同这位老师。\n\n如果你的思修是大一预置的，请千万不要因为她的评分“也还过得去”，就因为惰性不把她的课退了重选，到了期末你就会知道，当你每节课都点到了，也适当举手回答问题了，读书报告认真写了，小组作业踏实做了，而只收获到一个3.9，而看到其他同学匿名发帖“上课不听，也没提问4.5”的感觉有多难受。3.9其实也不能算真正意义上一个很低的绩点，但是相比之下，你觉得你是努力了拿到3.9，而别人可以躺平拿到4.5，而你对这个成绩无能为力，也无从下手的委屈真的不好受，这时候就会想要时间倒流，回到大一选课的时候，把她的课狠狠退了。
148924,609,陈小英,2022-01-14 03:20:17,17,17,0,确实，楼下说的非常在理！一个不体谅学生、不与学生共情&换位思考的老师也许未必是一位坏老师，但也很难称之为好老师！大一的思修课、也是第一门思政课到这里就“草草结束”了，现在只记得我自己肝的居多的锅，然而老师是怎么样的几乎都忘掉了。现在回想起来，这门课给我的收货也许仅有如何肝锅罢了......（来自一个有一群牛马组员的苦逼组长）
149702,609,陈小英,2022-01-16 14:01:33,28,28,0,不建议选这个老师，建议选梁清华老师，那个班分数都奇高，我感觉我思修卷飞起来，才一点点绩点，而我的同学在梁老师那里直接拿了4.8你说这谁心里舒服？？\n\n我打开查老师一看发现大家早就骂起来了。意料之外，情理之中。\n\n陈老师的给分机制是有问题的。\n\n小组作业是互评的，你觉得这个评分合理吗？让学生自己互相评，分数会高吗？难免故意打低分吧？感觉老师就是想省事。\n\n而且啊小组分数是直接组员均分。思修本来是摆烂专区，组员很多都是摆烂。我自己是组长，基本活都是我自己在做，小组展示基本我一个人在弄，包括志愿者活动全是我自己组织的。喔，最后和组里很多人一样拿平均的分数，我哼哧哼哧干了一大堆活，最后按照这样的评分机制。真的心凉！！！\n\n不过有几个组员确实蛮不错，干活很积极。就是真便宜了那些摆烂的组员。\n\n而且不调分的。不管你上课多么积极，顶多给你课堂表现分打高一些。什么其他分数她不动的。\n\n血的教训，不建议选，已经帮学弟学妹避雷了，别再来了
150914,609,陈小英,2022-02-21 04:56:00,21,23,2,壁垒壁垒速速壁垒 所有作业都认真做了每节课都到了上课发言也好几次了读书报告究极无敌认真写了小组作业评分也不低结果只有3.3\n\n事后我很礼貌地去询问了老师 结果已读不回\n\n我承认比我优秀的人很多但是我还是会不甘心只拿到这么点分数
151611,609,陈小英,2022-03-09 11:01:28,6,6,0,呵呵呵
160675,609,陈小英,2022-09-30 03:38:28,14,14,0,思政课拖什么堂啊啊啊啊啊
163177,609,陈小英,2022-12-09 03:19:52,9,10,1,网课截图
164136,609,陈小英,2022-12-18 10:16:53,15,15,0,节节课雷达签到 蠢货一个 思修拖堂二十分钟 蠢货
164151,609,陈小英,2023-01-13 13:10:06,15,16,1,天天点名，回答冷淡，事情又多，突然看到评论，知道八成凉凉咯\n\n\n\n追评:3.3，感谢老师不挂之恩（另外xdm能讲一下你们的分嘛，给后面学弟学妹壁垒，也让我看看大家分。。。
164838,609,陈小英,2022-12-26 14:19:01,7,9,2,事多，讲得无聊，很要求课堂发言，网课自己操作问题一直怪同学
165697,609,陈小英,2023-01-13 09:33:28,22,22,0,常年已读不回阴阳怪气 蠢货\n\n什么都做了还是被杀 纯纯脑瘫吗这不是\n\n话说她是不是买了分 这么蠢为什么还有9分 后面的学弟学妹别被买的分骗了
166210,609,陈小英,2023-01-11 12:09:52,4,5,1,just soso，可能是思政课普遍存在的问题
166397,609,陈小英,2023-01-12 07:10:22,16,16,0,速速壁垒！
166432,609,陈小英,2023-01-14 14:30:24,25,27,2,壁垒，除非你能忍受以下问题：\n\n1、每节课都点名，一次点不上扣总评5分\n\n2、读书报告查重并给重复率高的0分，使你大一就有机会挂科（不算很严，至少我是缝合的没被挂）\n\n3、讲课内容空洞无物并且拼命鼓励发言鹅颈\n\n4、拖堂，这学期最多一次好像有20分钟\n\n5、小组展示只看互评（就会被恶意评分）并且整个小组平均给分（干多干少一个样）\n\n6、给分烂，据说最高4.5（毕竟有如此离谱的给分标准又不调分）（被证明是错误的，有4.8的）\n\n7、志愿服务是强制整个小组一起完成的（但是不需要提供证明，也就是说摆拍几张照片也没问题）\n\n已读不回倒是没体验过，大概10月问过一次志愿服务作业要求，回复还是比较及时和耐心的\n\n--------------------------------\n\n据说这人快退休了，希望是真的，别祸害学弟学妹，有预置到她的思修课的建议退课重选，这老师说他心理变态一点都不过分\n\n也不知道为什么这么久不出分，又不捞人，不会忙着查重吧😓\n\n--------------------------------\n\n出分之后倒是还行，至少我所知的课友都不错，好几个4.5的，看来是大捞特捞了，不过鉴于以上已经写的，还是不建议选这门课
166445,609,陈小英,2023-01-12 09:31:43,18,18,0,22级上思修来答一波，老师是封建式教学的典范，会在课堂上强调玩手机的纪律，也会在短时间的10分钟内进行签到，其效果便如同小学强调纪律的老师管理学生一般，其他如强调思修报告查重的事情也的确属实。客观上来说是老一辈（较为顽固的那种）的思想，没必要强调老师是对学生不好那种，但的确不应该在思修这门课上强调顽固不化的东西。思修所要教育我们的应该通过课堂言传身教来实现，而不是这些条条框框的规矩。给分未出，个人感觉不会好，不推荐。
166470,609,陈小英,2023-01-12 10:32:53,15,15,0,她的思修是我这学期上过最烂的一门课
166494,609,陈小英,2023-01-12 11:23:21,12,13,1,思修预置到她你就等死吧
166508,609,陈小英,2023-01-12 12:52:13,9,10,1,节节点名\n\n要上课卷发言，玩手机还会被教育\n\n已读不回\n\n壁垒壁垒
166513,609,陈小英,2023-01-12 13:19:48,7,8,1,救命，怎么还不出分 。。。。。。\n\n我求求了希望给分最高4.5是假的......这样的给分真的会让同学们很心寒的
166699,609,陈小英,2023-01-13 09:18:30,18,20,2,奉劝学弟学妹们，壁垒壁垒！！\n\n每节课都点名，点不上总评扣5分，刚入学的小朋友如果不知道这什么概念的话，简单来说就是可以让你的绩点从4.5变成3.9\n\n上课内容难以形容，学期初我看她丝毫不涉及课本内容就问她期末考怎么准备，她就说之后会想办法的，结果一直没有，别的老师最后一节课基本都会划重点的吧，我最后靠着室友共享资料的\n\n鼓励发言，记录发言次数，说白了就是鼓励鹅颈\n\n小组研究报告搞小组互评，要是有哪个祸害人的组恶意差评怎么办？甚至多个呢？\n\n22年11月底校内疫情爆发后，对于志愿服务作业，我室友的老师都给了替代方案，可以写别的东西代替，她还是坚持要我们顶着疫情做，结果我最后被迫提前回家在家附近找志愿者活动（因为十二月初浙大校内和附近几乎没有志愿者了，我当时因为密接被拉去隔离错过了核酸检测志愿者活动）\n\n她自称绩点上限4.5，注意绩点的同学赶紧跑！！！！！不要跟我说什么4.5也很好，你能保证她给的4.5不会跟别的老师的5.0一样少？假设做着同样的事情，别的老师班的拿4.8你4.2你受得了？\n\n我就搞不清楚当初选课那会的9.3还是9.2怎么打出来的，害得我被误导了。现在已经跌到8.65了，算是开始回归正常\n\n反正别的课我不清楚，思修绝对不能选！！！！\n\n如果是不在乎绩点的同学的话，思修一个学期3000字读书报告(后来好像抽样查重了)+志愿服务作业+小组研究作业+上课不能缺勤迟到，自己看吧
166709,609,陈小英,2023-01-13 09:28:17,9,10,1,上课无聊经常点名，需要小组讨论派人上台发言，还会拖堂，体验感差。发消息已读不回。绩点最高4.5是假的，读书报告才写2800也有4.8，写出真实感受应该就好了。
166712,609,陈小英,2023-01-13 09:30:59,8,8,0,【思修】太死板，各种意义上的。学弟学妹们快跑
166716,609,陈小英,2023-01-13 09:46:54,10,12,2,寄，读书报告查重。\n\n不知道她的“大幅度抄袭引用”是什么标准，我怕我写的偏差太大就看了几篇论文，引用了并且标了出处。后来有点怕自爆了，并且一个上午重写了一篇4k字报告\n\n最后3.3\n\n平时上课积极发言，课后积极问问题，没有缺勤次次点到。真的服了还不如签到代签下算了还可以多睡好久www\n\n预制的不预制的都速速壁垒！！
166717,609,陈小英,2023-01-13 09:54:12,16,16,0,组长，事做了很多，作业认真做了，最后3.6
166728,609,陈小英,2023-01-13 10:31:40,8,8,0,给分太低了
166740,609,陈小英,2023-01-13 11:49:30,11,12,1,节节课爱点名，事情很多，而且这是一门你付出的不到回报课程，答主对此门迂腐死板的课程深恶痛绝，但是却得到一个不属于答主的分数——4.8，答主只求不挂就行，因此仅仅发过一次言，读书报告口水话连篇，志愿活动随意拼图，甚至还迟到过一次，在出分之前已经做好了迎接3.6的打算，这难道是由于我是在一个前四的小组吗？诚然，由于意外的分数让我窃喜不已。但是一门只求不挂去对待一门课程的人得到了一个不属于他的分数，我很难理解这门课程（思修）到底要教会我们什么，是告诉我们新时代应该具备的思想品德，还是你需要看到这个不公平的事实——你应该“投胎”到一个排名靠前的小组以获得一个较高的“平均分”？
166753,609,陈小英,2023-01-13 12:14:01,13,14,1,蚌埠住了，能发言都发言了，读书报告五千字，志愿服务70小时，一次都没缺勤，最后4.2，真是服了
166787,609,陈小英,2023-01-13 14:52:54,5,7,2,秋冬学期思修，本人发言1次，读书报告写了3408字，不是组长，志愿服务时长也不多，大概就十多个小时，高中选考了政治，期末考由于疫情是开卷打字六选四大题，感觉自己答题情况应该不错，每道题打的字数都挺多的，最后4.5，谢谢老师呜呜呜
166788,609,陈小英,2023-01-13 14:54:49,8,8,0,反正她快退休了，底下评论也都是骂她的，\n\n多的不说了，反正就是苦茶子扒下来了也得跑\n\n看着这么多骂的我就放心了
166794,609,陈小英,2023-01-13 15:19:50,2,8,6,4.5安全下车，感觉给分没有想象中差
166796,609,陈小英,2023-01-13 15:29:05,4,5,1,88-4.2，我的情况是差不多4次5次发言，所在小组的小组展示应该是最烂的，读书报告3500个人认为写得还可以，期末4道题两个小时敲键盘没有停下来过，虽然高中不选政治但应该答的还行。看了那么久关于老师的评价，真的抱着3.9就谢天谢地的心态，给了4.2真的还算满意了虽然就差1分就4.5。但能上4就真的很开心了。
166807,609,陈小英,2023-01-13 16:00:33,3,3,0,懂得都懂，一言难尽。
166808,609,陈小英,2023-01-13 16:16:09,5,5,0,上课拖泥带水  常年已读不回  评分机制诡异\n\n每节课都签到，下课会登记发言同学的名字，一些观点不敢苟同，讲课真的很没意思。\n\n学弟学妹们如果预置了她的思修建议能润则润，如果觉得麻烦的话可以参考下面意见。\n\n1.发言，然后赶你自己的事情。\n\n2.小组展示是同学互评，所以主题和形式都讨巧一点。\n\n3.期末考分点工整一些。（po没发过言绩点也还行，私以为是期末考的缘故）\n\n4.读书报告感觉老师比较偏好自己想法比较多的类型。据说会抽样查重。\n\n以上，祝满绩。（srds 她班上没见过满绩
166810,609,陈小英,2023-01-13 16:17:05,7,7,0,思修课堂还行，当故事听还算不错，干其他事情老师也没说，上了半学期开始发言，全勤，志愿者两小时，读书报告三千二，小组长比较给力，自认为期末发挥的不错，91，4.5，虽然卡了一档但是出乎意料的高。
166823,609,陈小英,2023-01-13 17:26:29,5,5,0,每节课固定点名，作业有着3000字的读书报告和小组调查作业和小组志愿作业，同时思修课上极其鼓励发言，只能说作为一门思修课，事情实在是太多了，非常不推荐选修这位老师的思修课\n\n补一下：绩点3.6
166828,609,陈小英,2023-01-14 00:35:37,10,10,0,22级来答一波，楼主上课没有发过一次言，志愿活动作业随意拼凑，读书报告算是好好写的吧，期末考试也算是认真抄书了，最后4.5，出乎意料。楼主想了一晚上没想明白，唯一的可能性是小组展示了，记得当时我们组展示完被cxy夸很好？。。。但是极其不推荐选这位老师
166841,609,陈小英,2023-01-14 01:24:17,8,9,1,4.8来报道，看到很多人说老师最高绩点是4.5，其实我非常担心，但是出分以后发现自己的分数还不错，很惊喜。\n\n本人除了第一节课的时候认真听了一下，其他课都没有听，上课也从来没有发言过，也不是小组长，我想我的分数可能是来源于读书报告和期末考。\n\n我读书报告写的还挺认真，我是抱着真正想要阅读这本书，而不是为了写读书报告而阅读这本书的心态去阅读，我在阅读的过程中会做笔记，简短记录每一章的内容和自己的一些想法，这样后面写读书报告会轻松一点。我的读书报告除了书本介绍的部分是百度百科上复制粘贴的，其他的内容全都是我自己写，写了3000多字，据说cxy会查重，所以读书报告要慎重对待。\n\n本人高中的时候选考了政治，并且学的不错。这次的期末考试因为疫情改到了线上，是开卷考，简直救我一命。虽然考试题目都是论述题，但是题目都不是很难，基本的原理在书上都可以找得到，只需要打字快一点，保证自己能在规定的时间内把所有想要答的内容打上去就好了\n\n总的来说，cxy的思修课上学不到多少有用的东西，如果预置是她，建议还是退选，去选别的老师吧
166846,609,陈小英,2023-01-14 02:02:47,5,5,0,堂堂点名 还提问
166979,609,陈小英,2023-01-14 12:58:55,3,4,1,卡绩 真的很绝
166994,609,陈小英,2023-01-14 13:38:10,8,9,1,cxy的思修课每堂都要点名（尤其早八被迫起床很难受\n\n作业方面有小组的调研报告+pre;小组的志愿活动（尽管后期因为疫情可以个人完成，但以后估计不会了[滑稽]；个人的读书报告；\n\n据cxy说读书报告会有查重，不过估计不太高应该没问题的（她说有人96%的查重[笑哭]；\n\n上课很水的，会提一个观点让想加分的同学去发言（本人做法是快速搜索之后上去发言，回来写代码（本学期几乎一半的PTA都是思修课上完成的[笑哭]\n\n不过实话实说，给分比较求是，4.5报道，朵朵上看到有4.8的（所以最高4.5应该是错误滴\n\n整体建议：上课还是要多发言，趁着大家都在思考的时候果断第一个举手，这样你就可以速速摆烂（否则越往后举手的人越多，观点也会被说的差不多）不过老师人很好，想发言都会有机会的[滑稽]
167008,609,陈小英,2023-01-14 14:52:20,4,5,1,次次到课，该做的全做了，不懂为什么只有3.9
167114,609,陈小英,2023-01-15 03:59:49,21,22,1,超级水的老师，还每节课都点名，去上她的课就是浪费时间。。。最后还给我卡在85
167157,609,陈小英,2023-01-15 04:28:18,3,4,1,点名太多
167222,609,陈小英,2023-01-15 06:35:07,24,25,1,给老师及格分6分吧\n\n①想得高分的别选，相对于其他很多给分好的老师给出很多5.0 4.8，陈老师的课上几乎没有满绩，4.8数量也很少很少\n\n但是给分也不算太差，4.5 4.2还是给了很多\n\n不过给分标准略迷惑（？）\n\n我们小组作业半躺平，读书报告我写了5000+（1500自己的感悟，剩下都是网上复制粘贴），志愿服务摆拍，高中选考政治，考试疯狂码字，每道题几乎都字数1000+，最后得了4.5\n\n②老师为人不近人情\n\n节节课查签到，ddl卡的巨死，在疫情封校的情况下志愿服务没办法做，老师仍然不改要求，死板的很\n\n私聊已读不回，在群里回复同学的语气要么阴阳怪气要么刻薄\n\n网课的时候自己不会操作就大喊大叫\n\n在老师身上感受不到大学老师应该有的涵养\n\n③上课几乎没有内容\n\n课上充斥着毫无意义的问题、不知所云的讨论、空洞无物的发言，不过老师会记录发言次数，经常上去随便说几句可能成绩会好一点？\n\n老师完全不讲教材，基本只做一页ppt，上课像聊天一样讲一些故事，但是又不同于其他老师的分享，老师总喜欢带着自得的语气讲自己的经历\n\n老师说话水平不高，讲课过程中充斥着额额阿阿的停顿和“然后呢”这种语气词，感觉像菜场老奶奶坐着聊天而不是讲课\n\n催眠能力十级\n\n④课其实算水，你玩手机、写论文、学其他的科目她都不管的\n\n但是据说读书报告查重\n\n老师脾气挺牛，青志来宣讲又不给ppt被老师骂了一顿\n\n\n\n总而言之，思修有很多其他给分更好讲课更好的老师选择，陈老师的课不推荐
167613,609,陈小英,2023-01-17 15:42:52,11,11,0,千万不要错过DDL噢\n\n读书报告千万不能雷同噢
168178,609,陈小英,2023-01-31 23:57:39,13,13,0,恶心死了qaq
168283,609,陈小英,2023-02-09 07:39:39,-41,0,41,纯不听课然后卷卷课堂发言就能拿到4.8！猛卷课堂发言准没错！
169655,609,陈小英,2023-02-27 09:24:20,5,5,0,自认倒霉
169838,609,陈小英,2023-02-28 05:51:56,-20,1,21,据说22年秋冬卡绩，然而是对所有人的。全员没有人超过4.5，但总感觉4.5有十几来号人。给分情况就是这样，蛮好的老师
172384,609,陈小英,2023-04-26 01:58:23,7,7,0,修的是陈老师的法学基础。今年春学期的课教室前四排只有我一个人（我在第一排）。陈老师讲课结合案例相对少，所以略显枯燥，但只要认真听课提问，能学到很多东西。读书报告和论文和课程内容也没有特别紧密的联系。最后可能因为报告和论文写得比较一般，拿了4.5。推荐对法学有兴趣的同学选修。
172435,609,陈小英,2023-04-27 01:45:25,6,6,0,上的老师的法学基础，老师讲得很好，收获了很多法学知识。只点过一次名，期末交一篇读书报告，一篇法律相关论文，没有考试。
172645,609,陈小英,2023-05-03 06:38:11,2,2,0,要说上课内容吧我确实没法评价，因为完全没听.......书评也是用高中读后感为大纲增添润色交上去的，小组作业也就循规蹈矩吧
173596,609,陈小英,2023-06-09 07:59:37,-4,8,12,sb一个\n\n话说她是不是花钱买了评论？ 楼下4.5 4.8的都是托吧
178189,609,陈小英,2023-07-07 18:15:25,19,19,0,【思想道德与法治】\n\n打分：8/10\n\n22级上的思修，其实对我来说算是印象最深的一门课（因为是在周一1、2节，也就是我大学第一节课）老师上课非常热情，虽然讲课水平的确不高（但是思修这门课你能指望上课讲很多干货也不现实）\n\n\n\n楼下的热评说的大多都属实，缺点的确非常明显。但其实我个人倒觉得没有那么不堪（可能是因为我对老师心理预期没有那么高）。已读不回个人没有体验过，问了老师能不能写《平凡的世界》的读书报告，老师很快回复了，并且当时正值疫情老师自己被居家隔离了顺便提醒我注意防护。网课直播，老师年纪大了，确实在设备出现问题时有些急躁，但我觉得也在我的可接受范围之内，并没有那么的出格和过分（老师肯定是希望能给我们把课上好才会急）。另外我个人觉得楼下有些热评措辞有些过激，私以为老师没有到“祸害学弟学妹”的程度。一个快退休的老教师，还是保留更多的善意吧。\n\n\n\n然后就是备受关注的给分问题。提醒一下学弟学妹，楼下所有的热评都写于老师出分之前，由于当时传的沸沸扬扬的“最高4.5”以及读书报告查重。这点确实导致我们那段时间内耗非常严重，纷纷在查老师下面留了差评。但是出分之后发现并没有很糟糕（我身边很多人都是4.5）。当然可能和其他个别老师会给出较多满绩和4.8相比，陈老师的给分没有那么好。\n\n\n\n给学弟学妹的建议是，如果你是预置的cxy的课，同时你在大一寒假有转专业（特别是热门专业）的计划，建议换其他老师，因为思修的确有很多给分更好的老师，而这个绩点对你们来说将会特别重要。如果不是这种情况，又嫌换老师麻烦的话，建议不用换了。
180678,609,陈小英,2023-09-25 00:45:57,0,0,0,不知所云
181367,609,陈小英,2023-10-16 04:25:43,0,1,1,纯sb
181368,609,陈小英,2023-10-16 04:25:42,0,0,0,纯sb
181369,609,陈小英,2023-10-16 04:25:42,0,1,1,纯sb
181370,609,陈小英,2023-10-16 04:25:42,0,1,1,纯sb
185128,609,陈小英,2023-12-26 11:58:21,1,1,0,讲课昏昏欲睡，还不让你睡
185337,609,陈小英,2023-12-28 03:58:10,2,2,0,曾经我看见查老师的评论，让我跑，我不在乎，我笑嘻嘻。现在，我会奉劝下一届预置思政的孩子们，应换尽换。
185995,609,陈小英,2024-01-07 08:14:35,0,0,0,思修课中规中矩
188012,609,陈小英,2024-01-18 12:29:21,-4,0,4,自认倒霉 小组展示是第一 论文也认认真真写了 别的同学是拿gpt写的 最后满绩 我呢 呵呵4.5 这种付出了比别人更多的努力最后三学分的课比别人低这么多的感觉跟吃屎一样
188064,609,陈小英,2024-01-18 06:27:44,0,0,0,还可以
188096,609,陈小英,2024-01-18 07:48:40,1,1,0,本人每节都去，过去也是摸鱼没发过一次言，读书报告水了一晚上，小组展示和志愿者平平无奇，最后得了4.2，感觉也就这样了，对绩点要求不是太高的话也不算差吧，毕竟思修也不值得很大精力。
188527,609,陈小英,2024-01-19 07:14:00,0,0,0,7/10，不建议有转专业计划的同学选，另外随意
189109,609,陈小英,2024-01-22 02:39:12,2,2,0,本人上课摆烂没发过一次言，而且最后一次课还缺勤了，小组展示的互评还是最低分，在这种情况下都有88（4.2），我觉得老师给分其实还行，倒也没有非常差
192206,609,陈小英,2024-05-11 16:21:10,4,4,0,老师这学期结束就退休了（在马院做学助看到老师来办退休手续了hhh），不管怎么样还是祝老师退休快乐！
215105,609,陈小英,2025-02-21 07:36:02,0,0,0,非常好
254,684,任凭,2015-03-14 23:12:15,3,11,8,毛本身也学不到东西。洗洗睡吧
378,684,任凭,2015-03-15 01:39:46,1,36,35,上课要求非常严格。但是只要按她的要求好好做了给分很高。
3345,684,任凭,2015-06-03 07:23:32,61,72,11,洗洗睡吧
5816,684,任凭,2015-07-09 13:48:12,9,15,6,差
8968,684,任凭,2015-10-07 07:45:12,20,22,2,个人观点，慎选
11579,684,任凭,2015-12-06 12:54:47,29,34,5,坑人还要装逼的老师
19723,684,任凭,2019-09-07 00:53:11,7,10,3,呵呵 绩杀
19726,684,任凭,2016-01-25 07:30:01,13,18,5,不喜欢。声音不好听，讲课没有其他老师好玩。问她调研课题相关，说不清。很容易自说自话。
19786,684,任凭,2016-01-25 09:16:46,10,10,0,生无可恋.......
19878,684,任凭,2016-01-25 13:13:17,11,14,3,除了不点名………给分真是神坑………
20023,684,任凭,2016-01-26 02:20:16,6,6,0,。。。
21404,684,任凭,2016-02-28 15:01:07,3,5,2,呵呵呵
22033,684,任凭,2016-03-02 06:28:15,20,22,2,真的好废话，这么没有重点的老师是怎么请来的
22673,684,任凭,2016-03-10 00:06:57,6,7,1,绩杀不解释 手动再见
23484,684,任凭,2016-03-31 07:42:01,13,16,3,没有零分，我只好打给她一分，这么脑袋没货还要坚持不懈地装逼的老师想想也是不容易
23633,684,任凭,2016-04-11 08:41:15,23,26,3,用生命在装逼，阻挠她装逼的学生就手撕到底
23634,684,任凭,2016-04-11 08:45:54,36,41,5,没内涵，爱装逼。都没听同学的展示，还在各种挑刺，不知道哪里来的勇气！\n\n展示前思路时间都排练过很多遍，中途非要打断说我们会时间不够，挑刺前来一句，在我的指导下规定时间内完成了展示，也是呵呵了。用生命在装逼！
23650,684,任凭,2016-04-11 15:42:31,-31,10,41,挺好的老师，只要在规定的时间内，规定的专题内选择合适范围，不犯常识性错误，完成一次挑不出刺的展示，以后上交一份规定格式思路清晰的小结，这样，你就不会被为难了
24641,684,任凭,2017-02-26 22:56:14,11,14,3,最差，没有之一
28595,684,任凭,2016-07-21 05:02:17,2,5,3,呵呵哒
30208,684,任凭,2016-07-01 05:38:38,5,5,0,全班死一片
30294,684,任凭,2016-07-01 07:59:24,13,14,1,绩杀。讲得差。说实话，选中了就退吧，太没内涵了，整就一中年女性自以为是的闲聊。
30365,684,任凭,2016-07-01 11:56:03,3,4,1,不听就行了。听了会难受半天
30421,684,任凭,2017-07-10 11:06:20,4,5,1,奇差无比，特别自负，绩杀!很不负责。。。
30540,684,任凭,2016-07-02 01:26:01,3,4,1,给分极坑，就是一个绩杀。讲课东扯西扯完全没脑子。这种人浙大也招，真TM搞笑
30552,684,任凭,2016-07-02 02:35:19,1,1,0,呵呵。。
30560,684,任凭,2016-07-02 03:09:56,19,23,4,思政课本来要求也不能太高 老师讲课水平一般 但对杭州各地的案例熟悉程度远远比学生大得多 所以会感觉要求比较多和高 个体差异吧 我的分数还好 而且感觉改革后的毛概真的水的一比
30932,684,任凭,2016-07-03 03:17:36,4,4,0,给分神坑，讲不清思路。。。要求奇葩。
31535,684,任凭,2016-10-20 03:08:31,1,7,6,上大课的时候感觉还行
32994,684,任凭,2016-09-10 05:01:46,52,55,3,跟个仙人掌兽似的，有事没事冒刺
33005,684,任凭,2016-09-10 04:49:58,13,21,8,想给负分然而没有 衣着打扮就很辣眼睛 五六十的人穿的像个小姑娘 眼线画的看不到眼睛 声音辣耳朵 犹记选课系统中的老师介绍中写道甜美的嗓音 我呸 上课水平不咋地 还听不进学生的发言 自己不知道的就说你乱讲 跟她讲话老是被打断 永远抓不住重点 很累
37943,684,任凭,2016-11-22 06:36:50,12,15,3,我认同了所有的批判\n\n但其实觉得这个老师有可爱的地方的
41084,684,任凭,2017-01-09 06:25:21,-44,14,58,怎么办，我是任凭的课诶……【•〔@〕】然后给了我94
41552,684,任凭,2017-01-12 07:34:22,3,4,1,无聊想打人
45806,684,任凭,2017-01-20 06:25:24,3,3,0,毛概课的坑货\n\n
47642,684,任凭,2017-02-11 02:22:48,3,3,0,路过看看低分榜
49529,684,任凭,2017-04-18 03:00:14,2,2,0,还不错呀
51544,684,任凭,2017-06-07 04:05:37,2,3,1,极其无聊
51887,684,任凭,2017-06-13 07:27:40,-2,4,6,怎么办 老师给分挺好的4.5? 上课也就那样
54319,684,任凭,2017-06-29 05:50:14,-31,7,38,第三轮才选上毛概课，当时查老师评分是最低的，一个班二十多个人，一开始也是很绝望。但是上课真的超级有趣，讨论的案例一点也不陈旧，推荐了好多很有价值的节目，老师的个性也十分直爽，十分美好的思政课体验！PS：老师衣品实在高！身材也好，养眼！
54329,684,任凭,2017-06-29 05:59:01,1,1,0,不太好
55911,684,任凭,2017-07-02 15:30:30,4,5,1,这个老师特别没有素养，非常喜欢同学发言，而且说的都是一些特别扯淡的东西，感觉用生命在装逼……给分的话，你党性够高她也不会给你太差的
59008,684,任凭,2017-09-19 05:44:28,1,1,0,为什么没有点零分的？
61142,684,任凭,2017-11-09 05:17:42,1,3,2,这种傻逼也能叫老师？
61915,684,任凭,2017-11-21 15:52:21,0,0,0,.....
64979,684,任凭,2017-12-28 06:09:22,1,1,0,很难受
67486,684,任凭,2018-01-21 10:10:57,8,13,5,哎，浙大愤青还是太多了，看不惯就动不动差评怎么混社会。考前评价一下老师，中等偏上，唯一觉得不好就是太爱找茬，喜欢扣小细节，容易浪费时间。纵向比较当然不算好，在毛概老师里我觉得还是可以接受的。
69841,684,任凭,2018-01-25 13:29:50,11,13,2,成绩给的还可以…小组报告一定要注意措辞，发言人任何一句话要是有问题都会给你纠正，包括词汇的使用（笑哭）。讲道理，上课的时候觉得老师揪住某个词或者某个观点不放会觉得“这老师怎么这么烦啊”之类的…但一看到考试卷就觉得情有可原:)简直是一张以十九大报告全文为基础的默写题，词语顺序都要来问你的（笑着活下去
70812,684,任凭,2018-01-27 14:18:28,2,5,3,下学期是任凭老师的毛概，求求各位传授经验TAT
76573,684,任凭,2018-04-15 11:55:02,0,1,1,无聊至极
79146,684,任凭,2018-05-24 05:59:30,0,2,2,这声音真是醉了，不带耳机真的没办法上课…
80176,684,任凭,2018-06-21 05:13:30,13,15,2,毛概课还要求什么呢。上的大课跟崔浩等老师比好多了，至少没那么迂腐。展示的时候喜欢鸡蛋里挑骨头倒是真的，辩驳的时候甚至说不完一句整话就会被打断。
83293,684,任凭,2018-07-10 04:43:26,4,9,5,当组长，上课发言，展示认真准备，讨论每次都回答问题，考试好好准备选择题，大题写满。4.8。
83339,684,任凭,2018-07-10 07:06:12,0,0,0,平时60%，平时分水还想上4难，最后平时分都基本能在80+。期末除了三道选择剩下全十九大（2018春夏），看一天十九大分点都记住，考试多写，期末也不太会下3（也可能崩…主要选择拉分多）\n\n点名没来一次扣五分。
87938,684,任凭,2018-10-18 04:55:29,1,2,1,一分钱一分货
99329,684,任凭,2019-10-29 09:03:02,-62,1,63,满绩怎么说
103165,684,任凭,2019-02-26 09:42:53,1,3,2,甄姬儿醉了
108081,684,任凭,2019-05-14 07:13:38,2,4,2,明明什么都不懂，真的瞎讲，因为一些站不住脚的理由随便给同学的发言打分，还很喜欢打断同学的发言。
111090,684,任凭,2019-06-29 14:40:06,-5,1,6,老师还不错，偏感性些，没有之前评论说的那么挑剔。悄悄告诉你们，选她课的人不多，选了一般就能上，由于人少两次ppt展示时间充裕，个人看来选她课好处更多~而且比起老师，毛概这门课更重要的是有一个靠谱的小组。大课每次都轮流准备发言，ppt展示分工明确准备充分，小组长按时记录上课情况，这些都不在于老师的~
112535,684,任凭,2019-07-04 17:11:49,2,3,1,给分是真的差，同样两道辨析题错了，室友别的老师4.2，我只有3.3
112691,684,任凭,2019-07-05 00:35:59,4,7,3,其实还是看小组合作吧 老师打的分数已经很仁慈了 说话也没前几年评论描述的那么毒辣 大概是改了?两道辨析题全错 平时分91 本来以为要3.9起步了 结果还是很仁慈地给了4.5 所以辨析题应该也不是得分低的问题症结所在吧
116345,684,任凭,2019-09-09 00:27:36,0,1,1,很自信
122012,684,任凭,2020-01-31 01:52:42,3,4,1,有个教学班因选课人数少而停班 活该
122860,684,任凭,2020-04-15 11:46:06,1,3,2,答辩的时候随随便便打断别人是礼貌吗\n\n为人师表，就要有老师的样子\n\n叉着腰评头论足的样子不像浙大老师\n\n食堂的大妈比她素质好些
123205,684,任凭,2020-05-19 08:35:36,3,4,1,傻逼老师一个，杠精之魂
126765,684,任凭,2020-10-19 07:58:09,2,3,1,给分贼低
126961,684,任凭,2020-10-30 10:26:08,-1,1,2,说话太吓人了
128352,684,任凭,2020-12-21 06:21:00,2,4,2,无话可说。。。就是不行好吧
130756,684,任凭,2021-01-29 04:09:47,-1,2,3,给分不错
131077,684,任凭,2021-01-26 01:08:26,10,10,0,20春夏的毛概，是网课。给到我的分数还行，我们组展示做得中规中矩，平时分小组给了90，总成绩87，其他人不知道怎样。课讲得不太好，展示的要求每次都说不太清楚，结果做出来不满意的时候会开怼甚至打断展示，坚持己见，喜欢花里胡哨的东西，声音有些尖锐。如果选到了她的课且没办法调的情况下，注意一下她展示的隐藏小要求：选题绝对不要重复！绝对不要重复！绝对不要重复！无论是展示还是调研都不可以。（班上就有小组因为选题重复被打回重做的）；还有就是展示的题目不要太大。比如她给的题目是“中国外交”，你的展示就不能是“中国外交”，而应该是“疫情后中美关系走向”这种范围的题目，不然容易打回重做或者被怼。\n\n以上，大家加油
132699,684,任凭,2021-02-03 10:58:07,14,14,0,讲课不太行，老年组崔章任杨四个中章和杨讲课稍微好点，任和崔各具特色，任是声音尖锐刺耳，睡不着;崔是声音低沉听不见，讲课像念课本条条框框抑扬顿挫，像私塾先生，做作业听着听着也能睡着。\n\n展示挑刺感觉还好，这学期任凭主要对一个小组挑刺了，我感觉只要是个老师肯定会对那个组挑刺，因为那个组真的展示太烂了。其他比如老师常说的繁荣昌盛和繁荣兴盛注意一下，还有一些常见的词语搭配，比如推动什么，加快什么，促进什么，不要犯太低级的语法问题感觉挑刺还好？\n\n给分感觉还是比较严，不算放水特别狠的老师，事实是考试成绩大家都很低，平时分90的情况下一般算下来总评80分是很难的，老师是肯定调分了的
133967,684,任凭,2021-03-11 01:50:24,2,9,7,平时成绩满，最终成绩才87？太难了
135988,684,任凭,2021-06-08 05:40:34,3,4,1,我只能说，对离谱老师的认知又被刷新了，快逃
137047,684,任凭,2021-06-30 03:44:38,1,4,3,出分前来评论，怕出分后评论有失公正。我上的任老师的习思想，任老师是蛮不错的老师，专题课在上除了那些知识点？以外，还会分享一些自己生活中的经历related to 专题内容，从而加深我对这些理论性的东西的印象。平时给分也还不错，虽然小组分没有95分以上的，但也没有88及以下的。。没有评论区说的那么emmm
138173,684,任凭,2021-07-07 17:06:39,10,11,1,这个老师就是个几把傻逼，分贼低事儿还不少
140640,684,任凭,2021-09-14 14:44:02,-5,1,6,很好的老师哇
140824,684,任凭,2021-09-16 12:26:15,1,3,2,看到评分这么低，我开始还不信，直到我亲自上了她的课。送后来者两个字：快逃！
141285,684,任凭,2021-09-28 08:40:56,2,2,0,嘿嘿，傻逼
142744,684,任凭,2021-11-15 19:33:06,2,3,1,啥也不想说 打一分是因为没有0分选项
143740,684,任凭,2021-12-03 14:57:33,6,7,1,这是浙大老师？表面所不用卷，实际上第一节课就说什么希望小组整点话剧，辩论啥的。好好的小组作业，传统讲PPT不好吗？非要引导学生去卷？？？？？问它小组作业这么写行不行，刚说两句话，就给我打断。“啊，你们这个不行的。。。。说了一堆前言不搭后语显示自己多厉害的话”我寻思我刚说两句话啊，你听到啥了啊。\n\n\n\n上完这个课，我只能说对毛概更加仇恨，完全没有提高我的素养或者兴趣。再你妈的见。为什么最低只能打1分啊。
144134,684,任凭,2021-12-19 09:22:43,-2,0,2,任凭 我的爹
150032,684,任凭,2022-01-18 12:03:05,0,1,1,xg课没啥好说的，期末开卷。，感觉给分略差但也算是正常的吧，还行。
151094,684,任凭,2022-02-23 03:15:24,4,5,1,如果这是1979年的毛概课我会认为这老师思路观点和上课展示形式挺新的，在2022年我只能说这是幼儿园水平。
152264,684,任凭,2022-04-01 00:59:54,5,7,2,什么叫既得利益者的丑恶嘴脸，看任君便知
152604,684,任凭,2022-04-15 14:36:42,0,0,0,。。。
156825,684,任凭,2022-06-21 04:58:32,1,1,0,还行的老师，二点六给的太低了，你让那些真正值二点六的老师情何以堪\n\n平时分很好！展示分给大家都尽量高了，我们组两次都是纯讲PPT都93（讨论表好好上网搜搜复制粘贴，不要一两句话应付）甚至会考虑到那些一点不干活的人，让我们平时分别给他太太低别让他挂了\n\n说话有点催眠讲课没听不清楚，展示会根据剩余时间控制提问时间，我展示结束的早被问了二十分钟，没遇到别的评论说的“挑刺”\n\n平时多发言，最后平时分会被直接拉到99
157663,684,任凭,2022-06-24 09:15:45,3,3,0,还行啊感觉，没评价那么吓人吧。上课没听过所以老师讲课内容不清楚，但是给分还挺好的，展示提问也还比较友好，平时分九十多很满足了（也可能是我运气比较好在一个很积极的小组里hh）
159867,684,任凭,2022-09-07 03:25:00,3,3,0,期末考试的范围都划错了，毛概课都没上毛，说要考，结果根本没考
160365,684,任凭,2022-09-20 09:56:19,2,4,2,感觉不如朝晖giegie捏
163352,684,任凭,2022-12-13 12:04:31,4,5,1,既得利益者的丑恶嘴脸，高高挂起饶有兴趣地讲解着一些不着边际的案例。
166825,684,任凭,2023-01-13 17:34:26,1,3,2,呃呃，满了就来给个10分把，平时分好像给的都很好，从不点名，问了别的小组都是基本90往上，不懂为啥老师评分这么低，课不知道上的咋样，没听过几节，记得带肖秀荣三件套，出卷喜欢参考肖四，接近一半原题，
167619,684,任凭,2023-01-17 17:29:34,4,4,0,毛概不点名，平时分还可以，展示也挺水的，按顺序发言不用抢。
174984,684,任凭,2023-06-20 14:24:53,0,2,2,xsl
177742,684,任凭,2023-07-04 14:12:03,0,3,3,评分低是有道理的
181115,684,任凭,2023-10-09 03:36:24,3,4,1,讲课毫无水平，啰嗦废话，教学任务布置乱七八糟，上课太痛苦了
184257,684,任凭,2023-12-14 05:36:10,0,0,0,如果真的选不到别的老师，勉强能上
188088,684,任凭,2024-01-18 07:32:33,3,3,0,出分了来评论一嘴\n\n习概这课肯定会调分\n\n平时分94最后总评88算了一下\n\n期末大概80左右，所以分数应该是四舍五入了没怎么捞\n\n上课完全不知道她在讲什么，虽然苯人基本上也没听过。确实喜欢对小组展示挑刺。\n\n点过一次名，在提前告诉组长来通知大家要来教室。\n\n分数勉强算是还可以吧，2.7有点太过了，选不到其他老师也能上。
188744,684,任凭,2024-01-19 20:15:54,3,3,0,给分还可以，没那么差吧
189424,684,任凭,2024-01-24 05:54:22,3,3,0,其实体验还好，展示挑刺有的我感觉确实是存在老师所说的问题，只是可能老师本身语调比较高大家会觉得冒犯；不用卷发言我很喜欢，平时分和朋友周边基本上都是93-95，学期末突击点了一次名（人真的太少了），最后给分也不错，不至于评分这么低
189942,684,任凭,2024-02-03 06:29:35,2,2,0,其实还行，讲课一般，但是让人很有亲和力，给分也不错
191005,684,任凭,2024-03-28 01:22:21,2,2,0,老师其实还不错的，当然算不上特别优秀，7-8分吧\n\n期末考认真复习了三天最后总评4.8，已经很满意了
197488,684,任凭,2024-07-17 02:16:09,1,1,0,老师其实还不错的，7分左右！\n\n22-23学年春夏毛概，平时不push，没有特别鼓励鹅颈，也很关心同学（由于我跨校区上课，老师叮嘱我路上注意安全）\n\n老师最后给每个组的平时分也大多是90多（平时个人发言可以额外加平时分哦），期末给分也不错（本人平时95＋，期末复习两三天，卷子答满，最后92）
200727,684,任凭,2024-10-21 11:18:59,1,1,0,喜欢打拳和批判学生是吧，难绷。这种素质低下，道德低下的老师是怎么进入浙大的。纯纯的逆天老师
200735,684,任凭,2024-10-21 13:16:47,1,1,0,上课是稀里糊涂的，\n\nppt讲课是一坨的，\n\n临近下课是心急如焚的，\n\n三观是连我上小学的表弟都不如的。\n\n啥玩意儿
4996,689,林小芳,2016-09-17 01:35:33,-3,14,17,给分挺好的。上课也很负责。
7758,689,林小芳,2015-09-15 12:34:26,24,41,17,蛮好的
14721,689,林小芳,2016-01-08 12:37:55,-2,4,6,很负责 也从学生角度出发 强调公平
16806,689,林小芳,2016-01-19 04:11:44,1,12,11,我遇到过的，讲课最好的思政课老师！
18825,689,林小芳,2016-01-22 15:15:11,-2,6,8,好老师~给分也挺好的~也负责任
18842,689,林小芳,2016-01-22 15:32:07,1,7,6,挺开明的，不是毛左。
19025,689,林小芳,2016-01-23 05:22:09,-6,5,11,老师很不错！！！
19045,689,林小芳,2016-01-23 06:37:55,1,4,3,非常好
21153,689,林小芳,2016-02-23 04:45:05,2,9,7,唯一非毛左
23076,689,林小芳,2016-03-17 02:21:45,4,11,7,绝非毛左，视野开阔。
26080,689,林小芳,2016-06-15 12:18:57,1,4,3,上课讲的东西感觉很不错，老师人也很好
32105,689,林小芳,2016-07-05 15:39:56,3,8,5,思路开阔，尊重学生，理解不同意见，注重公正公平，讲课生动有趣，非常好的老师，点赞！
32136,689,林小芳,2016-07-05 17:11:45,4,13,9,乱给分，差评！
32137,689,林小芳,2016-07-05 17:12:00,0,4,4,一分耕耘一分收获。只能说小组成员太不积极啦，小组分数应该不高。但是老师人很不错啊，给分公正。
32165,689,林小芳,2016-07-06 00:24:37,5,12,7,给分差…
32226,689,林小芳,2018-12-27 05:05:26,11,22,11,我很好奇为什么会这么晚出成绩，而且给分一般
32245,689,林小芳,2016-12-28 08:01:26,22,36,14,毛概付出了很多 平时积极发言 上台展示 考试前背了三天毛概 出成绩也比较慢 原以为成绩会高 结果一般 蛮失望的
32474,689,林小芳,2016-07-07 04:51:25,2,7,5,给分没有评论里说的那么好，但上课还行。
36630,689,林小芳,2018-03-07 01:47:21,-19,22,41,在贵校，马院的教员也能有8分了？
39246,689,林小芳,2016-12-22 00:16:44,15,16,1,平和……但是话有点多
46469,689,林小芳,2017-01-22 00:08:20,-2,7,9,给分真烂，上课积极发言，小组分高，还这么点分
46485,689,林小芳,2017-01-22 00:56:24,1,3,2,听课难受 给分也不好 呵呵
46610,689,林小芳,2017-01-22 03:55:22,2,11,9,抛开给分不谈，林老师讲课的姿势水平绝对是思政课老师中最高的。不知楼下一口一个贵校是什么心态。
46931,689,林小芳,2019-09-08 14:26:33,19,34,15,首先林老师就思政课的知识水平肯定是非常不错的。不说跟其他思政课，就跟专题课其他老师相比，林老师也是积极带动我们思考的，说的都很温和，没有强烈的价值观灌输。\n\n接着关于林老师的给分，我觉得还是正常的。林老师打分都是合理的，有着适当的分差，但是也都比较高的。我们小组展示准备非常认真，结果也不错，一次展示93，一次94（我们偷偷看的）。但是最后小组展示分数肯定少于93，我觉得很大原因就是那些评分员乱评，有些也有60+的，最多85的，评分员的评分没有一定的标准。老师也是要尊重评分员的评分的。
50899,689,林小芳,2017-05-08 07:37:56,-2,0,2,字数字数
57244,689,林小芳,2020-02-25 05:49:28,89,129,40,出分巨慢，啰里啰嗦，几句话可以讲清楚的事情非要翻来覆去来回说，上课质量不作评价，反正思政课基本也没人听，私以为十几分的思政课就是浪费人生，有这时间多上上专业课有什么不好(不针对老师)
57265,689,林小芳,2017-07-06 09:40:27,5,8,3,老师人比较好，但给分不咋地吧:(
57267,689,林小芳,2017-07-06 09:57:02,9,11,2,出分慢且差，为人讲究公平
59635,689,林小芳,2017-09-25 05:32:51,0,4,4,也算是浙大特色吧，教个j类课的老师觉得自己好了不起啊。提前说，扣分明目多的一批
63907,689,林小芳,2017-12-21 00:58:32,11,17,6,我对林老师的学术水平没有任何疑问，但是大班课的时间控制真的让人很捉急，讨论永远在剩下十五分钟开始，其余老师一般剩下半小时到45分钟，因此只要是林老师的课，没有不拖堂的，而且讨论三个班能走一轮就是奇迹了，如果是因为课程内容真的需要这么久，那也无可厚非，但是个人是不相信独独林老师的内容奇多，个人想法。
72362,689,林小芳,2018-01-31 03:37:57,2,11,9,平时按时到课，上课积极发言，考试认真准备，成绩出来3.3。并不知道林老师到底用的什么标准，只知道这个标准非常不公正，非常荒谬。课堂内容也是照本宣科，乏善可陈。一个令人失望的老师。
72678,689,林小芳,2018-01-31 00:26:09,2,6,4,给分差
72693,689,林小芳,2018-01-31 03:53:10,4,8,4,缺到一次扣了五分，最后成绩84。考试我是认真写满的，小组平时讨论课发言比较多，虽然平时分没有公示但应该比较好。这个成绩可以接受吧，原本以为自己肯定被正态了。
72737,689,林小芳,2018-01-31 04:03:52,-9,1,10,讲道理非常负责任的老师，给分也很公平公正，我觉得还是看小组的吧，想要成绩好一点就得小组展示非常好，毕竟占分最高
72969,689,林小芳,2018-01-31 12:51:07,5,8,3,给分很差
74028,689,林小芳,2018-02-04 09:49:04,0,6,6,真的是很不负责的老师，隔壁班老师专门考前梳理十九大报告，隔壁班同学做到好多原题。瞎点名，真是呵呵
83618,689,林小芳,2018-07-11 00:00:56,0,3,3,出分了，没有想象中糟糕，只感觉改革后毛概考试和课堂脱节，平常听听大课还有点意思，小课没什么必要，考试纯粹背一些考完就立马忘掉的东西。林老师是负责任并且有知识广度的老师，会尽力安排好课堂，同样地，一句话能翻来覆去讲几十分钟，加重了毛概课堂的烦絮。打了9分，是觉得浙大思政课可以再变得更符合学生认知感受一点。
83656,689,林小芳,2018-07-11 02:58:28,-6,2,8,老师挺能聊的...不过给分挺好哇0 0
83757,689,林小芳,2018-07-11 08:48:26,5,7,2,真是不知道这个老师的7.70评分怎么来的，这个学期每节课否回答问题，考试考的自己还满意，平时分不低，结果最后分数，我们班均记2.94，你们自己看着办吧
86991,689,林小芳,2018-09-20 01:50:00,3,5,2,拖堂不能忍！
86992,689,林小芳,2018-09-20 01:50:52,4,6,2,巨啰嗦，真是醉了，中间不下课还拖堂，一点很简单的东西都要重复讲两三遍，
91026,689,林小芳,2018-11-29 04:49:11,2,5,3,真的特别会逼逼\n\n点人回答问题点的少\n\n自己还要瞎逼逼一通\n\n希望这老师知道一点\n\n没有人想听思政课谢谢\n\n至于拖堂 呵呵
91778,689,林小芳,2018-12-20 02:10:29,1,3,2,林老师，我们是喜欢毛概才选的这课，你信么？不信还tm搞得像我们对这门课很感兴趣一样！
95539,689,林小芳,2019-01-19 14:27:59,1,4,3,贼鸡巴啰嗦，拖堂还能哔哔，球球您憋说了，你不知道一次性听个五六遍一样的东西会让人恶心吗
96454,689,林小芳,2019-01-21 04:10:30,6,7,1,最爱点名，啰嗦无聊，给分又差。\n\n不知道怎么会有7.7的
99101,689,林小芳,2019-01-24 09:00:51,6,8,2,我就奇了怪了，怎么没有零分呢？设计非常不合理这是第一点\n\n然后就是这个老师上课话多且没用，喜欢重复，尤其讨论课时候，非常喜欢自己问问题自己答，占本应该同学讨论的时间，还有，拖堂！严重的拖堂！还有出分慢，慢到你以为是教学事故，慢就不说了，还给分超级差，不是一般的差！大家，四分的大课啊！千万别选啊！千万别选啊！千万别选啊！
99116,689,林小芳,2019-01-24 09:33:42,-2,2,4,亲测给分差，垃圾\n\n
99239,689,林小芳,2019-01-24 13:19:27,5,6,1,很注重程序正义的一个老师。讲课内容也比较正常，国际关系讲解很优秀。小组平均分跟其他老师比较还是稍微低一些，平均低两到三分吧，但是整体来说问题不大，按照期末成绩来说应该是有给调分的。可以考虑选择。
99678,689,林小芳,2019-01-25 04:54:28,3,4,1,做什么事都要走程序，原则太多不太舒服，讲课相对其他老师还是可以的，给分还可以吧看出来肯定调分了
100797,689,林小芳,2019-01-27 00:53:55,-6,0,6,上课水平是我听过的思政课老师里水平最高的，每节课必然拖堂哈哈。给分感觉还行，考前还问了我们分数分档的问题，结果88卡在4.2？？
103245,689,林小芳,2019-02-27 03:07:41,-1,1,2,啰嗦没重点，说话噼里啪啦一通直接跑偏还不下课
105042,689,林小芳,2019-07-05 22:04:38,3,5,2,老师讲课还好，思想也比较中立不是很左的那种，学术水平还是在那里的。就是说话有点啰嗦，每句话都要说好几遍的那种！而且经常拖堂。然后平时分给分比较均衡，最高的组跟最低的组差不到3分，也就一档的事。主要还是看考试吧。我考前背了一个周的课本，最后感觉自己做的海星，平时分94，最后总评92，可能老师给我往上调分了？\n\n
109980,689,林小芳,2019-06-21 02:19:58,-4,3,7,只恨没有零分，真的差这个老师，啰嗦的不行仔细听听都是废话，每节课都要拖堂，为什么会有这种课？还必修
110409,689,林小芳,2019-06-28 15:51:06,-64,11,75,能说出“十几学分的思政课毫无用处”这种话的人，素质和态度可想而知。这简单的几门课都学不好，别的课就能牛得没边吗？
110981,689,林小芳,2019-06-29 03:05:02,0,2,2,不太好
112413,689,林小芳,2019-07-04 04:55:53,-6,5,11,之前发了条评价，是评价某些同学的，你们居然以为我在说老师，一直点灭，你们这阅读能力呀
113106,689,林小芳,2019-07-05 23:31:33,-2,5,7,小组平时分中下，个人无发言记录，无缺席，由于考试周压力比较大，并没有太多时间复习毛概，但也认真看了遍书，背了一些重要的小标题大标题，考试认真写满了，勉强上四，但是很知足了，谢谢老师！
113758,689,林小芳,2019-07-07 09:24:08,9,11,2,对于老师的评价，查老师这儿评论长的都挺客观的。老师做许多事情都很正式，但是时间观念比较淡薄每次展示课都是自己说好久再开始？然后每次都会拖堂，有点影响后面的上课。另外老师太喜欢在台下同学提问环节自己和展示小组交流了，那同学提问的意义在哪里呢？有时候不是时间不够提问同学名额少了，是因为你自己一直在说。三节的理论课也喜欢自问自答。不过看得出老师还是很认真敬业的，只是授课方式真的不敢恭维，尤其时间把握和吸引力上，学术水平也暂且不论吧，个人上完四个老师的大课没有发现特别喜欢，理论课吸引我听过超过一小时以上的。包括毛概评分最高的宇正香老师。\n\n然后老师真的很喜欢一句话重复三遍甚至四五遍啊，宁和严谷军老师组队出道吧。\n\n然后，感觉毛概老师更多评分出现这么大差距一个是因为给分，还有一个是因为个人说话上课风格，其他再没了。不过好像也没有多少人非常认真的每节课听理论的，所以很多查老师评分更多就是给分好坏的参考吧，毛概老师是这样。
114115,689,林小芳,2019-07-09 00:02:44,57,74,17,小组分倒数，一次个人发言记录，考前背了一晚上毛概资料，考试写满，最后3.9。。。 并不想抨击老师，因为大概所有毛概老师给分都这样吧。就只是想抨击一下毛概这门课，我真是搞不懂这门一点卵用都没有的课凭什么要设置成4学分(现在好像是5学分)。考前像文革时期背红宝书一样背一把手的语录有意思吗？考试的那些无聊的挖空选择题有意思吗？就仿佛和谐共处与和谐相处;不平等不充分与不充分不平等的语序有天大的区别似的。我并不觉得我一个学期下来党性有提高多少，相反这种上纲上线的考试方式让我对这种政治课产生了无比的反感。
118715,689,林小芳,2019-10-31 04:27:18,-3,0,3,这老师爱拖堂，而且非常认真，不让上课干别的，老拖堂10分钟真醉了
124594,689,林小芳,2020-07-03 10:59:16,5,5,0,老师思想和讲课水平都不错，人也很负责，乐于和学生交流。大家总体平时分差距不大，整体大家都还不错，但小组展示互评方面还是有点迷惑的。我自己拿的成绩一般吧，开卷考也确实不知道答题点在哪里。
135912,689,林小芳,2021-06-03 02:20:40,-7,0,7,1111
136651,689,林小芳,2021-06-22 11:50:25,-4,3,7,遇到最会拖堂的老师，上课语气很平淡，但是却说自己饱含感情。。。
136668,689,林小芳,2021-06-22 15:24:47,2,4,2,周一通知学生本来不用上的周二的课要早八点名，周二8点20人才在群里出现（始终没在教室出现），说今天是自习课？？？
138924,689,林小芳,2021-07-11 23:52:00,-103,6,109,林老师对学生认真负责，耐心体贴\n\n出分巨慢但给分比较公正\n\n习概88心有不甘，思政课最低分数…
142708,689,林小芳,2021-11-15 10:12:03,2,2,0,如果认真听课的话，我个人还是觉得老师讲课讲得非常好，非常负责。
148396,689,林小芳,2022-01-12 10:38:45,5,5,0,本学期出分速度挺快的，绩点给的还行。
148643,689,林小芳,2022-01-13 05:51:06,5,5,0,事情不算多，小组轮流发言所以不卷，给分也很高，体验很好
148784,689,林小芳,2022-01-13 13:31:59,1,1,0,虽然最后分一般，不过我自己背了多少东西我心里还是有点数的，平时分不低的（毛概），人很好，小组展示问问题的时候还会鼓励地点头，我认为这个评分是过于低了，至少应该有9分的
157572,689,林小芳,2022-06-23 19:18:24,5,5,0,大爱小芳老师，零基础的毛概，还能捞到八十分以上，强推
157574,689,林小芳,2022-06-23 19:58:20,2,2,0,上课不卷，认真完成课程任务就可以，老师每次都会表扬鼓励展示的同学，最后给分也很好！
157615,689,林小芳,2022-06-24 03:57:54,6,6,0,平时分（小组分）给分很好，躺平党只是认真准备好课堂发言和两次展示，额外发言一次也没做过，这样还有90+。当然也要感谢课代表和助教的帮助，还有组员们的努力配合。期末没有费力去背，所以应该只有70多分。毛概毕竟不开卷，想得高分必须要背。
157686,689,林小芳,2022-06-24 10:32:27,1,7,6,林老师的课不卷，一学期下来认真参与，期末好好准备就能拿高分，在老师自己儿子参加高考的关键时刻还能用心带出这一届真的很难不爱，最后94分4.8，强推。
173208,689,林小芳,2023-05-16 03:05:15,1,2,1,不太行，同学做报告做分享，啥也不听啥也不看，最后来问你你讲过的内容。。。。
177945,689,林小芳,2023-07-05 16:31:44,-56,5,61,点名多，给分只能说一般般吧，连4.5都没上
177997,689,林小芳,2023-07-06 05:36:38,3,4,1,给分挺好的
183514,689,林小芳,2023-11-27 03:48:49,6,8,2,不知道是该问候老师还是LX、ZQQ两位课代表，连课堂展示顺序都安排不明白，每周的课堂展示先自主报名后摇骰子是谁想出来的？如果不是组长催的话，周二下午的课堂展示在周六才通知选题，蒸乌鱼
183630,689,林小芳,2023-11-28 04:28:01,6,8,2,老师人真的挺好挺和善的，这个学期才选的给分好不好不知道，但是有用心备课，思政课基本都没什么人听，但是老师还是挺有激情的
189107,689,林小芳,2024-01-22 02:24:51,5,6,1,习概，事少分高（平时一点也不卷，平时分给的高，期末也会捞），但是出分比较慢
189116,689,林小芳,2024-01-22 03:18:00,2,4,2,老师我爱你 我思修课都能拿满绩～!
189171,689,林小芳,2024-01-22 08:23:05,2,5,3,事情少，反卷，给分好，谢谢老师！
189788,689,林小芳,2024-01-29 07:27:30,3,4,1,事少分高！老师人也不错！
190127,689,林小芳,2024-02-23 08:31:31,2,3,1,2023-2024秋冬学期习概，这门课的评分标准、讲课内容应该所有老师都差不多。林老师给分挺好的，特色是上课喜欢提问题（类似“x个xx具体是哪几个？”“xx是什么？”），一次加一份平时分，但往往问完以后就只停顿两秒钟，期间如果期间没有人回答就自己讲下去了，当然有同学就抢答了很多次hhh
190705,689,林小芳,2024-03-15 07:04:30,9,9,0,讨论题能不能不要拖到有同学提醒了再发，准时就这么难吗
190791,689,林小芳,2024-03-19 09:01:16,3,3,0,太拖拉了
193381,689,林小芳,2024-06-08 05:57:16,2,2,0,这学期雷达点名3次
195245,689,林小芳,2024-06-27 11:53:43,7,7,0,这个学期习概给分似乎没有査老师说的好~
195573,689,林小芳,2024-06-28 23:56:47,-9,4,13,4.8/92搞定\n\n给分不错，习概开卷，考前一点没看，上课一点没听\n\n想搞绩点的话，建议卷平时分，使劲卷\n\n比如各个活动抢着干，这样就会平时分很高\n\n我是靠平时分拉上去的\n\n点名点了三次这学期\n\n主要是卷平时分，因为期末是流水线老师改的，各个班都是一样
210988,689,林小芳,2025-01-10 09:35:03,3,3,0,平时分是小组互相打分 出来的时候看到只有92还以为要凉凉\n\n但是平时回答问题 以及写参观的感想都是会有加分的 感觉我的平时分在这里有所加分\n\n期末感觉老师也捞了\n\n最后92/4.8 平时事情很轻松 推荐大家选
211581,689,林小芳,2025-01-12 03:02:17,1,1,0,老师很好啊，这个学期没拖堂，出分速度也挺正常的（考完后7天出成绩），讲课能看出她的热爱，平时也不卷。写好两次感想，上课发几次言，我的小组分数不高，最后出的成绩也很理想，谢谢老师！
212235,689,林小芳,2025-01-13 13:44:40,-2,0,2,膝盖选她的课没问题的，事情不算少，但是我感觉膝盖应该都这样
5099,703,钟为民,2015-07-04 07:09:20,-5,13,18,风趣幽默
5828,703,钟为民,2017-09-18 08:48:11,11,27,16,有架子，不喜欢
5917,703,钟为民,2016-06-19 08:22:08,-23,15,38,人帅而且真诚，上课言语很接地气但是很有力量，很享受，最喜欢的老师之一。人很有魅力，经历丰富，上课会涉及到人生的启发。给分也非常好。绝对好评！
5928,703,钟为民,2016-06-19 08:20:24,-6,9,15,好老师！让我的形策没有挂掉！
5962,703,钟为民,2015-07-10 04:47:12,-1,18,19,非常棒
5968,703,钟为民,2015-07-10 05:16:50,21,35,14,必须到课，要不然一次5分没了。最后给分坑。
5975,703,钟为民,2015-07-10 05:48:11,149,245,96,绩点哔了狗
6229,703,钟为民,2015-07-12 06:48:23,3,16,13,不好
6365,703,钟为民,2015-07-13 08:32:11,44,64,20,土共5毛，给分这么差，还按座位点名。啤酒肚，爱炫耀。这次的助教也不怎么样。
6720,703,钟为民,2015-07-20 03:34:29,-4,14,18,按位置坐，必须到课，讲的还不错吧，绩点也不错
6970,703,钟为民,2015-08-23 10:44:41,90,133,43,思修绩点跪烂欲哭无泪
6990,703,钟为民,2015-08-24 06:57:30,-5,10,15,好
8134,703,钟为民,2015-09-17 06:06:28,-11,13,24,大一上的钟叔叔和另一个老师的思修，比起另一个老师感觉有趣多了虽然每次上课都有十分钟左右在读课文……给分也还好
9381,703,钟为民,2015-10-25 12:45:18,-5,7,12,拖堂。。。课讲得蛮好
9639,703,钟为民,2015-11-03 14:53:38,-13,8,21,一个好字、难得！
11481,703,钟为民,2015-12-02 11:21:29,-5,7,12,还可以
12254,703,钟为民,2016-01-04 20:49:59,-6,8,14,讲得实在接地气，确实学到了点东西！
12413,703,钟为民,2015-12-29 00:14:24,43,71,28,最后成果要装订成书 形式主义 演讲要求苛刻 一边说公平不会额外加分 又乱改绩点 有本事别当婊子又立牌坊 最恶心的是针对 千万别发邮件问他问题 会点组名嘲讽你们
12581,703,钟为民,2015-12-23 14:08:16,11,19,8,事情有点多
12582,703,钟为民,2015-12-23 14:09:18,-4,9,13,蛮幽默的
14024,703,钟为民,2016-01-04 00:40:33,-2,5,7,非常不好，有时候不是你的问题但却被他批
14829,703,钟为民,2016-01-09 15:14:05,-1,4,5,真的
14870,703,钟为民,2016-01-10 11:59:14,40,79,39,读书报告必须三张纸，多一张或少一张就没分\n\n作业必须在打铃前教，打铃后五分钟内教的只有三分之一的分数，之后的零分\n\n上课前要齐声朗诵宪法\n\n就没见过这么会装逼的
14900,703,钟为民,2016-01-11 02:00:55,-12,11,23,钟老师是一个实实在在的教育工作者，认真听他的课，你能把他给你教授的东西全部印刻到你的生活当中，学到的不仅仅是知识\n\n不过听他的课总觉得他的有些思想有点片面
15958,703,钟为民,2016-01-16 21:25:49,-11,7,18,遇到这样的老师真的好幸福，快乐又不失思考，难得。谢谢阿钟老师！
16681,703,钟为民,2016-01-18 17:41:11,2,10,8,老师上课没意思，但愿绩点别太低\n\n
17567,703,钟为民,2016-01-20 12:07:01,8,13,5,这个老师就像他的评分
17577,703,钟为民,2016-01-20 12:23:08,-6,6,12,一般般吧，朗诵宪法还行.
17639,703,钟为民,2016-01-20 14:17:41,15,27,12,给分不公平，干了许多也没用
17646,703,钟为民,2016-01-20 14:30:40,19,26,7,形式主义
17669,703,钟为民,2016-01-20 15:12:54,26,41,15,傻逼老师，绩点给的莫名其妙的低
17743,703,钟为民,2016-01-20 23:33:49,32,43,11,给分超差〒_〒
17772,703,钟为民,2017-06-15 12:20:34,5,14,9,感觉人还不错 然而是我太傻太天真 老师原来是做行政的 一些事情处理得的确圆滑 给分让我欲哭无泪。
17905,703,钟为民,2016-01-21 03:43:17,1,6,5,不喜欢
17949,703,钟为民,2016-01-25 16:40:49,-15,7,22,回想一下大一课程，思修阿钟叔的课其实最有收获……
18608,703,钟为民,2016-01-23 09:04:44,3,6,3,一般般
18627,703,钟为民,2016-01-22 06:59:53,27,42,15,给他一分是没有0分。
19397,703,钟为民,2016-01-24 05:30:49,2,8,6,晕菜，他咋不上天呢
19826,703,钟为民,2016-01-25 10:40:23,1,6,5,咋不上天呢！不亲民，给分坑爹，有些要求实在太TM严格了都有点不合理，上课没什么料，装逼满分
20322,703,钟为民,2016-01-27 04:10:44,3,4,1,不怎么开心
21356,703,钟为民,2016-02-28 07:51:48,11,17,6,努力了也没有回报。。。给分莫名其妙
22028,703,钟为民,2016-03-02 06:09:15,1,4,3,不好的
22789,703,钟为民,2016-03-12 01:27:30,38,58,20,第一节课老师说，跳楼之前一定要找阿钟老师。我想怎么会要跳楼呢？结果忙完无数的形式主义然后得到一个哔了狗的绩点之后。。。
22845,703,钟为民,2016-03-13 11:09:22,1,2,1,行策课简直是灾难
23712,703,钟为民,2017-05-31 10:17:00,61,89,28,大一时，预置的钟老师评分是7分，于是我没有想过退课。那个学期在思修上花的精力不比微积分少(我是组长)，小组展示是第二，最后3.6。努力与收获不成正比，这是钟老师给我上的最重要的一课。\n\n现在，看到评分变成了4.3，只能说公道自在人心。
25342,703,钟为民,2016-05-15 10:45:42,2,4,2,不喜欢思政类老师大谈科技
26498,703,钟为民,2016-06-19 08:21:30,2,6,4,老师爱装逼，老鼠爱大米，我也没办法，听他瞎bb\n\n
26505,703,钟为民,2016-07-01 05:50:47,14,19,5,人很不错。但是课实在太枯燥。座位固定要点到。还有论文。最后给分也一般。
27734,703,钟为民,2016-06-30 22:53:51,16,28,12,出分又慢，给分又少，唉，扯淡老师
29153,703,钟为民,2016-06-29 09:59:42,1,4,3,内心是日了狗的
29989,703,钟为民,2016-06-30 16:13:54,-2,2,4,固定座位简直不能忍。。最角落的人表示不如耍手机。奈何考得好。
29994,703,钟为民,2016-06-30 16:25:23,15,24,9,听课按座位号坐，每次上课都觉得在考试。然后收获最低绩点。冷漠
30006,703,钟为民,2016-06-30 17:12:37,-3,4,7,讲的挺不错的，就是必须按照规定的座位号坐，相当于每次都点名，给分还行
30019,703,钟为民,2016-07-01 00:12:26,11,19,8,超级垃圾的老师
30021,703,钟为民,2016-06-30 22:50:16,-1,2,3,打分。
30023,703,钟为民,2016-06-30 23:25:08,2,7,5,从不旷课，论文说写了就满分，期末考题都背到了，结果绩点低得可耻！别班同学既没有论文也没背题目还是轻轻松松高分！总之千万别选他的课！
30028,703,钟为民,2016-06-30 23:51:50,12,20,8,我背完了所有PPT……\n\n论文写得超认真……\n\n得了3.3……\n\n我室友……\n\n根本不用写论文…\n\n根本不用背三百多页PPT…\n\n4.2……
30097,703,钟为民,2016-07-01 02:24:18,2,5,3,固定座位真是没有点名胜似点名。。而且后排表示看不清啊！听他讲讲时政还挺有意思的，其他的没啥感觉。给分还行吧。
30143,703,钟为民,2016-07-06 11:40:26,4,7,3,一门思政类的无用课，连3.3都不给我，给我2.7是几个意思啊，垃圾老师还要点名，写论文，不要选
30423,703,钟为民,2016-07-01 14:12:25,-3,1,4,挺好的，只是我给了一分O(∩_∩)O
31155,703,钟为民,2016-07-03 09:48:07,10,14,4,固定座位不说了，反正我也不逃课。老师感觉很热情，形策下课应该是最晚的几个班级之一。但这绩点？？excuse me？
31239,703,钟为民,2016-07-03 12:32:19,-2,1,3,形策课还好吧，就是要按位置坐
33082,703,钟为民,2016-09-12 07:38:49,1,5,4,如沐春风 感觉比吡了狗还爽\n\n
33200,703,钟为民,2017-02-12 03:28:34,5,15,10,阿钟的课还是不错的，满满的爱国情怀和正能量，但是想拿高绩点不是很容易，首先要当组长，其次，报告一定要认真准备，最后期末考试一定要认真作答，主观题写多点比较好（4.5亲测）。
33212,703,钟为民,2016-09-16 00:42:38,2,10,8,回忆起来上阿钟叔的课还是很有收获！赞
33605,703,钟为民,2016-09-20 08:41:51,0,1,1,  
33743,703,钟为民,2016-09-21 09:33:34,-1,4,5,形策课还行\n\n就是固定座位不太爽，不过上课事情少，一篇论文加考试也不用回答问题登名字\n\n给分偏低，但是自己认真的话还可以。
33744,703,钟为民,2016-09-21 09:49:01,4,9,5,我当了组长，积极发言，做了展示，绩点马勒戈壁。
33812,703,钟为民,2016-11-08 07:57:09,1,4,3,呵呵呵\n\n
34669,703,钟为民,2017-01-19 02:28:29,22,28,6,我们小组秋冬的展示都是第一名，然而这并没有什么卵用，我3.9，我室友4.8，我不知道这是怎么打出来的
35901,703,钟为民,2016-11-10 08:48:27,82,162,80,没前面得人讲的这么差，他是一个挺爽气的老师。我看下面夸他的评论全被点灭了，觉得很不客观。如果评论一边倒，那么这个时候最需要我们去客观的思考，这次的美国大选不是说明了这个道理吗？\n\n当然了，我给他高分，主要还是因为他夸我帅，hhh开玩笑的。
35945,703,钟为民,2016-11-10 09:00:53,0,6,6,还是可以的\n\n
38647,703,钟为民,2017-01-18 08:28:21,2,11,9,感谢老师在人生路上的帮助...虽然我被绩杀了..................
39118,703,钟为民,2016-12-25 05:05:19,7,14,7,就是一只老狐狸   笑面虎   选他课的人别被他最开始的笑呵呵给骗了   他这是处事圆滑      这种人还来当老师  笑死\n\n
39597,703,钟为民,2016-12-26 02:53:07,8,22,14,奉劝各位一句，没上过的千万别选，预置的能退便退，惹不起一定要躲得起。此等大佛，非浙大能容得下的。给分低还能讲的头头是道：绩点不重要，别太看中了，成绩出来了别太关注……
39662,703,钟为民,2016-12-27 02:06:00,-1,5,6,俩次旷课平时分就没了是怎样的一种体验。
40307,703,钟为民,2017-01-02 07:08:37,2,6,4,这个老师事好多！！还各种不知道怎么做的作业！！
40309,703,钟为民,2017-01-02 07:13:39,-2,0,2,。无话。
40337,703,钟为民,2017-12-20 09:07:48,16,32,16,一个忠厚的共产党员，评分与绩点无关
40355,703,钟为民,2017-01-03 04:39:33,1,1,0,_(:з」∠)_
41003,703,钟为民,2017-01-17 09:59:05,2,6,4,给分不错
41330,703,钟为民,2017-01-17 08:20:23,16,25,9,小组展示第一绩点3.3？
41468,703,钟为民,2017-01-25 11:34:37,-9,11,20,很好的老师  那些绩点低的人自己都说上课自己上课水手机  还想要绩点？自己不努力怪别人？能要点脸？这群垃圾真是浙大教育的悲哀。一个个精致的利己主义者。
41469,703,钟为民,2017-01-17 11:38:01,-4,4,8,问问你自己你认真努力了吗  平时上课和考试你是认真的吗\n\n
41708,703,钟为民,2017-03-01 11:11:38,3,8,5,ljlj
42710,703,钟为民,2017-01-15 03:11:00,3,13,10,麻烦大家举报一下那位说什么精致利己主义评头论足的大手子，人类之光靠装清高提高逼格 怕不是洗地洗习惯了 我建议别和社会人接触了 想清高一辈子就别特么上大学 这个世界太污浊容不下
42762,703,钟为民,2017-01-15 04:58:33,3,7,4,垃圾，白费时间
43942,703,钟为民,2017-01-17 06:49:43,4,10,6,装逼男，绩点杀，给他一分我都觉得太多?
43944,703,钟为民,2017-01-17 06:51:04,3,7,4,给分超低
43951,703,钟为民,2017-01-17 06:58:49,5,13,8,思修：不点名但是会按小组来坐，别旷课，老师虽然表面不说但其实知道的，基本上旷课一两节平时成绩就不会太好看。秋冬一共两次论文四次展示，期中期末展示小组互相打分。最后一节课老师发了巧克力。作业好好做绩点不会差的（其实我们组也并没有多认真…不过最后绩点出来还是比我们预想的高呀。之前也是看了查老师的评价，所以对老师的印象可能不是太好。但后来我们组有个女生手倒水的时候被烫伤了，钟老师很细心地发现了还马上让她去校医院、及时涂药什么的，在那之后就对老师好感倍增了
43970,703,钟为民,2017-01-17 07:17:03,19,63,44,为什么都说绩点低 为什么都说老师不好呢\n\n事情很多吗 还好呀 这些量是合理的呀\n\n不管怎样 老师人很好很可爱啊\n\n最后一节课还给大家发巧克力\n\n给分也不差啊 这么说吧 我平时分成绩班级中等 最后思修考试也差不多中等吧 最后成绩出来 绩点4.2 反正超出我对这门课的预期了 比心老师
43978,703,钟为民,2017-02-24 07:21:50,-3,5,8,思修给分并不低，平时到课小组作业好好做考前看看书就好
43997,703,钟为民,2017-01-18 03:50:58,0,12,12,为什么给阿钟老师分这么低？思修上的很好啊，而且给分也很不错。感谢钟老师。
44018,703,钟为民,2017-01-17 08:10:04,9,13,4,给分低
44021,703,钟为民,2017-01-17 08:17:33,5,8,3,绩点呵呵哒
44055,703,钟为民,2017-01-17 08:47:28,0,8,8,钟老师人很好，给分也很棒！
44088,703,钟为民,2017-01-18 08:03:00,3,10,7,给一分是因为没有零分。一门思政类通识把学生均绩拉低那么多我也是服。
44129,703,钟为民,2017-01-17 15:18:15,-3,8,11,思修4.8。当组长 平时积极点 老师真的很不错的\n\n
44130,703,钟为民,2017-01-17 10:03:08,-2,3,5,老师很好，绩点不用看了
44136,703,钟为民,2017-03-05 11:29:29,-2,10,12,给分真的很好
44257,703,钟为民,2017-01-17 13:19:31,5,11,6,座位是固定的，老师讲课很认真，又红又专，就是有点枯燥，不过我不苛求。平时事不多，我也没什么突出表现，最后绩点3.9，我个人是觉得还好啦。老师挺亲切的，最后一节课还发了巧克力，是我所有老师里面唯一一个。
44295,703,钟为民,2017-01-17 14:26:11,-2,3,5,我拿的绩点意料之外的高。但是讲道理老师上课真的超级形式主义，只能说上他的课还是能拿到高绩点的，给后来人一点安慰吧。
44398,703,钟为民,2017-01-17 17:55:23,3,6,3,很明显是杀 改过自新了啊......\n\n
44426,703,钟为民,2017-01-17 23:30:28,0,4,4,思修期末考好好看书选择题做得好的话分数也还不错。
44452,703,钟为民,2017-01-18 00:20:49,23,29,6,好的老师在于，你的付出和你的收获成正比。坏的老师在于，你的付出和你的努力差距甚大。公正地说，钟确实有一定的对于实事的分析能力。但你作为老师，对学生的负责程度是不是过分了。
44463,703,钟为民,2017-01-18 00:41:03,0,8,8,本来已经做好了绩杀的准备……但是最后4.5……在小组展示并不理想的前提下，觉得这个给分好神奇？不懂是不是因为是小组长还是其他……
44479,703,钟为民,2017-01-18 01:01:22,3,9,6,之前一直以为老师是绩杀 还很忐忑 但是老师人很好 还组织我们去良渚博物馆参观 上课氛围很融洽 虽然事情稍微有点多 但是最后给分居然很厚道
44494,703,钟为民,2017-01-18 01:28:06,-2,4,6,思修绩点简直了。这种课绩点这么低真的没谁了
44572,703,钟为民,2017-03-09 01:57:11,0,8,8,怎么说呢，钟老师的思修没有我想象中、你们口中那么的绩杀。你想要收获一个好成绩不容易，但是并不是难如登天，要有付出，加上运气（辣鸡正态），绩点应该不会差到哪里去。钟老师的为人真的没话说，讲课也不错（读宪法什么的还是要吐槽一下）。总结一句，客观看待吧。
44586,703,钟为民,2017-01-18 03:39:57,1,9,8,很有意思 还会去之江参观 4.5 开心
44592,703,钟为民,2017-01-18 03:43:08,0,7,7,老师给分差么，我们组展示第四最后好多4.5啊，感觉老师还行啊，虽然不喜欢思修课，但是老师期末还发了巧克力
44632,703,钟为民,2017-03-14 02:37:18,-5,5,10,唯绩点论？？
44772,703,钟为民,2017-01-18 08:24:28,5,31,26,老师很好，还带去参观之江，考前看看课本，最后?点4.5。不太懂楼上那些人，自己不看书，还要怪老师。老师之前说了好多次要看看书，自己不听，不努力，有什么资格说老师不好。成绩出来就会说老师不行，也不看看自己的努力配不配得上一个好的分数。虽然上课读宪法，但人真的很好。
44955,703,钟为民,2017-01-18 15:18:24,5,13,8,不明白大家为什么不喜欢这个老师呢，挺好的呀，给分也还可以，而且会带我们去之江送我们巧克力，展示课也不错，比很多思修老师都好呀
44999,703,钟为民,2017-01-18 18:44:46,-2,4,6,这位老师很有思想，用心领悟，你能学到很多。这种自主探究型的学习过程，会教给你许多，也会给你带来几个真诚的朋友。老师待人和蔼，并且给分也很好。
45024,703,钟为民,2017-01-19 00:12:15,1,5,4,我觉得老师很好的啊…事情和别的老师比也不算很多吧，最后一节课还给发巧克力，平时稍微走点心绩点就会好啦
45672,703,钟为民,2017-01-20 02:34:36,-2,3,5,不错！！
45801,703,钟为民,2017-04-20 03:02:10,2,6,4,绩点全凭运气吧。同组同学绩点一点也不同
45865,703,钟为民,2017-01-20 07:58:50,-2,4,6,阿钟讲课很有趣^_^，给分水水哒，好评
45950,703,钟为民,2017-01-20 09:41:33,0,7,7,绩点出乎意外地好好好好好好\n\n大家不要怕啊啊啊啊啊
46089,703,钟为民,2017-01-20 15:04:50,3,8,5,无怨无仇这绩点也是低的没谁了
46846,703,钟为民,2017-01-22 12:45:05,6,13,7,绩点随机生成
51455,703,钟为民,2017-06-06 01:29:04,0,2,2,给分很好 期末考试要好好写
51854,703,钟为民,2017-06-22 09:11:56,6,8,2,每节课必点名，上课状态和给分关系不大，没翘过课不过也没听过课4.5，不过也有些同学惨不忍睹的，有挺努力的同学70。。不过大部分同学见到的给分还是挺不错
52298,703,钟为民,2017-06-18 02:51:32,-3,1,4,老师的课还是比较水\n\n我们小组展示是全班倒数第二\n\n原本以为会给分超差，结果绩点4.5。。。\n\n其实老师是一般，感觉主要靠考前刷题和翻书。。。
52356,703,钟为民,2017-06-19 03:54:07,1,3,2,超级垃圾
52379,703,钟为民,2017-06-19 08:38:51,6,8,2,楼上那帮舔这个老师的就是典型的高分笑嘻嘻，低分妈卖批。你去问问上他思修的大部分同学，绝对存在大量付出和得分不成正比的情况。所以我给他1分只能说是没0分。
52625,703,钟为民,2017-06-21 15:05:47,0,1,1,还好啊
52655,703,钟为民,2017-06-22 03:29:41,0,5,5,4.5
52712,703,钟为民,2017-06-22 09:18:18,8,11,3,行策课每次都到，学生手册96分通过，论文好好写，期末考论文写了2页半，在群里怼了一下，质疑那个评分标准，然后绩点3.6，嗯，没错，一定是我哪里做错了。
52720,703,钟为民,2017-06-22 09:54:19,0,2,2,至少感觉老师讲时事还是挺有趣的…
52722,703,钟为民,2017-06-22 10:00:34,10,12,2,形策几乎都背了写的完完整整，就作文破了老师的“形式主义”写了两张多几行，就给我2.7？！作文没写完的还有3.6呢，感觉我如果不写作文分数可能更高。被正态。
52725,703,钟为民,2017-06-22 10:08:23,2,7,5,形策：尽管我在划水，最后考试也有点糟糕，但老师还是给了不错的成绩
52734,703,钟为民,2017-06-22 11:01:24,6,7,1,形策课可选，思修不建议
52735,703,钟为民,2017-06-22 11:10:56,6,10,4,讲真我没觉得有楼上各位说的这么差的啊，挺好的老师，形策最后给分也真的很给面子，班里上四的也很多。想说不认真去做布置的任务考试前不复习的考得低并不能怨老师给分不好。
52942,703,钟为民,2017-06-23 22:31:09,5,8,3,不错的
53015,703,钟为民,2017-06-24 15:50:25,6,9,3,其实我们抱怨的并不完全是自己给分低呀，如果所有人都只拿3-3.9那就没什么可期待可抱怨了，但是正因为别人家的4.2和自己家的2.4同时存在才会有不满呀。\n\n况且这种思政课努力真的与成功是不成正比的，个人已经被思政课杀3次，已经没有抱怨的欲望了。\n\n以及如果消息不错的话，以后很多地方更关注的是主修专业绩了，so just let it go
55593,703,钟为民,2017-07-02 03:47:06,63,71,8,钟老师的形策课上溢满的“中国一片大好、中国未来一片大好”
58132,703,钟为民,2017-08-04 11:11:33,3,5,2,还好吧，挺有意思的
58862,703,钟为民,2017-09-18 06:03:39,3,5,2,超级好
59034,703,钟为民,2017-09-19 07:13:48,4,10,6,没有评论里那么妖魔化
59614,703,钟为民,2017-09-25 02:07:51,19,30,11,老师很和蔼 还面带笑容的讲课 看了评论说老师不好 我觉得其实还可以的，而且在中秋节前夕给我们发了月饼 个人觉得老师不错
59799,703,钟为民,2017-09-27 05:20:31,1,1,0,挺无语的
60365,703,钟为民,2017-10-18 06:47:51,0,1,1,还是不错的
60497,703,钟为民,2017-10-22 12:32:49,0,2,2,拖堂，给分超低
61882,703,钟为民,2017-11-21 11:03:53,0,0,0,感觉还好  还没有评过分不敢断言
61975,703,钟为民,2017-11-22 03:59:06,-2,0,2,感觉超和蔼的老师
63230,703,钟为民,2017-11-29 10:28:07,1,2,1,大声读宪法。。。其他的没印象，只有前面的小组展示比较有意思
63473,703,钟为民,2018-01-23 12:25:44,3,3,0,辣鸡辣鸡\n\n
63628,703,钟为民,2017-12-11 01:21:36,1,2,1,不明白为什么做分享和展示的人在念自己材料的空档里抬头看的都是老师而不是底下坐着的同学，您是讲给谁听？
64358,703,钟为民,2017-12-23 02:18:59,2,2,0,讲问题很片面，很不客观，一天到晚就是中国怎么怎么好，还让我们都不要出国留学了，无语。可以说浙大别的老师的课再枯燥我都会听，只有他的课我从来不听，都是官腔子，感觉没什么真才实学，很多理论都是胡说八道。
64514,703,钟为民,2017-12-25 00:51:18,2,3,1,单单根据美国宪法修正案仅修改27次就说美国法律不够与时俱进有失偏颇吧，而且说“中华民国现在在台湾”？思修课的开始言辞这么不准确也是醉了\n\n
64535,703,钟为民,2017-12-25 03:50:27,2,3,1,屁事真多
64557,703,钟为民,2018-01-23 01:56:45,8,8,0,上课读宪法，一次实践作业一次主题展示一次读书分享一次论文加展示。课程任务轻重还行，组员配合的话还是很顺利的。上课有时会发吃的，称自己钟爷爷蛮可爱。但可能是课程缘故，确实觉得讲得有一点红专空大，逻辑感不是很强。
64702,703,钟为民,2017-12-26 14:59:00,9,10,1,其实我们都希望把思修课从“水课”的堆里拯救出来，可是设立这门课的初衷就是类似于设样子给领导阶级看的，说白了就是“你校不开思修课，人家都开，就说明你校不爱国”。所以说无休止的PPT展示正是授课教师不知道该讲什么的一种体现。思修课本，我看不是给咱们看的，是给领导看封皮的，印刷那么些书，浪费多少纸张？而且据我观察课上能认真收看PPT者(不含评委)不足30%。其初始方向就偏了，难道还能从其他形式的微小弥补来使思修课达到数分、线代的抬头率吗？
64799,703,钟为民,2017-12-27 07:20:06,2,7,5,大爱老师，来刷高分
65676,703,钟为民,2018-01-08 07:20:40,5,14,9,老师讲的很有趣，有时也很幽默。老师还会发月饼，棒棒糖等等。真的超级好，一个值得尊敬的老师o(^o^)o
65835,703,钟为民,2018-01-09 12:44:35,13,23,10,其实觉得还好了，不然思修课还能怎么上呢？不都是酱紫无聊水水的吗？任务量还算OK，一篇个人读后感，一篇小组读书报告，两次小组展示包括一次课外实践，跟别的班比起来真的挺不错的了。老师人真的不错，反正就伟光正啊，有些话听听就好也没必要抓着不放。今天刚结课还没考试也还没出成绩，并不是想吹这门课这个老师有多好，只是想说明，对于一门思修课一个思修老师来说，我觉得没什么黑点。
66448,703,钟为民,2018-01-16 13:40:27,1,4,3,呵，垃圾。建议大家选题贴合老年人思维，毕竟打分很主观。而且一定要抢着当班长（划重点），福利不浅分还高。展示的时候班长不好好把握时间，最终吃亏的是最后几个组。
66449,703,钟为民,2018-01-16 13:41:46,0,1,1,。。。
66476,703,钟为民,2018-01-17 02:37:15,-4,1,5,除了事情略少以外，其他都很恶心。\n\n没什么真材实料，然后小组展示更是哔了狗。
67808,703,钟为民,2018-01-23 00:59:38,-1,2,3,分数十分良心……
68187,703,钟为民,2018-01-22 17:03:23,0,1,1,觉得老师上课还好啊，我们小组展示不错，平时我比较水……没想到最后居然有了4.5，十分好评hhhhh
68198,703,钟为民,2018-01-22 22:38:20,-2,2,4,认真展示\n\n裸考\n\n当组长\n\n4.8
68206,703,钟为民,2018-01-29 21:05:38,0,2,2,给分有点问题，但老师人很好\n\n
68213,703,钟为民,2018-01-23 00:06:00,-2,0,2,除了当组长和班长估计分会还可以\n\n其他的不管你付出再多，绩点也不会高。\n\n绩点瞬间被拉低。\n\n不可否认老师人不错，但是，就这样啰
68217,703,钟为民,2018-01-23 00:17:05,0,0,0,老师很好啊，上课还有吃的，任务不重的，思修真的是很欢乐
68218,703,钟为民,2018-01-23 00:20:47,-2,0,2,平时上课很水，没怎么听过，老师讲的也一般般，会让你朗诵宪法，跟其他思修班级要拍什么微电影比起来，事情不算多吧，就是小组大概展示很多有4次。我们小组表现不咋地，我也不是组长最后绩点4.2，期末考还是挺重要的。不过我是裸考
68219,703,钟为民,2018-01-23 00:21:35,0,0,0,老师人挺好的 但是不是组长和班长的给分真的不怎么样
68220,703,钟为民,2018-01-23 00:27:21,2,2,0,老师人其实不错，但我思修做的不比同学少，，最后比老师的均绩还低，努力与付出不成正比，有点失望
68223,703,钟为民,2018-01-23 00:44:30,1,1,0,虽然事情不多，但是思修拉低了我的均绩
68227,703,钟为民,2018-01-23 01:16:19,0,1,1,老师挺好玩的呀
68229,703,钟为民,2018-01-23 01:17:34,2,4,2,给我们发过月饼 黑糖话梅糖 可以说是非常可耐了 就是让全班一起大声朗诵宪法有点迷……
68239,703,钟为民,2018-01-23 01:27:29,3,3,0,绩点真低。。。
68247,703,钟为民,2018-01-23 01:34:58,19,21,2,小组里我做了最多的事情，最后绩点3.3？？？为什么比别的组员低了0.9?？？？付出和努力不成正比，这就是思修？？？？
68270,703,钟为民,2018-01-23 02:10:36,2,4,2,很和蔼的老师，给分也还行，平心而论查老师不应该这么低。
68275,703,钟为民,2018-01-23 02:19:32,2,7,5,第一门绩点上4的学科，感谢阿钟叔
68276,703,钟为民,2018-01-23 02:21:37,2,3,1,三观很正 道理很多 人还不错 绩点没狗 主要靠考试 绩点差的可能是考试没复习 跟你说不用复习的都是假的 和你说不用刷题的都是骗的
68279,703,钟为民,2018-01-23 02:22:31,3,4,1,阿钟叔超好啊！讲课讲的很有趣，平心而论事情也不算多，还会给我们发糖发月饼吃，真的是以为超温暖的老师了！给分也真的还不错！
68281,703,钟为民,2018-01-23 02:26:02,3,4,1,老师还蛮可爱的，会给我们发月饼发糖，事情不算多吧，最后考试裸考但还是拉高了一把均绩。可能思修课本身可能就不太吸引人吧，但上课好好听的话还是能学到一些好东西的。
68282,703,钟为民,2018-01-23 02:26:25,0,1,1,给分很好！上课还会发东西吃！！！跟其他思修课拍微电影比起来事情真的是很少了！两次展示一篇论文一篇读书报告！真的很喜欢钟爷爷！
68283,703,钟为民,2018-01-23 02:27:51,3,4,1,其实我个人觉得老师上课蛮有意思的，同时老师也是个蛮好的人，会发月饼发糖，让我们读读宪法有点蒙吧，给我的分数相当的高但是给我组员的分不高，都是一个小组的不知道为什么差距有点大，可能差在期末考吧，要是选老师的课可以尝试一下当个组长收获蛮多的，认识了很棒的组员，但是展示一定要新颖啊，总之谢谢老师给我那么高的分数
68309,703,钟为民,2018-01-23 03:09:11,5,8,3,我记得老师考前谈到我们的论文，说到某某同学的论文写的很认真，写了多少字，虽然论文不一定好但是至少态度很端正啊，然后我们小组展示还是第三，然后我考前刷了那么多选择题，最后思修绩点还是有点期待的，最后3.3，拜拜，不说了，，谁选谁知道。
68413,703,钟为民,2018-01-23 07:09:23,2,3,1,不点名，但会分组坐。我觉得吧，其实可以不要只想着恶竞，踏踏实实上课，考试认真对待，给分也还好。
68579,703,钟为民,2018-01-23 11:34:10,0,3,3,中秋的时候发了月饼，最后一节课发了棒棒糖，一人2个，给老师比个心。就很普通的组长绩点4.5组员绩点都上四了……讲真我觉得读宪法还行，没什么值得嘲讽的点吧。
68599,703,钟为民,2018-01-23 12:42:47,9,10,1,真的，到校绩点最低的一门课，真的本来以为就是努力就会有收获，这个分数，呵呵，写论文的时候肝到不行，而且完全不知道他是根据什么给分的……
68604,703,钟为民,2018-01-23 12:51:13,0,1,1,给分超高\n\n围笑
68616,703,钟为民,2018-01-23 13:06:10,2,6,4,绩点超高，认真做的话给分就好。我组长，4.8
68622,703,钟为民,2018-01-23 13:13:07,0,4,4,钟叔叔的课很放松很温馨有家的感觉啊啊啊啊。\n\n还带我们去之江玩，课程结束还有小礼物。钟叔叔的课是唯一我敢展示的课。疯狂打call。重要的是绩点高！！！还好当初没退
68627,703,钟为民,2018-01-23 13:16:52,2,6,4,给老师打爆电话！！！自称钟叔叔 人超级好 第一次上课就建群发红包 还自掏腰包包车组织大家去之江校区 上课乐呵呵的 作业也不多 小组展示分不高 但是最后绩点超棒！！！
68635,703,钟为民,2018-01-23 13:47:23,2,4,2,认真写论文，参与小组讨论与演讲，期末听钟叔叔的话绝不刷题，不是组长，最后4.8。讲真，钟叔叔的思修课跟一般老师的思修课真的不一样，内容丰富，情感真挚，没有官话套话，那感觉上过才知道。总之，为钟老师点赞！
68639,703,钟为民,2018-01-23 13:56:32,-2,0,2,老师真心是好老师，考前乖乖听话看一遍书，选择题简答题很多内容都可以答上来。老师上课总是笑眯眯的很和蔼。
68640,703,钟为民,2018-01-23 13:58:20,-2,2,4,老师讲的特别好   只要展示和期末稍微走点心  绩点也还是不错的 （真的不知道为什么这么多人说老师是绩杀  自己一直缺课不认真做作业还想着拿高分   不是自相矛盾吗）
68652,703,钟为民,2018-01-23 14:22:59,-2,3,5,笔芯！！！！！！！！！！！！！！！身处某工科反恐专业压力真的好大，思修绩点真的赞啊！！！！！！！！！！！！！及时雨，感谢，笔芯.上课还会发糖之类的，挺有趣，话题分享也能够从别人那里收获不少，感动！
68658,703,钟为民,2018-01-23 14:30:55,-2,4,6,我觉得老师还是挺好的 虽然讨论课有点烦  事情也不是很多吧   反正觉得这种课也是水不了的   最后一节课会给我们发糖  平常还会在群里发红包   要想绩点高的话小组展示一定要用心的   刚出分4.8  可能因为绩点比较高所以好话说的比较多   但老师挺不错  没有前面说的那么不好
68659,703,钟为民,2018-01-23 14:34:46,-2,1,3,老师人挺好的 认真做展示应该不会差
68671,703,钟为民,2018-01-23 14:58:07,5,6,1,我大概是组长里得分最低的了\n\n[手动微笑]
68672,703,钟为民,2018-01-24 02:49:38,9,10,1,其实那些说好的同学大部分是绩点高的，上4的，是，老师确实感觉亲切还会给我们小福利，但是最后小组展示在期末评分占比很大的啊，小组展示第一第二名的同学竟然比不上后面几名的，被绩杀为3左右，在小组中也不一样尽心尽力做PPT的同学3点几，不怎么参与的反倒上4了，这到底是怎么个道理，付出与回报不成正比，要知道大展示占比50%啊，正态分布也不是这样的啊？真是搞不懂。。。
68673,703,钟为民,2018-01-23 15:01:04,4,5,1,上课偶尔想睡觉，但是老师还是挺有激情的，会发吃的，会谈人生谈理想，感觉挺有收获，给分其实感觉所有思修老师都差不多的吧，一半靠修为一半靠运气
68694,703,钟为民,2018-01-23 15:38:06,-2,1,3,老师还可以，这次给分也应该挺公正的，但是均绩3.8不符合一贯4.0的风格。还有……这是第一门让我掉均绩的课，所以一丢丢难受
68696,703,钟为民,2018-01-23 15:39:45,144,178,34,上课固定座位，算是点名吧\n\n一个学期一份读书报告，一次课外活动，一次论文，不算太多\n\n给分很厚道，\n\n从我的角度给点建议的话，你读书报告不要往平凡的世界扎堆，知道你喜欢，但实在是太滥了，自我感觉良好，看到给分又喷，不如沉下心看部没看过的，答主看的毛泽东传，这或许是绩点的一个保障吧\n\n另外，讨论题应该是不变的，选上这门课的同学千万别往死刑上扎堆，我们思修展示，16个小组10个死刑废除的利与弊，，醉了\n\n总之，虽然钟叔的思修课的确很水，但你自己不能以水水过的态度应付，比如说论文，你选了死刑这个好入手的，文章看上去字数多，有个二三万字，实际都是杂七杂八的堆叠，是在逃避思考，逃避探究，这怎么能给高分，\n\n很多组的文章都是copy来，copy去的，自己的思考就显得尤为重要，记得我们小组讨论到晚2点，那个累啊，，，\n\n言尽于此，如果觉得对你有帮助，点个∧让更多人看到吧，\n\n助各位满绩了(ง •̀_•́)ง
68697,703,钟为民,2018-01-23 15:41:42,2,3,1,小组展示成绩其实比较差，但不知为何我分数出来还行……可能是读书报告和考试这种个人项目发挥得不错？老师挺和蔼的，对学生很好，事情比起别的班来也不多，之前预置没有退感觉不后悔。
68732,703,钟为民,2018-01-24 03:24:54,6,7,1,给分超级低了。。。上课好好听了，题目刷了很多，绩点却刷刷刷下去了。。。上课展示形式还是不错的，还去之江玩，也有给发好吃的糖果。就是评分形式不太好，就让学生打分，但是没有具体的规则。就拿时间分数来说吧，明明同样的时间，不同学生给的分数还参差不齐。学生评委说实话也没有很认真地听，看到好几个评委全程水手机，最后抬头看一眼打分，打出来的分数也很难说准确吧。希望以后能调整一下这里吧。人真的很和气，给发小零食！！！
68736,703,钟为民,2018-01-23 16:26:24,1,2,1,老师挺好的，会自己掏钱买很多吃的给同学，然后绩点的事情，每个思修老师都差不多的啊，都要正态分布，然后要知道世界上肯定有人比你更努力的。
68748,703,钟为民,2018-01-23 18:36:14,3,4,1,其实钟老师的课还好啦 最棒的就是他给每个组展示的时间超级长 其实一整个学期听下来觉得很棒啊 当然是挺需要花时间准备的 老师会发糖会发月饼 据说以前是绩杀感觉现在好很多了 认真准备了考试 最后绩点很好 还是可以选哒
68749,703,钟为民,2018-01-23 19:01:36,0,1,1,夸我帅。。。
68752,703,钟为民,2018-01-24 08:44:44,1,5,4,老师还好吧。上课比较客气，课上任务不多，可以水过去。做了一学期组长，两次课上展示，秋冬末的小组展示，一共四次还是比较多，尤其是我们组基本上冬学期的展示都赶到一块了。最后考试前我刷了点题，看了看书，考试感觉还好，最后的5.0还算不错。钟老师有句话说的不错：思修课并不能说明一个人真正的品德，成绩好不代表你品德有多么好，成绩差也说明不了你有什么问题。
68760,703,钟为民,2018-01-24 00:04:39,-3,1,4,老师人不错，上课中规中矩，事情比较多，感觉并不绩杀。
68791,703,钟为民,2018-01-24 01:59:11,1,2,1,钟老师的课我觉得很不错啊，老师人蛮亲切和蔼的，没有评论中说的那么可怕，课堂上比较注重由同学来展示，最后我的给分也很棒，感谢钟老师!
69118,703,钟为民,2018-01-24 08:42:35,-2,2,4,我觉得完全没有之前说的乱给分啊，只要上课按时到平时任务认真做，就真的可以拿到满意的分数，我4.2，觉得对得起自己的努力，一个朋友4.5，我感觉他的确比我做的好，给分合理，而且对我们很和蔼。9分
69184,703,钟为民,2018-01-24 09:42:58,-5,3,8,评价里的问题都没有啊，上课不听，小组展示也一般，不是组长，4.5
69301,703,钟为民,2018-01-24 12:25:46,3,4,1,那么努力，最后给分那么低，给分真的跟迷，胡给的吧，烦，给一分就算好了
69364,703,钟为民,2018-01-24 14:21:36,-2,0,2,挺好的老师 虽然平时事情有点多 但是好好听话写作业就好了！！！！
69422,703,钟为民,2018-01-24 15:38:14,-2,0,2,老师人很好。不过大多时候都是让我们在小组展示啥啥的，只有小组论文，给分不错，开心。
69567,703,钟为民,2018-01-25 03:59:51,5,5,0,绩点差！！觉得自己在思修上平时也花了时间，因为有小组展示，但是绩点真的超差！！
69570,703,钟为民,2018-01-25 04:04:39,0,2,2,老师人挺好=给分=最后考试成绩我也不知道=一般吧=
70096,703,钟为民,2018-01-26 05:49:22,2,3,1,很欢乐的思修课啦\n\n上课主要都是小组展示...\n\n钟叔中秋会发月饼期末还发糖\n\n给分也好
70823,703,钟为民,2018-01-27 14:38:11,-2,7,9,典型的高分笑嘻嘻，低分mmp。看老师评价老师就是看分数是吧，整天纠结那一点点绩点自己格局很高喽?
71084,703,钟为民,2018-01-28 02:41:39,0,1,1,老师人好，不在乎什么评分之类的，用心上课，虽然评分不高，但是你只要稍微用点心，给分都很棒
72815,703,钟为民,2018-01-31 06:14:41,0,1,1,绩点跪烂
73094,703,钟为民,2018-02-01 01:59:17,4,4,0,老师人很有趣，还会给我们发吃的。\n\n给分肯定有高有低，不可能人人上四。
73844,703,钟为民,2018-02-03 08:58:35,6,6,0,夸老师好的很多是水水过绩点还高的，说老师不好的是付出了很多最后绩点哔了狗的，老师给分真的有点随意
74023,703,钟为民,2018-02-04 09:18:50,4,4,0,思修课讲的内容大体就那个样子，只能说小组展示非常一般上课每节到但不听课考试认真复习拿了4.5，感谢老师！还会发月饼发糖，老师人也很亲切的。
74709,703,钟为民,2018-03-05 08:37:56,4,4,0,虽然不点名，但位子是分组做的，每到的话一眼就看出来了。事情其实也不算很多，每次课题用心做就好啦，ppt做的好看点，讲的人生动点，课还蛮轻松的，（我还睡了两节课，因为是早课太困了），期末还发给我们糖吃，最后绩点4.5也觉得还行（感觉比起其他人的另一个老是打零分重做的老师好多了）
74732,703,钟为民,2018-03-05 10:25:29,5,5,0,由于坐在第一排，所以整个学期都没能怎么水手机，不过，听课的感觉还是不错的，尤其是开始的每日话题小组展示，可以了解到许多有意思的知识，除此之外，书认真阅读了读书报告我也认真写了，可能因此比同小组同学的分高了很多，值得一提的是，小组组员之间分工合作很完美，也很有收获，总之，蛮有意义的一堂课。
74819,703,钟为民,2018-03-06 04:21:22,0,2,2,月饼很好吃，绩点不错
75076,703,钟为民,2018-03-07 08:32:02,2,2,0,还行，最后给分还可以，还发糖给我们
75274,703,钟为民,2018-03-08 10:46:04,4,5,1,我觉得..上思修感觉挺好..激情思修..
76684,703,钟为民,2018-04-18 08:24:52,3,6,3,人真的超级和蔼可亲，很幽默，建群发红包、中秋发月饼、包车去之江、课上读宪法……总之，超级好的。没有评论里说的那么妖魔化，给分也可以，好好做就行了，浙大总会有人被正态的，不挂就好了(哈哈哈哈哈哈哈哈哈隔)
78354,703,钟为民,2018-05-11 05:03:50,1,2,1,给分没有依据，付出收货完全不成正比
78474,703,钟为民,2018-05-12 08:30:15,0,3,3,我真觉得这老师没评论说的这么辣鸡。我觉得老师人很好，而且事情也不多啊。给分还是看你期末考试吧？？反正我上课没什么发言也没做什么展示，绩点也不会低啊。自己好好上课，和老师没什么关系
82262,703,钟为民,2018-07-07 15:06:49,2,2,0,形策春夏学期钟老师基本在出差，是由助教上课。老师人不错，课程事也很少，一次论文，一次期末考。
82297,703,钟为民,2018-07-07 22:26:12,0,5,5,阿钟老师巨好，墙裂推荐啊。人很好啊，假日发红包，中秋发月饼，下雪天还会带大家出去看雪。只要有付出，给分也会很好的。我思修4.8，形策满绩?。这样的老师评分不上9.5真的没天理。
82306,703,钟为民,2018-07-07 23:29:59,2,2,0,形策讲的很有趣 坐第一排的我 每次带了作业到最后也还是认真听讲?
82562,703,钟为民,2018-07-08 13:41:56,2,3,1,真没想到形策居然也能满绩，可能平时时政就关心比较多吧。老师上课也挺有激情，就是有点爱拖堂，形策给分还是不错的，起码这个学期班里4.8-5.0还是有一些的，墙裂建议多看看思考题答案，考试挺有用。\n\n
82601,703,钟为民,2018-07-08 16:20:36,0,2,2,老师人很好，形策课给分不错，还在群里和我们互动。
82689,703,钟为民,2018-07-09 03:25:04,2,2,0,行测给分不错
85872,703,钟为民,2018-08-24 14:42:16,3,5,2,特别烦人
86627,703,钟为民,2018-09-17 13:34:37,0,0,0,好好好
86637,703,钟为民,2018-09-17 15:05:53,7,9,2,石头剪刀布输了没有当成班长和小组长，但是也很愿意认真上课写论文的，求老师别绩杀!尽量仔细看看我们是否努力!不胜感激，老师态度挺温和的。
86682,703,钟为民,2018-09-18 06:11:38,-5,2,7,辣鸡辣鸡
87585,703,钟为民,2018-10-08 00:48:04,11,12,1,维尼的死忠粉
88601,703,钟为民,2018-11-03 09:27:35,8,9,1,我觉得。。。那个小组的志愿者活动真的很鸡肋。。。。周末大家会有不同的事情，也会有人学业压力大，不是所有的时间都应该服务一个很没必要的小组志愿者，还要求必须一组一起。。有必要么
88632,703,钟为民,2018-11-04 15:17:01,6,8,2,课外活动要求小组团体进行同一个志愿者活动。拜托大家都很忙的好吗？其他老师只要有独立做过就好了好吗？\n\n遇到一个啥事都不管的组长，第一节课还表现的特积极，结果后面完全不干事。别的组好歹组长组织一下硬着头皮做了，我们啥都没干。（这个虽然不能完全怪老师，但我现在怨气很重啊啊啊啊啊！）\n\n坐等绩点2.0。
88633,703,钟为民,2018-11-04 15:41:19,10,11,1,破事真多。\n\n一个人就能做的，非要整个小组一起来。结果大家凑不到时间，所有人都没做成。
88863,703,钟为民,2018-11-10 15:05:39,1,2,1,志愿活动欲哭无泪。ppt直接被教做人了。不怨谁，只是刚终于做完了来解压一下。真难，做完感觉不错。
89387,703,钟为民,2019-01-20 05:19:37,27,29,2,班长 你还正常吗？
90608,703,钟为民,2018-11-24 14:06:41,2,2,0,共产党员\n\n
91637,703,钟为民,2018-12-17 02:45:48,1,4,3,傻逼五毛，给了我高分我也要喷死他
91678,703,钟为民,2019-01-18 13:25:57,68,77,9,一个组员的命操着组长的心，最后拿了个非洲人的分数
92398,703,钟为民,2018-12-28 08:47:55,6,7,1,这是我第一次在查老师给差评，给分真的很没有道理还差非常难过。我们小组有几个同学都上4了，结果付出了很多的我和天天翘课请假的一个同学拿了一样的分数。差评不解释，很偏心，遇到了大家一定要换老师！！惨痛的教训，太拉绩点了！
92459,703,钟为民,2018-12-29 07:31:45,6,9,3,痛苦，两节课中间不下课。事情特别多！一学期四次小组展示，还会抽人回答问题，一千字读书报告(认真写了结果说交了就给10分？)无脑五毛，无语，讲的好多话我都听不下去。为什么不能打零分！每节课固定座位来点名，上课不准玩手机。
92738,703,钟为民,2019-01-04 05:31:35,0,1,1,自己体会
93007,703,钟为民,2019-01-07 01:45:09,13,14,1,老师人还好，但是思想没什么深度，很浅薄，就单纯的党一切都好
93060,703,钟为民,2019-01-07 07:27:41,12,20,8,预置的课，早知道退了。\n\n固定位子，每节课拿着本子看谁没来。【真tm培养奴性】\n\n玩手机，睡觉就会被请起来评价一下刚刚同学的展示。\n\n讲课可以说人的精神是暗物质。讲课充斥着一种中国特色社会主义的蜜汁自信，在他的眼里，中国解放银河系迟早的事。\n\n还有一种大男子主义。\n\n没事喜欢在后排转悠，\n\n明明是一门水课，自己没啥好讲的就让同学天天展示。哔事贼多，上课就恶心。\n\n\n\n
93082,703,钟为民,2019-01-19 16:25:43,34,37,3,随机抽签展示，我们组硬生生比别的组多做两次展示。这公平吗？不算这个，非常认真地完成每一次展示，排名第二，最后3.3是不是应该给一个解释？付出和所得不成正比。我想想自己这个学期认认真真做的那么多东西就觉得挺好笑的。真高兴再也不用见到这个大肚子没脑子的老师了，神一般的随性给分。只想说，预置的赶紧退。
93260,703,钟为民,2019-01-08 12:37:11,9,13,4,我觉得不捉弄人、不毁三观的思修老师就是好思修老师。唱不唱赞歌是大环境的事，钟老师人不是坏人。
93274,703,钟为民,2019-01-20 13:50:04,23,28,5,绩点还行，作为组长真的干了挺多活的，这个分对我来说算是合理。（老是装死不干活的组员被绩杀了，一阵暗爽）
93318,703,钟为民,2019-01-09 04:06:36,28,29,1,思想无深度，我觉得我也会上思修课嘞!以后我当思修老师，让同学们准备准备帮我讲课，自己在后面转转，水一节课真开心!绩点全靠学生打!上这门课千万别认真，认真就输了，不说了。谁选谁完蛋!
93325,703,钟为民,2019-01-09 04:21:43,32,33,1,如果组长很菜那就倒了八辈子霉了！
93396,703,钟为民,2019-01-09 11:45:29,-3,6,9,考试之前客观评论一下，钟老师还是很好的，没有评论说的那么差！
93449,703,钟为民,2019-01-09 18:51:03,-5,5,10,先给个满分，老师人还可以，思修嘛这课本来就这样，一学期终于结束，求老师给分好点
93908,703,钟为民,2019-01-14 08:06:14,0,3,3,感觉挺好吧，至于有人说活动贼多，这是每个思修课都有的吧，宪法课后读，谁知道你读了没。
94114,703,钟为民,2019-01-15 08:04:33,2,3,1,任务说多不多，说少不少，分到小组里其实每个人都不会占用太多时间，但主要还是看小组内部协调如何了，有个好组员很重要。还有说老师记人点名回答问题的，难道按时来上课，尊重同学不是作为一个学生的基本要求吗？一个占有3学分的思修课你想翘就翘想睡就睡，你不分低谁分低？小组展示凉凉的我，希望明天的理论考能给我点安慰
94138,703,钟为民,2019-01-15 09:11:35,0,2,2,老师人很好 \n\n四次展示认真做就有高分\n\n不要说这是一门水课\n\n必修的课里没有水课\n\n有付出就有回报\n\n
94259,703,钟为民,2019-01-16 05:18:17,0,3,3,10分，求善待
94425,703,钟为民,2019-01-16 11:56:57,6,9,3,老师人很好，最后一节课还给我们发红包。自己也很认真地准备每一次作业和展示，出成绩前保佑一下吧！！！
94508,703,钟为民,2019-01-21 13:09:08,16,18,2,呵呵3.3 我均绩被一门政治课拉也是没话讲
94684,703,钟为民,2019-01-17 23:21:51,2,5,3,没有大家说的那么差
94685,703,钟为民,2019-01-17 23:28:07,3,5,2,老师课人很好，事情还蛮多的，虽然最后分数和我预想有差距，但感谢老师不杀之恩！
94690,703,钟为民,2019-01-18 00:36:27,3,6,3,事多，给分好，又红又专
94700,703,钟为民,2019-01-20 16:27:43,-36,10,46,客观公正地说一下，上课不刷手机，好好做展示，好好参与小组活动，这不是思修课最基本的要求吗，为什么会有人认为这是老师一定要给他高分的筹码！我觉得在抱怨老师给分低的时候，是否可以先反省一下自己哪里还做的不好。我相信，老师的评分是公正的！！！
94701,703,钟为民,2019-01-18 02:25:20,3,4,1,给分好诶
94704,703,钟为民,2019-01-21 01:36:32,-158,4,162,绩杀！绩杀！绩杀！我是班长，上课从不迟到，第一次PPT展示小组第一，上课不看手机不写作业，最后91，差一分就能4.8了靠
94708,703,钟为民,2019-01-18 02:38:09,8,8,0,做这么认真绩点这么低 不要说正不正态啥的 人家老师怎么就能都给高分你咋就这样
94711,703,钟为民,2019-01-18 02:45:12,3,5,2,给分比预料的好
94719,703,钟为民,2019-01-18 03:01:24,2,3,1,Emmmmm 上课固定座位，感觉平时出勤挺重要的。绩点给的不是很好，如果很在意绩点，尽量不要选吧。平时上课还好，老师人也挺好的
94720,703,钟为民,2019-01-18 03:01:49,10,14,4,老师挺好的，跟付出成正比。本以为在平时做的事情老师看不见（PPT 组织小组 问卷之类的），最后也有4.2。可是组长真的很重要，如果愿意承担责任就要主动去组内竞选。我组长就是刚开始好像很积极，后半学期展示和论文从头到尾几乎没出现，线上完全找不到人，组织分锅什么的都是组员自己来，老师还说组长很辛苦有些同学调动不了，呵呵其实是是有些组长调动不了。服了。
94721,703,钟为民,2019-01-18 14:36:36,9,14,5,完全不知道给分标准是什么样的，上课天天说绩点不重要，这就是你随便给分的理由么？
94724,703,钟为民,2019-01-18 03:16:15,2,5,3,老师很好啊 还会发红包\n\n还会做冬日约定 让我少玩了很多手机? \n\n
94728,703,钟为民,2019-01-18 03:39:32,15,17,2,我只想问问组长和班长的绩点是多少，这种思政课老师能把给绩点的标准公布出来可能会好些。
94738,703,钟为民,2019-01-18 04:22:26,0,2,2,老师人真的很好，上课很认真，事情自然多了，绩点还行
94744,703,钟为民,2019-01-18 12:24:57,-3,3,6,已经没有朗读宪法啦，，同学们放心啦? \n\n
94756,703,钟为民,2019-01-18 05:17:05,0,3,3,大赞阿钟老师
94768,703,钟为民,2019-01-18 05:44:06,0,3,3,上课基本都是小组展示，只要不翘课，期末好好考，拿个4.0+问题不大
94807,703,钟为民,2019-01-18 08:22:05,-2,0,2,上课不能翘，绩点还凑合。
94815,703,钟为民,2019-01-18 08:41:57,-2,0,2,我爱阿钟，哈哈
94832,703,钟为民,2019-01-18 09:36:15,4,4,0,卡绩点了，没啥说的
94840,703,钟为民,2019-01-18 09:56:30,-4,1,5,思修课作业量还行一般，读书报告，实践活动，研究性学习三个。最后组长／班长的分数会比较高，刚开课可以争取一下。
94851,703,钟为民,2019-01-18 12:25:03,-33,3,36,思修5.0，期末考试才是王道
94859,703,钟为民,2019-01-20 14:24:29,-5,0,5,卡绩点了，呵呵
94923,703,钟为民,2019-01-18 12:55:20,-11,2,13,之前看评分只有六点几还很害怕，但是上了钟老师的课真的不错啊，是个很有态度的老师，可水可划。给分是我目前为止最高的，自己都震惊了（*＾ワ＾*）
95082,703,钟为民,2019-01-23 14:17:10,68,84,16,得，合着就是绩点满意的人一个劲得说别人小心眼，不客观。这些人的做人水平是真的让我觉得恶心，以小人之心度君子之腹。没有任何的考证，甚至连对其他同学的评论都没能做到认真读完，就自己脑补出了他人的形象并加以丑化，想必这种人才是真正的将绩点看得比什么都重的人，却又要在表面上苦苦伪装自己，先将给差评的同学戴上“不客观”的帽子，瞧瞧你们的嘴脸，恶臭不堪wwwwww
95102,703,钟为民,2019-01-18 23:24:12,14,17,3,只能说感受到了慢慢的恶意和伪善
95304,703,钟为民,2019-01-21 12:18:18,-24,7,31,真的不知道为什么会有这么多人喷阿钟，有付出就会有收获的，老师有本子记的，还有请假和旷课没啥区别，考前思修书翻几遍，党性
95350,703,钟为民,2019-01-19 08:50:13,-12,3,15,不知道为什么有那么多人喷老师。平时好好听课了吗，上课有没有都到，展示和读书报告好好写了吗，期末复习了吗，书看了吗。反正我是觉得自己分数低也不能总是怪老师吧。感觉老师还是不错的，和学生是比较平等的。还会发红包，让同学自己讲课。。。不能因为自己成绩低就喷老师吧。。。
95456,703,钟为民,2019-01-19 12:09:18,-8,2,10,老师挺和善的，至少给我们分享了一些人生哲理，反正我还没出绩点。做钟老师的班长是件幸福的事。
95472,703,钟为民,2019-01-19 12:35:06,0,2,2,老师很友爱
95595,703,钟为民,2019-01-19 15:57:44,-2,2,4,上课全程划水 感觉事情也不多啊 和其他老师差不多 只要读书报告好好写 期末考之前把书过一遍就行了 最好背一下 书不看就算我是社会主义接班人也只能懵 分数比我想象中高诶 因为我们小组展示都是垫底 但是还是挺好的
95607,703,钟为民,2019-01-19 16:08:49,-5,2,7,虽然思修课上没学到什么考点，但介绍了王阳明的四境界有些意义。本人的绩点给的还不错，就是有点不喜欢他对一些客观的东西加上自己唯心的想法(原来我之前学的都是玄学而不是科学)。
95609,703,钟为民,2019-01-19 16:09:54,-17,4,21,哇塞，第一门上4的课，我也太开心了吧！好像是按小组来算的，我和组长都是4.5本来说老师不好 ，但是绩点真的是超出我的预期了。很开心。读书报告和小组作业我感觉自己做的都不好，希望大家用心做吧。再次感谢老师。而且，说课上的不好的，你会听吗？老师最后还个发红包了，总之，不错啦！
95611,703,钟为民,2019-01-19 16:10:25,15,17,2,组长垃圾不管事情，我操心一切，几乎干了所有活\n\n组长4.5，我3.3
95630,703,钟为民,2019-01-19 16:34:30,47,49,2,感谢老师教会我大学第一课 人生就是不公平 没有为什么
95648,703,钟为民,2019-01-19 22:48:39,-6,1,7,讲的其实ok，给分情况不知道怎么给的，反正我觉得满足
95667,703,钟为民,2019-01-20 00:22:47,0,0,0,绩点...
95704,703,钟为民,2019-01-20 02:25:47,20,22,2,“乡愿，德之贼也。”孔夫子的这句话，我终于信了。看着是个好好先生，实际上就是笑面虎。展示全靠互评，有内容但是不有趣的得分比空洞但是只是为了搞笑而搞笑的小组低很多。根本不管组内分工，付出最多绩点最低。我造了什么孽会遇见这种“满口子假仁假义，一肚子****”的老师？
95729,703,钟为民,2019-01-20 02:50:20,16,20,4,虽然最后绩点3.3，但是我也强忍着怒火，不想喷老师。从来没有迟到，没有水过手机。积极参与小组工作，认真准备每一次展示。我只是希望老师以后能给出详细的评分标准，如果可以的话，可以像大英一样公示平常成绩，这样总比糊里糊涂地好。就算绩点低，但能知道低的原因。这只是我的个人想法。
95732,703,钟为民,2019-01-20 02:58:10,-2,6,8,小组展示全班倒数第一绩点也上了4，谢谢老师，考试一定要好好考
95733,703,钟为民,2019-01-20 02:58:46,32,33,1,红包也救不了我对阿钟的差评
95740,703,钟为民,2019-01-20 03:13:30,0,5,5,认真做全组均绩上4
95746,703,钟为民,2019-01-20 04:24:07,3,5,2,老师的课都是讲中国一片大好，但听多了感觉有点厌倦恶心
95779,703,钟为民,2019-01-20 04:36:44,6,7,1,这种同学评分机制就有问题?
95831,703,钟为民,2019-01-20 06:04:35,-2,1,3,上课水，努努力给分还行
95840,703,钟为民,2019-01-20 06:10:16,12,14,2,想起来了阿钟第一节课说的话:因为不公平，所以更精彩。所以绩点呵呵了?
95842,703,钟为民,2019-01-20 06:16:37,6,6,0,虽然自己干的活超多给分也还好但是真的不推荐这个老师。。。给分严重缺乏公平性
95850,703,钟为民,2019-01-20 06:24:21,2,2,0,感觉还行，就是事情有点多，当组长累死，绩点也还可以。那些平时想水的人可以水，但是考试一定要认真准备，毕竟思修是各班老师助教自己改的。
95871,703,钟为民,2019-01-20 07:09:09,10,12,2,如果组长不干事情，那么负责任的组员一定要在最后交论文的时候换掉组长名字。不然你付出的一切努力都可能被组长拿走。\n\n
95968,703,钟为民,2019-01-20 09:44:58,9,10,1,呵呵了是个人绩点都比我高\n\n
95981,703,钟为民,2019-01-20 10:13:48,-8,2,10,任务虽然比较多，但是好好做会有回报的，小组合作真的很重要
96009,703,钟为民,2019-01-20 11:21:07,-9,10,19,我每天上课看番 ppt做的还丑 ！！最后绩点4.5 欢迎大家选阿钟的课！
96012,703,钟为民,2019-01-20 11:22:48,-11,11,22,我是组长 我组员每天上课看番 ppt做的还丑 最后绩点4.5  小组均绩4.38 欢迎大家选阿钟的课
96013,703,钟为民,2019-01-20 11:21:49,-10,10,20,我组员每天上课看番，ppt做的还丑，最后绩点4.5，我们组均绩4.38，欢迎大家选阿钟的课
96014,703,钟为民,2019-01-20 11:22:21,-9,10,19,我前面那位同学每天上课看番 ppt还做的贼丑！！最后绩点4.5 欢迎大家选阿钟的课！
96015,703,钟为民,2019-01-20 11:21:24,-5,10,15,我们组组员每天上课看番 ppt做的还特特特丑 最后绩点4.5 欢迎大家选阿钟的课
96092,703,钟为民,2019-01-20 12:43:16,4,6,2,事情真的太多了emmmm 志愿者活动读书报告讲课研究性学习 而且作为组长每次报告展示都得自己来（不知道其他组是不是这样的）而且展示时间的打分真是不想吐槽了 超了几十秒分数就被扣光了真的很不合理 最后拿到的绩点还可以 但是真的是花了很多时间换来的 看了一下评论心疼有些做了很多事给分却很低的组员
96095,703,钟为民,2019-01-20 12:45:47,-3,1,4,每个人都有自己的观念和看法吧，不接受也不需要很强烈的反抗。把每个部分都尽力完成好，考前刷刷题库，老师给分还是挺合理的。加油！没如上那么差。（em……根据统计学原理呢，以上评论是自愿响应样本，有特别不满会来这里评价，得分好的同学自然没什么诉求咯）
96200,703,钟为民,2019-01-20 14:18:51,9,10,1,真的扎心辛辛苦苦做了一堆报告展示，每次班级评分都是前几，最后依然绩点爆炸喵喵喵?
96217,703,钟为民,2019-01-20 16:28:07,80,89,9,我从不旷课，不刷其他课作业，很少水手机，不是组长但是认真参与小组工作，期末结果3.3。另一个同小组的同学天天刷其他作业4.5。如果你想水这门课还有一定概率混一个高的绩点，那我强烈推荐这个老师；如果你想认真对待这门课，那请你退掉，因为期末绩点可能让你欲哭无泪。\n\n在此按捺不住怒火，在此说明一下钟老师的特点：\n\n1.原为校保卫科人员，教育水平可想而知。\n\n2.中国形势一片大好，少讲思修多灌鸡汤。\n\n3.小组分享次数较多，期末绩点随性给分。\n\n在此直言不讳，给钟老师提几点建议：\n\n1.取缔抽签分享。根据课程次数安排小组宣讲，不要让某些小组宣讲次数过多而引起不公平的问题，更不要让你随意的态度影响认真学习的同学。\n\n2.进行成绩公示。每次涉及评分的项目结束后都进行公示。期末可以在群里发一个成绩公示表（没有姓名只有学号的那种），让每个同学心服口服，更能证明你不是随意给分的。\n\n3.多进行自我革新。发红包不能让你的课变得生动有趣，建议多学习其他高分思修老师的课，这样才能对得起选上你课的学生，更对得起你浙江大学老师这一名分。
96282,703,钟为民,2019-01-20 16:10:40,19,21,2,底下有些评论真是让人受不了。你水课水到了高分了不起是吗？这样的炫耀有什么意义呢？觉得自己很牛逼是吗，刺激一下其他努力但分还没你高的同学是吗？真的挺恶心的。老师给我的分不低，我上面的话单纯想diss某些同学罢了。其实思修课本来就是水课，没有在听的人怎么评价老师水平？私以为老师是人不错的，又红又专课程性质罢了，上课其实不太过分老师也不会管你。至于给分，确实有点迷。认识的同学3.3，我4.5，但是小组展示我们组是没有他们好的，考试个人认为区分度不大，希望老师以后能公布一下小分吧。
96301,703,钟为民,2019-01-20 17:16:39,-7,0,7,实话说前半学期上课基本都在水手机后半学期老师说了之后再也没有玩过 不过上课确实没怎么听 这也是事实 作业都非常认真地准备参与了 绩点是达到预期的没有太好也没有太差 不过老师的课确实并不算太有意思 高分老师毕竟有道理的 但是思修嘛 想水我私以为也可以
96363,703,钟为民,2019-01-21 01:13:51,-1,2,3,超赞的老师
96381,703,钟为民,2019-01-21 01:49:33,-4,4,8,和其他思修班的老师比起来，钟老师算不错的了。第一节课我坐第一排，然后老师拿我举了个例子…也许这样被记住了吧？最后的研究性学习论文署的是我的名字(我不是组长)，然后思修小组一起做的SQTP是我当组长。做时当然没想那么多，但事后想想会不会是这些让老师没把我绩杀…？仅供参考。
96719,703,钟为民,2019-01-21 09:44:24,-19,1,20,我也不知道4.2是高是低，就这样吧。我上课也没怎么听课
96721,703,钟为民,2019-01-21 09:45:35,3,5,2,水课，没水平，乱给分
96740,703,钟为民,2019-01-21 09:51:59,4,5,1,事情巨多，每节课点名，给分还很玄学
96846,703,钟为民,2019-01-21 10:35:02,23,24,1,思修水了一学期\n\n感觉什么都没听没干\n\n最后上四了\n\n不知道说什么好\n\n感觉有点不公平吧
96985,703,钟为民,2019-01-21 13:55:01,-2,1,3,其实按照老师说的内容保质保量地完成 绩点绝不会低 不过最重要的是结队的时候一定要和班长或者副班长一组 大腿人物
97095,703,钟为民,2019-01-21 16:03:06,3,3,0,班长的评论呢？
97292,703,钟为民,2019-01-22 07:53:16,-8,4,12,"我其实觉的说老师上课没意思有些偏见了:1、你真的会好好听思修课么？2、无聊是老师的问题还是这门课本身的问题？我舍友说她们思修老师分也很低)。其次就打分而言，想问一句说自己不是组长干组长活的同学，你有让老师知道这一点么？有反应过么？如果没有为什么要求老师开天眼知道你私底下的付出呢？我们组长不干活，最后组员将论文上的组长名字改成了我，分数也不低啊。没有想为钟老师""平反""的意思，只是谈谈自己对于评论一边倒的看法。"
97598,703,钟为民,2019-01-22 11:49:16,-39,1,40,啊啊啊4.8！！！！感谢老师！！
97694,703,钟为民,2019-01-22 13:40:00,-2,2,4,一定不能旷课。小组展示就因为超时了一点，整组都凉了，老师说是为了正态的时候好区分……老师人还是蛮好的吧，逢年过节在群里发红包，挺关心学生的，取的班级名字也挺有特色。课的内容就没听过了…
97699,703,钟为民,2019-01-22 13:47:00,-2,0,2,一般般
97863,703,钟为民,2019-01-23 00:28:59,-2,1,3,还可以
98240,703,钟为民,2019-01-23 08:38:49,9,10,1,一门思修拖我绩点呵呵
98243,703,钟为民,2019-01-23 08:41:14,1,3,2,不说了，被卡绩了\n\n
98252,703,钟为民,2019-01-23 08:45:31,16,17,1,一定要当官?
98254,703,钟为民,2019-01-23 08:45:38,-4,2,6,按小组排座位相当于点名啦。老师教的还不错 很可爱的老师。只要你认真去做了，给分自然会好的。
98281,703,钟为民,2019-01-23 09:09:43,15,17,2,谢谢老师让我知道了努力与回报是不成正比的(微笑
98290,703,钟为民,2019-01-23 09:22:29,7,10,3,老师是点名的！！每节上课之前都会拿着一本大本子走来走去，其实就是在看人数。emm...上课的话，比较红，比较正能量，但其实学不到什么特别有用的东西，可能思修课都差不多。要当小组长或者班长，这样成绩会理想一点。我同学，考试卷面60%不确定，最后3.9，说明平时分还是挺关键的叭...评分标准有点迷，感觉运气成分有点大。老师感觉中等水平，不是绩杀，但会卡绩。阿钟属于正常老师范围（个人感觉...
98313,703,钟为民,2019-01-23 10:02:52,15,18,3,明明上课没有玩手机但是他就是会以为你在玩然后把你点起来评价展示还要挂你的绩点 ?全宇宙最恐同的老师没有之一非常让人无法认同他的观点 ? 每一次讲话都带着浓重的洗脑色彩强行正能量 ?  只能说保卫科上来的老师可能就是这样吧
98330,703,钟为民,2019-01-23 10:29:00,-27,3,30,3.3都是被正态下去的，反思一下为什么干不过满绩的吧。
98337,703,钟为民,2019-01-23 10:40:53,12,14,2,"我还能说什么呢。用完成计基综合报告的态度熬夜做完PPT，屁颠屁颠上台展示乐此不疲，然后因为请了病假，果然得到了""理所应当""的3.3。比起那些小组报告什么没做也有4+的人，要怪只怪自己好卑微。"
98503,703,钟为民,2019-01-23 13:53:15,10,14,4,我真的不知道老师是怎么给分的，绩点是真的迷。从没迟到旷课，小组作业也好好参与了，最后成绩……还有，老师的价值观是真的令我接受不能。
98575,703,钟为民,2019-01-23 15:07:08,3,3,0,我真的佛了
98625,703,钟为民,2019-01-23 16:13:03,-3,3,6,多做事，就有分
98807,703,钟为民,2019-01-24 16:02:16,4,6,2,本来是想说老师不推荐的，结果被友军炮击了。。。
99000,703,钟为民,2019-01-24 06:38:38,-1,5,6,一个被深受正态迫害的好老师...
99325,703,钟为民,2019-01-24 14:51:41,-20,1,21,老师会要求你交一份读书报告和一份小组研究性学习报告，任务不是特别繁重，话说读书报告不要选太热门的书，只要你期末考好好准备，绩点应该不会差到哪去，我就满绩了，谢谢老师
99512,703,钟为民,2019-01-25 01:46:23,7,8,1,组长多次翘课，上课一直水手机或者做其他课的作业。组里的事几乎都是我来做，ppt我来做，展示我来做。组里其他组员我就不提了，跟死了一样。最后我绩点3.9，组长4.2。心累，付出与收获不成正比。
99522,703,钟为民,2019-01-25 01:59:36,20,24,4,那个班长真是够了，非得来装个逼吗？
99878,703,钟为民,2019-01-25 08:59:21,3,4,1,挺好的，我们组两次展示一次第一一次第二，读书报告写的是《平凡的世界》，期末考前把书看了1遍，最后4.2。我觉得可以接受了。
100884,703,钟为民,2019-01-27 04:16:37,-2,3,5,钟老师其实作为思修来说还好啦，人其实不错，至于上课内容，大家觉得思修课该上什么呢?  就我认识的人来说，给分不错的是多数，有个给分不好的同学也还是觉得他本人其实OK。认不认真的话，其实细想想，一个小组应该都是一个分，然后读书报告有高低好坏，期末考试有高低好坏，至于上课看不看其他科目开不开小差，老师怎么知道谁是谁呢? 所以评论区有些低分同学也可以想想。
101545,703,钟为民,2019-01-28 11:47:19,-2,2,4,我觉得老师还好吧，我们组组长组员都是会干活的，大家组起队来比较愉快，最后小组展示分比较高。我是那种平时不会上去展示但会默默做的，给分也挺好的。可能期末考比较好，感觉期末我都会做耶。老师会发红包，人挺和善的。思修这门课的特点就是伟光正，我觉得这个可以理解。
102022,703,钟为民,2019-01-30 04:42:43,-17,1,18,之前还觉得老师上课太水了，但是最后成绩出来居然是我这学期最高4.8，谢谢老师！
102251,703,钟为民,2019-01-31 15:20:55,11,11,0,给分随意，思想很红
102302,703,钟为民,2019-02-01 01:15:22,-4,1,5,有重名的老师啊！同学们！感觉好像很多评论说的都是马克思主义学院的钟老师。大家评分前还是先看看自己的老师是哪个学院的吧，不然误导了以后选课的同学不太好
102613,703,钟为民,2019-02-13 10:10:00,7,8,1,你给的真滴烂
102680,703,钟为民,2019-02-20 08:00:28,0,2,2,老师的课确实鸡汤居多，上课的内容，其实思修就是那样，感觉上课内容全凭党性叭！老师人挺好的，我们组一共两次展示，一次居中，一次倒二，结果最后的绩点居然上4，但是有好多展示做的很好的小组的给分就很迷，感觉可能靠运气叭。? \n\n
102738,703,钟为民,2019-02-22 05:33:36,-11,0,11,老师人很好的，绩点真的是要小组努力啊!!!我们小组就超级好，每次展示都是前二，大佬带飞，所以绩点还不错啦。
102991,703,钟为民,2019-02-25 08:40:28,-22,2,24,我拿了4.8。\n\n读书报告，志愿活动，研究性报告还有pre都做得非常认真。\n\n当时听别的小组汇报，能感觉到其实很多小组都没有放心思在研究性作业上（我的心思，指的是，真正深入地思考过这个议题，尝试去挖掘它的价值），没有展现小组思考，甚至很多逻辑都乱。\n\n付出多少努力得多少分，这个努力并不是你声称的“努力”，而是真正体现在质量上的硬功夫。\n\n据我所知，我身边真正文笔好，有想法，肯思考很认真的学生，都拿了高分。
103315,703,钟为民,2019-02-27 08:50:59,2,2,0,给分超差
103542,703,钟为民,2019-03-01 03:00:02,5,5,0,给分成迷，真的魔幻给分。怀疑因为平时分拉不开因此建议我们考前不用怎么复习，并且希望我们考出正态分布的漂亮成绩。得到了人生中第一个最低分，平时成绩都可以，但出分真的好低
103681,703,钟为民,2019-03-04 06:47:36,3,3,0,给分混乱得一匹，但平均起来不低，想水思修的话，他的课真的好（滑稽）
105113,703,钟为民,2019-04-04 01:23:39,2,4,2,算了吧，这老师全班没几个上四的
105703,703,钟为民,2019-04-18 15:25:12,1,3,2,首先感觉查老师上描述有一点点问题，上个学期我就是这个老师，课的确水水的，不过这门课也并无很大，，，，，老师人是好的，别迟到旷课，组里的同学旷了两次课，3.3，然后报告迟交写多少给分没影响，关键书是真的要去看，除了平凡世界，任选。
110711,703,钟为民,2019-06-28 05:13:27,-1,1,2,给分不错啊
110720,703,钟为民,2019-06-28 05:32:11,0,2,2,呵呵呵
110748,703,钟为民,2019-06-28 07:19:08,1,1,0,形策，事情不多，上课的时候虽然有点红专，但比我听说过的其他老师好。给分不错
110754,703,钟为民,2019-06-28 07:30:51,2,2,0,不多bb 上学期思修给分还算可以 这学期形策直接3.3 我背好长时间的题就这么绩杀掉了？
110773,703,钟为民,2019-06-28 08:11:12,0,1,1,没缺过课，好好背了思考题和选择题，还是被卡了的嘤嘤嘤
110775,703,钟为民,2019-06-28 08:13:36,3,3,0,辛辛苦苦背思修背形策，感觉做的还不错，绩点低到爆炸。你良心不会痛吗！！！？？？
110919,703,钟为民,2019-06-28 14:11:53,0,2,2,老师还是挺好的啦，虽然被卡? 了但是绩点其实还可以，事情也少
110927,703,钟为民,2019-06-28 14:37:25,2,2,0,卡绩的辣鸡
111714,703,钟为民,2019-07-02 15:44:44,-32,3,35,表白钟为民老师！！我就搞了两天就满了。自己没复习好就骂老师给分差，属实弟弟行为。
117183,703,钟为民,2019-09-20 05:03:31,-2,1,3,钟老师思修算比较轻松的了，给分还行
120836,703,钟为民,2020-01-17 17:24:34,-1,1,2,本人不是组长，事情超少，特别水。上课水手机的，睡觉的，写别的科目作业的很多人…老师上课也很水…就期末的时候自己看了看题库，书也没看…结果89……所以我打了8分…（手动匿了
120839,703,钟为民,2020-01-17 17:45:19,0,1,1,本人不是组长，小组展示也不突出，期末4.8，个人还是感觉期末考试重要，主要是因为个人期末考前把书仔仔细细背了一遍，再加上是文科生本身一些说法就比较熟悉…所以总体感觉还是不错的。期末考试很重要！！！
120842,703,钟为民,2020-01-17 18:11:31,0,1,1,上课很多时间是让同学们展示，讲课的确是蛮水啦......我的确是没太认真上这门课，所以3.3也是没什么好说的。其实平时好好做，好好复习，或者有党性，应该分会不错吧。
120873,703,钟为民,2020-01-18 01:31:44,0,2,2,当组长挺累的，虽然最后的研究性学习课堂展示分数在全班中游，但是我自己拿了4.8，我同个组的一兄弟拿了4.5。老师上课很和蔼，考试也没那么较真，真的挺好
120885,703,钟为民,2020-01-18 08:07:12,1,1,0,nice
120905,703,钟为民,2020-01-18 13:23:23,-1,0,1,我们组展示分最高，而且优势较大，但是我们组并没有都满。所以期末考试还是挺重要的，还是得稍微背一背
120933,703,钟为民,2020-01-18 23:57:55,0,0,0,老师人挺好的
120981,703,钟为民,2020-01-19 07:27:22,1,2,1,期末考挺重要的，我们小组排名比较靠后，最后绩点还挺漂亮的
121023,703,钟为民,2020-01-19 09:04:50,1,1,0,本人绩点还可以 但是尽量客观打分\n\n这学期的课和以前可能有些不一样一学期展示每个小组三次\n\n研究性学习的打分是清清楚楚的评分\n\n上课是真真正正的水 水手机做作业都没关系 但是宁可迟到也别旷课\n\n任务相比于其他思修老师少一点吧 建议不要太上心 因为这门课努力也没有用 \n\n但是因为我们组长真的很认真很负责展示做的非常漂亮所以分数还比较好看 如果一组人都想水的话就好好碰运气吧
121042,703,钟为民,2020-01-19 09:58:25,-1,0,1,老师人很好的，注意一定要符合老师的要求就行了
121146,703,钟为民,2020-01-20 00:49:50,1,1,0,上课着实水…给分也还不错，只要小组任务做好，考前花时间复习，分数就不会太难看
121831,703,钟为民,2020-01-22 07:52:27,-4,1,5,钟伟民老师上课还好，总是能把我从睡梦中拉到现实中。课有点水，作业不多，刚刚好，还能去良渚玩耍。思修给分特别厚到，答主被海底捞到4.2。。
122532,703,钟为民,2020-03-03 10:15:11,0,2,2,个人感觉，比上面的平均给分，要好多了。课十分地轻松（展示+点评+半节课PPT）。就是展示性的作业有点麻烦，不过，思修一般都这样吧(=_=)
122943,703,钟为民,2020-04-23 11:48:09,-3,8,11,就搞了一个展示4.8\n\n不多说 有点赚
124897,703,钟为民,2020-07-16 05:11:06,11,17,6,既然你要教会我社会本来就是不公平的\n\n那好，我过个几年也给你好好上个一课\n\n欠下的债，总有一天要还的\n\n你配不上“为民”二字
127139,703,钟为民,2020-11-10 03:35:44,2,3,1,形式主义严重
127506,703,钟为民,2020-11-23 18:30:57,-16,11,27,婊子养的贱狗
129206,703,钟为民,2020-12-31 07:27:24,-3,1,4,对钟老师有点无语。
129610,703,钟为民,2021-01-08 13:26:35,-11,1,12,一分都不想给，事情比毛概还多，浙大逼事最多的老师，上课固定座位，还不准干别的事，要做志愿，写读书报告，两次展示，一次小组大论文，还有小组总结，硬软要求一大堆，爱卷的同学就选吧，怕事的千万别选，事最多给分还差。
129890,703,钟为民,2021-01-13 08:22:39,1,4,3,谁能让这个安保大队长重新去当保安去，带个啥课呀
131438,703,钟为民,2021-01-27 13:32:08,-34,1,35,气死我了气死我了\n\nlz均绩让他一颗拉下来一大块\n\n老子就是每节课迟到五分钟咋滴吧\n\n睿智
131444,703,钟为民,2021-01-27 14:06:45,24,25,1,我没上过他的课，但是楼下那个傻逼，每节课迟到五分钟有理了是吧？要点脸吧。你不配高绩点
131445,703,钟为民,2021-01-27 13:45:59,1,1,0,给分尚可，课比较水，如果想拿高分，建议当组长和主讲。读书报告别总是平凡的世界，冬学期的小组研究也尽量不要和大家都一样。
131447,703,钟为民,2021-01-27 14:03:13,3,4,1,很可爱的老师，作业与思修其他老师比很少了，考前还帮大家整理了思维导图，讲了解题技巧~给分的话，只要认认真真就能拿高分！
131448,703,钟为民,2021-01-27 14:05:29,1,2,1,组内任务我认真做，也从不旷课。我不能理解为什么我最后绩点比组内不干事的人还整整低一分。
131451,703,钟为民,2021-01-27 14:20:42,2,2,0,一个内心自由的老师
131469,703,钟为民,2021-01-27 15:26:29,4,4,0,小组里我干的事情最多，展示也都是我上台展示，结果我的思修绩点比同组同学低得多？这是什么意思？我百思不得其解啊？？？我每次思修没缺过一节课啊
131471,703,钟为民,2021-01-27 15:40:47,0,0,0,上课管的太严，给分很迷
131475,703,钟为民,2021-01-27 15:46:13,1,1,0,乱给分，就硬正态，吐了
131477,703,钟为民,2021-01-27 15:49:33,0,0,0,乱给分，给分毫无依据，不怕低绩点你就选
131528,703,钟为民,2021-01-28 02:19:20,0,1,1,啥也不说
131529,703,钟为民,2021-01-28 02:19:27,4,5,1,事情贼多但和他混熟绩点基本不会低
131535,703,钟为民,2021-01-28 02:48:04,5,6,1,没逃过课，读书报告写的超认真，小组展示也被夸好，我高中学政治的，自认为期末考考的应该还可以，最后绩点3.3，直接拉低均绩点0.3分，无语子…真的不知道老师咋打分的
131591,703,钟为民,2021-01-28 05:59:39,1,2,1,nt老师，乱打分，喜欢的随便大高，没存在感的直接正态
131628,703,钟为民,2021-01-28 08:16:14,-1,1,2,给分巨差。没有存在感的就无了。均绩直接掉0.4。都是泪
132615,703,钟为民,2021-02-03 00:40:18,3,3,0,给分有点迷
133260,703,钟为民,2021-02-21 13:59:30,3,4,1,明明很认真的绩点怎么这么低…我枯了
137155,703,钟为民,2021-07-01 14:22:17,2,2,0,老师胡乱给分
137158,703,钟为民,2021-07-01 14:41:42,3,3,0,蜜汁\n\n给分
137169,703,钟为民,2021-07-01 15:59:46,1,2,1,考试准备得挺认真 每次都去听课作业也交了\n\n形策3.6\n\n还是没有达到预期
137241,703,钟为民,2021-07-02 13:28:29,1,1,0,怎么会比我完全没学过的硬课的绩点还低，绩杀无疑。
137299,703,钟为民,2021-07-03 03:55:05,1,1,0,绩杀啊
137314,703,钟为民,2021-07-03 05:11:54,1,1,0,形策绩杀啊\n\n3.3什么鬼
137410,703,钟为民,2021-07-04 03:46:02,4,4,0,形策给分有那个大病
138566,703,钟为民,2021-07-10 00:55:46,5,5,0,讲课讲了个啥啊?天天讲一大堆像天人感应一样的东西，太智障了。\n\n然后形策作业都认真做了，最后给个3.\n\n3，不给一分没天理
141681,703,钟为民,2021-11-20 04:47:23,3,5,2,专业素养呵呵，老是想着武统台湾，对国际形势的分析让我真是开了眼界了
141738,703,钟为民,2021-10-24 00:50:59,-3,3,6,纯纯的nt，要求手写1500读书报告，我问他能不能写电脑上，他就说啥学生也能讨价还价？高考作文是用电脑写的？真的要吐了，浙大怎么会有这种自我感觉良好其实一无是处的老师啊
141740,703,钟为民,2021-10-24 03:02:45,0,2,2,纯纯sb
141756,703,钟为民,2021-10-24 13:28:09,0,2,2,很无语
142281,703,钟为民,2021-11-10 00:08:35,0,0,0,BREAUCRET AND FORMIST
143965,703,钟为民,2021-12-14 12:47:27,-1,2,3,屁事特别特别多 别选
144124,703,钟为民,2022-01-08 09:54:46,0,0,0,绷不住了，
144485,703,钟为民,2021-12-22 00:54:15,-1,1,2,千万别选 预制了都退了 P事情是真的多
144647,703,钟为民,2021-12-23 03:29:03,2,2,0,nbnb
145968,703,钟为民,2022-01-04 16:06:35,1,1,0,课上的很好，就是不怎么听得进去，唉，虽然感觉老师上课很认真内
146496,703,钟为民,2022-01-06 17:11:26,1,3,2,上课的确比较无聊，但是成绩还可以
146503,703,钟为民,2022-01-06 17:38:31,1,2,1,固定座位 但如果座位在后面不去也没关系\n\n上课的确比较无聊（我刚开始还听，后来直接写作业），但是成绩还可以（小组的大佬太强了）\n\n关于考试  考前稍微翻下书还是有所帮助，然后大题尽量多写一点。
146523,703,钟为民,2022-01-07 00:19:41,3,5,2,瞎tm给分
146524,703,钟为民,2022-01-07 00:27:42,1,2,1,瞎给分的臭老师
146532,703,钟为民,2022-01-07 01:17:29,3,6,3,喜欢钟老师圆圆的可爱的模样～平时偶尔会严厉甚至有点凶！但是往往会在凶之后又安慰同学！给分不错！主要是平时的分享要好好搞，然后和老师的关系要熟络一些，课后咨询老师什么问题老师都会开心和你交流滴！！！
146545,703,钟为民,2022-01-07 01:53:09,0,1,1,事情不多，但给分真迷。慎选吧，不然要死真的好评分不会只有六点几的。
146563,703,钟为民,2022-01-07 02:43:47,1,2,1,上课很水，每节课就是听同学展示听老师吹水很轻松，座位是固定的偶尔想起来了点个名，人很友善，布置的任务也不是很难完成，但就是给分很迷幻
146568,703,钟为民,2022-01-07 02:55:18,0,2,2,为什么不公布详细分数 瞎tm给
146597,703,钟为民,2022-01-07 04:43:23,0,3,3,选上钟老师课的同学们\n\n要多和老师交流\n\n用你的心\n\n感受老师指引给你的方向
146605,703,钟为民,2022-01-07 04:59:50,2,4,2,真的是很直爽很率真的老师，确实会要求我们课上不要刷手机，但是真的刷手机摸鱼他也不管啊（不是），而且上完课回来看查老师的评价发现很多学生不满的形式这学期都没有了，抽签分享变成按顺序，期末论文5000字上限而且没有让我们交纸质版…反正我真的觉得他是一个很通透然后听得进学生的话的老师。至于分数emmmm反正我是感觉老师有捞一下我的
146708,703,钟为民,2022-01-07 08:45:42,0,0,0,上的老师的思修，不得不说给分确实很迷，但是事情不多，确实不多
146736,703,钟为民,2022-01-07 09:50:37,0,0,0,读书报告认真写的，课上的硬性要求也完成了，期末小组作业有大佬带，考前把考试提纲认真过了一遍，注意了一些细节的问题，多选题大部分都有点把握，大题全部写满，最后给分也还不错。\n\n老师确实每天都是国内形式一片大好，感觉干货没有那么多，划水也无妨，但期末之前一定要把知识点自己过一遍，多少留个映象。
146762,703,钟为民,2022-01-07 11:28:54,1,2,1,给分会正态，人挺不错的，课无聊，事略多（思修课通病），想拿高绩点建议当组长或者班长，固定座位，变相点名
146792,703,钟为民,2022-01-07 12:46:36,0,0,0,助教老师真的好好，只要认真做了作业就会给高分，虽然最后的考试考得不好，但最终的成绩还是不错的！！！太感谢了！！！
146983,703,钟为民,2022-01-08 09:32:06,0,0,0,呵呵了
147168,703,钟为民,2022-01-09 03:10:37,-13,2,15,体验非常不错，不知道为啥老师只有六分…小组分数应该很接近，老师觉得只要努力了就行吧似乎，所以绩点还是要看考试啊…认真准备了一下（背了两小时）最后4.8分，非常意外hhh
147203,703,钟为民,2022-01-09 05:31:44,0,1,1,上课风趣，虽然不怎么按课本，
147714,703,钟为民,2022-01-10 14:02:42,0,0,0,emm
147831,703,钟为民,2022-01-11 03:21:04,0,2,2,上课学不到东西，挺无聊的，不过之前一直被诟病的一些制度今年好像是少了一些。全程摆烂的我最后飘过。想高分的话要当班长吧（小组长是随机定的），然后自己背书刷题就行了，上课学不到东西的。
148224,703,钟为民,2022-01-12 02:01:36,0,0,0,？？？？？？？？？
149100,703,钟为民,2022-01-14 11:32:23,1,1,0,呵呵呵
150806,703,钟为民,2022-02-19 00:51:43,0,0,0,有点水，但是同学上去展示的时候他会下来巡逻，就不好意思再水了，老师绝对反对上课睡觉，还会抽签点名回答问题，好刺激
151391,703,钟为民,2022-03-02 05:15:14,1,1,0,？？？？？已经结束咧
152379,703,钟为民,2022-04-07 07:41:17,0,0,0,讲的挺好
155413,703,钟为民,2022-06-12 09:46:55,2,2,0,。。。
156357,703,钟为民,2022-06-19 08:01:40,7,8,1,客观评价一下，形策课，每节课固定座位、点名，但上课会有人不来。老师人很好而且也很和蔼，就是上课有点无聊，虽然形策本来也没什么人听。平时事情很少，只有一篇小组论文，合作还挺愉快。期末集中突击了一下，把ppt重点背了一遍，最后绩点上4。大家还是自己判断吧。
156360,703,钟为民,2022-06-19 08:16:12,3,6,3,讲得挺好的，上课比较风趣。形策事情不多，只交过一篇小论文和一篇很水的作文。有时会雷达点名，但其实作为思政课也正常。给分不错。一开始会不让用手机电脑什么的但其实不怎么管。
156365,703,钟为民,2022-06-19 08:35:13,6,6,0,钟为民老师有两个，这个是教形策的老师。脸有点胖嘟嘟的那位。\n\n给老师打10分，我还挺喜欢听老师上课的，而且感觉老师比较真诚可爱。\n\n给分我觉得是公正的，和期末考试关系比较大，我复习了ppt的50%左右，也背了一些书，虽然复习的不多但扎实，选择题全对，后面也写出来了一些，应该算考的比较好，所以上4啦。\n\n个人对形策老师的要求就是不要胡乱给分。至少不要和努力大相径庭。钟老师本学期事非常少。就形策来说，推荐钟老师。
156383,703,钟为民,2022-06-19 11:56:33,3,3,0,钟老师的形策事情非常少，本学期只有一个个人作业和一个小组作业，雷达点名了三四次，最后给分也不错。推荐选钟老师的形策。
156406,703,钟为民,2022-06-19 11:59:06,-4,1,5,我上的是形策，给分真的好好！除了全校统一的一次感想，作业只有一篇小组合作的2000字论文。虽然每节课会有雷达点名，但形策一学期本来也没上几次。简版PPT和时事PPT都会按时传在学在浙大。考前花了一下集中精力过了一遍PPT和两本书后的习题，最后4.8。感动。老师肯定捞了，毕竟我浙大精神冬奥精神通通写不出
156572,703,钟为民,2022-06-20 09:42:43,-3,2,5,形策和思修都是钟为民老师，胖嘟嘟的可爱大叔w除了要求你上课按小组坐不太好翘课（）其他都挺好的！思修课程要求多但其他老师也是一样的，钟老师不会额外给同学布置任务。考前突击两三个小时，思修4.5，形策4.8，给分也很好！ww
156655,703,钟为民,2022-06-20 13:52:31,2,3,1,上的是形策 两个学期一共就一篇感想一个小组合作论文 事情很少 感觉这学期老师给分挺好的
156817,703,钟为民,2022-06-21 04:28:29,-1,4,5,老师给分没有一票评论说的那么差呀，主要就是看期末那次考试，自己加油吧，（甚至感觉老师挺能捞的？平时分给的挺好的
156896,703,钟为民,2022-06-21 09:49:14,1,4,3,虽然讲课真得无聊，但是老师事情很少，给分也还行，感觉会捞人
157926,703,钟为民,2022-06-25 15:22:39,5,7,2,钟老师能说善道，可惜巧舌偶尔也会不尊重实际地乱扯。但是作为大学思修老师，他信仰党和国家，感觉就足够啦。个人觉得形策和思修两门课钟老师形象也是大不相同。思修的钟老师要求苛刻严格，形策就很随意了。上学期因为思修小组干了很多活却被绩杀而一直怀怨，而这学期形策没费劲就上了4还是蛮感激钟老师的。
159637,703,钟为民,2022-08-22 11:08:37,3,3,0,真无语
160150,703,钟为民,2022-09-14 01:26:01,1,3,2,人还不错，事情有点多
160202,703,钟为民,2022-09-15 02:41:07,-5,1,6,这个老师的信仰真的令人钦佩
160571,703,钟为民,2022-09-27 08:02:47,-1,1,2,内容还行！
160887,703,钟为民,2022-10-18 08:04:28,2,2,0,水，且无聊，且逻辑有点差，但人还不错，可以选。
161000,703,钟为民,2022-10-23 16:16:22,-4,0,4,事不多，给分也还行
161600,703,钟为民,2022-11-09 09:27:15,4,4,0,不建议选
163932,703,钟为民,2022-12-16 15:17:27,3,3,0,事情真的多
164342,703,钟为民,2022-12-20 10:58:19,-3,1,4,上过钟老师的思修，有两次（还是三次来着？忘记了）小组展示，一篇个人读书报告，一篇小组论文，被疫情打断后也不知道是否还有其他任务。小组以及我自己的作业都是一般通过水平（但老师是随机抽取组长的，或许我只是运气比较好），但考前找到了一篇不错的重点，最后喜提4.2。注意一下考试还是很重要的。\n\n钟老师的课不太方便翘，但自己大一时也处于一个不翘课但会在教室玩手机的状态，个人感觉影响不算太大。不得不说钟老师对一般人的大学学习状态认识得还挺通透的，侃大山的时间也不少。如果选到这个老师的思修也不要太害怕，基本还是可以摆过去的hhhh注意考试就行，绩点看运气了！
165672,703,钟为民,2023-01-09 08:08:12,7,7,0,特意在出绩点前来评价一下。上的是思修，说实话事情蛮多的，上课不能碰手机（会当面警告）。\n\n\n\n也许是思修老师的缘故，无脑吹中国各方面都好，西方行为错误不人道，常常罔顾事实。客观的说，难道我们中国在各方面都领先了吗，做的事情又都是正确的吗？\n\n\n\n而且很难沟通课后作业方面的事，这方面可能不如一些年长的教授和年轻的助教好沟通，死板不变通，循规蹈矩，没有人情味。
165857,703,钟为民,2023-01-10 06:30:14,5,6,1,是有两个钟老师吗？反正用剪刀石头布选班长的那个钟老师真滴劝退。无逻辑，无脑吹，事多，上网课还一副拽样子
166162,703,钟为民,2023-01-11 08:32:46,5,5,0,太离谱了。大学第一个绩杀。
166735,703,钟为民,2023-01-13 11:16:37,8,9,1,反正就，被绩杀了，平时分还可以调的吗？越调越低，感觉平时上课挺认真的，读书笔记也是认真看完全书一个字一个字敲出来的，研究性报告整合也花了不少时间，宪法诵读明明说给满分的，就给一分，说话不算话也是服了……怎么说呢，拉低了均绩，我真的好心痛！！！老师你不会心痛吗？
167020,703,钟为民,2023-01-14 15:40:14,3,6,3,还没出分数，但是平时分一直在降低。\n\n老师海底捞，就是说老师在海底，把你可劲儿往下捞，经常臭着个脸。
167025,703,钟为民,2023-01-14 15:59:31,2,4,2,垃圾非常垃圾
167033,703,钟为民,2023-01-14 16:31:29,2,3,1,总之，失望
167056,703,钟为民,2023-01-14 17:51:35,3,3,0,给分真的就是一个随机
167070,703,钟为民,2023-01-15 01:21:30,1,4,3,这次好像有在捞。宪法诵读那个，老师后来改了满分就是20，乘以百分之五是1
167092,703,钟为民,2023-01-15 02:41:57,-3,4,7,感觉老师没有说的那么差，人还是很和蔼的，就是讲课水平不太行，听与不听没区别。座位是固定的，想水的同学可以往后坐。当了组长，事情不少，花了挺多精力的，最后如愿满了，谢谢老师
167110,703,钟为民,2023-01-15 03:49:35,3,5,2,老师上课水平一般，挺水的，给分也很迷，前面那些讨论课、演讲的分就是全班满分的，没得什么区分度。读书报告和论文得分不进行展示，总之得到很看运气成分。\n\n老师比较有自己的追求，敢于挑战自己的那种，上课分享一些自己蹦极，骑行去西藏的经历鼓励我们敢于挑战，印象挺深刻的。
167137,703,钟为民,2023-01-15 04:15:07,2,6,4,给了八分，一方面是我感觉没有想象中那么烂，感觉跟另几个上过的六分老师比要好不少，上课其实完全可以不听，固定座位，说是上课不能看手机，但是我偶尔看看也没事，最中间也有位不是看手机就是在睡觉也没提醒（最后怎样就不知道了），学期初看起来给的任务不少，但整个学期完成其实工作量不是特别大，就是展示什么的分我们是完全不知道的。最后考试因为是开卷可能考的还行吧所以89给了4.5，对于一门不用投入过多精力复习听讲的课我还算满意的。不过我无论是小组展示还是论文啥的都认真完成了，最后分数怎样我感觉应该是有一定运气的，比如史纲我和同学平时分如果不调的话应该一模一样的（同组均分），最后可能因为考试的原因他比我高了0.6，所以吧这种类型的课也没办法
167140,703,钟为民,2023-01-15 04:16:04,2,3,1,挺关心大家的，有人文关怀，想要建设一个友爱长久的班级群，有困难都可以找阿钟(虽然我没好意思找)，线上课一次我去晚了一小时还让组长询问我的身体状况，我以为会因此扣总评了结果没有
167169,703,钟为民,2023-01-15 04:37:40,-7,2,9,第一个5.0 冲
167185,703,钟为民,2023-01-15 05:04:27,0,1,1,课水无聊。给分还可以
167235,703,钟为民,2023-01-15 07:22:26,3,4,1,我不懂为什么最后一直都在调分，越调越低，出分还很慢。读书报告什么的分数也不公布，我是真的很心疼我的均绩啊。
167263,703,钟为民,2023-01-15 09:21:32,-1,0,1,老师挺不错的
167440,703,钟为民,2023-01-16 09:36:37,-5,2,7,给分好像还可以，？
167646,703,钟为民,2023-01-18 04:03:08,-3,4,7,事多但是给分还可以 我朋友平时分比我低但最后总分比我高三分我不知道为什么 给了八分 是因为我上课老睡觉还有89 谢谢阿钟哈哈哈
168335,703,钟为民,2023-02-12 11:07:38,-8,4,12,阿钟的思修是硬课，事情比较多。给分的话，就是说每件事情都做好不会低，我们全组4.5+。因为思修的几个重要的大型活动成绩最后都是数一数二。阿钟的给分确实玄学，但是只要把所有事情都干好，把思修课当硬课来上，最后成绩不会差的。我们小组两满绩，但最后出现4.5和5.0我们也感到很玄学，因为其实大家努力程度都差不多。\n\n总的来说当成硬课上绩点就不会差，太硬了）））
168352,703,钟为民,2023-02-13 10:21:32,2,8,6,老子知道为什么一看到狂飙里的赵立冬就知道不是个好人了，和这钟狗这老毕登长得一模一样，死婊子养的
168434,703,钟为民,2023-02-16 10:22:40,6,6,0,1.8，不解释。这辈子没这么低过
169230,703,钟为民,2023-02-25 01:28:24,10,10,0,像公园里高谈阔论的自信无比的大爷，不知道没有理论实力为什么还能这么自信
170035,703,钟为民,2023-03-01 05:34:32,-6,1,7,满绩了，大概是因为全勤加组长？其实一学期下来事情不算少，但是这应该是思修这门课的要求，据我了解很多班都是这样的。其实老师很好的，会关心你，上课可以随便自习，别玩手机就行，如果硬是玩手机就等着卡绩啥的吧，反正我觉得没我最开始想象的那么差
171115,703,钟为民,2023-03-16 06:48:42,4,5,1,上学期有调分，给分还是不错的，不过老师好像即将退休了，一切争论也都该随风而去了
173506,703,钟为民,2023-05-26 14:52:06,-14,8,22,钟老师很不错！\n\n看到不少同学对钟老师的评价，其实直接反映了部分同学的素质实在太低了：骂老师是一个学生应该做的吗？尊师重道是最起码的；绩点低，应该找找自身的原因，有没有认真学，有没有上课玩手机，考试成绩是不是很低？
175784,703,钟为民,2023-06-26 14:59:26,1,3,2,形策给分不错，还以为他很求是
175785,703,钟为民,2023-06-26 15:00:21,0,2,2,上课很难写作业，因为他讲的东西确实有点吸引人。课程本身很水，给分还可以
176334,703,钟为民,2023-06-28 12:18:07,2,3,1,给分不好啊:(
176421,703,钟为民,2023-06-29 01:32:59,3,4,1,垃圾 分低 座位固定 课堂永远中国大好
184181,703,钟为民,2023-12-12 03:31:37,2,2,0,nt老师 快跑 课上水不了
188482,703,钟为民,2024-01-19 05:27:26,3,4,1,尼玛，卡我绩，课也上的不咋样
188553,703,钟为民,2024-01-19 08:31:16,4,5,1,给分非常差，赶紧跑
188648,703,钟为民,2024-01-19 12:47:30,4,5,1,在学在浙大上眼睁睁看着自己从92.1被正态成90.1，结果出来88，只能说不是很懂什么操作
188910,703,钟为民,2024-01-20 14:11:44,4,5,1,卡绩大师
189670,703,钟为民,2024-01-26 13:51:57,2,4,2,钟老师人还蛮好，上课水水的，如果老师上课有写导图，导图可以抄下来。老师比较反感上课看手机。有固定座位，会点名（可能是学在浙大签到，也有可能是看到哪组少人询问组员）。相比于其他老师，平常事情不算太多。尽量当班长吧，实在不行当组长，有加一点平时分。\n\n老师给分有点迷。学在浙大上的平时分，一言难尽。第一天看xx分，第二天看直接被扣了5分……如果是集体降分把优秀率降下来，扣的分不应该一样吗。怎么有些扣两分，有些扣三分，有些扣五分呀。
207693,703,钟为民,2024-12-24 01:29:21,2,6,4,退休了 给个高分 人不坏
209143,703,钟为民,2025-01-04 16:20:12,-3,3,6,草你娘的狗傻逼，中国的高等教育就是因为充斥着这种傻逼，才乌烟瘴气。退休了还要领退休金，领你妈的叼毛。
211510,703,钟为民,2025-01-12 00:43:54,3,5,2,钟老师真的是个好老师，性子很温和，本来看评论说他绩点低，但最终来看，也还达到预期了，个人感觉听钟老师的课，还是挺有趣的，之前还给我们分享过他去旅游的经历。满分推荐。
211529,703,钟为民,2025-01-12 01:13:08,1,3,2,退休快乐
211554,703,钟为民,2025-01-12 02:01:13,0,2,2,被卡了
211590,703,钟为民,2025-01-12 03:26:59,-1,1,2,呵呵，事巨多，分巨差，还有点官僚气息
211657,703,钟为民,2025-01-12 06:11:50,-1,1,2,满绩 赞
214179,703,钟为民,2025-01-27 02:11:43,0,2,2,退休快乐老师！虽然一节课没听但是成绩很好的，对小组作业的形式要求很灵活的，感觉认真去做自己的部分期末认真考试就没问题！（或许分点答题乐观积极是加分项hhh）
219078,703,钟为民,2025-05-21 00:50:37,0,0,0,草拟妈的狗东西，不得善终
1843,730,段治文,2015-03-26 01:47:09,48,52,4,段子很多很有趣
2643,730,段治文,2015-05-05 02:42:53,11,13,2,牛，牛，牛，就是厉害，就是叼
4004,730,段治文,2015-06-17 13:13:44,4,6,2,段子很多很有趣
4203,730,段治文,2015-06-18 05:20:34,23,24,1,口才好，幽默
5519,730,段治文,2015-07-08 04:33:56,-8,12,20,略能吹嘘…太牛掰，反而不适合课堂了…
5565,730,段治文,2015-07-08 09:45:43,34,37,3,段子手\n\n
5566,730,段治文,2015-07-08 09:47:42,29,31,2,很棒的老师！上他的史纲从不会枯燥的
7939,730,段治文,2015-09-16 07:21:41,9,11,2,大牛老师，绝对赞
8313,730,段治文,2015-09-18 08:08:08,6,9,3,舒服，爽
9719,730,段治文,2015-11-05 10:46:41,28,34,6,我听过最好的课，有人说水，好好听绝对不水，各种幽默之下全是智慧！
11647,730,段治文,2015-12-09 07:05:58,18,22,4,闷头学习就是求死
12781,730,段治文,2015-12-24 04:10:45,7,11,4,绝对段子手，能把史纲上这么有趣也是不容易
12910,730,段治文,2015-12-24 08:36:18,8,10,2,他的课是享受啊
13557,730,段治文,2015-12-29 07:33:08,9,12,3,一学期就点一次名。段老师的课绝对不会枯燥，不过不适合记笔记（好在本人史纲课就没打算记笔记）。
14020,730,段治文,2016-01-03 16:35:04,0,2,2,很有趣，受益匪浅
14315,730,段治文,2016-01-06 07:53:39,202,219,17,“我推荐大家看一本书。”
14367,730,段治文,2016-01-06 14:09:43,39,41,2,段王爷，大神，修不上旁听都行，当听历史讲座了。
14624,730,段治文,2016-01-08 03:46:29,4,5,1,我推荐一本书…
15858,730,段治文,2016-01-16 12:33:27,11,12,1,能把他推荐的书全看完的才叫大牛
16085,730,段治文,2016-01-17 07:03:27,0,2,2,hhh会点名 我觉得还可以 有自己的想法 然而我是大水怪
17549,730,段治文,2016-01-20 11:30:07,8,11,3,实在服，就是应该没人能看完他推荐的书
18162,730,段治文,2016-01-21 08:28:11,2,4,2,老师知道很多东西！不一样的历史 上课很有趣 信手拈来～
18221,730,段治文,2016-01-21 09:47:17,2,7,5,老师其实是舍不得点名的，对于我这么水的学生来说，拿到这个分数真的很满意了，不过上课的氛围真的很好
18553,730,段治文,2016-01-22 04:06:30,7,10,3,绝对深刻。老师教的不是历史是一种思想～上起课来一段一段的丝毫不会困或走神～虽然似乎比某些班多写一篇论文，但是平时事少，给分很好！嗯！
18687,730,段治文,2016-01-22 10:08:28,14,19,5,来上我的课，总能听进去一点，成绩不会差
19266,730,段治文,2016-01-23 16:42:33,20,29,9,评分：10\n\n硬件：大佬，认识很多知名人士\n\n软件：体制内最理性的声音之一\n\n课堂：比较水，但段子颇多，且有一定深度；期中期末会交两次论文性质的作业\n\n给分：良心
19591,730,段治文,2016-01-25 00:49:03,7,8,1,每个短学期点一次名，而且是被逼无奈~给分好，人很理性~看书多~总共写了两篇论文，其他事没有~一定要选！\n\n我推荐大家看一本书\n\n这本书大家一定要看
20371,730,段治文,2016-01-27 07:42:03,0,2,2,不错的
21254,730,段治文,2016-02-27 15:04:36,0,3,3,段老师简直段子手，每一次都是一种精神享受。他的才情让每一次史纲课都是高水准的讲座。给分的话论文少抄点创新点都很好的
21434,730,段治文,2016-02-29 00:30:11,2,3,1,一学期就两次点名
21924,730,段治文,2016-03-01 23:53:30,0,2,2,好好好
22017,730,段治文,2016-03-02 05:56:20,0,3,3,谐星，太谐了
22039,730,段治文,2016-03-02 06:40:51,13,15,2,“我觉得我的有些话大家还是要记记的。“
22965,730,段治文,2016-03-15 07:51:06,1,3,2,水平极高，看似是段子，细细品味全是独到的思考
23010,730,段治文,2016-03-16 05:36:29,1,3,2,我推荐大家看本书～
23845,730,段治文,2019-01-23 16:10:40,1,2,1,挺好的，上他的课不枯燥，作业也不多，点名也就应学园要求点了两次吧
25147,730,段治文,2016-05-06 07:14:38,1,4,3,老师讲得非常有趣，能看出来学识很渊博
25207,730,段治文,2016-05-08 06:18:06,-10,7,17,给分超恶心。。。。
25736,730,段治文,2016-06-06 03:35:44,1,2,1,段王爷脑残粉 上课百家讲坛 强推
29611,730,段治文,2016-06-30 04:58:04,1,1,0,赞赞赞
31799,730,段治文,2016-07-05 02:36:31,0,2,2,我爱段治文，我爱助教。点名一定要到
31811,730,段治文,2016-07-05 02:47:20,0,3,3,我爱段治文，段治文爱我。
33004,730,段治文,2016-09-10 04:49:24,1,2,1,段治文，字子手，以字行
34507,730,段治文,2016-10-12 07:29:24,2,2,0,听得痛快！
35053,730,段治文,2016-11-01 00:27:49,26,31,5,助教说 可能你们听说过史纲给分放水，那我要告诉你们 我们班放的水不会比别的班少
37736,730,段治文,2016-11-20 12:45:06,0,1,1,姿势水平高，谈笑风生
39105,730,段治文,2016-12-21 07:39:48,0,1,1,老师讲得很有趣生动，很有思想，能学到很多东西，至少会有很多新的启发，还会推荐很多书，男神！强鉴！
41501,730,段治文,2017-01-12 05:21:32,3,3,0,对于史纲这种水课，配上段老师的段子食用更佳。
43184,730,段治文,2017-01-16 02:59:24,4,6,2,段子很棒，只要上课都到，作业认真做，给分绝对赞。
43185,730,段治文,2018-03-21 02:07:48,7,12,5,段子手……\n\n给大家推荐一本书啊，虽然你们不一定看的到……
43192,730,段治文,2017-01-16 03:19:19,-6,1,7,人太好了，有一次点到没去都拿了4.2
43215,730,段治文,2017-01-16 03:46:58,2,2,0,只点两次名
43232,730,段治文,2017-01-16 04:23:40,-3,2,5,随机给分吧…
43240,730,段治文,2017-01-16 04:35:29,1,1,0,很很棒
43494,730,段治文,2017-01-16 10:59:21,2,2,0,段子手
44336,730,段治文,2017-01-17 15:17:14,9,9,0,老师的课非常有意思。点名时一定要去，讨论课发言最好参与。
46081,730,段治文,2017-01-20 14:45:40,-7,3,10,选择题一题没对\n\n分数91\n\n你萌看着办（｡ò ∀ ó｡）
46376,730,段治文,2017-01-21 11:17:19,0,1,1,史纲本来打算写作业，但是一听他的课就停不下来了，根本不想写作业，讲课太棒了！！！
47484,730,段治文,2017-01-27 17:05:35,0,0,0,老师很好，可有趣，知识渊博，讲的好，人理性，有句话说得好，幽默之下全是智慧，好好学着吧。
48663,730,段治文,2017-03-09 05:11:09,0,1,1,我能说这是我第一门主动去记笔记的课程吗？
51861,730,段治文,2017-06-13 01:36:23,8,8,0,大家要看两本书啊：有字之书，无字之书…超级喜欢段王爷哈哈哈看到评分这么高我就放心了……
52359,730,段治文,2017-06-19 04:27:16,0,0,0,段老师讲课十分生动有趣，认真听他的课能有很棒的收获。
54612,730,段治文,2017-06-30 02:23:40,0,1,1,老师非常博古通今，听他上课像听评书，每节课都认真听，很有收获和进步。推荐，给分也不错
54624,730,段治文,2017-06-30 02:41:47,0,2,2,老段真的超棒！上课很有趣，以一种平静的口吻讲述他作为一个接待过主席总理各级领导的人赢的人生经历，两节视频课看电影，再留出两节课给你写论文，最后期末一节课答疑，人好事少给分巨好，这样的老师居然没有满分？
54625,730,段治文,2017-06-30 02:42:52,0,1,1,事少分多讲得好
54691,730,段治文,2017-06-30 04:51:18,2,2,0,恩，很想一直听史纲别去上下一门哲学……老师讲的很有意思，点名确实是出于无奈但是有点吓人，一学期点了两次但是猝不及防。然后老师给分超好~
54759,730,段治文,2017-06-30 07:20:23,2,5,3,史纲本身在思政课里已经是相对有趣的了，段王爷课上的很不错，高度概括性加上自己的段子还有推荐的书，如果认真是真的可以学到东西的。段老师本身也是社会治理方面的专家嘿嘿…虽然结课了但还是真的觉得自己以后要多点读书吧（而且给分很好啊。。。
59208,730,段治文,2017-09-20 07:35:05,7,7,0,“其实我一直想写一本书，但没时间，大家帮我写写。”
61946,730,段治文,2017-12-27 05:39:13,1,1,0,
63194,730,段治文,2017-11-29 05:55:47,1,1,0,老师语言非常幽默！上课一点也不水，知识非常自然！
65151,730,段治文,2017-12-29 12:00:56,1,1,0,最有趣的的史纲课没有之一
69522,730,段治文,2018-01-25 02:31:42,0,0,0,讲课还是挺不错的，给分也还挺公正
69535,730,段治文,2018-01-25 02:58:44,0,1,1,老师很有趣很幽默，会不自觉地被吸引。四篇论文但是给分很好！
75005,730,段治文,2018-03-07 03:06:26,1,5,4,我一直建议啊我们浙大本科生毕业就应该授予博士学位，为什么，那些博士啊三五年一直都在搞一个题啊，这学傻掉了啊已经。\n\n
75012,730,段治文,2018-03-07 03:46:41,0,2,2,代言人
75016,730,段治文,2019-07-03 00:48:24,8,35,27,极端毛左，自称习的代言人。大教授，您不了解经济学的知识就别随意贬低它。思想都是老一套。大言不惭说一些博人一笑的“段子”，浙大的学生都已经这么没有独立思考能力了？
75041,730,段治文,2018-03-07 07:02:07,6,10,4,呵呵呵，无语，之前怕是刷分吧
75046,730,段治文,2018-03-07 06:35:20,0,1,1,有趣极了！
75055,730,段治文,2018-03-07 06:57:26,4,12,8,怎么说呢……\n\n段子多，能吹水，符合中国式政治正确。但是某些价值观我实在无法接受，反智，当笑话听都听不下去
75056,730,段治文,2018-03-07 07:04:20,-1,7,8,先diss为敬。这是一堂不咋地的党课
75065,730,段治文,2018-03-07 07:42:09,0,0,0,这句话你们肯定没听，应为是我说的
75602,730,段治文,2018-03-14 02:39:13,0,3,3,老师对事很有个人见解，可能有些令人不喜，但确实可以触类旁通。另外讲历史这么有趣，上课可以看出老师知识十分渊博。择其善者而从之吧。
75616,730,段治文,2018-03-14 05:56:28,11,28,17,我的老天这个高分实在是太具有迷惑性了…作为一个高校老师，私以为断不该把任何政治观点、历史观点以如此激进、绝对的口气灌输给我们学生，更何况有些观点是争议性甚至有反智主义之嫌的。
76349,730,段治文,2018-04-04 03:09:28,8,9,1,你大概没尝过新青年的味道吧哈哈哈哈哈
77967,730,段治文,2018-05-09 04:01:32,-1,1,2,为段王爷爆灯！！！！干货很多，上课风趣。最关键的是三观很正，史纲课我是当成人生课在上的。
83722,730,段治文,2018-07-11 05:53:29,-4,0,4,上课还是不错的 听听挺有趣的 但是非竺院慎选H 作业多 4篇论文（一般两篇）第六周布置第八周交 偶尔被歧视
85839,730,段治文,2018-08-21 08:27:30,-2,5,7,这个9.7多半是假的\n\n真想给他0分
99077,730,段治文,2019-01-24 08:36:48,1,3,2,给分差 其他没什么
99201,730,段治文,2019-01-24 11:46:39,0,0,0,老师上课真的很有趣呢
105303,730,段治文,2019-04-09 12:27:30,7,7,0,我家很有钱啊，有钱也是一种烦恼
105683,730,段治文,2019-04-18 10:59:00,2,3,1,中国就是政治，中国只要学习政治就行。呵呵。
106705,730,段治文,2019-04-29 04:03:04,1,1,0,水。。。
115065,730,段治文,2019-07-15 04:52:40,12,13,1,虽然有些观点值得商榷，但总体上以更深刻的角度去审视历史。段子是其次，鼓励自由思考的风气才是首要。有多少人一边说课太水，又一边上课只做自己的事情，对老师精辟观点置若罔闻？老师鼓励大家上台发表自己的观点，但许多同学只是重复着红砖的陈词滥调，以水分的态度对待。老师鼓励大家在论文里说出实话，但有多少人抱着“思政课就是水”的态度抄抄了事？不喜欢思政课，不喜欢老师是个人的权利，但不要自己不认真对待又说老师不行。
116244,730,段治文,2019-09-07 13:00:08,3,5,2,水课！完全不像大学老师！奇怪分数这么高！
116628,730,段治文,2019-09-12 05:55:00,7,7,0,“知识就是落后”
116629,730,段治文,2019-09-12 05:55:34,2,2,0,“学习学习再学习就是落后落后再落后”
117242,730,段治文,2019-09-21 04:58:37,6,6,0,水课是真水不是大学教授的课
122920,730,段治文,2020-04-21 01:54:03,-2,2,4,段老师的史纲H 首先吧，事情确实有点多，3篇读书报告，1篇论文，而且最后成绩要正态，但不得不承认，老师的讲课能力是不错的，能吧中国近现代历史讲得有条有理，引人入胜，并且有老师自己的见解和思考 9分奉上
124228,730,段治文,2020-06-27 14:32:36,-3,2,5,史纲H出分后来评\n\n因为是网课所以有一半是看慕课的\n\n老师自己讲的内容说实话虽然水但对于不是文科生的本人还具备一定的吸引力\n\n至于每次上传笔记的确有点痛苦\n\n但老师没有万恶的小组展示！这一点我就直接给满分！\n\n作业虽然多但可以接受\n\n推！
125882,730,段治文,2020-09-15 09:13:37,-5,1,6,吹爆段老师的史纲！！！！！！！！！
129052,730,段治文,2020-12-29 07:30:25,-6,3,9,就一个词，牛逼！完全颠覆对政治课的印象。完全不会困的午一课。
129055,730,段治文,2020-12-29 07:34:43,-3,2,5,段老师是浙大为数不多的每节课都能收获掌声的老师
130151,730,段治文,2021-01-25 02:48:27,7,9,2,出分后来的。对ckc，应该有不少同学比较在意分数。\n\n上课内容高赞答案讲的基本赞同。\n\n依稀记得老师上课说过，你上我的课，分数肯定不会差的，我曾信以为真。\n\n现在觉得，可能是对好和差定义的问题。\n\n自己上课没怎么听，讨论课发言，6篇文章认真写，其中两篇论文还经过了加工打磨。考试自认为大体翻到了，但是有几个题目有点偏。最后88，被卡4.2。对于比较高层次的追求还是有些拉胯的。\n\n有同学上课很认真，做笔记，反应考试内容在笔记中全有。\n\n如果是想在史纲上追求4.8 5.0的同学，我认为在考试应对上裸考可能不太够。（当然这方面特别了解擅长的同学除外）
130861,730,段治文,2021-01-25 04:33:44,2,3,1,水是真的～上课讲的会考也是真的\n\n建议上课还是记下笔记哈 考试大部分题全抄笔记最后4.8\n\n个人感觉平时的讨论和论文影评书评还是认真写了 但是一个是字数不算多 另外是可能没有写出内容 所以还是没能满绩_(:3」∠❀)_\n\n老师上课段子还是挺多 推荐的书也都很有趣
130867,730,段治文,2021-01-25 04:59:06,-7,3,10,老师超棒！讨论课没抢到话筒发言结果还有4.5！上课也很有趣！强烈推荐/
132106,730,段治文,2021-01-30 09:47:44,4,5,1,出分奇快，字数跟分数成反比。上课喜欢吹牛，干货比较少，水课。听段子还是可以一选的
138022,730,段治文,2021-07-07 05:42:29,26,31,5,超级绩杀超级绩杀，p事很多全都认认真真做了，周围一圈人没有一个上4的，H课不正态给这么烂的分？
138032,730,段治文,2021-07-07 06:15:58,17,19,2,快逃快逃，H课去换gjx老师的，dzw大绩杀，一堆事情结果出分之后大家都没上四的，H的不正态这么给分真的想不明白
138034,730,段治文,2021-07-07 06:19:23,14,15,1,过于恶心
138035,730,段治文,2021-07-07 06:35:45,10,10,0,一个学期很认真学了，论文，读书报告都花了很大精力，我只能说自己太菜了！
138050,730,段治文,2021-07-07 07:50:16,-8,3,11,【授课】上课值10分，很有意思；【给分】给分只能说一般般，期末考统一批卷，改卷太严——最高只有79（有点像今年的军理，但是在H班最高只有79还是不太正常吧。。。不同学期修的人不是不公平了）；【作业】期中一篇论文一篇读书报告，期末一篇读书报告一篇论文，平时两次观影课各有1000左右的观后感。写的作业也许比别的老师多了一点，但是没有小组讨论没有小组展示！！！！！【点名】这学期好像有三次传统点名（老师点名你答到），不过他的课这么有意思，不建议翘【建议】对自己绩点要求高的同学慎选，像我一样喜欢听上课好的但对成绩无所谓的强烈建议选。【最后】点名全到，参加了讨论的那次发言，期中两篇八小时速成，期末两篇6小时速成，两篇观后感认真写了。估计是考试太拉了最后84，3.9
138923,730,段治文,2021-07-11 23:30:35,18,21,3,大家千万千万千万不要选段治文的课。事情非常多（是所有史纲老师包括不是H课老师中最多的），上课总是吹他自己就算了，但绩杀是你万万承受不了的啊！！！除非你对绩点不在乎。
139088,730,段治文,2021-07-12 14:54:38,16,31,15,段老狗什么时候死啊😅
140612,730,段治文,2021-09-14 09:59:46,2,2,0,中国共产党历史是五级制给分吗？
142265,730,段治文,2021-11-09 11:50:33,1,2,1,老师讲得很有趣、很有意义、很有思想
147159,730,段治文,2022-01-09 02:43:24,10,10,0,噢只能说莫名得到了开学来最低绩点
147162,730,段治文,2022-01-09 02:59:30,3,6,3,我只有说如果这门课是你的预置课的话赶紧退掉换别的老师 段老师事情是所有老师里最多的而且分超级低 这是我开学以来最低的一门课 vjf的5.0都不够拉这门课的绩点
151164,730,段治文,2022-02-24 01:16:38,2,5,3,上课很有趣，在书本之外会结合实际，讲许多自己独特而有趣的经历、见解和思考。他讲的内容看似随便、杂乱，但又有他自己的独特的思考和智慧，顺着他讲的想下去，你会真正明白一些复杂的历史与社会问题。我的视野就是这样被大大拓宽的。虽然我自己的有些观点与他相背，但我还是很欣赏他。\n\n他不是那种为书本作复读、作注解的人，这一点他自己也声明过。这意味着，他的课对期末考试考出好成绩的作用不大，期末考试的准备主要靠学生自己（其实这也应该，毕竟都到了大学了，不能指望老师帮你学习）。但是如果你不把这门课当作水课、只要拿高分的课，而是要从课上了解历史的真相，学到实实在在的对历史与现实的正确思考方式，那么他的课是十分有价值的。
154585,730,段治文,2022-06-02 08:35:07,1,1,0,听讲座一样，大爱
160093,730,段治文,2022-09-13 06:33:15,2,2,0,我爱史纲
164183,730,段治文,2022-12-19 02:42:34,5,7,2,会讲，能讲，敢讲的老师。如果史纲还有那些政治课都能像“段子手”这样来讲，我相信我们对自己的国家会有更多的了解与真正的认同。大爱dzw
164940,730,段治文,2022-12-28 02:44:49,1,2,1,大师级别，对中国社会有着独特思考和理解，敢讲敢说，不是一般的段子手
165032,730,段治文,2022-12-28 13:42:42,5,5,0,为啥看不起我湖南人？\n\n其他倒还可以，就当给上完数学的我放松一下。
165696,730,段治文,2023-01-09 10:04:06,6,7,1,给分很差
165786,730,段治文,2023-01-09 17:32:11,2,2,0,虽然上的是思政课，但很有历史课的感觉，所以培养史识还是很重要的。老师也很看重这一点，鼓励学生要有对历史的思考和自己的认知，而不是人云亦云。楼上说的很对，如果教授历史课的老师都能有段老师这样的风格的话，国人对历史的看法和对思想的认识也许就不会如同当代互联网这样浅薄了。\n\n至于给分，好像也是比较看重对这门课的重视程度和自己的想法吧，我中间的论文和读书报告都是更偏向于历史而非思政的，最后的期末考试也是在谈自己对历史的看法更多一些，最后4.5还挺高的。不过对历史没有兴趣的人的话可能会比较痛苦吧。\n\n推荐还是多看看历史，多思考，不要把它当做文科来学，可能会好一些？
166741,730,段治文,2023-01-13 11:32:33,10,11,1,7分，讲课给十分，给分扣3分，为什么比别的老师低这么多啊？卡绩点，这真的对不同老师的同学公平吗？
167496,730,段治文,2023-01-16 16:14:56,1,2,1,段王爷，讲课很好，一学期就点了两次名\n\n但是事情有亿点多（两篇观影感，两篇读书报告，两个大论文[吐血]\n\n有一点绩杀
173046,730,段治文,2023-05-12 02:56:09,4,5,1,手机都舍不得看，真的好老师，有历史素养，有文学启发，学识渊博，博古通今，真的特别喜欢！段王爷还是段王爷！
176468,730,段治文,2023-06-29 04:21:40,0,1,1,个人觉得段老师给分还不错  但相对而言事情会有些多 这学期（2022-2023春夏）两次电影观后感、两份读书报告、一篇期末论文  任务是有些的  中途有节讨论课  非常建议大家上台发表些自己的想法  段老师都会接纳的  也建议对时事感兴趣的同学去和老师多聊聊天  很有想法的老师
187631,730,段治文,2024-01-17 02:29:04,2,2,0,听了一学期故事
187634,730,段治文,2024-01-17 02:29:51,6,6,0,爱死你了，段老师😘
187644,730,段治文,2024-01-17 02:57:16,7,8,1,（23秋冬史纲H）\n\n分高事少不点名？如果你单单是冲着这个来的那我只能说too young too simple sometimes too naive。段老师的课可以说非常有意思，让一个纯纯理科生都能被吸引，他讲课的时候有一种演讲家的独特的气质，讲课从来不照本宣科（甚至可以说是抛开课本自己讲自己的），里面再夹带一点（可能很多）私货，对于政治总是有一些自己的精辟独到的看法。另外：“我给大家推荐一本书啊”xd\n\n4.8一本满足！期中一篇读书报告（命题）期末一篇小论文（命题），会限制最高字数，然后期中期末前各有一次电影观后感，随堂提交，一学期点过两次名，期末开卷不说大家也知道。\n\n总之强推
192064,730,段治文,2024-05-08 11:41:46,-7,3,10,看见查老师评价这么好真是惊讶了。专业课上的依托答辩，理论能力与授课水平都很欠缺的一个老师，平时很高傲，（）是歪的。
197731,730,段治文,2024-08-05 15:46:22,3,3,0,史纲，事有点多，但是讲得还挺有意思，会讲好多其他的故事，输出一些自己的观点，总之课不会太无聊。
201922,730,段治文,2024-11-07 11:53:29,2,2,0,顿感有愧先贤
220833,730,段治文,2025-06-22 03:09:11,2,3,1,给分真的好吗？我认真做，真没感觉给分好啊？远低于预期，不如纯水的室友。老师给分不如别的老师。对于不同班的学生公平吗？对于认真做的学生公平吗？
1181,867,张新樟,2015-03-21 16:25:55,-3,7,10,无聊……
2125,867,张新樟,2015-04-02 01:13:44,4,17,13,无聊
2736,867,张新樟,2015-05-06 11:15:25,0,11,11,毁人不倦
5858,867,张新樟,2015-07-09 15:42:47,45,65,20,上课的时候要学生跟他打太极…并！且！课代表不叫课代表叫书记！天哪噜！课代表坐的座位叫书记处！奇葩啊头一回见！真真儿的
6069,867,张新樟,2015-07-10 15:13:07,1,16,15,你不喜欢他，大概是没有理解马克思的真谛。
7501,867,张新樟,2015-09-15 00:50:08,91,104,13,每次上课都觉得他下一秒就要飞升得道成仙了……
8402,867,张新樟,2015-09-21 03:17:53,3,11,8,老师讲课让人想睡觉，但是师生情真的很不错
11414,867,张新樟,2015-11-30 13:58:15,0,5,5,老师自己对马原有理解，很希望学生能日常运用，但教学目的略难达到。挺有趣，人好，平时分方案学生决定，无论文有展示。＞v＜喜欢〜
12377,867,张新樟,2015-12-23 06:55:06,7,12,5,无论文，看似挺水，其实。。。。
12685,867,张新樟,2015-12-24 01:42:13,2,13,11,老师确实是很有思想见解的，如果想要学习为什么我国坚持社会主义，马克思有何有点。选该老师。我认为老师不在灌输在引导。好！
14446,867,张新樟,2016-01-07 06:43:34,1,6,5,呵呵呵
16858,867,张新樟,2016-01-19 05:52:27,0,5,5,完全不知道他在说什么
16866,867,张新樟,2016-01-19 06:11:09,-3,2,5,虽然课没听，但是给分高呀。
16874,867,张新樟,2016-01-19 06:35:31,3,7,4,给分不好
16900,867,张新樟,2016-01-19 08:22:22,-2,3,5,给分高\n\n
17630,867,张新樟,2016-01-20 13:53:31,0,6,6,讲课一般般 坚信马克思主义 但缺乏说服力 大讲气功太极 放90年代说不定可以出本专著 《马克思主义气功原理》\n\n事情少所以给分随机 有个一官半职会显著高
18077,867,张新樟,2016-01-21 07:23:48,0,4,4,就上课来说还是挺有意思的
18735,867,张新樟,2016-01-22 12:22:12,1,6,5,老师讲哲学，认识精辟，认识的哲学大门确实是被老师打开的，但是 很多同学都不听的，自然没有好分数。。。  真的很好的，彻底改变马原看法
18803,867,张新樟,2016-01-22 14:35:34,4,9,5,给分不错，虽没有回答过问题，但是和他打过太极……还有上课放的视频和文章都挺有意思的
21484,867,张新樟,2016-02-29 04:22:16,0,3,3,就是一个字：棒
22579,867,张新樟,2016-03-08 06:53:02,0,2,2,讲的有道理，视频好看…被洗脑了
23225,867,张新樟,2016-03-22 06:12:15,1,6,5,不会讲西哲就别扯淡，老老实实讲课本得了
25395,867,张新樟,2016-06-30 01:27:44,-1,4,5,给分还行，讲课垃圾，没有论文水水过好了。
25988,867,张新樟,2016-06-15 01:47:23,3,4,1,没论文啊！！！
28527,867,张新樟,2016-06-28 09:53:33,1,5,4,老师很随和，很超脱。对学生管的很少，论文自愿写。反正我没写论文，上课没发言，凭着组长职位和全班第一的展示分，平时成绩就满分了。
29493,867,张新樟,2016-06-30 01:33:53,2,6,4,张老师好啊！对马原不按照书交讲，有自己的看法，只要你上课听讲，给的一些比喻很浅显易懂，会让你明白很多，没想到在马原课上学到干货，不容易啊！
29512,867,张新樟,2016-06-30 02:04:28,-1,1,2,挺好的老师，有独特的内涵和知识深度。但可能不太适合某些人的口味(〃'▽'〃)
29566,867,张新樟,2019-02-26 08:35:16,35,53,18,给分高不高在于书记处。这学期班里一堆傻逼在书记处，展示是班里最高分，结果大家都很低呵呵呵呵………他们光自己分高了……傻逼祝福被劈腿
29692,867,张新樟,2016-06-30 07:57:16,-5,1,6,虽然课没听过，但是给分好呀
30240,867,张新樟,2018-12-27 07:43:48,4,11,7,上课会给我们看很多视频，确实能够引发我们的思考，期末没怎么准备最后成绩也挺好。没有论文，一次小组展示
47988,867,张新樟,2017-02-28 02:13:20,3,5,2,老师你需要一瓶脉动o>_<o
48001,867,张新樟,2017-02-28 03:06:35,2,10,8,他在幻想自己皇帝?4个书记……
50827,867,张新樟,2017-07-03 10:58:57,2,3,1,好老师 课堂轻松活跃 给分好
52598,867,张新樟,2017-06-21 10:17:42,2,3,1,好老师 上课放的视频资料都很有内涵 讲解也很精辟 平时任务少 对张老师印象蛮好滴
52818,867,张新樟,2019-09-10 03:54:02,9,33,24,从小到大一直对所谓的思政课没什么好感233333本来是抱着早点修完完事的心态修了马原。但是听了老师的课之后果断被打脸。。。老师用视频、文章这些通俗易懂、容易被接受的材料来表现深奥的哲学道理。原理可能很抽象，但是表现方式很直接具象。不敢说我都听懂了，但是通过一个学期的课，我明显感受到了马原作为一门思想政治类的大学必修课对学生的指导意义。老师的课让我明白，马原不只是我原来狭隘地以为抽象的哲学内容，它是真正能被运用到现实生活中解决实际问题的(虽然操作起来还是很困难)。另外，选课的时候听说老师会打太极。当时只是觉得这是就只是老师的一个兴趣爱好。今天这节课后，我猜想，这会不会是一种必然。我所了解到的太极讲究平衡与和谐。相比其他的运动，它表现得很温和。马原也给我类似的感觉。\n\n我非常庆幸自己选了老师的马原课，受益匪浅。感谢书记处和小组长的辛勤付出！谢谢同学们一个学期的陪伴！感谢！
52852,867,张新樟,2017-06-23 07:54:45,1,2,1,很棒老师人超好\n\n
52950,867,张新樟,2018-06-12 08:21:57,10,21,11,老师讲得很好，是属于慢热型的，一开始可能觉得无聊，想睡觉没意思，但每节课都听下来真得能学到很多东西。课程展示也很有趣，实话说每周二上课前都挺期待的
53720,867,张新樟,2017-06-27 11:16:28,4,9,5,老师属于内向淳朴的人，这个可以看出来，虽然可能带给很多同学（包括我）不好的听课体验，但不得不承认老师有用心讲课用心备课，我认为这就够了。有师德，有人情，是一位好老师。
56217,867,张新樟,2017-07-03 09:14:56,-5,3,8,正态 无脑书记加分
56225,867,张新樟,2017-07-03 09:34:19,3,11,8,老师太好了！！上课坐前排好好刷脸，多举手回答问题，考前多刷选择题，就满了……
56241,867,张新樟,2017-07-03 10:07:54,13,32,19,强烈推荐!很可爱个老师，讲课讲着讲着就会腼腆的挠挠头，举的例子形象易懂，助我听懂了本晦涩的马克思主义。会打太极，最后一节课还跟我们切磋。特别为学生着想，很体谅大家学习繁重，平时任务不多。微信群上发言也算发言分而且没有论文作业，平时上课不认真听也不会特别说你什么。考试也是尽可能给你分。我自己平时分是满分，考试虽然写的不好但最后有4.8。那些讽刺他以为自己是皇帝真的有看到他有多么平易近人吗!
56245,867,张新樟,2017-07-03 10:17:13,4,10,6,真心特别特别特别好的老师，非常和蔼，上课会给我们看很多视频，给我们讲他自己对马原的理解，发言也允许我们不看书瞎bb，还说我们的发言让他受益不少，事情也很少，特别关心和体谅学生。总之就是教的活泼，为人和蔼，上课轻松，给分还不错，强烈推荐！这么棒的老师不该只有7.5分
56269,867,张新樟,2017-07-03 11:08:33,2,2,0,老师人真的很好
56285,867,张新樟,2017-07-03 11:45:16,0,3,3,其实老师上课很有体系，会放一些相关的视频，任务也不多。总体来说还不错，点不点名完全取决于书记处。
56304,867,张新樟,2017-07-03 12:41:43,1,2,1,给分棒棒棒\n\n
56312,867,张新樟,2017-07-03 13:03:01,7,10,3,无论文，偶尔点名，给分超级棒（我是小垃圾），经常讲邪教，最后一节课打太极了\n\n课程方面:上课经常放视频，深入浅出讲东西，但是对于我一个文科辣鸡来说还是有些难懂……大概因为视频多所以水水过的人很多……但是讨论的氛围还可以。个人看法是，马原是需要我们认真去学习并理解的，还是有点后悔这学期没好好听课……
56444,867,张新樟,2017-07-04 00:21:54,0,1,1,炒鸡棒!
56553,867,张新樟,2017-07-04 03:27:24,0,1,1,好！！！
56766,867,张新樟,2017-07-04 14:37:36,2,3,1,老师上课会给我们看很多视频文章资料，同学们讨论，老师再提他自己的看法。每周的马原课都过得很有意思。我性格比较内向，没发过几次言，平时分就扣掉了近十分，期末疯狂复习最后竟然上四了。老师真的尽他所能给我们分数，上课教得也好，最后一节课还观看了他和同学打太极哈哈哈。现在课程结束了他还会在群里给我们发一些有趣的资料，真的很棒～
56798,867,张新樟,2017-07-04 15:48:34,5,8,3,想水可以很水，但听老师上课也挺有收获的，书记处好的话分不会低的，平时事情少啊！没有个人论文！期末考试论述题老师都能给就给分的，我们自己都觉得没打到点，老师都说我们内在思想是对的，都会给分，算下来，我期末考试应该有90+，真的是老师给分好！
59633,867,张新樟,2017-09-25 05:19:03,-4,3,7,很烂，给研究生上课，看不到智慧。
60560,867,张新樟,2017-10-24 06:06:44,0,4,4,老师的课深入浅出，结合视频具体事例加以讨论，班级组织得当，收获巨大棒棒哒
61076,867,张新樟,2017-11-08 04:36:51,1,3,2,其实挺耐心的，讲得内容如果仔细听的话其实都能运用和映射到实际生活中，比较喜欢创新的形式，是个和蔼可亲的好老师。
65206,867,张新樟,2017-12-31 08:10:49,-13,2,15,真的好老师，虽然我分不是特别高4.5也还不错，但上课讲的可水可听，也很有意思，总之很值!
65530,867,张新樟,2018-01-06 13:49:42,-18,11,29,老师很不错，就是选了一个辣鸡书记，把权利过多给书记，平时分全部给书记弄了。导致个人恩怨也放到了给分上。那些细节就不说了。\n\n\n\n但是还是强推这个老师。比较轻松。挺有意思。给老师10分!
65544,867,张新樟,2018-01-05 16:36:36,2,6,4,超棒的
67073,867,张新樟,2018-01-20 08:01:55,5,8,3,我们书记处人还不错\n\n当然了老师人也很棒。最头疼的论述题给我们放宽了
67581,867,张新樟,2018-01-21 14:54:38,-6,5,11,给分差！！！但是任务确实比较少，老师人也挺好的，关键是绩点低啊
68891,867,张新樟,2018-01-24 05:14:51,10,17,7,老师人不错，但是仿佛给书记处的权利太大了点。
68907,867,张新樟,2018-01-24 05:47:35,3,9,6,事少分好，十分送上
68933,867,张新樟,2018-01-24 06:37:31,-4,8,12,不想听，不喜欢所谓的书记。遇见这老师就别想通识课还能给拉拉绩点了
68951,867,张新樟,2018-01-24 06:59:51,4,10,6,没负担，一次小组展示，没论文，很水，给分好，复习了一上午，4.2，感觉老师还是很有文化的
69208,867,张新樟,2018-01-24 10:09:16,-8,0,8,还行吧
75542,867,张新樟,2018-04-03 04:07:53,1,10,9,我合理怀疑前面评论者的智商，到底有没有读过书u。这老师烂成这样也有8分？
75543,867,张新樟,2018-03-13 06:34:33,-3,2,5,好尬呀
75551,867,张新樟,2018-03-13 07:15:54,-2,2,4,在干嘛？
75862,867,张新樟,2018-03-20 06:14:26,-2,1,3,很尴尬 尬成?了
76593,867,张新樟,2018-04-16 05:45:11,20,23,3,书记处很糟糕
76819,867,张新樟,2018-04-24 06:32:55,-20,3,23,前面的同学，请问你是周二早上的课还是下午的课呢?对书记处工作有什么意见建议可以说一说，书记处这边会努力改正的!
79771,867,张新樟,2018-06-13 12:10:10,1,5,4,非常厉害的老师！真的通俗易懂，本来只是想水过马原的，超级惊喜了！！讲二元论部分让我从很长周期的抑郁情绪里恢复了不少，非常感激老师qaq例子都很生动，不按照课本来，会鼓励引导同学们去思考，收获很多！任务也不重，小组展示一定要有问题意识，选题范围不要太宽泛，分数不会低的！！然后关于发言，其实上课认真听自然会有想要发言的内容，老师也不是随便给发言分，是要有意义、有新意的思考内容，但是只要是自己的东西基本上分都会高！至于前排混脸熟这种说法…反正我是不舍得坐到比较后面啦_(:з」很宝贵的课！要珍惜啊qaq
79874,867,张新樟,2018-06-14 15:08:43,-3,2,5,课水事少给分好！
80397,867,张新樟,2018-06-26 05:35:14,-6,1,7,超级棒！真正能够重塑价值观的老师，现在还没有考试，但绝对10分！
80803,867,张新樟,2018-07-01 08:41:15,1,7,6,这老师就是个弱智，觉得他讲的好的人真的奉劝你们多读些书吧。
80857,867,张新樟,2018-07-02 05:15:48,0,1,1,经常讲邪教，展示是与邪教有关，每节课都点名，书记们才有高分，其他人高分比较难。关键是收获不大，不推荐
81264,867,张新樟,2018-07-04 13:05:22,1,1,0,上课内容和考试内容的关系不是那么的大.....还是要靠自己靠前多看书
85364,867,张新樟,2018-07-17 09:03:42,2,3,1,一个沉迷反邪教的老师，然后平时事情不多，上课喜欢放视频。有个书记处之类的东西。但是给分emmmm……认真复习期末考还是没上4，对文科生不太友好。\n\n然后就是想拿高分多举手发言吧\n\n
85374,867,张新樟,2018-07-17 09:49:26,2,3,1,我觉得我一个学期来听课也不应该只有70+\n\n嘻嘻
85440,867,张新樟,2018-07-18 01:32:57,-2,0,2,课水事少，连论文都没有，但老师沉迷反邪教……每一堂课都要批斗一次法轮功……给分一般……期末考什么都不会3.9
85586,867,张新樟,2018-07-20 02:31:40,0,0,0,马原，平时确实事少，但老师的教学内容跟课本比起来确实标新立异。。
86734,867,张新樟,2018-09-18 07:33:09,0,0,0,想睡觉
87877,867,张新樟,2018-10-16 15:42:56,-2,0,2,呵呵哒
89641,867,张新樟,2018-11-20 05:57:12,0,2,2,不是说老师上的不好，但是真的玄学听不懂……觉得上的不是马原，根本不讲原理不讲理论，是纯粹老师理解的马原。
91983,867,张新樟,2019-02-26 08:34:49,51,58,7,书记处多傻逼，总书记最傻逼
93210,867,张新樟,2019-01-08 06:35:29,-7,2,9,我一个工科生被他讲政治经济学吸引了...
93772,867,张新樟,2019-01-13 12:42:39,13,14,1,自我介绍+4次作业+总结+小组展示，上课又讲的不好给分又不好，大学以来最痛苦的一门课
94039,867,张新樟,2019-06-18 01:53:12,32,46,14,马克思主义高级舔狗，动用自己所研究的内容来掩盖马克思主义真正的弊端，如果你听他的课就会被他内容所吸引，但他将马克思主义渗透到各个方面来否定人的独立思想，他何尝不知道马克思主义就是一门“宗教”，让你来信仰。他所讲授的修炼会让你不知不觉的受到洗礼来坚信他的内容，直接否定西方普世价值等等。他确实讲的很好，但是奉劝各位在听课的时候保持清醒的头脑，这毕竟是一门政治课，依然逃不过所谓的宣传的俗套
94088,867,张新樟,2019-02-26 08:35:00,34,38,4,我对书记处制度非常抵制，真的很无聊，好端端的课搞得这么官僚。\n\n\n\n老师讲课四不像，既不讲理论也不讲事例，整天讲一些带着玄学的自己理解的所谓马克思主义。。。最后政治经济学讲得倒不错 ，其他几节真的听不下去，能把事例讲得比理论还绕的人我也是服了。。\n\n\n\n还有老师的英文能让我起鸡皮疙瘩
94161,867,张新樟,2019-01-15 11:03:24,1,3,2,看得出来老师讲课很认真，总是用一些形象的例子来讲解，还会放一些视频。然而马原课还是很无聊，大部分人都没在听……
94528,867,张新樟,2019-01-17 05:30:57,5,5,0,借楼问问这课他这样讲怎么复习啊。。
94637,867,张新樟,2019-01-17 13:08:36,22,25,3,辣鸡老师毁我青春，上课天马行空，按自己思路来，思路满天飞，不得要领，我不知道那些说老师好的人是否真的认真听老师讲课了。对于马克思主义，他真的没讲什么东西，理所当然的讲很多意识的东西，以为我们书上那些真理、时间、二元论都是会的。还有我不知道浙大的思政课为什么要闭卷考，老师上课没讲过书，考试还他嘛闭卷，如果这样搞你大可以把这拆成两门课，马原课不用开直接考试就行了嘛，再开一门课给老师过嘴瘾，不考试直接搞一波学校最擅长的变态分布就可以了。再者说出试卷的老师能做及格吗？祝出试卷的老师手术顺利。成绩全看书记处打分，书记处内定满绩，学弟学妹们记得第一节课坐在第一排。
94652,867,张新樟,2019-01-17 14:23:00,3,4,1,神学老师
94654,867,张新樟,2019-01-17 14:24:41,9,9,0,神学老师 这真是我大学最不马原的一节课了（微笑）
94655,867,张新樟,2019-01-17 14:27:58,5,6,1,理论上太极摸别人一下就可以制对方于死地。。。( ´∵｀)
94692,867,张新樟,2019-01-18 01:03:04,-15,8,23,我不是很理解为什么之前的评论戾气那么重。难道开课的目的就是为了考试吗？请问您们真的有认真听老师讲课吗？老师讲的明明那么好，很难理解的道理都能很通俗的讲出来。而且要是单单应付考试的话，考前看一遍书不就可以了吗？再说书记处，一个学期，就只有一次小组展示，给大家的平时分基本都上50了，您们到哪里还能找这种又能水又有干货的马原？还是说您们觉得马原不满绩就会拉您们的绩点？
94727,867,张新樟,2019-01-18 03:31:34,13,15,2,上课的时候特别后悔选这么扯淡的课……\n\n考试前看了马原书发现其实这门课还挺有趣的，可是老师讲得如此无趣（是老师自己的马原叭，个人认为某些方法和看法不具有普适性），就更后悔了……
99966,867,张新樟,2019-01-25 11:08:57,26,26,0,老师留作业时反复强调一两句话表达观点即可 恶竞狗次次成百上千字小论文 最后组内评分居然还是第一？excuse me?受虐倾向？就喜欢被恶竞，觉得恶竞的人就应该拿高分是吗？
100137,867,张新樟,2019-01-25 15:32:54,3,5,2,出分巨慢啊。。。
101123,867,张新樟,2019-01-27 15:04:58,-6,2,8,给分超好
101124,867,张新樟,2019-01-27 15:07:10,0,2,2,上课真的水
101129,867,张新樟,2019-01-27 15:17:20,11,17,6,搞什么书记处？脑子没事吧？官僚主义搬到课堂上来用？脑子拎清的伐？上课讲的什么玩意？一节课都听不下去！事情么噶多！考试临头说给写序号的人加五分！教学秩序还有没有的啦？课程结束边让我们整理一学期发言啥的东西！哇！这些平时发发微信的东西也要给整理出来？聊天记录早就清清掉了！你但凡平时说一下也不会这样局面尴尬吧！平时分扣了五分不算很多吧！考试好好写了给我绩点3.6？一定要按你思想写才能拿高分是吧？怎么就那么喜欢临时布置任务啊？好好的老师被当成这样！跪服.......
101131,867,张新樟,2019-01-27 15:22:56,11,13,2,自以为自己创立了一套很先进的制度，实际只是在减轻责任
101132,867,张新樟,2019-01-27 15:23:37,7,11,4,评分标准书记处定就算了，最后一节课才公布是什么意思。还喜欢恶竟。不说了，傻逼老师，一生黑。
101135,867,张新樟,2019-01-27 15:38:51,8,12,4,这种傻逼老师我也是服了，一门马原能拉你绩点0.1你敢信？真是人在浙大走，傻逼老师迎面来啊
101149,867,张新樟,2019-01-27 17:25:05,-13,0,13,课好事水给分好，水了一学期，就一个小组展示和上课发言，考前复习背了一上午，最后绩点4.2，我吹爆。
101155,867,张新樟,2019-01-27 23:23:37,2,2,0,恍然如梦
101162,867,张新樟,2019-01-27 23:42:34,-11,3,14,评分全交给书记处确实不合理，老师最后也反思了。老师认认真真的看完了我们所有人都课程评价和建议，还有我们私发的邮件，全都有反馈，真的很棒。没有论文，只有平时一些小作业和小组展示，期末考就刷了一下选择题（好像用处不算大）最后4.5，谢谢老师
101170,867,张新樟,2019-01-28 00:42:42,17,18,1,楼上那位你是怎么代表我们所有人得出全都有反馈这个结论的???
101191,867,张新樟,2019-01-28 01:45:37,-5,0,5,讲课有点玄，认真听还是有很大收货的，书记处有好的，也有可能不太令人满意的，总体来说还是不错的。
101222,867,张新樟,2019-01-28 02:19:16,-12,3,15,好老师。\n\n讲课内容很吸引人，以前一直觉得马原是很无聊的课，但是老师讲了以后很多都觉得很好玩。\n\n平时事很少，没论文，发言要求也是一两句话即可。虽然有人恶竞但是我每次都是一两句。给分也很好。论述题我估计标准非常宽哈哈，考前老师还和我们说“放开想象力”，完全没复习一通乱写，结果最后满了。感恩老师。
101252,867,张新樟,2019-01-28 02:46:06,15,16,1,嗯，我觉得这位同学提的意见很中肯，讲的也很再理，但是我还是要按照我的方法上课。(很好！)
101394,867,张新樟,2019-01-28 06:36:52,4,5,1,我必须申明一点：这门课叫“马克思主义基本原理概论”，不叫“马克思主义哲学”，更不叫“我的马克思”老师人很好，给分也不错，只是可能马原课不适合张老师
101617,867,张新樟,2019-01-28 15:27:26,-7,16,23,本来不想写评价的，但是看了一圈评论，戾气之重让人难以置信，大家对班级制度和教学方式这么多意见，为什么平时不提出来呢？老师从第一节课开始就鼓励大家写邮件给他，为他改进教学方法提意见了，可是大家有不满不去跟老师反映，却在结课以后再来指指点点，恣意谩骂，我不觉得这样的行为是具有健全人格的人应该做出来的事情。每一个学生都不给老师提意见，做这种公共课讲师的老师又怎么去改进自己的教学呢？我对张先生的课堂也有不少意见，也写邮件向他反映过，他很认真地回复了我，我能看到他对课堂互动性不高，同学们听课后评价不一的忧虑，他也确实在之后的冬学期中做了一些改进的尝试。我不是书记处的成员，但课堂上有过几次发言，最后整理出来的学期总结也相对来说比较厚实，尽管平时分没有特别高，最后考试也有很多不会做，但最后还是满绩了。我不能说老师的授课效果令人满意，但他的讲课内容是真诚的，不是形式化的照本宣科，为什么一位真诚地向大家分享并渴望得到同学们回应，努力改进课堂的老师会被同学们这样地指责呢？是大家都习惯于  制定标准-按标准做拿高分  的课堂模式而拒绝进行师生间的探讨和交流了吗？大家是不是在“努力完成课程要求获得一个好成绩”的同时忘记了什么是 人 的课堂呢？我希望以后再选这门课，这位老师的同学可以在第一节课就好好想一想，可以在学习过程中尽可能地把自己所有的不满和愿望表达出来。学弟学妹们心里要相信：很多不好的评价都是交流上的障碍带来的误解，学长们难受的情绪，希望以后不会出现在你们身上
109616,867,张新樟,2019-06-18 01:56:34,2,2,0,啊我死了
109631,867,张新樟,2019-06-18 04:41:21,1,1,0,我佛了……
114540,867,张新樟,2019-07-10 12:34:53,2,2,0,马原可不应该是上课放放视频，下课让书记处整整就弄好的东西
116626,867,张新樟,2019-09-12 05:43:15,-5,0,5,讲课从某种方面而言其实非常有趣。给分好，任务少。我觉得这三点就够了。
116865,867,张新樟,2019-09-17 01:54:28,5,6,1,马克思主义是如此的正确，以至于它的敌人也要伪装成马克思主义者的样子
116902,867,张新樟,2019-09-17 06:15:52,12,12,0,上了两节课，感觉老师精神不太正常...？（不确定）说话颠三倒四的，一点逻辑也没有，也不知道在讲些什么
116909,867,张新樟,2019-09-19 07:37:24,4,4,0,不好的
117043,867,张新樟,2019-09-18 14:39:08,14,15,1,毫无逻辑，胡言乱语，垃圾老师，连布置任务都完全不清楚，如何执行，如何考量，都没说；任何一个上了年纪的男人拉上台都可以讲到差不多的水平，尤其是喝醉了的那种。
117229,867,张新樟,2019-09-20 15:49:55,6,6,0,太迷了
117410,867,张新樟,2019-09-24 03:56:27,1,1,0,感觉不是一个马原老师，尘世啥的
117430,867,张新樟,2019-09-24 07:35:55,4,5,1,若能专开一门自己的哲学课，可算有自己的思想，九分十分都能得。但要当马原老师，平心而论，这么个教法六分嫌多。我是来上思政课的，而非在林荫树下学作逍遥学派谈笑风生，而且就目前上的内容来看，我感觉不到授课内容与马克思有半点关联。小子愚笨，问一下懂哲学的各位，“马哲的最核心是二元论”这句话对吗？
117893,867,张新樟,2019-10-08 02:40:49,4,4,0,我寻思我悟性也不差，选过通识类的哲学类课程感觉也不错，但是这个马原我怎么就是听不懂呢kao
118168,867,张新樟,2019-10-22 03:11:36,5,5,0,上课不知所云……备课＝上网刷短视频……
118724,867,张新樟,2019-10-31 07:28:38,1,2,1,无话可说
119326,867,张新樟,2019-11-12 07:07:21,2,4,2,我现在 感觉老师像xj组织头目 放的视频都是精神污染\n\n而且他每节课真的不是在翻来覆去地讲一个主题...？
119343,867,张新樟,2019-11-12 07:18:51,3,4,1,打一分是因为没有零分\n\n听课都能听崩溃
120124,867,张新樟,2019-11-17 15:08:59,0,5,5,想说很多 但打了又删 汇成一句话 NMSL
120777,867,张新樟,2020-01-16 23:57:42,3,3,0,玄，但是事少给分好(✪▽✪)！
121683,867,张新樟,2020-01-20 21:48:16,3,4,1,不点名 一份听课笔记（包括个人感想 小组讨论 和小组的一篇小论文） 小组不给安排 自己联系 只要组员好 真的事少 老师给分也很好 我满了
122577,867,张新樟,2020-03-05 00:26:19,0,1,1,前面看到有同学说老师没有逻辑，不，他不是没有，只是坚信自己的逻辑。同学投票出的方式，他用自己的逻辑否定了结果，并且一直我觉得。。。这是第二节课，但我已经不相信他说的每一句话。结课以后再来。
122961,867,张新樟,2020-04-26 05:32:32,0,1,1,老师能教我打太极吗
123461,867,张新樟,2020-06-09 04:37:36,3,4,1,快逃！！
123832,867,张新樟,2020-06-15 01:46:15,2,5,3,y1s1，这老师上课声音这么轻，讲课内容跟马原没半毛钱关系，讲的都是些玄学，纯合铁nt\n\n
124038,867,张新樟,2020-06-22 04:22:00,-1,4,5,别骂了别骂了，书记处很好哒，20年课程已经公开评分了，那些骂骂咧咧的人自己上课是什么样不知道啊，不配合老师的教育教学工作还有理了？？？我佛了！
124419,867,张新樟,2020-06-30 15:40:23,4,6,2,老师上课有时会点名，讲课自成体系（但这个体系不太好，没兴趣听，考试也不会考这么深)，因此对于基础性的知识点很少讲，但如果分班阅卷的话也没啥关系，老师说按照他讲的或者课本上的都可。\n\n声音很轻，上课也很慢，不太有激情。\n\n据说是吴氏太极拳第五代（好像是）传人，看他放的小视频感觉太极拳打的不错。\n\n老师上课时喜欢放一大堆视频然后讲自己的看法，认真听的话蛮有道理的，但我感觉认真听的人不会超过一个，只有要完成学在浙大的讨论，并且又不太看得懂视频才会看回放去听一点。\n\n老师人不错，上课有一个工作小组，也不知道怎么分的，感觉他是挺想把自己的一套理论讲给大家的，对于邪教的一些剖析看起来挺深刻，也没有细看，没有论文，最后交一个听课汇总，因为这学期线上的原因，实战（就是一次展示）也比较简单，线上展示念稿子也关系不大，同学们打分的，感觉老师给分不错。\n\n如果实在是想水，可以选；想听马克思的一套，请找一个别的老师；想听老师的一套，中午喝一杯咖啡来听，并把没必要的东西收起来以便上课时这些东西太吸引你而听不进去老师讲的东西。\n\n最后再强调一句，老师人还是不错的！
124425,867,张新樟,2020-07-01 03:17:17,2,5,3,不吹不黑人不错
124703,867,张新樟,2020-07-06 13:59:50,2,6,4,不好好教课，就讲玄学，绩点巨低，我一个学相关专业的，这么低的绩点，期末考试我绝对心里十分有底，我也不知道为什么。
125874,867,张新樟,2020-09-15 07:21:19,0,1,1,很不错
125995,867,张新樟,2020-09-16 12:05:18,0,1,1,好好好
126080,867,张新樟,2020-09-17 08:11:06,3,4,1,整个大学碰到的最差的老师，我大一上就选了他的马原，当时对浙大的教学水平真的是绝望，后来上过其他好老师的课才逐渐恢复信心。另外他上课的内容，自己的马原水平真的是极差，我一个学相关专业的学生真的都看不下去
126309,867,张新樟,2020-09-22 06:08:28,1,1,0,人还行 感觉上课听不太懂 太玄学了 可能是我造诣不够
126899,867,张新樟,2020-10-27 04:05:59,6,6,0,年轻人不讲武德
127817,867,张新樟,2020-11-28 00:58:10,4,4,0,秋学期选了他的宗教课，平时分是一次课堂展示+课后听课记录，期末考试开卷，题目提前告知，可提前做准备。讲真，这节课除了第一节课剩下的课一节没听过，听课记录照着ppt写的，课堂展示倒是认真准备了，最后下来课堂展示小组全班第二，4.5绩点，对于我来说还算不错，因为课是基本没听。老师讲课有点迷，什么二元论啊，黑格尔啊，说实话我听不懂，感觉真的没学下什么东西
127842,867,张新樟,2020-11-28 11:05:10,3,3,0,老师上课比较无聊，平时没咋认真听，感觉老师说的宗教理论非常的拗口和抽象，感觉其实学不到啥。小组展示认真准备了，平时笔记就是10分钟对着PPT复制粘贴。期末考试会提前给四道大题，上线500字，任选两道题写，我结合了一下我自己专业的理论讲了一讲，答题说实话有点偏但是比较新颖吧。最后老师给了5.0\n\n我觉得这个老师要拿高分就需要跳出他课堂讲过的知识，在他的体系之外找一些新的材料或者理论。虽然我自己的观点可能比较稚嫩。
129053,867,张新樟,2020-12-29 07:31:54,-6,3,9,非常好的老师，把原本无聊的马原课上的很有趣，会放许多视频，没有论文，任务轻，一开始听有些困惑但是老师会用生动的比喻还有自己的理论把一些枯燥的知识点讲出来，受益匪浅
131842,867,张新樟,2021-01-29 05:54:51,5,5,0,点到都到了，课堂笔记认真写了，考试怕太低特意去找考研政治课看了，求个4.2不过分吧，给2.7，服了
131974,867,张新樟,2021-01-29 17:31:37,0,2,2,拿这学期我的体验总结：事少无论文，平时作业可以不交，期末交总结就可以；期末考试本以为会炸，结果居然还不错，复习几小时居然可以上4。上课可以水，但是绩点要高的话大概离不了担任职位和复习多看书。如果你不是那么想学马克思主义，那可以选选看，感觉上课是在上大半的中国传统文化+小部分的马克思主义，老师讲课非常玄幻，身着练功服，点评马保国，非常有那味。\n\n\n\n与其说是一门政治课，这门课感觉像是中国传统哲学观的马克思主义plus，以至于到最后你会惊恐的发现课上学的东西是应付不了考试的。仅仅看了几小时书的我绩点上了4，所以我觉得这至少不是一门没复习完就完蛋的危险课程。平时分来自上课签到、小组展示和个人听课记录，老师设立的那些职位，到最后我都不知道怎么选出来的，不过对成绩的影响也没像评论区说的那么夸张。
132303,867,张新樟,2021-01-31 15:23:39,-1,0,1,还可以，我觉得至少我确实学到了一些东西（虽然对于马原没有什么兴趣，也没听过课，但是有关一些问题，和老师做过讨论，确实很有收获）
132434,867,张新樟,2021-02-01 14:28:12,0,2,2,什么都干了，3.0是尼玛什么鬼，趁早退选！
188781,867,张新樟,2024-01-20 02:30:19,1,1,0,垃圾人
286,868,许丽萍,2015-03-15 00:16:05,27,37,10,许丽萍老师很和蔼，人很好
730,868,许丽萍,2015-03-16 05:20:27,130,139,9,关心同学身体健康甚于讲课
856,868,许丽萍,2015-03-18 01:20:22,48,58,10,上课很松很和蔼。
1698,868,许丽萍,2017-03-06 02:36:14,46,57,11,不是很有趣，但老师人不错
3410,868,许丽萍,2015-06-10 06:33:15,0,10,10,挺无聊的
3556,868,许丽萍,2015-06-17 01:33:59,7,16,9,挺和蔼的一个老师，上课水水发言还是要的
4321,868,许丽萍,2015-06-19 12:03:12,22,26,4,脾气好，三观正。
4423,868,许丽萍,2015-06-22 16:34:03,-12,24,36,说实话，讲的都是一些老生常谈的东西，还喜欢说一些自己不懂的经济，政治，有的话说出来真的很幼稚，比如，把那么多贪官杀掉，可以援助多少贫困的人…实在无语
4448,868,许丽萍,2015-06-23 08:05:06,6,9,3,老师讲课很好的
4836,868,许丽萍,2016-12-19 16:10:47,-1,4,5,给分好
4978,868,许丽萍,2015-07-02 00:50:58,7,10,3,还挺好的
5149,868,许丽萍,2015-07-05 03:48:46,8,11,3,人好
6590,868,许丽萍,2015-07-16 03:32:49,5,14,9,绝壁的好老师啊！给分超级厚道！我考试考的这么惨还是上4了，我爱她她她她她她她她啊啊啊啊啊啊啊啊啊啊！业界良心
6638,868,许丽萍,2015-07-17 00:41:59,0,4,4,人好，事少，给分厚道
6675,868,许丽萍,2015-08-26 02:54:26,0,4,4,好！
14138,868,许丽萍,2016-01-05 01:16:07,1,5,4,讲的很一般。。很和蔼很关心同学 为同学停课写论文
14608,868,许丽萍,2016-01-08 03:00:59,43,49,6,是个三观很正，关心同学的好老师。宽容不同的观点，看重真实的想法，论文里哪怕直接写没看懂也没关系~
15705,868,许丽萍,2016-01-16 07:11:40,0,2,2,人很好，事情少，给分棒
16305,868,许丽萍,2016-01-18 00:47:52,13,18,5,很和蔼。每节马原课看西方哲学史，老师看到之后向我推荐了这本书的英文版。。。
18161,868,许丽萍,2016-01-21 08:28:07,0,5,5,讲做人的道理，最后一堂课给人无尽的感动，力顶，只有上完了才知道珍惜。
19428,868,许丽萍,2016-01-24 07:58:17,0,2,2,许老师人特别好！！
19510,868,许丽萍,2016-01-24 12:27:58,0,2,2,还不错，很关心学生
19563,868,许丽萍,2016-01-24 16:40:42,0,2,2,好老师！！
19698,868,许丽萍,2016-01-25 15:00:07,1,4,3,老师挺好 但是很偏爱某些专业的学生 颗颗 虽说学术有专攻 不过我想说一谈到经济政治方面的东西这老师真的不专业 哲学和社会学还行
19840,868,许丽萍,2016-01-25 11:17:50,0,2,2,挺不错
19926,868,许丽萍,2016-01-25 14:32:27,0,5,5,给分高 出分慢 课ok
22750,868,许丽萍,2016-03-10 13:30:54,0,3,3,好老师！！
24730,868,许丽萍,2016-05-03 08:28:50,0,3,3,老师人很好
26041,868,许丽萍,2016-06-15 07:40:43,-26,6,32,下大雨依然要 下水…………脾气不是很好
26559,868,许丽萍,2017-09-18 06:24:49,30,35,5,讲真！老师真的特别特别好 关心学生健康胜于上课是大实话 在浙大见过的最温柔最善良妈妈般关爱学生的好老师！能选她的课真是最幸福的事了！
27565,868,许丽萍,2016-06-27 03:39:18,0,2,2,脾气好
28644,868,许丽萍,2017-03-06 02:35:55,23,29,6,如果说什么是师风师德，那许老师就是最好的体现。非常关心学生，尽管常常因为马原课大家的表现很失望，但是人还是很好！
29504,868,许丽萍,2016-06-30 01:50:53,0,2,2,超级关心同学，感动！
31216,868,许丽萍,2016-07-03 11:41:41,-1,3,4,女神！
31250,868,许丽萍,2016-07-03 12:58:13,1,5,4,只能说课本身不有趣，但老师挺会讲的。对学生真的非常非常宽容啊，事情少，给分也算好的了吧
31260,868,许丽萍,2016-07-03 13:22:03,0,2,2,有三次签到 老师人很好 给分真的很好
31283,868,许丽萍,2016-07-03 14:08:34,0,2,2,老师对学生真的很好，而且最后给分也很宽容
31294,868,许丽萍,2017-12-20 12:25:03,1,5,4,很关心同学，对不同的看法十分包容，给分不错
31296,868,许丽萍,2016-07-03 15:07:43,0,3,3,老师人真的炒鸡温柔炒鸡好，关心同学又非常包容，给分也好
33523,868,许丽萍,2017-01-22 03:20:09,1,3,2,老师给分真好 人真好 感谢老师
33905,868,许丽萍,2016-09-22 11:56:23,0,5,5,上课很有干货，对同学们也很有耐心，最后给分满满的师生情
34104,868,许丽萍,2016-09-27 05:06:26,0,2,2,温柔善良
34324,868,许丽萍,2016-10-02 11:41:03,1,9,8,上课真的很水，感觉在浪费自己的生命。上帝啊，普通话不标准不说，语言组织能力真的很差，前提基础立足点之类的词随便乱用，根本就没有一点政治词汇的敏感性好吗。
34393,868,许丽萍,2019-06-18 03:05:44,9,24,15,没逻辑没思路没深度。还真的以为自己特有内涵特懂哲学。浙大选老师的标准真是匪夷所思。
38055,868,许丽萍,2016-11-24 00:54:41,7,9,2,无聊，很水
38892,868,许丽萍,2016-12-19 16:18:16,3,6,3,下大雨那个你说的是许亚萍吧
41223,868,许丽萍,2017-01-22 11:05:52,4,5,1,随便吧
43408,868,许丽萍,2017-01-16 08:24:22,1,1,0,老师很善良，鼓励学生表达自己想法和包容不同想法
45763,868,许丽萍,2019-01-03 14:36:05,48,67,19,分还没出，就事论事说一说，老师人非常好，提前下课让我们吃饭，但讲课真的不行，非常水，例子混乱，没有逻辑。不管学生展示多渣，或是回答多差，都会说“很好，不错，惊艳…”老师总是笑笑的，很温柔，但其实还是希望老师能有原则一点，有啥说啥，这样学生才能对自己的水平知根知底。
46525,868,许丽萍,2017-01-22 01:50:04,2,3,1,打分。
46581,868,许丽萍,2017-01-22 03:12:28,0,1,1,哈哈哈哈老师给分真好谢谢老师哈哈哈哈\n\n
46607,868,许丽萍,2017-01-22 03:47:02,0,2,2,浓浓的师生情，上课水 出分慢 但是给分特别特别好 \n\n
46616,868,许丽萍,2017-01-22 04:07:04,1,3,2,给分好棒啊 \n\n上课虽然没听具体内容\n\n但是其他有的话还是很受用\n\n
46633,868,许丽萍,2017-01-22 04:30:34,3,5,2,讲课挺有趣的，上课更多的是启发学生的思维，也会告诉我们一些书上的重点段落。人很和蔼，很爱笑的一个老师，给分也很好，上课认真听课积极发言会有加分的。期末考完老师说，严格的来说有三分之一的人不及格，但是最后绩点还是很不错的。非常喜欢这个老师
46635,868,许丽萍,2017-01-22 04:34:50,0,3,3,能选上这样的思政老师夫复何求。
46671,868,许丽萍,2017-01-22 06:18:53,2,3,1,很温柔的老师~是一个文艺女青年哈哈哈，人真的很好，懂得也不少，就是受马原课程本身的属性所限所以没办法~虽然不是很能理解年轻人的思维但是很宽容的！
46680,868,许丽萍,2017-01-22 06:52:02,1,3,2,老师人真的非常善良，非常理解和体谅同学们，事少给分好，授课略无聊但也不会让人反感。谢谢老师！
46686,868,许丽萍,2017-01-22 07:09:41,1,3,2,我复习最久最认真的一科却和我裸考的同学成绩一样，比较失望。
46950,868,许丽萍,2017-01-23 04:54:37,1,3,2,给分不错的啦！而且事情很少，平时也很温柔。但是有口癖，会听的很烦躁_(:з」∠)_
47072,868,许丽萍,2017-01-23 14:15:23,1,3,2,只希望我的毛概老师也像许老师一样，事少给分好
48476,868,许丽萍,2017-04-01 02:34:30,-13,8,21,讲课水平和?一样，为什么这老师没被开除？\n\n说一切认识从实践中来，自己全然不懂实践，在具体学科上的造诣似乎不及初中生。\n\n上课第一第二周，全然宣扬宗教，感觉平时上课神情和那些校外信教的老太太差不多。她是马原老师吗？\n\n上课思路很乱，让人对马克思主义根本没办法有一个总统的认识。\n\n唯一不错的是会提前10min下课。似乎这是老师唯一的亮点了。
48477,868,许丽萍,2017-03-06 02:35:44,0,0,0,玄学
48482,868,许丽萍,2017-03-06 02:57:45,2,3,1,关心学生⊙_⊙
49977,868,许丽萍,2017-04-28 02:42:44,0,2,2,许丽萍：用手机进行碎片化阅读的都是社会青年。
51306,868,许丽萍,2017-05-30 09:04:39,-5,8,13,讲课很差劲，三观难以接受，认为学习没用，女生可以不努力，宣扬宗教。马原课让这种人来上？
52806,868,许丽萍,2017-06-23 03:40:27,2,4,2,老师很温柔，给分不清楚。但是教学一直以鼓励为主，虽然大家都不听…但是人品没问题的，评论里有些真的迷得没法看。
52835,868,许丽萍,2017-06-23 06:42:28,0,1,1,有口癖，听起来挺难受的，总的说老师人还是很好的，只是某些观点不能认同，总的来说还是一个好老师。
54371,868,许丽萍,2017-06-29 07:56:08,0,1,1,有人知道老师的电话或邮箱吗？？？急
56524,868,许丽萍,2017-07-04 02:45:30,-3,2,5,老师很温柔很温柔 事情少 但是马原还是主要靠自己的吧 反正我满了
56530,868,许丽萍,2018-06-22 02:18:53,1,1,0,许妈妈吼啊
56614,868,许丽萍,2017-07-04 05:50:56,0,1,1,给分超超超超超好！马原这课就是红砖，所以选个好老师很重要，强推。
56663,868,许丽萍,2017-07-04 07:57:30,-20,4,24,对于理科生开说，上课的确听不懂，但是老师的确很关心学生的健康，给分也好！（这是重点！！！）\n\n\n\n翘课一次，小组评分倒数第二，选择填空全靠蒙，最后4.5?
56803,868,许丽萍,2017-07-04 15:54:17,4,5,1,给分……好吗？3.6?感觉选择题做的还算顺！展示也是中等水平！难道是我论文写的太烂？？还是大题写的差
58829,868,许丽萍,2017-09-18 04:27:05,13,23,10,首先论文只有两个评分标准，十分和九分，组长没当上想靠好好写论文往上拉分别想了。小组给分完全是组长定，定完也不公开，感觉这种评价方式并不是很合理。老师人还是挺好的，但讲课说真的很无聊。作为一个不是组长但组内认真做事，论文花了大功夫写作，期末背到爆炸的理科生，3.9分蛮难过。
59988,868,许丽萍,2017-09-30 03:06:51,0,0,0,老师非常好
60342,868,许丽萍,2017-10-18 01:52:54,8,11,3,评分太高
65902,868,许丽萍,2018-01-10 05:30:52,0,1,1,很好，非常推荐
71174,868,许丽萍,2018-01-28 05:51:25,-1,0,1,好老师！！！！
71176,868,许丽萍,2018-01-28 05:54:56,1,2,1,老师人很好，感觉好温柔呀，关键给分很好呀。出分有点慢，但是估计是忙着调分吧。
71178,868,许丽萍,2018-01-28 06:03:41,-5,4,9,好烂的老师啊\n\n真的很认真了还是分很低
71201,868,许丽萍,2018-01-28 06:34:05,-1,1,2,老师真的很好 每次不管同学说什么都会肯定 而且说过好多次从我们身上学到很多 说的我都很惭愧 课堂发言有记录  这个学期课堂上发了三次言 论文水过去的 小组展示分数挺高的 最后4.5 满足了
71211,868,许丽萍,2018-01-28 06:51:26,1,1,0,给分慈悲是真的，上课也很注意和同学沟通，总之这个学期和老师相处得很愉快啦
71213,868,许丽萍,2018-01-28 06:53:34,0,1,1,非常暖，非常好的老师\n\n很幸运
71224,868,许丽萍,2018-01-28 07:16:48,0,0,0,给分极好 不过也看自己的考试成绩啦\n\n
71228,868,许丽萍,2018-01-28 07:27:56,0,1,1,老师给分真的是好，但是不要因为老师给分好期末就不努力了，毕竟期末也有很大影响！
71263,868,许丽萍,2018-01-28 08:12:14,0,0,0,老师很温油很棒
71364,868,许丽萍,2018-01-28 10:57:01,1,1,0,主要是看期末考，论文，小组展示和发言。给分好（我原来以为我思修这类课都不会上4哈）。老师也很好，嗯上课会跟你分享很多，虽然很多书和人我都不知道……哲学方面讲得很合我意。
72397,868,许丽萍,2018-01-30 05:08:37,0,1,1,一定要当组长！！！\n\n老师人很好！
73976,868,许丽萍,2018-02-04 02:50:42,0,0,0,相当和蔼，平易近人，不过讲课未见得有多流畅
76067,868,许丽萍,2018-03-26 06:47:58,0,0,0,老师讲课真的是通俗易懂，不带一点专业术语....
77318,868,许丽萍,2018-05-04 15:12:50,13,16,3,上课非常水，作为一个有一定哲学基础的人觉得她的马哲讲得毫无逻辑。人确实很和蔼，对大家也以包容鼓励为主。给分真的很一般很一般。
83781,868,许丽萍,2018-07-11 08:27:23,0,3,3,不说了，我就是来打10分的。\n\n
83786,868,许丽萍,2018-07-11 08:33:07,1,3,2,给分巨好 我这样的钢铁理科生都能上3
83787,868,许丽萍,2018-07-11 08:33:27,3,3,0,emmm课其实讲的不怎么样，感觉逻辑性很差。\n\nbut老师人很和蔼，期末考试写错老师名字orz没有被为难（虽然卡绩点了）
83788,868,许丽萍,2018-07-11 08:35:36,0,1,1,10分，必须的
83792,868,许丽萍,2018-07-11 08:37:14,1,3,2,老师很温柔的，很关心学生的身体，好像是从夏学期开始就有点名了吧。给分的话，感觉挺好的呐，上课基本没怎么听，马原这种东西奉行考前两小时原则吧，好好背的话，理科生上四也不是梦呐～
83793,868,许丽萍,2018-07-11 08:38:43,1,3,2,人好、上课很水、给分高、事少
83794,868,许丽萍,2018-07-11 08:38:44,0,1,1,有点水，老师人好
83796,868,许丽萍,2018-07-11 08:39:36,2,3,1,好好好
83801,868,许丽萍,2018-07-11 08:42:32,0,1,1,许老师讲课比较发散，但是可以做同学们生活上的导师，很关心爱护同学，平易近人，给分好，事情少。很感谢许老师！
83803,868,许丽萍,2018-07-11 08:47:10,0,0,0,非常温柔有见识的老师
83810,868,许丽萍,2018-07-11 08:52:12,1,3,2,老师讲课的逻辑有时候会很乱，但不可否认的是，老师具备一定的专业水平，老师会很认真听同学们的发言，都会予以肯定，非常关心学生健康，好棒！
83811,868,许丽萍,2018-07-11 08:52:13,-2,0,2,老师很好啊
83817,868,许丽萍,2018-07-11 08:59:51,-13,4,17,唯一一门下4的通识课，不知道为什么，打扰了
83865,868,许丽萍,2018-07-11 11:18:40,1,2,1,哲学专业出身的许老师，上课经常会提一些很有深度的思考题让我们讨论，真的是在传道授业。期末考试感觉大家都差不多，给分基本看平时表现和论文。每次课我都坐前两排，每周的马原课都是一场精神盛宴。小组展示有时也会有唇枪舌战，还好老师及时出来解围23333，考前老师还发微信祝我考试顺利，简直不能再好了～
83886,868,许丽萍,2018-07-11 12:28:12,0,0,0,老师人真的超好 上课水水发言 然后论文会给我们减字数 一此小组展示 虽然给我卡了绩点 但我还是爱她！
84409,868,许丽萍,2018-07-12 20:28:04,1,2,1,老师很关心我们，为了让我们吃好饭都尽量早下课，喜欢听我们的想法，给分也很好呐
84433,868,许丽萍,2018-07-13 00:02:43,8,10,2,人不错，课就呵呵了
84532,868,许丽萍,2018-07-13 05:41:04,0,1,1,话不多说，许老师给分真心慈悲为怀，你懂的~
85224,868,许丽萍,2018-07-16 07:54:37,0,1,1,老师可能讲得有点散，但是很认真负责，超级温柔的！
85436,868,许丽萍,2018-07-18 00:43:42,7,8,1,8分不能再多了。事少，讲课很一般。没有小组长包分配制度不建议当组长。提醒大家马原一定要提前准备！我一个理科生感觉真的很难不知道背什么，最后找了一堆资料整理框架才清晰了一些。另外选择题也很难，不仅要做题库，书也要仔细看看，尤其是绪论部分。
87157,868,许丽萍,2018-09-21 03:22:53,13,15,2,老师上课真的非常无聊，很多废话还很催眠。评论说老师人好我没意见，但这个9分真的过高了
88563,868,许丽萍,2018-11-01 12:00:49,12,12,0,心向物理（尤其是量子力学）的马原老师
89214,868,许丽萍,2018-11-17 02:29:54,0,1,1,十分无聊。逻辑模糊，表达不清，说是讲得慢照顾不同基础的同学，但是讲课内容没有干货啊!!不知道为什么有这么高的评分，难道就是因为给分好?求学的目的是提高自己而不是水成绩好吧?
89774,868,许丽萍,2018-11-20 18:34:19,0,2,2,课是真的无聊，翘课是常规操作，在寝室里睡觉美滋滋?
91189,868,许丽萍,2018-12-03 03:03:40,3,3,0,人好不否认，9分绝对偏高了，课非常无聊，不建议特别选（对老师没有意见，我只是来拉低一下平分
93016,868,许丽萍,2019-01-07 02:16:45,0,1,1,老师人是真的好，讲课是真不行。
93018,868,许丽萍,2019-01-07 02:49:16,0,0,0,。。。
93049,868,许丽萍,2019-01-07 06:22:53,0,0,0,考前答一波，老师真的很用心，会关心我们的身体健康，上课也蛮认真（虽然我从来没听，一听马原就头疼），但老师会教你很多生活上的道理，或对或错，但她是个温柔的好老师。
93641,868,许丽萍,2019-01-11 04:16:41,1,5,4,emmm人好没意见，说三观正的都是认真的吗
93838,868,许丽萍,2019-01-14 03:32:09,-1,2,3,老师讲课真的不好吗？？\n\n认真听是有意思的呀！\n\n老师真的知识面很丰富
93852,868,许丽萍,2019-01-14 04:13:01,0,0,0,讲课有点混乱，题外话有点多，但人很好！
93863,868,许丽萍,2019-01-14 04:52:43,1,2,1,www老师真的太好了！\n\n结课的时候说了一大段话 真的是很关心学生 三观也很正\n\n事情也少
94471,868,许丽萍,2019-01-16 15:41:24,0,0,0,…………
98775,868,许丽萍,2019-01-24 02:22:07,14,19,5,我以为这老师上课逻辑混乱思想陈旧，就算人很温柔给分好也应该不过8左右，没想到居然有这么高分数……不说了我就是来拉低评分的（真的想学马原的千万别选她的课了，或者就跟某位交西哲的老师说的一样，浙大叫马原的都不能称之为学者？
100264,868,许丽萍,2019-01-26 01:24:34,-5,4,9,一次点名没到，期末也有突击看一看，结果3.3？excuse me ？老师是个烂好人，没有原则只会和稀泥
100265,868,许丽萍,2019-01-26 01:29:22,4,7,3,老师给分成谜 可谓随机给分。。。
100266,868,许丽萍,2019-01-26 01:29:50,-21,8,29,我竟然满绩了，既不是组长，上课也没发过言。因为是理科生，所以理论很差，论文建了个很low的数学模型，结果模型证明到中间卡住了，最后因为不想多花时间，强行收尾。期末懊悔复习法，刷了选择题题库，简单看了一下书，就满了。\n\n好老师，还是注重期末的卷面成绩吧
100272,868,许丽萍,2019-01-26 01:45:39,3,7,4,成绩意外之喜！说实话付出很少，就稍微认真写了写论文，考试也基本考高中老本但是！真的很感动了！班长组长们都是很棒的！\n\n不过说老实话，老师讲课不太行，人很不错！很幸运上了您的课啦~负担真的不大~
100281,868,许丽萍,2019-01-26 02:00:47,-9,6,15,作为一个马原老师逻辑混乱 上课每天嗯嗯啊啊讲不出个完整的有内容的话 只能靠关心学生健康拉一拉评分 给分还不好 想听课的朋友建议不要选这位 真的一节课都坚持不下来听完 学无所获就算了 还拉我均绩 真是可恶
100287,868,许丽萍,2019-01-26 02:10:10,0,4,4,平时基本没发言，最后绩点高出了自己的预期，老师很和蔼，不错的。
100289,868,许丽萍,2019-01-26 02:13:04,0,2,2,老师上课很轻松，但是很用心！给分也很棒！
100293,868,许丽萍,2019-01-26 02:15:10,-9,6,15,尽管我上课听不懂，论文也不会写(来自工科生的悲泣)但老师人很好，总会提前下课让我们吃饭。而且老师给分超好，完全没有哲学基础，考试前突击背了一下重点，让人意想不到的4.5，真的超级超级开心！
100295,868,许丽萍,2019-01-26 02:18:24,9,11,2,emmmm奇奇怪怪的为什么大家评论都很好
100312,868,许丽萍,2019-01-26 02:47:41,4,5,1,也算在这门课上认认真真付出过 结果真的很失望 不明白为什么分数这么低 很难受
100337,868,许丽萍,2019-01-26 03:16:42,0,1,1,老师很和蔼哦 最后考试要自己加油复习呐\n\n
100342,868,许丽萍,2019-01-26 03:19:16,2,5,3,出分慢一点但绝对好老师，不解释
100352,868,许丽萍,2019-01-26 03:27:42,0,3,3,课后问问题，老师午饭都没吃 给我仔细地讲了一小时。这样的好老师不多啦
100529,868,许丽萍,2019-01-26 09:01:08,-1,1,2,老师人很好啊！
101355,868,许丽萍,2019-01-28 05:24:48,-8,3,11,感谢老师！思政课第一门满绩。\n\n虽然不清楚自己分怎么来的，但是还是很感谢。马原考前需要刷题，许老师讲课比较慢，大概只能听剩余价值的部分，其他要自己认真看呀。
104862,868,许丽萍,2019-03-29 03:06:58,12,25,13,1分只为拉低评分。\n\n老师虽然称得上负责，但作为教师，最重要的是教学，而不是性格，给分或者关心同学健康。而老师的教学水平，实话说没有那么高。给9分以上实在太高了，有误导之嫌。\n\n还是说，其实教学水平在你校并不重要？
112200,868,许丽萍,2019-07-03 22:24:31,0,1,1,人确实很好，但给分有点迷...
112319,868,许丽萍,2019-07-04 01:34:01,-1,2,3,蛮不错的一个老师～
112361,868,许丽萍,2019-07-04 02:47:28,0,1,1,老师有点佛
113849,868,许丽萍,2019-07-07 18:13:59,-1,2,3,老师真的还蛮好的！！
118124,868,许丽萍,2019-10-21 06:08:16,4,6,2,我家住在一个没有网的地方，特别偏僻，如果想找我不要给我发邮箱，我看不到
118527,868,许丽萍,2019-10-28 06:16:30,8,10,2,主要是想拉低一点分，从授课水平说九分太不真实了
121883,868,许丽萍,2020-01-23 05:34:47,0,0,0,好。。
122098,868,许丽萍,2020-02-12 14:34:40,1,4,3,特别关心体谅学生，还说“我的课你们不要花太多时间  你们有很多事要做”。喜欢启发我们去思考一些以前没想过的问题。
122669,868,许丽萍,2020-03-16 02:48:17,7,9,2,这学期网课，基本全读稿子，PPT内容简单空洞。上课随机提问，问的问题不知所云。强烈建议不要选，很无聊。不如去选方瑞老师。
122996,868,许丽萍,2020-05-09 07:28:48,7,10,3,我来拉低评分了\n\n讲的不知所云，不如选择隔壁方瑞老师
124460,868,许丽萍,2020-07-01 13:45:42,-3,1,4,给分超级好！
124465,868,许丽萍,2020-07-01 15:08:12,6,6,0,上课不行
124480,868,许丽萍,2020-07-01 23:54:20,0,3,3,哇～强烈推荐许老师的马原课，老师人好，给分也高。
124493,868,许丽萍,2020-07-02 03:01:53,1,4,3,客观的说，上课不太行，给分还可以
124497,868,许丽萍,2020-07-02 04:04:48,1,4,3,我永远爱老师帮我捞到恰恰好92，为老师的捞人技术点赞，太善良啦！每个同学是论文还都给了评语。出分虽然慢，但是我相信老师是在努力捞人
124607,868,许丽萍,2020-07-03 14:38:48,5,10,5,老师真的太好了！事少（只有一篇论文，无展示）分高！本学期是开卷考试所以大家考试的差距似乎不大，出分慢应该是老师很努力地在调分了~
126653,868,许丽萍,2020-10-12 02:44:45,5,7,2,我都不知道这个9.1是怎么来的
126725,868,许丽萍,2020-10-16 02:12:24,1,4,3,老师你大可不必不懂装懂，以偏概全，给别人挂标签
127005,868,许丽萍,2020-11-02 09:43:02,0,1,1,给分好
129633,868,许丽萍,2021-01-09 10:23:50,3,4,1,讲不好干货，寥寥几个例子翻来覆去说
131886,868,许丽萍,2021-01-29 08:32:30,-12,4,16,德不配位
133465,868,许丽萍,2021-03-01 04:11:46,0,0,0,老师人挺好的，但是讲话有点啰嗦
135378,868,许丽萍,2021-05-09 02:13:06,7,8,1,老师性格好，佛系，不适合卷王，愿意划水的同学不能错过
135937,868,许丽萍,2021-06-18 03:17:01,-6,4,10,举例讲解毫无逻辑，真想带耳塞。听着课我都快笑出来了。
136470,868,许丽萍,2021-06-18 10:27:18,3,3,0,老师讲课水平不论，人还是很好的
136569,868,许丽萍,2021-06-21 06:58:19,2,2,0,老师上课很认真，也很体谅同学的其他的课业情况。好好交作业好好展示，会有好的回报的～
139294,868,许丽萍,2021-07-14 05:35:22,2,3,1,水平不论\n\n课堂氛围挺好，卷的气氛不浓，给分也好，老师人也挺好\n\n算是比较舒适的一位老师
144775,868,许丽萍,2021-12-23 14:19:10,1,1,0,很和善的老师，要求也不高
146328,868,许丽萍,2022-01-06 08:28:44,2,2,0,讲课水平确实不太行，不过事情少关心同学，而且很体谅大家，就从过ddl很久后还能补交论文和课堂发言这一点就值得十分。
148348,868,许丽萍,2022-01-12 07:58:33,0,0,0,老师人很好，很关心同学
148971,868,许丽萍,2022-01-14 05:05:29,-1,1,2,给分差
149285,868,许丽萍,2022-01-15 03:43:42,0,1,1,讲课真的不太行，给分…唉
149603,868,许丽萍,2022-01-16 07:34:19,3,3,0,给分无敌了
155631,868,许丽萍,2022-06-15 01:21:13,0,0,0,老师人还是不错的，比较关心同学，（马原）上课事情比较少，如果想把这门课水过去的可以选她。当然你可能不太能学到什么东西，期末需要靠自己（
158711,868,许丽萍,2022-07-01 13:54:53,1,2,1,老师很好，发言可以课后补，ddl能往后推，很和蔼亲切的老师！
164818,868,许丽萍,2022-12-26 09:23:25,3,3,0,讲课一般，给分不错，事少
166148,868,许丽萍,2023-01-11 07:40:22,0,1,1,讲课无聊
166271,868,许丽萍,2023-01-11 15:16:09,5,5,0,老师讲课水平确实一般，但是人特别好，特别关心同学，主要给分是真好。
166446,868,许丽萍,2023-01-12 09:34:09,6,6,0,老师讲课是一般但是从她的讲课可以看出她讲的很认真，是热爱这门课的老师，不过这门课可以当水课上，讲的一般问题也不大。\n\n给分很好，人也很好，很温柔的一个老师，每次小组展示完她都在不停地夸不停地鼓励学生，课堂发言就是让我们读几段书上的话，就算没发言也可以在学在浙大补一个文字稿，只要发言了发言分就拿满。
170136,868,许丽萍,2023-03-01 13:04:53,2,2,0,老师人巨好 很温柔 带给你极致的关怀和享受。
176004,868,许丽萍,2023-06-27 11:38:43,5,5,0,老师人真的很好，温柔善良，很关心同学，真的很好。很适合水，老师课堂发言就让大家读ppt或者书上的话，力争让大家都发言满分，还特意为没发言的同学在学在浙大上开一个题目算成发言。小组展示之后老师也是真的很真诚地夸奖同学们，下雨天老师会让我们注意安全，阳了生病请假什么老师都非常理解，不扣平时分。虽然还没出分，但是这一学期的马原课真的感觉被老师的真诚打动，希望许老师越来越好。
176819,868,许丽萍,2023-06-30 08:53:59,6,7,1,老师真的太好了！！！马原给我捞成这样！不过我们可能是老师最后一届学生了？那就祝老师身体健康！谢谢老师！
176845,868,许丽萍,2023-06-30 11:05:39,0,0,0,老师是好老师，最后也获得了理想的分数
176871,868,许丽萍,2023-06-30 13:30:07,0,0,0,老师讲课确实有点没重点且啰嗦。但是!人真的特别特别好!很关心同学身体健康，阳了跟她请假她回复了一大段让我好好休息。最后喜提4.8，很开心!
176894,868,许丽萍,2023-06-30 14:50:49,0,0,0,老师人很好，很关心学生！！
420,1055,刘召峰,2018-03-09 03:43:43,223,270,47,老师真的很有思想，上课也很有意思~\n\n
1456,1055,刘召峰,2015-03-22 04:59:07,86,105,19,讲课很棒，对历史有自己的看法，不和书上讲的一样，会教学生质疑
1717,1055,刘召峰,2015-03-23 12:40:38,164,188,24,真正的学者!
2294,1055,刘召峰,2015-04-16 12:25:05,24,33,9,有想法，有看法
2334,1055,刘召峰,2015-05-16 11:56:00,17,26,9,棒
2653,1055,刘召峰,2019-07-07 17:08:36,17,23,6,注重思维培养，收获很大
3454,1055,刘召峰,2015-06-16 02:58:47,45,56,11,治学态度严谨，教会我们从不同角度看待历史人物，客观评价历史。
3471,1055,刘召峰,2019-11-11 01:11:14,11,29,18,人很好 但是理科生并不能理解老师的思维 听起来太理论很枯燥
3842,1055,刘召峰,2015-06-17 05:54:18,56,71,15,真的很有思想的老师
4379,1055,刘召峰,2015-06-20 02:43:45,33,43,10,挺喜欢这个老师的，讲课很认真，点了一次名（因为下雨去的人实在太少）很有思想
4608,1055,刘召峰,2015-06-25 03:17:02,0,5,5,有思想的老师，上课有一点点无聊，但是能学到很多
4787,1055,刘召峰,2015-06-29 01:34:54,23,31,8,有思想，真学者，看待历史客观公正，上他的课很有收获
4814,1055,刘召峰,2015-06-29 07:05:02,20,27,7,有三份作业，但老师真的很好。
5020,1055,刘召峰,2015-07-02 06:50:33,39,49,10,易于理解的学术讲座超赞
5055,1055,刘召峰,2015-07-02 15:58:11,14,19,5,很学术，很有思想，超级认真务实的老师。选他的课只要认真对待就好。
5392,1055,刘召峰,2015-07-07 06:45:12,11,15,4,讲的不错
5916,1055,刘召峰,2015-07-10 02:11:01,-53,21,74,这种水课要求还那么多纯属闲的蛋疼
6213,1055,刘召峰,2015-07-12 05:04:13,11,14,3,感动
6733,1055,刘召峰,2015-07-20 07:29:37,18,26,8,很有思想，作业略多，不过还是很有收获
6887,1055,刘召峰,2015-07-29 03:32:35,18,22,4,超级喜欢我老刘\n\n
7224,1055,刘召峰,2015-09-11 09:37:04,128,149,21,好老师，可以说大学里第一个培养我批判性思维的课就是中国近现代史纲要课。有一次我们请他来和我们探讨问题结束时送他小礼物，他都拒绝了，说“为学生做点事是应该的”。
7270,1055,刘召峰,2015-09-12 12:40:49,11,15,4,好老师
7326,1055,刘召峰,2015-09-13 14:17:07,9,15,6,棒
7332,1055,刘召峰,2015-09-13 15:00:50,19,25,6,讲得超级好，很有味道，喜欢开发学生的思维，展示很多课本之外各家的言论，训练基本研究的思路和习惯，鼓励发言和展示。大爱啊～
9453,1055,刘召峰,2015-10-28 00:28:44,13,18,5,很棒！
9851,1055,刘召峰,2015-11-11 06:31:21,3,7,4,很喜欢他的课~
10375,1055,刘召峰,2015-11-18 09:56:45,3,8,5,棒棒哒
10875,1055,刘召峰,2015-11-23 08:00:04,2,5,3,讲课很有思想，作业有些多
11137,1055,刘召峰,2015-11-24 12:24:52,2,4,2,很好很好
12652,1055,刘召峰,2015-12-24 00:01:37,2,2,0,不点名，但是常回答问题有加分
12916,1055,刘召峰,2015-12-24 10:08:48,2,4,2,一般般
13040,1055,刘召峰,2017-10-09 06:21:48,23,30,7,很注意培养学生的思辨能力，上课讲历史和说故事一样，可以不碰手机上完三节课。超棒。
13780,1055,刘召峰,2015-12-31 02:05:37,7,12,5,肚子里很有知识！学者！
14820,1055,刘召峰,2016-01-09 14:03:19,4,5,1,思政课里面很有意思的课
17328,1055,刘召峰,2016-01-20 04:42:14,3,7,4,讲得很棒！
26660,1055,刘召峰,2016-06-20 17:20:43,6,11,5,这学期是一位叫程早霞的老师上的，只能是呵呵呵呵呵呵呵呵呵呵呵呵呵呵呵呵呵呵呵呵呵呵呵呵呵呵呵呵呵呵呵呵呵呵呵呵。
30350,1055,刘召峰,2016-07-01 10:49:59,2,5,3,这学期是开学，一个叫帅瑞芳的老师说来代课，这一代就是一个学期，我就很迷了。。。
30925,1055,刘召峰,2016-07-03 03:03:08,3,6,3,代课的帅老师不行
31438,1055,刘召峰,2016-07-04 02:11:14,2,8,6,这学期的程早霞真的是我见过的最差的老师了，上课完全不知所云，千万别选她的！！！！千万！！！！\n\n
32453,1055,刘召峰,2016-07-07 02:23:34,3,7,4,出国了没在教务网给告示，代课的程早霞！差评！！！我的分还好，但是别人呢？给分差一点的，完全是糟糕的史纲课，不堪回首。
33727,1055,刘召峰,2016-09-21 07:30:05,1,3,2,很有腔调
33829,1055,刘召峰,2016-09-22 03:42:44,-2,2,4,真.学者
33858,1055,刘召峰,2016-09-22 06:20:36,19,27,8,本来抱着玩手机的心态来听课 但是刘老师的讲课方式 不洗脑 只提供选择的做法 讲述中隐着的开放而严谨的思想 不刻意的包袱 清甜口味的狗粮 让我不由自主放下手机 男神
33863,1055,刘召峰,2016-09-22 06:52:13,-1,2,3,炒鸡棒 好老师
33871,1055,刘召峰,2017-02-26 12:56:31,-1,5,6,作业多，讲课很好
34536,1055,刘召峰,2016-10-13 02:36:19,0,1,1,有深度 有思想
35355,1055,刘召峰,2016-11-09 06:11:36,4,7,3,很不错的老师，不过事情稍有点多
35605,1055,刘召峰,2016-11-10 07:31:38,1,3,2,上老师的课会让学生学着从不同的角度思考问题，会很有收货，讲课很好
36027,1055,刘召峰,2017-01-05 02:40:50,2,9,7,一个讲课炒鸡好的老师，能给人恍然大悟的感觉，很有思想。\n\n但是\n\n作业是\n\n真的很多……\n\n(。ŏ_ŏ)
38013,1055,刘召峰,2016-11-23 05:52:24,3,5,2,老师是一位真正的学者，但是作为理科生听得有点晕晕的
38434,1055,刘召峰,2017-03-01 09:56:56,3,4,1,老师很有见地? 很喜欢听老师讲课
39244,1055,刘召峰,2017-01-07 04:30:06,5,9,4,老师从未点名。课堂发言占平时分。。。可是我实在不知道说些什么。哈哈哈。。。如果当作听学术讲座的话，老师还是可以的。。。
40493,1055,刘召峰,2017-01-04 00:59:03,5,7,2,非常棒，真的是把历史和哲学作为一生的事业的那种老师。但是作业略嫌多……真的是做得得好累。我想说这么有内涵的老师不用留这么多任务我也会听课啊QwQ
40580,1055,刘召峰,2017-01-04 06:54:36,-1,1,2,满分！
40692,1055,刘召峰,2017-01-05 04:20:00,3,4,1,作为一个对历史很不感兴趣的人，却能够完完整整地听完老师的课！真的是一位很棒的\n\n老师，受益匪浅！
40708,1055,刘召峰,2017-01-05 05:26:06,1,2,1,一个很有思想很会思考的老师，会启发你以一种新的角度去思考问题，很多思考都很发人深省。性格很温和，上课很有趣，值得一听!
40731,1055,刘召峰,2017-01-05 07:28:18,1,2,1,学者之风
40735,1055,刘召峰,2017-01-05 07:36:33,1,2,1,挺有启发的，很棒！
41494,1055,刘召峰,2017-01-21 10:17:18,2,7,5,作业比其他班多好多好多
42396,1055,刘召峰,2017-01-21 06:38:13,1,3,2,课还行，就是作业有点多，给分一般啦
46263,1055,刘召峰,2017-01-21 05:36:50,1,2,1,最后一节课超感动
46268,1055,刘召峰,2017-01-21 05:59:20,6,17,11,猝不及防\n\n困惑解惑和论文辛辛苦苦两万多字，认真做ppt准备展示，期末还很认真的看书复习，结果是这样。说实话，史纲这样的课，作业有点多，还是挑事少的老师吧。
46270,1055,刘召峰,2017-01-21 06:04:01,-2,6,8,绩杀。
46275,1055,刘召峰,2017-01-21 06:13:37,-2,6,8,急啥绩杀击杀
46279,1055,刘召峰,2017-01-21 06:31:24,0,5,5,后悔退了预置选他的体验
46280,1055,刘召峰,2017-01-21 06:32:53,0,3,3,老师给分真好啊！感动
46286,1055,刘召峰,2017-01-21 06:38:57,1,4,3,上课很有意思的。老师真的是一个有思想的学者而不是一味宣扬社会主义。
46296,1055,刘召峰,2017-01-21 07:07:45,1,4,3,老师讲的挺好 但是 给分可以再好一点
46299,1055,刘召峰,2017-01-21 07:12:50,1,4,3,虽然没怎么听课 但论文还是有兴趣地认真做了  绩点给的不错   讲道理事情不算少 但我还是很感谢他
46379,1055,刘召峰,2017-01-21 11:44:59,4,7,3,不点名 要求挺高事情挺多但给分不差。
46464,1055,刘召峰,2017-01-21 17:03:35,4,8,4,刘老师的课堂是真正有料的课堂，他也是真正有责任心和学者风范的老师。拿到高绩点或许有点难，但是你绝对可以在老师的课堂上学到很多东西。
46532,1055,刘召峰,2017-01-22 01:56:32,0,5,5,一开始挺恐怖的，老师喜欢咬文嚼字和刨根问底，后来习惯了，感觉挺有意思的，平时作业真的比其他老师多不少。感觉挺有收获的。绩点给的不算高吧，但是感觉付出多有回报吧。
46594,1055,刘召峰,2017-01-22 03:29:34,5,8,3,上课很有思想，学术上很严谨，会教你独立思考。\n\n作业有3份，算是比较多的了，但好好做给分不会亏待你的。
47066,1055,刘召峰,2017-01-23 13:28:51,2,7,5,或许刘老师给分一般，任务也很多，但确实有所收获。谢谢老师让我明白了什么是学术精神和学者之风。
47573,1055,刘召峰,2017-02-02 02:04:24,-9,3,12,老师讲课很棒 但分也是真低……
47590,1055,刘召峰,2017-02-04 14:30:15,143,162,19,上大学以来感觉最好的课和最好的老师，知识渊博，思想深邃，足够为人师表，一腔热忱，心怀天下，这样的老师让我看到了中国知识分子的风骨和学术复兴的希望，老师本身的经历同样很为人称道。那些说事多分少的真是够了，你们的大学生活难道只有绩点了吗，难道以为在课堂上提一些简单无聊的问题来换取加分就有所收获吗，如果不去多了解一些文史哲方面的东西，谁都不知道自己精神思想有多么空虚。
47876,1055,刘召峰,2017-02-27 01:34:48,1,4,3,赞的地方是，老师真真正正的在讲历史，而不是仅仅是史纲；个人觉得稍微有不足的地方也是讲的历史过于单薄了……不过是好老师~
48192,1055,刘召峰,2017-03-01 06:45:22,5,8,3,老师蛮有趣的\n\n“爱美人不爱江山”\n\n很有才华 博士后啊
50974,1055,刘召峰,2017-05-10 14:50:19,5,7,2,能听到许多不同的观点，可以帮助大一新生从历史入门学习批判思维。
51320,1055,刘召峰,2017-05-31 07:54:26,-15,7,22,老是喜欢卖弄学问
52009,1055,刘召峰,2017-06-14 06:43:14,1,2,1,老师超棒的！！客观讲课
52012,1055,刘召峰,2017-06-14 06:48:51,3,4,1,非常棒，能够提出我们想不到的东西，引发我们深度的思考
52022,1055,刘召峰,2017-06-14 07:51:56,1,2,1,好老师！
52152,1055,刘召峰,2017-06-15 07:39:52,1,4,3,大概是大一遇到的最负责任的老师
52216,1055,刘召峰,2017-06-16 03:40:20,13,20,7,怎么说呢，老师人非常渊博有思想，对历史的有独到的见解，认真上他的课绝对受益匪浅。但是他的课比其他老师的课事情会多一点。还有一点让我个人很不舒服的是，仅仅是对我个人而言，他会给发言的同学加平时分，这就有很多同学都是为了发言而发言，讲的内容都很水，发言完坐下就玩手机，课间再美滋滋地上台加个平时分。个人观点。
52571,1055,刘召峰,2017-06-21 06:54:04,88,100,12,一名坚定的共产主义者，一位以身作则的思想导师，一个固执中国梦的守望者，老师最后一节课说:我坚信中国会发展成为最强的国家，让我们一起为建设富强民主中国而奋斗！那一刻掌声飞扬~
52575,1055,刘召峰,2017-06-21 07:09:47,1,3,2,你懂的
52578,1055,刘召峰,2017-06-21 07:28:19,61,70,9,老师是我见过的最好的历史老师：首先知识渊博，学术态度非常严谨；其次有思想，不盲从主流或者课本，也不灌输知识或者价值观；非常尊重学生，展示发言和提问都不会打断，真的是在培养学生的思想；能把主流的思政教育讲得这么有趣，而且老师真的好可爱啊讲课的时候经常一本正经地开开玩笑。希望老师以后可以多开几门课程！！！
52797,1055,刘召峰,2017-06-23 03:00:38,4,10,6,感觉老师喜欢卖弄学问…虽然更能感觉得到，他读的书很多，有自己的见解，但是几乎对每个学生的看法都要反驳一下，感觉不是很好，可能是我错觉吧
55404,1055,刘召峰,2017-07-01 12:32:30,23,27,4,老师非常有思想，而且自己有坚定的信仰，这一点让人非常佩服。我们超小班二十人每节课都可以深度讨论，非常有收获。老师学识渊博，无论你讨论那个话题都能立刻列出你应该了解的学者、该领域有名的论文和著作，而且老师强到就算你强词夺理也能把你怼的心服口服的地步。老师让对记史实毫无兴趣的我找到了学历史的兴趣。成绩还没出，不过老师绝对给10分
56341,1055,刘召峰,2017-07-03 14:09:56,14,18,4,老师特别认真，有思想，但是工科生听起来有些懵orz，事情有些多，但是认真也会有收获的
56366,1055,刘召峰,2017-07-03 14:51:46,-18,7,25,太垃圾了，事情超多，平时分给的又低
56457,1055,刘召峰,2017-07-04 00:52:21,4,8,4,老师没话说，真学者。但事情这么多给分还这么低，挺伤心的。
57626,1055,刘召峰,2017-07-10 22:58:31,14,18,4,实事求是说，老师非常负责任，上课有自己的思想，会给同学补充其他的知识，从来没点过名。关于给分，我上课没有参与恶竞般的发言，但是困惑解惑和论文确实认真写了好几天，9k＋的字看了不少资料也问了很多人的意见，考试觉得也就一般，最后4.5。确实是个好老师，付出就有回报吧。别的班要演历史剧啊事情其实不多的。
58364,1055,刘召峰,2017-08-29 16:34:45,9,11,2,真正有思想有深度的史纲课！刚开始的时候觉得老师的课要做的任务很多，困惑解惑作业很烦，不过随着时间推移，本来对历史不感兴趣的我逐渐对我研究的那段历史产生兴趣。而且老师上课时不是只照本宣科，他往往提出一个与主流相左的观点来让我们评判。这门课也是扭转了我对思政类课程的观念，强烈安利！
59176,1055,刘召峰,2017-09-20 05:55:35,-1,1,2,相当不错
59205,1055,刘召峰,2017-09-20 07:29:06,0,1,1,棒棒哒
59222,1055,刘召峰,2017-09-20 08:49:12,0,1,1,老师确实是好老师，但是他布置的作业太多了，不喜欢他上的课程的人简直是煎熬
59520,1055,刘召峰,2017-09-22 03:51:21,5,6,1,思考有深度，刚开头就让我很感兴趣！
60042,1055,刘召峰,2017-10-08 03:58:08,0,1,1,非常棒，有思想
60208,1055,刘召峰,2017-10-13 03:08:36,0,1,1,很不错
60209,1055,刘召峰,2017-10-13 03:16:51,0,1,1,挺好的老师，很有学术思想
60691,1055,刘召峰,2017-10-26 23:45:48,0,1,1,美滋滋\n\n
61728,1055,刘召峰,2017-11-20 10:07:25,2,3,1,有思想，有活力。值得一听！
61890,1055,刘召峰,2017-11-21 11:39:50,2,3,1,令人尊敬的老师
63822,1055,刘召峰,2017-12-15 14:06:28,2,3,1,真的十足的好老师，有理想有思想，知行合一，虽然只是上了您的一节马克思主义哲学课，加上课后与您的交流讨论，感觉自己收获颇丰。
64995,1055,刘召峰,2017-12-28 06:52:40,1,2,1,真的好 学者
65207,1055,刘召峰,2017-12-31 09:30:02,98,107,9,“如果因为顾虑学生给自己打低分而不告诉他们资本家是如何剥削压迫劳苦大众的，那还算什么马克思主义者！”刘老师的这番话，振聋发聩。
65395,1055,刘召峰,2018-01-03 14:55:56,16,19,3,刘老师是让我对历史产生莫大兴趣的人，一名真正的学者，学识渊博。刘召峰老师为了给学生上课奔波于紫金港和西溪校区之间。每次看他收上百份论文要在短短时间里看完还要给出评分就觉得他十分辛苦。上课听同学展示的时候特别认真，会用笔记下来认真给出反馈。有一次还看到他在校车上争分夺秒地看书，并且用笔勾画着。刘老师的课堂让我受益匪浅，上课完全不会水手机。打10分觉得有点少orz（虽然还不知道成绩就来评价了）因为真的是特别好的老师丫～
65915,1055,刘召峰,2018-01-10 07:49:34,1,2,1,老师很有思想，长的快了点，虽然平时的任务比较重，但是认真做一定可以的到一个好结果的。? ?
65930,1055,刘召峰,2018-01-10 10:14:13,4,5,1,今天史纲课结束了，感觉很不舍，老师真的很好，很有人格魅力，思想深邃，知识渊博，语言条理清晰，既能让人听懂又能给学生很大的启迪，解决了我的很多问题，三节课听下来觉得很充实，说事多的怕是没上过别的史纲课，我其他室友史纲又有历史剧排练展示又多，相比较事情并不算多，还没有考试，但这个老师我给十分。
65971,1055,刘召峰,2018-01-10 13:17:38,5,6,1,唉很可惜 很好的老师 但是上课没有很认真的听过 最后一节周五的课 希望能认认真真听他讲完 他的思想令人尊敬
66064,1055,刘召峰,2018-01-11 08:52:37,3,4,1,真学者
66134,1055,刘召峰,2018-01-12 04:15:04,7,9,2,真的是非常非常好的一位老师，上课也很有意思，是真正有涵养有风度的一位老师，祝大家能选上他的课
66136,1055,刘召峰,2018-01-12 04:17:44,2,4,2,好。
66238,1055,刘召峰,2018-01-14 02:24:59,5,7,2,老师讲课真的很认真，很有自己的想法，不是单讲课本知识的。最后小组展示每个小组老师都会提自己的想法，还会和我们讨论疑问点。
69341,1055,刘召峰,2018-01-24 13:34:23,0,2,2,很棒的老师
69551,1055,刘召峰,2018-01-25 03:40:47,2,4,2,好老师真正的学者师者。
71968,1055,刘召峰,2018-01-29 07:05:45,3,5,2,还没出分。就是想说，好老师，不论分数。
72374,1055,刘召峰,2018-01-30 03:52:47,0,2,2,? ? ?
72378,1055,刘召峰,2018-01-30 04:01:21,1,3,2,绝对好老师 上课美滋滋
72382,1055,刘召峰,2018-01-30 04:17:38,2,3,1,老师很有思想，去问他问题都有收获！而且给分还好！除了这门课程要写的东西有点多以外别的真的特别好！写东西的过程中也会学到很多，没学过历史收获也很大。
72383,1055,刘召峰,2018-01-30 04:17:49,7,9,2,老师很渊博，有思想，纯粹的学者气质！还有助教小姐姐超级可爱啊（｡ò ∀ ó｡）\n\n重要的一点，老师说的东西可能比较高深，大多数情况下听着也繁琐，但只要你在这个环境下，老师的这个上课模式真的会潜移默化的让你学会思考，学会辩证～
72405,1055,刘召峰,2018-01-30 05:24:45,2,7,5,老师真的很有思想，可惜我听不太懂。我上课也没发过言只做过一次展示。事情挺少的。本来以为会被正态结果拿了4.5，超级意外的，给分好好！
72441,1055,刘召峰,2018-01-30 06:38:59,2,4,2,老师很厉害，给分还行，没发过言认真写论文4.2
72466,1055,刘召峰,2018-01-30 07:17:13,9,10,1,老师幽默，有思想，有水平。\n\n鹅颈比较严重，但这不是老师的锅，某某校长呵呵了……\n\n刘老师真的有水平。
72710,1055,刘召峰,2018-01-31 02:51:52,7,10,3,除了国懿爸爸我真的就想说，君生我未生，我生君已老！非常佩服老师这样有思想有文化的人，很想再上老师的课，选上刘老师的课的人真的很幸运！困惑解惑和论文一定要好好写啊
74007,1055,刘召峰,2018-02-04 05:19:17,2,3,1,老师自己的理论水平很高，只要上课发言了，还会给你加平时分。但给分一般
74686,1055,刘召峰,2018-03-05 05:46:33,0,2,2,挺有思想的老师，上课也挺有意思；就是课下交流的时候好像热情不大，总体很好的！！！！
74861,1055,刘召峰,2018-03-06 06:43:10,3,5,2,为刘老师打电话，真的是非常好的史纲
75920,1055,刘召峰,2018-03-23 03:37:22,-23,11,34,一上来就“十大戒令”，不太注重真实性。之所以给了两分而非一分，是为了表现他与其部分同事的区别。
75924,1055,刘召峰,2018-03-25 00:53:55,-4,15,19,十大戒灵真实性有待考证，无论如何拿出来当例子不太妥。不过还是非常好的老师，很有思想。
75977,1055,刘召峰,2018-03-23 03:32:04,2,4,2,很好～
75978,1055,刘召峰,2018-03-23 03:33:41,10,15,5,老师已经解释过所谓真实性的考量依据，十分支持，下面那几句，恐怕是有点酸了吧
75984,1055,刘召峰,2018-03-23 04:18:23,6,8,2,只能说老师讲课太有趣，害得我前两节课的常微分方程从来没做完?
76210,1055,刘召峰,2018-03-29 05:35:30,0,3,3,老师上课真的很有趣，知道的也很多～
76218,1055,刘召峰,2018-03-29 06:33:33,17,18,1,? 老师居然看查老师
76219,1055,刘召峰,2018-03-29 06:46:18,1,3,2,很舒服
76396,1055,刘召峰,2018-04-07 10:57:02,7,10,3,本打算水过去的。虽然是讲历史，但是我现在对马克思主义产生了浓厚的兴趣！！
76563,1055,刘召峰,2018-04-15 07:57:16,2,5,3,凭本事让我上课不睡手机不睡觉的老师 很有收获
79849,1055,刘召峰,2018-06-14 09:51:58,0,1,1,老师很好 学者
80143,1055,刘召峰,2018-06-20 13:52:56,0,1,1,tql
80578,1055,刘召峰,2018-06-28 04:30:18,4,6,2,刘老师让我看到了一个真正的文科学者的样子，儒雅，风度，见识高远，也让我对“马克思主义者”这一称谓有了敬畏。课程最后老师说，希望能开一门介绍马克思主义的公选课，能让愿意接受马克思主义的人更理论的学习，因为他始终相信，讲台就是阵地，你不占领，总有人会占领。\n\n瞬间泪目，这大概是一个真正学者的样子吧。课程作业就两篇论文一次展示，不算多，特地在没给分之前来评价，希望刘老师能在学术中收获更多。
80596,1055,刘召峰,2018-06-28 07:25:22,-1,1,2,我爱他！！！！！！！！！！
80600,1055,刘召峰,2018-06-28 08:11:31,0,1,1,刘老师真的讲的很好，算是我在思辨能力上的启蒙老师。教会了我看问题的方法与角度，好老师！！
80674,1055,刘召峰,2018-06-29 04:13:41,0,2,2,很有思想的老师，敢说敢为的老师
82021,1055,刘召峰,2019-01-25 07:48:43,5,18,13,论文给分老师直接说字数少给分少，还有上课故意混淆概念，以一些子虚乌有的事情来挑拨情感培养所谓的思想，不过树立正确的政治观念
84233,1055,刘召峰,2018-07-12 10:10:16,0,3,3,没出分前评一波：印象中上课没认真听过老师讲课，但听过的东西都让我印象深刻
84899,1055,刘召峰,2018-07-14 09:31:42,2,5,3,事多，，，
84900,1055,刘召峰,2018-07-14 09:34:54,1,4,3,讲课没意思，事情还多
84901,1055,刘召峰,2018-07-14 09:41:37,0,9,9,人格和意识形态上，是纯正的马克思主义者，但又不囿于教条，能够结合历史并着眼于实际来看待和分析问题，不左不右。        教学上，支持学生独立的思考与见解，能最大化的利用同学的主观能动性，课上群儒舌战好不痛快。                      给分上，本人上课无举手记录，论文也无他人数十万字长篇大论，仍有4+的绩点，给分公平。                      遇召峰老师乃人生大幸!
84902,1055,刘召峰,2018-07-14 09:40:59,2,3,1,...
84909,1055,刘召峰,2018-07-14 10:15:13,-2,4,6,一般吧。7分
84911,1055,刘召峰,2018-07-14 10:34:29,0,2,2,深刻，有思想，燃起我对马克思主义的兴趣
84916,1055,刘召峰,2018-07-14 10:50:34,4,6,2,感觉事情很多，嫌麻烦的别选...
84917,1055,刘召峰,2018-07-14 10:53:48,11,15,4,事情多，给分一般
84927,1055,刘召峰,2018-07-14 11:37:04,0,4,4,老师很学者，看着好严格，其实给分很好啊
84930,1055,刘召峰,2018-07-14 12:10:16,2,6,4,刘老师可以说是政治老师里难得的学者，听了他一学期的课，学期末突然就很想入党?。我88绩点4.2，感觉给分也算公正（毕竟我字写的太差了），对于想学到知识开阔见识的同学，我还是强烈推荐的！――来自一个大三老学长的发言?
85687,1055,刘召峰,2018-07-26 00:21:24,0,1,1,上课有干货，考核问题多。
85715,1055,刘召峰,2018-07-27 22:47:38,2,4,2,事多，不适合水课的同学，是我思政课最低的绩点了；但老师讲课挺好的，有些观点会让你耳目一新，认真听还是挺有收获的，总的来说，7分吧
85792,1055,刘召峰,2018-08-10 12:14:23,0,1,1,很有思想，但是任务会比较多。平时上课很重视发言，而且都会给出自己的见解
85822,1055,刘召峰,2018-08-19 07:54:56,1,2,1,老师是山东老乡，感觉很亲切，上课非常严谨认真，感受到了一份传授知识的责任感，感谢老师
86944,1055,刘召峰,2018-09-19 13:01:42,0,3,3,大师级老师，思想家，深受洗礼，值得大家认真倾听，认真思考
86995,1055,刘召峰,2018-09-20 02:03:14,1,2,1,儒雅有风度
87005,1055,刘召峰,2018-09-20 02:20:44,4,6,2,zju的一位思想大家！非常有思想也很有情怀，敢说敢言，倾心以授！
87047,1055,刘召峰,2018-09-20 05:36:58,0,1,1,老师很有自己的想法
87066,1055,刘召峰,2018-09-20 06:26:49,1,2,1,生动活泼 敢说敢做  真正的大家
87090,1055,刘召峰,2018-09-20 08:05:39,3,4,1,谢谢老师，这是我向往的历史课
87160,1055,刘召峰,2018-09-21 03:37:01,5,6,1,“别的老师怎么认为这门课我不管，但我可以做好我自己。”刘老师堪称真正的学者。
87560,1055,刘召峰,2018-10-06 01:12:51,0,1,1,非常好
87755,1055,刘召峰,2018-10-11 13:25:39,2,2,0,。。。
88285,1055,刘召峰,2018-10-26 13:42:01,2,5,3,百家讲坛都不服只服刘老师
90649,1055,刘召峰,2018-11-24 18:01:35,19,22,3,老师还不错，就是恶竞太严重
91339,1055,刘召峰,2018-12-06 06:14:33,4,4,0,老师是好老师，我是垃圾学生，但是还是要给老师打call！
91615,1055,刘召峰,2018-12-16 04:24:42,2,2,0,刘老师人超级好
91675,1055,刘召峰,2018-12-17 15:59:32,1,2,1,感谢老师，我无法想象没有遇见这位老师的生活
92221,1055,刘召峰,2018-12-27 06:06:03,11,12,1,老师可以给十分，讲的很好，但是课上杠精真的太多了，选课慎重，听课很难受
92761,1055,刘召峰,2019-01-04 08:11:40,2,2,0,。。。。
92805,1055,刘召峰,2019-01-04 14:01:20,10,12,2,刘老师最可贵的一点就是，在同学们发言或提问时从来不会像某些老师一样中途打断或说“课上不讨论这个”。这是因为他有绝对丰富的知识为学生们解惑，更是因为他是一个真正的老师。
93479,1055,刘召峰,2019-01-10 03:38:24,4,5,1,真正的学者！
93532,1055,刘召峰,2019-01-10 07:54:03,8,9,1,歡迎大家報考劉老師的碩士研究生
93535,1055,刘召峰,2019-01-10 07:59:09,3,4,1,老师讲的很有思辨性，他把一个问题剖析的很深入，能够培养你真正的思考！这样的学者是浙大不可多得的人才！
93584,1055,刘召峰,2019-01-10 14:41:41,6,9,3,老师赞的，但恶竞氛围比较浓厚
96105,1055,刘召峰,2019-01-25 06:35:51,19,27,8,作为一个混合垃圾，在浙大遇到如此高水平的老师，却注定只有一学期的缘分。现在，每天挣扎在数分线代里，我恨自己，为什么高中没有追随初心，而放弃了文科? 回首望去，却已经没有退路。如果有机会重来一次，我愿意一直做刘老师的学生。
96707,1055,刘召峰,2019-01-24 14:20:49,2,3,1,思想啊，老师浑身上下闪烁着思想的光芒
97067,1055,刘召峰,2019-01-21 15:39:50,3,4,1,很有思想，上课也很好玩...就是耐不住困(இдஇ; )
97181,1055,刘召峰,2019-01-21 23:52:14,9,10,1,老师讲课非常精彩，对教学也十分的用心！但美中不足的是。我觉得持续整整一学期的小组展示让广大同学失去了倾听老师深刻思想的机会。
98152,1055,刘召峰,2019-01-23 06:26:01,1,3,2,为刘老师爱上史纲课！甚至想去旁听研究生课程！\n\n特别有态度的学者 感觉可以算标杆式人物
99690,1055,刘召峰,2019-01-25 05:08:18,-4,3,7,非常好的老师，只要平时花点功夫结果不会差的（个人感觉鹅颈不是很厉害
99698,1055,刘召峰,2019-01-25 05:16:01,0,4,4,老师真的很好，上课扩展的知识也很多，听老师的课会有很大的收货，最主要的是，给分也很好！！！
99700,1055,刘召峰,2019-01-25 05:19:32,0,1,1,老师真的很好，本来想水的史纲课一学期居然认真的听了，有很大的收货，虽然作业多，但给分也好啊，毕竟付出与结果是成正比的。
99702,1055,刘召峰,2019-01-25 05:20:43,1,2,1,老师知识很渊博，很有思想，会和同学讨论很多问题，也不会避讳说到一些事，而且给分也很好啊啊啊。
99708,1055,刘召峰,2019-01-25 05:26:11,0,1,1,老师上课很棒 特别有思想 是真正的学者吖
99709,1055,刘召峰,2019-01-25 05:26:34,0,2,2,学者风范 大师风范 令人尊敬的一位教师
99715,1055,刘召峰,2019-01-25 05:36:36,8,11,3,老师学术能力没得说，有思想有见解，课讲的也好，上他的课完全没有做其他事的欲望。作业不多，而且只要你认真完成作业了成绩自然不会差的。本人没有一次发言，读书报告几百字，困惑解惑和论文各四千多字(但确实是认真写了，读了很多书和论文，做了大量引用)，最后绩点也不错。一门课程总是需要一个评价方案的吧，尤其是史纲这样的课，我们应该理解的。鹅颈确实存在，但不要把别人的努力全部看做鹅颈。个人觉得反复说鹅颈严重的大多是不肯真正下功夫又看不惯别人拿高绩点的。再次为刘老师打call！
99718,1055,刘召峰,2019-01-25 05:38:41,6,7,1,老师讲的很好，就是小组展示时间太长了
99731,1055,刘召峰,2019-01-25 05:54:29,-42,4,46,很认真的学了论文 总共25000字左右吧 然后和只写3000字的一个分
99798,1055,刘召峰,2019-01-25 07:39:22,2,4,2,坚定的共产主义者，马克思主义的信仰者。真正的学者和老师，要不是因为不是学文科的料以后就肯定选报他的研究生了
99806,1055,刘召峰,2019-01-25 07:49:11,-5,3,8,愤青。。。
99808,1055,刘召峰,2019-01-25 07:49:42,0,4,4,。。。。。
99819,1055,刘召峰,2019-01-25 07:59:21,3,4,1,感觉学到了很多东西，关于怎样辩证地看待问题，怎样思考。
99860,1055,刘召峰,2019-01-25 08:48:49,1,3,2,在他的课上能学到立身处世的气节
99903,1055,刘召峰,2019-01-25 09:24:26,3,5,2,事情比较多，干货比较多，但是我不喜欢，就这样
99906,1055,刘召峰,2019-01-25 09:25:15,12,16,4,混合，史纲H，绩点被拉下0.06，是我自己还不够努力吧。绝对为刘老师打call，刘老师和某些上课只扯稗官野史的老师比起来强太多了，不仅有学者之识，更有儒者之风！
100239,1055,刘召峰,2019-01-26 00:20:29,3,5,2,还不错。想水课的勿选
100379,1055,刘召峰,2019-01-26 04:07:33,1,2,1,有思想，敢说话的好老师，不过课程本身鹅颈严重，给分还不错但也绝对和你平时鹅颈程度有关。
100457,1055,刘召峰,2019-01-26 06:59:57,1,7,6,上刘老师的课确实学到了许多思考的方式，这才是大学的文科课堂上真正需要学到的。课堂上的恶竞发言一次都没参与过，真正体现你学到东西的还是论文的质量，论文4000字，绩点4.5
100804,1055,刘召峰,2019-01-27 00:58:11,-1,1,2,学术性很强，学到的不是史纲的知识，给分也还行
101446,1055,刘召峰,2019-01-28 08:16:05,5,7,2,向每一个周围小伙伴推荐过刘老师啦！刘老师上课不照本宣科，而是丰满教材细节，挖掘深度，更重要的是，他会以一个严谨的马克思主义者的思维领你学会如何看待问题、如何评判历史和如何从历史中学习。\n\n刘老师虽然比别的班多一份困惑解惑作业，但是认真做也会收获很多。我的给分也是很不错的。（对了开卷考不简单……看了书也不一定会?）\n\n记忆深刻的是面对同学们的各种问题，老师拿着话筒侃侃而谈的学者风度。
102282,1055,刘召峰,2019-01-31 16:34:59,5,8,3,刘老师讲课超棒！本来想水过去的史纲课结果每节都认真坐前排听了下来。恶竞肯定是存在的，不过刘老师更看重的应该是我们对待学术的态度，教了我们很多论文规范之类的。坚定的马克思主义者，爱国爱党，但又不会避讳谈一些敏感话题。是一个真正的学者！\n\n助教姐姐人也超好！\n\n只能希望大家不要碰到杠精了（我这节课上就有一个杠精天天杠天杠地）\n\n欢迎大家报考刘老师的硕士研究生\n\n招生专业：马克思主义基本原理\n\n“欢迎人文社会科学各类专业以及其他专业的同学报考，特别欢迎有志于将来从事学术研究的同学报考；不愿下苦功者，莫入，否则，于你是不幸，于我也是痛苦。”
102718,1055,刘召峰,2019-02-22 03:11:28,1,3,2,收获很大哟，爱你老师
103400,1055,刘召峰,2019-02-28 02:23:27,-12,7,19,老师很好，知识很渊博，但是可不可以不要再讲十条戒令这种谣言了。。。。。
103446,1055,刘召峰,2019-02-28 07:14:00,0,4,4,这个点名制度有点窒息。。。
103548,1055,刘召峰,2019-03-01 03:18:12,0,2,2,有思想有涵养 温柔 娓娓道来\n\n太可爱了！
103549,1055,刘召峰,2019-03-01 03:18:40,2,6,4,老师和老师的老婆太甜了吧
103789,1055,刘召峰,2019-03-05 15:24:34,0,5,5,感觉装逼太狠l了
103997,1055,刘召峰,2019-03-08 23:20:55,26,32,6,恶竞真的严重\n\n上课会有很多人进行奇怪的发言\n\n影响听课体验\n\n
104019,1055,刘召峰,2019-03-14 03:38:32,-13,15,28,有个黑胖子总喜欢在课上鹅颈
104020,1055,刘召峰,2019-07-07 23:44:05,-67,19,86,老师课讲的真的很好但是恶竞确实严重（楼下说的那位同学叫修彦名，来自浙江大学竺可桢学院混合1801班
104153,1055,刘召峰,2019-03-13 05:48:44,41,70,29,同学您好，我是xym。真的很抱歉，我本来只是对历史有兴趣，才在课上经常和老师交流思想。没想到对你造成了如此大的困扰，十分抱歉。不过您在这里把我的信息直接晾出来，是不是也有些不妥呢？
104155,1055,刘召峰,2019-03-13 05:42:51,0,1,1,觉得很好
104162,1055,刘召峰,2019-03-13 07:48:17,-6,13,19,亲历，xym同学问的问题都挺好的啊，不属于恶性凑数。ps，实际上发言和最终分数没有很大的关联，以后上课的同学不如在该下功夫的地方下功夫
104167,1055,刘召峰,2019-03-13 08:59:27,-3,9,12,不能因为自己分数原因和其他想法来恶意揣测别人吧。上课问问题是老师提出的，有问题就问本身也没有什么问题啊。每个人都可以选择把自己的问题提出来，只是很多人都没有认真上课而已。私以为，老师上课方式很好，提问的时候氛围也挺好的，也能了解很多想法，同学多问也没有什么问题。
104351,1055,刘召峰,2019-03-18 12:13:31,-2,1,3,认真的好老师
104460,1055,刘召峰,2019-03-21 03:19:52,-2,1,3,思维深刻，很受启发。谢谢老师，觉得课上玩手机很不好意思??
104474,1055,刘召峰,2019-03-21 07:22:45,6,7,1,老师讲的很好，但鹅颈实在太令人讨厌了。有的人简直不知所云。
109025,1055,刘召峰,2019-06-06 01:45:15,0,6,6,恶竞严重，事贼多，差评
109844,1055,刘召峰,2019-06-19 16:14:48,0,2,2,超级棒!
109871,1055,刘召峰,2019-07-08 00:17:12,17,27,10,不能骂人就没啥可说的了
109925,1055,刘召峰,2019-07-06 00:24:39,6,8,2,真正的马克思主义者，而且特别简朴低调，经常会看见老师坐校车来上课，平时骑一辆很久的自行车，真想凑钱给老师换一辆自行车?
109949,1055,刘召峰,2019-06-20 12:44:21,1,3,2,有点舍不得结课
110285,1055,刘召峰,2019-06-25 10:06:45,0,5,5,写论文时说超了字数扣分，真的是好老师，一定程度防治了恶竟
113773,1055,刘召峰,2019-07-12 16:20:15,25,37,12,事多分少\n\n恶竞横行\n\n（没错就是这样总结的 优点的话看高赞就行了 这条同样也是真实情况的实话是用来被喷的）
113788,1055,刘召峰,2019-07-07 13:16:12,-2,0,2,老师很棒啊，上课讲的很有自己的思想，上课，给分都是尽心尽力的，棒棒哒
113825,1055,刘召峰,2019-07-07 17:14:54,0,3,3,老师很好，恶竞……无奈¬_¬｀，绩点不高啊……我的原因，平时分太差了。
113828,1055,刘召峰,2019-07-07 17:15:59,1,3,2,深夜来给老师评价了 本人理科生 历史盲 困惑解惑和论文都尽我最大努力了 过程中也真的学到了很多 上课从来没有发过言 期末考因为不熟悉这种考试所以抄错了很多 做好了及格边缘的准备 看到绩点时真的挺感动的 谢谢老师
113836,1055,刘召峰,2019-09-11 03:26:56,2,29,27,我要看着这个狗老师分数下滑，伪君子
113855,1055,刘召峰,2019-07-07 19:46:04,0,3,3,我觉得我挺认真的呀，结果绩点好低。。。看来是我水平太差了。老师是个好老师。
113864,1055,刘召峰,2019-07-07 22:00:21,23,23,0,事多分不高，建议真正热爱近代史的同学选
113895,1055,刘召峰,2019-07-07 23:54:01,-8,5,13,有批判性思维，但好像很多人不喜欢，后面渐渐不来上课。点名一次不到扣7分。老师人很好，给分很好。
113897,1055,刘召峰,2019-07-08 00:06:42,-1,11,12,虽然分有一点点不满意，但是老师真的很有知识，很有情怀去。能学到很多的历史知识。云山苍苍，江水泱泱。先生之风，山高水长～
113950,1055,刘召峰,2019-07-08 02:27:01,9,15,6,能别选他就别选他了   事多分低   平时上课恶竞发言很多人还不知所云可成绩就是比你高    课后作业很多   小组分组不合理    人数少的四五个人多的十几个     然后小组一起做展示、写报告   每个人花的力气差的很多
113958,1055,刘召峰,2019-07-08 03:03:11,-6,6,12,有人说老师事多分低，但老师在第一节课就说过给分尽量给高。老师本身很不错，课堂上也蛮有趣味，虽然我最后绩点不高，我觉得很大程度上是我自身的问题。反观评论区，有些同学没有对老师一个学期认真付出表示感谢，还不尊重老师，有点让人心寒。
113960,1055,刘召峰,2019-07-08 03:11:58,8,9,1,老师有理想，忠实的马克思主义者，但是事情真的很多，两篇论文，还有一篇读书报告还有小组展示，还有考试，还要点名，不到一次总评扣7分可能有自己的观点，但是可能和很多人的看法不太一致，有点恶竞，给分不好，查老师分数高可能是因为给他上课的激情
113963,1055,刘召峰,2019-07-08 03:27:14,10,15,5,老师显然是不错，只是这学期我当组长，真的是任劳任怨一学期，同时论文困惑解惑都认真写，最后也只拿了一个3.9，难免心里有点不快。但这里有的同学总是以事多分低来贬低一个老师，我觉得也实在眼界太过狭隘，这种评价是有失偏颇的。老师的课显然是有营养的，这种年头还能见到在思政课上真的有坚定立场的老师不多了。私下交流中，也能感觉到老师自己也是一个难得的有逻辑和敏捷思维的人。你们甚至可以在课上不喜欢马社共，甚至我了解到的论文写这些方面的同学绩点也比我高。假如各位和我一样努力过了绩点不算太高，还是希望共勉，但假如本来就没怎么对课程上心过，你们那所谓自由的话语又算得上什么？
114019,1055,刘召峰,2019-07-08 09:55:54,8,8,0,恶竞严重  \n\n发言加分很正常\n\n但总得考虑是否有质量吧\n\n我那个班绝大多数的发言都是为了发言而发言\n\n不仅辣耳朵 降低好感 还浪费宝贵上课时间\n\n最主要的是 他们绩点还更好看一点?\n\n老师本人还是很喜欢的 很有个性\n\n但课堂安排确实有待改进
114030,1055,刘召峰,2019-07-08 11:51:49,3,6,3,老师是一个很优秀的学者，个人认为老师上史纲这种大家都不听的课真的有点可惜，个人学识很渊博，但是由于史纲课本身的原因每次上课听课的人寥寥无几。还有就是班级鹅颈太严重了，主要就是发言制度，我真的强烈认为应该取消发言制度或者干脆来个点名发言，大部分的发言都毫无营养纯粹为了发言而发言，关键发言还占好多分，希望老师能够调整一下这个制度太不合理了。抛去上课基本就是论文和困惑占比最大了，写出深度来估计给分都不低。而且小组合作就一次，不用太头疼小组之间的事情。
114047,1055,刘召峰,2019-07-08 13:33:34,10,14,4,能听得出老师本人是有水平的。但无奈本人一个学理的，历史盲对历史也不感兴趣。我不喜欢老师一开始上课就说的要把你们培养成历史型人才，很不喜欢这种论调。事情不少，我不敢说老师给分不行但至少我的分只有3.6。论文也好好写了，困惑解惑也好好写了，无奈我真的没什么历史素养。但我觉得这都没啥。最令人烦的还是恶竞，先不说困惑解惑所谓一万字的上限，光是课堂发言就能看出恶竞之程度。一堆人只是机械性的重复，这种没营养的发言听着都尬耳朵，关键是这种不知所云的发言还能加分。我想问问，所谓的求是校风什么时候变成了恶竞之风?
114172,1055,刘召峰,2019-07-09 13:48:59,40,47,7,看见最后绩点，咱也不敢说，咱也不敢问
114193,1055,刘召峰,2019-07-09 03:53:09,11,17,6,找助教问了一下，平时分92，期末66，于是绩点比较低，看上去是因为期末没有调分导致的？这样对于平时工作勤恳的组长，困惑解惑认真对待的同学来说难免会有很大的落差吧。试卷是统改的，听其他班的同学说，他们老师要求他们写满，因为只按字数给分？如果真是如此，那未免太无趣了些吧。并不认为自己历史素养差到哪去，不接受这样的分数。\n\n\n\n老师的课是挺好的，不过好在哪里就讲不出了。不是很能跟得上老师分析的逻辑，所以后面的课都没怎么认真听，比较愧怍，毕竟刘召峰老师之前说他因为浙大有史纲这门课才选择来浙大的(原话记不清了)。但这门课大家都没怎么听，分数不高大家也不高兴，浙大还真是没意思呀。
114203,1055,刘召峰,2019-07-12 07:00:15,26,38,12,刘老师是个好老师，能看出来理论水平挺高的，上课也比较注重思辨，能引导学生，平常的困惑解惑作业也挺有收获。真是谢谢老师了！我感觉我在史纲这门课上花了不少心血，查了大几十篇论文，找了几本书，认认真真做了困惑解惑，上课也发言了2次，小组展示也很费了一番功夫，感觉在知识上收获挺大。最后平时分将近90，考试70+，只有3.9。抛却收获的知识，感觉付出和得分不相符，如果用我这个态度上其他老师的史纲，起码能上4吧。希望老师不仅在教学上一如既往地认真用心，在最后的给分上也能体谅一下学生，毕竟我们班的均分比其他班低了不少。我不想以功利的心对待这门课，不想以事多事少评价老师，毕竟我还很喜欢历史的，这算是人生最后一次历史课了? ，但这个得分我实在无法接受。
114424,1055,刘召峰,2019-07-10 01:49:46,24,48,24,骗子，是个骗子。\n\n第一节课：我的学生做的事情多，所以得分也应该比其他班的学生高；\n\n最后成绩出来，普遍比其他班低0.5+，只说了句大家期末考的太差了，也不调分。\n\n一个大大的骗子。
114771,1055,刘召峰,2019-07-11 12:12:25,-23,11,34,"说老师平时分不好的：先想想自己在某知和某度上抄了多少; 说期末给分不好的，先想想自己有没有好好复习这门三学分的课。说恶竞的，这里借用一句刘老师本人的话：""上课认真听讲，积极互动就算是恶竞吗？""只不过是看不惯别人拿高分，而自己又不愿意做出改变罢了。"
115242,1055,刘召峰,2019-07-17 02:45:08,4,7,3,您确定在课堂上   假如你穿越到清朝变成李鸿章，你会怎么做     这种某乎体的发言不算恶竞么
115402,1055,刘召峰,2019-07-21 05:04:54,4,8,4,老师很好，给分不好
116587,1055,刘召峰,2019-09-12 02:29:07,36,38,2,没有男人没法生haizi，但是没有丈夫可以
116591,1055,刘召峰,2019-09-12 02:41:42,0,0,0,爽上天
116627,1055,刘召峰,2019-09-12 05:52:04,0,1,1,非常有趣
117072,1055,刘召峰,2019-09-19 03:03:59,1,2,1,超级棒
117598,1055,刘召峰,2019-09-26 13:49:25,4,4,0,绷紧神经，准备抢答。
118053,1055,刘召峰,2019-10-19 13:51:54,6,6,0,虽然老师教的很好，但是还是希望付出的努力能得到回报，在分数上还是希望老师宽容一点，理科生真的尽力了，希望老师能调分，谢谢了
120724,1055,刘召峰,2020-01-16 01:21:39,1,2,1,深邃的思想，平易近人，好老师！
120801,1055,刘召峰,2020-01-21 09:13:06,3,3,0,唉唉唉
121236,1055,刘召峰,2019-12-26 06:43:14,-2,0,2,i了！
121707,1055,刘召峰,2020-01-21 03:51:37,0,4,4,老师讲的逻辑有点像是强加的，表面上说是论证可能在我看来像是瞎掰？不知道…反正事多分低 3.9
122584,1055,刘召峰,2020-03-05 06:19:48,1,1,0,老师很有思想，也很能引发我们的思考，听老师上课很舒服
123645,1055,刘召峰,2020-06-11 06:43:50,0,2,2,老师很有水平很有创意，是个真正的学者，对老师也很有好感，只是，课堂上自从说了发言有平时分，就不乏有一些（剧烈？）鹅颈出现，总有人哗众取宠，提出一些不怎么相关的问题来拿平时分，emmmm让人有点ex，影响听课体验
123647,1055,刘召峰,2020-06-11 06:54:10,5,5,0,还没有考试，先来评价一下。上课可以水，但作业绝不水。一万字上限的困惑解惑、一次小组展示和8000字上限的课程论文是老师比较特别的作业（最后一节课认真解释了这么布置作业的原因），需要真正去探索一个感兴趣的话题，学到很多。老师很擅长启发思考，抛出问题但不给出所谓标答，关注不同的话题和观点，经常和我们分享。五一劳动节，为了批判一些商业人士的言论，特意发了推文。他说，精进思考能力的最好方法就是围观老师吵架hhhh。个人觉得刘老师才是真正的学者，也是在上了很多水课之后第一次发现浙大的老师水平高。倒是很遗憾自己不是学历史的。总之，特别幸运预置到刘老师，感兴趣的同学们千万别错过呀~
123664,1055,刘召峰,2020-06-11 08:52:19,-2,4,6,？？？有些同学在不加分的时候也问问题的啊，有些人是不是没听课还说人家ex，你自己更ex吧，又不是所有人都是说加分以后才问问题的好吗
123690,1055,刘召峰,2020-06-11 14:41:30,2,2,0,趁着没出分来评论一波，害怕出分爆炸到时候就想喷了。作业挺硬核，课程内容也是很有深度的，至少我觉得是真的有讲理论的。最近思想也有所“左倾”，听了老师的课也是补充了一些理论知识，让自己避免盲动和激进。话说老师为什么不开毛概，想听怎么讲。
124070,1055,刘召峰,2020-06-23 07:56:03,8,8,0,挺好的，就是理科生有点想流泪。以及对于发言这件事，我们大英老师之前说非常能理解一些性格本身就很安静的同学，所以我也很希望这堂课的平时分能更多角度地体谅到不一样性格的同学们，让每个人不仅仅是会正切要害地说，更会听、会写、会想。
124092,1055,刘召峰,2020-06-23 13:18:13,3,4,1,趁还没出分来给老师评个分。老师很谦逊，会认真回答学生提出的每一个问题（甚至有时候我们觉得ta是在刷存在感而提一些没什么意义的问题时，老师也会很诚恳地指出），也会感谢学生给的指证；老师会分享一些时事看法，很有独到的观点，会用心去培养学生的独立思维，会告诉你该怎么样去研究问题。总而言之，在老师这里学到不少比成绩更重要的东西，老师担得起学者二字。（希望下学期能旁听老师的资本论研究小组，虽然是工科生哈哈）
124440,1055,刘召峰,2020-07-14 14:29:07,9,10,1,给分好差啊
124445,1055,刘召峰,2020-07-01 10:12:16,12,13,1,这么说吧，讲课是讲的很好，思想也比较有深度。与此同时这门课对理科生还是相当不友好的，而且老师给分不算好。（仅供参考，这两个事实同时存在，并不存在哪一个掩盖哪一个）
124455,1055,刘召峰,2020-07-01 11:32:32,1,3,2,为人师表，万世可称颂之。疫情时期，分数不高，但是对等
124456,1055,刘召峰,2020-07-01 11:40:24,-3,2,5,我觉得给分挺好的…吧。老师讲得也很好，对于很多历史细节都有自己的理解。解惑选择了一个自己很喜欢的主题，所以可能探讨的比较仔细与深入。期末考试写得手要断了…写了很多但不知道有没有到点上。
124459,1055,刘召峰,2020-07-01 13:17:02,10,10,0,出分了来回答一下。\n\n想选lzf老师的做好事多恶竞的准备，发言会加分（虽然是疫情后期补加的设定），上限1w的困惑解惑和8k的论文（恶竞之风），还有小组展示。有的小组展示被别人提出的问题会奇奇怪怪的。\n\n老师上课很不错，如果想水的话请走他处。\n\n工科生，因为对历史还蛮感兴趣的就选了老师，挺认真的上了这门课。困惑解惑选了一个挺新颖的题目，写了近9k，论文8k，有发言，小组展示的同学比较拉跨，最后4.8供参考。
124467,1055,刘召峰,2020-07-01 15:27:31,-3,3,6,给分差，b事多，呵呵
124485,1055,刘召峰,2020-07-02 00:47:32,-7,5,12,垃圾老师
124768,1055,刘召峰,2020-07-08 23:49:15,-4,4,8,事多自吹给分少？
124909,1055,刘召峰,2020-07-17 14:22:31,-11,11,22,工科生，解惑8k+，论文6k+，绩点4.5，有发言，仅供参考。看到很多说给分不好的，个人感觉其他老师的打分方式可能是“给能打到的最高分数”，刘老师没做到这点（感觉没满绩的样子）。竞了绩点应该不会太差（通识课都有正态，拿高分应该也都得竞一下吧）。作业次数不多，但内容挺多（只看上限是这样）。当时选课的时候也看到了过去关于给分的评价，但还是没换老师，因为有兴趣（键政）。课程内容应该说是思政课里水平很高的，关于一些话题的讨论也很有深度。写作业也是有兴趣成分在其中，因此内容也比较丰富（字数多）。如果要选的话建议不要排斥听课，对相关历史有研究兴趣，有精力完成作业（鹅颈）。最后扯点题外话。因为看到评论说“真正的马克思主义者”而对老师很感兴趣，听课后也觉得不枉此名。“马克思主义”是什么？是一个符号？是宣传时喊得响的口号？是所谓“30岁以后还信没脑子”？马克思主义的逐渐符号化了，其内容逐渐离我们远去。有人只喊着“割韭菜”、“阶级矛盾”，却只是打着旗号只想着个人发展；有人觉得马克思主义已经不符合时代了，或许他是只着眼于“属于自己的一小片‘时代的海面’”。思政类课讲的有多少是思想、政治、理论？我觉得更多的是口号、观念。
125394,1055,刘召峰,2020-09-08 05:44:28,6,7,1,给分差
126059,1055,刘召峰,2020-09-17 03:58:40,-4,5,9,绩低事多
127561,1055,刘召峰,2020-11-24 11:00:26,1,2,1,很有思想的老师，值得听的思政课。
127840,1055,刘召峰,2020-11-28 08:30:00,4,4,0,思想很深刻的老师，马克思主义者
128896,1055,刘召峰,2020-12-26 13:45:14,3,3,0,有幸上过刘老师的几节习概论，太有意思了，实不相瞒这是我大学以来第一次主动听思政课。
128942,1055,刘召峰,2020-12-27 09:17:06,2,5,3,国士无双
128970,1055,刘召峰,2020-12-27 14:26:59,3,3,0,大一上的刘老师的史纲，从来没有发过一次言，困惑解惑作业和论文都有好好写，最后4.5，理科生很满意啦，老师真的很有思想！强推！and没有选上刘老师的习概好难过
129881,1055,刘召峰,2021-01-13 07:01:53,1,1,0,刘少峰老师，教学育人，真正的大学教师！
129914,1055,刘召峰,2021-01-13 12:59:44,6,7,1,跟老师一起读资本论，也算上过他的课了吧。老师是一个热忱的马克思主义者，如果你也是，我想你一定要跟老师好好学习。\n\n顺便给老师的资本论读书会打个广告，欢迎大家参加！
131087,1055,刘召峰,2021-01-26 01:31:21,0,3,3,老师非常棒！！\n\n非常负责非常认真\n\n教会所有人如何去分析如何去批判\n\n能预置老师的课程不得不说实为大幸
131123,1055,刘召峰,2021-01-26 05:00:28,4,5,1,绝望，习概的平时分给的也太低了……
131243,1055,刘召峰,2021-01-26 19:28:57,0,1,1,习概给分并不好 但上课比较有内涵
131272,1055,刘召峰,2021-01-27 02:27:51,12,12,0,习概给了我2.1，太难了
131273,1055,刘召峰,2021-01-27 02:30:24,7,7,0,习概真绩杀。。。估计平均分不到3，真的是难受。。。
132195,1055,刘召峰,2021-01-31 02:05:50,2,2,0,上课不错，但真的绩杀
132357,1055,刘召峰,2021-02-01 05:07:43,2,3,1,史纲 论文自觉写得很学术垃圾 但老师最后还是给了4.8 很喜欢老师 下学期希望去听他的资本论读书会
133348,1055,刘召峰,2021-02-26 05:24:36,1,4,3,史纲只有3.6，哭了。不过事挺少，困惑解惑+论文。
133795,1055,刘召峰,2021-03-10 08:48:41,-13,12,25,庸俗唯物主义者，庸俗！沽名钓誉，这评论真是给我看吐了
133841,1055,刘召峰,2021-03-08 04:04:47,4,4,0,好老师啊
133896,1055,刘召峰,2021-03-09 07:44:09,5,6,1,上大学后第一次得到思辨能力的提升！
133944,1055,刘召峰,2021-03-10 08:55:53,-3,5,8,不喜欢
133945,1055,刘召峰,2021-03-10 09:02:45,-2,6,8,为什么没有零分
133946,1055,刘召峰,2021-03-10 09:04:55,4,8,4,恶性竞争惨烈。太受不了了。
133947,1055,刘召峰,2021-03-10 09:05:33,-2,3,5,不喜欢
134462,1055,刘召峰,2021-03-29 10:16:39,4,5,1,那位说“庸俗唯物主义者”的人，你知道什么叫庸俗唯物主义吗？
135168,1055,刘召峰,2021-05-05 09:53:42,1,2,1,学术水平高
136041,1055,刘召峰,2021-06-10 06:09:00,3,3,0,非常倾佩的老师，学者的风度，很羡慕
136383,1055,刘召峰,2021-06-17 08:24:04,5,9,4,允我叫刘老师一声“先生”！真正诠释了什么是“学为人师、身正为范”。有一次就价值观问题询问刘老师，老师亲自打电话过来，耐心地阐发我该做一个怎样的人。他尊重选择思想的自由，强调基于理性认知的感性才会坚定。来到浙大遇见过的最有风骨的老师之一
136929,1055,刘召峰,2021-06-28 10:10:41,0,2,2,很有趣的是，和刘老师观点针锋相对的另一位老师，学生们的评价也很高。个人更支持刘老师。
136963,1055,刘召峰,2021-07-08 16:45:32,-44,33,77,你们是没见过真正的大师，听了两节lzf的课就开始在这指点江山了？\n\n还最有风骨，学者风范，怪不得浙大名声垃圾，你们眼里这就是浙大的好学者，那浙大还发展个屁\n\n\n\n楼上还有洗地的，洗p呢洗，就那个庸俗唯物主义者说到点子上，被踩的也最多，真的搞笑\n\n\n\n你要汲取知识，汲取你的去，但是文史哲素养为0的工科生就别在这自以为是地纵览古今，指点天下大事了行吗？没见过大师你去哈佛斯坦福看看，再不济去费边社会主义指导的LSE看看。要是你被狭隘的mz主义裹挟着不愿意睁眼看世界也没事，你去清北复交看看，在这听两句煽动性话语高潮nm呢？\n\n浙大名声垃圾还用得着扣帽子？人尽皆知的事实你自己呆在象牙塔里不愿承认罢了\n\n正如一开始说的，就是你俩这种人让浙大更加lj
137364,1055,刘召峰,2021-07-03 13:02:39,5,7,2,上一楼，你不实名我都看不起你，您是哪里来的神仙？这么自信？来来来，您站出来让大伙看看什么是真正的大师。
137543,1055,刘召峰,2021-07-05 04:33:32,7,12,5,浙大声名垃圾又是哪个垃圾扣的帽子？我看有你这种垃圾才让学校发展停滞吧，别人从刘老师的课上汲取知识你还要说三道四，你怎么不去当教授呢？
138216,1055,刘召峰,2021-07-08 03:28:58,8,11,3,事情多，给分少，慎选
138217,1055,刘召峰,2021-07-08 03:37:10,9,13,4,评分：9\n\n评价刘老师，分多方面\n\n上课方面：刘老师的水平几乎无可挑剔，上他的课可以体验到他超高的逻辑水平和思辨能力，但是我这种文科水平较差的理科生可能不太跟得上。\n\n任务方面：一次小组展示，一篇上限8000字的困惑解惑（刘老师比别的老师多布置的作业），上限1w字的论文，以及平时额外加分的回答。所以任务量总体较重，而且可以看出刘老师比较鼓励鹅颈。\n\n给分方面：就我自己来说，上课发言加三分平时分，困惑解惑写了5600字，论文接近8000字，期末考前复习三天（把课本重点做好标记，刷选择题）。最后给分4.2，给分相对别的老师不算很好。\n\n\n\n结论：10分给讲课，因为事多和给分扣一分。对文科感兴趣的同学可选；怕事多，想卷高分的同学慎选。
138218,1055,刘召峰,2021-07-08 03:38:32,2,3,1,高中学理科的，对历史一窍不通，但是论文和困惑解惑都查了很多的资料写的很认真，虽然最后期末考炸了，绩点也还蛮不错的。老师人很好，认真学真的能学到很多东西
138226,1055,刘召峰,2021-07-08 04:12:05,4,4,0,刘老师很有思想，课非常不错的，对思辨能力有比较大的提升，尽管老师的部分逻辑我不理解（也有小部分观点是我不认同的），但我仍然感谢老师教我什么叫真正的学史明理、学史增信、学史崇德、学史力行。\n\n但是一，困惑解惑+论文，如果认真做的话，还是一个不小的工程，需要看比较多的文献资料的。\n\n二，给分，真的，真的，不算好，甚至算比较差的。我本人3.9，身边的同学都没上4（我已知4位同学的成绩，朵朵上面的评论区目前也还没看到有人上4），甚至不用正态的H课竟然有同学被给到3.0（小组展示我觉得大家总体做的都还不错）…不知道的还以为是数分课的成绩呢…\n\n总之，刘老师课确实很好，但给分确实不好。选与不选，大家自己考虑，毕竟3分的课绩点比别的班动不动低0.6，0.9左右，说一点都不难受绝对不可能，真不是我卷…
138312,1055,刘召峰,2021-07-08 13:03:04,-1,1,2,好老师，真的!
140183,1055,刘召峰,2021-09-03 10:47:56,-8,16,24,我来看看这伪君子还能骗多少人
141575,1055,刘召峰,2021-10-15 05:08:40,9,32,23,自我吹捧，自我吹牛，给我留下太深印象了。喜欢上课到处骂人、抨击其他当官的，装逼自己清高，咬文嚼字，容不得学生质疑。说自己因为做学术才留在浙大教书，而不留在北京。我就奇了怪了，难道北京不能做学术？？
142377,1055,刘召峰,2021-11-10 16:52:41,2,16,14,"马原课上批判高华，科尔奈都称得上是人身攻击了……\n\n什么科尔奈和汪精卫的类比，高华是""以小人之心度君子之腹""，实在是没啥营养。\n\n科尔奈的那个批判还是专挑别人去世的那天说……"
143676,1055,刘召峰,2021-12-01 10:09:02,0,8,8,治学态度严谨，有文人风骨，respect
145544,1055,刘召峰,2021-12-30 08:07:37,1,4,3,习惯好评
149009,1055,刘召峰,2022-01-14 06:38:10,-1,3,4,史纲 课很好 老师水平很高很有思想 每节课会围绕几个问题讲述历史 注重问题意识与思考 刘老师的史纲大概是我唯一愿意听的思政课了\n\n就是给分低于预期
149230,1055,刘召峰,2022-01-15 00:18:01,3,6,3,真正的马克思主义者！
149796,1055,刘召峰,2022-01-17 03:41:50,2,3,1,史纲（H）。\n\n上课讲课会基于课本的，问题的分析、思辨与拓展都很有深度。认真听课会有收获的。\n\n但感觉某些时候观点比较偏激。\n\n相较其他几个史纲（H）老师比较严格。\n\n作业要求算比较多的。八千字上限的困惑解惑作业，小组展示，六千字上限的史纲论文。\n\n点名很重要，这学期点了三次名，缺一次总评会扣五分。\n\n最后考试是开卷考试，个人感觉复习的意义不大，对课本（的目录）大概熟悉就够了。
151251,1055,刘召峰,2022-03-05 16:50:40,4,21,17,此垃圾老师一副老子自以为是的臭架子模样，满嘴仁义道德，其实做作虚伪的很，扒皮之后，只不过是一坨精致的利己主义者。它所谓的 思想 其实也就是愤青！臭傻逼，呸！
151622,1055,刘召峰,2022-03-10 01:58:13,1,8,7,伪君子
151908,1055,刘召峰,2022-05-09 09:32:29,-1,1,2,………………
152092,1055,刘召峰,2022-03-25 14:40:37,7,15,8,做人就不评价了，怕脏自己的嘴。\n\n仅说立场和水平，在基本立场上我和刘老师一致，但客观地说，甘阳和刘小枫对您可以说是降维打击。不在一个层面上。希望您的观点更加深刻，论述也更有张力，而不是单纯靠批判甚至侮辱他人来抬高自己。
152350,1055,刘召峰,2022-04-06 04:36:53,2,3,1,刘老师真的很棒！
153692,1055,刘召峰,2022-05-08 10:19:05,7,8,1,一位真正有风骨，有思想的学者
153881,1055,刘召峰,2022-05-15 08:53:08,-26,5,31,喜欢上课到处骂人、抨击当官的，居然还抨击民营企业家，尤其装逼自己清高，咬文嚼字，容不得学生质疑。说自己因为做学术才留在浙大教书，而不留在北京。我就奇了怪了，难道北京不能做学术？？是不是以后学术做的差不多的话再跑路去北京？
153932,1055,刘召峰,2022-05-17 06:18:39,-22,8,30,课堂确实说过自己因为做学术才留在浙大教书，而不留在北京。可能以后学术做的差不多，当领导了再锦衣还乡再跳槽北京？？最烦装逼清高的人，上课时候只会满堂灌
154262,1055,刘召峰,2022-05-27 10:21:18,14,15,1,其实没有下面说得那么严重。我感觉吧，下面有些评论说的内容大概占老师内心的不到一成，人总得图点啥嘛，怎么要求老师这么严格呢？而老师确实是很好的，他有自己的观点，根据自己的观点会有一些批判和赞扬，谁都有这个资格。他讲课基本也不虚美，不隐恶，敢补充，作为一个副院长言行很平和，很朴素，还有比较充分的史学背景和教学经历。他是值得尊重的，尽管他不能使所有人满意。
154709,1055,刘召峰,2022-06-04 03:56:48,0,1,1,很不错，上课收获很大，也可以了解一些有趣的东西，但是在疫情方面的看法我不是很认同。我对历史了解比较少，作业完成起来比较困难，不过也算激发了我对历史的兴趣吧
154848,1055,刘召峰,2022-06-06 07:22:05,1,2,1,真的不错
154865,1055,刘召峰,2022-06-06 09:18:27,1,1,0,.....
157200,1055,刘召峰,2022-06-22 08:45:20,4,4,0,老师人真的很好呜呜呜，超级好超级好超级好，吹爆吹爆！
157307,1055,刘召峰,2022-06-23 01:41:57,3,4,1,卡绩王者，给分不差，但是卡。。。
157647,1055,刘召峰,2022-06-24 07:51:43,2,3,1,老师挺好的，上课收获很大
157689,1055,刘召峰,2022-06-24 10:35:39,1,1,0,老师马原给分不错的
159619,1055,刘召峰,2022-08-22 08:01:12,-28,15,43,自以为是，上课喜欢满堂灌，然后是很喜欢咬文嚼字，找一些话语的毛病。根本不懂得学生的心理，也不站在现在年纪的学生立场考虑学生的想法，就是自以为是清高和装的理论高大上，他自己也是当领导的，又去抨击其他当领导的，他自己抨击浙江的民营企业家，又生活在发展民营企业最好的浙江省。感觉上课有时候说话很迷，估计是装逼装的有点错乱了。
160165,1055,刘召峰,2022-09-14 05:43:21,4,6,2,《资本论》导读，课很硬，一学期资本论三卷全部要读完，老师讲的很好，但外专业请谨慎选择！\n\n后面有一部分会涉及到经济学的概念，大一同学不要选！跨专业不要选！\n\n跨专业选手每次上课都到，认真听讲，但确实很多听不懂。。。喜提3.3
160166,1055,刘召峰,2022-09-14 05:46:58,3,3,0,懂得都懂
160172,1055,刘召峰,2022-09-14 06:51:55,3,3,0,《我老婆》
164701,1055,刘召峰,2022-12-23 13:29:25,4,4,0,是个很有思想很有深度的老师，但是给分很求是
166410,1055,刘召峰,2023-01-12 07:37:51,0,1,1,很喜欢的老师！
166621,1055,刘召峰,2023-01-13 04:32:35,11,15,4,课讲的是真不错，真正的马克思主义者，对历史问题有自己的见解，学到了不少他的批判性思维，还是有用的。\n\n至于给分…真的不咋地😭还不是不求是，因为我不管8000字的困惑解惑作业，还是小组展示，还是期末考试，都有很用心的准备，答的都还不错。最后只有4.2…如果是别的老师比如zh等，按照我这程度就算不满也会有个4.8了。出分后有些伤心😭
167184,1055,刘召峰,2023-01-15 05:00:14,3,4,1,讲课很有意思，确实能学到很多东西，但给分对于我本学期付出的时间而言不咋地，卡绩
168078,1055,刘召峰,2023-01-26 04:22:12,3,3,0,很认真的老师
169226,1055,刘召峰,2023-02-25 01:19:06,6,6,0,作为一门思政类课程，真真正正的学到了很多历史知识，更重要的是学到了思维方法，虽然最后因为一些个人原因得分一般，但是觉得能上老师的课真的很开心
170694,1055,刘召峰,2023-03-08 07:35:49,12,24,12,很差劲啊
171105,1055,刘召峰,2023-03-16 04:09:28,18,30,12,先叠个甲，只针对资本论选读这门课，并且是从经济学专业出发看的，因为这是我们专业的必修课。首先我并不怀疑老师的上课水平，但是我认为经济学院让马院老师来开课就是个错误。老师以及上课发言的很多外专业同学（这门课虽然是经济学专业课，但是绝大部分是外专业同学）对西方经济学的理解是非常粗浅的，那为什么能把西方经济学贬的一文不值呢？最后再叠个甲，上述不针对老师和外专业同学，仅仅是对这门经济学的专业课的评价。
173029,1055,刘召峰,2023-05-11 13:06:27,-1,5,6,同学，老师上节课点名了吗
173056,1055,刘召峰,2023-05-12 05:50:30,9,17,8,楼下的同学的话固然有理，不过，经济学院的专业课，所以要懂“西方经济学”的老师来讲，那么这是“西方经济学院”吗？外专业的同学为什么比经院的多而且学得更认真，不需要反思吗？经济学院的老师为什么研究马克思主义经济学研究的不扎实，不需要反省吗？觉得老师和同学理解“浅薄”的，微宏经是满了吗？并且，有没有认真理解同学们表达的意思呢？想起来上次那个展示的同学，他的“消费费用”明明不是花费的钱，也讲了消费费用是类似于自己做饭需要洗碗这种“消费行为产生的费用”，这是和交易费用相似的界定，而一位提问的同学直接理解成了买商品时要付的钱，并根据自己的错误理解发起非难，这是否需要反思呢
173060,1055,刘召峰,2023-05-12 05:55:17,-8,7,15,楼下同学也许有道理。是经济学专业课，所以要懂西方经济学的人来上课，那么经济学院是西方经济学院吗？说老师和同学不理解，那么这位同学微观宏观是满绩了吗？而且，想起上次展示最后那个提问的同学，明明展示的同学展示时说明了“消费费用是消费行为产生的费用，比如自己做饭要买菜洗碗，会麻烦”，而不是消费时要支付的钱，那个提问自己没有认真听，理解错了同学的意思，还理直气壮的责问，这又是谁不深刻理解呢？
173257,1055,刘召峰,2023-05-17 06:27:18,1,5,4,仅针对史纲（H），pre半小时，但挑刺不止半小时，后面上课还一直在鞭尸，承认前面几个刺还有些道理，但思政课要求脱稿pre也是有点过分了吧，针对某个数据，自己不信就一直咄咄逼人，要一个答案，拜托，别的组pre怎么没见你这么挑刺，本来觉得自己组里组织得挺好的，结果被批判得一无是处（
173399,1055,刘召峰,2023-05-23 06:18:12,-1,6,7,发那两段话的人真的不是来搞笑的吗，明明对西方经济学不甚了解，但是要狠狠地批判它，是什么给了您高高在上的资本。就像没吃过龙虾就说它多么多么难吃一样，一点基本的逻辑都没有，还学什么社会科学
173962,1055,刘召峰,2023-06-05 08:46:53,7,8,1,上大学来遇到的最有思想的老师之一，我上课的时候摸鱼摸着摸着也会被老师的思想辩驳给吸引。虽然我们班的课堂氛围一般，但是老师会尽力鼓舞我们发表观点，也会给我们提供一些思路。
174344,1055,刘召峰,2023-06-10 06:57:34,-7,6,13,下面发了两段差不多的话都人笑死我了，估计你就是那个被提问的人吧，提问的那个同学都明确指出了是概念上的错误，你非要谈什么“理解”，概念都错了还理解什么东西？我中级宏观微观都满绩，我可以说吗？上来就偷换概念，建议去学学逻辑学，下面已经有个同学喷你了，我也就不多说了
174351,1055,刘召峰,2023-06-10 09:07:13,14,18,4,对西方经济学，刘老师不能面面俱到持有一些个人看法是很正常的，但是他上课的态度和授课的水平都是值得肯定和尊重的。为什么让马院的老师来开资本论选读，一方面是因为专业要求，学经济学确实不能不读资本论；另一方面，经济学院年轻老师里几乎没有研究资本论的，要不是迫不得已，经济学院也是不会找马院的老师来开课的。刘老师对资本论的研究深度不容置疑，本来就是经济学领域的不同流派，方法论也是不一样的，心态包容一些就好，何必谈一个对错嘞（
174475,1055,刘召峰,2023-06-13 01:37:27,-7,4,11,发那两段话的人经典“先不谈”。先不谈老师和同学到底懂不懂经济学，你必须得微经宏经满绩（不会有人觉得那个说经济学不研究生产的人懂经济学吧？）；先不谈经济学总共只有20多个人，经济学同学就是比外专业少；先不谈概念使用错误，你理解就是错的。既然都这样了还有什么好说的呢？
174861,1055,刘召峰,2023-06-19 05:55:28,5,8,3,下面这位同学经典“先不谈”，不谈本人的意思是什么，首先“我觉得”你的意思就是XX，然后我觉得你这个意思就是把概念用错了。先曲解别人的意思，然后说别人这个意思不对。照这个思路，这些同学们大可以批评的更狠一点，去批评所有类比和比喻，什么二月春风似剪刀，春风能是剪刀吗，概念都用错了，谈什么理解。
174865,1055,刘召峰,2023-06-19 06:23:11,-24,7,31,笑死我了发两段话的人，张五常就说过，“马克思是我见过最蠢的人，我曾把市面上马克思的书都找来看过，一句话也看不懂。我们自己研究经济多年，如果还看不懂，那基本上就是错的”。你再懂经济学能有张五常懂？他尚且说马克思就是瞎扯。反驳你的人虽然全程偷换概念，但是反驳的好！还什么“资产阶级经济学院”，前面的同学不敢说我说，就资产阶级经济学院怎么了？经济学院就服务资产阶级了怎么你了？也就你顶着匿名瞎bb。
177286,1055,刘召峰,2023-07-02 15:03:52,0,3,3,老师很专业很认真也很捞
177287,1055,刘召峰,2023-07-02 15:03:52,1,3,2,老师很专业很认真也很捞
177395,1055,刘召峰,2023-07-03 06:25:53,5,5,0,老师资本论课程讲的非常通俗易懂，大受教育。
178046,1055,刘召峰,2023-07-06 11:13:45,-1,1,2,哈哈哈
178349,1055,刘召峰,2023-07-10 14:31:26,21,25,4,“张五常就说过”那位同学我实在蚌埠住了，你但凡放个萨缪尔森、庞巴维克也好啊，张五常根本就没做过马经研究，哪怕一篇马经的文章都没有，萨缪尔森都认为马克思是“一个政治经济学的有创造力的缔造者”（参见Paul Samuelson：《Marx as Mathematical Economist》，第292页），怎么张五常比萨缪尔森还懂马克思还懂经济学吗？张五常是出了名的狂，而这位同学我看更狂······
178530,1055,刘召峰,2023-07-13 13:11:39,7,7,0,讲课不错，很有思想\n\n给分不是很好
178937,1055,刘召峰,2023-08-02 10:53:10,10,16,6,万能回答：不是我党的问题，是我党内的坏分子的问题。
182504,1055,刘召峰,2023-11-16 16:29:57,-2,12,14,很歹毒，不体谅学生，给分也不好
189307,1055,刘召峰,2024-01-23 04:37:26,2,3,1,上的马原，感觉刘老师很有人格魅力，而且学术水平过硬，讲课不拘泥于教材，课中课后回答同学问题有耐心且易于理解，在结课的时候还给我在我的教材上留了寄语。关于小组的pre，如果在组内有突出贡献(如:当小组组长或者承担了主要工作等)的话可以向助教和老师申请额外加分，这在一定程度上可以减轻因小组其他组员摆烂而导致分数低的问题，虽然我不知道可以加几分(可以自己去问问)。最后的结果我也比较满意，很捞!
190015,1055,刘召峰,2024-02-09 01:02:40,1,1,0,老师思想很深刻，然后讲的也很好，我觉得如果真的想练自己的理论能力和思维能力的人可以跟，然后打分的话我觉得还挺好的，因为我真没有怎么竞争，上课的话也你喜欢的话就发言吧，没什么想说的，就安静就行，困惑解惑认真做就行，你对这个感兴趣的话得分不会低的，期末考试的话，文科生大部的大题还能拿的好一些吧。
192918,1055,刘召峰,2024-05-31 14:15:46,11,14,3,一个人的食物有时是另一个人的毒药，经济学的专业课，不应该和马院混在一起，由一个不懂西经的老师来讲。之前yb的政治经济学，lwd的经济思想史都相安无事，但就这门课听很多经济学的同学都听不下去。lwd说过，如果一个经济学院里有马经方向的学者，那他基本上是被边缘化的，现代西经几乎是马经天敌。yb也说过，政治经济学三个老师没一个是经济学系的，如果经济学系没有能力开这门课，那它应该被移出培养方案，而不是被拉来凑数去满足那些上面的zzzq
193166,1055,刘召峰,2024-06-04 06:24:40,0,0,0,有水平
195312,1055,刘召峰,2024-06-27 17:23:38,0,0,0,我上的是《资本论》选读，老师讲的很好，就是结合原文讲的很多，有点绕，没太听进去，其他都还好，复习一下期末考的一般，老师给分求是。
195354,1055,刘召峰,2024-06-28 00:36:42,0,2,2,老师人很好，虽然感觉这课很难学，但是最后考试老师也有放水了
196128,1055,刘召峰,2024-07-01 18:53:29,0,9,9,给分烂中烂，张口闭口庸俗经济学，自视清高，以为自己很有水准。如果不是课程冲突谁愿意上这课。\n\n\n\n如果想要不怎么学也能拿一个稍微看得过去的分，千万别选他的课，快跑。
196641,1055,刘召峰,2024-07-04 12:36:45,-5,15,20,可以理解一些同学评价给分不好，但对于政治经济学流派的问题还是要有“求是”精神，可以因为给分不好不选课，但不能颠倒好坏\n\n刘老师的课对比那些马原老师简直天差地别，也敢于批判当下社会的问题，并不是单纯的思政课，非常有专业性，马政经理论讲的是有一套逻辑的，说这门课是zzzq完全是不求是\n\n课上刘老师也给了大家辩论的机会，为什么不辩论呢？刘老师对大家的问题也都是尊重的呀，敢于辩论才是理论自信\n\n被局限在新古典经济学实在是太遗憾了，如果按照班里有些同学的观点“主流经济学最大的优点是可以结合数学”，那还要经济系的学生干什么？让数学系的学生解决问题不就好了？\n\n个人斗胆认为经济系的学生相较于理工科学生的长处本应该是类似马的“历史维度”和“哲学高度”，更应该珍惜刘老师的课堂！！！
197083,1055,刘召峰,2024-07-07 11:27:50,3,4,1,外专业来的，坐标资本论选读，刘老师讲课很有深度，能学到很多东西，期末考会提前给提纲，按提纲认真背给分还好。给刘老师十分。
197550,1055,刘召峰,2024-07-18 14:07:05,5,5,0,事情多给分差
198138,1055,刘召峰,2024-09-02 08:11:21,0,2,2,给你11分，分11期付。事多，给分巨烂。
200455,1055,刘召峰,2024-10-17 07:15:20,4,5,1,事多分少，对水课的同学非常不友好
200506,1055,刘召峰,2024-10-18 02:32:11,2,2,0,其他专业学生快跑，作业超级多
201584,1055,刘召峰,2024-11-04 13:37:43,-3,7,10,很符合我对一神教传道士的刻板印象
201804,1055,刘召峰,2024-11-06 12:04:44,0,4,4,老师上课全是干货，真的想让人学到东西。
202419,1055,刘召峰,2024-11-12 13:47:34,1,5,4,上的博士生思政课什么中国马克思主义啥的\n\n上课怎么样就不评价了，感觉老师缺个于谦，不然可以开个相声班社，就叫做反串社了。\n\n只是看了下面有人拿甘阳和刘小枫和老师做对比，我只能说，虽然刘小枫做施米特被大家普遍认为是瓦釜雷鸣，但是刘的本职工作古希腊罗马哲学确实是功底扎实的啊。至于您……
203684,1055,刘召峰,2024-11-20 12:44:17,2,5,3,事多分少，不想折磨自己的快跑
204100,1055,刘召峰,2024-11-24 06:28:59,1,3,2,真正的好老师
206138,1055,刘召峰,2024-12-13 06:09:29,0,3,3,讲课很有深度，适合热爱历史热爱思考上同学。
208476,1055,刘召峰,2024-12-28 07:39:16,1,2,1,人很好，对学问很有热情，感觉他比较适合教专业课。
213995,1055,刘召峰,2025-01-22 14:15:38,2,6,4,“革命者来！”
218824,1055,刘召峰,2025-05-07 05:31:36,0,2,2,马原，事多分少
219381,1055,刘召峰,2025-05-26 07:30:35,1,1,0,当身处于一种关系之中的时候还能不能想象超越这种关系的状态，是选择从一个现象推到另一个现象，还是说抽离出现象直接去改变更深层次的东西，这不仅是个方法论的问题，也是个意识形态的问题，在此之上才有好坏的价值判断。那么再反过来，如果意识形态只是工具而没有对错之分，作为目的的人在现在这个体系里又存在于何处以什么样的姿态展现出来呢？想到的一些跑题的事情罢了
221550,1055,刘召峰,2025-06-24 11:54:24,0,0,0,给分好像很求是，上课很好
705,1062,宇正香,2018-03-04 09:56:05,25,40,15,耐心的好老师，补选她的课比较容易，老师还会帮你交条子
2871,1062,宇正香,2015-05-09 15:36:50,4,13,9,好老师 给分厚道 课在思政课里算是良心了 听了还有收获 老师也很好 我期末成绩算错了老师还给我打电话致歉
3752,1062,宇正香,2015-06-17 03:23:06,-7,9,16,不推荐不推荐不推荐
4755,1062,宇正香,2018-06-10 07:02:10,8,12,4,我觉得在思政课里算好了 给分很好 我们小组的成员分似乎都很高 而且打分公正透明 说给分低的肯定敲了不少课
6078,1062,宇正香,2015-07-10 17:17:36,5,10,5,上的好人好给分也不错
7202,1062,宇正香,2015-09-10 15:59:34,4,8,4,讲毛泽东算是很有经验，人很好，给分非常透明，主动一点不会低
11598,1062,宇正香,2015-12-07 08:34:37,5,9,4,良心老师
21030,1062,宇正香,2016-02-11 12:53:29,6,9,3,公平公正
21664,1062,宇正香,2016-02-29 13:20:53,4,7,3,老师人很好 课讲的不错 给分也给力
25949,1062,宇正香,2016-06-14 14:02:24,4,6,2,非常好的老师
30254,1062,宇正香,2016-11-15 13:09:36,-14,5,19,坑死。改卷感觉太草率，一天就出分了。
30674,1062,宇正香,2016-07-02 07:43:01,2,5,3,？！？！？！
32157,1062,宇正香,2016-07-06 00:12:29,3,5,2,非常好非常好非常好！！！
39539,1062,宇正香,2016-12-23 16:10:12,-1,1,2,很好啊
45788,1062,宇正香,2017-01-20 05:51:41,3,5,2,棒棒哒\n\n
45794,1062,宇正香,2017-01-20 06:05:01,1,3,2,给分好，一身正气的老师。。。。好好写报告好好调查就好了。
45918,1062,宇正香,2017-01-20 09:06:22,-2,5,7,老师人不错，要求太多，给分完全就看发言次数，不透明，而且在课上遇到了和这个课一样恶心的人
56367,1062,宇正香,2017-07-03 14:52:23,1,3,2,毛概大课老师轮流上课，没啥可说的\n\n老师平时分给的很好，想要拉开差距主要靠大课小组发言次数，然后还有考试。老师尽可能给很好的分数了，至于考试，我觉得思政课其文科的性质决定了文理考试有差别，所以还是客观看待吧
56732,1062,宇正香,2017-07-04 12:46:45,-1,1,2,老师人很nice，很为学生着想，选上她的课是很幸运的事情！
66240,1062,宇正香,2018-01-14 02:41:58,2,3,1,啊啊啊啊啊 老师退休了 QAQ 我还想着大三选她的毛概啊
70000,1062,宇正香,2018-01-26 02:26:39,3,5,2,分很低呀
70075,1062,宇正香,2018-01-26 05:27:15,-1,1,2,老师人很好，在毛概老师里面算是很好的了，给分也很公平
74894,1062,宇正香,2018-03-06 09:36:27,4,5,1,好好好...好吗？！
74895,1062,宇正香,2018-03-06 09:38:45,4,4,0,花半天功夫给你讲怎么算分\n\n
98569,1062,宇正香,2019-06-21 02:31:58,5,5,0,老师人很好 给分还行吧 毛概总分讲道理主要看考试多一点 平时分最多差一档 上半学期小组展示课有一次点名 展示课上提问发言会有平时分加分 恶竞的可以选她的 然而据说好像一次只加平时一分 小组讨论的话如果是宇老师的基本上所有组都会被轮到 这点比其他老师要好 讲课么其实我觉得很一般了 组内给分规则比较详细且公正 新版习概没题刷还是有点难考的
103212,1062,宇正香,2019-02-27 01:28:22,1,1,0,评分标准讲了两节课?
111755,1062,宇正香,2019-07-02 18:26:21,-5,2,7,老师太棒了，毛概里绝对良心的老师，只不过91卡机有点难受，十分，ps老师今年退休好像
111806,1062,宇正香,2019-07-02 23:42:23,-10,1,11,老师太棒了，毛概里绝对良心的老师，只不过94卡机有点难受，十分，ps老师今年退休好像(?
112108,1062,宇正香,2019-07-03 15:06:03,-5,1,6,老师我爱你\n\n虽然我才4.2
113272,1062,宇正香,2019-07-06 03:30:11,-5,0,5,老师太棒了，毛概里绝对良心的老师，只不过99没满分有点难受，十分，ps老师今年退休好像(????
124953,1062,宇正香,2020-07-26 01:00:08,0,0,0,女神！！！
124954,1062,宇正香,2020-07-26 01:02:15,0,0,0,宇老师女神！毛概必选！
124955,1062,宇正香,2020-07-26 12:14:30,0,0,0,好老师！
151162,1062,宇正香,2022-02-25 02:11:51,-1,0,1,公平公正，和蔼可亲！
27,1094,张应杭,2015-03-14 15:28:27,1,15,14,中国传统哲学和马克思主义结合
191,1094,张应杭,2015-03-14 16:40:23,3,15,12,有亲和力
739,1094,张应杭,2015-03-16 06:29:31,65,80,15,儒雅有魅力
1679,1094,张应杭,2018-04-06 11:09:20,10,22,12,老师是个很有个人魅力的人
1829,1094,张应杭,2015-03-26 01:18:49,-5,8,13,不错，很多人生道理，不过给分一般
1869,1094,张应杭,2018-01-03 14:42:03,1,11,10,给分一般，到很有气质，上课权当听讲座
2215,1094,张应杭,2015-04-09 07:27:34,42,102,60,略肤浅无干货，喜欢心灵鸡汤的会喜欢他吧。逻辑狗表示受不了他讲课。
2432,1094,张应杭,2015-05-01 03:59:16,0,6,6,很有收获，大境界!
5176,1094,张应杭,2015-07-05 14:35:00,0,6,6,用心的老师
6644,1094,张应杭,2015-07-17 02:38:41,20,36,16,上课真的很棒，从马原讲到佛教思想、为人处事等等。平时事情不多，期末给分还算可以。
7555,1094,张应杭,2015-09-15 03:40:58,4,16,12,人生美学是我听过最最好的通识！
7675,1094,张应杭,2015-09-15 08:26:56,9,24,15,老师很好！人生美学美呆！老师讲的很生动，每节课都好好听的。。唯一一门课
8045,1094,张应杭,2015-09-16 17:37:40,0,4,4,棒棒的
10439,1094,张应杭,2015-11-18 21:06:25,1,5,4,铁杆粉丝，张老师结合生活实例授课，并且分享很多人生心得！
11857,1094,张应杭,2015-12-18 06:44:20,0,5,5,很棒，很喜欢关于人生美学的课
12227,1094,张应杭,2015-12-22 11:59:46,-1,1,2,
12954,1094,张应杭,2015-12-24 11:12:07,2,6,4,人生美学太好了，虽然被正态了，但就像老师说的，上一门好课的意义远比分数重要
14347,1094,张应杭,2016-01-06 12:35:50,1,5,4,讲的超级棒，超级有魅力！
14825,1094,张应杭,2016-01-09 14:42:19,1,3,2,张老师绝对的大师 太崇拜了
15361,1094,张应杭,2016-01-14 04:00:33,0,4,4,老师很有风度啦，课很有意思，最后一节课说正态什么我要被吓死了T_T 不过最后分还不错 最后考试有题是上课讲过的≥﹏≤
15418,1094,张应杭,2016-01-14 10:19:29,8,24,16,就算只有2+的绩点也依然支持大家选这门课，虽然不一定收获的了高分，但能收获到更多比分数更重要的东西
15500,1094,张应杭,2016-01-15 02:06:55,-1,5,6,呃...分不是很好但课很不错吧
16163,1094,张应杭,2016-01-17 10:59:33,1,2,1,老师很有趣！！！
16221,1094,张应杭,2016-01-17 13:52:01,261,329,68,“爱是什么呢？我读研的师兄告诉我，爱就是让你一个人骑5小时的自行车去看自己的异地的恋人，一起吃顿饭又回来了，而且一路上是吹着口哨回来的。” 重塑了价值观。
16988,1094,张应杭,2016-01-19 11:28:26,0,4,4,人生美学没想象中那么好
20115,1094,张应杭,2016-01-26 06:44:05,0,3,3,非常儒雅的老师，用心听会发现并不是鸡汤，马原只要用点心，不要太水，能获得一个比较可观的分数。
22635,1094,张应杭,2019-10-22 15:33:57,-192,23,215,这种人活着除了浪费粮食没有其他作用，要不是为了得这几个学分我是坚决不会来听他胡说八道的。
22703,1094,张应杭,2016-03-10 04:41:40,0,3,3,给分不好，课不错
23441,1094,张应杭,2016-03-30 02:06:22,14,29,15,老师自以为是唯物论者，但是很多话讲得都很没有根据，对西方排斥，对现代科学理解片面。在我看来，不止有点唯心，有时还有点迷信……抛开这一点还是不错的，死理性派慎选。
23490,1094,张应杭,2016-03-31 13:20:45,-6,11,17,最水的通识没有之一。讲的道理都是心灵鸡汤，还是十年前的。没有退课是后悔的事情。
23618,1094,张应杭,2016-04-10 08:21:32,5,13,8,古典主义，清淡的风，很纯粹，受益匪浅
24024,1094,张应杭,2016-04-25 13:59:10,0,2,2,很好的老师哦 给分好有魅力 上过最好的通识课
25134,1094,张应杭,2016-05-06 02:49:56,1,2,1,要读原著…好苦…
25371,1094,张应杭,2016-05-16 06:31:08,-1,2,3,讲课没有想象中的好，马原比较水
26926,1094,张应杭,2016-06-21 15:52:17,4,6,2,哲学系的老师，挺儒雅的，讲课比较鸡汤
27503,1094,张应杭,2016-06-26 14:51:47,33,64,31,大家不要被骗了，水军好多。
28672,1094,张应杭,2016-06-28 12:12:20,0,3,3,张老师讲课风趣幽默，有自己的见解，很棒！
28878,1094,张应杭,2016-06-29 02:22:44,-1,1,2,很放松，修身养性\n\n
30892,1094,张应杭,2016-07-02 23:51:43,0,4,4,三观很端正，积极从容
30895,1094,张应杭,2016-07-02 23:58:59,0,10,10,张老师的课很水，没有展示，有几次点名式的小测试，还有一篇500字的心灵鸡汤还有一篇读书报告，是马原老师里事情最少的吧
30951,1094,张应杭,2016-07-03 04:16:38,-35,7,42,张应杭一生黑，因为他均绩直接掉0.2，慎选！
31629,1094,张应杭,2016-07-04 09:45:15,0,7,7,人不错，不会对我们生气，事情很少，大多是完成课堂作业代替点名。马原的内容枯燥不是老师的错……真心不感兴趣。只要认真完成极少量作业，考试好好考，成绩就不会差。
32319,1094,张应杭,2016-07-06 07:04:16,-4,4,8,给分我觉得挺公正的，上课有时会有课堂小作业突击点名。我每次点名都在，期中读书报告写了4000+，期末刷完了马原选择题题库，考试碰到好多原题，所以自认笔试考得还行，最后绩点4.3
32385,1094,张应杭,2018-01-20 00:22:39,2,10,8,一次点名没到 考试基本裸考就是吃高中老本 最后4.2 我觉得给分也挺正常的吧 楼上说“一生黑”的那人 我只能说你挺可笑的.
38663,1094,张应杭,2017-04-30 01:19:22,34,41,7,乱传谣言是违法的……
39002,1094,张应杭,2016-12-20 11:42:34,17,20,3,老爸，你开车就没有生气的时候？\n\n那当然没有，我是文化人………
40301,1094,张应杭,2017-12-24 04:39:29,0,2,2,谁知道老师联系方式啊 还有考试考什么 哪里考啊
40514,1094,张应杭,2017-01-22 02:39:26,0,3,3,充满了智慧
41009,1094,张应杭,2017-01-08 03:41:44,4,8,4,老师怎么说呢，是一个后天派，好像不太相信基因的力量。和我自己观点有些相悖，但是听课还是很好的，整个学期也只有一次作业，考试也是开卷，可以带电脑?。挺好的，大家选吧～
46195,1094,张应杭,2017-01-21 01:51:25,0,6,6,老师讲课娓娓道来听着很舒服 平时除了读书报告几乎没有别的事情 考前稍微刷了点选择题背了点提纲 给分4.5很开心 感谢老师
46578,1094,张应杭,2017-01-22 03:08:40,-1,3,4,事情很少，就几次课堂作业权当点名。虽然很多观点不认同，但是至少讲课不是很枯燥。马原最后考试背背书绩点就还好，毕竟有正态
46682,1094,张应杭,2017-01-22 06:57:23,-5,0,5,我想，老师很多观点是由于思政课的性质吧，我对课上很多略显片面的观点也不赞同。然而术业有专攻，不能以期望理工科老师的标准去要求学人文的老师。有的鸡汤还算值得一听。偶然发现老师有一本书叫《东方管理智慧》……看书名怎么感觉不太马克思……
48198,1094,张应杭,2017-03-08 04:32:33,1,6,5,助教帅
48963,1094,张应杭,2017-03-19 11:23:52,-2,0,2,给分真的很差
49569,1094,张应杭,2017-04-19 02:18:06,0,2,2,我一个有文化的人怎么能在冬天吃冰淇淋？嘿嘿嘿
52291,1094,张应杭,2017-06-17 18:23:16,0,2,2,儒雅 谦和
53931,1094,张应杭,2017-09-20 05:45:14,-24,12,36,马原给分一般 平时一次课堂作业不在 但是和老师请过假了 考试选择题大部分都写过  读书报告也写了4000+ 最后只有4.2唉
55955,1094,张应杭,2017-07-02 17:55:01,0,2,2,老师人很好\n\n但是出分也忒慢了\n\n以及人生美学人文素养不是特别好的同学慎选
56485,1094,张应杭,2017-07-04 01:35:28,0,2,2,马原给分一般，非常非常非常水(应该是事最少的马原老师了)。但是上课偶尔要交作业当点名，故不能翘课。
56550,1094,张应杭,2017-07-04 03:22:53,6,9,3,一位儒雅温柔有气质的老师，听他上课很舒服，人超好，给分也很棒！
56554,1094,张应杭,2019-06-13 02:40:44,-13,8,21,4.8。我没有听过课。就是考试的时候结合自己的观点和课件就可以了。很棒的老师。
56686,1094,张应杭,2017-07-04 09:12:56,2,4,2,给分真的一般
58074,1094,张应杭,2017-07-28 07:40:36,81,85,4,原来课程改革2+1就是上两节放一节~社会我杭哥！让这样的改革来得更猛烈些吧！
58366,1094,张应杭,2017-08-30 00:58:58,0,2,2,很温柔，有气质，吸引人
59203,1094,张应杭,2017-09-20 07:22:39,0,1,1,老师讲课超级有意思，会引用很多当代的人和事，绩点不高但是上他的课是一个有趣的经历
60305,1094,张应杭,2017-10-17 04:06:23,197,211,14,“这种请假理由我是接受的：今天下雨了，我想到这场雨后可能桂花就要落了，突然想撑伞去桂花树下发发呆。”
61870,1094,张应杭,2017-11-21 10:29:47,0,1,1,有底蕴\n\n
63815,1094,张应杭,2017-12-15 10:16:45,0,0,0,。。。
64689,1094,张应杭,2017-12-26 10:56:51,1,1,0,好课好课
64730,1094,张应杭,2017-12-27 03:53:31,1,1,0,可以水也可以好好听，好好听真的很棒，无法用语言表达的好
64946,1094,张应杭,2017-12-28 04:27:07,-7,3,10,人生美学真的超级棒！\n\n作为一个只要鸡点不要听课的学生来讲，我没有听过一次课，但是考试的时候写作文就有4.8。个人认为人生美学只要你自己抒发了自己的鲜明观点，然后结合ppt写作文就好了。不要照抄ppt就okay.
65977,1094,张应杭,2018-01-10 14:02:01,4,5,1,老师很有教学热情，对学生很友善，谈吐很有吸引力
67536,1094,张应杭,2018-01-21 13:00:49,0,0,0,不错哈哈
68261,1094,张应杭,2018-01-23 01:52:54,0,0,0,老师人很棒很随和哇，有一次嗓子状态很差也还坚持讲了一节，还有一次课给我们放电影（虽然看完要写思考题）。平时会有几次点名性质的小问题，但是一周两节课还没有别的任务简直太轻松有木有！最后一次课开卷考试啥都能带，非文科生看到试卷惊呆的同时表示real头痛，绝望地抄了俩小时书。不过刚刚看到成绩出了，还算不错吧，意外之喜。
68336,1094,张应杭,2018-06-27 05:31:08,4,9,5,人生美学这门课比起其他通识真是太省事了，只上两节课，没有论文，小组展示什么的，期末还是开卷什么都可以带，最后给分也不错，好评。不过就是上课比较水，感觉没有学到我心目中真正的人生美学。
69672,1094,张应杭,2018-01-25 07:45:41,6,6,0,马原课确实挺水的，但给分也太差了吧？
69912,1094,张应杭,2018-01-25 16:00:29,3,4,1,很感谢老师，感觉老师平时很多任务是给大家找分的…至少对于我这种期末考大题一道不会的人来说得分全靠平时，这个答题情况86 4.2真的很满足了
70513,1094,张应杭,2018-01-27 00:07:51,9,11,2,马原的事情少是真的很少，给分也真的很一般。所有课都到了，每次论文按时交了，期末感觉也写满了，绩点只有3+。
70561,1094,张应杭,2018-01-27 08:16:25,1,3,2,男神！人超好，会帮我捡东西拔插头，上了一学期马原却感觉上了人生美学，上课内容很有意思，我从来不水手机。再说说期末，因为考试安排太紧不得已两小时速成马原，刷了两套选择题扫了几眼提纲结果居然3.9很开心很开心很开心了。
70705,1094,张应杭,2018-01-27 12:11:05,0,0,0,思想古典，上课是享受，洗洗脑，虽然有时候的确像鸡汤，还是课是不错的呀。没有作业，认真听课成绩不差的。
73181,1094,张应杭,2018-02-01 06:12:19,3,3,0,自我感觉课很水。。。
73694,1094,张应杭,2018-02-02 16:37:49,-1,3,4,人生美学真的是很适合那些想轻松拿通识分的学，老师布置的任何task甚至期末考试都是在课堂上解决的，而且课下的还很早，有时会放电影供大家消遣什么的，给分也挺好，保证出勤一般就不会被正态
75893,1094,张应杭,2018-05-30 05:36:19,-15,9,24,无知，爱装逼 ，毫无逻辑，一派胡言，声音贼大，令人作呕
76446,1094,张应杭,2018-04-09 12:00:47,0,1,1,有平时作业吗  考试形式怎么样
77904,1094,张应杭,2018-05-08 12:22:26,5,8,3,老师是一位极度有人格魅力的老师。男神。喜欢他讲话那种不疾不徐的优雅，更喜欢他由内而外散发出来的儒雅。期待每周二晚上的如沐春风。
80435,1094,张应杭,2018-06-26 12:04:13,2,4,2,很儒雅和随和的老师，有机会还想上他的课
83199,1094,张应杭,2018-07-10 02:18:00,3,3,0,作为一个理科生可能真的学不好。。。
83236,1094,张应杭,2018-07-10 03:16:03,0,4,4,给分超级超级好  事儿也少  一定要选他的人生美学
84079,1094,张应杭,2018-07-12 03:34:41,0,3,3,上张老师的课是一种享受，就这么简单。
84098,1094,张应杭,2018-07-12 04:07:46,-1,2,3,老师是天使吧 上课轻松给分还好
84126,1094,张应杭,2018-07-12 05:31:40,6,7,1,给分低，复不复习和最后得分没关系，关心绩点的人慎选
85202,1094,张应杭,2018-07-16 04:34:56,0,2,2,老师很儒雅，上课时会讲一些有哲理的故事，也很关心同学，很幸运选上了老师的课。
85225,1094,张应杭,2018-07-16 07:58:19,1,3,2,喜欢老师的课，有人说是心灵鸡汤，但我觉得细细品味还是有道理的，老师是在教我们如何温柔地对待世界吧。
85614,1094,张应杭,2018-07-21 07:22:34,-2,2,4,老师的鸡汤是我听过最舒服的鸡汤
86511,1094,张应杭,2018-09-17 03:02:04,-5,5,10,垃圾 给分差
86866,1094,张应杭,2018-09-19 06:26:44,0,1,1,说实话我挺喜欢老师的课的  以马原理论联系现实  马原课这样很享受了  如果能让我一边嗑瓜子一边听就更享受了~
88213,1094,张应杭,2018-10-24 05:39:50,24,36,12,张老师的课事情确实少，期中只要交一篇读书报告。平时没有作业。\n\n有两节课看了“摩登时代”，以此反映人的异化问题，个人觉得比干巴巴地照本宣科好。\n\n但是接下来几节课老师讲课就不太严谨了。老师要论证唯物主义可以，但直接把唯心主义直接归类于“乱想”“误导”，也不列举唯心主义的几大观点供学生判断思考，不觉得太片面太肤浅了吗？难道那么多哲学流派都是傻子？一方面老师强调哲学思维，另一方面老师在授课时太多内容都是单方面下定论，几乎没看到思辨性何在……\n\n最让我震惊的是，有一节课老师为了说明唯物主义是正确的，居然说“黛玉葬花是没文化，是唯心主义”。老师下的这个结论真的深思熟虑过吗？看到张老师还教人生美学，emmm...不敢按照老师的逻辑推下去，文学史怕是要凉凉……\n\n对张老师真是又爱又恨，希望接下来的课不要进一步变成“脱口秀”，让人失望。
91509,1094,张应杭,2018-12-12 05:43:25,10,11,1,个人不喜欢他的马原，一直灌鸡汤，或者鼓吹一些过于理想化的东西。而且他对事情的评论总是让人觉得他并不为讲道理，而是单纯因为他站在某一方的立场上，便极力维护这一方的观点。私以为一名思政课老师还是应该引导学生去思考，而不是单纯地把某种立场灌输给学生
92850,1094,张应杭,2019-01-05 07:29:47,4,6,2,马原课体验极好，可以提前下课，给分不清楚，但是老师真的有人格魅力
93771,1094,张应杭,2019-01-13 12:34:19,-1,4,5,人生美学 有意思 有思想 有深度 老师真的是学者风范 当然印象最深的还是那句“我不跟你一般见识 没文化的人才会XXX” 哈哈哈哈哈哈
98993,1094,张应杭,2019-01-24 06:33:20,10,15,5,给分emmm
99054,1094,张应杭,2019-01-24 07:59:07,13,16,3,人生美学。给分玄学。\n\n上课也就很一般灌灌鸡汤。\n\n不晓得那些吹的人什么心态。
99089,1094,张应杭,2019-01-24 08:52:40,6,8,2,老师的马原真的超轻松。最后给分吧，可能确实因为老师平时事少，所以期末考占比比其他老师大一点，但期末考突击背一下和多刷些题还是很有帮助的。总之，张老师是个不错的老师，但没什么党性的同学慎选
99090,1094,张应杭,2019-01-24 08:52:50,7,7,0,讲的真的很鸡汤，没啥实质的内容，有三次小测，你折水课
99094,1094,张应杭,2019-01-24 08:56:14,2,2,0,主要还是需要自己的思考吧
99459,1094,张应杭,2019-01-25 00:08:34,1,3,2,人生美学，全勤，期中作业也交了，期末考得，这文科性质题目我不知道答的怎么样。通识课，绩点3.3，不知道说什么，先给大家拜个早年。\n\n    期中作业最后是全班打分，去掉最高分。讲道理这个去掉最高分我是有疑问的，如果去掉1个最高分，那基本没差还麻烦，如果把最高分的全去了，那好像不对吧。再说了，光去最高分，不去最低分。\n\n    人生美学，这课一点也不“美学”，指望欣赏来的都赶紧走吧。\n\n
99476,1094,张应杭,2019-01-25 00:36:29,0,1,1,给分不好
103971,1094,张应杭,2019-03-08 05:41:43,1,3,2,又红又专
105075,1094,张应杭,2019-04-03 06:31:37,0,0,0,马原老师太可爱了！！！\n\n代言飙锅串串（的老板娘）\n\n还安利热剧《都挺好》\n\n张老师我爱了！！！
108369,1094,张应杭,2019-05-22 05:53:23,9,13,4,感觉老师很浅薄，对事情的看法很唯心。对很多事情夸夸其谈，对他的观点不能苟同。讲苏轼时说，苏轼被王安石嫉妒排挤，秦国灭亡是因为太暴虐π_π，还举了孟姜女、阿房宫的例子。总之让我难以相信，他居然是马原老师。
108999,1094,张应杭,2019-06-05 07:47:16,5,5,0,打了五分，上的马原。轻松是非常轻松的，毕竟原本三节课只要上两节课，有时候还只有助教来放PPT，做个几百字的小作业然后就走了，而且没有展示，没有恶竞发言，但是感觉老师膨胀了。。。
109510,1094,张应杭,2019-06-16 06:04:19,9,10,1,张应杭老师的马原是所有老师中最水的马原课，只上两节，有时候只需要看看电影写写短评，无恶竞。但上课讲的东西不多，复习比较麻烦。老师有很丰富的人生阅历，认真听的话能有很多人生的感悟，可以说是把马原课上成了人生美学课。喜欢老师风格的人，推荐你来选。
112554,1094,张应杭,2019-07-04 17:38:30,4,5,1,人生美学水学分可以，想学到什么还是算了吧
112747,1094,张应杭,2019-07-05 03:41:10,3,5,2,乱给分
112779,1094,张应杭,2019-07-05 02:57:04,0,2,2,老师三观很正，很喜欢老师上的人生美学课！学到了很多！为老师打call！
112932,1094,张应杭,2019-07-05 12:57:44,2,2,0,马原课看自己吧，一个学期少上16*45分钟的课还是蛮爽的。最后绩点看考试咯～
113135,1094,张应杭,2019-07-06 00:08:34,8,9,1,事少给分差，最后考的不错也很低，?杀
113359,1094,张应杭,2019-07-06 09:49:33,-2,4,6,给分极差且迷，只有心灵鸡汤，三观略偏（比如男性必须有阳刚之气以及看不惯女汉子，女孩子不要化妆注重自然等），观点不能苟同。
113962,1094,张应杭,2019-07-08 03:19:17,-6,7,13,马原喜提3.0，大学以来最低?点
114493,1094,张应杭,2019-07-10 05:56:17,4,4,0,有些时候觉得老师的观点还能接受，但是有些时候就无法接受。对于我来说，老师好坏不重要，因为我们是从自己的认知出发的，带有自己的主观性，但是我们可以自由选择吸收老师所介绍的内容中对自己有启迪的点，这样子就够了。\n\n顺便想说一句，我选的是夏学期人生美学。最后的期末考试在公邮里有，题目是在上一年冬学期的考试总结里，只有一道题目不一样。并且我也看了今年的助教改卷点评，和去年点评几乎一模一样。
116509,1094,张应杭,2019-09-11 02:51:51,4,6,2,听了一节马原我就知道，这和那些所谓《四书》、《论语》的儒家思想教育课没有任何区别。\n\n“马克思主义理论都是德性的问题。”
117980,1094,张应杭,2019-10-17 12:14:23,3,9,6,我听过最好听的思政课！听他讲祖国的发展，讲阿里讲华为，真的快哭了，觉得太不容易了。可能不爱听的同学没什么党性吧。
118200,1094,张应杭,2019-10-22 15:31:56,6,7,1,没有比较就没有伤害，老师马原的课可以说是最友善的了。没有小组讨论，没有展示，不会刻意点名但是有时会在课结束前请大家写两百字的感受当作点名，老师上课从不讲虚的，都是自己切切实实的经历体会，比那些只抱着书本上课的好多少不知道。
118214,1094,张应杭,2019-10-23 05:53:06,5,5,0,给老师发邮件他会认真回复你，就连格式都很严谨
119765,1094,张应杭,2019-11-15 13:41:50,1,2,1,真实而普通的人
121006,1094,张应杭,2020-01-19 08:33:50,1,1,0,儒雅的老师，上课会听的很认真
124596,1094,张应杭,2020-07-03 11:31:51,3,4,1,2019-2020春夏学期马原，线上。老师在期末结束给了一个阅卷的分析，很温柔，很用心，很认真，很舒服。绩点不算高也没炸，谢谢老师。
128239,1094,张应杭,2020-12-15 01:27:26,0,0,0,哈哈哈哈
129463,1094,张应杭,2021-01-06 02:24:59,5,7,2,为啥这么多水军？
129745,1094,张应杭,2021-01-12 02:54:48,4,6,2,学到了很多中国古代哲学的东西，之前一直觉得这种东西很无聊，结果被他这么一讲真的很有意思。自己也去图书馆借了冯友兰先生的《中国哲学简史》看，后来才知道冯友兰是他老师的老师。那四舍五入我也是他的学生的学生的学生了hhh。
131278,1094,张应杭,2021-01-27 02:48:12,0,7,7,体验特别好的思政课和特别温和儒雅的老师，强烈推荐。首先事情特别特别少，马原课没有小组讨论小组展示个人展示，只有一篇读书报告和期末考试，基本上卷也卷不起来吧。其次上课很有意思，认真听老师讲了不少自己的人生经验（不听也没事hh），最后改卷的时候老师特别说他今年才知道浙大绩点的折算规则，然后就给每个人都加了平均分来拉高绩点，反正我对我的最终成绩还是满意的。最后的最后，老师参与一个什么课程改革计划，马原课每周只上两节，最后一节自由答疑可以走人，提前吃饭它真的好香！
131279,1094,张应杭,2021-01-27 02:58:58,3,7,4,老师真的很好！之前虽然看查老师评论说老师事少给分也少，但一直觉得老师上课很好，即使分数差一点也值了。今天出成绩，老师在群里为我们写了长文，真的很感动，老师阅卷后虽然对我们的掌握情况不满意但还是给我们提出了理论课程的学习方法，还因为同学的建议最大程度照顾我们的绩点。感觉自己上课不够认真太对不住老师了(┯_┯)
131280,1094,张应杭,2021-01-27 03:04:02,3,7,4,老师最后发了阅卷通报，好认真，一学期没好好上老师的课，经常写作业玩手机感觉太对不起老师了。最后给我们加了平时分，而且老师的课认真听还是很不错的。推荐，事情少，而且就上两节课
131286,1094,张应杭,2021-01-27 03:26:49,-3,5,8,先生之风，山高水长。教授对待学术的求是态度、对待生活的豁达通透实在值得敬佩。作为他一学期的学生，实属幸运。
131306,1094,张应杭,2021-01-27 04:40:23,4,10,6,怎么说呢?是我太菜还是了吗？每次考勤都到，论文要求是1500－3000，我也只写了3000。我承认上课是没有认真听完过所有课，但还是听了呀，最后考试前也读了书，做了一下历年卷，考试也卷到最后基本写满了，最后成绩最低那档，有点难过，感觉付出没有得到相应的回报。呜呜呜呜
136108,1094,张应杭,2021-06-11 03:34:29,0,7,7,老师改完卷子时在群里发了份阅卷通报和自己看待成绩的态度，似乎都是老师的心里话，当时有一种没好好听课的愧疚油然而生。
141523,1094,张应杭,2021-10-13 07:28:17,8,9,1,受不了张老师的逻辑，他真的很唯物吗？
149353,1094,张应杭,2022-01-15 07:01:26,10,12,2,上课不好好讲书本知识，动不动就是大道理，怎么指望我们能学到东西？？
149566,1094,张应杭,2022-01-16 03:43:29,10,12,2,我不理解这位老师，他不应该开唯物主义的马原
149814,1094,张应杭,2022-01-17 06:13:00,6,9,3,不理人，乱讲课，乱给分，比学生走的早
154643,1094,张应杭,2022-06-02 16:12:23,0,1,1,我不否认他是个好老师\n\n但他不应该被束缚在马原的课堂\n\n他让我想到了蒋勋
154914,1094,张应杭,2022-06-07 01:49:25,-4,1,5,挺好的老师
156491,1094,张应杭,2022-06-20 03:40:26,3,3,0,关于《马原》授课的质量有点一言难尽，许多观点也难以苟同，但是老师人是非常好的，随和（慈祥？）；授课采用课改（最后一节课答疑，可以直接溜），任务量很少，总体来说非常轻松；最后考试闭卷全客观，还是看个人掌握，总体推荐
160219,1094,张应杭,2022-09-15 06:24:08,1,1,0,除了一篇课程论文之外什么都没干，甚至期末也基本没复习，提3.9，算是事少分还行\n\n\n\n至于老师的观点，看到评论这么多人都不认同我就放心了，抱着包容的心态看吧
160609,1094,张应杭,2022-09-28 02:28:59,1,7,6,我求你讲点干货照本宣科而不是在这里扯逼
160943,1094,张应杭,2022-10-20 13:17:58,3,3,0,不赞同他的学术观点，也不理解他的授课方式
163561,1094,张应杭,2023-01-11 06:05:31,6,8,2,马原\n\n优点是只用上两节，第三节就可以走了；人品也没有问题\n\n缺点是存在偏见，许多观点不敢苟同；而且给分超级烂\n\n学了二十多门课了，最低绩点居然是这门，而且比倒数第二的那一门低0.6
164950,1094,张应杭,2022-12-28 03:50:51,5,5,0,以事少见闻的老师，整个学期只有期中一篇读书报告（字数上限）和期末考试，而且三节的马原课只讲两节，剩下一节可以选择离开或者留下来讨论（与成绩不挂钩，大部分人都走了），课没怎么听过不好评价
166093,1094,张应杭,2023-01-11 05:41:05,5,5,0,无语，给分巨差，我宁可事情多一点也不要就这么点分数
166098,1094,张应杭,2023-01-11 06:20:07,-8,3,11,事情少真的很少！！没有小组没有展示，平时一篇读书报告和随机掉落的小作文。\n\n  老师讲课感觉很哲学，有时候比较有趣，有时候有感觉他红过了头成了黑。但总体而言是一个蛮好玩的人，不会多么苛刻挑刺的。\n\n  给分的话，原本看查老师上的评价感觉心很慌，但这一学期上下来感觉如果平时认真写作文+期末认真考（政治经济学真的要背呜呜呜呜），给分不会差到哪里去（俺听了fwj老师的复习课背到了最后一题，感动）
166102,1094,张应杭,2023-01-11 06:38:47,6,6,0,事情真的少，给分真的烂
166478,1094,张应杭,2023-01-12 10:46:48,11,12,1,之前一直忍住没评，今天看了阅卷通报忍不住了。平时上课水，不讲知识尽扯皮就算了。网课期间愣是推了几次课让我们看别的老师，最后阅卷通报还写了两次随堂小测，实际只有一次，您难道自己没点数吗，怕不是摘了一部分之前的阅卷通报。总结:要想学真知识，期末考高分就别选(除了想凭自学和有之前的积累的同学可以选选)
169104,1094,张应杭,2023-02-24 09:56:49,3,7,4,这种老杭大的二货怎么还在浙大祸害研究生呢
169248,1094,张应杭,2023-02-25 03:43:37,-4,0,4,表面功夫集大成者\n\n很伪善
170115,1094,张应杭,2023-03-01 11:43:47,4,7,3,上的是张老师的马原课，事很少，三节课中最后一节是讨论课，没有问题的人可以提前离场。也不点名，但是会有当堂纸质小测，内容是对一些问题的看法。至于讲课内容，可以说逻辑有些混乱且和马原关系不太大，更多的是一些形而上的观点的输出，可能张老师相比逻辑严密的马原还是更适合人生美学这样浪漫的课。最后，给分不好，不捞人，平时分只占比30%而且会像模像样地扣，建议对绩点比较在意的人别选。
170679,1094,张应杭,2023-03-08 03:24:27,0,5,5,上了第一节导论课，老师的理论实在是有点。。。很符合我对老pinky的想象😅\n\n好在事情少
170686,1094,张应杭,2023-03-08 07:05:32,5,6,1,上了两周课，引论和导论，两节老师讲，第三节讨论课也可以先走\n\n不得不说张老师讲课颇有当代复旦四大才子之风
174047,1094,张应杭,2023-06-06 02:38:24,1,3,2,事确实少\n\n态度不好，消息已读不回\n\n给分非常差（即使考虑到事少，性价比也比较低）\n\n擅长自我感动，不少观点比较偏激难以认同\n\n如果只看学分不看绩点，推荐；\n\n如果你不希望单学期三十学分的均绩被拉掉0.1+，快跑
174188,1094,张应杭,2023-06-07 07:10:31,2,3,1,今天是老师的最后一次课，是我大学期间完整听下来的一门思政课，谢谢老师
174794,1094,张应杭,2023-06-18 06:44:22,3,3,0,人生美学8次课，一次电影+小测，最后一次期末考试；每次上课只上前两节。
175760,1094,张应杭,2023-06-26 12:18:45,-3,1,4,给分烂，懒，烂烂烂
176615,1094,张应杭,2023-06-29 12:39:08,6,7,1,今年是老师退休前最后一次授课，张老师感觉是很随和的人，没有说要强硬的灌输观念给你，会紧跟时事分析一波，氛围还是轻松的；上课事情少，我记得平时作业只有2次当堂300字小作文顺带点名，小作文多想点个人思考，也不用卷发言抢平时分，每周就一次课第三节课可以走人，负担很轻了；至于给分，老师考前俩周还问我们期末占比50%会不会太高了大家可以多提意见，而且期末就是背背知识点，5章PPT的内容相较其他一些专业课量真的很少很少了，高中有点基础更是很好拿分的（我考前只看了2小时学长整理的提纲）
180438,1094,张应杭,2023-09-21 15:21:39,2,2,0,马原事情真的很少，一次随堂作业+一个期中论文，期末考试好好考给分就挺好
184414,1094,张应杭,2023-12-19 06:54:23,-8,4,12,真的很受不了所有观点都特别爹，看不起一切，尤其物化女性歧视女性，每次都是讲什么女生整形女生减肥女生冬天露大腿女生为情自杀女生攀附导师……呕，真的被骗进来选这个课
187645,1094,张应杭,2024-01-17 03:01:23,7,7,0,三节课的马原课程改革只要上两节，平时事情真的真的少，给分出乎意料的好
196168,1094,张应杭,2024-07-02 03:02:27,2,3,1,给分一般，也有可能是我实在不愿意背魔改的马克思。。。。。\n\n但老师的学术水平和道德不敢恭维，完全是国家的喇叭，强行融合民族主义和马\n\n学校不要再让搞所谓“中国哲学”的来讲马了，能让这种水平的老师站在讲台是学校的耻辱\n\n唯一让我记住的就是“退休金每月有两万”。。。。。\n\n既无学术，也不事生产，凭什么？？？
199002,1094,张应杭,2024-09-14 02:06:36,-1,0,1,人生美学课，虽然和我一开始预想的内容不太一样，但是学习和比较儒释道的基本观点，还是很有意思的一件事情。考试和小测都简单的，小测就当作点名。给分还行，毕竟研究生也不看绩点了。唯一介怀的就是写了很久很认真的一个作业讨论，发给老师之后没有回复我了。也可能老师太忙或者我自己写得不太好吧。感觉在老师身上能够感受到一点老杭大文科人的风骨，至于对于唯物的理解，我觉得课上的内容也就是一个参考，一家之言，没有必要上升到老师本身不行。
219728,1094,张应杭,2025-06-05 02:14:28,0,0,0,讲述了很多人生大道理
219841,1094,张应杭,2025-06-08 12:53:16,0,1,1,一边吹华为阿里科技发展，一边说中国重道不重器，所以把自己女儿送到意大利学艺术设计。还是在全校的党课上说这些呢。既得利益者老登真是高调。多少被压榨的劳动者的血泪造就的科技成果，在你嘴里就是大企业牛b，我看你也不懂最基本的马克思主义原理吧。中国各大美术学院的实力你看不上吗？不喜欢吗？
417,1112,吴旭平,2018-09-18 10:57:46,283,328,45,难得有把哲学讲的这么好的老师，有趣而又思考，上课与学生们互动很多，最后尽可能的给学生更高的分数
1371,1112,吴旭平,2015-03-22 01:18:27,169,176,7,幽默风趣，但同时见解深刻，让人把马原课也能三节课认真听完。给分也超赞，业界良心好老师。
1455,1112,吴旭平,2019-05-30 05:05:19,77,85,8,马原好老师不解释
1704,1112,吴旭平,2017-07-18 04:58:54,31,37,6,有趣 第三节课辩论
1777,1112,吴旭平,2015-03-24 11:44:07,64,68,4,男神
1910,1112,吴旭平,2015-03-26 06:32:09,49,52,3,简直感动 好老师\n\n
1946,1112,吴旭平,2015-03-26 15:32:16,21,25,4,男神！
1976,1112,吴旭平,2015-03-27 12:14:59,13,16,3,有意思的哲学
2375,1112,吴旭平,2015-04-27 15:55:58,29,35,6,讲得特别好，听课就是一种享受～
2378,1112,吴旭平,2015-04-27 16:54:35,50,58,8,上过他的课的人都知道、真是个难得的一名老师！！必须赞 ！
2386,1112,吴旭平,2015-04-28 04:15:37,28,29,1,马原好老师！赞
3430,1112,吴旭平,2015-07-08 16:44:32,17,18,1,两个字，男神！
3659,1112,吴旭平,2015-06-17 02:04:42,8,12,4,超级赞！很可爱的老师，非常注重与学生的互动，关心学生
3736,1112,吴旭平,2015-06-17 02:52:00,18,18,0,好好好
4224,1112,吴旭平,2015-06-18 07:03:16,12,13,1,上课很有趣!
4339,1112,吴旭平,2015-06-19 06:51:23,22,25,3,点名点了一两次，听课真的是一种享受啊！老师很可爱，棒棒的！
4565,1112,吴旭平,2015-06-24 12:14:28,12,18,6,超级好的老师，作为理科生也会认真听哲学了，下学期不开马原了好可惜
4963,1112,吴旭平,2015-07-01 15:33:23,30,34,4,吴老师上课很有趣，辩(si)论(bi)的形式也很棒，总之马原课也很有意思了
5347,1112,吴旭平,2015-07-07 01:33:26,13,16,3,挺好的
5384,1112,吴旭平,2017-12-25 14:20:34,10,12,2,好老师
5434,1112,吴旭平,2015-07-07 12:18:52,134,141,7,高能段子手+有意思几乎不靠党性的哲学课+引发思考
5605,1112,吴旭平,2015-07-08 15:38:21,35,36,1,风趣幽默，不枯燥，辩论形式有趣，人超好，给分也棒，大爱！（而且长得也帅hhhhhhhh）
5619,1112,吴旭平,2015-07-08 16:40:51,6,10,4,太赞
5763,1112,吴旭平,2015-07-09 08:50:55,6,9,3,简直不能太棒
5823,1112,吴旭平,2015-07-09 14:09:05,90,96,6,老师当年可是追到班花啊。\n\n
6023,1112,吴旭平,2015-07-10 09:30:23,7,10,3,帅！
6188,1112,吴旭平,2015-07-11 16:35:23,9,10,1,棒\n\n
6732,1112,吴旭平,2015-07-20 07:25:41,18,21,3,喜欢辩论这种形式，无论对考试还是培养哲学思维帮助都太大了，老师很棒
7440,1112,吴旭平,2015-09-14 11:27:49,15,17,2,高能段子手233选马原见到他就别犹豫了\n\n
7638,1112,吴旭平,2015-09-15 07:02:01,7,9,2,讲课以启发为主，鼓励学生自主思考，课堂互动很多，辩论也让人感受到自身思维的不足，很好的马原老师
8046,1112,吴旭平,2015-09-16 17:38:25,5,7,2,太感动了
8924,1112,吴旭平,2015-10-01 07:13:13,10,12,2,有一定的佛学修养
10579,1112,吴旭平,2015-11-20 06:20:23,49,51,2,非常有趣的老师 讲课深入浅出 极其幽默 头像是圣斗士星矢，课前放万合天宜和火影，还有哲理小短片。\n\n不展示，辩论，特别好玩！\n\n讲课很棒！三观端正！\n\n给分好!
10889,1112,吴旭平,2015-11-23 08:15:51,6,7,1,超级赞，讲的深入浅出，内容丰富
10963,1112,吴旭平,2015-11-23 13:35:04,8,9,1,马原得高分出乎意料/猫汤还是有点震撼/老师像老友
13585,1112,吴旭平,2015-12-29 14:54:49,11,11,0,好难过老师出国了，马原最赞老师不解释
15280,1112,吴旭平,2016-01-13 08:39:27,1,4,3,老师幽默风趣又可爱，而且给分高。\n\n
15492,1112,吴旭平,2016-01-14 21:30:38,-1,2,3,幽默风趣。思想和灵魂都得到洗礼
18957,1112,吴旭平,2016-01-23 00:34:25,5,8,3,马原最好老师不解释，讲课好，给分超级好，可惜这学期出国了没有开课，男神！
19415,1112,吴旭平,2016-01-24 06:50:57,6,9,3,马原课非正常打开方式 每次上课都不想开小差 不想水手机 老师用非常明白通俗的方式传达系统性的哲学知识 实在是太难得的课题体验
20194,1112,吴旭平,2016-01-26 14:15:07,-1,2,3,好老师6
21705,1112,吴旭平,2016-03-01 00:40:05,0,2,2,特别好
22860,1112,吴旭平,2016-03-13 16:03:38,2,3,1,目前听过最好的课
25495,1112,吴旭平,2017-01-18 13:02:20,8,12,4,老师把深刻的道理用最简单的语言表达出来，触类旁通，水群时也可以坐而论道，有很多经典语录，没有水平可以么？不像有些课就是玩概念游戏。那些上课玩手机不好好听的一提问当然尴尬了，典型以怨报德。点名一两次～～
25500,1112,吴旭平,2016-05-23 14:28:00,-2,2,4,很好的哲学老师
26268,1112,吴旭平,2016-06-16 12:43:18,-3,1,4,超棒的老师
33632,1112,吴旭平,2016-09-20 12:50:13,0,2,2,超级棒！
33894,1112,吴旭平,2016-09-22 11:08:18,1,4,3,真心赞 大学课堂能遇到这样的老师也是一种荣幸啊！！
34111,1112,吴旭平,2017-01-18 03:01:19,3,10,7,云何降伏其心，谁知道答案啊，在线等……
34222,1112,吴旭平,2017-01-17 13:28:09,14,14,0,老师很好的，选吧选吧不会后悔的
34290,1112,吴旭平,2016-09-30 02:16:41,8,9,1,男神老师 想嫁 他去年交流一年说有人等着他回来上课 我要是知道他 我也愿意等他一年
38277,1112,吴旭平,2017-01-15 10:54:38,-14,4,18,好老师！但是我记得是点了三次名的，难道不同班级点名次数还不一样吗23333
38479,1112,吴旭平,2016-12-06 15:34:20,1,2,1,老司机?
38702,1112,吴旭平,2016-12-15 05:49:57,-1,0,1,老师特好\n\n
38744,1112,吴旭平,2016-12-16 08:36:09,4,4,0,业界良心~\(≧▽≦)/~
38937,1112,吴旭平,2017-01-15 15:43:31,1,2,1,老师超级好
39798,1112,吴旭平,2017-01-10 13:38:22,2,3,1,好老师，有意义
40199,1112,吴旭平,2016-12-30 02:16:42,-1,1,2,贼好的！！
40259,1112,吴旭平,2016-12-31 03:37:29,3,3,0,难懂的哲学问题经他讲解后，非常清晰易懂，有学问又挺有趣
40602,1112,吴旭平,2017-02-18 10:10:02,24,31,7,快选这老师，快选，快选~
40885,1112,吴旭平,2017-01-06 05:16:03,23,26,3,在共产主义旗帜下把车开的6到飞起，除了不太会写字以外优秀到没朋友
40887,1112,吴旭平,2017-01-06 05:24:22,2,2,0,特别棒
42825,1112,吴旭平,2017-01-15 08:44:36,0,2,2,男神！！！！！！！人格魅力
42860,1112,吴旭平,2017-01-15 09:59:15,18,20,2,男神男神男神男神男神男神男神。\n\n点了一次名一篇期中论文一次小组辩论一次讨论课。\n\n每次上课都飙车。人超好呀！
43801,1112,吴旭平,2017-01-17 12:25:53,12,16,4,哇老师上课是真的有趣，给分也良心，还会飚车。。从没见过这么有意思的思政课老师，可惜老师不开其他本科生的课程，专注给研究生开车，嗨呀好气。\n\n
43805,1112,吴旭平,2017-01-17 03:47:54,-1,2,3,非常好，老师讲的好，给分好，推荐\n\n
43807,1112,吴旭平,2017-01-17 08:26:44,0,2,2,男神！男神！
43814,1112,吴旭平,2017-01-17 03:55:06,15,17,2,讲课自成风格\n\n一言不合开车\n\n浙大第一才子\n\n人好课好分好(*˘︶˘*).。.:*♡\n\n
43815,1112,吴旭平,2017-01-17 03:57:44,4,6,2,无敌男神，给分超好，上课有趣，人品又好，又可爱～
43821,1112,吴旭平,2017-01-17 04:26:19,0,3,3,真正意义上大学的课\n\n
44026,1112,吴旭平,2017-01-17 08:22:18,14,17,3,想嫁！！！ 要是早生几年就好了呜呜呜
44051,1112,吴旭平,2017-01-17 08:45:07,1,4,3,作为一门思政课，不照本宣科，有干货还能水得开心真是不易，给老师点赞！
44089,1112,吴旭平,2017-01-17 09:09:08,4,6,2,好老师！！想娶！！男神老师等我两年！！
44090,1112,吴旭平,2017-01-17 09:10:22,14,15,1,满分无误。思政课救星，飙车飙的很凶，很爽。
44094,1112,吴旭平,2017-01-17 09:12:35,10,11,1,思政课里难得好老师，有干货，又有趣，关键是浓浓师生情，大赞
44109,1112,吴旭平,2017-01-17 09:32:36,-2,0,2,好好好的很
44115,1112,吴旭平,2017-01-17 09:42:36,2,4,2,上课幽默风趣，不局限于一些意识形态。期末会划重点。要是老师再开一门毛概多好
44127,1112,吴旭平,2017-01-17 09:52:21,18,20,2,评分竟然没到10分？
44147,1112,吴旭平,2017-01-17 10:44:39,1,2,1,思政课只服吴旭平
44201,1112,吴旭平,2017-01-17 11:55:23,3,5,2,必须满分！极好的老师！能把哲学课讲的那么有趣的难得！！而且给分好！！男神！
44203,1112,吴旭平,2017-01-17 11:56:17,0,2,2,超级有趣的老师 人也超级好der！
44204,1112,吴旭平,2017-01-17 11:56:18,-2,2,4,简直棒到不行，上课炒鸡有趣，给分炒鸡高
44207,1112,吴旭平,2017-01-17 11:57:11,-2,1,3,上马原课是一种享受，段子手吴男神。
44208,1112,吴旭平,2017-01-17 11:57:17,3,4,1,感谢老师的辛苦工作\n\n
44209,1112,吴旭平,2017-01-17 11:57:21,-1,1,2,我爱吴男神！
44211,1112,吴旭平,2017-01-17 11:57:51,1,3,2,超级萌
44212,1112,吴旭平,2017-01-17 11:57:57,1,3,2,老司机，大家快上车吧
44214,1112,吴旭平,2017-01-17 11:59:14,2,3,1,好老师，没什么理由，就是好
44215,1112,吴旭平,2017-01-17 11:59:25,107,124,17,吴男神课讲的真的超级好！给分真的超级好！秀和班花的恩爱真的技术一流！车开的一级棒！充满哲学气息的浙大顶尖段子手。老师，我想gay你！\n\nps.哪位大佬知道老师空间“云何降伏其心”答案是啥？！！！在线等急！！
44216,1112,吴旭平,2017-01-17 12:02:55,49,50,1,先说良心话，自己真不是一个平时爱发言，也不会对刷分有什么想法，自己也就是朴朴实实地完成每一项内容，期末两天的攻坚完成了马原的考试。老师的给分让自己很感动，觉得攻坚有了效果，也很惭愧，觉得平时上课写作业也好，水手机也好，挺以怨报德的。说了这么多，再评价下老师，觉得是马原课的一股清流(讲起段子来是泥石流)，真心感谢老师这一年的陪伴，新年快乐。
44217,1112,吴旭平,2017-01-17 12:02:58,2,4,2,真·男神 讲课水平 人格魅力 给分情况 每一项都完美，选他没错
44220,1112,吴旭平,2017-01-17 12:04:22,-1,3,4,哈哈哈哈实力段子手啊，给好好好，感动
44228,1112,吴旭平,2017-01-17 12:15:13,0,3,3,上课生动有趣
44237,1112,吴旭平,2017-01-17 12:45:42,0,2,2,吴男神又帅给分又好！！老师我爱你！！
44239,1112,吴旭平,2017-01-17 12:46:20,-2,2,4,非常棒   男神！！
44243,1112,吴旭平,2017-01-17 12:54:51,4,5,1,只想说浙大最好的老师没有之一，能上他的课真是幸运
44246,1112,吴旭平,2017-01-17 13:00:39,-1,2,3,只恨不能给100分！
44255,1112,吴旭平,2017-01-17 13:16:14,0,3,3,把马原课上的如此的有趣真的是很需要幽默感和水平的~男神棒
44256,1112,吴旭平,2017-01-17 13:18:19,1,3,2,老师超级男神，给分很好，第一次能听下去马原这种红专课，hhh上课偶尔开车，有时车速太快hhh…
44265,1112,吴旭平,2017-01-17 13:29:00,0,2,2,从此只爱吴老师
44267,1112,吴旭平,2017-01-17 13:46:38,9,12,3,老师人很好 车速很快
44273,1112,吴旭平,2017-01-17 13:52:56,16,20,4,大家看下面的评论就大概已经知道老师是怎么样的了吧!不论从功利的角度还是学知识的角度来说，老师真的都很棒，平时不上课的时候也会在群里和同学们讨论哲学问题。选课的时候吴老师包揽了一半的马原学生哈哈哈哈所以有机会选上有机会选上他的课真的是运气很好了。最后也暗落落的说一声平时上课都没好好听实在挺不好意思的，希望之后有机会上老师课的同学可以多参与一下课堂啦!
44279,1112,吴旭平,2017-01-17 14:05:46,9,11,2,很逗的东北老师，喜欢开车，上他的课很轻松，平时课程压力不大，是首选的马原老师。大爱吴司机！
44288,1112,吴旭平,2017-01-17 14:17:22,38,45,7,有一种无奈叫不能打11分
44296,1112,吴旭平,2017-01-17 14:27:20,9,14,5,长得帅(男神之名不虚)，情商高，给分好，作业有趣，第三节课辩论充满了哲学的思辨性。人格魅力爆棚(据说娶到了班花)。缺点？画画比较抽象算吗？hhh
44297,1112,吴旭平,2017-01-17 14:30:59,2,4,2,敲敲敲极棒的老师～\n\n
44307,1112,吴旭平,2017-01-17 14:56:32,1,3,2,好喜欢男神～
44315,1112,吴旭平,2017-01-17 15:05:08,-1,2,3,真的是好老师，讲段子，上他马原课是哲学思想的启迪。
44340,1112,吴旭平,2017-01-17 15:44:52,2,4,2,老师给分好，讲课棒！强烈推荐！
44395,1112,吴旭平,2017-01-17 17:31:02,-1,2,3,良心思政课
44400,1112,吴旭平,2017-01-17 19:54:49,0,3,3,给分好，风趣幽默，不是为所谓的马原而上课，真正的哲学大师。
44422,1112,吴旭平,2017-01-17 23:24:10,89,96,7,听吴司机讲课是一种享受。\n\n专业开车一百年，于平淡中见大智慧。吴司机是真正把哲学学懂并且用于指导行为的。对学生是最低要求，对自己是最高要求。\n\n偶尔与吴司机讨论一些问题，可以看出司机是真正把学生和学生的意见放在平等的地位。\n\n虽然没上过其他老师马原课，不过我相信，吴司机是最好的马原老师，没有之一。\n\n\n\nPs：第一次学习帝评价老师，献给吴司机。
44465,1112,吴旭平,2017-01-18 00:46:55,3,5,2,虽然最后分数不高，但是老师人真的超级好，课真的超级棒！
44477,1112,吴旭平,2017-01-18 01:00:03,22,24,2,我不管，老师给我满绩，我就要给老师满分，
44533,1112,吴旭平,2017-01-18 02:33:05,23,23,0,能选上老师简直花光所有欧气
44608,1112,吴旭平,2017-01-20 01:33:41,-35,17,52,讲道理 上课一般 没什么厉害的特色 除了开车总是会让全班蜜汁尴尬 也不是什么“浙大最好的哲学课”  给分是不错 因此才获得男神称号吧
44809,1112,吴旭平,2017-01-18 09:29:28,15,17,2,男神！老司机！想知道云何降伏其心答案！想看班花师娘！
44827,1112,吴旭平,2017-01-18 10:10:53,6,7,1,吴老师上课有趣给分又好不能更男神了好不好！上课随时随地开车防不胜防哈哈哈哈，真心推荐啊！能选上他的课你偷着乐去吧！选上是你这学期最幸运的一件事了，你还过来查他？
45191,1112,吴旭平,2017-01-19 06:26:37,1,3,2,男神不解释
45340,1112,吴旭平,2017-01-19 11:37:59,1,3,2,好老师，选他的课没错的
45380,1112,吴旭平,2017-01-19 13:28:56,3,4,1,老师就是天使！\n\n
45627,1112,吴旭平,2017-01-20 01:21:45,-4,1,5,四个字：男神，优秀
45633,1112,吴旭平,2017-01-20 01:32:44,1,3,2,百年难得一遇的好老师！上过他的课是一笔宝贵的人生财富！
46659,1112,吴旭平,2017-01-22 05:39:37,5,8,3,真的超级好的老师。因为性格缘故，不喜欢发言，但是通过认真写论文和查找资料也能取得不错的平时成绩。觉得老师照顾到了每一种学生。其实现在有些后悔当初没有认真听老师的课。
47031,1112,吴旭平,2017-01-23 10:00:05,-1,2,3,老师真男神。把枯燥的哲学课上得很有趣，辩论的形式也很有意思，给分超棒！群里氛围很好！好想再上一次老师的马原！男神爱你，笔芯~
47485,1112,吴旭平,2017-01-28 00:00:06,-1,4,5,除夕一连发了六七个一百块的红包
47607,1112,吴旭平,2017-02-07 05:58:06,4,7,3,男神...男神...果然我的哲学不行，白跟您混了半年，我的绩点~(>_<)~
48362,1112,吴旭平,2017-03-02 10:33:48,2,5,3,赞我 给你们班花照片 老师给过我
49128,1112,吴旭平,2017-06-29 10:53:26,7,12,5,男神上课超级有趣啊，最后还会给我们高分，真的棒，理科生也认真听马原了呢~~~绝对10分啊
49944,1112,吴旭平,2017-04-27 11:13:17,1,4,3,666
50245,1112,吴旭平,2017-05-02 02:49:38,-27,9,36,没感受到这老师棒在哪，或许需要和别的马原老师比较，反正他的低速车让我感到很尬很无聊。
50930,1112,吴旭平,2017-05-09 09:24:18,2,3,1,男神\n\n
51575,1112,吴旭平,2017-06-07 08:46:45,0,1,1,好课快选
53673,1112,吴旭平,2017-06-29 10:02:45,-2,2,4,男神不要走
54176,1112,吴旭平,2017-06-28 15:21:18,4,6,2,虽然我可能要挂科了，ahhhh，也给老师满分
54413,1112,吴旭平,2017-06-29 09:43:07,2,4,2,吴老师是真的好，和蔼可亲，关心同学，给分更是没话说，上课有意思，马原强推，绝对男神
54417,1112,吴旭平,2017-06-29 09:50:40,5,10,5,大写的男神，为了我们的绩点操碎了心。答主现已加入排队生猴子队列。
54421,1112,吴旭平,2017-06-29 09:57:30,6,10,4,为老师疯狂打call
54422,1112,吴旭平,2017-06-29 09:59:05,11,13,2,为我们的绩点操碎了心
54424,1112,吴旭平,2017-06-29 10:01:10,0,2,2,超级好
54426,1112,吴旭平,2017-06-29 10:01:31,2,3,1,求男神正面上~
54427,1112,吴旭平,2017-06-29 10:01:48,-3,1,4,真的超男神啊啊啊啊啊啊！辩论的确是一种能够调动学习马原积极性的方式啊:)超赞的~给分也超级赞！
54428,1112,吴旭平,2017-06-29 10:01:53,6,10,4,老师真的超赞啊（虽然我平时都忙着做自己的事情）但是老师真的很有个人魅力，和那些衣冠楚楚很有排面的所谓名师站在一起，能压他们好多…给分真的很好，像我这种临时抱佛脚也就只在考前刷了两百道选择题的人，卷面分出乎意料不难看？可以说是很感谢老师了。
54431,1112,吴旭平,2017-06-29 10:02:28,0,2,2,老师很好很好很好！上课很有趣，而且也尽量给同学比较高的分数！真的超级棒～
54435,1112,吴旭平,2017-06-29 10:13:09,-2,2,4,男神！上课非常启发同学思考，平时分给的很高，还有浓浓师生情?
54436,1112,吴旭平,2017-06-29 10:05:06,3,5,2,老师超可爱！上课天天听段子！期末复习的时候为我们的绩点操碎了心，最后分也很好。满分男神了！
54437,1112,吴旭平,2017-06-29 10:05:24,3,7,4,拯救我绩点的一定是师生恋hhh男神是我的不许跟我抢ｸﾞｯ!(๑•̀ㅂ•́)و✧
54440,1112,吴旭平,2017-06-29 10:10:15,-1,2,3,老师真的是很认真的在讲马哲，上课感觉超好的。期末自觉认真回忆师生情的老师也是没谁了?。10分，必须10分
54442,1112,吴旭平,2017-06-29 10:11:30,5,8,3,除了画画太有魔性之外大概是挑不出别的毛病了_(:з」∠)_
54444,1112,吴旭平,2017-06-29 10:13:58,3,4,1,老师上课超好玩！超有趣的一个老师。虽然马原听不懂，但是有吴老师在，每节课都认真听讲了呢！超级棒！推荐选这个老师！
54456,1112,吴旭平,2017-06-29 10:30:19,0,3,3,太有趣的老师！太喜欢了！给分无敌好了
54462,1112,吴旭平,2017-06-29 10:46:17,1,4,3,超级好的老师，上课有意思，给分好
54463,1112,吴旭平,2017-06-29 10:47:46,-1,2,3,不解释，好老师
54466,1112,吴旭平,2017-06-29 10:52:45,1,3,2,我这种上课只知道水手机的人，都一直被吸引到听课，关键给分超级好，赞赞赞，男神绝对
54467,1112,吴旭平,2017-06-29 10:53:22,1,4,3,男神老师上课十分风趣，给分超棒。很有童心但又能够把哲学的东西深入浅出
54470,1112,吴旭平,2017-06-29 10:56:01,1,3,2,很棒，上课有意思，给分也很好
54472,1112,吴旭平,2017-06-29 11:00:27,2,6,4,一学期没听讲，考试之前没刷过一道题，高中三年没学过政治，三本推荐书目和教材都没看。最后4.2。。。。真心好老师，虽然我没怎么听，但是他开的车我都跟上了。。。强推。。。
54476,1112,吴旭平,2017-06-29 11:04:30,-1,3,4,给分又好，讲课又棒。这样的老师哪里去找啊【敲黑板】摸摸你们的良心，能不给十分嘛？浙大第一男神啊！！
54477,1112,吴旭平,2017-06-29 11:04:48,0,3,3,段子手 老司机 男神男神男神  把哲学讲的很好很好很好  第一次评分献给男神！
54482,1112,吴旭平,2017-06-29 11:13:36,14,17,3,出分前给我们来一发高分喷雾，男神不解释
54488,1112,吴旭平,2017-06-29 13:03:25,2,5,3,各种开车
54491,1112,吴旭平,2017-06-29 11:38:54,2,5,3,讲课好给分好，感谢男神
54492,1112,吴旭平,2017-06-29 11:39:50,3,6,3,讲课讲得好就不说了，给分还这么好！！
54498,1112,吴旭平,2017-06-29 11:59:24,11,13,2,始于颜值，忠于人品，陷于才华。
54500,1112,吴旭平,2017-06-29 12:06:52,0,3,3,真心好老师，不想结课
54519,1112,吴旭平,2017-06-29 13:08:41,0,2,2,我浙大男神 专业老司机
54545,1112,吴旭平,2017-06-29 14:59:31,-18,6,24,上课一般
54656,1112,吴旭平,2017-06-30 03:26:33,-2,2,4,很棒，完全不枯燥，生动有趣，高能段子手，老师很厉害的，喜欢和学生互动
54672,1112,吴旭平,2017-06-30 03:55:32,4,5,1,老师讲课真的生动，而且课后与大家交流也很多，考前线上答疑，给分又那么好，强烈推荐！
54712,1112,吴旭平,2017-06-30 05:29:34,1,4,3,大爱！
54737,1112,吴旭平,2017-06-30 06:20:21,3,6,3,虽然成绩不好，也要狂赞我男神
55002,1112,吴旭平,2017-06-30 15:28:34,4,4,0,男神不解释
55090,1112,吴旭平,2017-06-30 23:46:41,5,6,1,超级棒的老师！
57574,1112,吴旭平,2017-07-10 03:12:46,1,2,1,老师讲课很有趣！给分也超好 男神
60838,1112,吴旭平,2017-10-31 04:24:46,0,3,3,我要下车！这不是去阳光幼儿园的车！
62586,1112,吴旭平,2017-11-26 04:56:59,-1,3,4,在浙大一年里碰到最喜欢的人社科老师，觉得是一位有思想，上课可以深入浅出，超级棒的老师 喜欢喜欢
63891,1112,吴旭平,2017-12-18 16:03:59,2,5,3,完美的老师，睿智的智者
64452,1112,吴旭平,2017-12-24 04:38:33,1,2,1,听了快一个学期的课，舍不得结束
65111,1112,吴旭平,2017-12-29 02:19:52,1,3,2,老师真的太好啦！！
65749,1112,吴旭平,2018-01-09 03:06:08,2,3,1,炒鸡棒！
65793,1112,吴旭平,2018-01-09 06:58:32,4,7,3,真的很感谢zju教务系统给我预置的三位老师 思修的潘老师 史纲的甘老师 和马原的吴老师 真的很感谢能让我相信哪怕是思政类的课 也会能遇到这么好的老师 能让我看到思考的力量 能让我切身体会到一名大学老师所能包含的全部 真的是太棒啦！
65869,1112,吴旭平,2018-01-09 16:34:15,24,27,3,上完男神的课，我特别想嫁给他。有种遗憾叫君生我未生，我生君已老。我只能说男神是完美的理想型了。幽默风趣，博闻强识。男神一个笑，我都可以陶醉一天。马原还没考试，但我给老师满分！我的心都被俘获了！男神，爱您❤️
66445,1112,吴旭平,2018-01-16 13:22:37,10,12,2,强烈要求老师开一门恋爱技巧教学
66631,1112,吴旭平,2018-01-17 16:27:51,5,6,1,人生导师
67268,1112,吴旭平,2018-01-20 14:35:23,5,5,0,男神不解释
67314,1112,吴旭平,2018-01-20 16:49:45,3,4,1,最好的马原老师
67499,1112,吴旭平,2018-01-21 10:54:09,0,3,3,就两个字，牛批
67503,1112,吴旭平,2018-01-21 11:03:03,3,5,2,课堂非常有趣，互动性很强!给分超级超级友善!
67505,1112,吴旭平,2018-01-21 11:03:45,2,4,2,男神不解释！！！！
67508,1112,吴旭平,2018-01-21 11:07:51,8,8,0,出分后第一时间答一波，所有的赞美都名符其实，老师真的很好很好，不选后悔
67518,1112,吴旭平,2018-01-21 11:41:40,4,6,2,优秀的吴司机??????
67535,1112,吴旭平,2018-01-21 12:59:05,6,6,0,男神！由衷地后悔没有好好听...
67541,1112,吴旭平,2018-01-21 13:11:46,3,5,2,我要给20分！！！
67542,1112,吴旭平,2018-01-21 13:14:11,8,8,0,吴老师的气质从第一节开始一直惊叹到出分，太爱了。
67548,1112,吴旭平,2018-01-21 13:22:31,3,5,2,吴老师我男神～表白吴男神！
67550,1112,吴旭平,2018-01-21 13:28:17,12,13,1,听老师的课是一种享受！我一个理科生高中最烦政治课，听老师马原开始慢慢的对马克思主义感兴趣了，完全不靠党性引导，就是以理服人！跟老师谈谈问题的时候，真的感觉老师学富五车，作为男生非常崇拜老师！ps:最后给分真的贼好贼好
67552,1112,吴旭平,2018-01-21 13:32:06,4,6,2,老师非常棒，上课有趣，平常事不算多，平时踊跃发言期末甚至能免去论文，最后给分也非常好。老师是真的能把马原的相关的东西讲透的，既有客观的关于普遍哲学的教育，又有深刻而生动的辩证唯物主义、历史唯物主义、政治经济学的内容。在老师课上真的能学到很多东西
67571,1112,吴旭平,2018-01-21 14:04:49,2,6,4,满分不解释，我何德何能拿这么高的分数(●—●)
67574,1112,吴旭平,2018-01-24 06:36:47,7,9,2,人帅课好给分棒
67607,1112,吴旭平,2018-01-22 00:04:02,4,5,1,超可爱的一个老师，讲课很生动，本来不喜欢马原的，但是上了吴老师的课之后能静下心来思考，感觉学到东西不少。期末给分超好，浓浓的师生情。真·马原男神！
67611,1112,吴旭平,2018-01-22 01:04:41,8,9,1,幸好一直坐前排不然绝对后悔 \n\n
67709,1112,吴旭平,2018-01-22 05:37:33,7,7,0,膜拜，人生导师
67843,1112,吴旭平,2018-01-22 08:12:27,2,3,1,男神老师不解释！
68298,1112,吴旭平,2018-01-23 02:50:18,-2,1,3,贼好了，讲课有趣，给分又好。
68945,1112,吴旭平,2018-01-24 06:53:06,3,5,2,吴老师的好。。。就不用多说了吧
69910,1112,吴旭平,2018-01-26 02:00:39,0,3,3,很棒，给分很好
71026,1112,吴旭平,2018-01-28 01:57:25,5,6,1,论文分满所以平时分满，我一个工科生最后4.8，谢谢男神
73543,1112,吴旭平,2018-02-02 02:36:59,1,3,2,好老师，难得连着三节课都能不水手机
73804,1112,吴旭平,2018-02-03 06:19:16,4,5,1,老师很民主，点不点名公投决定，发言够多不用写论文。事少分多课程有趣，能学到不少哲学入门知识…人也超可爱～能一本正经讲道理然后突然放飞自我^u^
78341,1112,吴旭平,2018-05-11 03:31:42,4,5,1,全程高能
80043,1112,吴旭平,2018-06-19 07:22:59,11,12,1,他说：“马克思主义应该增加他的理论包容度，如果一个思想理论足够强大，它不需要通过官方意识形态的形式来进行灌输从而形成对其他思想一致对外的状况，一个理论要根据自身的正确性和自身的深刻去说服人，而不是通过政治手段。”
80109,1112,吴旭平,2018-06-20 05:11:55,7,7,0,吴老是一位真正教我们哲♂学的老师
80519,1112,吴旭平,2018-07-07 10:27:44,32,34,2,万人血书恳求老师开课讲毛概
81061,1112,吴旭平,2018-07-03 13:36:11,-1,1,2,超级有趣的老师，上课很生动，可以学到很多东西\n\n
81080,1112,吴旭平,2018-07-03 15:40:25,0,2,2,陈独秀都没他秀
81502,1112,吴旭平,2018-07-07 11:43:51,-30,9,39,被吹的太神了，上了一学期被恶心到了
81544,1112,吴旭平,2018-07-05 10:41:41,2,3,1,是我见过最好的马原老师，课讲得很有深度
82176,1112,吴旭平,2018-07-07 10:32:22,2,3,1,不多说了，真的是好老师
82177,1112,吴旭平,2018-07-07 10:34:20,3,5,2,我从来没想过一个学期里我最喜欢的课会是马原课，也从来没想到过会有用思政课来拉分的一天！男神永远是你男神！
82178,1112,吴旭平,2018-07-07 10:34:33,-14,4,18,给分差
82179,1112,吴旭平,2018-07-07 10:35:56,1,2,1,非常棒
82184,1112,吴旭平,2018-07-07 10:44:53,1,3,2,最有趣的马原课！
82185,1112,吴旭平,2018-07-07 10:45:21,-1,2,3,绩点太棒了耶！！！男神！！！
82186,1112,吴旭平,2018-07-07 10:49:41,1,3,2,幽默风趣
82189,1112,吴旭平,2018-07-07 10:53:03,3,3,0,本学期唯一没翘过的不点名的课（虽然最后一节课点了次名）上课困意都没了，太有意思了，而且给分高！给分高！！给分很高！！！！！
82190,1112,吴旭平,2018-07-07 10:53:33,1,3,2,真心的好老师，
82192,1112,吴旭平,2018-07-07 10:55:05,4,6,2,老师讲课幽默有趣，并且“普渡众生”，给分很好，今年全班没有挂的～是很好的老师～
82193,1112,吴旭平,2018-07-07 10:57:38,5,6,1,能听吴老师的课是一种福气。现在很努力的想挑点毛病，可我失败了。
82194,1112,吴旭平,2018-07-07 10:59:19,2,3,1,超级棒的一个老师！很幽默！
82195,1112,吴旭平,2018-07-07 11:01:28,3,6,3,既然你能选上吴老师的课，那就务必好好珍惜啊！不认真听是一种损失！
82196,1112,吴旭平,2018-07-07 11:05:03,4,4,0,乌拉圭都回家了，就算马原满绩又能怎样？更何况我还没满……唉！
82209,1112,吴旭平,2018-07-07 11:54:54,2,5,3,老师不仅是把哲学思想融入课堂，上课很有趣。而且给分超级好……到目前为止最有意思的课非马原莫属
82213,1112,吴旭平,2018-07-07 12:23:13,3,4,1,幽默风趣，还能把知识讲透彻
82222,1112,吴旭平,2018-07-07 13:07:31,-1,1,2,上课很轻松，任务也不重
82224,1112,吴旭平,2018-07-07 13:23:27,12,13,1,来浙大两年遇到的形形色色各式各样的老师，好的也有，差的也数不清。但是，吴老师可以说是最好的老师没有之一。思想、水平、为人和给分，全浙大我觉得难找出第二个这种优质老师，简直男神没话说。
82246,1112,吴旭平,2018-07-07 14:42:26,2,3,1,怎么会有老师这么好的人啊啊啊啊啊啊\n\n课讲得好\n\n人长得帅\n\n给分好\n\n课上的真的很好\n\n结课的时候真的舍不得啊啊啊啊啊啊\n\n给男神膝盖
82259,1112,吴旭平,2018-07-07 15:05:38,0,5,5,呜呜~为什么评分掉了，之前还9.97的。吴老师必须满分啊，讲课很棒，事情又少，给分又好（反正我满了，嘻嘻~），夫复何求!来浙大一年了，吴老师，国懿爸爸，还有我的专业课老师都是我遇到过的最棒的老师啦~
82337,1112,吴旭平,2018-07-08 02:32:08,0,1,1,超级棒
82439,1112,吴旭平,2018-07-08 07:47:19,4,4,0,特别特别有意思，最有意思的思政课，老师思想很深刻，车速也很快哈哈哈哈哈哈哈哈哈~
82455,1112,吴旭平,2018-07-08 08:29:59,7,9,2,怪不得老师能追到班花
82456,1112,吴旭平,2018-07-08 08:32:05,0,2,2,讲课很有趣
82624,1112,吴旭平,2018-07-08 23:06:14,-9,2,11,吴老师史纲不错，军理李心北史纲何俊杰都是上课很有意思的老师。就是我思政课都莫名分低简直有毒。
82653,1112,吴旭平,2018-07-09 02:23:36,0,2,2,真真真真好老师加段子手，听课根本不知道枯燥为何物好吗！！
82949,1112,吴旭平,2019-01-20 13:11:33,-80,7,87,马原只做了一套选择题，课本看了其中一章中的一节，累计复习时间约1h，竟然满绩了！
84275,1112,吴旭平,2018-07-12 11:58:07,3,4,1,炒鸡棒
86534,1112,吴旭平,2018-09-17 05:14:05,-2,1,3,满分！给分超级棒 人又幽默 上课又生趣 知识又渊博
88144,1112,吴旭平,2018-10-23 03:31:31,2,2,0,最喜欢的思政课老师 没有之一
88508,1112,吴旭平,2018-10-31 12:44:28,4,5,1,我就是那个期末考试没预习瞎写被点名的.jpg\n\n但老师是真的好老师233333
90047,1112,吴旭平,2018-11-22 03:01:09,1,2,1,很好(✪▽✪)
90973,1112,吴旭平,2018-11-28 08:28:26,3,4,1,把深刻的内容讲平淡，把高远的知识讲得生活，没法儿不喜欢。
92266,1112,吴旭平,2018-12-27 10:35:07,-1,1,2,可惜我上的时候段子少很多嘞\n\n
92502,1112,吴旭平,2019-03-23 02:55:32,6,7,1,男神生日快乐呀
92744,1112,吴旭平,2019-01-04 06:12:04,2,3,1,能预置吴司机的课，我真的超级开心啊。老师真的超级无敌无敌好，幽默风趣，课外也和学生交流，把东西讲得很好，支持吴男神！！！认真听学生的见解，然后再发表自己的看法，补充或者肯定或者纠正，老师就是超级好！！！
93182,1112,吴旭平,2019-01-08 04:33:40,5,7,2,老师让我相信了共产主义！
93841,1112,吴旭平,2019-01-14 03:33:27,1,3,2,超级棒，课讲得很有意思，老师人超好
96126,1112,吴旭平,2019-01-20 13:13:19,-1,1,2,谢谢吴男神！！！！（土拨鼠尖叫）
96127,1112,吴旭平,2019-01-20 13:16:11,1,4,3,55555超好的老师！！点到都是民主投票点几次！！平时分超轻松的满了！期末根本没看任何东西最后4.2！！！表示怀疑均绩高于3.91啊！老师讲课超风趣！（虽然因为我秃头工科狗没时间写作业只能上课写没好好听课现在想想良心隐隐作痛qaq）
96134,1112,吴旭平,2019-01-20 13:19:14,0,2,2,给分非常好。男神
96136,1112,吴旭平,2019-01-20 13:21:22,1,3,2,竟然不是10.0？！天理难容！！思政课最好的老师没有之一啊！！
96137,1112,吴旭平,2019-01-20 13:21:41,2,3,1,啊啊啊啊啊啊啊啊啊超爱吴老师！！！以及我表白一下班长！人超好超认真负责，我平时分出问题了，半夜很细心帮我一点点查过去，感恩！
96139,1112,吴旭平,2019-01-20 13:23:21,-3,2,5,老师太棒了，平时分给的很高，最后也会尽量调分，关键是真正地在讲哲学！考试没怎么复习，竟然满了，真是太感谢了！
96145,1112,吴旭平,2019-01-20 13:28:59,2,3,1,老师太棒啦，讲课好，给分也很好
96148,1112,吴旭平,2019-01-20 13:30:23,2,3,1,上课很轻松，时常举一些贴切有趣的例子（偶尔开车）手动狗头? ，完全颠覆了我对马原呆板的认知
96154,1112,吴旭平,2019-01-20 13:36:54,0,1,1,老师实在是太好了，不选后悔，选不到遗憾！
96157,1112,吴旭平,2019-01-20 13:41:07,1,4,3,不选后悔
96170,1112,吴旭平,2019-01-20 13:55:22,3,4,1,老师讲的都很有趣，啦啦啦。快选上！
96215,1112,吴旭平,2019-01-20 14:33:29,4,9,5,这么说吧\n\n如果你要选马原\n\n哪怕签条子\n\n都要选吴彦祖(爱称)老师\n\n然后我知道老师空间答案\n\n哈哈哈哈哈哈哈哈哈哈哈\n\n试的人记得加句号\n\n
96218,1112,吴旭平,2019-01-20 14:35:50,3,4,1,给分好！上课有趣！
96660,1112,吴旭平,2019-01-21 08:44:54,0,3,3,上课可水可听，想认真听的，会觉得哲学非常有趣（老师车速有点快，系好安全带）。最后绩点，，，给每个人的分数都那么高我真的担心男神被领导谈话啊啊啊啊啊
97093,1112,吴旭平,2019-01-21 16:02:33,3,3,0,太棒了
97094,1112,吴旭平,2019-01-21 16:03:04,1,3,2,老师给分挺好的，会调分，而且尽量不会让你卡绩
97555,1112,吴旭平,2019-01-22 10:36:33,-1,1,2,男神无疑了，哲学素养很高，讲课超级有趣呀，给分也好。一定要选他的课呀！！！
100197,1112,吴旭平,2019-01-25 22:00:39,6,8,2,我仍然坚信在不远的将来共产主义能够实现
100943,1112,吴旭平,2019-01-27 07:27:35,1,2,1,…\n\n啊啊啊
102203,1112,吴旭平,2019-01-31 10:46:27,3,6,3,有原则，对作弊的同学处理的方式很令人敬佩
102894,1112,吴旭平,2019-02-25 00:26:52,-1,0,1,瞎几把答的卷子都给我上4了
102954,1112,吴旭平,2019-02-25 06:05:18,7,7,0,没错，这是我男神！马原课在周二下午，那是我一个星期最开心的下午！男神加油！希望你从此以后都好好的！
103037,1112,吴旭平,2019-02-25 14:32:10,-1,1,2,我爱吴老师
103759,1112,吴旭平,2019-03-05 05:32:48,2,3,1,老师是我男神
104195,1112,吴旭平,2019-03-13 15:42:06,0,4,4,真的好❤️
104706,1112,吴旭平,2019-03-26 08:24:21,1,3,2,男神不解释
106217,1112,吴旭平,2019-04-25 16:00:29,0,1,1,老师人超好 还会讲人生哲理
109960,1112,吴旭平,2019-06-20 14:04:48,4,4,0,挺好的老师
110563,1112,吴旭平,2019-06-27 13:17:17,0,2,2,超级好的老师！
110564,1112,吴旭平,2019-06-27 13:18:14,4,4,0,老师超好！！这样的讲课风格超喜欢的！！
110572,1112,吴旭平,2019-06-27 13:30:14,2,2,0,体验极佳
110582,1112,吴旭平,2019-06-27 14:02:19,2,3,1,好老师 我哭了
110632,1112,吴旭平,2019-06-28 00:00:57,1,3,2,上课好（不枯燥！），老师人好，给分好（超好
116349,1112,吴旭平,2019-09-09 00:50:46,-1,1,2,太好了 谁上谁知道\n\n浙大最喜欢的老师，没有之一！
116413,1112,吴旭平,2019-09-10 06:55:11,-2,1,3,棒棒哒！
117421,1112,吴旭平,2019-09-24 06:04:43,11,12,1,越啥，越革命！有人一起革命吗！
117426,1112,吴旭平,2019-09-24 07:05:09,15,16,1,马克思主义车王
117661,1112,吴旭平,2019-09-28 04:24:49,2,4,2,老师性格特别棒
117717,1112,吴旭平,2019-09-30 01:39:52,6,6,0,欲罢不能
118403,1112,吴旭平,2019-10-26 14:11:48,-13,5,18,忽悠段子
118510,1112,吴旭平,2019-10-28 00:03:56,-22,9,31,不懂尊重没有敬畏心的人能算好老师吗
120390,1112,吴旭平,2019-12-03 01:04:06,0,2,2,研究生中特课程老师，讲的内容很丰富有趣
121078,1112,吴旭平,2020-01-19 13:11:13,1,3,2,绝对值得
121229,1112,吴旭平,2019-12-26 15:10:04,-11,6,17,低俗不喜欢
122127,1112,吴旭平,2020-02-15 14:00:51,9,9,0,听说吴老师当年追到班花？有趣
122352,1112,吴旭平,2020-02-25 04:39:03,3,4,1,老师太可爱了！知识点用很有趣的方式讲出来
122360,1112,吴旭平,2020-02-25 09:02:27,10,10,0,大家好我是马克思，在线求一个恩格斯，挺急的！：）
122437,1112,吴旭平,2020-02-27 12:01:39,0,2,2,隔壁bd
122578,1112,吴旭平,2020-03-05 02:23:12,3,5,2,你我一时的栽树，为后来的同学提供一片绿荫
122735,1112,吴旭平,2020-03-27 03:36:00,4,4,0,强推中特，从不点名期末开卷
122793,1112,吴旭平,2020-04-07 12:34:29,-32,21,53,能说出蛋炒饭这种恶心谣言来侮辱毛教员烈士儿子的，脑子和屁股起码有一个不正常，同学们别被这看似幽默的杂种骗了
123238,1112,吴旭平,2020-05-24 01:30:39,29,31,2,今年上吴老师网课，上课都会让他的猫主子“康德”出镜，并且康德还会霸占吴老师的笔记本电脑还不被赶走，非常地溺爱。感觉特别暖。课程讲的那是非常有意思，第一次有思政老师问大家要不要再讲一会儿，然后大家全说“要”
123541,1112,吴旭平,2020-06-09 13:50:53,7,8,1,千万别翘课，不然会很惨！！！
124179,1112,吴旭平,2020-06-26 13:21:30,5,8,3,马原给分超好！自己网课水了一学期无发言记录论文也是赶出来的竟然有4.5爱了爱了（有时下午课太困了甚至电脑开着静音睡觉……感觉很对不起老师_(:з」∠)_
126249,1112,吴旭平,2020-09-21 01:41:38,1,3,2,老师牛逼
127215,1112,吴旭平,2020-11-15 03:27:37,-8,3,11,其实一般吧，不靠谱的段子多
127554,1112,吴旭平,2020-11-24 09:56:56,2,2,0,吴老师挺好的，但是助教水平不怎么样，讲的比较枯燥，但是人还不错，给分还可以
127755,1112,吴旭平,2020-11-26 10:32:53,-2,1,3,给人的人生很大的启发
127955,1112,吴旭平,2020-12-01 07:13:10,0,1,1,讲课非常有意思，给分也很好
128095,1112,吴旭平,2020-12-07 06:42:41,2,3,1,挺有意思的
128299,1112,吴旭平,2020-12-17 03:27:27,1,2,1,谢谢老师，学到很多，也笑到很多！
129306,1112,吴旭平,2021-01-04 04:12:46,3,4,1,老师讲马克思和恩格斯的恩爱（bushi故事，有把我头都笑掉，再也无法直视这两人，啥不说10分，除了他还有谁
129484,1112,吴旭平,2021-01-06 06:26:48,3,4,1,特别特别特别好
130454,1112,吴旭平,2021-01-22 13:13:35,3,3,0,真不错
130473,1112,吴旭平,2021-01-22 16:34:07,1,3,2,男神不解释，吴司机是真司机，第一节课就全程高能，爆笑不止。且难得有能把马原讲得如此透彻如此有趣的老师！果断满分满分
130857,1112,吴旭平,2021-01-25 04:16:14,2,4,2,讲课很有趣可惜我没听过课。不过最重要的当然是给分好啊啊啊啊啊！
130877,1112,吴旭平,2021-01-25 05:29:18,0,2,2,好就vans了！吴老师yyds😍
130879,1112,吴旭平,2021-01-25 05:34:13,-1,0,1,吴老师永远滴神，人好，讲课有意思，给分高，还有猫猫！
130883,1112,吴旭平,2021-01-25 05:59:05,4,5,1,真的太喜欢了  没有人会不喜欢吴老师
130923,1112,吴旭平,2021-01-25 08:57:14,-1,1,2,讲课太有意思了！最后给分也超好！
130993,1112,吴旭平,2021-01-25 13:26:34,1,2,1,nice
131140,1112,吴旭平,2021-01-26 07:07:33,11,11,0,吴老师让我这个对政治毫无兴趣的理科生了解发自内心地爱上了马原，真正树立了共产主义远大理想（是真的！）选到吴老师的课实在太幸运了！没有任何一点不打10分的理由！
131227,1112,吴旭平,2021-01-26 17:08:48,1,4,3,唯一让我每次都到场的思政课。
131260,1112,吴旭平,2021-01-27 01:09:04,0,2,2,给分极好
131689,1112,吴旭平,2021-01-28 12:30:03,4,5,1,男神，膜法师，老二次元。给分超好，上课更好，下课后我们上去问问题还会和我们交流很久，有一次交流了一个多小时。虽然上完还是对哲学提不起什么兴趣，但是也是能学到很多的。
131820,1112,吴旭平,2021-01-29 04:17:04,-1,1,2,讲课非常有趣，给分特别好
132038,1112,吴旭平,2021-01-30 03:54:04,10,12,2,老师非常有耐心，QQ问问题秒回，有次早上课后和我们探讨到下午上课，都没有吃午饭。吴老师是学问人品兼备不可多得的好老师。
132309,1112,吴旭平,2021-01-31 15:47:37,2,5,3,从上课到给分到猫咪无可挑剔，他的存在简直是对其他马原老师的不公！！！（doge）
132397,1112,吴旭平,2021-02-01 09:23:25,2,3,1,对哲学真诚地热爱，也以赤诚之心希望学子们能接触到更多看似高深的哲学知识。感谢老师！
132440,1112,吴旭平,2021-02-01 15:22:19,5,6,1,旭平·吴是我上大学以来遇到的最具哲学气息的老师，改变了我对整个浙大的看法。
133863,1112,吴旭平,2021-03-08 11:08:44,0,1,1,第一次听到有老师把课讲的这么生动有趣
133927,1112,吴旭平,2021-03-09 17:28:44,0,3,3,讲课幽默风趣，有独特见解，超级棒的老师
133939,1112,吴旭平,2021-03-10 06:07:43,13,17,4,他让我意识到马原是货真价值的哲学课而不是政治课
134023,1112,吴旭平,2021-03-12 03:50:13,-2,0,2,太有趣了！贼有梗
134564,1112,吴旭平,2021-04-01 14:36:58,5,10,5,跪了，神一样的反思能力
135723,1112,吴旭平,2021-05-21 00:38:23,1,1,0,wxp老师yyds
136354,1112,吴旭平,2021-06-17 02:36:22,7,11,4,永远滴神，真的为学术和学生着想！顺便血书老师开毛概H
136358,1112,吴旭平,2021-06-17 02:48:30,3,4,1,旭平吴超人！
137790,1112,吴旭平,2021-07-06 06:52:26,-17,6,23,老师太好了，上课有趣平时分也能拉满，考试虽然只背了半天还拿了4.5，表白一下
137796,1112,吴旭平,2021-07-06 07:11:13,3,5,2,好老师，上课也上得很好
138084,1112,吴旭平,2021-07-07 09:34:26,1,3,2,wxp yyds
138357,1112,吴旭平,2021-07-08 16:16:01,12,14,2,楼下背半天4.5的 真是对marx原教旨最大的侮辱
138634,1112,吴旭平,2021-07-10 04:47:09,2,3,1,社会主义发展史事少分高，推荐选
140434,1112,吴旭平,2021-09-11 10:30:25,2,3,1,中特听的特别爽，很有意思
140574,1112,吴旭平,2021-09-14 03:16:53,3,4,1,太卷了
142076,1112,吴旭平,2021-11-05 06:31:49,1,2,1,男神 不解释😘
142503,1112,吴旭平,2021-11-12 09:42:34,0,2,2,有趣的灵魂
144155,1112,吴旭平,2021-12-20 00:35:34,-1,1,2,老师真的很幽默，教得很好
145696,1112,吴旭平,2021-12-31 08:28:15,-2,1,3,依然是考前来评个分，跟老师一个学期之后感觉还是不错的，讲的确实挺好，老师跟我互动也比较多，有个建议是关于这个辩论环节的设置可能需要改动改动了，有人上去两方纯念稿子，实在是没意思，而且这辩论的质量确实也有点低。。。
145817,1112,吴旭平,2022-01-03 01:56:25,-1,0,1,真不戳
145823,1112,吴旭平,2022-01-03 03:50:22,4,5,1,一个聪明的男人👨🏻
145970,1112,吴旭平,2022-01-04 16:14:17,0,1,1,好极了
146023,1112,吴旭平,2022-01-05 05:14:16,2,4,2,良师益友，浙大难求！
148445,1112,吴旭平,2022-01-12 13:00:38,5,7,2,康德🤤🤤🤤我的康德🤤🤤🤤
149166,1112,吴旭平,2022-01-14 15:06:54,11,12,1,老师讲课很有意思，不听可惜，虽然是思政课但是内涵讲的很深刻，完全不是说教\n\n资本家压榨剩余价值哪里讲的真的棒，我一个讨厌这些东西的人都听的津津有味\n\n平时分很好得，多发几次言能满，但是考试很难，全选择，不调分，所以最后总绩点并没有达到预期
150045,1112,吴旭平,2022-01-18 13:31:35,0,3,3,康德，浙大的神！\n\n吴旭平爸爸也是\n\n听他讲马原是一种享受
150215,1112,吴旭平,2022-01-20 11:23:14,6,6,0,估计像我这样平时分没满的班上也没几个了QAQ，吴老师和康德老师都是马原的神，10分送给他们
153298,1112,吴旭平,2022-04-27 22:14:25,9,11,2,可以说是浙大最好的思政课老师了
154331,1112,吴旭平,2022-05-30 10:48:25,3,5,2,草原之王！！！！！
155542,1112,吴旭平,2022-06-14 07:39:21,-1,1,2,好老师！
156082,1112,吴旭平,2022-06-17 12:10:21,4,5,1,男神捞捞捞捞我吧
156407,1112,吴旭平,2022-06-19 12:05:32,-68,6,74,趣味低下，段子低俗。真的没有什么营养价值。内容水，对社会愤青赢得掌声。关键是关键是，期末考察事情真多，小组讨论作业+期末闭卷考试+课程论文。屁事真多
157430,1112,吴旭平,2022-06-23 08:05:04,6,9,3,楼下什么鬼啊 马原每个班任务都一样 自己菜为什么要喷老师？？？
157944,1112,吴旭平,2022-06-25 17:06:03,2,4,2,吴旭平捞神！
157953,1112,吴旭平,2022-06-25 18:05:10,6,15,9,马原H，客观公正地打个9分。\n\n吴老师是很少有的能把思政课讲得不催眠的老师，会在课堂内容里穿插很多段子，可以说非常懂大学生上课想听些什么。老师的思想很新潮，会在课前课间大屏逛b站放小约翰可汗的视频，也不避讳同学谈论一些看起来比较敏感的话题。至少吴老师的课是上到现在这么多思政课里唯二让我能全程听完且不想翘的。\n\n扣一分是因为讲太多段子也不免会有把一些哲学家或者思想低俗化的嫌疑。虽然不至于歪曲史实，但如果对西哲有一些了解的同学很容易从这些段子里听出一些不那么爽快的东西。如果要和史纲赵晖老师这样的大师对标的话，底蕴上似乎还差了那么一点。\n\n至于给分，能看出老师已经很尽力了，绩点难看是我自己考不出来的问题（悲
158030,1112,吴旭平,2022-06-26 10:19:23,1,2,1,课讲得好，照顾学生，给分也好，选上就是赚到
158079,1112,吴旭平,2022-06-27 00:43:48,5,6,1,男神，不解释
158081,1112,吴旭平,2022-06-27 00:56:10,1,2,1,我的wxp，我的男神，海底捞啊啊啊啊
158082,1112,吴旭平,2022-06-27 01:09:44,1,2,1,吴老师马原男神，上课讲哲学例子都很生动，给分也巨好，选他！
158089,1112,吴旭平,2022-06-27 02:08:34,2,3,1,好好好
158093,1112,吴旭平,2022-06-27 02:56:57,3,3,0,好好好！
158169,1112,吴旭平,2022-06-27 09:04:52,0,1,1,好老师
159809,1112,吴旭平,2022-09-01 07:10:17,14,17,3,老师有化腐朽为神奇的超能力，思政课全程高能，有幸和康德一起上课~~
160333,1112,吴旭平,2022-09-19 08:08:29,8,9,1,社会主义发展史第一堂课，全程高能
160368,1112,吴旭平,2022-09-20 10:44:49,-2,2,4,好老师。。
160509,1112,吴旭平,2022-09-25 05:29:44,4,4,0,马原课前两周，听得好爽
160683,1112,吴旭平,2022-09-30 14:53:16,4,7,3,舌战群儒之无懈可击
161663,1112,吴旭平,2022-11-10 07:13:09,7,9,2,对非哲学专业的学生比较有意义
163293,1112,吴旭平,2022-12-12 07:47:05,19,21,2,超级超级超级超级好的老师！记得当时我们十几个同学下课找他讨论，老师舌战群儒，从九点二十分一直讨论到十一点多，还意犹未尽。那真是我在浙大最美妙的一个夜晚
164415,1112,吴旭平,2022-12-21 02:10:58,9,10,1,网课直播撸猫的老师谁不爱呢
164570,1112,吴旭平,2022-12-22 02:42:23,0,3,3,社会主义发展史，老师真的非常能讲，把课上得很生动有趣！
165309,1112,吴旭平,2022-12-31 10:59:58,5,7,2,考前对康德交代后事也太生草了[ac01]思政课里听课体验能比得上吴老师的人太少了
165458,1112,吴旭平,2023-01-06 10:30:01,2,2,0,完美的男人！
165490,1112,吴旭平,2023-01-07 06:50:18,10,13,3,无知时诋毁wxp，懂事时理解wxp，成熟时成为wxp，如果我🐴⭕️挂了，来世我一定认真听🐴⭕️🙏🙏🙏
165612,1112,吴旭平,2023-01-09 04:09:06,-1,4,5,能把马原讲得非常别开生面、妙趣横生——当然，代价就是让严肃的马克思哲学扁平化，纯论内容的话可能会更适合非社科的同学。考虑到很多学生对马克思的认识寥寥，总体来说，吴老师的马原仍是一门付出了心思的好课，希望会有同学学了这门马原后对马哲研究产生兴趣吧。ps：考前让康德猫猫给自己送行也太好笑了
165823,1112,吴旭平,2023-01-10 03:13:12,0,1,1,讲课很幽默，给分也不错
165849,1112,吴旭平,2023-01-10 06:07:01,3,3,0,点名，但不多。\n\n平时分和你在课堂上的积极程度有关，但wxp课上问题一般为哲学性问题，没有正确答案，有想法就会有分数。\n\n有作业，量小次数多。\n\n闭卷考试，但感觉稍微复习复习材料分数并不会太低。
165877,1112,吴旭平,2023-01-10 08:01:03,4,6,2,很喜欢老师！\n\n最开始是因为严谨的逻辑，与丰富的知识；后来也因为康德嘿嘿！\n\n老师给分很好，我上的马原H，平时：期末是60:40。平时分由辩论、平时小测（老师不会操作改成学在浙大每周提交二百字）、考勤等组成，发言一次可以加三分，这些加起来最多90分，教师评价10分。如果不发言的话其他几项满也可以，班上很多同学平时分都满了～\n\n期末考试和马原非H一套卷子，老师会给大题范围，高中学了政治感觉很轻松，老师给分很好～～\n\n点名：本学期雷达点了一次还是两次的样子。
166380,1112,吴旭平,2023-01-12 06:21:09,0,1,1,老师讲课清楚而且非常有意思，课上和同学有很多交流，真的帮我们解释清了很多疑惑
166567,1112,吴旭平,2023-01-13 00:32:18,3,6,3,讲课幽默，能感受到老师的博学，感觉讲课就是信手拈来的事。老师给分也很好！
167497,1112,吴旭平,2023-01-16 16:17:17,2,4,2,永远爱吴旭平老师和康德！！！！！\n\n可能你会觉得事有点多，但是别问，问就是给你期末加分的理由\n\n满绩bd
167694,1112,吴旭平,2023-01-18 10:38:09,1,2,1,我永远爱吴旭平老师。给分超级无敌好，都给我选！
169925,1112,吴旭平,2023-02-28 12:37:04,1,3,2,男神啊
170054,1112,吴旭平,2023-03-01 06:39:10,5,8,3,1.永远的神 无论上课还是给分还是事情多少（和其他马原班级相比） 2.整学期就点两次名好像，有点忘了，要点名之前起码提醒了两遍 第一遍是点名那天的前一周，第二次提醒是当天点名的第一个课间（啊同学们到课间了那我们。。下个课间点名） 就算是看智云、迟到等各种原因我觉得你都是能签上的。。心软的神
173887,1112,吴旭平,2023-06-04 06:31:15,7,9,2,社会主义发展史，本来是抱着水课的目的去听的，结果第一节课被老师讲课深深吸引，津津有味的听完了！
174530,1112,吴旭平,2023-06-13 16:17:22,4,6,2,能把思政课变成津津有味的故事会的猛人，大学以来通识课体验最好的老师了
174639,1112,吴旭平,2023-06-15 02:37:08,2,6,4,男神不解释，很幸运大学里遇到吴老师。段子手老司机，学术水平高，又能真正学到一些知识，增进智慧的马原课，太多可以夸的方面了，为什么不能打11分呢？
174711,1112,吴旭平,2023-06-16 05:56:23,8,9,1,我来就是来送一个10分的。\n\n能低门槛接触到真正的哲学，实际上对于非哲学系的同学真的不容易。
175150,1112,吴旭平,2023-06-22 02:57:44,4,4,0,巨巨巨好的马原老师
175609,1112,吴旭平,2023-06-26 01:44:21,6,9,3,吴老师我永远的男神！！！
175713,1112,吴旭平,2023-06-26 09:37:26,-22,6,28,平时分不会调一点，稀碎的辩论加上随缘的投票，可以让根本没到场甚至一点没参加辩论或者一言不发的人的平时分远高于参加辩论但被投票少的人
175738,1112,吴旭平,2023-06-26 11:02:48,3,5,2,一学期只点一两次名，并且会提前通知，上课超有意思，平时分基本拉满，我的神！
175743,1112,吴旭平,2023-06-26 11:14:14,5,6,1,非常好的体验，把政治课讲的如此生动有趣，本工科生收获了很好的绩点
175744,1112,吴旭平,2023-06-26 11:21:33,3,6,3,吴旭平我的超人
175745,1112,吴旭平,2023-06-26 11:22:47,9,10,1,马原不选吴旭平，思政万古如长夜
175748,1112,吴旭平,2023-06-26 11:43:02,8,9,1,最好的思政老师。在他的课上，可以学到真正的哲学思想。一向来对思政不喜欢，他的课可以让我放弃写别的作业认真听。辩论完全社恐友好，没有论文读书报告。点名就一两次，还会提前说。给分真的太捞了。wxp我男神！！！
175753,1112,吴旭平,2023-06-26 12:07:33,2,3,1,好课 可选
175774,1112,吴旭平,2023-06-26 13:49:27,6,6,0,神神神 事又少分又高又能学到东西 讲的太好了\n\n（至今犹记辩论辩得不好，辩完跟老师聊了很久，聊完就被圈粉了）
175963,1112,吴旭平,2023-06-27 09:28:16,8,10,2,前面那个说平时分的，上课发言一次就能加三分，辩论结果对你的影响也就是两次发言而已。老师上课也总是会问一些哲学性的问题，如果在乎平时分的话很容易满
176814,1112,吴旭平,2023-06-30 08:43:48,4,7,3,wxp我的超人！！！讲课非常生动有趣，不喜欢政治的人也能不由自主的听进去，给分也很好
176911,1112,吴旭平,2023-06-30 16:03:27,9,9,0,老师真的很好，我直接吹爆
177237,1112,吴旭平,2023-07-02 11:04:01,10,11,1,不选wxp的马原h，有难了
177569,1112,吴旭平,2023-07-03 18:05:20,8,11,3,爹，真送分啊
177722,1112,吴旭平,2023-07-04 12:09:55,10,14,4,重要的是，收获了知识又收获了爱情，感恩男神TAT
178229,1112,吴旭平,2023-07-08 10:13:00,26,27,1,真正的好老师啊\n\n在学习这门课的第一天，学习哲学的部分，就感受到老师所讲的东西和自己之前接触到的东西有所不同，真的就像一股清流一样，让我一下对马克思主义有了全新的理解，说实话，这是我第一次接触到哲学这一体系。之后的每一节课都十分的精彩，我每节课都认真的听讲、做笔记。经过一学期的学习，最后回到最熟悉的科学社会主义的时候，对马克思主义的认识已经和之前完全不同了，对世界也有更新的认识。\n\n来上课的人十分少，这让人十分的难过。这么好的课程，真希望能有更多的同学来现场听到。如果有同学想来旁听，我觉得大可以来（除了第一节），空位是很多的，绝对不虚此行。\n\n讲到有的部分，老师也十分激动，虽然老师已经讲很多遍了，但是还是就像一腔热血被点燃了一样。可惜抬头的同学也寥寥无几\n\n不得不说，我觉得老师的授课方式不适合认真听讲。作为要记笔记的学生，我学的十分辛苦，我感觉课程设计时就没有考虑这个，时而长时间没有记的东西，时而根本记不过来。老师的课程设置是两节讲课一节辩论，极大的压缩了本就有限的课时，然而，吴老师显然是按照三个课时在讲。这一点不得不批评吴老师，讲课的时候，前面一个半课时非常舒服，最后的二十分钟则会直接起飞，我在底下就非常赶非常难受，一些很有意义的东西，就像紧迫中一笔带过了。但或许也没有人在乎老师究竟讲了什么。在现在的教育形式下，只能把思政课做成这样的形式，才能传播出一点东西吧\n\n但是，专心听和一边干自己的事一边打一耳朵听真的不一样。这学期的马原是我最快乐的课之一，在课上每时每刻思考，每节课都有全新的感悟，让我感觉短暂地脱离了沉重的学习压力，到达了理想主义的乌托邦，好像已经实现了共产主义，在这个小小的一方教室里短暂的享受着自己精神的自由和解放\n\n后来在路上遇见了一次吴老师，给吴老师打了一次招呼。吴老师当然不认识我，但我一定永远记得这个炫耀自己猫，用一口幽默的东北口音教导过我的有点胖胖的可爱男人
179620,1112,吴旭平,2023-09-19 01:50:13,6,7,1,真的是很有趣的老师，上他的社发课笑到肚子痛，语言犀利还精辟，绝绝子。\n\n强烈建议他多上几节，提振一下我麻木的心灵
179711,1112,吴旭平,2023-09-19 12:30:01,4,5,1,只能说名副其实
180568,1112,吴旭平,2023-09-23 02:32:56,1,4,3,有幸听了一节吴老师的社会主义发展史，真的太有趣了，久违的全程没有干别的事情，甚至还认真做了笔记
184499,1112,吴旭平,2023-12-21 02:39:22,1,4,3,咔咔咔
184938,1112,吴旭平,2023-12-24 13:25:24,2,3,1,真挺好
186495,1112,吴旭平,2024-01-11 10:20:04,3,4,1,选就对了
186519,1112,吴旭平,2024-01-11 12:25:43,-3,0,3,好老师！！
187001,1112,吴旭平,2024-01-14 05:58:26,-3,6,9,一点不记得，考试纯编，能拿到这个绩点。。。哪里来的这么好的老师。。。
187002,1112,吴旭平,2024-01-14 06:02:29,3,5,2,唯一真神wxp，i了i了
187004,1112,吴旭平,2024-01-14 06:10:16,17,19,2,下辈子我要转生成你的猫
187005,1112,吴旭平,2024-01-14 06:14:17,7,8,1,打分再次超过上限！过年快乐！！！！
187006,1112,吴旭平,2024-01-14 06:15:18,3,4,1,满分！从未见过能把政治课讲的这么好的老师！
187017,1112,吴旭平,2024-01-14 07:03:59,5,6,1,怎么说吧……懂均绩4.6的含金量嘛\n\n吴老师我愿称为真神\n\n一个思政课几乎周围都是4.8\n\n毫无压力考前一天复习即可\n\n\n\n（喜欢猫猫嘿嘿
187025,1112,吴旭平,2024-01-14 07:39:48,0,1,1,老师太棒了
187033,1112,吴旭平,2024-01-14 08:05:22,-1,2,3,经常发小猫咪\n\n高中选过政治，考前背了1.5h，考试仅仅只能说把试卷填满了，直接捞到满绩
187070,1112,吴旭平,2024-01-14 10:19:36,-1,1,2,想要猫猫
187086,1112,吴旭平,2024-01-14 11:38:20,1,2,1,给分好，还有猫猫
187533,1112,吴旭平,2024-01-16 12:39:29,0,2,2,猫和马原的神！
187800,1112,吴旭平,2024-01-17 13:17:59,3,6,3,给分好的可能是幸存者偏差吧，也不是所有人都能拿高分。
189894,1112,吴旭平,2024-02-01 13:33:52,-1,2,3,点名提前通知\n\n爱发毛毛\n\n给分巨好
190144,1112,吴旭平,2024-02-23 17:03:44,22,25,3,吴老师热爱教学事业，希望树立学生对于世界更有深度和更为宽广的看法；他用心对待生活，常和学生分享家中宠物猫的照片；尽管他教学的课程有一定特殊性，但他倾力希望打造生动而有内涵的课堂，让同学们参与其中，他每次课会安排对于一个哲学话题的辩论以及听众对此打分之环节。吴老师几乎不点名，也几乎不留额外的作业 (这两件事都是“几乎不”，但不是“完全不”)，最后的给分也非常照顾学生的感受。\n\n吴老师有一些自己对于世界的感受，发布在公众号等平台上；这有在雪域高原的触景生情，有对生活的反思，也有对已故父亲的怀念等等。或许一门课程所漫延之时间很短暂，与老师共处一间教室的机会也很有限，但他对于生活和教育的态度或许能给予同学一些长久的影响；这一点并不是寻常的。
190448,1112,吴旭平,2024-03-04 11:50:03,12,14,2,四史通识课能记笔记，什么实力
191103,1112,吴旭平,2024-04-03 07:00:59,1,3,2,我永远爱吴旭平老师
194707,1112,吴旭平,2024-06-25 04:07:51,4,6,2,老师真的很好！！！讲课非常风趣幽默，对哲学的理解也很深刻，是我为数不多能认真听下来的思政课。\n\n给分：平时分占50%，给分很好，作业有一次小组辩论（占平时分30分，胜方30败方25）和一次读书报告（30分，大部分人都在26+），还有两次不能翘的讨论课（30分，少一次扣5分）。上课发言可以加分（3分/次），最后还有10分的老师评价。发言个三次左右基本上平时分就满了。\n\n考试：闭卷全靠背，这个强度不好评价...有的人背的很认真背好久，有的人考前突击一晚上，po应该发挥还不错，虽然有个大题完全不会，但是最后分数比预想的高一些QAQ 老师改卷应该也捞了\n\n不管怎么说，吴老师的马原课绝对是满分！能预置到老师的课很幸运！！！
194720,1112,吴旭平,2024-06-25 05:21:14,2,5,3,吴旭平老师是很好的 上课幽默风趣 但是高分是幸存者偏差 也不要希冀不努力就能拿高分\n\n考前背了三遍书 客观题知识点和主观题知识点都背了两遍 最后出分比预期低很多 可能还是我太菜了吧\n\n虽然没能拿到想要的绩点 但预置吴旭平老师还是很幸运的
194737,1112,吴旭平,2024-06-25 07:24:33,0,2,2,好老师！
194784,1112,吴旭平,2024-06-25 11:36:05,1,2,1,老师超级好
194805,1112,吴旭平,2024-06-25 12:45:09,0,3,3,吴老师确然为一名好老师，平时分给的很慷慨的，最后考试看个人，我有高中政治底子，请他人不清楚状况，考前复习了一天，93/4.8，maybe是选择题可能出了些没办法的错误，基于分数而言老师平时分拉满已是最好的了，考试看个人不要妄图不复习取得很好的分。感谢老师的一学期讲课，受益颇多。
194898,1112,吴旭平,2024-06-26 01:34:58,4,7,3,老师是真的能把枯燥的哲学和有趣的段子有机结合的人！！自带东北特色的幽默气质而且老师本人是真的很深入的洞悉了马原以及马原之外各种思想流派的内涵，认真听可以收获很多知识，不认真听也可以博得一乐。\n\n给绩点也很良心，虽然鼓励课堂发言加分，但是本人从没发过言，小组讨论和辩论也水水的，最后绩点是4.8！\n\n思政课程真的很需要这样优秀的老师！！！
194977,1112,吴旭平,2024-06-26 07:09:55,3,6,3,吴老师特别好的老师\n\n高中没学过政治，平时分拉满了最后4.8，因为前一天专业课考试所以马原就背了一天，大题基本就是背下来几个理论然后自己瞎扯\n\n主要是不点名，老师第一节课会让大家投票点几次名，我们投的0然后就没点过\n\n给吴老师十分！
195853,1112,吴旭平,2024-06-30 10:25:58,6,10,4,讲课幽默风趣，引用信手拈来。哲学方面感觉很有造诣，政治经济学可能我听过yb老师讲就没有那么震撼，但吴老师讲西方哲学真的是一愣一愣的，且吴老师正经哲学科班出身，我觉得吴老师讲的可以算真正的马克思主义原理。\n\n给分方面即使辩论输了三次发言也能满分，赢了就一次差不多。今年卷子难（也许是改卷严格），大家卷面分平均没以前高，吴老师应该又拉高了大家的平时分，还在群里解释了。非H的卷面没办法调，但吴老师仍然尽他所能给大家最好的分数。\n\n另外虽然不点名，但建议听课。本人工科生没学过政治但是每节课认真听认真发言，期末复习哲学部分就感觉很快，很好理解，毕竟吴老师讲得太好了！
197533,1112,吴旭平,2024-07-18 05:42:43,0,3,3,真神，全心全意为学生着想，上课很有意思会举各种例子，辩论体验也很好
198838,1112,吴旭平,2024-09-12 06:00:34,2,5,3,老师特别特别特别幽默
207519,1112,吴旭平,2024-12-22 14:13:07,4,5,1,很好的老师，有思想的老师！
209175,1112,吴旭平,2025-01-05 02:05:38,-38,4,42,上课太娱乐化，一大堆段子、轶事、野史塞过来，早已经容不下真知识了，似乎只是为了博同学一笑。我尤其反感他对待古希腊哲学的态度，仿佛把那当成一种玩笑，当成可笑的东西，包括他对其它一些古早一点的哲学家（黑格尔、空想社会主义者）也是这个态度。对此我相当不齿。即便你是马克思主义者，即便你站在正统马克思的视角，你也绝不能因此全盘否定其他人的哲学，你可以不屑、可以嘲笑，但唯有经过严肃的思考你才有资格不屑和嘲笑。你不能把其他哲学当作一个玩笑、一个笑柄，最起码的尊重还是要有的，你得去认真考虑他们的想法，毕竟他们也是大哲，他们的想法一定有其合理性在的。连马克思的博士论文做的都是伊壁鸠鲁啊。最不应该的是把这种玩笑带到课堂上，带给同学们，让同学们养成一种对待非马哲学的玩笑姿态，这是一种变相的洗脑。
210922,1112,吴旭平,2025-01-10 07:14:29,7,8,1,老师，您是我的神，我跨专业选的马克思主义哲学史，早八上课都去了（但是就点过一次名）但是确实哲学内容不适合我，而且可能因为是专业课，上课很多知识有点小难而且比较细，所以上课都没听（老师讲课真很好也很有梗，没听是我的错wwww）这学期期末闭卷，有划重点，因为是小班加上老师出卷，划的重点很多都考了，我考前狂刷ppt考前背了一个半天，反复看划的重点，加上也是文科选科考生，有点政治底蕴以及答大题的政治思路，不太会的也疯狂自由发挥，大题卷面基本写满了，最后4.5~
211351,1112,吴旭平,2025-01-11 08:31:33,4,5,1,社发史4.5爽了 下学期上老师的马原 上完了再来评价
212288,1112,吴旭平,2025-01-14 00:47:50,1,2,1,马原出分啦 特来感谢
212328,1112,吴旭平,2025-01-14 01:33:37,2,4,2,吴老师，你就是我的爹🫡
212375,1112,吴旭平,2025-01-14 02:24:34,0,5,5,捞王，wxp永远的神，高考未选政治期末不用背4.8拿下拿下
212455,1112,吴旭平,2025-01-14 04:42:01,5,7,2,神中神，无需多言。在吴老师的课上，你甚至可以同时拥有幽默风趣的整活老师、轻松愉快的讲课氛围、硬核专业的学术知识、为数不多的课后作业和（接近）满绩的超高绩点。集百家之长于一身，我不知道还有什么理由不打十分！
212533,1112,吴旭平,2025-01-14 06:55:39,4,6,2,老师的恩情还不完！
212606,1112,吴旭平,2025-01-14 09:10:18,1,3,2,马原唯一真神！
212722,1112,吴旭平,2025-01-14 15:03:53,4,6,2,马原课上一共可能出现5个太阳，一个是天上的，另外三个是视频里远在平壤的，还有一个就是在讲台前，咔咔狂讲的老师。恩情还不完👋😭👋
212982,1112,吴旭平,2025-01-15 12:01:51,0,1,1,吴男神！！！！\n\n神中神，上课有趣给分好
214397,1112,吴旭平,2025-02-02 15:00:56,0,0,0,555
215015,1112,吴旭平,2025-02-20 05:31:57,-2,1,3,超级好的老师，最后轻松拿了4.8，10分不多说了
216507,1112,吴旭平,2025-03-17 14:06:23,0,1,1,把思政课上成学生都爱听样子的好老师，伟大无需多言，尊重思想自由鼓励表达的老师已经薄纱一大片干讲ppt的了
216887,1112,吴旭平,2025-03-28 04:28:15,3,4,1,打游戏最高的配置是朋友，而不是装备。马原的最高配置是吴旭平，而不是内容🙋
217512,1112,吴旭平,2025-04-12 02:42:20,0,1,1,吴老师上课幽默风趣，把知识点融入在每个人物故事片段中，让学生很有启发，支持
217955,1112,吴旭平,2025-04-18 09:48:42,10,10,0,为什么社发史给分那么烂？我们写的论文真的好好读了吗？
218008,1112,吴旭平,2025-04-19 05:29:33,8,10,2,社会主义发展史87/4.2\n\nemmmm怎么说 我认真写了论文 但是感觉小测蛮难的 可能论文写作也不是我强项吧 听说以前这门课很多人4.5
220388,1112,吴旭平,2025-06-17 14:44:08,1,1,0,选上男神的课就偷着乐叭！上课特别特别幽默风趣还有一股明显的大碴子味儿（一开始以为是东北汉纸，一查发现是浙江老乡，再一查原来是吉大博士，那就解释得通了哈哈），干货满满，会传递很多自己的思想也特别注重和学生的互动与思想碰撞。。明说自己会捞大家只不过我们要给他捞的空间，主打一个说到做到啊啊！！吴男神我将拥护你一辈子（泪流满面握拳状）！！！
220417,1112,吴旭平,2025-06-18 01:30:29,1,1,0,坐标马原，今日出分，喜提91(\n\n\n\n吴老师的平时分是很好拿的（平时分总分一百，占最终成绩50%），两次讨论来了就有30分的基础分；一次辩论赢了30输了25；读书报告写的声情并茂有自己的见解就能30（我自己就是30分嘎嘎嘎）；平时上课回答一次问题就能加3，很容易回答4、5次的（老师的问题既有趣又简单）。\n\n\n\n期末复习可以参考98或者朵朵上大家分享的知识梳理什么的，选择题不是很难。大题切记一定要背著名的思维导图，做一做历年卷。虽然最后我被商品经济干趴下了，但是其他的内容我觉得我还是答得不错的哈哈哈。
220423,1112,吴旭平,2025-06-18 02:13:08,2,2,0,满绩感恩
220621,1112,吴旭平,2025-06-19 03:02:19,0,0,0,利益相关，满了感激。卷子完全不本本主义，主要考核理解而不是死记硬背，理解了原理做的很轻松，上课也覆盖了考试内容。\n\n吴老师上课幽默风趣入木三分，深入浅出，很好的融合了知识理解、课外内容和课程考核内容，复杂的哲学概念也能轻易理解，工科生上课欢乐程度堪比刷B站知识区。
220684,1112,吴旭平,2025-06-19 08:14:48,0,0,0,马原H总评92，老师神中神！上课也很好玩，就是辩论输了扣的平时分要用回答问题弥补对社恐人士不太友好，感觉正反方抽签对结果影响还是蛮大的。不管怎么说马原选吴老师就对了！！
220735,1112,吴旭平,2025-06-19 11:35:12,0,0,0,wxp 真是我的爹😭
221119,1112,吴旭平,2025-06-21 10:34:00,1,1,0,社发给分看运气，运气好4.5，运气不好4.2
221947,1112,吴旭平,2025-06-27 14:56:09,0,0,0,伟大，无需多言。wxp你就是zju马院的太阳
222045,1112,吴旭平,2025-06-29 07:11:57,0,0,0,社发史给分没有之前说的那么好\n\n马原多卷卷平时分吧（不习惯当众发表自己观点的同学可能不太合适）\n\n不过有时间精力听老师讲课的同学还是可以选的
3160,1121,章前明,2015-05-18 05:25:42,38,49,11,确实是章前明的课
3416,1121,章前明,2015-06-11 07:54:46,12,21,9,害怕\n\n\n\n
3758,1121,章前明,2015-06-17 03:26:14,25,29,4,有一种分分钟撞墙自尽的感觉
5703,1121,章前明,2015-07-09 07:40:56,35,37,2,老愤青 脑子不大拎得清
6196,1121,章前明,2016-12-28 14:20:34,61,72,11,身为小组长，点名都到，回答过问题，展示过两次。最后只给了78，就这么跟学生过不去？
6329,1121,章前明,2017-02-27 09:14:34,-151,28,179,满绩路过。在可量化部分竭尽全力还是可以拿高分的
8080,1121,章前明,2015-09-17 02:28:12,5,7,2,呵呵呵
8436,1121,章前明,2015-09-21 08:37:59,7,11,4,和呵呵
10058,1121,章前明,2015-11-15 06:00:25,13,16,3,上课一直呵呵呵，不知道在干什么
11025,1121,章前明,2015-11-24 02:10:36,8,10,2,自我感觉良好。
11251,1121,章前明,2015-11-26 02:01:22,9,10,1,极差无比
13954,1121,章前明,2016-01-03 02:50:55,3,7,4,呃冒死选了他
19999,1121,章前明,2016-01-26 01:06:10,-37,7,44,平时分完全小组长给。如果你能做到发言数量和质量俱佳，老师会记住你然后提醒你的小组长给你打满分。点名很水可代签。讲课一般，这门课全是展示他又能讲些什么
20584,1121,章前明,2016-01-28 15:52:58,22,36,14,在浙大碰见的最垃圾的老师，讲课无逻辑无内容。深受tg宣传荼毒的老精分。
21628,1121,章前明,2016-02-29 11:00:29,2,5,3,博导啊！！！！
21791,1121,章前明,2016-03-01 06:14:36,9,12,3,全班集体发言表示听不懂他在说什么
23311,1121,章前明,2016-03-24 05:23:14,9,10,1,这老家伙。。。白痴
23687,1121,章前明,2016-04-12 08:37:29,3,5,2,这老师闲事管的多
25445,1121,章前明,2016-05-19 08:56:36,1,2,1,差评\n\n听不懂\n\n
29185,1121,章前明,2016-06-29 10:57:44,3,3,0,差评！
30336,1121,章前明,2017-02-27 09:14:28,-164,10,174,这老师太差劲了，虽然我平时什么都不做，但是也不能只给4.2啊
42935,1121,章前明,2017-01-15 12:39:56,6,8,2,啥玩意儿 口齿不灵清就算了 脑子也有点
42936,1121,章前明,2017-01-15 12:40:11,2,2,0,？？？
42939,1121,章前明,2017-01-15 12:41:30,22,25,3,为什么不能给零分呢 这种老师 上课不知道讲什么 给分又差 人又膨胀 还说自己有很多房子哈哈哈哈
42940,1121,章前明,2017-01-15 12:44:11,1,3,2,为什么没有0分
43154,1121,章前明,2017-01-16 01:16:27,1,3,2,呵呵呵呵
46479,1121,章前明,2017-01-22 00:42:11,3,5,2,厉害了
48017,1121,章前明,2017-02-28 05:17:32,2,5,3,瞎BB
51661,1121,章前明,2017-06-08 05:34:36,1,3,2,什么都不让干，除了听课，真是醉人……
55201,1121,章前明,2017-07-01 03:36:57,0,2,2,……别选他的，，，别选…
55461,1121,章前明,2017-07-01 14:03:33,0,1,1,我只能呵呵了
59047,1121,章前明,2017-09-19 08:06:10,2,5,3,笑死我了，最后两个近100的差评显示了大家对于婊砸极度的愤怒hhh
59428,1121,章前明,2017-10-20 20:43:43,12,14,2,能放一个五毛版《中美这七年》给学生讨论然后强行归纳我国制度优越性…重点是后面的讨论方向越来越歪了（手动滑稽）我觉得还是自己抽空多看看毛选比较有营养，绩点尽人事听天命吧，谁知道这老师会不会再给篇地摊文出来的结论当课题呢（摊手）
60170,1121,章前明,2017-10-12 05:42:54,0,3,3,章老师的观点的确朽的可笑，歪的可笑。
65764,1121,章前明,2018-01-09 05:07:28,4,5,1,要不要上课自己弄不灵清，一波四折，搞出个教学事故
65766,1121,章前明,2018-01-09 05:10:18,6,7,1,课前半小时分钟说今天的课取消，结果课前十分钟说今天上课。
65769,1121,章前明,2018-01-09 05:16:13,6,7,1,听老师的课是怎样一种体验？\n\n没体验
74839,1121,章前明,2018-03-06 05:34:55,2,3,1,1+1=2什么鬼。。
76119,1121,章前明,2018-03-27 08:35:12,2,3,1,你最好不要有不同的意见，章老师不会有耐心听。
81926,1121,章前明,2018-07-06 13:25:35,-6,1,7,其实，老师从来不点名是真的。平时要多发言，他的平时分在所有毛概老师里给分算很高的了。至于期末考试难道不是要看自己吗？
82308,1121,章前明,2018-07-07 23:54:36,7,7,0,太坑了，均绩哪里有3.5。。。我问同学都没3.5，上课自以为是也就罢了，给分还这么烂，你可拉倒吧，全校毛概就你课选不满，谁爱选谁选，绩点没人给你负责。老师加油，争取哪一年学生就选满你的课了。拜拜！再也不见！
82353,1121,章前明,2018-07-08 03:23:07,12,13,1,大家好好想想吧，查老师一点几分是有原因的，只有这个老师的毛概选不满也是有原因的
82390,1121,章前明,2018-07-08 05:10:38,36,44,8,我就搞不懂为什么学校要把毛概这种大思政课放在工科的专业课绩点里计算。是觉得我们这些高中三年，大学两年从不写政治卷子的同学，能跟文科生站同一起跑线上？
82587,1121,章前明,2018-07-08 14:54:05,-12,1,13,看到学习帝均?一点几认真的吗……
87940,1121,章前明,2018-10-18 06:27:11,0,3,3,感觉讲课还是可以的
92660,1121,章前明,2019-01-03 11:23:46,-30,10,40,老师关于中国的现状想法很有洞见。是我在这个时代见过为数不多的没有受白左思想荼毒的人了。尽管给分不是很好，但是还是很有收获。上了他的课才明白我国政治制度的优越性。决定从一名精致的利己主义者蜕变成一名无产阶级战士。如果你不是很在意分数，并对中国特色理论特别感兴趣，推荐选他。
103925,1121,章前明,2019-03-07 09:17:10,7,7,0,在我对不上老师名字和脸之前我还觉得他是扬冀辰，所以听课也没什么偏见的听。感觉认真听真的还好，有内容，也可以看出老师对毛概的热情和理解。
112503,1121,章前明,2019-07-04 14:56:43,0,0,0,一般般吧
116309,1121,章前明,2019-09-08 02:37:38,2,3,1,哈哈哈\n\n
124330,1121,章前明,2020-06-29 09:10:09,1,1,0,内容讲的还行，不过习概这个东西吧，大家都懂的，没必要认真听，或者说认真听了也大概率学不到什么有用的东西。还有这老师给分好像不太行，大三保研决赛圈可能会受影响。
126769,1121,章前明,2020-10-19 13:46:32,2,3,1,淦，上台发言要求脱稿，组长逼上台 我太难了
131761,1121,章前明,2021-01-28 21:53:30,3,3,0,给分极其畜生，甚选
131764,1121,章前明,2021-01-29 00:01:20,15,15,0,放弃幻想 准备考研 谢谢老师让我早做决定
131918,1121,章前明,2021-01-29 09:57:40,2,2,0,思政课最低绩点，分低是有原因的，慎选
132110,1121,章前明,2021-01-30 10:33:07,3,4,1,fuck
141795,1121,章前明,2021-10-26 06:32:43,3,3,0,沙暴一个
143131,1121,章前明,2021-11-19 13:40:56,5,10,5,给10分，绝对良心老师！已经改邪归正了！
148240,1121,章前明,2022-01-12 02:51:28,5,9,4,改邪归正，给分巨好。21年秋冬毛概（
156823,1121,章前明,2022-06-21 04:50:18,0,9,9,绝对好老师，给分改变很大
156863,1121,章前明,2022-06-21 07:50:53,8,11,3,真的是好老师，给分很好！！！\n\n教学方面反正都是合班课为主，老师没什么太大关系的（虽然估计也没多少人会好好听）。\n\n之前可能是分太低了都没人选，班里人数很少，反而大家都不恶性卷，课程体验很好！\n\n22春夏留
165116,1121,章前明,2022-12-30 11:18:47,8,13,5,章笑子太多了&怎么没有0分这个选项 不能再多了
174190,1121,章前明,2023-06-07 07:26:05,2,3,1,懂的都懂
174665,1121,章前明,2023-07-05 10:01:36,26,29,3,章老师，您的给分真的是不想让同学们好过啊，那我们也只能去教务处给您投上宝贵的投诉票了。我不相信我们班的同学平均素质就比别的班低2-3档，但是您在成绩上的体现是这样的，平时分比别的班低10分，改卷卷面也比别的班同学要低（或许也有可能别的班同学有些加分机制吧），但是这份师生情我算是看透了，会让您有事情干的，反正我一个边缘人因为这门课已经没书读了
179088,1121,章前明,2023-08-27 14:28:39,8,10,2,好个啥子，快跑
180290,1121,章前明,2023-09-21 03:16:19,59,60,1,希望23秋冬的同学们看到这条，大家都不要恶竞吧，毕竟咱也只剩这么多人了竞争估计也不激烈了，每次做个PPT就这么过去吧，已经选不上好老师了那干脆还是让这个课程全程过得舒服一点吧，tmd，看到的孩子们顶顶我
185820,1121,章前明,2024-01-04 15:27:01,2,4,2,sb一个
189463,1121,章前明,2024-01-24 11:56:17,4,7,3,2023-2024学年的秋冬学期上了章老师的毛概课，最后成绩真的很好。感觉章老师平时课上讲的很认真，点评得也很到位，会真的教我们如何写好一个调研报告，也会告诉我们要怎么完成一个好的展示。很多重点老师会着重强调（虽然我也没听嘤嘤嘤）。平时分的话会给小组一个平均平时分，我们小组是91，班上最高的，确实比其他班的好像要低一些。如果你也选了章老师的课，建议你能当小组长就当小组长，这样平时分会高一点哦。
189668,1121,章前明,2024-01-26 13:39:58,9,9,0,能不选就不选，选上了也别难过，还可以，我们班平时分最低87，最高91（相较其他班比较低了，听说有的班最低93）然后小组内部分配分数。\n\n应该不会调分，求是，其他老师如果考太差可能还会调调平时分。\n\n平时老师会提问，基本没人回答，回答会有加分，不想听课就两次展示的时候问问题，也会有加分。
190549,1121,章前明,2024-03-08 03:37:55,7,7,0,上课挺激情，除去给分我觉得还行
190592,1121,章前明,2024-03-11 02:29:09,-2,2,4,给分挺好的啊，就是单纯的不调分。我们班小组基本上在91-93没什么差距，组内自己分配的，最后考试靠自己。
196285,1121,章前明,2024-07-02 23:25:10,7,7,0,23春夏 感觉老师给分貌似变好了…？期末卷面应该不高平时分92但是给了4.5
196307,1121,章前明,2024-07-03 00:42:09,8,8,0,老师很好啊，给分也很棒，建议来！
196344,1121,章前明,2024-07-03 04:04:22,6,6,0,给分挺好的，平时分小组分配完89，考完最后成绩是90
196354,1121,章前明,2024-07-03 04:58:20,6,6,0,24年春夏班的来了，客观的说一说吧\n\n先说给分，平时分是组内分配，分锅时积极一些就不会太差，我是91\n\n期末考我们这次的卷子比较恶心，感觉卷面分很低，最后绩点4.2/88，已经很满意了，老师应该有捞\n\n上课的话，如果不听的话其实哪个老师都差不多，章老师会突击点名，没啥事的话还是尽量到课\n\n总结就是章老师比我想象中好一些，大家不敢选他的时代可以结束了
196816,1121,章前明,2024-07-05 09:27:49,7,7,0,章老师真的不一样了，给分很好！
400,1143,朱培霞,2015-03-15 01:57:09,10,22,12,虽然讲的不太好，但是人很好，给分挺好！她上课还会推荐书，期末为了正态会被迫点几次名。。。
1324,1143,朱培霞,2015-03-21 23:58:02,7,24,17,超级水的史纲老师，没有之一……
1554,1143,朱培霞,2015-03-22 12:25:18,12,24,12,讲课差
1595,1143,朱培霞,2015-03-23 00:56:20,53,102,49,人很好，但是满脑袋马克思主义唯物史观，而且我看得出来她是真心相信的……
1626,1143,朱培霞,2015-03-23 02:31:36,39,70,31,伦理学毕业挺通情达理的 布置作业啊点名啊作为她政治任务也是干的  上课对理科生很宽容 期末给分也还好 上课嘛史纲大水课她这样的老师其实算不错了
1791,1143,朱培霞,2015-03-25 02:15:52,75,141,66,水平确实不高，听她的课确实不爽。
2408,1143,朱培霞,2015-04-29 07:30:44,41,60,19,太水了....感觉学不到什么有用的
2624,1143,朱培霞,2015-05-05 00:46:13,6,15,9,上课超级水，给分又不好
2664,1143,朱培霞,2015-05-05 04:30:42,9,34,25,对历史没有任何自己见解。说话时嘴型也很奇怪。一个劲儿的让学生起来答。要你老师干啥
3573,1143,朱培霞,2015-06-17 01:39:16,16,25,9,讲课水平不够
3592,1143,朱培霞,2015-06-17 01:45:28,6,12,6,一点意思都没有，感觉老师有自己装b倾向，而且说话逻辑有的混乱，话比较多讲课听着很无聊，而且不由自主烦躁
4209,1143,朱培霞,2015-06-18 06:17:36,3,6,3,听不进去
4211,1143,朱培霞,2015-06-18 06:28:15,44,84,40,已经没法形容了。老师 回家写论文吧。不要教书了。简直降低浙大思政老师水准。
4251,1143,朱培霞,2015-06-18 10:45:13,3,8,5,喜欢点名，超级坑。
4693,1143,朱培霞,2015-06-26 05:47:16,18,30,12,虽然课一般般但人还是很和善的
4921,1143,朱培霞,2015-07-01 03:31:06,9,12,3,拿本高中历史书会比听课有用清晰得多
5043,1143,朱培霞,2016-09-13 15:16:17,37,59,22,自己都说了自己讲得不好………
5236,1143,朱培霞,2015-07-06 03:21:51,2,5,3,呵呵
5237,1143,朱培霞,2015-07-06 03:22:25,3,12,9,坑就一个字
5865,1143,朱培霞,2015-07-09 15:54:23,14,22,8,老师课讲的一般 人很好的。
6595,1143,朱培霞,2015-07-16 04:28:48,0,12,12,挺好的老师，很亲切
6674,1143,朱培霞,2015-07-18 04:11:37,3,14,11,能不在浙大拉低浙大思政老师的平均水平嚒！
7042,1143,朱培霞,2015-08-31 22:40:46,6,14,8,假大空
7329,1143,朱培霞,2015-10-13 01:50:20,-2,4,6,很好，比较水
7549,1143,朱培霞,2015-09-15 03:21:21,3,9,6,刚上 水爆了 不知道再说什么
7623,1143,朱培霞,2015-09-15 06:44:15,26,42,16,老师人确实不错，但，貌似真的听不下去啊，感觉水
7931,1143,朱培霞,2015-09-16 07:07:46,7,12,5,太水了。老师本身很没水平，对历史没什么见解。评分什么的也没有自己的判断。
8114,1143,朱培霞,2015-09-17 05:20:09,4,6,2,蛮水的
8152,1143,朱培霞,2015-10-08 05:40:32,-10,9,19,垃圾，麻痹不知道在讲什么，滚回家去吧
8162,1143,朱培霞,2015-09-17 07:35:40,0,8,8,还不错
8746,1143,朱培霞,2015-09-25 07:09:58,2,6,4,不咋地
8948,1143,朱培霞,2015-10-04 00:52:18,4,6,2,讲课水平真的太糟了。
9043,1143,朱培霞,2015-10-11 08:19:59,-1,5,6,毕竟不是绩杀，听听也不错
9082,1143,朱培霞,2015-10-12 11:51:22,0,5,5,负责的老师
9105,1143,朱培霞,2015-10-13 05:19:39,0,4,4,大水，水平太差。
9164,1143,朱培霞,2015-10-15 02:42:31,-2,3,5,水平不行啊
9174,1143,朱培霞,2015-10-15 06:01:25,0,3,3,困啊困啊
9222,1143,朱培霞,2015-10-18 01:29:59,2,8,6,反正我翘了她的课去听同时段的赵晖啦
9920,1143,朱培霞,2015-11-12 16:42:49,-6,6,12,我不知道浙江大学思政老师应有的水凭是什么样，但是上课把逻辑思维拿出来看，然后讲一些他说的好之类的话，是不是显得自己水平太低了
10123,1143,朱培霞,2015-11-16 11:55:57,-3,1,4,全程看韩国欧巴～
11920,1143,朱培霞,2015-12-21 10:38:50,-10,4,14,辣鸡老师
12293,1143,朱培霞,2015-12-23 01:05:07,5,8,3,你可以在她的课上很水，虽然老师讲课确实不好，但是为人很好，还是不错的
12611,1143,朱培霞,2015-12-23 15:22:46,0,5,5,不错，老师人很好啊，还请吃饭，好，不错，人挺好的，幽默。
12627,1143,朱培霞,2015-12-23 15:58:03,-4,1,5,
13106,1143,朱培霞,2015-12-25 01:57:44,0,5,5,明明很好，不听可以干自己的事
13195,1143,朱培霞,2015-12-25 06:32:33,-3,0,3,挺好的  讲课十分呵呵
14140,1143,朱培霞,2016-01-05 01:49:56,21,34,13,人实在太好了
15324,1143,朱培霞,2016-01-25 09:06:22,-1,5,6,垃圾老师毁我青春
19620,1143,朱培霞,2016-01-25 03:11:18,-2,6,8,反正我觉得给分很好，不像某些思修老师论文明明写的很好考试也很认真分数还要看发言啦报告啦感想啦每节课点名啦水课这样已经不错了差评的你还真的以为自己历史专业的？\n\n
19625,1143,朱培霞,2016-01-25 03:23:50,0,3,3,人很好，上课水，但是轻松啊，水平怎么样也不管，本来史纲也就没什么人听课。
19702,1143,朱培霞,2016-01-25 06:22:03,1,2,1,给分低啊
19742,1143,朱培霞,2016-01-25 08:11:37,1,4,3,虽然老师讲的不好 但给分真的不错
19748,1143,朱培霞,2016-01-25 08:23:55,8,13,5,好老师 给分高
19791,1143,朱培霞,2016-01-25 09:21:03,1,4,3,课上的一般，人超级好，很和善，希望老师可以上的越来越好\n\n
19810,1143,朱培霞,2016-01-25 10:08:15,4,9,5,不是很懂她的给分，我发过两次言，考的也觉得不错，但是分数真心不好看，比一些上课不发言的同学还低
19843,1143,朱培霞,2016-01-27 02:04:08,0,1,1,只能说不知马上去讲思修是怎样一番酸爽的体验...是刚真的是受够了
19850,1143,朱培霞,2016-01-25 12:09:26,-4,2,6,绩杀！！！！
19913,1143,朱培霞,2016-01-25 14:20:40,4,6,2,讲得不好，但老师人很好，给分也不错，史纲这种水课这样就挺好的
19938,1143,朱培霞,2016-01-25 14:53:09,-2,0,2,：） \n\n
19990,1143,朱培霞,2016-01-27 02:58:20,-1,2,3,真心不错，虽然我没听过
19995,1143,朱培霞,2016-01-26 00:56:54,5,5,0,上课有些无聊，给分还可以
20198,1143,朱培霞,2016-01-26 13:38:55,2,6,4,老师让我史纲4.8，谢谢老师！
20597,1143,朱培霞,2016-01-29 00:24:23,2,4,2,对学生很好
20862,1143,朱培霞,2016-02-02 14:21:49,-1,0,1,太水了
21060,1143,朱培霞,2016-02-14 04:39:28,2,4,2,上课确实还可以改进一下哈，觉得老师好像有点沉浸在自己的世界里，很难跟上老师的逻辑，可能是我自己的问题，不过老师人真的挺好的。
21422,1143,朱培霞,2016-02-28 23:47:10,6,6,0,觉得老师人真的很好，我们去考试不交白卷她都会想办法让我们过
21489,1143,朱培霞,2016-02-29 04:48:40,-4,4,8,烂，无以复制的烂，上课不知所云，逻辑混乱，关键是考试从来不给题库or重点，问什么都是不知道，唯一一个上完课还不知道老师叫什么的，一个学期只上过三次课。
22024,1143,朱培霞,2016-03-02 06:04:41,-3,2,5,我要疯了，全都是【诶我们思修课上巴拉巴拉……】  然而这是史纲啊！！！！！！！！！！！真！！的！！！要！！！！疯！！！！了！！！！
22322,1143,朱培霞,2016-03-03 15:02:08,-1,3,4,上课适合睡觉，但声音太大影响睡眠
22584,1143,朱培霞,2016-03-08 07:16:22,2,4,2,人好是还挺好的，问题是讲课真心差啊...逻辑混乱毫无重点，想听课都觉得浪费时间。
25615,1143,朱培霞,2016-05-29 10:27:00,2,4,2,人很好
26011,1143,朱培霞,2016-06-15 04:32:23,-6,2,8,浪费青春
31514,1143,朱培霞,2016-07-04 04:52:16,-6,3,9,浙大怎么会要你这样的老师？？
31520,1143,朱培霞,2016-07-04 05:00:41,3,4,1,上课很水…作业也很少…给分还不错
31557,1143,朱培霞,2016-07-04 06:22:04,-1,2,3,给分挺好的，但，讲的真心很烂
31562,1143,朱培霞,2016-07-04 06:31:42,2,3,1,水还是真水...我是基本没听课...上课水，对我们也水。给分因人而异，考试拼手速。反正选择没什么人对
31584,1143,朱培霞,2016-07-04 07:17:34,-9,1,10,傻逼不解释
31676,1143,朱培霞,2016-07-04 12:47:31,3,4,1,老师的讲课水平一般，但是人很好，很体谅学生，这学期每次都提前下课让我们早点去吃饭，也不要我们写论文。\n\n思政类的课能这么省事水过也不错啊
31699,1143,朱培霞,2016-07-04 13:54:45,4,6,2,讲课确实有点无聊，但是给分浓浓师生情……谢老师！
32571,1143,朱培霞,2016-07-08 00:43:59,5,7,2,老师人真挺好的
32683,1143,朱培霞,2016-07-09 09:56:50,2,4,2,给分不好，但事少挺好的
33501,1143,朱培霞,2017-01-17 10:16:38,-22,1,23,辣鸡老师，一分不想给
33502,1143,朱培霞,2016-09-27 00:59:57,-4,3,7,谁说的老师事情少？思修课事情多的跟什么似的而且逻辑不清话说不清楚自以为上课很充实exm？
33583,1143,朱培霞,2016-09-20 07:19:47,-1,3,4,挺好的 很开心 能学到一些东西的
33606,1143,朱培霞,2017-01-21 11:14:34,19,38,19,看了评论，可能老师不适合史纲，但是作思修老师我觉得朱老师超级棒的，群里还经常卖萌，上课有时候特别搞笑，也经常会提前下课，论文原题多，也会给脱ddl，给分也特别好，发过言应该能上4吧，真的好。
33815,1143,朱培霞,2016-09-22 01:57:10,3,4,1,很风趣啊…
34102,1143,朱培霞,2017-01-17 14:44:18,2,6,4,好老师，值得推荐
34231,1143,朱培霞,2016-09-29 02:13:15,-2,2,4,你是来搞笑的吗？
34452,1143,朱培霞,2016-10-11 02:13:17,-4,0,4,真的水平太低 讲话没有条理 东一句西一句\n\n俗\n\n且自尊心很强
34527,1143,朱培霞,2016-10-13 00:52:40,-1,2,3,原本不打算给差评的，可是，课讲成这样，居然还没有课间，
34529,1143,朱培霞,2016-10-13 01:17:45,-1,2,3,水平不是很高的一位思修老师，第一次教思修，反正水过来了\n\n
35612,1143,朱培霞,2016-11-10 07:33:20,5,7,2,没什么实质性的内容，但是老师人不错
35619,1143,朱培霞,2017-01-03 09:54:52,-9,0,9,腊鸡老师，
35768,1143,朱培霞,2017-01-05 03:11:07,6,8,2,人好，课水。感觉课上睡觉对不起老师，但不睡觉对不是自己。
36067,1143,朱培霞,2016-11-10 11:28:48,-6,0,6,无聊死了，不过没什么作业。
36289,1143,朱培霞,2016-11-11 13:37:48,5,8,3,老师和蔼可亲，比较开朗，对人好啊 真的很不错哟
36571,1143,朱培霞,2016-11-15 02:25:31,-9,1,10,没水平
38283,1143,朱培霞,2016-11-29 07:28:16,4,7,3,其实老师人很好的，不知道为什么分数那么低
39282,1143,朱培霞,2016-12-22 02:27:08,7,10,3,老师还好啊，看得出来是大爱伦理学，认真听讲课挺有意思的，不要因为自己不听课说老师不好！
40078,1143,朱培霞,2016-12-29 05:45:48,20,29,9,老师很好的，下面的评论不知道是怎么回事。\n\n就单说作业吧，作业都可以拖到最后一周交甚至单独一个时间交，老师也不会怪你。圣诞节的时候老师还特别暖地祝我们节日快乐。真的很棒！
40478,1143,朱培霞,2017-01-03 14:30:20,-1,1,2,思修够水
42734,1143,朱培霞,2017-01-17 10:47:21,16,26,10,老师上的思修课给分非常暖啊，对我这种人真是雪中送炭
42758,1143,朱培霞,2017-01-17 08:49:13,2,4,2,给分还不错
43386,1143,朱培霞,2017-01-17 17:52:04,16,27,11,好奇了   这么好的老师为啥评分这么低 。  朱老师给分真的超级好  只要上课回答问题次数不是零
44056,1143,朱培霞,2017-01-17 08:49:54,10,15,5,老师人很好的，很善良，群里还会卖萌很可爱~虽然思修是一门水课，但是老师作业一点都不多，认真复习考试绩点没问题呀！爱老师！
44058,1143,朱培霞,2017-01-17 08:50:47,17,30,13,老师人很好呀给我们上的思修课也没有传说中那么无聊 期末了还会给你发言的机会让你刷平时分（尽管我并没有发言）笔芯❤️
44061,1143,朱培霞,2017-01-17 08:53:15,4,6,2,老师上课一般，人很好，尽管上课有些无聊，但事情还算少，而且老师挺通情达理的。给分也中规中矩，水水过还是容易的
44064,1143,朱培霞,2017-01-17 08:55:05,8,10,2,她很搞笑，人很好，思修讲的还不错，给发也好。
44087,1143,朱培霞,2017-01-17 09:06:45,10,13,3,也许她作为史纲老师讲课不怎么好，但转去思修之后在思修里算很不错的了，能看到她备课的努力，给8分表示鼓励。另外给分也不错。
44093,1143,朱培霞,2017-01-17 09:12:27,14,20,6,老师讲的入情入理，跟学生的关系很好，平易近人，通情达理，适合思修这种思政课程，同学们都觉得给分好。虽然上课我都水过去了，但是现在真的感谢老师。
44097,1143,朱培霞,2017-01-17 09:19:38,14,31,17,事情很少，理科生4.5，狂笑不止。老师上课很亲切，偶尔会点名回答问题（不过回答问题会加平时分），还会积极鼓励我们上课发言，很好的老师！
44112,1143,朱培霞,2017-01-17 09:38:47,8,13,5,老师蛮有趣的呀，有时候很逗比的，给分好～
44174,1143,朱培霞,2017-01-17 11:23:40,-15,1,16,绝望的老师，给分还很低。虽然我没有听过课。不过听课估计也不顶用吧。
44175,1143,朱培霞,2017-01-17 11:25:11,7,7,0,不错的老师，上课很有趣。
44198,1143,朱培霞,2017-01-17 11:53:26,22,32,10,挺好哒，思政军体课不都一般水嘛，老师给分挺好哒，最重要的是人挺善良的，都是水水为什么不选她咧？
44272,1143,朱培霞,2017-01-17 13:52:32,15,18,3,讲道理 老师人还是很好的 上课想尽方法让我们活跃起来 但是大家都是想水水过嘛 平时事也不多 老师和同学们也聊得来 老师考虑到期末大家复习比较紧张 给大家的论文ddl一拖再拖 真的很人性化 成绩低也怪不了谁 如果平时任务完成质量高的话也不会被正态很低吧 正态的残酷你我都懂 怪不了老师
44403,1143,朱培霞,2017-01-17 21:29:21,7,8,1,喜欢喜欢喜欢！老师上思修会给我们放小视频之类的，很和蔼的老师！给分也很好！
44446,1143,朱培霞,2017-01-18 00:09:04,3,6,3,很棒的老师。经常无意萌到同学。上课也蛮有趣的，任务不算多，论文选题很宽。给分很好。
44834,1143,朱培霞,2017-01-18 10:34:55,2,3,1,老师人很好～虽然事情有点多但是给分还是不错的
44934,1143,朱培霞,2017-01-18 14:26:42,6,7,1,老师特别好，给分很好
45015,1143,朱培霞,2017-01-18 23:51:00,8,11,3,平时课堂上有一个问答的环节  多举手多回答 她不划重点 期末考自己扫一遍书 差不多就可以满绩了
47310,1143,朱培霞,2017-01-25 07:27:16,6,7,1,老师很认真
47774,1143,朱培霞,2017-02-24 08:47:11,5,7,2,思修教的是真的棒！
52175,1143,朱培霞,2017-06-15 11:13:50,5,6,1,很舒服，很轻松
59293,1143,朱培霞,2017-09-20 13:27:15,4,4,0,老师很活泼2333
59401,1143,朱培霞,2017-09-21 06:48:14,4,5,1,挺好老师，第一节课就像是
59416,1143,朱培霞,2017-09-21 08:13:10,7,8,1,这个老师以前教史纲，现在改教思修。\n\n个人感觉，老师的气质真的不适合史纲，对于思修还是很合适的，毕竟老师不是那种偏严肃的人。\n\n打分还可以。
59424,1143,朱培霞,2017-09-21 08:57:43,4,6,2,口音有些奇怪，但是讲课还是蛮有意思的，蛮幽默。
59808,1143,朱培霞,2017-09-27 06:32:30,13,19,6,老师15年的评价已经过时了，老师有进步了，她也自己说了，以前水平差，不会说话。讲课有意思，因为年轻，所以聊的起来。很不错老师
59871,1143,朱培霞,2017-09-28 03:21:15,5,5,0,非常好
59919,1143,朱培霞,2017-09-28 07:26:25,-4,1,5,没有收获，太水了。
60184,1143,朱培霞,2017-10-12 08:36:31,-4,1,5,上课真的水，不知道在讲什么
61965,1143,朱培霞,2017-11-22 03:17:31,4,4,0,老师人挺好的
61974,1143,朱培霞,2017-11-22 03:55:44,-4,0,4,三个字
64115,1143,朱培霞,2018-01-16 07:44:01,5,6,1,老师很好
64632,1143,朱培霞,2017-12-25 16:41:50,13,16,3,想传授知识与信仰，首先需要自己的坚定，觉得朱老师就是这样的人。讲的不错，事不多，可能会有一丢丢水。但认真听肯定有很大收获。（为什么热门评论都是15年的，这样对认真改善自己的老师很不公平诶）
64892,1143,朱培霞,2017-12-27 16:45:59,3,5,2,其实感觉朱老师挺好的，人也很善良的。虽然上课的确不是很有意思，但能感受到老师是真心对生活有自己认识的，也希望教会我们一点东西的。\n\n
65069,1143,朱培霞,2017-12-28 13:09:31,17,22,5,上的思修 还没上完看到评论区忍不住说一下，单纯的以一个理科生的角度看问题，我想说这门课本来不就没什么用的吗（想学到东西的同学别生气），我觉得思修老师本就应该给学生传播一些正面价值观，在这一点上朱老师的观念只能这么正这么积极了！而且，人好不解释，水平…这门课需要啥水平？水一水不好么？
65210,1143,朱培霞,2017-12-31 10:26:22,4,6,2,原话:思修就是大水课嘛，但是上善若水。我以为她很有水平，结果还是大水课。。
65350,1143,朱培霞,2018-01-03 07:56:43,-7,2,9,妈呀从来不讲课本就知道天南海北的扯\n\n佛学、闪米特邪教、法学都洗，甚至用了假例子（波茨坦磨坊）\n\n说她真心信马克思的那位开玩笑吧
66620,1143,朱培霞,2018-01-17 14:31:50,3,5,2,看了评论了，现在教我们的是思修，我就这么说吧\n\n因为下午就是大化实验，所以每次都带作业过去写\n\n结果没有一次按理想的完成了，因为上着上着就听课去了…( ･᷄ὢ･᷅ )\n\nps：感觉带完我们这几届评分会暴涨，因为讲得的确不错
66661,1143,朱培霞,2018-01-18 05:07:33,4,6,2,信我一句话，老师人真的很不错，真的真的很不错，
68317,1143,朱培霞,2018-01-23 03:19:53,2,5,3,作为思修老师给满分
70596,1143,朱培霞,2018-01-27 09:14:37,0,4,4,整天不知道在讲什么  我明明读书报告也做了作业也都加了上课也发言了结果绩点只有这么点 我也是没话说了
70624,1143,朱培霞,2018-01-27 09:56:46,3,6,3,给分贼坑
70839,1143,朱培霞,2018-01-27 15:22:31,1,5,4,老师人很好很善良啊，也挺幽默的啊，重点是压力小，任务也不多，给分也不错。反正思修课都是水过去的，选这个老师没错啊。
70850,1143,朱培霞,2018-01-27 15:40:20,3,4,1,人挺好的。
70855,1143,朱培霞,2018-01-27 15:48:47,-2,1,3,人还好，上课会跑到下面来调动气氛。但是我绩点爆炸了……
70871,1143,朱培霞,2018-01-27 16:03:39,1,5,4,上课水的不行，根本没有一个思政老师应有的表达能力和基本素养。整个课程的平时考评一团糟。努力一学期，期末被正态
70880,1143,朱培霞,2018-01-27 16:32:23,2,5,3,我啥都没做，上课就发了一次言，期末没准备，没做读书报告，小组展示被点名批评，本来已经不报希望了，结果绩点居然还不错，点赞！
70890,1143,朱培霞,2018-01-27 18:12:51,2,2,0,挺舒服
70897,1143,朱培霞,2018-01-27 22:55:21,2,5,3,绩点凉凉
70900,1143,朱培霞,2018-01-27 23:15:03,2,4,2,上的思修。努力发言了还做了展示，但是为啥绩点这么低?比那些完全没发过言的另一半人还低?等于说我辛辛苦苦一学期最后只配靠运气?
70902,1143,朱培霞,2018-01-27 23:37:32,1,2,1,老师人很好，给分也不错，思修课比较轻松。
70908,1143,朱培霞,2018-01-28 00:00:53,-2,1,3,老师人挺好哒，虽说上课可能一般，但是给分挺不错的，思修绩点简直令人惊喜。
70935,1143,朱培霞,2018-01-28 00:32:47,0,3,3,给分不错
70936,1143,朱培霞,2018-01-28 00:33:29,-2,3,5,作为思修课，真的超级轻松。平时没有什么作业，而且老师人很好，你没做好可以推迟一点交，老师不会怪你。上课多发发言，绩点应该不低了。
70939,1143,朱培霞,2018-01-28 00:39:34,-1,1,2,上课挺水的，平时多发言吧
70967,1143,朱培霞,2018-01-28 01:13:28,-2,5,7,上课体验极差，疯狂叫人回答一些无甚意义的问题，老师笑点奇怪，口音令人窒息。上课如果不发言，给分真的呵呵，坐等被正态吧。
70970,1143,朱培霞,2018-01-28 01:15:27,-4,1,5,水是水，给分很好吗?刷这么多脸也没有高的分，或许是我思想觉悟太差了吧。
70975,1143,朱培霞,2018-01-28 01:22:24,-4,2,6,上课很会提问，问题都很emmm，不过好像最后不看这些。什么都没干4.2绩点。可能思修课只能这样吧
71039,1143,朱培霞,2018-01-28 02:02:37,4,4,0,老师是真的好老师，至于课水不水，我只想说，要是课上刷手机，微积分都是水课。
71042,1143,朱培霞,2018-01-30 03:19:58,2,3,1,给分不好的可能考试崩了
71051,1143,朱培霞,2018-01-28 02:08:53,-2,3,5,要是有0分我绝对不打1分，讲课讲的不好，分还给的低。
71058,1143,朱培霞,2018-01-28 02:13:50,1,3,2,非常非常棒的老师，负责任，讲得好，可以与学生打成一片，最重要的是，给了一个我觉得配不上的分数！
71101,1143,朱培霞,2018-01-28 02:55:27,2,3,1,思想道德部分讲的还挺好 法律部分感觉有些仓促吧（不过我也不怎么听课...）事少给分好
71119,1143,朱培霞,2018-01-28 03:33:43,3,3,0,上课笑点奇怪，但人是好人。关于思想，道德，修养，个人觉得老师都在很好的践行。总之很感谢老师。
71122,1143,朱培霞,2018-01-28 03:39:55,2,2,0,人蛮好的，有尽力想讲好的感觉，可能这课就比较水吧……人不错！
71137,1143,朱培霞,2018-01-28 04:13:11,0,1,1,水了一学期，有3.9还可以了 ?
71144,1143,朱培霞,2018-01-28 04:32:12,0,0,0,老师上课还好。\n\n最后几次课点名提问。\n\n任务量正常。
71150,1143,朱培霞,2018-01-28 04:52:45,1,1,0,给分不好啊QAQ大概是上课不发言的原因 老师人还是不错的 事也不算多
71223,1143,朱培霞,2018-01-28 07:14:52,0,1,1,老师人好通情达理，有很多回答问题的机会加平时分，就不要吐槽问的问题怎么怎么样了，谁叫这是一门思修课。而且就算一学期不回答问题感觉也行还会在80左右吧。。
71268,1143,朱培霞,2018-01-28 08:24:06,5,5,0,是个好人，但不能说是好老师。
71283,1143,朱培霞,2018-01-28 08:42:51,0,2,2,很棒棒啦，虽然绩点emmm但是老师人挺好的，任务不多而且挺好说话，上课也会给我们看看小视频，推荐很多书。自己水了一个学期绩点也不能怪老师，总之没有前面说的那么糟。
71328,1143,朱培霞,2018-01-28 09:54:53,2,3,1,老师讲课确实不大吸引人，估计是课程原因，哎，
71383,1143,朱培霞,2018-01-28 11:22:17,-2,2,4,即使绩点最后还不错，我还是不能给她打高分。醉人的口音可以忍受，扯淡、佛曰xx的思想，真是宛如强奸一般的精神体验。
71482,1143,朱培霞,2018-01-28 13:46:23,-1,1,2,思修关键看平时分，然后我就gg了。老师平时事比较少，人不错，至于讲课，我也没怎么听过。
71659,1143,朱培霞,2018-01-29 00:13:49,2,2,0,。。。
71918,1143,朱培霞,2018-01-29 05:43:58,0,1,1,我全程划水，没啥感受，绩点3.9，勉强还阔以，但是我一表现很努力，每节课都争取回答问题，还做了读书展示，感觉必定满绩的同学被正太了。嗯，就酱
72017,1143,朱培霞,2018-01-29 08:12:45,2,2,0,老师人很好  可以给拖DDL  给分的话emmmmm感觉有一点迷
72032,1143,朱培霞,2018-01-29 08:40:37,2,3,1,不知道那些说她给分好的是些什么人，上课积极发言不下5次，读书报告认真写了5000多个字，绝对有自己的想法，期末考试主观题写的像小论文那么长，结果。。。。。成绩没上4。呵呵呵→_→，佛系给分法，我和她无缘。
72253,1143,朱培霞,2018-01-29 15:56:26,4,5,1,最后思修的绩点甚至没到均绩，但是读书报告，网课题目都是自己超级认真写的，还是挺失望的。\n\n除此之外，朱老师可能是刚开始教书？上课就是照本宣科的讲，时不时插一些自以为十分幽默的段子，但真的是一点也不好笑。而且老师情商超级低。。。我也很无奈啊
72560,1143,朱培霞,2018-01-30 11:25:57,2,3,1,逻辑确实很差，上课确实很烂，给分确实很低。
72570,1143,朱培霞,2018-01-30 11:42:39,7,8,1,思修最后小组展示的时候明明是老师自己课时安排有问题，导致最后几个小组没有时间展示，最后居然说没有展示会很影响平时分，所以你们平时分受很大影响。甩锅给学生。
72646,1143,朱培霞,2018-01-30 15:18:39,0,1,1,给分还行
72700,1143,朱培霞,2018-01-31 02:15:19,0,1,1,上课比较水，真的。思修课我真的都不听的，因为实在太水了。给分......反正我没上4。
73205,1143,朱培霞,2018-02-01 07:19:42,0,2,2,应该最后考试占了不少分吧，平时发言7次，做了读书报告，考试看了一遍书，背了大纲，选择题有些不记得了，大题写了不少字，最后4.5。。。应该还行吧。
73575,1143,朱培霞,2018-02-02 04:09:55,4,6,2,平时上课比一般人认真多了，发了两次言，读书分享也做了，作业也有好好做，结果才给83……哭唧唧
73637,1143,朱培霞,2018-02-02 08:08:54,2,4,2,我上课发言次数为0，不是说老师的课不好，是我真的不喜欢发言，想着如果因为没发言就没平时分我也认了，没想到最后给分还不错呀，老师挺好的
73841,1143,朱培霞,2018-02-03 08:42:06,0,5,5,上课去不去认不认真对成绩没什么影响，令人难过的事情是作为一个每节课坐第一排不写作业和老师认真交流的人最后绩点还不如上课坐在后排玩手机的人高，3分里2.9分给推荐的书目，0.1分给老师。
73948,1143,朱培霞,2018-02-03 17:51:53,0,3,3,上了老师的思修课。实话实说，课上有些无趣，但老师本人还是很温柔很认真的，下课可以和她讨论很多 虽然绩点比想象中略低，但还是给老师十分。
74719,1143,朱培霞,2018-03-05 09:02:47,-1,1,2,给分还可以
74751,1143,朱培霞,2018-03-05 12:10:26,-2,1,3,讲课水平实在一般，思想正的有些可怕。给分还不错，对学生挺好的。\n\n不点名。\n\n
75533,1143,朱培霞,2018-03-13 04:42:04,-13,2,15,口齿不灵，睁眼瞎……
75675,1143,朱培霞,2018-03-15 04:18:39,-3,1,4,。。？
75820,1143,朱培霞,2018-03-19 07:02:04,-5,2,7,大家小心了 可能你努力了一个学期就会因为这门课栽掉一半 老师非常随机 会因为很多其他因素耽误课程安排 最后还会给努力的你一个低分 所以上课之前一定把自己脸洗白一点 尽力做到不努力却被打高分的那一群
86976,1143,朱培霞,2018-09-20 00:26:26,0,2,2,非常有意思
87776,1143,朱培霞,2018-10-12 10:03:04,0,3,3,好可爱
88377,1143,朱培霞,2018-10-30 01:50:06,0,3,3,全是废话，不过这不能怪她，毕竟她教的课是那两门
88411,1143,朱培霞,2018-10-30 09:21:05,3,6,3,老师很不错啦，毕竟思修水课，老师也很努力的，给分挺好，人也很好，作业给我们拖ddl，太暖了
88909,1143,朱培霞,2018-11-12 05:52:09,2,5,3,老师其实还好，通情达理。不过讲课硬盒还拖课是硬伤，暂且给个9分
89124,1143,朱培霞,2020-01-13 11:16:45,0,11,11,垃圾。
91545,1143,朱培霞,2018-12-13 02:38:14,2,4,2,思修课是水课，但是老师讲的挺不错的，仔细听听真的有收获。不要把对于思修课的偏见转移到老师头上。
92950,1143,朱培霞,2019-01-06 07:48:15,1,3,2,和老师能聊得来
93003,1143,朱培霞,2019-01-07 01:17:46,4,7,3,很水，老师没什么时间观念
93046,1143,朱培霞,2019-01-07 06:12:53,4,8,4,朱老师是一个非常可爱非常有意思的老师，大家不应该把对于思政课的偏见转移在她身上鸭?
93047,1143,朱培霞,2019-01-07 06:15:19,8,12,4,\n\n朱老师风趣幽默，课堂氛围轻松愉悦～思修是一门水课，因为上善若水呀。老师对佛学有深刻的理解，看透人生。老师说，思修课上一定要学会一门修身的方法。静下听听，甚有道理。爱朱老师！
93470,1143,朱培霞,2019-01-10 02:32:16,8,9,1,课讲的可以，但是时间安排是什么玩意儿？
93907,1143,朱培霞,2019-01-14 08:06:10,10,13,3,水课，没讲什么内容，时间安排不当，双标，展示的时候超时的不打断，没超时的反而被打断\n\n
94157,1143,朱培霞,2019-01-15 10:50:55,5,10,5,真的超超超无聊，人也迷迷糊糊的，一有事就躲着不出来回应，老师这么喜欢躲就躲回家写论文去吧。
94160,1143,朱培霞,2019-01-15 11:03:19,0,5,5,自求多福吧 谁选谁倒霉
94562,1143,朱培霞,2019-01-17 08:18:35,5,6,1,很善良的老师，虽然上课水平有待提升，但是值得鼓励！
96006,1143,朱培霞,2019-01-20 11:01:46,4,4,0,有人去催催老师出分么
96630,1143,朱培霞,2019-01-22 15:12:17,29,36,7,赞同之前那位同学，先说绩点，3.9，从未逃课，作业好好做，但也没有特别拼，就这样。然后客观说说一个学期的感受。\n\n首先，学不到什么东西是真的。老师上课管自己high，也没有什么明确的逻辑线，导致课堂学生参与度极低。\n\n其次，恶竞问题。基本平时分都来自于小组展示，也正是因为如此，我也算是提前了解到仿佛社会的黑暗了吧。表面公正评分事实上明争暗斗，群里和和气气的发言背后都是对于其他组的贬低。花式让自己组分数高一些，方法也是层出不穷。各位组长可以扪心自问一下，给自己组打100的同时其他组最高80是什么心态？\n\n最后，时间观念。或者说，时间观念的欠缺也体现老师综合素质水平很一般（很一般往往指代一般偏下）如果说不能做到公平地让每一组拥有相同的展示时间与机会，就请您仔细反思自己的上课水平ok？\n\n\n\n说多了，可能确实也带了个人情绪了。总之，老师没有差到无可理喻，认为自己有足够的恶竞能力或者想要体验提前步入社会的明争暗斗的现场的，欢迎来选。真的不是劝退，通过足够的运气＋恶竞的实力（没错，没有学业水平的能力），你也能成为期末在群里发“谢谢老师”的一份子。\n\n个人观点，欢迎前来反驳。
96872,1143,朱培霞,2019-01-21 11:18:31,6,6,0,为什么还不出分
97671,1143,朱培霞,2019-01-22 12:57:01,-7,3,10,朱老师给分不错的，人也很好，发消息去求课件老师还很耐心帮我找了，作为一门思政课体验还算不错。
97683,1143,朱培霞,2019-01-22 13:25:42,2,2,0,感觉学不到太多东西
97689,1143,朱培霞,2019-01-22 13:36:12,13,16,3,老师挺一般的，我只是想分享一下思修课上的黑暗经历，老师的不作为加上拖堂使得展示上有很多不公平的地方，表面公平公正实际上暗地里鹅颈严重，这堂课让我看到了不少人为了绩点恶心的吃相，感谢老师，虽然思想并没有得到什么提升，但确实让我看到了人性真实的一面，来自一个表现平平但至少比某些天天逃课还拿4.2的选手态度认真的小透明
97696,1143,朱培霞,2019-01-22 13:41:55,24,24,0,垃圾，展示不控制时间。前两组展示一节课，最后一组两分钟，玩你?呢
97714,1143,朱培霞,2019-01-22 14:12:22,5,8,3,别选 绩杀
97717,1143,朱培霞,2019-01-26 06:29:55,6,9,3,我求求你们说明一下周几班哪节课的思修吧 我真的看晕了 笑死
97747,1143,朱培霞,2019-01-22 14:52:30,-17,4,21,哇哇哇老师给分出乎意料的好啊！水了一个学期，读书报告写的不是很好，也没有当组长，最后89分  4.5终于没有卡? 了啊啊啊啊     老师上课会讲很多自己的经历和心经大师的一些观点，很有涵养。老师人非常善良，真的是与人为善！喜欢喜欢！老师对待生活也是很正能量，真的超级棒的女神！
97748,1143,朱培霞,2019-01-22 15:00:16,12,15,3,每节课都有去，小组展示读书报告也认真做，没有当组长，最后就平平无奇的3.3。什么? ？
97751,1143,朱培霞,2019-01-22 14:54:37,-6,3,9,看得出来，老师上课还是很认真的，如果自己认真听课，真的可以学到人生道理（但是没有多少人听），总得来看，老师比我预期的好，虽然总喜欢讲佛教，虽然有些地方讲的不清楚，虽然小组展示控制时间不准……
97753,1143,朱培霞,2019-01-24 15:04:38,31,34,3,你们不要吵啦不要吵啦，打一架吧！你们每个人都说出了我的心声，帮我省了很多口舌，谢谢各位，骂同学也骂得好，怪老师也怪的精彩，希望以后没有学弟学妹选这个老师的课，思修，水的很开心，老师自己第一节就说了，水课，我想说，绩点高的别tm把自己当回事，明白人都知道这课没什么技术含量，绩点低的也别bb了，你tm还能让那个sb老师帮你重新改分数？一群小动作不断互相贬低的废物，不过也是，上课你们德行也就这样
97755,1143,朱培霞,2019-01-22 15:14:32,2,3,1,有情绪分在里面 都说老师人好 就是我的分特别低
97756,1143,朱培霞,2019-01-22 15:15:20,-8,3,11,上课确乎有点无聊但给分是真的好
97759,1143,朱培霞,2019-01-22 15:21:17,-1,2,3,分虽然不高，但是其实老师人挺好的，给分也不错，一学期大概点过3次名
97760,1143,朱培霞,2019-01-22 15:21:37,-3,2,5,给分还行，主要看小组
97761,1143,朱培霞,2019-01-22 15:30:59,-4,0,4,感觉像初中政治课？？\n\n
97762,1143,朱培霞,2019-01-22 15:32:03,-12,3,15,查老师就跟豆瓣一样越来越没法看
97763,1143,朱培霞,2019-01-23 07:52:25,2,15,13,我是昨天那个diss第一组的，我不是第八组的，具体哪个就不说了，我想说的是，按照前面那位仁兄所言，第一组时间被压了这么多，你们能怪第八组，难道不应该去质疑老师能力么？其次，你时间被压了这么多，做的这么仓促，比时间做的长的第八组，分高那么多，从客观角度来看就是最后一句给高分组长门门满绩的拉拢语直接有关，这就直接反映出学生权利太大，按照感情而不是事实给分，再者，我就是diss你第一组没有丝毫内容，各种掠过，搞笑呢，打水漂在？相比而言，第八组就是比你们有内容。他们的辩论确实很累赘，但是不像你们组那样直接把重点内容掠过反过去花时间打感情牌         我又不是第八组的，回答这个问题不应该最公正么？你们心里有点数就不会去踩我上一条回答。
97764,1143,朱培霞,2019-01-22 15:32:05,18,20,2,老师人总体上挺好的，但是展示的制度很有问题。总体上觉得赋予同学的太多权力去打展示分了，而且有些小组的展示时间被压缩的太过分了，希望老师看到之后能改变一下展示制度。然后有些同学的吃香真的太难看了，给别的小组打分完全出于主观情感。老师课上讲的‘慎独’，希望你们能好好学学。
97767,1143,朱培霞,2019-01-23 06:19:13,27,30,3,总结一下，上课不知道在讲啥，下课经常拖课，作业随你乱做，小组恶竞严重，学生权力太大，制度十分不合理，课堂展示随意打断。很ok！谢谢老师帮忙拉低绩点！很！9！8！o！k！\n\n老师：你尽管认真读！给的分高算我输！
97768,1143,朱培霞,2019-01-22 15:40:37,22,23,1,一言难尽。。首先，自己上课时间控制不合理，给每个组的机会其实是不公平的，其次，恶竞尤其严重。我佛了，没翘过一次课，读书报告和小组作业都认认真真完成了，除了小组里的人一切不配合外，最后得分还比每次迟到的人低。。。
97773,1143,朱培霞,2019-01-22 15:49:27,18,22,4,听课是没什么好听的，作业都交，期末考认真准备，小组任务也参与，最后3.3。真的谢谢老师帮我拉低绩点，真的！
97777,1143,朱培霞,2019-01-22 15:53:05,30,37,7,有点恶心-_-||\n\n别的老师没考试不说，还拼命捞学生\n\n你呢？
97783,1143,朱培霞,2019-01-22 16:01:42,12,15,3,有自知之明地认为是水课，给分过于随意，这是对待自己所授课的态度也随意吗？还是不在乎拉低的绩点对同学的影响？搞不懂? ? ?
97787,1143,朱培霞,2019-01-22 16:11:00,18,20,2,给分随意，没有时间观念，最后的付出与收获完全不成正比。选了她的课可以什么都不干，这样分可能还会更高一点。这样的老师除了被绩杀也没什么办法。。。
97799,1143,朱培霞,2019-01-22 16:48:32,0,3,3,。。。
97823,1143,朱培霞,2019-01-23 04:52:05,-16,8,24,给分的话，读书报告好像作用不大，要求1800，我写了2500左右，编不下去，但是给分也没公开，所以不知道效果如何，期末考选择题一般，简答题写了四开满满一面，感觉在分数上没有体现，主要看小组作业吧。4.2，超级感谢老师!
97841,1143,朱培霞,2019-01-22 23:44:04,-7,4,11,上课有点水hhhhh但是给分不错呀!
97843,1143,朱培霞,2019-01-22 23:46:25,-8,7,15,给分还不错啊。老师很善良。没当组长还有4.5。选个好组长很重要。期末考需要把书过一遍，对选择判断题很有帮助。
97854,1143,朱培霞,2019-01-23 00:14:55,-6,3,9,课，思修嘛……但是事情不算特别多，老师人很好，调分调得辛苦，思修嘛，不错了。老师自己也说这是水课hhh
97884,1143,朱培霞,2019-01-23 00:50:17,-12,6,18,老师人真的超级好，经常讲儒释道的知识，每次思修课带着其他作业去，最后都被老师讲的内容吸引，听了整整一节课，绩点给的也很棒，我上课发言了几次，上四没问题，不知道评分里为什么会有负面的东西，老师真的棒，全班同学都超级喜欢她，么么哒，真的吹爆。
97885,1143,朱培霞,2019-01-23 00:50:43,1,5,4,朱老师人非常善良，脑子里也是有货滴！虽然绩点不高，但还是要说nice!
97899,1143,朱培霞,2019-01-23 01:23:51,4,6,2,课水，老师确实没有什么时间观念，但是给分还可以，恶竞什么的没有亲眼看见也不好评价，就酱
97900,1143,朱培霞,2019-01-23 01:24:41,3,5,2,这老师原来教史纲的，突然发现她史纲和思修gpa一样，莫不是把思修成绩按史纲标准正态的，求求您向隔壁梁老师学习学习，上课真的毫无亮点，小组互评暗流涌动
97991,1143,朱培霞,2019-01-23 03:27:27,2,4,2,emmmm确实挺水的。不过事情不多。老师本人知识水平是不错的，但是上课真的就一般了。给分还是不错的。
97992,1143,朱培霞,2019-01-24 02:11:47,8,15,7,我还真他妈要反驳一下那个高赞说第八组认真做比不过第一组不认真的，我们第一组你哪只狗眼看出来不认真？我们这™是诙谐的PPT风格。我可qmndb的不认真，老师给分什么的就不评价了 反正冲你这评论我他妈就给老师10分了，反正课是没听过的
98007,1143,朱培霞,2019-01-24 02:11:55,16,20,4,1.22那个喷第一组的，你们用你们自己的猪脑子好好想想，是哪个组搞了一个跑题又没用的辩论，最后超时使得第一组只有十五分钟?第一组最后介绍了具体的方法论和推荐做法，你们那个跑题辩论最后得出什么有用结论了吗?自己做不好就别瞎bb
98030,1143,朱培霞,2019-01-23 04:08:40,14,16,2,思修的课我一直认为是水课，上她的课就更不用听了。不是没听过，而是真的学不到什么东西。有人说她上课讲的好，还有的人说听不懂。我去～她讲的课有丁点逻辑吗？一个非常肤浅的道理还要讲上半天的老师，说听不懂的估计是你自己没思想，被人家说一套信一套。至于评分，呵呵，绩点上4的高兴自然想着法的夸老师，苦的是那些平时规规矩矩来上课，按时认真完成作业绩点最终却不如一个天天旷课上课迟到的人。
98054,1143,朱培霞,2019-01-23 04:30:46,9,17,8,1. 老师确实没有把小组展示的时间和上课的时间安排好，这是缺点没错。\n\n2. 但是老师儒释道的东西真的讲得很好啊！！！你们上课不听就觉得老师讲课一无是处吗？真的是很有趣了。\n\n3. 最后一组和八组的展示，说好了一组15分钟，先说的第八组讲了21分钟给一组留了9分钟你们特别好意思是吧？？？完了还在群里说想讲的东西太多了讲不完了呜呜呜？？？本身对于时间的把控就是你需要掌握的东西，你做不到别人给你低分你怪谁？？？这也算恶竞那您们还是别学习了。\n\n4. 再退一步，小组展示是小组互相打分，不服课程群里骂大家啊，你们跑过来骂老师是什么意思？？？\n\n5. 回到给老师评分，第一节课上善之水就让我很喜欢，穿插的宗教文化和伦理学知识也让我有所收获，这不是一门毫无意义的课。我喜欢。
98153,1143,朱培霞,2019-01-23 06:27:11,1,6,5,老师人很善良，但是讲得确实一般，其实读了不少书，但不能很好的表达出来，而且课堂节奏很乱，小组展示、课堂等没有安排好。小组互评水分比较重。但不管怎么说还是谢谢老师，老师应当尊敬。希望大家不要把查老师当作一个发泄的平台，而是客观地评价老师，给其他同学一个良好的参考，谢谢
98183,1143,朱培霞,2019-01-23 07:05:25,3,6,3,上课极其无聊，一学期只记得她说过“好生活”三个字，为了刷平时分还举手发言了两次。小组作业认真完成了，期末考试卷大题写满，结果绩点3.6。老师只说可能是期末考的原因，本人高中选修政史地，政治第一次考就100，难以理解。然后就不回复了，另一同学去询问老师只说“成绩不重要”。
98211,1143,朱培霞,2019-01-23 07:51:53,-1,2,3,都能tm在这里嘴臭对线？牛批哦，我真的笑了
98245,1143,朱培霞,2019-01-23 08:42:58,3,5,2,emmmmmmm只希望老师更公平一点，给组长的权力太大了，然而有些组长自己抢着要当组长之后还毫无作为，变成组员催着组长完成任务，与此同时，组员还要被组长打分？？exm？？太搞笑了吧
98288,1143,朱培霞,2019-01-23 09:18:52,0,4,4,客观的说一下，有些事情不要都在那里怪老师，有多少人是把思修当水课的，课都没开始上就拿出其他东西来看，课堂氛围不是都靠老师一个人的，很多时候老师上课大家都没反应，老师上课的激情都被你们磨掉了，在课堂上都能看到老师无奈的表情，现在在这里疯狂diss老师上课不好，能不能先反思反思自己。不过实话实说小组互评这个机制真的有些问题，给学生太多权利了，同学很难真正客观的去打分，最好把权利部分还给老师自己，这样才能更客观一点，而且每次最好能稍微点评一下自己对这组同学展示的看法，给大家一个指导作用，不然课堂展示对听课的同学意义真不大，而且互评评分同学们又不能做到客观公正。
98304,1143,朱培霞,2019-01-23 09:51:12,-4,4,8,我觉得老师人挺好的
98319,1143,朱培霞,2019-01-23 10:12:26,-9,2,11,很幽默
98415,1143,朱培霞,2019-01-23 12:25:36,-1,4,5,不点名，事情少，这就行了，反正思修考试全是常识
98444,1143,朱培霞,2019-01-23 12:51:55,5,8,3,真是难受了 绩点出来的一刻均绩直降 说是思修考试不用复习但是我看了一天认真准备了 小组展示也挺不错班级前列 组长分配也没有问题 没有缺过勤 也认真完成各个任务了 结果成为本学期最低绩点（???\n\n首先觉得给分不公开不透明真的很让人疑惑 其次老师给各个小组展示的时间机会也不均等 真的很难过
98453,1143,朱培霞,2019-01-23 13:03:18,8,10,2,前面说我们对待思修不认真的请搞清楚因果关系，我记得第一节课大家基本上都去的，甚至有不少人做笔记，大家都希望大一有个好的开始，可老师表现真的太让人失望了，尬笑，跑题，到后来拖课让小组没办法展示，可以说一点点消磨了我对思修的耐心，也正是这种老师才让思修成为了所谓的水课
99130,1143,朱培霞,2019-01-24 09:59:02,11,11,0,道理我都懂，求求你们不要battle了。我就是第一组的，我3.3。自认为期末考试也没有比别人差很多，小组该做的也都做了，该交的作业也都交了，难不成我是被老师踢出第一组了？？？？
99428,1143,朱培霞,2019-01-24 22:46:44,6,6,0,绩杀。
99452,1143,朱培霞,2019-01-25 00:01:31,18,20,2,课是真的水，思路是真的不清晰，期末是真的自己要复习。评论里有人的吃相确实也够难看的，平时认真听课的能有几个？考后把所有的事往老师头上安。老师的确给分有些迷，但人本身是真不坏的，平时水的轻松，绩点看综合和一丢丢运气了，不推荐，也不批评。
99971,1143,朱培霞,2019-01-25 11:22:45,5,5,0,讲的不咋地
100248,1143,朱培霞,2019-01-26 00:41:55,6,8,2,挺负责的老师，只是给分有点迷，感觉付出与回报不成正比
102195,1143,朱培霞,2019-01-31 09:22:29,-21,3,24,给分很高，大家不要受其他人影响
102465,1143,朱培霞,2019-02-03 02:35:37,2,2,0,我觉得楼下的思想可能出了问题，给分当然有高的，之前那些朋友讨论的是给分低的低在哪里。\n\n
103631,1143,朱培霞,2019-03-03 02:15:03,-1,4,5,老师人很好，很亲切。
104000,1143,朱培霞,2019-03-09 01:52:31,0,1,1,真的难受
105262,1143,朱培霞,2019-04-08 17:31:02,0,3,3,一个思修，上出了整个大学四年的阴暗面，我也是服了
108974,1143,朱培霞,2019-06-05 02:34:39,1,1,0,感觉挺好的呀 思修课好像大家一般都不怎么听 但是讲的还可以有时候听听也挺有意思
110273,1143,朱培霞,2019-06-25 09:06:56,2,2,0,仿佛是随机生成的绩点
115675,1143,朱培霞,2019-08-17 16:40:53,3,4,1,很开心能在这里见到大家，评论区里的个个都是人才，讲话又好听，我超喜欢你们的。你说什么？高分？高分是不会有的，这辈子都不会有的，也就勉勉强强躲过绩杀才能维持的了生活这样子（狗头报保命）
116518,1143,朱培霞,2019-09-11 03:24:25,6,6,0,刚听课，不知道在讲什么
117349,1143,朱培霞,2019-09-23 07:17:56,-17,1,18,给分太差，读书报告写了一万字，3.3
117402,1143,朱培霞,2019-09-24 02:43:27,-2,1,3,还好吧
119287,1143,朱培霞,2019-11-12 02:49:36,0,3,3,恶心，不知所云
121261,1143,朱培霞,2019-12-25 07:14:00,0,3,3,上课不知所云，讲的东西和考试内容毫无关系。分组18人一组，读书报告志愿活动研究性学习最后还要期末考。研究性学习展示近40页ppt每组只给6分钟，还包括了她要提问的时间。讲了没半分钟就被打断，之后又被屡次打断提问。仿佛只是给她一个人展示，自己看过知道了就说这段过或者结束的时候来一句“唉下去吧”。发送了报告电子稿当作没收到，只看纸质稿的报告，没交纸质稿就说没看到报告。
121264,1143,朱培霞,2019-12-25 04:31:45,3,4,1,小组展示真的是一言难尽……
121267,1143,朱培霞,2019-12-25 02:49:58,2,3,1,绝了。真的绝了。
121658,1143,朱培霞,2019-12-10 04:52:17,2,3,1,思修课整组一人一张大A4纸上去念？知道自己组超时还挺得意？老师就是不愿意批评？呵呵
121662,1143,朱培霞,2019-12-11 03:10:20,2,4,2,这老师真的，选上就退吧，毫无原则，前两组展示一节课，剩下的让你压缩5分钟，这玩个锤子玩。恶竞最严重，看不懂给分规则，想不明白为什么在教课
121767,1143,朱培霞,2020-01-21 17:59:06,-1,3,4,如果想水的话很不错了 事少给分还行 老师人挺不错 （上课水平比较一般）
121776,1143,朱培霞,2020-01-22 00:26:24,3,4,1,最重要的不是绩点低。最令我失望的还是思修这门课花了一个秋冬学期，我却什么都没有得到。
121779,1143,朱培霞,2020-01-22 01:21:28,5,8,3,你们都说水水水，老师上课水平不行，可我一个学期听下来，感觉其实用心听，收获还是蛮大的，可能不是人人都喜欢听人生哲理？而且小组讨论我觉得也蛮和谐的（至少我们组内是这样的）组内的10位同学我们都相处甚欢，编排情景剧，户外志愿者，一个学期下来至少还是很开心的
121783,1143,朱培霞,2020-01-22 01:35:39,4,6,2,orz，根本不知道是按什么打的分，我还复习你妈个鬼啊，玄学，早知道开学看她评分这么低就该换掉，你评分是抓阄吗
121790,1143,朱培霞,2020-01-22 02:12:11,0,3,3,不怎么点名 偶尔让人回答问题 但我们这个班基本没人主动举手回答问题 我没答过 最后绩点还不错（非组长）。 感觉老师上课在很努力的幽默 看出来老师的认真 但课的内容和考试的关联不太大 不如多做做题…总的来说老师的课还是可以选的～
121791,1143,朱培霞,2020-01-22 02:17:45,0,2,2,挺水的，适合想水的同学，给分不错
121913,1143,朱培霞,2020-01-23 17:17:21,5,5,0,老师很善良讲课也很用心，但是课堂恶竞严重，小组互评打低分暗损现象明显，小组成员过多总是有一种效率低下的感觉。给分一般吧。
122055,1143,朱培霞,2020-02-07 16:36:10,12,13,1,绩点3. 3的举手
122266,1143,朱培霞,2020-02-21 12:12:21,2,3,1,介于思政类课堂的硬性要求，老师在限定题材上能尽力让课堂生动实属不易。作业不多但是想要做好的话还是不容易的（非常感谢思修的组员们，在一起完成小组合作的过程中一起成长了许多）。至于之前有同学提到上课讲ppt被打断的情况，事实是，由于本学期课时少了一节，导致所有小组都得在1个半小时时间内完成研究报告的课堂展示，为了让所有小组都有展示机会，自然得压缩每个小组的展示时间。且老师已经提前通知了每个小组只会有6分钟的展示，关注课堂通知的同学前期准备的时候可以稍微讲ppt做得精简一些。每个小组展示后，老师都会给出细化的评价与改进方向，老师还是负责任和尊重同学的。
123038,1143,朱培霞,2020-05-04 02:46:44,2,3,1,其实老师还是挺不错的，感觉蛮和蔼，给分还可
128350,1143,朱培霞,2020-12-21 01:34:44,4,4,0,这个老师会拖ddl，懂的都懂
128659,1143,朱培霞,2020-12-25 02:49:50,2,3,1,老师真的人很好，上课仔细听收获很大，小组成员比较多活也比较少，老师也喜欢聊天来提起大家兴趣。真的是个好老师，可惜被思修这门水课局限。没办法，思修嘛，老师再好该水还是水，平常都是一边听老师讲一边下面做自己的事。不过作业任务少给分还行，选她绝对挣，就是不知道啥时候点名就没办法旷课碎懒觉😎
128691,1143,朱培霞,2020-12-25 04:26:11,3,4,1,我觉得朱培霞老师超好啊，虽然讲课的讲述过程不很流利、逻辑也不太强，但讲的内容很实在、有深度啊。而且她真的很认真负责地在备课讲课，她自身也是一个很乐观的人，这学期刚生完孩子，就晚上带孩子白天上课很辛苦，但她依然超认真又很开心的讲课，上课的同学在水课，她自己一点没有水。\n\n尤其要说的是她会讲很多书本里空话以外的内容，包括道德绑架、LGBTQ！学到很多的\n\n还没上完不知道给分怎样，反正她说不会为难学生
129071,1143,朱培霞,2020-12-29 12:30:40,1,3,2,很可爱的一个老师。确实水，但老师很可爱
129785,1143,朱培霞,2021-01-12 09:46:17,3,4,1,谢谢老师让我感受到社会的险恶，太过于放权给学生不是什么好事
130134,1143,朱培霞,2021-01-18 01:49:48,6,7,1,今天知道了她的厉害，课堂展示时间把控不了，有的课堂展示讲20分钟，最后一组只有两分钟时间，哈哈哈哈笑死了
132824,1143,朱培霞,2021-02-04 01:57:25,8,9,1,刚刚出了分，来说几句自己的感受（只是一个非课代表非组长也不卷的普通同学，观点仅代表自己）。思修课本身的内容就是很水，但是老师确实也是认真在讲了。老师不会强制要求听课，偶尔走下来大家心照不宣地收起来手机和其他课的书，有同学太入迷没有察觉老师也不会当面批评。课堂展示时间分配确实是不合理的，但是并不是完全是老师的问题，有些组在老师反反复复提醒时间的情况下还是要继续讲下去，看得出老师真的很无奈，所以提个小建议以后可以和别的班一样规定时间，超时扣分。不过不用担心的是展示的评分和展示时间并没有太大的关系，但是展示的内容有深度还是很重要的，因为老师真的有认真去听。平时上课一定不能逃课因为有不止一次的点名（思修规定至少要点两次名）。出分之前看了很多以前的评价有点慌，但是最后发现给分还可以（虽然也不是特别高）。很长时间没有出分老师可能确实是在捞。总之选上了课的不用慌，正常上课正常交作业完成任务分就不会难看。而且其实老师人挺好的，要是上课听得特别认真还会下课悄悄跟你说你听得好认真。每次课堂讨论老师的观点都很质朴，发言的时候说自己想说的就好。
132826,1143,朱培霞,2021-02-04 04:13:39,0,1,1,人很随和\n\n给分很好\n\n大爱
132827,1143,朱培霞,2021-02-04 02:25:12,2,3,1,人挺好的啊 给分也挺高 不知道为什么要给低分
132828,1143,朱培霞,2021-02-04 02:28:20,3,4,1,虽然讲得确实不咋地但是给分超好的！爱了
132832,1143,朱培霞,2021-02-04 03:44:17,2,2,0,老师人真的很好 思修课吗 大家都懂 任务比较轻松 给分不错
132843,1143,朱培霞,2021-02-04 06:20:34,-5,2,7,我来给老师高分了！！！\n\n给分真的棒！老师人很好！\n\n不是组长，有发言，读书报告认真写，小组研究性学习认真参与，考试水水过\n\n4.8\n\n真的不虚
132847,1143,朱培霞,2021-02-04 07:04:43,0,0,0,课水事少给分可以。观点也很nice。小组展示时间分配确实有些问题，但其实不影响分数，只是对认真准备的同学来说，可能有些失落感。
132849,1143,朱培霞,2021-02-04 07:14:55,0,0,0,想水还不错
132860,1143,朱培霞,2021-02-04 08:06:54,0,1,1,有时听课有时不听课，考试像写了篇作文绩点3.3，已经麻木了，无所谓了。虽然水课，以后还是要认真卷啊
132863,1143,朱培霞,2021-02-04 08:21:36,2,2,0,给分超级好(✪▽✪)
133067,1143,朱培霞,2021-02-07 12:19:14,0,1,1,虽然老师讲课逻辑有点乱，但会与同学分享一些很好的思想和观点，而不是简单拘泥于课本，认真听会有很多收获
133701,1143,朱培霞,2021-03-04 03:55:47,0,1,1,老师真的挺好的，她自己也说这门课是水课，但能感受到她真的想上好这门课。给小组打分也很公平，不知道为什么朱老师的评分这么低
133748,1143,朱培霞,2021-03-04 11:54:43,-1,2,3,什么sb老师，认认真真学还被绩杀，小组展示什么都不干的最后满绩，我真是佩服这评分机制
135883,1143,朱培霞,2021-06-01 01:07:08,0,0,0,真觉得老师挺好的，活泼可爱，让本来无聊的思修课多了一丝活力，给分也很好啊
136255,1143,朱培霞,2021-06-14 05:07:25,1,1,0,上学期的朱老师的课，客观来说两句。首先对于老师本人，性格非常好，上课很有活力也不会强制要求发言之类的，能感觉老师是在认真授课，但个人感觉水平一般，对于思修这种思政水课来说也已足够。看见其他评论说的，小组展示时间分配出问题，后面的组完全没有时间这一点，确实是存在的，但是并不会影响得分。我当时是最后一组。只剩下三四分钟展示的时间，只是匆匆而过，课后去找老师问情况，老师说展示时间并不会对评分有很大影响，主要还是看展示前提交的那个调研报告。另外还有一点，因为我是课代表，所以更清楚，朱老师给大家的平时分都打得很高很高，最高分和最低分之间没差几分，所以绩点低的同学很可能是因为期末考考得不好才被正态的，成绩不好有的时候不要总是想着怪老师，先问问自己。
138342,1143,朱培霞,2021-07-08 14:37:14,0,0,0,老师很好！
7423,1240,吕有志,2015-09-14 10:33:47,32,46,14,老师快退休了，讲课不多，但是真的很有知识
7620,1240,吕有志,2015-09-15 06:40:59,6,9,3,深入浅出，很有知识，非常熟识社会，对时局把握得很好。
8420,1240,吕有志,2015-09-21 06:40:57,17,20,3,老师很社会  是领导  教的很大气
8468,1240,吕有志,2015-09-21 12:30:56,10,12,2,课件层次清楚，有其独到见解，不照本宣科。
8557,1240,吕有志,2015-11-20 01:58:44,6,8,2,厉害的老师。知识渊博，有人格魅力
8607,1240,吕有志,2015-09-23 05:36:25,5,7,2,这样的老师我们喜欢，有学问，不摆架子，注重方法。虽然一开始有点难，但值得听下去。
8940,1240,吕有志,2015-10-03 13:50:46,5,11,6,就是麻烦了些
9392,1240,吕有志,2015-10-26 03:29:53,5,6,1,长知识
9590,1240,吕有志,2015-11-02 10:35:45,13,19,6,君子风度，大师风范。翩翩公子，温润如玉。他的课不能错过！很尊重学生的老师。肚子里也很有货。
9799,1240,吕有志,2015-11-09 13:54:18,14,17,3,吕老师对国际政治研究有自己的理论观点，教的也很有水平，能深入浅出。吕老师是教授，也是领导，但是在学生面前很亲切，很尊重学生，丝毫没有架子。
10137,1240,吕有志,2015-11-16 17:08:57,5,6,1,老师思维很开阔，课程生动，推荐读物具有启发作用，结合时事评论分析。
11029,1240,吕有志,2015-11-24 02:30:35,4,4,0,这门课哒事情比较多。考试不好考
11065,1240,吕有志,2015-11-24 04:36:21,7,9,2,作业略多，考试对理科生有点麻烦，我个人感觉是我的问题导致成绩略低，老师人还不错
11075,1240,吕有志,2015-11-24 05:13:03,0,1,1,还好，有思想
11089,1240,吕有志,2015-11-24 06:01:06,-5,2,7,很好的老师，给分也超赞
11121,1240,吕有志,2015-11-24 10:43:36,1,3,2,讲课内容基本和教材一样，差不多等于念ppt…给分不咋滴…
11154,1240,吕有志,2015-12-02 04:56:40,0,1,1,挺好的
11165,1240,吕有志,2015-11-25 02:36:49,-1,0,1,Ppt做得很好，听后有收获
11202,1240,吕有志,2015-11-25 08:38:50,15,17,2,老师讲的不错，就是给分有点低了，原则性强。
11279,1240,吕有志,2015-11-26 07:25:46,4,5,1,知识渊博
11372,1240,吕有志,2015-11-29 08:54:29,-3,4,7,最后考试很简单哇，很好拿分，力赞
11397,1240,吕有志,2015-11-30 04:01:52,2,4,2,讲课很好。但是给分真的不知所以，辛辛苦苦准备了两三个星期的论文和读书报告还不如人家两小时赶出来的东西，真的不服
11398,1240,吕有志,2015-11-30 05:27:11,1,2,1,给力！
12990,1240,吕有志,2015-12-24 12:43:33,4,6,2,讲得挺有意思的，但给分一般…
14509,1240,吕有志,2016-01-07 09:56:22,-1,1,2,老师很博学讲的很好  可惜就是课麻烦
15015,1240,吕有志,2016-01-11 13:29:38,6,7,1,老师挺好的，就是有点拖堂
15202,1240,吕有志,2016-01-12 15:17:08,0,1,1,老师讲课很认真，这门课拓宽了我的视野，对我们写作很有帮助。
20242,1240,吕有志,2016-01-26 15:57:37,-1,0,1,德高望重。
20263,1240,吕有志,2016-01-26 22:53:21,4,9,5,大绩杀，给分超坑，谁选谁倒霉，不在乎绩点的随意！！！不喜欢，一点都不喜欢。
20665,1240,吕有志,2016-01-30 16:44:48,2,3,1,课的事比较多 给分一般
20790,1240,吕有志,2016-01-31 12:02:31,-1,0,1,了解不少时政和国际关系方面的东西\n\n不过任务不少
21114,1240,吕有志,2016-02-17 22:05:22,-2,0,2,分数还算可以，印象不错。
35644,1240,吕有志,2016-11-10 07:38:12,0,1,1,增进知识
36193,1240,吕有志,2016-11-11 03:26:55,-1,0,1,很棒的老师，能收获很多知识
36426,1240,吕有志,2016-11-13 11:54:06,-2,0,2,老师非常棒   很有知识    也亲切
36916,1240,吕有志,2017-01-10 09:16:21,7,8,1,1.5分通识课能上出4分的感觉…如果不是实在没课上了，建议理工科同学不要轻易选。（老师说话方式有点奇怪。句尾必接啊~ 做作业bgm略魔性）
37953,1240,吕有志,2016-11-22 08:26:34,7,7,0,给分坑
37961,1240,吕有志,2016-11-22 09:34:16,3,4,1,点名，事多，考试难。本人被正太了，但老实说老师讲的不错。想学知识的可以去，想拿绩点的还是算了吧。
37969,1240,吕有志,2016-11-22 11:24:20,3,3,0,五人小组展示八分钟+4000字论文+两道很难的大题 事情比较多 可以学到很多知识
37984,1240,吕有志,2016-11-22 15:43:29,3,3,0,给分超级烂 论文要求高 还有考试 \n\n手动再见/:bye
38084,1240,吕有志,2016-11-24 03:16:23,3,3,0,课很棒很棒，老师很有知识，但是绩点很低不知道为什么
38658,1240,吕有志,2016-12-13 15:28:54,1,1,0,讲课无聊。给分莫名其妙
39053,1240,吕有志,2016-12-21 01:54:58,2,2,0,老师不错，给个低分是因为任务真的很多，小组展示要写成论文，个人要写一篇4000字论文，期末还有开卷考试。
39180,1240,吕有志,2016-12-21 13:16:03,0,2,2,玛德我第一次遇到这么能拖堂的人 一节课就算了 八次课八次拖堂 真当学生等下都没事情我擦
41399,1240,吕有志,2017-01-11 09:24:52,1,1,0,不说了，创造了我通识课的最低分。。
41400,1240,吕有志,2017-01-11 09:30:38,0,0,0,认真听很有收获的，就是声音有点催眠……
41522,1240,吕有志,2017-01-12 06:09:48,1,1,0,奔着经济去的，讲的太多是政治。人很严谨，给分太低，不适合水，\n\n讲真这给分醉了
41527,1240,吕有志,2017-01-12 06:29:06,3,3,0,老师本身还是不错的，但是，但是，给发不好，事情多！！！
41995,1240,吕有志,2017-01-13 11:23:01,2,2,0,讲课也一般吧，感觉也没学到自己想学的东西，而且大绩杀，已经后悔了
42339,1240,吕有志,2017-01-14 04:52:19,2,2,0,没意思，给分差，超级后悔
42490,1240,吕有志,2017-01-14 09:30:30,5,5,0,催眠术
47415,1240,吕有志,2017-01-26 05:45:56,0,0,0,老师认真讲课，但也就……科普水平感觉……作业是真多……但是论文期末考试稍微恶竟一下，也有4+。感觉，理科生还是绕道吧……能言善辩，有自己独立想法的文科生可以试试。
47580,1240,吕有志,2017-02-02 20:32:33,0,0,0,被迫看了几本书
47581,1240,吕有志,2017-02-03 22:01:59,0,0,0,作业要求高了一点，老师还是很负责任的。
54960,1240,吕有志,2017-06-30 13:33:17,0,2,2,吕老师温和博学，很幸运从他的通识课上到了他的毛概，给分真的很好啊！老师要退休了，祝福～
55216,1240,吕有志,2017-07-01 04:04:44,0,0,0,无话可说
63765,1240,吕有志,2017-12-14 06:51:46,0,0,0,没什么干货
66324,1240,吕有志,2018-01-15 06:10:26,0,0,0,事情太多了，对理科生不是很友好
73779,1240,吕有志,2018-02-03 05:28:50,0,0,0,给分低
79923,1240,吕有志,2018-06-15 07:59:00,0,0,0,不知道给分怎样 但讲课确实很棒
86232,1240,吕有志,2018-09-11 14:03:20,81,87,6,呢啊~~~~~~~~~~~
86234,1240,吕有志,2018-09-11 06:50:27,28,30,2,嗯丶啊～
86235,1240,吕有志,2018-09-11 06:55:23,24,26,2,嗯啊～娇喘
86236,1240,吕有志,2018-09-11 07:24:06,20,21,1,嗯啊 要三个字才能发布耶 嗯啊
86237,1240,吕有志,2018-09-11 07:03:29,15,18,3,嗯♂  啊♂ 嗯～啊～
86238,1240,吕有志,2018-09-11 07:10:56,6,7,1,有丶东西的哦，弟弟们别刷手机了
86239,1240,吕有志,2018-09-11 07:17:25,5,5,0,嗯呐。
86240,1240,吕有志,2018-09-11 07:19:48,7,7,0,确实有点东西，但是一天只睡了三个小时真的很困，满脑子都是嗯啊
86241,1240,吕有志,2018-09-11 07:20:14,0,3,3,求你别再嗯呐了
86245,1240,吕有志,2018-09-11 08:30:40,1,1,0,什么都没听却要写观后感
91859,1240,吕有志,2018-12-23 12:25:24,3,3,0,我觉得他讲的挺好的啊，而且长的有点像维尼熊
97541,1240,吕有志,2019-01-22 10:21:18,0,0,0,关心学生的好老师～
97613,1240,吕有志,2019-01-22 12:04:07,5,5,0,同学们，这次考试不调分，请大家放心。?
99454,1240,吕有志,2019-01-25 00:04:42,3,4,1,同学们 这次考试不调分 请大家放心 我先把成绩报上去了
103290,1240,吕有志,2019-02-27 07:11:54,0,0,0,。。。
109617,1240,吕有志,2019-06-18 02:36:37,1,1,0,事情烂多，做ppt+写论文+考试+点名，一门通识课是想上天吗？八次课拖八次堂，真的如果有别的选项就别选这门课。
110746,1240,吕有志,2019-06-28 07:14:03,1,1,0,毛概不要选，完全按高考改分，毫不调分，考察不想去笑嘻嘻让组长动员，难道组长动员了之后组员就能去了吗，我跟他们什么关系啊何德何能？最后没办法自己去了浪费了一天的时间最后也没有什么加分的。我真的很想骂脏话
112838,1240,吕有志,2019-07-05 05:39:06,1,1,0,绩点大杀
122659,1240,吕有志,2020-03-13 02:56:00,2,2,0,今天刚听老师的课 表示前面同学的嗯啊太生动形象了
126146,1240,吕有志,2020-09-18 07:34:13,3,4,1,上他的中特课，第一节课的感觉没有太多的干货，比较喜欢尬吹xi（不是说xi不好，但是他没说到点上）……后面如果有别的想法再补充
131070,1240,吕有志,2021-01-26 00:25:59,1,2,1,大绩杀，慎选
143116,1240,吕有志,2021-11-19 06:09:04,5,5,0,这么多年，吕老师是经历了什么，变成了一个发布口号的大喇叭
145243,1240,吕有志,2021-12-28 11:40:43,1,1,0,。。。
147304,1240,吕有志,2022-01-09 12:36:00,0,0,0,（研究生中特）几个老师一起上课的，老师们都很不错，激情澎湃，能感受到热爱⊙▽⊙。。。\n\n\n\n展示：主题与课程有关均可，内容大概偏理论（不需要毛概那种调研），但不是空谈理论，都研究生了都懂～\n\nPPT好看有可能被夸(✪▽✪)。。。\n\n\n\n论文：主题与课程有关均可。。。\n\n\n\n考试：两道论述题，一道与自身实践紧密结合，一道与中特理论紧密相关。因为是秋学期的课，我复习的时候理了理每个章节的思路，中特还是很有趣的。。。\n\n\n\n成绩：据我所知，中特课成绩都很不错(//∇//)
149234,1240,吕有志,2022-01-15 00:37:25,1,1,0,大杀快跑
149476,1240,吕有志,2022-01-15 13:38:52,1,1,0,给分一言难尽。。。
152183,1240,吕有志,2022-03-29 14:03:18,2,2,0,官媒传声筒，没思想
201124,1240,吕有志,2024-10-29 05:32:30,2,2,0,老师来西湖大学教书了?
393,1402,蔡晓卫,2015-03-15 01:52:34,1,13,12,讲的还行，有一次调查和一次读书报告
952,1402,蔡晓卫,2015-03-19 14:26:36,-4,7,11,挺不错的课~就是课本没有什么用...不过由于是通识课~所以如果希望学系统的法律知识是不可能了~不过如果真是想了解了解法律方面的东西的话值得推荐~
1292,1402,蔡晓卫,2015-03-21 17:38:29,1,9,8,挺好
2249,1402,蔡晓卫,2016-11-02 05:36:23,-6,21,27,老师挺漂亮的...
5430,1402,蔡晓卫,2015-07-07 11:26:12,13,37,24,讲课还好 就是成绩满满的正态分布 啊
5494,1402,蔡晓卫,2015-07-08 02:59:57,-4,9,13,这门课就是和经济法有很大重合度，虽然总体不如周男神，但是老师讲的也蛮好的，最喜欢听案例了。
6916,1402,蔡晓卫,2015-08-08 12:44:10,17,42,25,思修看平均绩点就知道，比别的老师低个4或5分吧，想想2.5学分的课真是呵呵了。。。。绝对的绩杀，能换就换吧。。。
7401,1402,蔡晓卫,2015-09-14 07:51:57,-3,8,11,挺不错
7402,1402,蔡晓卫,2015-09-14 08:13:12,12,19,7,坑，就是坑。平时还有分
7810,1402,蔡晓卫,2015-09-15 13:34:34,10,17,7,垃圾
8343,1402,蔡晓卫,2015-09-18 16:10:26,6,19,13,思修的垃圾老师
8429,1402,蔡晓卫,2015-10-26 06:38:03,39,60,21,拖课 拖课 拖课\n\n
9740,1402,蔡晓卫,2015-11-06 16:38:52,3,11,8,老师在不经意间说出了无数段子
11763,1402,蔡晓卫,2015-12-14 11:10:09,4,8,4,难受啊
13853,1402,蔡晓卫,2016-01-01 10:12:48,2,8,6,偶尔还会少女心
16933,1402,蔡晓卫,2016-01-19 09:30:23,-4,7,11,觉得老师挺萌的
18028,1402,蔡晓卫,2016-01-21 06:46:59,4,7,3,事多 给分非常写意
18030,1402,蔡晓卫,2016-01-21 06:50:14,-5,4,9,很喜欢的老师，很萌(๑•̀㉨•́ฅ✧
18034,1402,蔡晓卫,2016-01-21 07:05:44,-4,4,8,挺好的，，，
18088,1402,蔡晓卫,2016-01-21 07:31:48,-5,8,13,老师讲课很棒例子很多，给分是比较严谨的但是实事求是，上课可以不听但是作业和考试一定要好好做绩点也能好好的，我自己就拿了4.5
18146,1402,蔡晓卫,2016-01-21 08:20:36,0,12,12,老师挺好的 规矩不多 作业也少 只要考试认真就肯定会有好成绩 老师性格真的很棒的 赞
18147,1402,蔡晓卫,2016-01-21 08:22:20,1,10,9,很好的老师，讲的不错，一次读书报告一次小组展示，事情并不多，平时课堂多参与就好。
18220,1402,蔡晓卫,2016-09-20 08:15:40,4,6,2,满满的正态分布
18267,1402,蔡晓卫,2016-01-21 10:48:19,-4,2,6,轻松的
18294,1402,蔡晓卫,2016-01-21 11:47:44,-10,7,17,反正当组长，认真交了读书报告和论文，考试裸考选择题不太会，依然拿了4.5
18429,1402,蔡晓卫,2016-01-21 15:14:16,-6,2,8,一学期去了不到五次，每次作业认真做了4.2不错了
18544,1402,蔡晓卫,2016-01-22 03:38:32,-5,3,8,老师挺好的……给分也还能看吧
18580,1402,蔡晓卫,2016-01-22 05:23:21,-5,2,7,挺好的啊，就是老爱拖课，不过整理还是不错的。
18633,1402,蔡晓卫,2016-01-22 07:26:41,-4,3,7,挺好的呀很萌的老师
18701,1402,蔡晓卫,2016-01-22 11:06:46,-11,1,12,上课还行 挺水。多发言就好
19351,1402,蔡晓卫,2016-01-24 02:43:49,-2,6,8,个人觉得思修考试是比较简单的，相比史纲还是简单吧，她的话一定要好好完成平时任务，其实把展示搞好，讨论课和读书报告写好，一般就能上四
19406,1402,蔡晓卫,2016-01-24 06:10:50,-2,4,6,事情不是很多，平时比较重要
21269,1402,蔡晓卫,2016-02-27 19:25:29,7,11,4,思修课超级坑
21345,1402,蔡晓卫,2016-02-28 06:24:15,2,10,8,为什么没有0分
23726,1402,蔡晓卫,2016-04-13 16:35:20,-3,6,9,蔡老师真的挺有意思的，毕竟通识课要正态，认真做好作业给分还好吧，思修4.2飘过
32914,1402,蔡晓卫,2016-07-30 09:10:39,-11,3,14,内容还是蛮充分的 作业量中等 可以选
34307,1402,蔡晓卫,2016-10-01 00:07:52,4,9,5,作业好多。。是别的老师的四倍牙四倍牙
34797,1402,蔡晓卫,2016-10-23 10:25:02,-3,2,5,嘿嘿嘿
39338,1402,蔡晓卫,2016-12-22 06:22:42,-2,8,10,虽然人漂亮。但是你仔细听，会觉得她看不起人……她说的都是对的你们都是傻逼，问题没听懂是你的问题不是我的，你们怎么连这个都不知道。口头禅是“诶那我觉得。”
39737,1402,蔡晓卫,2016-12-30 04:01:39,-5,8,13,尖酸刻薄，喜欢当众羞辱同学，逻辑奇怪而混乱。上她的课总是感到满满的恶意。
42852,1402,蔡晓卫,2017-01-15 09:42:55,-8,2,10,老师我要满绩
45203,1402,蔡晓卫,2017-01-19 06:59:24,7,12,5,自以为是的老师
45205,1402,蔡晓卫,2017-01-19 07:01:07,15,25,10,干嘛不多给点分呢，反正是水课，与人方便多好哇
45207,1402,蔡晓卫,2017-01-19 07:05:09,18,24,6,永远意识不到自己有错误\n\n说话总是不耐烦\n\n瞧不起学生\n\n又刻薄事又多给分又差\n\n没有资格教思修\n\n
45208,1402,蔡晓卫,2017-01-19 07:05:18,7,11,4,给分好低，辣鸡\n\n
45217,1402,蔡晓卫,2017-01-19 07:18:55,-10,0,10,很严谨的老师，态度认真应该就没事，思修本来就无聊，也不是老师的问题，听老师讲法律还是蛮有趣哒~作业虽然多，但是比起微电影这种作业，难度系数还是算低的。
45220,1402,蔡晓卫,2017-01-19 07:32:51,-6,2,8,被指定为组长，平时上课就玩电脑、我们组的读书报告感觉也就一般吧，后面影评也不算很用心，最后绩点还行吧 3.9满足了……不知道其他老师怎么样，我感觉她真的是事多的，每次都要在qq交作业，写过两千字爱国教育比较 小组四千字读书报告 两千字影评 以及无数小作业。每次上课之前还在群里发相关知识让我们看…还拖课，拖得很严重。【不过这算是负责任吧，虽然我觉得没啥意义】
45226,1402,蔡晓卫,2017-01-19 07:39:31,13,21,8,绩......杀........
45238,1402,蔡晓卫,2017-01-19 07:53:58,27,46,19,上课内容单调无趣，前几章设置的提问讨论跟初一政治课一样也是无语了……作业奇多，前前后后写了一万多字，平时任务比梁清华班都多很多，还有考试。认认真真码论文写感受，上课多次回答问题，期末考试也复习了背了。最后给个3.9……浙大大概有梁清华那样平时任务多不考试的老师，也有平时任务轻松给分看期末的，平时作业超多还要考试的也就此一家了……还有分组和组长直接公布，完全不知道是怎么分的。想好好做事的都没机会，我们组组长平时上课玩手机或者缺课课下也不作为，最后给分还比我们高，是不是给钱了啊。
45239,1402,蔡晓卫,2017-01-19 07:55:42,11,17,6,绩杀 慎选
45251,1402,蔡晓卫,2017-01-19 08:12:08,22,37,15,如果你选了，建议你换掉。如果你除了她选不上了，那就别上了。如果你不听劝告，祝你期末走好。
45267,1402,蔡晓卫,2017-01-19 08:36:57,10,13,3,好好完成作业 结果就得到这样的成绩 真是呵呵 别选了大家 太坑了 努力得不到回报 想到2，5学分我也说不出什么了
45311,1402,蔡晓卫,2017-01-19 09:59:30,19,31,12,作业认真做了一节课没缺给分也令人难受
45314,1402,蔡晓卫,2017-01-19 10:03:39,-11,0,11,给分真好
45348,1402,蔡晓卫,2017-01-19 11:58:50,-7,2,9,课很水 最后一节课叫本学期所有发过言的上来签字。。可想而知。给分不差，至少我这么觉得。
45443,1402,蔡晓卫,2017-01-19 14:33:56,6,10,4,只想说两句话：我是文科生。呵呵。
45473,1402,蔡晓卫,2017-01-19 15:01:41,6,7,1,辣鸡\n\n
45518,1402,蔡晓卫,2017-01-21 01:06:41,10,13,3,实话实说没怎么听，但授课方式很单一;作业不少;让学生辩论时自己会不断评论，和自己意见不同的就反驳;不过想到她这么一直讲底下没人抬头就觉得有些可怜;给分很差，满满的正态(多个样本)。
45855,1402,蔡晓卫,2017-01-20 07:32:47,4,6,2,全班100人上4的不到20个呵呵呵\n\n
45895,1402,蔡晓卫,2017-01-20 08:41:26,8,9,1,给分实在不行……
46424,1402,蔡晓卫,2017-01-21 13:57:02,0,2,2,，hhh
47086,1402,蔡晓卫,2017-01-23 15:51:57,4,9,5,事多，给分差，垃圾老师
47218,1402,蔡晓卫,2017-01-24 14:45:25,-8,2,10,我觉得老师上得还挺好的啊，我不是文科生，不过也上4了，有点惊喜
47300,1402,蔡晓卫,2017-01-25 07:04:35,-11,5,16,我上课积极发言，作业也还可以，小组合作也干活，给了我4.5。讲道理发言上去打对号是对认真参与课堂的人的侮辱，不过各位说老师绩杀的，你们有认真听过课吗?有人旁听的情况下诸位埋头于手机不给老师情面，分怎么可能高! 当然 思法课本来就没那么重要诸位自己衡量吧。要分选别的老师，也少冒风险
47997,1402,蔡晓卫,2017-03-07 05:16:53,-3,3,6,我上课很认真，作业挺多的，都做了，期末写满了，平时还经常发言，。。\n\n绩杀啊，室友梁清华4.5，我只有3.9
48468,1402,蔡晓卫,2017-03-05 15:49:22,2,2,0,3.3，不说话
49333,1402,蔡晓卫,2017-04-05 16:31:30,11,15,4,还没到期末我提前来给差评。不选的几个理由：1.上课没营养。你说你平时作业多也就算了，讨论的还都是没有营养的问题，简直就是初中思品；2.不注重对学生的思维培养，就感觉直接把课题和一大堆法条丢给你让你自生自灭；3.回答问题不耐烦，瞧不起学生；4.作业要求不合理，也没有说明，甚至有一次忘记自己布置了什么作业；5.最重要的一点——我花了比法学基础其他班同学更多的时间来搞你这门课，凭！什！么！我学到的内容比别人少得多而且无趣的多！这种心理落差感真的无关绩点好吗！简直浪费生命。
49539,1402,蔡晓卫,2017-04-18 05:19:05,4,9,5,我说的是法学基础。感觉讲的还可以吧，任务也不多，有论文和小作业，无考试，想水或者好好听都可以的，有时会放庭审的视频，挺有趣，感觉一个通识选修上成这样很不错了。没出分，理智评价。
49732,1402,蔡晓卫,2018-03-06 04:22:58,4,12,8,她的法学基础⋯⋯辛辛苦苦两次个人作业，一次小组作业，一篇论文，从未逃课，呵呵⋯⋯你就给我这成绩⋯⋯\n\n我可以接受绩杀，但我不能接受事多还不尊重学生成果的绩杀⋯⋯
49743,1402,蔡晓卫,2017-04-25 08:54:18,-3,1,4,主要还是看自己吧，法学基础平时作业认真做，最后论文用心写，最好有自己的观点，给分不会太差
49793,1402,蔡晓卫,2017-04-26 05:50:29,-4,2,6,老师人挺好的，很好说话，虽然是通识课，但平时用心完成任务，还是有收获的。最后的成绩挺好的，自己都没想到。
49909,1402,蔡晓卫,2017-04-27 05:50:35,10,16,6,太垃圾了！一个半学期的通识课，事情那么多，两次小作业一次小组讨论课2000字然后期末论文4000字！结果给分那么差！没翘过课，每次作业都好好写了！
50323,1402,蔡晓卫,2017-05-02 10:33:05,8,9,1,垃圾老师
52752,1402,蔡晓卫,2017-06-22 12:30:00,5,6,1,慎重选择
52769,1402,蔡晓卫,2017-06-22 16:14:32,2,2,0,小组讨论课一组上去讲完后，“我希望之后的小组能从XXX方面来讲”，“请最后的小组来总结前面的发言吧”。所以你的小组讨论是这么随意发挥的嘛。期末论文限定小，千篇一律，没什么意思。平时上课的案例也是大同小异。
59347,1402,蔡晓卫,2017-09-21 03:16:21,4,7,3,垃圾老师
60293,1402,蔡晓卫,2017-10-17 00:51:16,2,4,2,垃圾lao shi
61853,1402,蔡晓卫,2017-11-21 08:53:07,2,3,1,la ji lao shi
63639,1402,蔡晓卫,2018-01-17 07:27:02,-3,1,4,大学第一节上的就是她的课，别提多绝望。上课干巴巴一副不屑的样子，还说什么 人生就是你也在演戏我也在演戏…WTF？
64622,1402,蔡晓卫,2017-12-25 14:49:36,3,4,1,每个小组按固定位置坐的，所以来没来一目了然，不用点名。还没期末考试，预计分不会高，因为我们小组展示水得太严重了哈哈…其实老师挺好的，每次说交作业，都会看大家情况延后ddl，总共也没多少作业，嗯，我听说的一些思修老师布置的调查作业还要烦呢。
64928,1402,蔡晓卫,2017-12-28 03:33:44,6,8,2,思修，目前还没有参加期末考试。看了看上面的负面评论，感觉也没有如此不堪，作业目前为止就是一次调查和读书报告，也不算多吧，平时上课还好也没有感觉看不起学生。emmm但是内容照搬教材是真的，比较无趣。以上来自一位希望老师千万不要绩杀自己的可怜学生T^T
65105,1402,蔡晓卫,2017-12-29 01:34:57,2,3,1,其实还好吧，可能无聊的感觉是思修课本身的性质决定的
68445,1402,蔡晓卫,2018-01-24 03:35:59,3,5,2,每节课都去了，作业很认真做了，在这门思政课投入太多时间，结果...最伤心的不是绩杀，而是卡绩啊！！！
68846,1402,蔡晓卫,2018-01-24 03:31:14,5,6,1,思修3.3我也是呵呵
68848,1402,蔡晓卫,2018-01-24 03:33:16,1,2,1,其实我觉得也还好，虽然老师给分可能不是很好，但是每个人习惯的确不一样，认真听还是有收获的，但是任务确实比较多
68859,1402,蔡晓卫,2018-01-24 03:47:38,2,4,2,辣鸡..
68862,1402,蔡晓卫,2018-01-24 03:56:20,-11,4,15,4.5 刷脸就行
68864,1402,蔡晓卫,2018-01-24 03:59:17,2,10,8,我是17级的，这一学期成绩刚出就来评分了，老师的任务不多，真心不多，可以说一学期没为思修操过什么心，考试考得也很一般，最后成绩还行，上课也比较水，老师人也很温柔，挺好的！
69032,1402,蔡晓卫,2018-01-24 07:44:19,2,11,9,没上面说的那么差啊，我算是水了一个学期的思修了(每堂课都在全程水手机/睡觉/写微积分作业)最后期末近乎裸考(就翻了20多分钟思修课本)还能混到3.9我已经很满意了。讲课无聊是真无聊，但是思修这种课你又期待怎么样呢，其实事少给分不坑就行，这点蔡老师还是很好的。
74299,1402,蔡晓卫,2018-02-10 04:01:52,3,4,1,给分真不行
74379,1402,蔡晓卫,2018-02-16 06:36:30,3,5,2,垃圾老师 慎选\n\n
76868,1402,蔡晓卫,2018-04-25 01:07:41,-1,3,4,上的法学基础和思修，思修任务很少分也还好，法学基础没有出分。所以客观评论，老师还是不错的，不懂为什么这么多被绩杀了
77870,1402,蔡晓卫,2018-05-08 09:14:25,-3,1,4,嗯，作业认真的写了，最后还可以吧
77886,1402,蔡晓卫,2018-05-08 10:52:40,-5,1,6,这老师讲的还好，只不过给分确实。。。随性。可能要求太高，以法律专业的角度要求学生吧，建议没有一定基础的学生不要选，除非你绩点高
77889,1402,蔡晓卫,2018-05-08 10:56:59,-3,2,5,我觉得还好呀
77918,1402,蔡晓卫,2018-05-08 14:19:28,-5,2,7,事情有点多，对于想水一水的人不友好，但对感兴趣的同学能学到东西，如果只是想刷绩点还不想认真的人建议换一节课
77921,1402,蔡晓卫,2018-05-08 15:15:34,1,3,2,不言中
77925,1402,蔡晓卫,2018-05-08 15:00:08,-2,3,5,思修慎选，毕竟这个老师是要考试的。法学基础可以考虑，老师上课讲的比较浅。如果是浙江选了政治做选考科目的，放心大胆的选吧。基本不会超出法律常识那本书的范围。教科书可以不买，根本不用的那种。ps.如果可以和老师私下交流，被老师记住名字的话，绩点不会差。
77942,1402,蔡晓卫,2018-05-09 00:35:37,-10,3,13,不懂为啥绩杀，思修和法基都给分不错，人很好，讲课很细致虽然略显累赘，也没有杂七杂八的事儿，平时几个作业认真做了，期末论文好好写，不至于现在到这来骂老师吧
77953,1402,蔡晓卫,2018-05-09 02:53:36,-9,3,12,上老师的法基，短学期的课一次小组讨论，一次作业，然后期末论文不考试，事情不算多，老师态度和蔼可亲，授课案例很多，讲的很好。
78964,1402,蔡晓卫,2018-05-18 04:58:20,16,20,4,上了她的课 你就会明白为什么很多人对浙大排第三有看法了
85786,1402,蔡晓卫,2018-08-10 01:30:56,6,8,2,垃圾老师
86070,1402,蔡晓卫,2018-09-03 11:55:45,6,8,2,垃圾rubbish
97276,1402,蔡晓卫,2019-01-22 07:41:12,2,6,4,思修这种大水课，绩点看人品吧，也没什么期待的毕竟没好好听过...老师人还行啊，期末还会给我们划重点，交作业的时间到了还会催一催没有交的同学赶紧交，没有评论区那么刻薄吧...
98255,1402,蔡晓卫,2019-01-23 08:46:30,3,5,2,真是菜
99148,1402,蔡晓卫,2019-01-24 10:23:06,-2,4,6,给分还好吧，上课也挺好的
99152,1402,蔡晓卫,2019-01-24 10:28:37,6,12,6,其实思修这门课吧，我觉得你们到底想要老师讲成什么样？我觉得蔡老师讲的蛮好的，重点也会着重告诉我们；而且其实就算老师讲得好，很多人也依旧不会听；只要你认真完成作业，期末考前背一背书，还是很轻松的阿！老师作业也不多，很轻松啊！虽然经常拖课...但是其实没拖的那么夸张。
99159,1402,蔡晓卫,2019-01-24 10:43:05,6,8,2,这个老师上课不知道在讲什么也就算了 还绩杀 我真的醉了 为什么当初选了这个神仙的课
99162,1402,蔡晓卫,2019-01-24 10:52:12,6,12,6,最令人恶心的老师，不好意思，NM$L。\n\n好好过年不行？非得把学生卡绩。学了一学期在你这里p都没学会，上课水的一批，不补觉可惜了。还他妈喜欢卡人绩点，真的服了。一门水课还不给人方便，怎么是真的是名利如粪土，不在乎学生的评价吗？真的垃圾，浙大有这样的老师，又水又菜还喜欢搞学生，作业多吃力不讨好。教务网继续给你差评 ！
99165,1402,蔡晓卫,2019-01-24 10:57:19,7,8,1,一学期就点过一次名。\n\n卡绩真的太难受了。\n\n思修这种水课各位还是水着上吧，你上课听没听讲绩点都一样低除非你是组长。\n\n真的有点后悔，一学期在思修课堂上大部分时间在听讲，换来个这种…绩点，还不如上课多学学线代。\n\n算了，本来这种通识课给分还是看运气吧。
99174,1402,蔡晓卫,2019-01-24 11:09:30,3,6,3,什么绩点 我靠 黑人问号\n\n
99185,1402,蔡晓卫,2019-01-24 11:25:43,1,5,4,老师上课课堂氛围比较轻松，可能比较说教吧，但认真听还是很有收获的。感谢老师，绩点终于不那么爆炸了
99212,1402,蔡晓卫,2019-01-24 12:06:45,3,7,4,我觉得蔡老师挺好的呀 讲课还好喜欢听她举例子（虽然不常听课...） 思修课其实很明显少了很多人她也从来不说 作业算少吧不花多少时间的 人也耐心 而且绩杀？没有吧...我思修还是蛮水的也拿了不错的分 总体来说我推荐蔡老师的！
99226,1402,蔡晓卫,2019-01-24 12:55:04,4,4,0,课有点无聊，听不大进去
99238,1402,蔡晓卫,2019-01-24 13:13:33,4,5,1,明明认真做了事情，最后还是那么低的绩点，呜呜
99349,1402,蔡晓卫,2019-01-24 15:13:08,3,8,5,我觉得老师人比较好，也和蔼，不明白为什么评分这么低……作业不多，一学期读书报告 研究性学习 公益三项 认真点做完我绩点4.2 上课也只点过一次名 作为思修我觉得挺满足的了
99395,1402,蔡晓卫,2019-01-24 16:13:27,2,5,3,上课很无聊，就是照着书，但给分自认还可以
99514,1402,蔡晓卫,2019-01-25 01:51:36,2,4,2,刘海挺好的啊
99524,1402,蔡晓卫,2019-01-25 02:01:02,-5,3,8,4.5绩点满足了
99531,1402,蔡晓卫,2019-01-25 02:15:57,1,4,3,听得出来挺有法律素养的感觉
99542,1402,蔡晓卫,2019-01-25 02:30:20,6,6,0,上课无聊，不过我其实不知道思修是不是每个老师都上的无聊。至于绩点，给分偏低。就这样了唉。
100004,1402,蔡晓卫,2019-01-25 12:28:09,3,4,1,垃圾老师，期末思修考竺校长的两问.我觉得老师更要必要反思下这种教法能给学生带来什么?能把学生打造成什么样的人
100032,1402,蔡晓卫,2019-01-25 13:01:04,-3,3,6,老师还是不错的，平心而论事情挺少，上课照本宣科大多数老师也是如此吧，给分也可以的
100413,1402,蔡晓卫,2019-01-26 05:47:31,-5,4,9,其实给分我觉得主要还是靠考试吧\n\n因为不是组长也没有做过PPT\n\n自我感觉考试还可以\n\n然后分数出来还拉高均绩\n\n虽然卡分了但是\n\n4.5已经很满意了
100488,1402,蔡晓卫,2019-01-26 07:56:40,9,12,3,我的ma呀，3.3的绩点，还被卡绩了…我不想喷老师，我就是不明白我哪里做得比别人差，人家无所事事在组里混也能上4？好吧他们政治素养太高我比不上，告辞！（还有4.5的同学就别秀了，我吃不消了，你可知我均绩被她一下子拉低了多少？）
100824,1402,蔡晓卫,2019-01-27 01:24:51,4,5,1,上课东扯西扯但又扯的毫无意思，感觉对很多方面缺乏基本的常识？？
101233,1402,蔡晓卫,2019-01-28 02:33:43,-3,8,11,看不懂评论了 老师上课的故事多有意思啊 任务也少 给分也很好啊 骂啥呢一个个
101546,1402,蔡晓卫,2019-01-28 11:47:22,6,6,0,听课什么体验?不好意思啊这种课不就是拿来水的吗？最后绩点只能说……看命吧。
102180,1402,蔡晓卫,2019-01-31 05:34:30,-2,4,6,老师真的很好的 给分也挺好 很喜欢她
102495,1402,蔡晓卫,2019-02-03 14:11:50,6,9,3,上课略无聊，时常睡着；作业略多，书评作业公益作业小组研讨作业请抓紧；期末还是有考试的，期末考完大英别忘了把书好好看一遍；至于给分......看命吧，现在来说这个老师给分已经好很多了。本人认真了一学期还是有4.2的。（注意：这个老师班上没有挂科的！）
102937,1402,蔡晓卫,2019-02-25 05:08:28,-1,1,2,给? 不错吧
102941,1402,蔡晓卫,2019-02-25 05:31:32,0,5,5,绩点感觉还是主要看考试吧\n\n因为平时也没有做过展示之类\n\n到最后绩点还是有4.5\n\n唔好好考试吧嗯
103412,1402,蔡晓卫,2019-02-28 03:37:39,-1,3,4,老师人很好
103784,1402,蔡晓卫,2019-03-05 12:31:42,3,4,1,人如其名  菜
117480,1402,蔡晓卫,2019-09-25 02:02:21,3,3,0,垃圾老师
118114,1402,蔡晓卫,2019-10-21 03:58:08,2,2,0,务必慎选
121150,1402,蔡晓卫,2020-01-20 01:14:40,1,1,0,要混脸熟，老师上课略水
122769,1402,蔡晓卫,2020-04-02 00:04:24,3,4,1,蔡老师其实人挺好的，给分也还可以啊，思修这样的课因为课程本身的性质就这样了.. 这也没办法
129751,1402,蔡晓卫,2021-01-12 03:49:19,7,9,2,其实老师人真的挺温柔的挺好的
131657,1402,蔡晓卫,2021-01-28 10:26:49,3,5,2,什么都认真做了，最后绩点只有3.9还卡绩也是醉了。您只给我平均分，我也给您5分平均分。
131664,1402,蔡晓卫,2021-01-28 10:31:51,-1,2,3,老师人其实挺好的，课真的有点无聊，但小组报告认真写，给分不会差的！
131692,1402,蔡晓卫,2021-01-28 12:40:16,-1,2,3,老师挺好的，虽然上课有一些些无聊，但事情不算很多，最后给分也挺好的。努力就有回报的，看到老师说“都在骂我吗”，感觉有点心酸，给老师正名一下。\n\n真的，努力就不会差！期末好好考，多写东西，有态度就有分数。
131704,1402,蔡晓卫,2021-02-01 12:30:49,1,3,2,这老师绩杀
131769,1402,蔡晓卫,2021-01-29 00:48:58,3,5,2,1.上课质量非常差，连最起码的话语表达清晰都没法做到。2.授课无内容，甚至自己背不下核心价值观24字，可见老师业务水平。3.搞不拎清，在她的安排下考试前5分钟同学都无法就座。4.绩杀。
131783,1402,蔡晓卫,2021-01-29 02:07:02,-2,2,4,感觉给分还好
131835,1402,蔡晓卫,2021-01-29 05:01:30,0,3,3,读书报告认真写了自己的感受，考试前把书过了一遍，答题写的多一点，4.8。感觉平时也没干啥，谢谢老师捞我！
131962,1402,蔡晓卫,2021-01-29 15:26:21,-1,1,2,思修上课已经尽力在听了 展示的时候我们小组也被表扬了 期末也花了很久在复习 但是给分还是不高 还卡绩
132100,1402,蔡晓卫,2021-01-30 08:55:55,-1,2,3,感觉也就上课水水，从来不听课，但给分还是挺好
132875,1402,蔡晓卫,2021-02-04 09:33:43,0,2,2,之前一次给了五分，现在想想是真的气，什么都好好做了就给85是什么意思，其他班水水都有4.8。我有认真对待您的课，您这么敷衍了事，对学生毫不负责，那只能1分伺候了。
134205,1402,蔡晓卫,2021-03-19 10:07:52,0,2,2,每节课都坐第一排还是被正态了
137489,1402,蔡晓卫,2021-07-04 12:50:02,-1,0,1,法学基础，只能说神课，自己体会
139720,1402,蔡晓卫,2021-07-21 08:15:16,13,17,4,上过老师的思修和法学基础，真的也没有评论区里那样不堪，老师真的是很希望和学生打成一片，也不是一个人高高在上，会和下面的同学交流，虽然有些选择同学做分享的操作可能并不是很合理，但整体上真的是算不错的，还记得这学期老师和第一排的一个帅气xgg聊起过自己对于学生评价的焦虑（偷偷听到），就希望大家在收获知识的同时，也给老师一个正向的鼓励！
140153,1402,蔡晓卫,2021-08-31 04:46:51,-1,1,2,这个老师情商绝对有问题
142228,1402,蔡晓卫,2021-11-09 02:18:01,0,1,1,为什么没有下课还还有拖课！
142765,1402,蔡晓卫,2021-11-16 03:27:20,0,1,1,拖堂，哎
145835,1402,蔡晓卫,2022-01-13 08:11:29,3,4,1,出分咯！出乎意料的好分数！给老师跪了\n\n老师很温柔，讲课有一点无聊，课里组织的活动很有意思。报告报告了两节课，讲课的同学个个都是人才。
148518,1402,蔡晓卫,2022-01-12 18:01:46,1,1,0,老师很好
148535,1402,蔡晓卫,2022-01-13 00:02:50,3,5,2,老师很温柔很漂亮！就是会拖堂………给分还行！
148546,1402,蔡晓卫,2022-01-13 00:50:31,4,4,0,个人给分挺好的，老师长得像中年版娄艺潇hhh。
148573,1402,蔡晓卫,2022-01-13 01:56:39,1,2,1,绩杀！绩杀！绩杀！
149337,1402,蔡晓卫,2022-01-15 06:22:39,1,1,0,yysy，老师讲课一般，我对思修投入较少，拿的分数还过得去（就是卡了有点难受），给了个客观的分数。
149387,1402,蔡晓卫,2022-01-15 08:13:48,0,1,1,思修课比较水，但老师比较认真，作业考试给分比较合理，可冲。
151472,1402,蔡晓卫,2022-03-04 05:34:27,1,1,0,很好呀
151473,1402,蔡晓卫,2022-03-04 05:34:22,1,1,0,很好呀
151630,1402,蔡晓卫,2022-03-10 02:40:04,-6,0,6,感觉还行，事不算多（思修平均水平，考试瞎编，4.5
153067,1402,蔡晓卫,2022-04-24 18:56:39,1,2,1,上的法学基础，老师上课真心不错，没想过这学期那么多课里面只有法基有在听课。期末论文也是最后一天才赶的有4.5🙏
154849,1402,蔡晓卫,2022-06-06 07:22:46,1,2,1,上课磕磕巴巴只会念ppt，给分标准不明乱给，小组展示时插嘴评论，我真的会谢
160565,1402,蔡晓卫,2022-09-27 03:40:20,0,2,2,姐求你别拖堂了。。饭店拖十来分钟你良心不痛吗。。。吗的。。。课间也从来不放的😅
166062,1402,蔡晓卫,2023-01-11 04:02:04,2,3,1,非常好！！！给的很高
167219,1402,蔡晓卫,2023-01-15 06:14:55,12,15,3,满绩辽！开心飞了\n\n蔡老师人美心善(救命老师好白好白，好美腻)很温婉但又有风骨、个性\n\n笨人就是认真参与课堂，认真参与讨论，认真完成作业，考试前看一看就满绩了。\n\n只能说有付出才有回报，那些没怎么努力付出的人，凭什么要求老师给高分？
167251,1402,蔡晓卫,2023-01-15 08:39:00,6,6,0,老师人很好啊，很温柔～分数出得很迟（大概是狠狠捞了一波）
167264,1402,蔡晓卫,2023-01-15 09:39:18,3,3,0,老师很温柔，上课也很有耐心，平时作业完成好分不会太低。
167273,1402,蔡晓卫,2023-01-15 10:55:58,7,8,1,bdbd狠狠bd，平时作业做的一般认真也有4.5，摆脱正态束缚后给分真的好好\n\n读书报告好像说不限字数但太久了不确定所以自己写了800复制粘贴了2000没被制裁，小组作业也做了擅长的部分而且大家都很厉害没有大摆子所以很舒服。我最开始还上课做笔记来着后面太累真的提不起兴致，期末开卷救我小命。思修本身课程就是这样，我也就听一些感兴趣的，但上课发言pre的童鞋们是不是太厉害了一点让我汗颜。\n\n老师好温柔好亲切，不会强制发言，有的时候看老师落寞的表情有点心疼
167275,1402,蔡晓卫,2023-01-15 11:00:10,-2,0,2,上课不敢恭维 但是可以不听写作业\n\n作业很多 读书报告3000字+\n\n之前看评价说績杀，但这个学期作业做得很认真 最后成绩也很满意啦
167278,1402,蔡晓卫,2023-01-15 11:26:43,11,11,0,当我被预定这门课时，查了下蔡老师评价感觉要糟，但是一学期下来，发现虽然上课并不是很有趣，但是对待同学很认真，也很用心，与评价完全不一样。\n\n思修课表现很多，只要你做过一次，然后读书笔记认真写，就可以拿到好的成绩
167281,1402,蔡晓卫,2023-01-15 11:37:03,7,9,2,和査老师上的热评比起来，感觉老师真的有在改变！我上的是思修，这学期蔡老师上课很和蔼，对小组展示的点评也很温柔耐心，没有出现评论里瞧不起学生的情况。作业量不算大，一篇读书报告、一次小组研究性学习就好。给分也挺好的，我读书报告是ddl当天赶的，研究性学习当了组长+担任了写报告，期末考试把能写的全写上去了，最后满啦！大家可以放心选~
167297,1402,蔡晓卫,2023-01-15 12:12:48,7,7,0,读书报告字数刚过线，在里面瞎扯\n\n没有发过言\n\n小组展示还行，不是组长\n\n工信大类，高考无政治\n\n最后4.5，给分算是很好了
167317,1402,蔡晓卫,2023-01-15 13:41:42,2,2,0,这个学期上了蔡老师的思修～\n\n蔡老师是个超级温柔，很有气质，也很有自身见解的老师\n\n说实话刚开学时看到查老师的评价有些微担忧，但接触过后会发现老师真的很棒！\n\n思修课因其自身课程特色可能会有一些枯燥，但可以感受到老师很努力的通过播放视频、聊个人经历等方式来丰富课程的趣味性\n\n老师的课上不会强制要求分享，不过还是建议大家主动报名参加哦\n\n大家以认真的态度去做好老师布置的任务一定会取得令自己满意的成绩的～\n\nPS.希望之后选到老师的课的同学上课能更加积极认真一些，有些时候看到大家没怎么听的时候，老师的表情会有一些落寞……拜托大家啦！
167401,1402,蔡晓卫,2023-01-16 04:00:33,10,12,2,很能捞，上课没听过，做作业一般认真，最后绩点4.5，比查老师上的评价好太多啦，老师平时也很温柔！太爱啦！
167402,1402,蔡晓卫,2023-01-16 04:44:30,4,4,0,给分不错，事也比较少，可以水的很舒服。\n\n本人工信大类，没有参与课题讨论发言，作业也比较应付，给分最后也不错。\n\n课上的实在不太行，有些无聊，但指望思政的课有意思本来也就不太现实。\n\nbd
167443,1402,蔡晓卫,2023-01-16 09:42:54,8,9,1,这个学期听说给分很好，我可能稍微有点卷，满了；但啥也不干的同学也有不少4.5+的。只是之前她的风评一般，听说给分不咋地，所以大家理性看待
172520,1402,蔡晓卫,2023-04-28 13:02:51,-119,2,121,我论文写了整整一个星期竟然才4.5\n\n均绩下降0.01\n\n太伤心了
172793,1402,蔡晓卫,2023-05-07 07:53:16,8,9,1,【法学基础】\n\n第一，老师人很好，很温柔\n\n第二，老师讲课很好\n\n第三，老师给分很好\n\n最后，楼下的这位你是在挖烂坑还是想找抽？秀绩点的狗他妈能不能滚蛋？
173263,1402,蔡晓卫,2023-05-22 08:01:40,3,4,1,首先，老师人很好很温柔\n\n其次，老师给分很好\n\n最后，楼下的这位你是在找抽吗？
174254,1402,蔡晓卫,2023-06-08 08:20:36,4,4,0,给分真的很好\n\n点名会提前通知\n\n可以水
175394,1402,蔡晓卫,2023-06-24 13:31:36,1,1,0,讲课不是很有趣，但是给分很好，工科选手喜提4.8，认真写论文了（抄了好几篇论文但是自己翻译过的水平）
185560,1402,蔡晓卫,2024-01-02 07:09:47,8,9,1,bd一下。跟热评里不一样，跟最近的新的评论比较接近，可以放心上
187466,1402,蔡晓卫,2024-01-16 09:16:35,2,2,0,不错的
188471,1402,蔡晓卫,2024-01-19 05:08:39,3,3,0,事情有点多…
189007,1402,蔡晓卫,2024-01-21 08:18:03,2,3,1,老师很温柔，有一些细碎的作业但是量很小，读书报告2k，印象里就期末点了一次名，给分也好。表白思政课上认真又负责的队友~
189108,1402,蔡晓卫,2024-01-22 02:33:34,-1,0,1,hhh
190233,1402,蔡晓卫,2024-02-26 07:43:03,0,1,1,好好好
191568,1402,蔡晓卫,2024-04-25 06:07:25,1,1,0,法学基础给分挺好的～
191820,1402,蔡晓卫,2024-04-30 16:56:45,3,4,1,和蔼可亲，上蔡老师的法学基础课基本没有压力，老师讲课都是结合具体案例分析，关于最基本的人身权利，与生活息息相关，说句心里话，蔡老师的课有种难以言表的温馨氛围
198879,1402,蔡晓卫,2024-09-12 10:47:48,2,2,0,这个老师讲的一言难尽，听了两节课，真心不怎么样，而且还拖堂，中午差点吃不上饭。至于改作业、考试给分什么的暂不清楚。但两节课的体验真的不咋滴
199737,1402,蔡晓卫,2024-09-28 12:21:09,2,2,0,上一次想给她评分，但想着刚开课还是该多了解一下老师，于是就等等看，但现在真受不了了。真的很想说她上课无聊没劲，一节课下来不知所云，对学生就端着架子，同时布置两项研究性学习然后要求你不到两个星期出结果，你跟她请求指导她就扯东扯西 她自己可能都不怎么清楚。回不回消息全凭天意，助教也是一言难尽。一个水课布置的作业比主课还多。你要是觉得自己时间多的没地方浪费，经历充沛到没法发泄，那你就尽管来选这门课，真心祝你好运！
207484,1402,蔡晓卫,2024-12-22 09:50:19,2,2,0,上课点名n次，，，小组作业之类的全都是模糊不清的东西
208633,1402,蔡晓卫,2024-12-30 08:45:13,2,3,1,思修没点过一次名\n\n老师很温柔 人很好\n\n课完全是自习（）发言有课堂分 但是没人卷（没有什么问答环节）\n\n喜欢😍美女老师😘
208856,1402,蔡晓卫,2025-01-02 14:36:15,3,4,1,老师人挺温柔的，没有说的那么不好，可能这两年变好了吧。德法课也就正常作业量，可能还比别的班少一点（我运气也比较好，碰到的组员都很认真负责）。至于上课什么的，反正也不听，在下面玩手机她也没有提醒。期末还没考，成绩还没有出，许愿一个绩点。
209847,1402,蔡晓卫,2025-01-07 08:49:01,-2,0,2,实在不怎么样
210831,1402,蔡晓卫,2025-01-10 04:46:33,7,7,0,老师很温柔，德法课给分也挺好的，老师上课很期待同学们的发言，感觉她也很希望从同学们身上获取知识，大家上课摸鱼她也不会说。
210842,1402,蔡晓卫,2025-01-10 05:25:03,2,2,0,...
210850,1402,蔡晓卫,2025-01-10 05:32:37,5,5,0,老师给分很好的！！！！
210869,1402,蔡晓卫,2025-01-10 05:43:26,9,9,0,德法课。\n\n出分了来给老师一个好评，刚开学时因为预置的德法课老师评分太低了，所以退了，但是发现其他老师也选不上🌚🌚，后面实在没人可选了才在一众偏低分的老师中选了蔡老师，主要是看了之前学生的评论说她给分变好了。\n\n怀着忐忑的心情，lz 发现蔡老师其实确实挺好的，很温柔，很体贴，外出实践课会提醒同学们带好水杯，上课也不会强求同学们发言，但是发言会有 bonus，作业是有几项完成了就得分，大家上课似乎也都在干自己的事情，老师也差不多习惯了。\n\n最后，还是很感谢蔡老师，给了楼主一个十分满意的绩点（楼主也没卷几次发言，不过确实是有发言就是了，鼓励大家多多发言呀！🌹
210879,1402,蔡晓卫,2025-01-10 05:53:16,2,2,0,😭我写的三面答卷，我做的3次pre，我写的观摩报告…\n\n不过老师人很温柔www
210896,1402,蔡晓卫,2025-01-10 06:15:45,0,0,0,德法课老师给分很好！
210898,1402,蔡晓卫,2025-01-10 06:27:41,0,0,0,啥都干了最后绩点没上四，可能这就是命吧。老师人倒是很温柔，但是有时候会拖堂
210912,1402,蔡晓卫,2025-01-10 06:34:02,0,0,0,老师人很温柔很好滴！！最后给分也很满意！！
210918,1402,蔡晓卫,2025-01-10 06:41:40,0,0,0,老师很优雅，人很好
210960,1402,蔡晓卫,2025-01-10 08:44:58,0,0,0,给分迷
211003,1402,蔡晓卫,2025-01-10 10:05:50,3,3,0,德法上课允许干自己的事情，不卷，老师人挺好，最后给分比预期稍微差了一些但仍然很好！
211423,1402,蔡晓卫,2025-01-11 11:10:30,3,3,0,人好，课水，分高
211528,1402,蔡晓卫,2025-01-12 01:12:50,2,2,0,会拖堂，课挺水的，但是给分不错
211667,1402,蔡晓卫,2025-01-12 10:07:35,1,2,1,差\n\n一个水课byd天天拖堂\n\n还点了好几次名\n\n给分更是依托
214908,1402,蔡晓卫,2025-02-19 04:56:24,3,3,0,老师人挺好的
214939,1402,蔡晓卫,2025-02-19 07:39:38,2,2,0,课挺水的，给分还不错，但是有人做pre，她比较喜欢打断插画，不然没啥的
217523,1402,蔡晓卫,2025-04-12 08:06:47,0,0,0,法学基础，课堂氛围轻松，一次小组讨论，2k读书报告，3k论文，可以说是没什么事，纸质点名不多
219231,1402,蔡晓卫,2025-05-23 08:22:38,0,0,0,上课就是水课，有空回答个问题就行。感觉给分还可以
220313,1402,蔡晓卫,2025-06-17 08:15:12,0,0,0,思政、法学基础很轻松，事少，付出既有回报
220404,1402,蔡晓卫,2025-06-17 18:36:44,0,0,0,法学基础课很好！老师很温柔，不点名+一篇读书报告+一篇论文+一次讨论，真的很水也很有趣哈哈哈哈，给分也棒
220518,1402,蔡晓卫,2025-06-18 10:41:04,1,1,0,法学基础事少给分好，上台发言分享读书报告最后95/5.0，供参考
221670,1402,蔡晓卫,2025-06-25 07:42:03,1,1,0,上课水水的，不点名，给分也还行，没占用什么时间，比较满意
1163,1408,高永,2015-03-21 16:22:38,7,37,30,有想法
2178,1408,高永,2015-04-05 11:25:47,3,20,17,好老师\n\n
3275,1408,高永,2015-05-25 14:30:39,36,54,18,左派，自由主义者估计听不惯
3864,1408,高永,2015-06-17 06:54:15,0,11,11,有想法的老师。
4382,1408,高永,2015-06-20 07:09:44,2,9,7,哦
6065,1408,高永,2015-07-10 14:46:09,2,13,11,可爱
6545,1408,高永,2015-07-15 03:26:08,0,6,6,不错
9317,1408,高永,2015-10-21 07:09:59,-15,17,32,有人说他是左派，那只是中国意义上的左派，其实在政治光谱上是接近法西斯主义的国家主义，和周小平是一类人
16477,1408,高永,2016-01-18 07:32:59,0,8,8,讲得好，有想法
18382,1408,高永,2016-01-21 14:02:03,0,7,7,挺好的 上课有条理，善良 给分不知道，还没出
20089,1408,高永,2016-01-26 05:23:11,-12,6,18,找人代课，呵呵
25449,1408,高永,2016-06-30 04:30:01,-1,14,15,有一次上课站都站不稳 是喝酒了吗？？\n\n
25724,1408,高永,2016-06-05 05:33:56,1,8,7,课讲的挺好的，思政老师中少有的左派，从另一种角度来分析社会
27229,1408,高永,2016-06-23 16:45:14,0,6,6,呵呵哒
27231,1408,高永,2016-06-23 21:27:25,0,9,9,坑 呵呵 感觉上课准备不是很认真
27239,1408,高永,2019-01-03 08:59:20,86,134,48,我真是醉了… 难道我浙的学生已经沦落到根据老师的给分来评价老师的好坏了？ 还说上课睡着的实在太夸张了吧？ 自己拿的分低 说明确实考试没有好好准备 我的分也不高 但是觉得老师上课还是会给一些启发和思考。    分数不满意就开始无脑黑 键盘侠？ 简直是不可思议
27257,1408,高永,2016-06-24 05:40:02,0,11,11,给分有点坑 平时成绩会给的比较低 但是很负责 协商啊什么的都会做
27800,1408,高永,2016-06-29 14:07:19,0,7,7,不会挑分什么鬼
28355,1408,高永,2017-09-15 06:11:53,-3,8,11,感觉老师很萌啊，平时分也跟大家沟通协调了，上课讲得很清楚。
28593,1408,高永,2016-06-28 10:44:47,1,24,23,非常不好
28648,1408,高永,2018-03-05 01:15:22,-5,8,13,呵呵，上课举的例子来自各种朋友圈和qq空间：）
29193,1408,高永,2016-06-29 11:14:21,7,18,11,平时分有点低啊
29285,1408,高永,2016-06-29 14:19:15,9,27,18,超级偏执的一个老师 叹气
29300,1408,高永,2016-06-29 14:42:59,0,6,6,给分太差
29304,1408,高永,2016-06-29 14:49:29,-3,4,7,不是很懂他给分的逻辑，上课也很一般。有一次上课还睡着了。
29315,1408,高永,2016-06-29 15:03:04,0,7,7,血崩了
29317,1408,高永,2016-06-29 15:05:41,-1,3,4,荡涤灵魂
29427,1408,高永,2016-06-29 22:26:31,0,5,5,感觉就是绩杀
29573,1408,高永,2016-06-30 03:55:57,2,8,6,平时分略低，做事有点拖，理论水平尚可的毛左
29594,1408,高永,2016-06-30 04:28:34,1,7,6,上课很有意思\n\n
29762,1408,高永,2016-06-30 09:42:31,0,3,3,呵呵hhh
30641,1408,高永,2016-07-02 06:08:49,51,68,17,高永老师乃是马院的一股清流，他是正宗学马克思主义出身的，比那些野路子的根本不懂马克思主义只会捧臭脚的人不知道高到哪里去了
32119,1408,高永,2016-07-05 16:03:31,-1,6,7,比较喜欢在qq群里和大家沟通的老师，蛮亲民的
60819,1408,高永,2017-10-31 01:23:36,0,14,14,被哲学系的piapiapia打脸之后开始用不给发言机会报复( ◠‿◠ )mmp
60825,1408,高永,2017-10-31 01:56:28,-9,7,16,您说不发言就没有得分了。可那能怪我们吗？一个秋学期过去了，您一次都没抽过我们组，说句不好听的话，您是脑子上有伤所以眼神也不干了吗？？？
60902,1408,高永,2017-11-02 03:49:04,0,1,1,。。。。。
62517,1408,高永,2017-11-25 15:06:43,1,4,3,真的是解惑啊困扰多年的问题终于有了些思绪 特别有想法的老师
62820,1408,高永,2017-11-27 05:37:03,0,9,9,左且蛮横
62922,1408,高永,2017-11-27 11:02:59,0,5,5,蛮横强硬
62998,1408,高永,2017-11-28 01:01:27,-5,1,6,海中巨兽
63052,1408,高永,2017-11-28 04:57:57,0,7,7,根本不给看不顺眼的小组发言机会，他上这么多次课，无视我们小组，还说没发言的小组下次一定要好好准备啊，我真是无语了！你根本没听过我们发言啊，反正我们组要疯了，最后的成绩根本不指望了，因为摆明老师莫名看我们不顺眼啊
63484,1408,高永,2017-12-05 02:59:56,2,8,6,老师很可爱呀~也不要根据评分来选老师啦，敢说真话的老师~赞一下
63562,1408,高永,2017-12-07 02:01:44,-25,6,31,毛概大课要记笔记。。纯种傻逼
63749,1408,高永,2017-12-14 03:10:04,-15,11,26,自以为是的傻逼老师，讲的特别无聊，还有人说他讲的好的同学，不会是水军吧，你在浙大上的课是有多无聊。最恶心的事，还要强迫别人来听课。\n\n你讲的好，我自会听。但不是。请别浪费学生的时间行不？
63902,1408,高永,2017-12-19 03:57:02,-2,8,10,真的不知道哪里得罪他了，嘴里说着给发言次数少的组发言机会，下课组长去问也是这样回答，说看我们组发言次数够多了，但是上课宁愿叫倒数第二个发言次数少的组也不叫我们组，直到现在我们组发言次数倒一了还是不给机会，说白了就是等着给我们组正态，再具体细致的评分机制，没有监督，也是权力的变相集中
64123,1408,高永,2017-12-21 04:32:03,-9,4,13,好奇怪的人，莫名其妙就说我在拍他?喵喵喵?神经病
66188,1408,高永,2018-01-21 15:50:54,67,93,26,高老师本人不便亦不需做出辩解回应，而我却不能不说几句反对的话。也是主观意见，如有冒犯，请海涵之。\n\n1.高永老师真诚友善，敢说肯说。我个人认为高校思政课能做到言之有物言之有实已属如意，且我本人是很愿意并期待上高老师的课的。\n\n2.关于发言机会。第一，我们组有对各组发言情况做非官方记录，与官方版不同，我们还比较了各组举手与被请情况。得出的一致结论是：存在有意平均，未发现不公对待。第二，高老师虽是我班负责教师，实际上课次数却不多，为秋学期三次讨论课与冬学期末专题课和展示课。秋学期讨论课发言基本平衡，对此我印象深刻。而进入冬学期，尤其后几次展示课后，参与提问的小组明显减少，屡现乏人参与的情况。如各位觉得本组发言次数过少，何妨此时多加表现，相信高老师绝不会宁愿自己尬讲撑场也不给各位机会的。第三，大课难免恶竞，恶竞比的便是谁更恶。发言机会必须一次不落地、努力地争。保证绝对的平均与多数的高分，不是老师的职责。\n\n3.关于与哲学大佬争论问题。是我班某组。此后我们抱吃瓜心态留意围观过，并未发现持心不公有意压制的情况。且请恕直言，贵组发言并不特别踊跃。看此条评论发表于十月，我猜测可能指讨论课平均发言次数的情况，如您看见我的评论后亦同意您此前说法稍欠妥当，烦请略予修改。
66276,1408,高永,2018-01-21 07:39:28,0,2,2,夫鵷雏，发于南海而飞于北海；非梧桐不止，非练实不食，非醴泉不饮.于是鸱得腐鼠，鵷雏过之，仰而视之曰：‘吓!'\n\n\n\n
67441,1408,高永,2018-01-21 08:03:23,-5,33,38,2017/12/28，在大学课堂上说出「既然艺术选择用艺术的手段干预政治，就得接受政治用政治的手段干预艺术」，「艺术家以艺术的名义逃避政治的斗争——这是非常软弱的表现」的话，只能说是又毒又坏了。创作和表达观点是多么天然的事情，只可恨肉体凡胎抵不过社会主义铁拳一顿乱锤。不过说到底，对毛概老师的道德水准抱那么高的期待做什么呢。
67464,1408,高永,2018-01-21 08:58:43,-1,6,7,看了下评论，我总结一下：1.评分机制是发言次数越多分数越高\n\n2.发言是我们举手老师随机叫某些组，所以存在某些组准备了发言但是却没有得到机会的情况。\n\n3.有些组发言次数较多，老师说给发言少的组一些机会，但实际上仍然随机抽取发言。\n\n4.发言确实存在有的组很积极，有的组不积极的现象，唯一不能理解的就是老师为啥要说一句：给发言次数少的组一些机会。难道不是发言次数越多分数越高吗？既然如此，发言多的组难道就应该让出发言机会吗？\n\n
72777,1408,高永,2018-01-31 05:21:54,0,1,1,打分制度不够合理 希望以后修改一下造福学弟学妹吧\n\n\n\n
72781,1408,高永,2018-01-31 05:28:35,0,2,2,个人觉得一节课可以无上限刷次数的规定不合理，一节课以最高发言质量记一次会更好
72802,1408,高永,2018-01-31 05:56:30,2,4,2,给分不错的 分数主要看小组成员合作得好不好
72832,1408,高永,2018-01-31 06:59:01,-3,5,8,记仇 政治立场很明确 讲课并不有趣 为人还可以 很可观了 慎选
73171,1408,高永,2018-02-01 05:44:29,0,2,2,老师讲课很认真
74472,1408,高永,2018-02-27 07:02:57,1,4,3,老师不错，给分还可以
78695,1408,高永,2018-09-29 04:05:50,599,656,57,头一次看到大家在此争论，谢谢关注。有些做法与言论可能有些同学难以接受，不过我还是略做解释。课堂举手发言难免有所疏漏，未能照顾每个小组，只能在可能的范围内尽量公平。因为班级较大，我虽然经常点名但一般也记不住同学与小组，期末亦完全根据发言记录给分。至于观点倾向，我想还是要讲出我以为正确的话，以有所引导，这也是思政课宗旨所在。限于教学纪律和自身观点，有的同学的观点我难以赞同，有时还要做批判性分析，但也仅针对观点本身，并无他意。只是学识浅陋，有些问题思考不深，有时感觉没讲清楚，在此致歉。高永\n\n
79079,1408,高永,2018-05-22 08:00:33,-3,7,10,老师，想问您为啥看见我们组举手了，且定睛看了几秒，硬是环顾教室看看其他组有没有举手。这时，有一组举手了，您立马超级开心地点了他们组！老师我们是不是哪儿做错了呢，让您不开心了呀，求指教啊啊，好多次了啊！
79238,1408,高永,2018-05-28 08:29:21,9,11,2,我觉得高老师还可以啊。毛概这种课分数低也不是一个老师的事情啊。嗯总之看到老师说自己的教务网上同学们的评价超级低就很心疼…老师也不容易，大家都善良一点吧~
79698,1408,高永,2018-06-13 02:01:43,23,27,4,说实话毛概是一门看队友的课，要是你们组都没有人好好准备发言和报告，分低也是正常的啊？而且老师轮流上课，给分低也不能怪一个老师吧！再者高永老师也有照顾发言次数少的组啊，已经尽量保证平均了，平时发言次数多的组把发言机会让给了次数少的组都没觉得不公平，如果真的不公平就不会想着平均一下发言次数这一说了，直接让最积极的小组每节课都发言不就完了。你可以觉得老师上课不好，但也不能人身攻击吧:)认真学绩点能差到哪去，一个个甩锅给老师倒是轻巧。看到高永老师前面的留言，和他在群里说教务网评分有点低，真的有点心酸。
80877,1408,高永,2018-07-02 08:10:11,28,33,5,我觉得其实老师在专题课上讲课比其他老师认真多了，看得出有想法有准备，觉得老师应该不止这个分。
84088,1408,高永,2018-07-12 03:46:14,1,4,3,老师人很和善 有事都会和学生商量
84099,1408,高永,2018-07-12 04:10:20,2,7,5,还没出分，但是老师很认真吧，也很实在，我鄙视那些只看绩点的人
84210,1408,高永,2018-07-12 08:38:57,-15,1,16,老师挺友善负责。但是这个给分，我只能说过分了。。打个1分以示敬意。10分友善负责，-9分给分好
84225,1408,高永,2018-07-12 09:33:04,4,7,3,老师太好了，为了提高我们的成绩，和我们商量怎么调成绩，平时分超高的，期末好好准备一下，一定能拿好成绩！
84226,1408,高永,2018-07-12 09:35:14,0,2,2,感谢老师变得仁慈\n\n给分真的是很好了\n\n也感谢队友带飞\n\n4.8
84227,1408,高永,2018-07-12 09:35:46,-1,3,4,给分很好！满了！
84311,1408,高永,2018-07-12 13:40:21,10,15,5,诶，老师不应该这个分的。平时发言次数老师有尽力在调整，好几次说要点名其实也没有点。我们小组没有抢到加分的展示机会，但是两个发言次数都满了调研报告也认真写了平时分也才扣了一分，期末考试好好准备成绩肯定不会差的。给老师10分拉高一点平均分。
84776,1408,高永,2018-07-14 00:29:30,2,4,2,高老师人不错啊，很为学生着想，只不过思政课也要正态，无论哪个老师都会有同学拿低分的
84890,1408,高永,2018-07-14 08:09:34,1,3,2,老师真的很不错啊，10分先满为敬
86579,1408,高永,2018-09-17 09:54:00,0,2,2,第一次在查老师上评论，高老师是真的不错的一个老师，讲话很幽默做事情也很认真，评分很低觉得很不应该
87430,1408,高永,2018-09-29 02:02:14,0,2,2,老师讲课很有激情，知识面很广
92352,1408,高永,2018-12-28 03:12:15,-3,0,3,研究生政治课…给分扎心，，，估计直接按照得分来，没调分
92365,1408,高永,2018-12-28 04:53:25,0,2,2,老师真的是个和善的青年老师，一学期交流起来也很融洽，我们小组合作很好，尽管被点到的次数不算很多，但我们组里组长和学姐积极争取回答平时分，最后我竟然4.8（脸红），班里真的有几个组不回答问题，也没有好好准备。\n\n
93685,1408,高永,2019-01-11 14:48:59,1,1,0,老师人挺好的
94012,1408,高永,2019-01-15 01:24:14,0,0,0,人还是挺和善的，今天最后一节课，不论成绩，老师还是可以。看了很多评论，想说每个人观点不太纯属正常，不用在毛概课上太较真
94885,1408,高永,2019-01-18 12:04:56,0,1,1,老师思想深邃，其实更适合开一门通识，毛概这种人人必修的课容易因为得分不符合期待招致很多同学的不满。但是上老师的课真的学到了很多，老师学识渊博，思想很有深度。
99688,1408,高永,2019-01-25 05:06:33,3,5,2,为高永老师正名，人真的挺好的，这个学期大概是大家被评分吓到了，上课人很少，恶竞完全没有。第一节讨论课玩的游戏因为班小所以很有趣。只要认认真真完成作业、每次讨论发言、最后考试写满（我没怎么背书orz）给分非常好的
103892,1408,高永,2019-03-07 04:15:31,2,5,3,拜托别的组讨论发言能不能简短点？叽里呱啦一堆没有重点，害的我们也没时间发言了。每次都举手很累的好嘛？？？？老师人很好，有些发言的人真的太啰嗦了，太啰嗦了，太啰嗦了！！！！！！
104775,1408,高永,2019-03-27 14:58:18,0,6,6,推崇周小平花千芳胡锡进之流的推荐选他的课?
105169,1408,高永,2019-04-05 15:56:17,0,3,3,真正传道受业解惑者不应有如此中庸的评分
105281,1408,高永,2019-04-09 04:04:36,-9,7,16,个人觉得这老师讲的很一般。但是在浙大这种学生政治素养普遍偏低的情况下，这种漫无边际其实没什么营养的上课方式反而能得到不错的评价，给人一种思想很深刻的错觉。
107902,1408,高永,2019-05-11 03:15:25,-16,6,22,这个年头毛左也挺可怜的，大家哄哄老师就行了。
110053,1408,高永,2019-06-22 02:26:47,1,5,4,没有出分前，先来评个分，老师很有见解，个人感觉比那些只会念ppt 的毛概老师强很多，而且事情不多，会为学生着想，虽然有点像吊斯，但超可爱，很喜欢?
110119,1408,高永,2019-06-23 08:52:20,2,6,4,老师不回避敏感问题，个人认为还是挺难得的。至少我觉得这学期下来不亏。
110426,1408,高永,2019-06-26 14:51:24,0,4,4,毛概这门课相比马原可谓是很有收获了。课程或者老师好坏，客观上只有三个方面。1.课程内容是不是符合它的名字？2.课程设计是否合理？3.内容是否给人启迪。第一点毋庸置疑，第二点虽然不尽如人意，但是毛概课中加入的调研实践环节也算是丰富课程形式的手段，教学内容虽多，也还可以接受。第三点是我认为高永老师做得非常好的一点，高老师善于用理论知识结合实际，以逻辑去分析问题，不是简单重复书本。至于有些同学抱着偏见来上这门课，自然是无法体会到的，学得痛苦也能理解。
112157,1408,高永,2019-07-03 17:55:09,-5,2,7,高老师讲课真的水平很可以 有观点会传输 平时分给的很高 非常仁义了
112279,1408,高永,2019-07-04 00:38:45,0,7,7,刚上完这学期的课来评分。\n\n个人觉得高永老师的课挺好的，抛开大课不讲，我觉得至少讨论课是我们班的非常的特色，对于各类不同问题的讨论确实有着别样的乐趣，高老师也确实在努力让这门课有趣起来了～\n\n毛概课令人难受的其实在于恶竞而不是在于老师，某组可能会几乎每节课都想尽方式发言然后还恬不知耻的说自己没发言过。这给多数同学体验确实不美好，老师们可以继续考虑如何完善。\n\n但毕竟这里是对老师的评价，从老师而论，高老师给分还是挺不错的，我们寝室三人选了他的课，谈不上多好的绩点，但都是在心理预期上，没有过高或者过低。老师除了有时候容易忘事情(这也是老师颇为可爱之处)，其他一切都很棒～
112352,1408,高永,2019-07-04 02:29:33,-7,13,20,老师可以的，恶竞的人太傻逼，每天举手，发言你妈呢？吃相过于难看，导致体验很差
113239,1408,高永,2019-07-06 02:28:14,2,10,8,老师人很好，一学期点过两次名。毛概专题课是好多个老师上的，个人最喜欢高老师。评论区某些同学嘴巴能否放干净些，第一节课老师就讲清楚毛概平时分机制，主要就是靠课堂发言来拉开分数。只要课程制度不改革，举手发言的混乱现象就会一直存在。那请问在这一背景下，认真准备发言每节课举手的组错在何处。你又不想发言又想高分，请问你是哪尊神仙全世界都得让着你？
118583,1408,高永,2019-10-29 02:31:45,1,8,7,听高老师的课是一种享受。他是娓娓道来，从我每次都想看看你们是否还年轻谈到莫言的诺奖，方方的软埋。他的声音很好听，让低头学习的我忍不住抬起头去，听他讲述故事一般讲课。在浙大，我好久没这样的体验了。总之，我很欣赏和喜欢这个老师/斜眼笑
120656,1408,高永,2020-01-14 17:16:25,15,23,8,老师水平应该是挺高的，可惜似乎不敢讲话了，也特别怕拍照。大环境使然吧。
126600,1408,高永,2020-10-06 12:53:45,-15,11,26,居然有水军给它洗白！高永这个垃圾脑残上课水平真臭！还蛮横无理，只想睡觉。
128087,1408,高永,2020-12-07 05:14:53,2,5,3,事太多
128088,1408,高永,2020-12-07 05:19:16,1,6,5,上课强制关电脑，有本事点名啊……
128573,1408,高永,2020-12-24 05:11:48,13,20,7,友情提醒：强制关电脑/平板，上课前手机最好充满电
129361,1408,高永,2021-01-04 13:44:47,-18,10,28,就是彻头彻尾的法西斯主义，崇尚专制和个人崇拜，这种人居然能给人上课？？？
129538,1408,高永,2021-01-07 02:43:52,-22,4,26,又关电脑又不点名 nm$l
129539,1408,高永,2021-01-07 03:14:42,-3,4,7,真无聊
130223,1408,高永,2021-01-19 10:40:52,79,115,36,预告一下，各位同学如果有想选我的课，请一定慎重考虑。我下学期会严格禁用手机和电脑，并且不允许在课上学习其它科目。如果不能接受这个要求，请慎选。
130617,1408,高永,2021-01-24 03:20:15,3,7,4,说句公道话，老师水平还是很不错的，起码这学期轮班的四个老师里只想听高老师的，不知道为啥评论区戾气这么重……
130985,1408,高永,2021-01-25 13:03:24,1,2,1,老师救我
131408,1408,高永,2021-01-27 11:29:27,12,24,12,针对评论区里说的不让开电脑一事：本学期某周专题课督导组检查旁听，完全以上课学生有没有开电脑为评判老师课堂教学的标准。尽管老师再三请求同学们关电脑，但是大家还是开着电脑各干各的......我不知道这件事给老师带来了多大的影响，甚至可能让老师受到了处分，从那以后老师才要求上课最好关掉电脑。高老师人真的很好，在毛概课本身这么卷的课程安排下力争让每个小组都能获得发言机会，在专题课上也会抛出一些随堂问题让更多的小组能够发言。就不让看电脑这一点，我想这本身就是很合理的要求，我知道大三了大家专业课忙，经常在包含毛概在内的很多课上打开电脑写作业，但是你我都清楚这是一种很不尊重老师的行为。老师不去管你是老师的宽容，老师去管你也是情理之中，不要被纵容惯了以为这是理所应当的事。最后如果那次课真的给老师造成了什么不好的影响我仅代表我个人向老师表示深切地遗憾。
132686,1408,高永,2021-02-03 10:01:22,1,5,4,老师讲课很好啊，很可爱啊，给分很公平啊，发言很合理啊，总之就是谢谢老师全家啊
132687,1408,高永,2021-02-03 10:05:31,-7,6,13,给分差，沙币老师
132702,1408,高永,2021-02-03 11:13:32,5,7,2,首先表明 老师在思政课老师里面算是人比较好 准备很充分 讲课也很有逻辑的那种老师\n\n但是如果你是对绩点有追求的同学 还是建议快逃吧 低情商来说就是绩杀 5学分的课真的太影响总绩点了 组里面没人上4 可能老师还是太求是了一些 希望老师能够理解一下同学们对追求绩点的需要吧
132784,1408,高永,2021-02-03 14:57:32,-1,2,3,老师还是仁慈的，就是在电脑这事上可能有些强硬。小组给分也仁慈了，考完期末考我以为自己要挂了结果还有这分真的很感谢老师
132944,1408,高永,2021-02-05 08:30:14,0,3,3,不知道是不是因为老师的心态变化，毛概树最终没有被种下。有点遗憾。
133492,1408,高永,2021-03-10 05:15:37,4,9,5,很偏执，不让用手机不能用电脑
134272,1408,高永,2021-03-22 10:38:03,20,22,2,我不是本科生，我谈一下自己的看法。\n\n因为前面有同学说对于本科来说，这门课如果是高永老师上是绩杀，所以我稍微在评分上扣了一点。\n\n但是我觉得高永这样的老师，真的很难得。\n\n不管怎么说，他上课的时候，能马上对所有做分享的小组的主题做一个分析，并且最后点出所有问题的根本所在。\n\n或许因为种种原因，老师上课对自己的看法已经很隐晦，但是如果你耐心听，认真听，会有自己的看法。\n\n我觉得作为学生，我能有这样的老师某种程度上我很感恩，因为对于学生而言，最珍贵的，就是可以有带他从不同角度认识这个世界的老师。\n\n或许有人说我是水军，但随便吧，其实在那么多那么水的研究生课程中，我觉得学到最多的，目前来说反而是高永老师上的课。\n\n但我也真的明白，对于本科的同学来说绩杀是多么痛苦。\n\n所以如果想学习，或许可以上上高永老师的网课？我也不知道有没有，但现在似乎在部署什么云课堂？\n\n对于本科追求绩点的同学，或许可以向其他同学多打探打探哪些老师给分比较好～
134485,1408,高永,2021-03-30 02:46:37,32,35,3,不明白为啥高老师是高熊林卢四位老师中评分最低的。个人认为高老师课讲得最好。至于给分，从查老师的数据看，高老师给分是可以的。\n\n难道就是因为高老师讲的是真正的马克思主义吗？
135765,1408,高永,2021-05-24 10:54:13,0,1,1,不说了
135980,1408,高永,2021-06-07 12:07:35,18,24,6,讲民生问题，三胎和躺平这节课，代码写累了解除静音，不知不觉听了半节课\n\n真的敢讲，就理论水平来说我觉得也是高卢熊成四个老师中最高的
137686,1408,高永,2021-07-05 15:09:19,0,4,4,很有观点与想法，是四个老师中最有个人想法的老师了
138418,1408,高永,2021-07-09 04:59:24,4,6,2,上了老师的毛概和习概，毛概分比较低，习概分比较高。但是不管哪门课老师讲的都是很有东西的，尤其毛概课，可以说是推心置腹，能感觉到老师内心是有信念的。对自由主义的意见也是仅作点评，发言给分完全是按小组发言次数而不是对发言本身，所以也没有不公平。给个高分平衡一下。
139181,1408,高永,2021-07-13 06:50:43,2,4,2,老师挺好的，我们小组基本没卷，最后小组成绩只有八十，最后也有3.9，感动........
140784,1408,高永,2021-09-16 05:06:39,5,9,4,水平高，没得说
141427,1408,高永,2021-10-08 07:20:41,22,30,8,评论区还有说高老师崇尚专制、崇尚法西斯、国家主义的，甚至还有和周小平胡锡进之流做对比的（我属实蚌埠住了）。怕是把高老师的马克思主义和某些人的鹿克斯主义搞混了。高老师的水平没话说，马克思主义的观点也非常正统。不过大家要体谅老师，有些话只能点到为止，难免会令人产生误解和错误的联想。
141854,1408,高永,2021-10-28 01:49:53,18,20,2,精彩！思路清晰，讲课有深度，有激情，录下来放B站上有百万播放量的那种👍
141949,1408,高永,2021-11-02 00:22:27,1,4,3,讲课非常好
142145,1408,高永,2021-11-08 00:36:36,-12,8,20,上课禁电脑禁手机禁平板，中特最后闭卷考试，极大的平时作业量，极差的给分，沉浸在自己的世界里的人，勿选
143291,1408,高永,2021-11-23 03:31:33,26,28,2,现在只禁电脑不禁手机了。如果你毛概愿意听课思考的话，推荐高老师。就如今的内宣风向，愿意说人话的老师并不很多。
144163,1408,高永,2021-12-20 02:29:05,-22,5,27,上课内容没有逻辑，想到哪儿说哪儿，论断也没有依据，把任何问题都归到资本上，完全的情绪输出，主观臆断色彩太重，既不客观也不全面，看不见马克思主义者应该具备的辩证思维。
144519,1408,高永,2021-12-22 04:48:49,-40,6,46,在课堂上讽刺自己妻子的愚昧无知，充分体现了男高知的高傲自大和看不起女人。
144660,1408,高永,2021-12-23 04:06:01,2,5,3,老师很有自己的想法，讲课也很有热情
144820,1408,高永,2021-12-24 17:58:26,4,6,2,我不是高老师班的同学，也不认同上课禁电脑的做法。但我认为高老师是认真地想把毛概课上好的老师，也是马克思主义信仰坚定的老师。最近的几节课特别是从严治党这节，让一开始没打算认真听的我也耐着心听了下来，引起了我一些思考。抛开成绩问题不谈，我认为高老师是一位值得敬佩的优秀的老师。
144823,1408,高永,2021-12-25 00:59:02,21,27,6,前面有一个说高老师讽刺妻子的..为啥我记得，高老师只说过，他妻子给他发了一句马克思的话，然后高老师告诉她这是谣言。这难道是讽刺妻子愚昧无知吗？而且高老师之前说过她妻子很擅长历史和文学，吊打自己。这难道也是讽刺妻子无知吗？
146035,1408,高永,2022-01-05 07:03:54,6,9,3,一开始我想着课程结束了好好评价下\n\n现在我跑来给他打10分
146079,1408,高永,2022-01-05 11:21:05,-4,3,7,无语了
149798,1408,高永,2022-01-17 03:57:11,3,5,2,老师有思想，非常不错！给分也好，真的好老师！
150068,1408,高永,2022-01-18 22:16:42,0,2,2,老师讲的很好
150761,1408,高永,2022-02-18 02:17:04,17,18,1,高老师点名少，但偶尔是有的。讲课很好，可以看出是比较有信仰的马克思主义学者，最后给分也不错（我们组平时分平均98），虽然感觉考试背的和考的几乎正交了，但是居然有4.8。
150992,1408,高永,2022-02-21 16:09:28,-5,0,5,被卡绩点
152041,1408,高永,2022-03-24 02:49:41,18,20,2,咱就是说，没有对比就没有伤害，老师有水平的。当然，可能因为我也是左派的原因吧。
152223,1408,高永,2022-03-30 17:16:39,-12,3,15,水平不行
153292,1408,高永,2022-04-27 15:18:35,16,16,0,和其他同学交流过之后，才知道高老师的毛概课其实比较“躺”。高老师课上不点名，发言的问题一般不会提前发给大家，也不需要提前准备，不用做PPT。而某些老师每节课发言都要提前准备PPT。虽然第一节课说课上不让用电脑，但是事实上他后来也不管，我还是肆无忌惮地用电脑。至于讲课，大部分情况下语速很慢且有点无聊，但是有时会突然讲得非常流畅、精彩、有激情（感觉像是准备过，或是讲到了自己擅长的领域）。
154359,1408,高永,2022-05-31 04:02:46,-15,5,20,上课不让用电脑，不提前给思考题要求现场发挥，15分钟极限准备准备的完善一点还要质疑你是不是提前知道了题目……一言难尽
154441,1408,高永,2022-06-01 12:26:03,11,12,1,我最爱的男人之一（ 唯一的缺点：课时太少 ）老师能不能多开一点课我太想上啦。啊啊啊啊啊我的永宝就算你给我零分我也要给你满分
155536,1408,高永,2022-06-14 06:02:56,9,10,1,难得的正常人
156487,1408,高永,2022-06-20 03:31:06,22,24,2,我就坐在前排，每节课都用电脑。老师根本不管，第一节课说不让用电脑只是“例行公事”罢了，更何况私下交流时老师也对目前大学生学业压力大表示担忧。老师不提前发思考题，也是不想让大家浪费时间准备这种无聊的PPT，现场谈谈自己的想法就行了，而且不会因为发言质量而扣分。
156865,1408,高永,2022-06-21 07:57:00,8,11,3,四个里面唯一会在课上讲毛主义的毛概老师，还讲的很好！
157641,1408,高永,2022-06-24 07:36:04,2,6,4,一学期没听课\n近乎裸考\n就考前看了两个小时肖秀荣知识点\n喜提4.5\n其实我觉得花一两天复习 也就4.5
158692,1408,高永,2022-07-01 11:02:12,10,11,1,老师其实挺好的，分数不至于这么低
163237,1408,高永,2022-12-10 14:49:32,-20,3,23,脑子多半有点坑
164226,1408,高永,2022-12-19 12:07:53,1,2,1,非常好
164369,1408,高永,2022-12-20 12:51:14,26,32,6,刚上完习概线上课 我出奇地听完了整节课 因为他敢说敢讲，很客观\n\n10分送上
164371,1408,高永,2022-12-20 12:57:39,17,19,2,请保存他的课。指不定什么时候就看不到了
164373,1408,高永,2022-12-20 12:59:51,9,10,1,22.12.20听完高老师线上课后留
164377,1408,高永,2022-12-20 13:04:17,9,10,1,太敢说了！老师是真的敢，respect！
164380,1408,高永,2022-12-20 13:20:35,13,17,4,不谈观点对不对。高老师至少不像其他几个马院老师只会念PPT，就凭这点他比其他政治课老师强太多。
164381,1408,高永,2022-12-20 13:17:01,4,5,1,一位真正的马克思主义者，上他的课很享受
164385,1408,高永,2022-12-20 13:24:48,7,8,1,本科对我帮助最大的思政课。有评论说左派自由主义者可能听不惯，我一开始看到这条也有些被劝退，但是还是选了。没有感受到观点冲突带来的不适，老师尊重各种各样的看法，鼓励大家思考发言，讲课逻辑敢说话，作为一门思政课像这样引导大家一起思考真的很难得
165311,1408,高永,2022-12-31 11:55:31,2,9,7,从没见过这么不负责任的老师，拿学生的分数当儿戏。辛苦准备的答辩到最后所有小组分数一样，就按照上课发言定平时分？？不是敢说就是一位好老师的。
165409,1408,高永,2023-01-04 12:42:44,0,5,5,真的恶心，平时分多给点儿能死？这么支持恶竞，不抢着卷死别人就不给高分是吧？正常作业啥的都很好不争不抢差不多八十多，你给60？恶心
165664,1408,高永,2023-01-09 07:31:31,4,6,2,不是，习概平时分也太低了吧，正常大部分小组也就一次发言，平时分就直接没了10分左右，我觉得给分应该第一次发言的分数多一点，因为大部分组只有一次发言，反正抢不到发言的组基本发言那里就扣了10分。
165772,1408,高永,2023-01-09 15:37:33,10,11,1,讲课很好；但是平时分是不是给的有些不合理？如果小组没有抢到额外发言机会只发言了一次，最后专题发言那一块就要少18分，按0.3权重平时分就要少5.4分，在大家调研报告差不多的情况下，如果只发言一次平时分就很难上90了（习概小组太多了，差不多一半多组只发言一次），这不是大家努不努力的问题啊？
166386,1408,高永,2023-01-12 06:34:16,0,10,10,sb老师，出分最晚，专题课发言形式还特立独行，平时分至少比其他老师低5到10分，预置的快跑。
166393,1408,高永,2023-01-12 06:59:21,2,3,1,前来还愿！习概是第一次思政课上4！开心！
166436,1408,高永,2023-01-12 09:21:24,7,8,1,高永老师的习概课很有见解，从他线上那次课侃侃而谈可以看出，但是老师指定的发言规则太不合理，发言分只看发言次数，班里小组太多，很多组没有第二次发言的机会，就比其他组少5.4分。室友在成龙老师班，他们班每个组的发言次数是一样的，我和ta平时干的活差不多，都是做了一次展示的ppt，写了调研报告，我平时分比ta少5分，折算进总评刚好少3分。
167373,1408,高永,2023-01-15 16:42:00,5,8,3,有深度的老师
169696,1408,高永,2023-02-27 12:21:27,9,10,1,（看近期几条评论感觉确实离谱，可能高老师上学期大脑短路了？？一年前上的高的毛概，班里大部分组的小组分都是90+。不知道为什么上学期习概会出现这种情况）其实如果对算法有意见可以直接向老师反驳，高老师之前也在给分的算法上也有过不合理之处，但是在同学提醒之下，听取学生的意见改进了算法；另一个例子是在有同学反馈学业压力过大后，老师解除了对课上做其他事情的管制。以后大家可以多反馈，高老师还是比较容易接纳学生建议或意见的。
169905,1408,高永,2023-02-28 09:20:56,-2,4,6,好老师！
170997,1408,高永,2023-03-14 02:13:15,10,11,1,课程刚开始，有些小组已经发言五六次，我们组却集体举手，从未被点到。如此计算平时分的方式，实在是令人生气。全凭一时眼睛扫到哪里，在大家都有话说和平时分重要的情况下，如何令人服气？老师别的方面观感都很好，只是这一随意点人的方式，造成了严重的偏差！
173459,1408,高永,2023-06-02 12:10:28,-11,10,21,标准的垃圾。
174655,1408,高永,2023-06-15 06:40:01,4,6,2,老师上课言之有物，也让学生可以讨论各种社会问题，是个难道的好老师
174893,1408,高永,2023-06-19 12:30:12,8,11,3,不指定小组发言，总是自由举手，有时候举手了老师也叫不到，感觉真的不如其他班每节课指定好更加公平。。另外给老师私聊发消息老师也总是已读不回，这点观感也很差。。
175102,1408,高永,2023-06-21 13:29:46,6,8,2,不谈分数，确实是上课最有深度的思政老师
176755,1408,高永,2023-06-30 04:08:24,1,5,4,可以的
176756,1408,高永,2023-06-30 04:09:00,10,14,4,这给分真服了，你是踩点打分还是踩着字打的分啊？气死人
179624,1408,高永,2023-09-19 02:08:05,6,6,0,老师平时不会点名，除非到的人真的很少。高老师上课非常值得认真听讲，很喜欢老师的讨论课，老师会根据课堂内容来随机布置思考题，也会很认真地提炼出同学们上课发言的内容然后做总结和发散。老师真的很好很好，让我对马克思主义有了全新的体会。
179769,1408,高永,2023-09-19 18:16:33,7,8,1,放弃了py上的另一个接近满分的老师的课来低定高老师的课，虽然不知道给分怎么样但愿意相信在讲座上会说出自己读某本小说每每落泪的人是个好人。
182111,1408,高永,2023-11-10 06:24:40,21,25,4,上过那么多思政课，老师的授课/平时分是我见过最鼓励内卷的。。。如果遇到摆烂的组员的话我建议快跑，别像我一样被困住内耗
182764,1408,高永,2023-11-20 07:01:42,11,11,0,可以称之为“先生”
185605,1408,高永,2024-01-02 17:26:14,16,16,0,结课了，打个十分先～\n\n高老师的马克思主义观点非常正统，讲课也很精彩。老师本人是立场比较坚定的，但论证自己的观点很有理有据，不是把自己的想法强加给你。说回到毛概课本身，高老师的课堂在我看来很符合思政课应有的样子，就像高老师自己说的，思政课应该对同学们的思想有所引导。对我个人来说 作为一名在风气偏右的学院就读的学生，老师的很多观点给了我很大的启发，也算是打开了一扇窗户。
186974,1408,高永,2024-01-14 03:53:47,5,5,0,好老师，现在这个分真的低了\n\n其实开学的时候，老师要求非常多，还要做各种杂事，让我很不开心。上课也主要是展示，一个小组展示回答问题就一节课过去了，啥也不讲，让我觉得就是浪费时间的课。\n\n后面老师改了，讲一半，展示一半。很多观点，我以前并没有接触到，有的事情真是令人深思，每节课都感觉很有收获。后面才知道，老师一天从早上到晚，到我们这已经讲不动了，但还是强打精神给我讲课。
187480,1408,高永,2024-01-16 10:11:21,5,5,0,老师平时分给的其实挺高的，只是大家组队一定要找靠谱的队友，组员根本不发言扣了很多发言分。。。
189455,1408,高永,2024-01-24 10:37:39,3,4,1,高老师，呜呜我的高老师，真正的马克思主义者
189456,1408,高永,2024-01-24 10:37:51,0,1,1,特别可爱的老师 爱来自国际校区
189490,1408,高永,2024-01-25 02:58:06,12,12,0,上了一整学期课+分数也出了，整体来评论一下，我感觉高老师应该值得更高的分数的，就是出分比较慢（。）\n\n高老师的讲课水平很高，我觉得比我对马克思主义更有兴趣的同学应该也更能感受到他的思考，只是前半学期上课方式比较无聊，都是小组展示，后半学期他开始大段时间讲课才有比较充分的体现。\n\n老师的课程任务听说算是比较多的？这个是听朋友说的，我自己也没什么感觉。一次小组展示+小组读书会+实践活动+平时提问发言。老师班上的提问发言机制确实比较卷，因为不是固定轮流的，需要自己举手去抢，但是老师后期确实会让发言少的小组优先发言，我感觉我所在的组一开始抢到的也不多，后来弥补回来了。高老师的平时分给得很高，听说后面还再进行过调整，如果肯花心思应该分数就不会差。\n\n毛概期末考是课程组统一阅卷，但是平时分占比更大，高老师给分是很好的，最终成绩也不用太担心。总体来说，我感觉老师挺好的🥳
189509,1408,高永,2024-01-25 04:58:47,6,7,1,2023秋冬毛概出分，gy老师狠狠捞了，本思政fw被救活了owo\n\n今年期末考毛概偏难怪，但据说每个老师要在班里分别调分maybe？\n\n前两年听说老师给分求是了点，但今年真的狠狠捞了，除了出分慢了点，但出分慢就是在捞（maybe\n\ngy老师上课很有条理，真的讲出了很多课本上学不到的东西，非常值得选，7分感觉低了（勿喷
191050,1408,高永,2024-03-30 10:42:43,9,10,1,太鼓励内卷了
193146,1408,高永,2024-06-04 04:12:52,1,3,2,坚定的马克思主义者，观点实事求是，不可多得的好课堂
193241,1408,高永,2024-06-05 04:14:27,1,3,2,很和蔼的老师，真正的马克思主义者，对左翼思想感兴趣的同学可以选
193575,1408,高永,2024-06-13 06:45:18,0,2,2,很有思想内涵的老师
194837,1408,高永,2024-06-25 15:16:06,3,6,3,给分太低了，据说是从这届开始给分变低的，这届本身题就难平时分还低，真破防了
196453,1408,高永,2024-07-03 13:33:22,4,4,0,点名貌似不占分，遇见摆烂组员真的会寄
196525,1408,高永,2024-07-04 02:21:53,-3,6,9,坚定的马克思主义者，理论水平高，能够真正学到东西的好思政课
196546,1408,高永,2024-07-04 04:22:31,-2,4,6,高老师真的很好！老师讲课非常有水平，对于理论的讲解也很精彩。过去在思政课上只能学到书上的知识，但是在高老师的课上我了解到了很多理论背后的历史背景以及老师对理论的理解。我感觉这才是大学思政课应该有的水平。我在高老师的课堂上受益匪浅，尤是这学期的党建馆参观。近代史前一半是由志愿者介绍的，但是后一半是由老师讲解（是志愿者同学临时提出的建议）。老师的讲解很精彩，我也从这次现场教学学到很多。虽然出于个人原因，这学期认真听的课并不多，但我希望有机会能够再听听老师讲毛概或者习概。\n\n关于点名的问题，老师点坐在前面的同学的概率更高。希望能够为需要发言机会的同学提供帮助。
196634,1408,高永,2024-07-04 11:39:39,2,3,1,老师本身没问题，但自己组小组的时候要慎重，别白打工了。
196939,1408,高永,2024-07-06 03:58:56,-6,6,12,不点名，上课有水平，期末捞同学，给分好\n\n很荣幸能听到如此棒的毛概课，听高永老师上课是享受
197056,1408,高永,2024-07-07 03:38:24,8,10,2,不知道其他人怎么样，反正我们组都没上四
200780,1408,高永,2024-10-22 07:53:32,8,11,3,喜欢恶竞，问个gpt，举个手，卷个发言的意义在哪里
202948,1408,高永,2024-11-15 10:34:46,3,5,2,你的事情有点多了吧哥
205042,1408,高永,2024-11-30 07:59:07,8,17,9,最难忘的就是他讲到反右斗争的时候，说后来给这些人全面平反使得反革命分子得逞，酿成了后来的六四。在轻度洗白的时候还不忘记内涵邓，意思是六四是邓咎由自取。我觉得非常搞笑，印象也很深刻，让我感到大多数人的所谓政治理念不过是玩笑而已。
205597,1408,高永,2024-12-10 03:31:43,-6,1,7,还行吧
205609,1408,高永,2024-12-10 06:15:02,-21,8,29,支持恶竟，疑似喜欢女同学，男的举手就是不找，只找漂亮女同学，选了他倒了八辈子霉😂
205749,1408,高永,2024-12-12 02:09:09,-9,2,11,事多，讲课思维不连贯，至今没懂毛概的调研目的是什么……感觉像是社会学应该干的事情dbq
209303,1408,高永,2025-01-13 02:43:49,-16,3,19,虽然老师一些政治观点很幼稚，但仍然值得尊重，人是无法摆脱成长经历和时代的局限的。\n\n（给分待定，出分后补完）\n\n老师这学期给分不错，可以选👍
211478,1408,高永,2025-01-11 14:55:30,-2,2,4,呵呵呵
211499,1408,高永,2025-01-11 17:37:32,-2,4,6,楼下呵呵呵什么？\n\n小组平时成绩满分 95 啊，你还有个人签到 5 分没给你加啊，老师给每个小组的小组成绩都加了 2 分
212260,1408,高永,2025-01-13 15:02:27,4,6,2,老师还是挺好的，持不同观点的人也可以多辩辩，盲从和不认同但是只敢在下面质疑总是不好的。这学期选择题很难，不知道毛主席说的反对出偏题怪题什么的，反对本本主义什么的出卷老师有没有听。gy不是出卷老师也不能背这个锅。不过这平时分给的实在是，如果一个人干调研写报告弄发言最后还要被吸血实在是很难受。后面选gy的课的同学，记得找点有用的队友好过期末刷夜
212364,1408,高永,2025-01-14 03:14:32,3,6,3,小组真的太恶心，忙活大半个学期不如熟人互相给高点😅😅😅\n\n恶竟
212622,1408,高永,2025-01-14 09:46:40,0,3,3,高俅哥
213195,1408,高永,2025-01-17 15:47:44,12,12,0,老师是一个特别真诚的人，在课堂上会直白或隐晦地说一些自己的看法，鼓励大家独立思考，你可以选择同意或不同意；课程调研的任务相比其他老师会没那么水，但也确实是希望让同学们能看一看社会现状，看一看劳动者。\n\n其实老师现在给分挺好的，上课发言确实有点卷，如果能找到靠谱的队友还是很不错的。\n\n当然，想水一点还是建议选其他老师。
213270,1408,高永,2025-01-16 14:25:35,4,5,1,非常赞同前辈们说的，老师是一名真正的马克思主义研究学者，会认真回应大家的思考，真实思考社会中出现的问题，让我进一步认识了我生活的时代\n\n从成绩来说，老师海底捞，自我认为，认真听课就好，平时分老师会捞的！
213282,1408,高永,2025-01-16 18:32:54,1,1,0,老师上课和为人都不错的。最后给分应该是大捞了平时分，就是平时任务量多了一些
213455,1408,高永,2025-01-17 12:34:43,2,3,1,高老师上课会不定期点名，雷达15分钟，完全来得及赶到教室。上课不会管学生在做什么，会认真给展示案例的小组提出建议和疑问，看得出来老师对待自己的课堂很认真负责。恶竞问题似乎也没有那么严重，主要还是看小组组长push不push，只要组长分工明确、给分透明，体验感还是很好的。建议人文社科的学生退掉预置换成理科生多的班，不会像全是文科生的班级那么卷发言卷展示。
213474,1408,高永,2025-01-17 14:46:11,1,1,0,真正的马克思主义者！而且给分也不错
216154,1408,高永,2025-03-11 05:44:14,1,1,0,毛概这个课就是看考试呀，你期末考的分数不高总评肯定高不了，考试本来就难，分低真的和平时分没啥关系吧
219717,1408,高永,2025-06-04 14:33:43,5,5,0,本学期去除了发言加分，改成平时分的85%直接送+15%小组展示或读书报告，雷达点名了几次。但是老师说去除发言加分感觉效果不好，后续会考虑回到之前的标准，本学期评价方式不试用于后续学期（老师原话），望周知。
3479,1415,汪建达,2015-06-16 11:16:12,-2,6,8,哦
4191,1415,汪建达,2015-06-18 04:08:34,21,42,21,不怎么样。。
4368,1415,汪建达,2015-06-19 14:42:53,1,5,4,还行叭，反正没听过
15462,1415,汪建达,2016-01-14 13:18:23,-14,9,23,好老师。
17957,1415,汪建达,2016-01-21 04:49:22,-12,5,17,人很好，只要你好好听课，好好展示，他讲得还是很有趣的结合了很多现实。
18395,1415,汪建达,2016-01-21 14:20:23,19,42,23,感觉分数很低，提前来给你差评
19014,1415,汪建达,2016-01-23 04:05:24,4,5,1,哦呵呵
19530,1415,汪建达,2016-01-24 14:47:05,16,25,9,日了狗了给分超低
19623,1415,汪建达,2016-01-25 03:21:06,-15,14,29,论文一定要好好写 如果有各种加分的活动一定要参加 千万不要点名的时候不到 平时成绩拿了95 虽然期末考试很差 但是也上了4
22146,1415,汪建达,2016-03-02 14:17:44,-8,1,9,不错，挺好的
22355,1415,汪建达,2016-03-04 02:05:15,8,14,6,呵呵哒
22356,1415,汪建达,2016-03-04 02:05:45,-8,1,9,还好吧
26158,1415,汪建达,2016-06-16 06:30:19,7,13,6,谁特么说好的，是托吧。这老师讲的都丫的什么鬼，只能说脸皮真厚。
26970,1415,汪建达,2016-06-22 02:57:27,6,10,4,不知道为什么论文分数很高 课外的活动还参加了最后却只有六十多分
27461,1415,汪建达,2016-06-26 10:39:12,9,15,6,观点很狭隘
27719,1415,汪建达,2016-06-27 09:30:51,5,9,4,不要选他的课
28463,1415,汪建达,2016-06-28 09:06:26,6,8,2,根本不知道在讲什么，会点名回答问题，让学俄语的上去翻译碑文之类的，上课是一种煎熬。感觉给分会很低
30938,1415,汪建达,2016-07-03 03:34:26,6,9,3,给分不怎么样 课堂内容枯燥乏味
30974,1415,汪建达,2016-07-03 05:10:53,6,9,3,垃圾，破事多，给分还烂
31009,1415,汪建达,2016-07-03 06:02:59,-3,1,4,这给分……
31039,1415,汪建达,2016-07-03 06:47:03,11,15,4,给分超级低 ，出分慢，上课无聊，还要按组坐。点名居然是下来随便找一组点名。前面那么多座位空着呢。坐前面的经常被要求回答问题
31227,1415,汪建达,2016-07-03 12:12:49,-5,1,6,还好啊 ...
32561,1415,汪建达,2018-06-10 15:27:51,6,8,2,（不是很懂你们马原.jpg）
33478,1415,汪建达,2016-09-19 13:26:25,3,4,1,我后悔当初为什么要选他的课
38596,1415,汪建达,2016-12-11 10:45:59,-1,2,3,超烂的老师，屁事多，超级坑，千万别选他的课，为什么不能给他0分
38698,1415,汪建达,2016-12-15 04:50:30,-3,1,4,呵呵  本来以为他也就是坐位子交作业各个流程都得照他的想法来 这次展示发现他根本没有认真听！很气
39546,1415,汪建达,2016-12-24 07:06:03,1,3,2,卧槽。快上完来看评价怎么又低了一分。。。。\n\n
40055,1415,汪建达,2016-12-29 03:18:27,2,6,4,一定要每节课到教室，一次点到没到直接扣十分，不说了我先跳糊了
40353,1415,汪建达,2017-01-03 04:34:04,0,1,1,啊啊啊
40358,1415,汪建达,2017-01-03 04:46:59,0,1,1,差。。。\n\n
40371,1415,汪建达,2017-01-03 05:54:18,0,0,0,马原…
40924,1415,汪建达,2017-01-06 12:39:29,3,6,3,预感给分巨低 提前给个3分 我是不是给高了……
41984,1415,汪建达,2017-01-13 11:05:51,11,16,5,写的论文分数不如网上抄的\n\n
46020,1415,汪建达,2017-01-22 04:58:50,2,4,2,这波师生情可以
46648,1415,汪建达,2017-01-22 05:22:24,-1,5,6,给分比想象的好很多，老师上课挺认真的，但马原课程就这样，不是老师的错，好老师
46649,1415,汪建达,2017-01-22 05:23:28,2,4,2,出分慢，给分差
46651,1415,汪建达,2017-01-22 05:24:59,1,6,5,拖了这么久才出分，给分还特别低，平时分大家都差不多高，然而试卷给分太低，白瞎逼逼了这么多，失望啊。。。
46657,1415,汪建达,2017-01-22 05:36:06,1,4,3,上课巨无聊，非要按小组坐位置，给分查到一种境界……
46666,1415,汪建达,2017-01-22 05:59:50,6,14,8,给分蛮好的呀…说差的你们有认真复习吗…平时分都给的蛮高的…给分差只能说是自己问题吧
46676,1415,汪建达,2017-01-22 06:52:02,11,18,7,马原给挂了
46684,1415,汪建达,2017-01-22 07:07:42,9,12,3,4.2，谢老师不杀之恩
46696,1415,汪建达,2017-01-22 07:29:13,-1,1,2,不好玩，给分不好
46714,1415,汪建达,2017-01-22 08:05:03,0,1,1,一般，上课要点名的，还要提问题
46738,1415,汪建达,2017-01-22 08:52:20,-1,1,2,给分一如既往的差，对得起马原老师评分最低的评价
46803,1415,汪建达,2017-01-22 10:59:55,-1,2,3,出分慢，给分差，还要编座位，每节课点名回答问题，平时分大家都一样，也没啥差距，最后得分看心情打的吧，慎选。
46811,1415,汪建达,2017-01-22 11:12:07,-3,0,3,分数让我委屈地哭了出来
46848,1415,汪建达,2017-01-22 12:55:29,1,2,1,不好不好
46894,1415,汪建达,2017-01-22 20:41:58,1,4,3,特地赶来给差评。
46913,1415,汪建达,2017-01-23 01:47:51,1,1,0,讲得一般般啦，不过给分还是不错的，我论文批评马克思，政治不是很正确，也没给我上4了，本来以为要挂了。。
47435,1415,汪建达,2017-01-26 10:28:42,49,57,8,怎么说呢，老师是一个比较传统的人吧，无论是上课还是给分都比较中规中矩吧，所以上课会比较无聊，座位按组坐，上课抽人回答问题当作随机点名，旷课平时分扣10分，正常情况下大家的平时分都在90左右，好一点的95左右，得分关键还在于期末考，考前要多刷选择题，大题目的话考前准备得很充分的人也是不多的，稍微熟悉一下教材知识点就好，基本上大家都是三道论述题瞎bb，高中是文科生的话可以吃点老本，反正我考前也准备得不是很好，刷了几套选择题，课本知识点稍微熟悉了一下，因为真的不想背23333，考前还心慌慌的，后来选择题的话有几题是文印店里面的题库有的，大题目就靠仅有的一些知识展开，写了还挺多，因为当时特怕老师像大家所说的给分不好23333不过最后马原成绩也还好，平时分我看老师都给差不多也没特别认真地做，只有91，总成绩88 ?这个分数太尴尬?其实这个老师也没说得那么可怕啦！
47531,1415,汪建达,2019-06-12 02:17:23,13,21,8,平时分都是88-92区间基本，好好复习，论文写了，感觉给分还可以。没有很苛责，老师也挺不容易的
52210,1415,汪建达,2017-06-16 03:06:23,5,6,1,老师讲的挺好，点名也就是叫人回答问题，一节课点一两个而已。。。自己不来上课怪谁。
55862,1415,汪建达,2017-07-02 13:43:11,7,9,2,老师还可以，没有评论区说的那么差，只要作业好好做，平时分都挺高的
55877,1415,汪建达,2017-07-02 14:06:28,0,2,2,不是很懂为什么那些人说给分低……我感觉论文好好写，每节课都到，考前看看选择，大题都写满……给分也行啊……
55878,1415,汪建达,2017-07-02 14:07:16,2,2,0,垃圾。
55886,1415,汪建达,2017-07-02 14:35:08,2,2,0,很丧，给分也低，喜欢点名
55934,1415,汪建达,2017-07-02 16:36:18,4,4,0,老师虽然上课有点无聊，但是马原应该都差不多，给分不错的，平时分也很高的！！！
55990,1415,汪建达,2017-07-03 01:27:03,0,4,4,老师上课还是有点意思的，本身又是搞哲学的，感觉是同学们不愿意上这门课。还有老师给分很好
56030,1415,汪建达,2017-07-03 03:02:03,2,2,0,给分烂 是真的烂\n\n事情少 就论文和展示
57798,1415,汪建达,2017-07-15 23:53:25,7,9,2,卢江老师的课换成这老师了，有点害怕
59944,1415,汪建达,2017-09-28 15:26:45,-2,3,5,老师其实挺好的，讲课确实无聊点，不过马原课可能都有点无聊吧，老师事情特别少，平时分给的并没有说的那么低，论文好好写考试前多刷点题，最后得分没问题的
68361,1415,汪建达,2018-01-23 05:05:38,0,1,1,老师还挺好，平时好好完成作业，平时分还是很高的
68369,1415,汪建达,2018-01-23 05:26:21,2,3,1,平时讲得怎么样大家心里都有数。只说给分 就一个字 烂。直接拉低均绩。
68394,1415,汪建达,2018-01-23 06:18:03,-1,1,2,老师人不错的～
68504,1415,汪建达,2018-01-23 09:30:58,0,3,3,卡我绩点…其实讲道理老师讲课还是可以的。也不累，给分也还行吧
68516,1415,汪建达,2018-01-23 09:50:00,0,1,1,感觉还好吧，水一水，平时到课，上课不听也没关系，期末刷刷选择题，好好看一遍书，论文好好写
68684,1415,汪建达,2018-01-23 15:17:57,-1,0,1,感觉还挺不错的
68691,1415,汪建达,2018-01-23 15:30:50,0,1,1,论文好好写 考试前记记背背，刷刷选择题，就稳了呀。  这门课算事情比较少的了
68887,1415,汪建达,2018-01-24 05:07:57,-1,1,2,个人觉得老师问题不大……至少你辩论好好做，论文好好写，回答问题，期末好好准备选择题，老师不会为难你的。
69248,1415,汪建达,2018-01-24 11:01:52,0,2,2,还行吧，一学期一篇论文一次展示，平时分大家差的不多，给分也还可以
72361,1415,汪建达,2018-01-30 03:12:12,0,1,1,事情少但是不好好学马原容易被正态emmmmm
75032,1415,汪建达,2018-03-07 05:30:06,6,10,4,发型地中海，中年油腻男。给分很较真，补考都没过。欢迎大家来选
79533,1415,汪建达,2018-06-08 04:15:18,6,6,0,记住，千万不要参加外出实践！
80754,1415,汪建达,2018-06-30 10:37:46,-3,1,4,老师上课很认真 给分也是 ..这要用点心 期末考试认真复习一下 高绩点没什么问题.平时分老师也是尽可能给高的
80793,1415,汪建达,2018-07-01 06:30:49,3,4,1,他自己都说了，平时分给不高的。\n\n慎选！
82646,1415,汪建达,2018-07-09 01:58:56,-5,3,8,老师对哲学知识理解很透彻，上课自己很投入很尽心。给分的话，虽然跟大家说平时分会压的比较低，但其实最后还是帮大家调高了，最后的绩点很好看。
82652,1415,汪建达,2018-07-09 02:21:03,-1,1,2,辩论占了平时成绩很大一部分，但是辩论的两个组分数可以差十分 而且一定要拉开十分的差距。要是对手很强，那平时分就完了
82663,1415,汪建达,2018-07-09 02:31:05,0,2,2,别的老师平时分几乎给满，最低63、64/70，他最高65/70，期末改卷也特别严，大家自己看着办吧\n\n
82686,1415,汪建达,2018-07-09 03:22:13,2,2,0,有点绩杀
82701,1415,汪建达,2018-07-09 03:38:01,2,3,1,当了组长，所有活动都参加了，小组显示也做的不错，得了3.9，后人自己看着办吧
82741,1415,汪建达,2018-07-09 05:04:15,3,7,4,讲课挺好的，讲哲学挺有意思，期末考的话理科生自认倒霉吧。给分一般般吧 我发言好几次平时分91最后卡绩4.2，课外活动千万别去，任务不多，总之这个老师还行，对思政课绩点比较佛系的同学不用担心
83094,1415,汪建达,2018-07-09 16:05:16,1,1,0,平时分很低……
86929,1415,汪建达,2018-09-19 11:51:44,4,4,0,后排听不见
93858,1415,汪建达,2019-01-14 04:35:10,0,2,2,还没考试，上课挺水，事少，虽然编位置但是我感觉他没有根据这个点到，偶尔抽几个过道上的同学回答问题。平时分也差距不大，估计就看考试成绩了，不知道差评是咋来的，自己的问题还是别怪老师了
99067,1415,汪建达,2019-01-24 08:23:18,0,2,2,老师给分挺好的，上课进度总体比较慢，喜欢提问一些大家不怎么会的问题
99072,1415,汪建达,2019-01-24 08:28:34,2,3,1,给分可能随助教改变而变好了。老师的课程就是上课，辩论，论文和期末考。讲课不吸引人但是没管我们干什么，发言的话及时百度就好。总的来说，事少（除了辩论棘手），分数还行，高分看本事。
100852,1415,汪建达,2019-01-27 03:04:13,-2,1,3,老师很棒
110691,1415,汪建达,2019-06-28 04:31:02,5,7,2,千万不要选他的课啊！期末认真背书+选择题刷了四份，大题目理论全写了，给分3.9以下；真的不知道是咋回事啦，感觉比学数学还努力？
110700,1415,汪建达,2019-06-28 04:54:53,6,6,0,不懂这分怎么给的，平时分90，期末前刷了题也背了书，结果这个成绩。。。服了
117138,1415,汪建达,2019-09-20 00:25:21,-92,9,101,这就是浙江大学的学生的评论，分不行怪老师，真是有够可笑的呢，嘻嘻
120720,1415,汪建达,2020-01-15 23:09:13,2,2,0,给我的分居然和我无法拯救的微积分一样低，我服啦！！！！！平时好好听课论文好好写还上过政治经济学，知识还挺扎实的…真的不知道怎么给分的
120743,1415,汪建达,2020-01-16 07:51:36,0,3,3,emmm。上课感觉老师挺认真负责的  人挺好的平时分基本在90左右
120748,1415,汪建达,2020-01-16 09:07:44,3,3,0,挺糟糕的，感觉这个老师上课啥也不懂，啥也讲不出来。平时分一开始说不一定考虑发言，但最后平时成绩还是有发言的影响。这个”不一定“就很令人作呕。事少分低，上这门课的体验就和老师本人一样，有种loser的感觉。
120955,1415,汪建达,2020-01-19 02:45:44,4,8,4,所有课最差一门。只有七十几。考前背了好几天，选择题只有三道不确定，大题个人感觉并没有很糟糕 毕竟高中文科生，政治选考100分。平时分91。发邮件不回。总之傻逼一词完事🙂
125079,1415,汪建达,2020-08-28 08:21:58,7,10,3,事少，一个学期只有一个论文，一次6分钟的发言，课很水。给分很迷，但也不太差（我知道的几个人中有上90的）
125472,1415,汪建达,2020-09-10 01:52:13,2,5,3,总评79分 是我菜了
125996,1415,汪建达,2020-09-16 10:41:23,-3,2,5,好好好
128564,1415,汪建达,2020-12-24 03:18:13,-3,2,5,求4.2！
130444,1415,汪建达,2021-01-22 11:51:00,6,8,2,哈哈哈哈哈哈哈哈哈，快点选他的课！你会开心的 哈哈哈哈哈哈哈啊哈哈
147945,1415,汪建达,2022-01-11 07:48:49,6,6,0,给分迷惑
147951,1415,汪建达,2022-01-11 08:00:38,6,7,1,给分迷惑，论文好好写的，高中选了政治，考试时不确定的就几道，结果出分就3.6
147983,1415,汪建达,2022-01-11 08:57:59,3,6,3,老师上课比较无聊，我认真听得没有几节，课堂氛围因为没有发言加分一点都不卷，听课的人很少。\n\n论文好好写，签到有两次，考前认真背，高中江苏文科生，总评91，4.5。
148024,1415,汪建达,2022-01-11 10:56:11,-2,1,3,事少，给分也还可以
149001,1415,汪建达,2022-01-14 06:19:44,0,5,5,马原这种格式化的课程，老师能做的也不多。我还是很喜欢汪老师的课的，有很多生动的例子，也会讲讲什么是真实的马克思，如果不盯着绩点去看，这门课还是很有收获的。
149536,1415,汪建达,2022-01-16 01:57:47,2,7,5,感觉其实还行，比较适合划水，就四人小组一个pre加上论文加期末考试，事总体而言不多（只想划水过，也没想要学什么的我觉得体验还行），也有鼓励上交纸质笔记的环节，我没交，绩点也还行（上四了我就很满足了ToT）
156471,1415,汪建达,2022-06-20 02:25:03,2,7,5,考前正常刷题不翘课不缺作业 绩点也可以接受 老师人挺好的自己不来上课记缺勤就别骂老师平时分扣的多了……
165658,1415,汪建达,2023-01-09 06:50:20,-11,7,18,一学期从没点过名。老师讲课还不错，对同学很温和。我因为疫情延迟了返校，后来又因为阳了发高烧请病假，老师都很体谅。期中报告选了个与我本专业有关的题目，小组展示就普普通通地正常做了。二卷文科生，高中的时候政治一直不错，今年是选择题+三道论述，题型很像高考。考前那个晚上看了一遍书，95分5.0。
165778,1415,汪建达,2023-01-09 16:18:27,3,7,4,给分感觉还行吧，感觉老师人还不错，网课期间经常吧有问题及时沟通之类的挂在嘴边，上课的话我比较摸鱼（bushi）。这学期就是一个读书报告/论文+小组展示，老师会抽人回答问题（尤其是教室肉眼可见的人少。）总得来说平时事比较少。层主考前预习了一天（愧怍），主要是刷选择题和背了一些概念，最后3.9，不能和楼下大佬比，但个人满足了
166371,1415,汪建达,2023-01-12 05:54:29,9,13,4,挺温和的，上课不太管，小组展示好好做，读书报告好好写，考前好好背，是可以满的。
187272,1415,汪建达,2024-01-15 10:56:16,7,8,1,感觉老师上课稍微有点传统枯燥吧，但是事情确实挺少的，就一个小组展示加课程论文。本人工科人，考试前好好学了一个礼拜，最后4.8非常满意了
187316,1415,汪建达,2024-01-15 12:53:50,3,4,1,给分很求是，期末跟着fwj的智云课堂划了重点，背了两周4.2，比较失望吧
187355,1415,汪建达,2024-01-15 14:56:13,4,5,1,老师人挺好的，讲的还可以，有一些内容，能引发人的思考。很随和，就算同学不听也不会生气，会下来用提问的方式提醒。人也不错，在一些方面挺体谅学生。只要交一篇读书报告/论文、一次小组展示，没有作业和小测，事情应该是所有马原老师里最少的了。考前一天简单看了看背了背，最后给分也挺不错的。
209888,1415,汪建达,2025-01-07 10:29:51,3,3,0,大家好啊，我教你diy马原4.5\n\n首先选汪老师的课，缺点只有上课点人提问，但是事非常少，只有一篇小论文和一个小组做的ppt。\n\n然后上课猛猛写作业，记得举手两次\n\n期末怎么办呢？去智云听psz老师的最后一课，找一下复习提纲猛背两天，学学答题方法，不要单纯背课本，期末试卷不要空，就能90分辣！\n\n稳辣都稳辣
209904,1415,汪建达,2025-01-07 11:09:38,2,2,0,辩证看待查老师评论
210215,1415,汪建达,2025-01-08 11:52:29,2,3,1,汪老师给分无敌好，整个学期都在课上抄大物实验报告（bushi）考前两周开始背并且刷题但说实话效果不好，拖到最后两天才开始狠狠背但是从结果来看效果不大（这次期末的选择题考的很多来源于书本而且大题较细）1/3不确定，后两道道题全靠乱编填满卷子出分4.5\n\n\n\n老师的事情在马原里应该算是很少的，只有一个小组ppt展示和一篇小论文，整个学期只正式点了一次名而且提前通知了，但是上课也会通过提问的方式随机点名
220776,1415,汪建达,2025-06-19 15:43:55,0,0,0,emmmm，出分赶来评价一下吧，感觉评论辩证看待吧。\n\n怎么说呢，wjd老师的课听着能听出来是用心了的，备课啥的都很走心在做，但是毕竟是马原，没什么人听，大家都在写作业。说实话平常上课会点人回答问题，但是答不上来也不会说压力人之类的，而且点到概率不大，我本人一个学期都没被点过。\n\n讲讲上课节奏吧，其实上课节奏包括延伸部分其实讲得挺好的，听着节奏挺舒服也比较有趣，但是不划重点，相当于就是作为一门不考试的课的话值10分，但是它考试，这就有点没办法了。\n\n说说期末考试，本人复习了不到一天，期间大半在玩手机，实际用时有没有三个小时都难说，感觉比较有用的是cc98上一个极简版的复习大纲吧，花了一个小时背了大纲，应付大题很有用，小题要过一下比较详细的复习资料才能做，会细一点。答题尽量写多写满吧。最后4.2飘过，还行。
220905,1415,汪建达,2025-06-20 09:52:05,0,0,0,背多分课程，老师其实只起到一个给分的效果，那么越放任的老师自然越好
3778,1500,张立程,2015-06-17 04:09:40,1,39,38,只能说给分真的很棒
5041,1500,张立程,2015-07-02 12:26:35,2,12,10,不错不错
5664,1500,张立程,2015-07-09 05:15:43,2,16,14,给分好。
5678,1500,张立程,2015-07-09 06:24:44,-14,13,27,水水的  给分好！！\n\n
7380,1500,张立程,2015-09-14 05:16:39,9,20,11,幽默\n\n
7381,1500,张立程,2015-09-14 05:17:54,7,18,11,幽默啊\n\n
11951,1500,张立程,2015-12-23 05:23:19,1,10,9,挺好的吧 为什么还会内容太过简单
12384,1500,张立程,2015-12-23 07:19:23,-3,11,14,太喜欢老师了！人很有趣，讲课也好玩，气质帅
12945,1500,张立程,2015-12-24 11:06:57,7,17,10,有趣可爱
13665,1500,张立程,2015-12-30 09:09:49,4,13,9,………
14098,1500,张立程,2016-01-04 08:39:20,7,19,12,真心替学生着想
14142,1500,张立程,2019-01-05 21:35:45,16,51,35,讲课很棒的老师
14260,1500,张立程,2016-01-06 13:21:35,0,17,17,屁事多得不得了 半个学期都耗在这个史纲课上了
14422,1500,张立程,2016-01-07 03:20:51,4,15,11,。。。
14924,1500,张立程,2016-01-11 03:43:50,5,12,7,上课挺水，但是老师讲的很好的。很和蔼
15204,1500,张立程,2016-01-12 15:17:32,1,20,19,很棒的老师，很体谅学生的，太忙连课程论文都有可能免掉了。
15241,1500,张立程,2016-01-13 03:05:14,0,6,6,超能吐槽
15591,1500,张立程,2016-01-15 13:41:11,2,12,10,很好的老师，喜欢上他的课。
15994,1500,张立程,2016-01-17 02:14:59,2,10,8,很有意思。\n\n
17378,1500,张立程,2016-01-20 06:54:48,2,12,10,水水的，但是好老师
18280,1500,张立程,2016-01-24 04:42:52,0,7,7,没诚信
19393,1500,张立程,2016-01-24 05:11:39,11,25,14,给分太低
19396,1500,张立程,2016-01-24 05:24:50,5,25,20,课代表3.6 均绩低成狗 毁我前途 课水事多 只能说 退课保平安
19399,1500,张立程,2019-01-26 14:25:43,15,43,28,事情特别多，给分还不好。四次讨论课，还有读书报告口试。有一个文科女生特别认真做事也不能上四，也是醉了
19401,1500,张立程,2016-01-24 05:53:33,10,26,16,总觉得老师知道很多东西，但不讲出来，课有点水，给分也不好。但老师挺和蔼的呢
19402,1500,张立程,2016-01-24 05:53:53,13,42,29,给分容易毁前程  慎选
19404,1500,张立程,2016-01-24 06:01:53,-11,10,21,不多说 给分棒
19407,1500,张立程,2019-01-26 14:35:55,39,84,45,事情这么多，给分还那么低，选哪个史纲老师的课都别选他！课代表和好多特别认真的同学都没上4！
19414,1500,张立程,2016-01-24 06:29:21,11,41,30,给分好个毛
19425,1500,张立程,2016-01-24 07:47:05,16,67,51,给分低得可怕 个人读书报告小组展示小组读书报告小组口试以及四次讨论课还有校外实践 样样不水 都很认真 考试也不虚 只能说付出收获不成正比吧
19451,1500,张立程,2016-01-24 08:58:59,10,32,22,不水不水很不水，事情很多，给分还低，课代表都没上4。对老师本人是没什么意见，但是给分真不好，难道是今年（2015）变成这样的吗……大家慎重
19548,1500,张立程,2016-01-24 15:39:56,5,17,12,被骗了，给分其实超低的……
19630,1500,张立程,2016-01-25 03:35:00,2,7,5,给分好
19888,1500,张立程,2016-01-25 13:59:31,1,5,4,上课很水  任务还好不多
20368,1500,张立程,2016-01-27 07:17:50,4,21,17,客观的来讲，张老师的给分其实是不错的，许多吐槽的可能是卷面分数考的低了，只要认真上课，hold住卷面分，史纲分数不会差。老师讲的很棒的，比较锻炼能力，推荐。
20659,1500,张立程,2016-01-29 13:04:14,-2,7,9,还行吧，事多，而且每次小组展示完他都要否定刚才同学说的很多观点……真的很不爽。翘了两个月的课，其实最后也没什么影响
20955,1500,张立程,2016-02-05 10:34:11,-2,4,6,史纲课大概都这样吧，老师特能讲，每次讲完都会问，知道吧，然而没有人理他。
20989,1500,张立程,2017-07-04 08:10:29,-20,19,39,说给分不好的你们认真考试了吗，我就呵呵，毁你前途，别的科好的话这一门不上四，3.9，能影响你到哪去？有趣。おもしろい。
21049,1500,张立程,2016-02-13 13:46:59,2,5,3,人蛮可爱的
21612,1500,张立程,2016-02-29 10:31:10,-1,4,5,我做了什么给我这么低的成绩。。真的有听课
22001,1500,张立程,2016-03-02 05:26:15,-1,2,3,好可怕
22222,1500,张立程,2016-07-04 03:12:55,0,5,5,...
23320,1500,张立程,2016-03-24 08:05:36,6,8,2,可以的
25880,1500,张立程,2016-06-13 06:26:31,11,22,11,给分好TM低啊……
28504,1500,张立程,2016-06-28 09:38:29,2,5,3,老师挺幽默的啊
29114,1500,张立程,2016-06-29 08:54:00,-6,2,8,挺好的，给分不错
30776,1500,张立程,2016-07-02 12:50:51,2,5,3,坐等师生情
30787,1500,张立程,2016-07-14 11:07:17,0,8,8,事多给分差
31286,1500,张立程,2016-07-14 11:06:26,12,40,28,什么之前说给分好的都是坑。。付出收获不成正比真是醉了……感觉他并不把学生的成绩当回事，成天很随意散漫的样子，简直糟透了！
31295,1500,张立程,2016-07-03 15:07:35,-1,3,4,感觉还行吧
31307,1500,张立程,2016-07-03 15:22:39,2,10,8,分太低，真的
31364,1500,张立程,2019-09-18 07:09:27,121,234,113,腊鸡老师 全班最高分88分 一个上90的都没有 千万不要选 事多给分差 选谁也别选他 别的老师4.5以上的扎堆 他tm最高的也只有4.2 为了让更少的人遭到他的迫害 顶我上去
31445,1500,张立程,2016-07-04 02:19:38,4,8,4,虽然事儿比较多，本来以为给分比较差，不过现在好多了！主动给我们提了分，感受到了浓浓的师生情
31449,1500,张立程,2016-07-04 02:26:31,-2,2,4,事多给分差
31451,1500,张立程,2016-07-04 02:28:16,-1,3,4,作为一门思政课 还没得到过这么低的分 辣鸡慎选
31472,1500,张立程,2016-07-04 03:03:40,-2,10,12,给分真心低，在群里发成绩，给79.82.85分的同学提分，这样做真的好么？三分一绩点本来就不合理，但是明显给这些同学提分，让81.83.84分的同学怎么想？第一次给个老师低分，很多门课我考的低不难过，但是就这个老师的做法让我很是气愤！
31478,1500,张立程,2016-07-14 11:06:48,4,22,18,事情的确多一些，比其他班多一篇手写读书报告和一次小组展示，给分我也不说糟糕吧，毕竟自己也没有太走心对待史纲。我只能说其他老师给分太好要求太水，同学4.5 4.8扎堆，感觉挺不公平的，心情愤慨。血的教训，后人慎选。
31486,1500,张立程,2016-07-04 03:20:56,5,9,4,给我加了一分( •̀∀•́ )
31493,1500,张立程,2016-07-04 03:27:57,4,5,1,讲道理给分挺好的真的，而且很水
31498,1500,张立程,2016-07-04 03:41:28,6,13,7,自己初中高中不听历史课历史差。但是老师最后还是给加了一分提了一档。老师真好膜膜打。
31507,1500,张立程,2016-07-04 04:12:30,-1,2,3,事很多给分很低…此刻心情复杂
31512,1500,张立程,2016-07-04 04:44:20,2,5,3,全班最高4.2…
31513,1500,张立程,2016-07-04 04:49:54,-1,3,4,给分低成那样~还说什么
31516,1500,张立程,2016-07-04 04:56:35,0,1,1,不做评论
31517,1500,张立程,2016-07-04 04:58:16,2,4,2,老师懂得很多啦，脾气也很好。展示讨论课什么的和别的班差不多啊。平时也挺水的。就是给分。。。最高88?
31518,1500,张立程,2016-07-04 04:58:46,15,34,19,老师都已经努力在调分了。那些说老师抬分还看不下去的什么心态。不给你抬分就不好了吗。老师都已经多努力在调分了。不调也不好调也不好 要闹哪样
31528,1500,张立程,2016-07-04 05:15:44,0,2,2,史纲评分不考虑试卷难度系数这点建议改。事情多 给分不好 \n\n
31530,1500,张立程,2016-07-04 05:23:23,-1,1,2,呵呵呵
31542,1500,张立程,2016-07-04 05:52:28,15,37,22,我觉得老师没有那么可怕吧，老师懂得也很多，讨论课四次可能有点多，三次可能比较好，剩下事情也不算很多啊，上课老师也在很认真的讲课，全班没几个抬头都在玩手机难道能赖老师吗？其他老师水确实给分好，但我觉得卷面hold住，平时好好做，是不会亏的。分数这种东西，有正态在，肯定不会让所有人满意。
31561,1500,张立程,2016-07-11 12:44:41,2,3,1,给分低
31591,1500,张立程,2016-07-04 08:48:38,0,1,1,其实老师也很不容易了， 虽然大家都低了点毕竟也要看卷面成绩总不能乱给分吧
31622,1500,张立程,2016-07-04 09:28:47,2,3,1,普遍给分极低
31783,1500,张立程,2016-07-14 11:10:53,1,6,5,说句实在话 三个班两百多人最高分就90，上课很水什么的我都不想黑，要刷绩点的大神们自己斟酌吧\n\n
31807,1500,张立程,2016-07-05 02:42:22,0,1,1,3个字
32352,1500,张立程,2016-07-06 08:30:04,2,3,1,为什么这么说他啊我觉得他人超好啊！二话不说给我签条补选...
32418,1500,张立程,2016-08-10 00:36:17,-2,3,5,该说的这里差不多都说了，我只想说，这种老师在品德思想上真的很有问题呢
32804,1500,张立程,2016-07-14 13:25:13,0,1,1,额……人不错的，给分我觉得文科生比较好……考试比较高一点……其他上课什么的，平时分都是看运气的……我怎么觉得我平时超级水……选了的人自求多福= =|||自己多刷脸，上课积极一点，认真一点也是基本咯\n\n
33271,1500,张立程,2016-09-17 08:41:47,2,3,1,。。。可以吧，讲的还好
33839,1500,张立程,2017-02-22 08:12:19,1,1,0,老师超级幽默
34172,1500,张立程,2017-01-19 14:31:37,1,3,2,课划水，但讨论课和作业要好好完成，期末考试选择题很难所以分低也不是因为老师，只有5点几评分有点没道理
34844,1500,张立程,2016-10-25 02:46:29,5,6,1,考试怎么样不知道，但是平时还是很好的，课不错，人和蔼
36633,1500,张立程,2016-11-15 06:36:21,-2,3,5,负分滚粗。
39878,1500,张立程,2016-12-28 05:37:40,5,9,4,感觉认真听干货还是挺多的 也是挺有趣的 分数高低不重要
41300,1500,张立程,2017-01-10 12:46:19,4,5,1,好老师
41964,1500,张立程,2018-10-17 10:44:59,24,83,59,什么心态，张老师超级棒的好不好，教学实践也很好玩一整个学期一次小组展示两次讨论，给分低是他让同学给评的分啊。老师超级亲切，常常和群里的同学打成一片，课下也是个很爱玩的老师。真的很棒，不要仅仅根据绩点评价一个老师好呐？
45370,1500,张立程,2017-01-19 13:51:24,12,22,10,很好的老师啊，一点都不绩杀
45371,1500,张立程,2017-01-19 13:15:29,-3,2,5,果然绩杀，上课无聊
45373,1500,张立程,2017-01-19 13:17:05,2,2,0,哈哈 看你自己啦
45375,1500,张立程,2017-01-19 13:21:01,30,71,41,好老师，自己不认真不积极期末成绩不好也不能全部归咎于老师吧，平时如果真的按要求去做了，不管绩点多少都会有一些收获和理解吧
45390,1500,张立程,2017-01-19 13:44:57,9,11,2,张老师666
45391,1500,张立程,2017-01-19 13:45:01,16,39,23,学到很多，老师很萌啊，会很大家水群，真师生情
45392,1500,张立程,2017-01-19 13:45:06,15,27,12,好老师，正态本来就不会每个人都满意。
45393,1500,张立程,2017-01-25 04:41:05,10,15,5,给分还是不错哒。
45394,1500,张立程,2017-01-19 15:00:52,16,25,9,好评啊，给分高，给分好，浓浓师生情啊。老师人也挺好的，有时较起真来很可爱
45395,1500,张立程,2017-01-19 13:45:58,8,10,2,老师很好啊 观点啥的都蛮好 给分也好呀 就是你点名一定要在 一定啊
45396,1500,张立程,2017-01-19 13:46:55,5,7,2,老师很幽默啊~也不怎么点名 期末给分还可以哦 平时分很高挂科率很低
45397,1500,张立程,2017-01-19 14:07:38,8,10,2,给分可以
45398,1500,张立程,2017-01-19 14:58:06,8,11,3,挺不错的，虽然事情多但是给分实在根据平时课来。所以付出与努力还是成正比的。
45400,1500,张立程,2018-07-06 14:03:32,98,176,78,讲道理  我上课基本不听课 就听听几个有趣的点。    每次作业做了，考试也认真考，给分还是不错的吧，老师人蛮好的。
45401,1500,张立程,2017-01-19 13:49:26,0,1,1,被正太
45402,1500,张立程,2017-01-19 13:49:28,16,40,24,张老师的课得细听才有收获，无奈史纲课大多数人都不感兴趣。其实老师人挺好挺和蔼呢，事情不算特别多，给分的话，这学期似乎真的从良了诶~
45405,1500,张立程,2018-08-27 10:09:07,16,25,9,是个好老师，是我上课没好好听了，如果选了这个课，一定要认真，能学到很多，虽然是党性很高的课，但是老师懂得很多，绩点嘛确实一般，不过我也不是太在意这个啦，反正均绩过三就行
45406,1500,张立程,2017-01-19 13:51:45,7,7,0,嗯…只能说超乎我想象的分数吧。
45407,1500,张立程,2017-01-19 13:52:10,5,7,2,浓浓师生情
45409,1500,张立程,2017-01-19 14:10:19,18,43,25,老师给分变好啦，人也很幽默。至于分数的问题，对于个人来说，讨论课一定一定多发言，小组展示自己也要说话。老师给分实际上比较实在，往年的情况不能苛责老师。最后卷面hold住。\n\n老师真的，非常逗哈哈哈哈哈哈哈哈哈哈哈
45410,1500,张立程,2017-01-19 13:53:02,5,5,0,我觉得老师很幽默，很有意思的，给分也还好吧，反正喜欢
45412,1500,张立程,2017-01-19 13:54:34,16,28,12,不知道为什么，这学期张老师突然从一个绩杀变成了给分小能手(突然兴奋.jpg)
45413,1500,张立程,2017-01-19 14:09:13,6,6,0,老师挺有趣的
45416,1500,张立程,2017-01-19 13:58:26,2,2,0,可爱极了
45417,1500,张立程,2017-01-19 16:03:04,2,3,1,其实老师给分还是很好的 上课不发言的我最后也拿到了不错的绩点 而且老师也很幽默啊 可以的
45418,1500,张立程,2017-01-19 14:02:38,2,2,0,一句好，好老师。
45420,1500,张立程,2017-01-19 14:03:31,2,3,1,老师很好 上课还给我们讲一些有趣的历史小故事 长得帅，给分也很棒！
45421,1500,张立程,2017-01-19 14:04:42,3,3,0,不如师生恋
45424,1500,张立程,2017-02-18 12:40:39,3,3,0,给程老师答的，程老师的学术水平绝对不是盖的，对待历史非常严肃认真，可惜不把这门课当水课的人实在是太少了。不过老师把平时分的统计全交给组长课代表是不合适的，紧密团结在组长周围的人都挺爽的，嗯，不针对所有组长。
45427,1500,张立程,2017-01-19 14:08:37,6,7,1,感觉，不是很绩杀啊 虽然给分也不水，但还是蛮客观
45428,1500,张立程,2017-01-19 14:09:50,6,7,1,老师挺好的 讲课挺好的 人也挺好的。虽然平时有小组展示 还有两篇读书报告 还有两次讨论课 事情有些多但是也不难。给分是看老师相对的没错  但是学习是自己的事吧  没有好好学过也没有好好复习的人就不要说什么给分不好了。而且今年给分不错哦！
45431,1500,张立程,2017-01-19 14:15:22,17,26,9,一学期就点过一次名，还是随机抽了四五个，报完名字还说到“正态就看它了”。挺随和的一个老师吧，本人上课固定第四桌水手机，怒刚他也没什么关系。不上课的时候还陪我们水群，期末群里疯狂刷“浓浓师生情”
45435,1500,张立程,2017-01-19 14:22:56,6,7,1,老师很和蔼啊 讲得其实还有趣的，而且人超好，很可爱！hhhhhh  绝对不是绩杀。虽然身为理科生真的没什么兴趣，但平时任务还是好好做了，最后给分还算可以。要是什么都不付出就要拿分，那也没什么好谈！
45472,1500,张立程,2017-06-15 14:50:05,6,9,3,认真听的话能听到不同的鼓点；既符合马克思主义教育理念，在又红又专的团队里也算一股清流.还有、谁说没有90分的。好几个吧（扎堆给90+的很公平吗？
45475,1500,张立程,2017-01-19 15:05:28,4,5,1,老师给分其实挺好挺客观的。只要各方面自己都稍微上上心，期末绩点就会不错了的。最后4.2
45477,1500,张立程,2017-01-19 15:07:20,11,13,2,老师超级会水群，仿佛一直在视监(ง •̀_•́)ง
45493,1500,张立程,2017-01-21 01:26:50,2,2,0,很有趣
45495,1500,张立程,2017-01-19 15:33:51,2,2,0,给分公正客观
45963,1500,张立程,2017-07-02 08:06:39,10,13,3,老师人挺好的，认真作展示，写论文，绩点上四没问题，但给分也不太高~
45986,1500,张立程,2017-01-20 10:47:39,1,2,1,讲道理，除了上课没有认真听，其他每次任务都有用心完成，给分真心不好。（看了评论还想吐槽，是不是给你的分高就叫给分客观公正啊）
46171,1500,张立程,2017-01-21 00:46:04,3,4,1,作为一个历史盲，真的是每一节课都水手机。但是老师挺理解我们的，看到我写其他作业一笑而过。哈哈。平时论文认真写，讨论课多参与，当个观察员也好的。考试的时候认真写，应该不会太差。虽然85只有3.9 差一分就能4.2了，但是还是觉得比较满意，因为毕竟之前觉得我史纲会挂呀！
46249,1500,张立程,2017-01-21 04:46:21,2,2,0,没有说的那么差吧，是个在群里很活跃的老师。讲真我确实没怎么认真听课，也没什么作业，但给分还可以
47046,1500,张立程,2017-01-23 11:04:39,-1,1,2,给老师干活，结果那么低的绩点…伤心?
47148,1500,张立程,2017-01-24 04:50:45,1,1,0,选的是他的课，最后是另一个程老师上的 ，感觉这个老师真的挺好，事情不太多，而且比较照顾学生，我那么水，最后居然4.5，真是谢谢老师
48393,1500,张立程,2017-03-03 01:11:38,0,0,0,好好好
48394,1500,张立程,2017-03-03 01:12:58,2,3,1,从假老师那边逃出来，这个老师真的讲的太棒了。
50986,1500,张立程,2017-05-11 03:10:14,4,4,0,有点激进 有点激动，老师和你真心说一句 史纲没人听的，您别那么在意
51160,1500,张立程,2017-05-21 10:57:55,0,1,1,呵呵呵
51727,1500,张立程,2017-06-08 16:18:56,8,8,0,老师特别爱笑 很萌的呀 为啥分这么低
52017,1500,张立程,2017-06-14 07:05:36,0,0,0,挺棒的
53515,1500,张立程,2017-06-27 01:42:11,1,1,0,老师很可爱，等会就要考试了，来这里蹭蹭仙气
53571,1500,张立程,2017-06-27 04:59:16,2,3,1,老师人好好啊TVT讲得挺好的，人也很随和，可我们都不听课他也很无奈
55731,1500,张立程,2017-07-02 09:47:09,1,1,0,老师挺好的
55735,1500,张立程,2017-07-02 09:51:15,2,2,0,老师讲了很多东西，也很认真，是带着感情在上课的。\n\n讨论课和上课提问都好好发言的话分数没问题的，但如果你每节课都有玩手机水水过还指望高分就算了吧。
55746,1500,张立程,2017-07-04 04:20:30,-7,2,9,老师讲得超级好，给分也超高，么么哒
55770,1500,张立程,2017-07-02 10:59:13,0,0,0,挺好的，虽然上课不怎么样，但给分不错
55913,1500,张立程,2017-07-02 15:42:08,2,3,1,绩点靠努力了，老师虽然事多但还是hin可爱的，水群王子
56163,1500,张立程,2017-07-03 07:16:23,-12,0,12,上课从来不听 不过读书报告认认真真写了 期末考开卷的大题也比较简单（选择题建议直接放弃）最后给分也不错 轻松4.5
56573,1500,张立程,2017-07-04 07:43:23,3,6,3,张老师好好啊啊啊啊！！超可爱，到现在最喜欢的一个老师！٩(˃̶͈̀௰˂̶͈́)و在群里会经常和学生互动，完全没有老师的架子，上课也很随和的，积极发言，做小组长干事情，讨论也态度端正的，给分不会低到哪里去，良心说，分低的同学自己不活跃，不认真，上课一次也不回答问题，小组作业也甩锅，能怪老师吗？
56574,1500,张立程,2017-07-04 07:43:04,1,2,1,老师超好玩的，就像大哥哥一样。呸，他就是大哥哥(ಡωಡ) 上课要是仔细听可以听到不少深刻的东西。
56580,1500,张立程,2017-07-04 04:13:44,0,0,0,还好吧
56584,1500,张立程,2017-07-04 04:23:03,2,3,1,气质型，自嗨，声音好听，通情达理
56585,1500,张立程,2017-07-04 06:04:33,-2,3,5,推荐甘均先，谁上谁知道，没事给分好，
56589,1500,张立程,2017-07-04 06:05:44,2,2,0,\n\n张老师讲得非常棒，很有收获。超赞！爱您！
56668,1500,张立程,2017-07-04 08:21:59,2,3,1,老师人真的好……讲得也有意思
60757,1500,张立程,2017-10-29 12:23:32,3,8,5,我觉得张老师7分差不多了，马克思主义学院的老师，你懂的，太左了，感觉没怎么备课就来上了。
61479,1500,张立程,2017-11-17 14:11:14,2,3,1,老师人挺好的
62987,1500,张立程,2017-11-27 23:55:23,3,4,1,哈哈哈哈哈群里发zz表情包的还以为是他儿子
66083,1500,张立程,2018-01-11 12:56:32,7,9,2,老师人超好，很有思想，也很有趣，每次上课坐在最前面，虽然很多同学都不听（常态吧诶）但是还是讲的很有激情。老师值得更高的分数，我给了满分！
66165,1500,张立程,2018-01-12 08:23:42,6,8,2,上课真的很水啊 学不到什么\n\n但老师人还蛮好\n\n平时全靠大佬组长carry
67162,1500,张立程,2018-01-25 04:56:37,5,7,2,浓浓师生情٩(๑^o^๑)۶
67235,1500,张立程,2018-01-20 13:30:41,3,5,2,很好的老师
69540,1500,张立程,2018-01-25 03:12:55,3,4,1,老师会有一次点名\n\n还有老师给分真的很不错\n\n
69542,1500,张立程,2018-01-25 03:23:32,6,7,1,老师人很好，总是乐呵呵的，上课和讨论课的时候需要发言，但是偶尔有一些发言很水，纯粹为了发言分，但是上完一学期的课，自己的一些想法与间解还是很有提升的
69543,1500,张立程,2018-01-25 03:24:54,3,4,1,好老师，自己不认真不积极，理科生期末成绩不好也不能全部归咎于老师吧，平时如果真的按要求去做了，不管绩点多少都会有一些收获和理解吧
69560,1500,张立程,2018-01-25 03:53:24,-1,1,2,给分超好，上课水，事情少
69569,1500,张立程,2018-01-25 04:00:55,3,4,1,老师人挺好=给分很不错=一学期会点几次到=
69597,1500,张立程,2018-01-25 04:49:50,-3,0,3,给分没有上面说得那么好，不过自己没被正态已经很开心了，当过一次观察员，尽量多发言吧，相比真正讲得好的老师确实有差距，不过也很好了，对了，一学期就点过一次名，随机的...
69603,1500,张立程,2018-01-25 05:12:06,1,3,2,超好的老师，上课侃侃而谈，懂得特别多，给分也超好，会水群的老师，很可爱的
69623,1500,张立程,2018-01-25 05:41:12,2,3,1,真的是好老师，对于历史并不死板地照本宣科，很有趣，而且老师对我们很好哦，浓浓师生情，打call
69661,1500,张立程,2018-01-25 07:32:34,2,2,0,我觉得让同学评分很不合理 讨论课的评分全看同学心情 倒是论文认真写了老师评分就不错了
69714,1500,张立程,2018-01-25 09:00:22,1,4,3,老师挺好的，已经尽量给大家高分了，但因为正态嘛，所以有些事老师也无奈。
69767,1500,张立程,2018-01-25 10:49:14,-1,2,3,老师我好惭愧，每一节课都在背大英。师生情啊。好老师！
69782,1500,张立程,2018-01-25 11:24:45,4,7,3,老师一学期点一两次名\n\n感觉历史学术素养很好\n\n虽然不按课本讲有点乱\n\n来教史纲这种思政课可惜了\n\n每次老师上课都是前几排空着\n\n真的心疼老师了\n\n\n\n史纲上课完全划水\n\n一次言都没发过\n\n但读书报告认真写讨论课积极发言\n\n以及卷面分数凭高中历史基础还是混了个4.2\n\n希望老师能有机会上真正的历史课！！
69871,1500,张立程,2018-01-25 14:47:23,1,3,2,不错真心不错
69887,1500,张立程,2018-01-25 15:24:27,-5,1,6,可以说是真的适合没有素养的水课  小组作业很差  讨论课没有说过话  但是只要考试写满了也能拿4.2  另外老师可是水群小王子哦！
70194,1500,张立程,2018-01-26 08:14:26,8,11,3,说给分好的都是绩点高的。。。hhhhh好不好听了就知道了。反正不喜欢这个老师。。。。。。。
70378,1500,张立程,2018-01-26 14:15:44,7,9,2,讲课是很认真，但是缺乏乐趣，绩点给的太低。
71511,1500,张立程,2018-01-28 14:20:36,10,14,4,只能说这分数对不起我花的时间，给分真的不厚道
72285,1500,张立程,2018-01-29 21:06:58,-2,2,4,喜欢水群的老师一定是好老师
72558,1500,张立程,2018-01-30 11:19:01,1,1,0,也就这样吧。。。
72702,1500,张立程,2018-01-31 02:17:47,0,2,2,上课基本没什么人听，但是感觉讲得还好吧。给分真的不怎么样，平时事情可能有点多，考试一定分数要高一点！
73271,1500,张立程,2018-02-06 02:17:51,-3,5,8,我来更改数据，给分真烂！！！我才52％? ? ? 拉均绩！！！！卷子和读书报告我都写得非常认真！！！我还是观察员，一点加分都没有！！！老师你真的好棒棒哦！！！?
73439,1500,张立程,2018-02-01 14:39:27,10,13,3,上课催眠 冷嘲热讽
73747,1500,张立程,2018-02-03 05:04:20,1,2,1,课没啥问题就是不够生动。给分已经很人性化了。就是期末真是变态，各种十分二十分的大题。平时多看看书还是很有用的。
73803,1500,张立程,2018-02-03 06:18:38,2,2,0,有的时候老师挺可怜的，因为他讲的历史人物我们真的不知道呀（捂脸）而且考试基本就是乱答题了，一个历史好的人如是说。最后的成绩还是挺惊喜的，因为我以为还要再低一点呢…
74516,1500,张立程,2018-03-02 16:43:02,1,1,0,可能老师真的学识很丰富，但是讲课略微有点不走心，像流水账讲一段历史，思考性东西比较少，而且有种调侃史纲课的感觉，可能黑色幽默我不懂吧。上课自己看相关的推荐书可能收益更大。
74749,1500,张立程,2018-03-05 12:08:42,1,2,1,上课风趣，人也好说话。期末考一不小心浙江发展抄成中国发展，20直接没了，以为凉了，结果还行，师生情还是有的。给分良心。\n\n偶尔点名，不过是正常操作。
75308,1500,张立程,2018-03-09 01:23:45,1,1,0,就是nb\n\n
75366,1500,张立程,2019-01-26 14:25:21,12,24,12,非常想给他零分，第一节课就说“世界上有三种性别，男士女士女博士”excuse me？？？倒尽胃口.
76036,1500,张立程,2018-03-25 10:27:48,3,3,0,事情超多，尽心尽力完成后，给分让我失望。
76376,1500,张立程,2018-04-05 12:22:23,1,2,1,小组发言约定15-20分钟，实际一节课一组，讲课草草带过，辣鸡
79475,1500,张立程,2018-06-06 07:18:30,1,3,2,看得出来老师史学功底深厚，各种史料信手拈来，平时也主张我们看第一手的历史资料而不是在网上人云亦云。虽然有展示，有讨论课，但是不辛苦。史纲课程其实能上的这么有营养真的很不容易了，认真听能知道很多历史具体的细节。
79695,1500,张立程,2018-06-13 01:48:51,8,10,2,我就是来拉一下分的。“大学性骚扰过多是因为招的女生太多了”，还觉得女生写不出来，会让老师帮忙写，我不管这是开玩笑还是怎样的心情说出这种话，但这种脱口而出的话一般都是内心的真实想法了。第一次评价居然给了这一位，生气
80579,1500,张立程,2018-06-28 04:40:38,0,0,0,不错的
80580,1500,张立程,2018-06-28 04:46:04,2,2,0,老师反对正态分布。我给十分。
81725,1500,张立程,2018-07-06 03:51:59,1,1,0,老师挺好的，但我赶上的辣鸡组长 讨论课也不来 口试也不来 全靠组员 唉 不好说今年老师给分如何...
84545,1500,张立程,2018-07-13 07:00:10,1,1,0,老师给分是真的好，虽然上课有点水，但是人真的非常可爱，很亲和
84553,1500,张立程,2018-07-13 07:19:54,-1,0,1,超棒的一个老师，给分真的很好，实践课超开心，上课略水会有三次点名
84563,1500,张立程,2018-07-13 07:39:25,0,0,0,老师给分很好啦，而且上课也很有意思，也会和大家一起水群，超级棒的老师！
84568,1500,张立程,2018-07-13 08:04:39,0,0,0,老师蛮好的
84686,1500,张立程,2018-07-13 14:14:14,0,0,0,老师很好啊   史纲课事情也不算多  给分也不错
85066,1500,张立程,2018-07-15 08:18:11,0,0,0,
87018,1500,张立程,2018-09-20 03:12:40,1,1,0,很有趣啊明明！
87742,1500,张立程,2018-10-11 06:30:34,-1,1,2,姿势水平不够啊…差不多是个普通大v的水平…幸好声音听起来不会让人觉得很难受
90948,1500,张立程,2019-01-26 14:31:20,-8,12,20,观念也太偏激了吧，说国宝丑没必要赎回，十二生肖这种具有重大历史意义的你一句丑就不回了？浙大的商科毕业出去就会被歧视？就你的人大nb吗？
90959,1500,张立程,2018-11-28 05:23:20,0,1,1,观点片面偏激，时不时在群里要发票。
92060,1500,张立程,2018-12-25 23:02:35,-2,2,4,后期基本上不讲课，身为老师上课经常迟到，课堂展示，论文，还有考试（纸质材料），事情多，给分低，非常非常不建议选
93728,1500,张立程,2019-02-04 09:56:16,-53,28,81,真的是受不了“浙江精神与浙江发展”这本书了。浙大在浙江本地招生过半导致“生源平均质量严重下降”就不说了，还强迫所有人学什么“浙江精神与浙江发展”，简直是一本神书，把“浙江人”吹得上天，字里行间透露出的莫名优越感，还要弄个“精神”别人一起学习！说句不好听的，作为一个外省人，你浙江精神和我有个屁关系？！谁给你的勇气把它弄成必修？学你mb，你要学自己学，开成选修课，我tnd这里屁都不放一个。思修书内容还不够吗？还要你这本烂书来占用我的复习时间？真是mmp了，脏话都是都是对其赞美，真希望有些制定者能长个脑子
93850,1500,张立程,2019-01-14 03:59:15,-15,2,17,老师自己上课迟到，找人代课，一半的课程都让学生讲，没有师德。
94070,1500,张立程,2019-01-15 05:47:24,-4,1,5,老师挺好的呀 史纲课全都写作业从来没听过，两次讨论课随便发言两次，论文认真写，期末考前翻了翻书，靠着高中的人文历史素养答卷，最后水了4.2红红火火
95983,1500,张立程,2019-01-20 10:17:09,1,2,1,说实话是很可爱的老师！虽然平时有点佛，但是对学生真的很好，作业不多成绩也很nice，为张老师打call！！
96273,1500,张立程,2019-01-20 15:51:56,2,2,0,被正态了，老师还行，给分不太好
96364,1500,张立程,2019-01-21 01:14:21,1,1,0,？？？？？？
99373,1500,张立程,2019-01-24 15:53:38,3,3,0,给分emmmmm\n\n文科生的我微积分甲的绩点都快比史纲高了
99548,1500,张立程,2019-01-25 02:39:44,14,17,3,水平是有的，部分观点过于偏激。但是总体是一个敢说实话，把学生当朋友的人。我历史也比较差，只能平时多表现，最后也没上4，不过也可以接受。建议期末试卷要写满，不能不做。至于浙江精神这本书，说实话就考了一个选择和一个论述，那个选择我们浙江人也不知道，论述也是现翻书的，跟是不是浙江人没关系。
99643,1500,张立程,2019-01-25 04:26:27,3,4,1,喜欢张老师。虽然他总是惊讶于我们这么无知哈哈哈，很萌很渊博的老师，声音太棒了。感觉老师私下是一个很有趣的人呢，表情包多多的。
99683,1500,张立程,2019-01-25 04:58:14,3,4,1,事情少，上课很水，也没有个人鹅颈和mooc这种乱七八糟的东西。随便听两耳朵能感觉老师的水平还是不错的。作为理科生当组长和一个班的文科生划水一学期绩点海星。希望学校改一改1.15的课吧，老师也会和我们吐槽吃好几年学霸餐受够了呢
99686,1500,张立程,2019-01-25 05:04:05,6,8,2,老师讲课很有趣呀，水课的话他也不会管，还认识了可爱的小组同学，总体上课体验不错！\n\n骂浙江精神的同学我也就呵呵了，这占用你复习时间了？都是浙大学生了注意一下素质可以吗？
99699,1500,张立程,2019-01-25 05:19:29,1,2,1,啊我死了，我的绩点巨低，组长而且平时的作业任务，展示全部认真完成，期末考试成绩均分，但是！绩点在均绩一下很多啊
99703,1500,张立程,2019-01-25 05:20:53,2,2,0,老师很可爱 给分也尽力在调了
99704,1500,张立程,2019-01-25 05:21:02,1,2,1,上课无聊，都没多少人听，给分还差
99711,1500,张立程,2019-01-26 14:12:13,-4,1,5,垃圾给分
99736,1500,张立程,2019-01-25 06:01:28,4,5,1,我想把这次评价分成两部分\n\n第一对于张老师：老师知识很渊博 可以说是一个通晓古今的老师 上课我觉得是形式问题 比较尬 比较无聊 但这不影响老师是一个好老师\n\n\n\n第二对于绩点：我们小组的读书报告用的是我的读书报告    唯一一次小组讨论课我也算是小组里面最积极的 就算这门课很水我也每次都按时到 从不早退迟到  但是就算是这样 最后也是79分 3.3 可能这个绩点也不是那么那么低 但是正态分布的规则是：30%的人在79及以下 这就证明我是全班垫底的那百分之三十 这样一想 心里面就很不是滋味 我是文科生 我很喜欢历史 所以说实在话 我最喜欢的历史成为我最辣鸡的一门课 真的很难受 我也不是觉得自己多厉害觉得上个班级均绩（3.7）还是可以的 4以上我都不追求了 结果还是这样\n\n\n\n所以综合两方面打个6分
99742,1500,张立程,2019-01-25 06:16:04,-3,1,4,差评。
99758,1500,张立程,2019-01-25 06:31:32,-9,1,10,投诉信：\n\n1.学生询问了5位周围学生后，成绩分别为76、77、78、79、81，在随机抽样下样本均值与方差似乎偏低，远远低于秋学期其他老师中特平均成绩（秋学期其他老师平均分咨询了5位学生后大约在85-95之间）。因此，我们五位学生都希望能够获得相关具体评分过程信息。\n\n2.本人2次点名均到达，从无缺课情况，期末论文格式规范、字数为6万字，是在导师指导下秋冬学期写就的学生的书稿内容。期末考试前后整页写满无空白，并且所考题目均是所带资料中充分准备过的内容，然而成绩却是77分。有一位同组同学，所带考试资料完全相同，所答内容几乎相同，期末论文字数为5000字，平时点名未到1次的情况下却也是78分。因此，非常疑惑在打分评分过程是否公平公正、合理合情。
99794,1500,张立程,2019-01-25 07:34:33,1,2,1,给分非常低
99814,1500,张立程,2019-01-25 07:56:58,3,5,2,给分挺好，水水的都能上四
99840,1500,张立程,2019-01-25 08:15:15,6,8,2,不知道前面一些同学知道自己的成绩不理想时有没有和课代表反映过，课代表在群里不是说了如果和想象中差距很大可以反映一下嘛…我觉得都这么说了，只要有正当理由，老师应该会适当调整的。这一点上我觉得张老师做得挺好的。然后那位论文六万字同学，难道你觉得你们这样恶竞是一种很好的风气吗。
99897,1500,张立程,2019-01-25 09:17:53,0,0,0,有期末论文? ？
100586,1500,张立程,2019-01-26 11:04:07,-2,3,5,平时没怎么听课，就把基本的作业都做了，考试拼命写看运气 4.5挺好的
100637,1500,张立程,2019-01-26 14:42:11,-18,16,34,大赞这段评论！什么浙江精神与浙江发展鬼东西。不过是在你浙江上个学而已。说起来哪里没有历史文化名人？？？我家乡古时候比你浙江名人学者多多了！\n\n真tmd恶心！\n\n复制一遍前面那位仁兄的评论，踩的基本浙江人
100660,1500,张立程,2019-01-26 14:07:48,0,1,1,老师真的好
100665,1500,张立程,2019-01-26 14:18:52,6,9,3,我觉得张老师讲课挺好的吧，绩点低的肯定有自己的原因，能不能不要喷老师？！我觉得张老师真的很和善，讲课也很幽默，上他的课很轻松，虽然我绩点只有3.6，但是是我自己的问题，总之我觉得张老师讲课很好，建议大家选张老师的课，希望大家不要被那些恶意诽谤误导！！
100666,1500,张立程,2019-01-26 14:20:04,3,4,1,老师人超nice 上课很无聊
100668,1500,张立程,2019-01-26 14:20:40,0,1,1,优秀啊
100669,1500,张立程,2019-01-26 14:21:10,0,1,1,只能说低于自己的预期
100670,1500,张立程,2019-01-26 14:21:59,3,5,2,怎么会有这么可爱的老师啊哈哈哈哈是个小公主了！宠着！
100672,1500,张立程,2019-01-26 14:23:00,0,2,2,超好的老师~棒！
100673,1500,张立程,2019-01-26 14:23:46,-5,5,10,说实话，对于我一个理科生，高中几乎没学过历史，期末也能考80多，最后绩点出来4.5，我就觉得，这老师，真好。
100674,1500,张立程,2019-01-26 14:25:23,0,1,1,我觉得很有趣啊  史纲这种枯燥的课老师能讲成这样 很不错啦
100676,1500,张立程,2019-01-26 14:26:50,1,3,2,事少 真的少 老师挺可爱的
100677,1500,张立程,2019-01-26 14:27:36,2,3,1,挺不错的，很有耐心哦
100678,1500,张立程,2019-01-26 14:27:51,2,3,1,老师人很好，学术基础超扎实～我们这种小菜鸡的各种错误秒发现，做展示还有点小担心的说。但是老师人很好，留给我们很多时间，事情也不多，总之就是非常棒！
100679,1500,张立程,2019-01-26 14:28:01,3,4,1,认真做事和期末考是两回事好吧，丢了一个上不了四正常啊，犯不着自己绩点稍微比预期低一点就抱怨吧，这不是自己的问题吗？张老师给的分已经很好了。
100680,1500,张立程,2019-01-26 14:30:05,2,2,0,老师事情很少，而且有点可爱(有点无聊也是不过总体还是很好哒!
100683,1500,张立程,2019-01-26 14:32:24,5,8,3,事情少，我舍友期中期末肝论文，而我感觉史纲好像没有过什么作业一样，后来想起来了，一个小组展示，一篇一页信纸的读书报告还有一个小组的1k读书报告，这样的史纲老师还去哪里找～而且老师人很好，正态也非他所愿，在群里和我们聊天很可爱哈哈哈哈。但是史纲是伤透我心的一节课（和老师无关），绩点3.3…第一门下4的，突然就自闭。
100684,1500,张立程,2019-01-26 14:32:31,-1,2,3,虽然绩点只有3.6（其实我对非专业课的要求只是不挂），不过老师事情很少，只有一次小组展示、小组读书报告和个人的浙江精神读书报告，上课也很认真。还是很推荐各位来选的。
100688,1500,张立程,2019-01-26 15:09:51,13,17,4,再来客观评价一下吧，老师自身知识丰富，干货型，上课确实不够有意思，容易走神。一个学期一次个人读书报告一次讨论课一次小组分享一次小组读书报告，个人读书报告要求1500字，助教评阅，小组的一组一份就好，然后回答一个老师的问题，由老师给分，期末会点名一次当考勤，讨论和分享是小组互评，事情讲真不算多。缺点的话，不可能出现4.5以上扎堆之类的情况，因为平时分主要是看互评，老师不会调分，加上大家期末分数不会太高(想想那些多选题吧)，总评高分的确少，想拿4.8甚至满绩的同学需要真的很强才行，想水水拿高绩点还是不太可能的，当然小组大佬带飞上四还是可以实现的，至于30%的正态要求老师也没办法，所以被正态应该是所有班都会有的情况吧。最后认真做了真不一定有好成绩，毕竟还是要看结果，展示什么的不够精彩或者讨论课发言一般的话确实有可能分数偏低，大噶自己权衡吧
100694,1500,张立程,2019-01-26 14:44:56,5,6,1,老师人很好 事少作业不多 讲课很好要自己去听  给分不错的
100714,1500,张立程,2019-01-26 15:15:39,2,3,1,老师很好，老师专业能力很强，上课具体怎么样先不说，就想给大伙说一点，老师打分没那么低。说周围人分数都低的，是不是问的都是组员？有没有想想会不会是小组作业做得不够好呢？打分没毛病。
100773,1500,张立程,2019-01-26 23:43:09,11,15,4,前面大段大段的差评是几个不满老师的研究生刷出来的，不信查王心月老师，有一样的评论。
102062,1500,张立程,2019-01-30 08:45:33,-1,4,5,老师给分还是不错的，尤其是和平时的任务量对比起来。上课也会侃，如果排在遍布大课的一天里，体验还是相当不错的。
102252,1500,张立程,2019-01-31 15:24:10,3,5,2,史纲绩点3.0，难受
103260,1500,张立程,2019-02-27 04:56:56,4,9,5,那个说浙江精神书的...这本书入教材一部分是因为一号早年在浙江当书记的时候提出的这个概念...所以想想你在反对的到底是谁...
103809,1500,张立程,2019-03-06 02:49:02,1,1,0,。。。
103830,1500,张立程,2019-03-06 07:05:45,-19,1,20,讲很多野史，也不知道这个人是怎么讲的好像他这现场的。逻辑奇怪，cue抗英可歌可泣，但是又嘲讽百姓给钱就能带英军上岸？这一点就让人很服。\n\n其它讲课还行，ppt很丑
103833,1500,张立程,2019-03-06 07:26:09,2,4,2,本来想喷楼下的，想想算了，人各有志
103962,1500,张立程,2019-03-08 03:28:15,23,27,4,为什么要让学生打分???很棒的展示满分五十也就给三十多，所以全班是想同归于尽???把均绩拽下来就开心了???
104156,1500,张立程,2019-03-13 05:56:56,7,11,4,喷那个楼下傻逼了\n\n老师说抗英可歌可泣说的是英雄的事迹，说老百姓给侵略者带道是悲叹那时民族意识没有觉醒，合着您老人家听了一两句话就拍板说人家逻辑不清，你个老瘪犊子没听课还想给自己立牌坊了？讲野史，是不是他妈的不一本正经的说历史意义就是野史？信不信老师正式讲的话你这种沐猴而冠的小人又得跳着脚说老师念课本？是不是跟你观念不合就是糟粕？你这种人来到浙大只能说是苍天无眼谢谢。
104208,1500,张立程,2019-03-14 03:03:08,2,5,3,绩点给的实在太低了吧，上4就那么难？
104717,1500,张立程,2019-03-26 11:13:56,-1,5,6,事很少，看着几个室友每天为了史纲各种头秃，而我们只需要看两本书写两篇读书报告(其中一本还是一小组合在一起一千字)\n\n上课没有听过课 期末考我相信你听了课也没几道会做 但就这样还有4.2 老师自己也很可爱
105112,1500,张立程,2019-04-04 01:22:23,2,3,1,就这样的，我3，唉╯﹏╰
106344,1500,张立程,2019-04-26 12:51:59,9,10,1,极差的体验
107035,1500,张立程,2019-05-01 03:19:52,8,9,1,每周上半天课还不够吗？还整个慕课出来，真有意思
108365,1500,张立程,2019-07-11 02:47:33,10,14,4,每学期有两节讨论课（屁用没有，每次完还要心得体会），一次读书报告（小组形式，最后一节课组长上去回答张立程的提问），一次小组展示（讲台下面的同学评分），期末考试开卷（请带上史纲课本和浙江精神，注意只能带这两本书和手抄资料），谨以此条评论给下一届的学弟学妹们一些有用的信息。想拿高分找几节课向小组展示的同学提问，再在讨论课上多发言，还要记得当组长，对思政课的绩点不在意的同学请找个不认识的人当组长，然后托个信得过的人帮你签到（好像一学期就点一次名吧，反正我们这个学期是这样的），最后去干自己想干的事情吧，有一下午的时间休息也是不错的，另外，下午没事又不想睡觉的就去隔壁听赵晖的课吧，讲得真的好，又特别幽默，诸如张立程等人的思政课上起来没有半点意思，不要把时间浪费在这种地方。
108521,1500,张立程,2020-01-12 21:53:10,52,70,18,只想说这次的课代表pancong真他妈傻逼，群里回复一幅很牛逼的样子好像老师亲儿子，通知工作也不到位
109899,1500,张立程,2019-06-20 05:26:12,1,1,0,诶……\n\n
110939,1500,张立程,2019-06-28 15:28:36,15,22,7,老师不差，课代表pc怎么回事？？？
112016,1500,张立程,2019-07-15 02:29:57,20,43,23,傻B老师，1分鼓励，在群里发查老师截图diss同学，给分很差，上课啥也不讲
112410,1500,张立程,2019-07-06 06:02:52,6,8,2,出分真心慢
112961,1500,张立程,2019-07-11 04:05:55,2,11,9,修改一下答案吧，我就是那个历史学考B史纲四点五90分整的人，我觉得这次成绩完全是由考试决定的。而考试中我个人感觉有很多同学漏了一半左右的答案，剩下的一半再完整也没什么用了。（上次说我挂了一门数学狗头保命，这次告诉大家我挂了两门狗头保命），而且我还是课代表pc班里的。骂老师有用吗？最多建议老师修改评分标准。
114095,1500,张立程,2019-07-11 05:11:23,19,26,7,上课一般吧不过这应该是思政课的常态吧，就是有一点我不太明白为什么要一边diss正态分布一边给学生打很低的分…还在群里怼人…
114121,1500,张立程,2019-07-11 02:37:21,2,5,3,emmm反正就这样吧...给分不咋滴.
114139,1500,张立程,2019-07-09 09:43:29,4,8,4,老师客观来说还可以，不算很水，但是平时无意义事情太多了，都什么玩意，浪费时间，还有那个sb课代表藩某，真的是一言难尽，每次通知事情和回复引起极度不适
114143,1500,张立程,2019-07-11 02:47:28,-21,17,38,来你们不喜欢的课代表pc来了。说我脾气不好像大爷的几位，我承认我脾气躁，这学期也的确因为史纲的问题自己发了好几次脾气。那么我要问问，我每次在群里发公告或者at全体成员的时候，有多少人认真看完了，有多少人是连记录稍微搜一下都不愿意就直接当伸手党的？一个个都是大学生了搜索能力没有吗？还有展示打分的问题，最后有多少小组是一次分都没发给我的？我在小组长群里at人有过用吗？最後说明一下自己成绩来反驳某些人的亲儿子言论：85，3.9。这学期的课代表的确让我在某些事情上懂了很多。
114225,1500,张立程,2019-07-11 17:13:29,71,90,19,第一次看见有结课后群内怒怼同学的。鲜花马屁？真正心声？还放图，人＋谷=俗，人＋山=仙？谁的人生还没个起伏呢？拜托，大家都是成年人了，学生不糊涂。。。课水不水，催不催眠，评分合不合理，备课用不用心，学生听过课就知道，这叫求是。师生关系确实本就不怎么平等，学生在这里评论一下也是表达一下想法。既然老师您也在看查老师，还蛮关心自己风评的，那有没有考虑过如何改进呢？
114271,1500,张立程,2019-07-09 15:58:00,11,11,0,我分好低…没想到会栽在史纲上面www
114642,1500,张立程,2019-07-11 02:35:59,0,0,0,233333
114643,1500,张立程,2019-07-11 02:36:48,-9,5,14,其实张老师讲课还是很棒的。说什么不如其他老师的想问问你们认真听过几节课？课程有作业很正常，展示一学期就轮到一次，慕课也不是史纲才有。张老师已经很善良了，自己不重视不认真还怪老师给分低？自己不看群不及时完成任务还要怪课代表？浙大学子就是这个样子的吗？不得不说这种行为很让人失望。
114647,1500,张立程,2019-07-11 17:17:06,14,28,14,你讲课不好给分不好就算了，费这么大力气在群里洗白pc，pc是你亲儿子？本来想直接在群里怼的，但是想到不要和这种sb一般见识了，没给我挂我谢谢您，以后眼不见心不烦，再见sb
114651,1500,张立程,2019-07-11 02:46:03,1,1,0,客观上来说老师上课还是很有自己的见解的，史纲课本来就没什么人听，给分低我到没觉得，还行，，
114652,1500,张立程,2019-07-11 06:51:03,46,59,13,我觉得，身为一个老师，在自己的课代表与学生产生冲突的时候，维护课代表是正常反应，毕竟关系更近，但是是不是也应该考虑一下，为什么别的老师的课代表不被攻击？为什么下午班的课代表受到了如此程度的尊敬？pc的一些行为和做法我可以理解，但是这不代表他可以被原谅，请问pc在群里飞扬跋扈的态度老师知道多少呢？pc同学曾经因为同学玩一个“你们这个是什么群啊”的梗就开始对同学禁言，请问这是一个成熟稳重的课代表应该做的事情吗？课代表本身职能包含引导，不以引导同学作为本职工作而一味耀武扬威，现在觉得自己委屈，还觉得同学不努力，同学没有问题要你做什么呢？你有这样的想法不觉得可笑吗？\n\n\n\n对于某些说pc挨骂是因为他管事多，是因为我们不满自己的分数的人的回答：\n\n很多人对自己的分数未必不满意，他们只是觉得课代表做的不太稳妥，就像你喜欢吃西瓜和你史纲满绩没关系一样，不用硬扣帽子，没意思。另外，请问哪位同学一而再再而三问同一问题了呢？不是课代表没有一次性让所有同学知道问题吗？再次，别的班级也有全权管事的课代表，他们管事情多，他们挨骂了吗？下午班的课代表是被我们尊敬，不只是不挨骂而已，兄dei，辩护也要讲究基本法。
114669,1500,张立程,2019-07-11 03:05:45,5,6,1,要写的书评是需要一些史学基础的，讨论课的主题还是比较有趣的。如果组里没有太多freeriders的话，这些工作量对于一门三学分的课来说也是不多的。给分的确比其他班低，但是每一项成绩都是课前说好的（除了突然出现的mooc）但是，对比其他班要做的事情不多，绩点还比张老师班高，其他班有些划水的同学绩点会比最认真的几位同学还高。一部分老师当水课给分，一部分老师当硬课给分，对学生来说是不公平的。
114670,1500,张立程,2019-07-11 03:10:38,4,9,5,emmmmmm本来没想来查老师写评论的 给分不做评价\n\n但是老师在群里截了图diss查老师下面的同学 那我不得不开麦说一下了\n\n首先课代表是一份工作和责任 不是资本\n\n其次老师在维护某一课代表的时候怎么不想想大家为什么对其他三个课代表没有意见？而且我想这应该不是某一两位同学的观点吧 一杆子打死真的OK吗\n\n最后反正课都结束了 老师说实话没必要这样搞得大家都不开心
114672,1500,张立程,2019-07-11 03:16:09,-2,0,2,。。。
114673,1500,张立程,2019-07-11 03:21:43,5,9,4,如果是一个人说不好是诋毁，偏见，所有人都说不好还觉得是大家的问题？本来没想着来查老师评分，看到在群里diss学生后果断过来给一分
114678,1500,张立程,2019-07-11 17:12:59,5,14,9,这老师全程在水，他自己都说他水。分数是给的真低呀!而且老师在班群里面骂人真是的，这样好吗？明明是自己做的不够到位，反而要说学生不好，这样的老师还是不要选择为好。千万注意不要选张立程。就这样，帮我顶上去吧。
114682,1500,张立程,2019-07-11 03:38:55,2,4,2,挺好的，虽然有慕课但不用写论文啊
114686,1500,张立程,2019-07-11 03:51:29,1,1,0,。。。
114694,1500,张立程,2019-07-11 04:09:40,-4,5,9,为什么一定要拿课代表说事，老师是什么样，课代表认不认真，你上课又是什么状态？出成绩的时候想想自己有认真过吗？反正我觉得老师是一个很好的人。
114695,1500,张立程,2019-07-11 04:10:11,1,8,7,自己上课不听期末怪老师怪课代表zz正确了奥
114702,1500,张立程,2019-07-11 04:23:10,4,6,2,上学期就觉得很过分了诶，这学期更加了！
114709,1500,张立程,2019-07-11 04:45:47,48,54,6,……在查老师里面diss同学我也是第一次见
114710,1500,张立程,2019-07-11 04:46:39,-1,0,1,想睡觉。
114717,1500,张立程,2019-07-11 05:43:50,-3,17,20,我仿佛又看见了一块喷子聚集的地方。好好的查老师匿名评价系统，现在变成了一群喷子发泄自己不满情绪的地方。张老师上课可能真的没有很好，评价体系可能也有些不合理的地方。但是如果你真的有实力拿高绩点，你被埋没了吗？更多的是大家就像老师说的那样，上课基本都在水手机水电脑。评论区有说其他课代表没被diss，就pc被diss了说明pc就是真差劲，我也很想请这位同学回忆一下，是不是pc在群里管的事比较多，回答问题比较多。你闷声不响，当然没有人说你怎样。我是其中一个组长，发期末读书报告的时候我发错邮箱了。pc回答我说，他之前有说过邮箱也有说过截止日期。我翻了翻群，确实是的。没错，课代表确实需要尽到一些义务，但凭什么你不看群消息一而再再而三向人家问问题，人家得好声好气地一而再再而三地回答你？人家有欠你什么吗？我一直以为浙大人都是温文尔雅的，都是与人为善的，兴许我还应该认识到一点，不管在哪里，都会有一种人，不计自己的原因，而只把结果归根于别人的错误。查老师，作为一个匿名评价系统，但不代表这里可以“畅所欲言”，你可以给差的评价，你也可以给老师打低分，但是在评论区里用“傻逼”这等字眼去发泄自己的情绪，恐怕折射出的就是自己了。
114729,1500,张立程,2019-07-11 07:39:00,-2,4,6,毕竟自己水过来的，给分满意了
114745,1500,张立程,2019-07-11 08:56:41,20,23,3,其实我还是很喜欢老师的，但期末qq群里diss同学真的有点......夸张......没必要啦老师，上完课老师学生就一拍两散互不相干了。关于给分的问题，我所知道的是大家的平时分都是调高的，只能说史纲这门课的期末考试分数太低了。另外楼下炫耀自己历史考b的同学，高中学的课叫历史不叫历史学......两个东西啊。\n\n哦对了，就是期末前我去问老师老师说mooc是不算分的？？
114756,1500,张立程,2019-07-11 10:23:20,24,31,7,全程只有一次点名，上课跟通常的思政课差不多，最后给分确实不好。\n\n至于楼下所说的，pc做了什么其实我个人也没太清楚（因为不怎么水群），但老师一看查老师就在群里在线开怼了？拜托都是成年人了，这么多人评价肯定说明pc有一些不好的地方，但老师你这喷来喷去的有什么意思呢？徒然伤了一波人的心。\n\n对了，老师还说如果隔壁赵晖老师上课比他好，趁早退课去选赵晖老师。这里我也要吹爆赵晖老师，上课是真的有趣（曾经资源共享的时候上过一节），学弟学妹们还是别选张老师了，咱高攀不起
114759,1500,张立程,2019-07-11 11:15:44,4,7,3,这给分??展示课学生互评，都是恶意伤害
114878,1500,张立程,2019-07-12 08:06:28,11,17,6,所以pc到底做了什么\n\n有没有人说说....\n\n吃瓜
114890,1500,张立程,2019-07-12 12:45:33,1,5,4,呃，3.9，绩点不高，因为我期末考就65……：\n\n1.老师的水平是可以的，不过这个比较主观，还是要看大家怎么想。2.我们的考察是两次讨论课（我们这届主题是穿越成慈禧和蒋介石）及讨论课后小组上交的心得，一个小组合作的书评，一个小组合作的展示。3.讨论课时提问和别组展示时提问的同学应该是有加分的。积极参与这个就不多说了。4.平时分是调过了的，调高了，至少我的调高了。5.期末考考好才是王道，别的不要想太多了……\n\n希望对大家有帮助吧～
114985,1500,张立程,2019-07-13 17:37:04,4,13,9,我希望能够比较客观的说明一下我对于同学们以及老师的做法的一些看法。首先针对大家最为关心的分数问题，我所知道的大家的平时分都是经过调整的，并且都是调高的，包括有人说的展示互评导致互相伤害，其实后来课代表都整体调高了，最后平时分也是在老师要求下所有人都加了分数(除了学校要求不得不正态以外，这个也是无奈之举)。而之所以还有人抱怨分数低，那是因为绝大多数人期末考试只有六十多分，虽说只占比30%，可就算平时分已经都给到了九十多，可最终评分低也是自然。至于老师的做法，我个人认为无可厚非。虽说查老师是一个匿名程序，但大家还是应该自觉遵守些规矩的，而不是一味的发泄情绪。在老师的评价下进行人身攻击，我认为是可耻的行为，不应是浙大学子干的事。反过来，老师和pc所做也完全是道理所在，而之所以被这么多人攻击，也只是没让这些人舒舒服服地水到高分而已。
114992,1500,张立程,2019-07-14 00:34:21,16,21,5,我是下午班学生 没有发过一次言 期末再好也是被正态 不知上午班情况下 但确实看到了很大戾气 客观来讲zlc在思政类老师里不算差 但很多言论以及处理事情的态度过于偏激 就算为课代表发声也完全没必要在大群里公然diss所有同学 幽默风趣我保留意见但身为老师处理问题的不成熟是展现淋漓尽致了 最后大家不欢而散真的没必要 尤其是下午班只是简单了解事情经过的学生看到这几段话又会产生怎样负面情绪？当然还是希望大家能保持冷静 就事论事别人身攻击
114993,1500,张立程,2019-07-14 00:48:02,3,18,15,其实我真没觉得张老师的行为很过分，但评论里那几条骂的是真的难听而且居然还被顶了上来，很多条都是下午班同一个人发的，本人偶尔水群，课代表除了有些通知不及时也没什么大毛病。张老师的课还是挺有意思的，给分可能比其他老师低一点，上课很水，事情不多，就这样
115056,1500,张立程,2019-07-15 02:01:00,-6,2,8,emmmmm
115067,1500,张立程,2019-07-15 05:29:13,-1,4,5,所以pc到底是男是女啊
115073,1500,张立程,2019-07-15 07:06:15,-6,3,9,我觉得?️
115144,1500,张立程,2019-07-16 05:34:12,8,11,3,给分真差
115303,1500,张立程,2019-07-18 06:08:26,2,10,8,今年查老师主要围绕批评上午班课代表和老师在群内批评某些学生只会怨天尤人展开。。不过我这里要说点别的。1.老师的风格是比较直来直去的，讲话不兜圈子。还记得有个同学提问展示同学时讲到“据说×××”，老师问这是在哪里看到的，同学也讲不出来。老师说没有依据的话不要乱信乱说。其实我是很喜欢这种讲话拿证据的态度的。包括课代表一事，满是怨愤之词的评论和给出了具体证据的评论就是0和1的关系，前者除了泄愤传播负能量没有别的作用。2.上午班某课代表确实有过，也确实像个孩子一样轻易给人禁言。。如果我被禁言了我也会很生气的? 。。。而下午课代表做事则比较清楚，也很平易近人。我是下午班的，上午班课堂上怎么样不做评论。3.大家最关注的给分环节。课堂主要是1次展示2次小组讨论，展示是同学互评+老师与课代表调分，这里说一下，确实调了！也确实有的小组的展示比较无聊会被正态。但是正态是肯定存在的，在限度内尽可能调高分就够了。小组讨论我的发言基本是最多的，嘻嘻。。发言肯定是有回报的。假设小组讨论和展示不扣分。还有两大项目是线上答题和期末考试。我线上答题一大半错过了时间? 所以这里扣分很惨，大概扣六七分（如果认真写了的话基本满了）期末选择题一分没得，卷子全力写，最后总成绩大概扣六七分。所以最后绩点4.2? ，非炫绩，这个成绩没啥好炫的，只是给大家一个参考。多发言，好好展示，线上不要忘了答，期末一定要多写，这些加起来上4大概没跑了！不过调分是课代表参与的，所以不清楚和课代表有没有关系。4.课堂讲的和考的关系不大，上课时间我一直坐在第一排写电工训作业hhh。5.老师还是很和蔼的，他对我做读书考核，一开始我讲的有点少，他耐心地问我还有没有别的想法，过了一会我才又想起来要说的东西。老师是很爱笑的，只是个性比较直。
115313,1500,张立程,2019-07-18 11:34:25,-6,11,17,可快点滚出浙大吧
115363,1500,张立程,2019-07-20 02:38:00,-9,6,15,张老师水平很高，作为认真听了一学期的我觉得讲课很有趣。给分还行吧，事情都这么少了还计较什么呢。
115501,1500,张立程,2019-07-30 01:15:09,5,9,4,又可以刷一分了
115566,1500,张立程,2019-08-05 10:25:36,2,7,5,呵呵呵呵呵
115607,1500,张立程,2019-08-21 10:53:37,1,6,5,愿你今晚去世
116526,1500,张立程,2019-09-11 04:05:47,-1,2,3,一般般吧 希望之后能让我改观
116527,1500,张立程,2019-11-13 11:06:40,7,22,15,上课选课代表玩黑幕，明明第二个男生的票数要比第一个多好多，老师竟然说第一个男生获胜了，其实这样真的很不好，给同学留下了很差的印象?
116528,1500,张立程,2019-09-11 04:08:10,-9,1,10,同学给了个差评，我给个好评补上
117191,1500,张立程,2019-09-20 06:44:32,2,4,2,退课吧
117922,1500,张立程,2019-10-10 16:07:16,1,8,7,一流大学还有这种奇葩，该奇葩言论如下：\n\n1.浙江省除了浙大还有哪个双一流？？中国美院就国画世界一流，国画世界一流有用吗?？？宁波大学的一流学科在宁波有用吗？？？\n\n2.浙工大当年要不是四校合并，今天还当不了浙江第二\n\n3.你们这些研究生大多数不都是比浙大差的学校，过来为了一个名校情结出来好找工作吗？？
117992,1500,张立程,2019-10-18 01:16:35,-4,1,5,就是好
118404,1500,张立程,2019-10-26 14:12:32,2,4,2,咋没零分呢
118511,1500,张立程,2019-10-28 00:06:38,0,1,1,咋这样
118703,1500,张立程,2019-10-31 01:45:45,-5,1,6,讲得不错！
120040,1500,张立程,2019-11-17 11:27:53,-9,7,16,男课代表选的公平公正，工作认真负责，赞一个
120044,1500,张立程,2019-11-17 07:39:25,-4,8,12,下面那条说选课代表有黑幕的同学，我劝你善良。
120045,1500,张立程,2019-11-17 07:40:00,-7,6,13,做课代表的那个男生挺认真负责的，怎么会是黑幕呢？公平公正选出来的。有些人不要在这里柠檬，做好自己的事情吧。
120047,1500,张立程,2019-11-17 11:26:08,-8,6,14,讲道理男课代表挺好的啊，怎么选出来的大家有目共睹，真有什么问题某些人当场不会说吗，跑到这里来吐黑泥?
120089,1500,张立程,2020-01-23 12:59:34,1,9,8,这明明是一个评价老师的公众号，为什么会有那么多讨论课代表的评论？以为旁人看不出是水军？
120241,1500,张立程,2019-11-25 07:54:38,10,11,1,选课代表真没长眼睛，这种人都选得出来
120251,1500,张立程,2019-11-26 08:00:40,2,5,3,傻逼玩意
120279,1500,张立程,2019-11-27 10:44:02,7,12,5,还是建议老师不要让同学评分。本人身为组长，有评分的权利，我一直都是打的很高的。但是有一次无意中翻评分条发现其实同学评分是很不客观的。首先，恶意的低分过多。其次，很多人的历史素养是不足的，让其评价是不合适的。见过一些讲的很有深度的小组，只是没有问答、或者一些花里胡哨的小品就评分不高，这也是不客观的。再次，很多人打分其实很有随意性，因为实际上很多打分的人自己是不听同学分享的。\n\n这让人有一种古代希腊“多数人的暴政”的慨叹。多数人的历史素养根本不足以参与评分。强烈建议改为全部由老师评分。\n\n再说说课堂吧，其实老师的水平是有的，自己很喜欢历史，也是为数不多的每次上课都听的人，其实很能听到一些历史的细节开拓眼界，也许不能只怪老师吧，毕竟正态分布的制度使然，这也是学校管理层思维简单化的体现。不过我仍然为自己感到幸运，自己喜欢历史却最终没有选择历史，但还能通过老师的课继续学习历史，史纲本身是为政治宣传而作的历史，但在这学期的史纲课上，我却真真切切的听到了活生生的、而不是僵化的、只为宣传的历史。\n\n
120282,1500,张立程,2019-11-27 11:24:44,4,7,3,老师很不错，讲课也好，就是男课代表小心眼还记仇，这间接让同学对老师的印象变差。很心疼张老师！张老师的名声都被这种学生糟蹋了。我很喜欢张老师的课。
121906,1500,张立程,2020-02-11 21:01:29,4,9,5,老师上课很少讲课，基本都是东拉西扯。\n\n虽说你我本也不听，但仍希望课程有趣。\n\n代表无能酷爱装逼，平时分就掉在井里。 \n\n希望日后擦亮慧眼，认真讲课好好评分。\n\n（以及课代表陶醉真的SB）
122506,1500,张立程,2020-03-02 12:38:10,-1,1,2,张老师上课还是很有趣的，但是大家还是不能水课，不然就会像我一样被正态
122649,1500,张立程,2020-03-12 01:11:43,-2,2,4,老师水平挺高的，而且对待课堂展示或者讨论课的态度很客观，基本不会被同学的台风影响观点的判断。认认真真听了一学期的史纲，不能说获益匪浅，但也确实已经得到了超过对于思政课期待的收获。而且给分真的八错.... 一学期什么都别落下认认真真学绩点不会差的
124543,1500,张立程,2020-07-02 14:38:47,4,6,2,上课讲得不敢恭维，乱扯的东西挺多，给分真的呵呵。
124544,1500,张立程,2020-07-02 16:11:14,4,4,0,给分好迷，我真实悲伤了👋🏻
124551,1500,张立程,2020-07-03 00:38:23,3,3,0,给我卡绩了呜呜呜😭
124553,1500,张立程,2020-07-03 00:47:51,-7,1,8,给分还是挺好的 张老师平时事相对其他老师少 认真交笔记 小组读书报告和pre认真完成平时分不会低 期末评卷也比较宽松 说给分迷的同学先想想自己平时分吧 每周的讨论题当周完成的同学经常只有60%左右    不按时完成讨论或许是平时分低的原因
124564,1500,张立程,2020-07-03 03:52:10,-42,4,46,上课东拉西扯。课后事情挺多，笔记要上传，讨论恶竞。认真复习多日，不是组长不恶竞，全书从新翻到烂，给分4.5，感觉给分不高，还是拉低了我的均绩。
127217,1500,张立程,2020-11-15 04:28:36,8,10,2,私货太多。不点名还好，不太管学生也还好。跟我们说那个少数名族的qj案，来了一句，一个巴掌拍不响。一听就知道是个nc。大学教授还搞这种受害者有罪论，您配吗？很生气
129068,1500,张立程,2020-12-29 12:26:42,-1,0,1,还卜错，事少
129738,1500,张立程,2021-01-12 01:42:24,12,14,2,这个听说过吧，也没听说过，好吧。
131647,1500,张立程,2021-01-28 09:48:14,-4,3,7,好，绩点给的高
131674,1500,张立程,2021-01-28 11:10:46,1,4,3,作为一个没发过言，不鹅颈讨论课和小组展示的人来说，期末没被卡这点就够了。老师上课喜欢谈天说地，开“百家讲坛”，和书本有时候会离得比较远，但可以听到有些有意思的东西，不过个人感觉对于老师上课的有些观点还是不能苟同，就当了解了。另外，如果对这段历史有兴趣的话，其实老师上课会有提些切入点，自己也可以以此找点东西看看。今年因为课程安排问题，小组论文就取消了，负担也轻了一些。
132286,1500,张立程,2021-01-31 13:37:42,3,3,0,绩点想死
135055,1500,张立程,2021-04-28 09:51:59,3,4,1,讲道理，给分没有很差，人也不错，就是百分之四十的考试占比有点大，可能这也是低分的一个原因吧
136299,1500,张立程,2021-06-16 02:30:40,3,3,0,无语了
136468,1500,张立程,2021-06-18 08:22:56,6,7,1,这位老师的三观绝了，都2021年了，为什么还在宣扬受害者有罪论？？“一个巴掌拍不响”，我直接乌鸡鲅鱼。
138023,1500,张立程,2021-07-07 05:43:27,5,6,1,别选啊！！！完全不调分的
138031,1500,张立程,2021-07-07 06:04:03,4,4,0,给分看不懂
138033,1500,张立程,2021-07-07 06:17:08,1,3,2,老师给分挺好的呀，就是上课有点乱
138090,1500,张立程,2021-07-07 09:44:39,3,3,0,。。。
138129,1500,张立程,2021-07-07 12:26:02,4,4,0,给的什么破分啊？？？完全无法理解了。而且上课价值观也奇奇怪怪的，快逃
139890,1500,张立程,2021-08-11 12:50:22,2,3,1,这种老师怎么在浙大混下去的
140084,1500,张立程,2021-08-25 07:56:27,6,7,1,马院学生表示，傻逼一个
141181,1500,张立程,2021-09-26 00:21:10,6,7,1,？上课发表辱女言论，秀自己那点可怜的阅读量很来劲吗老师？？？
141462,1500,张立程,2021-10-10 09:23:44,2,2,0,开个学习班还要一直拖堂
141570,1500,张立程,2021-10-15 03:02:02,4,5,1,21世纪了，还一套奇怪的价值观，衣服上印个英文字母都是文化侵略，干脆别学英语得了
141694,1500,张立程,2021-10-20 09:54:55,-1,1,2,还要交听课笔记我🤮
141759,1500,张立程,2021-10-25 00:43:39,1,3,2,人很好 ，不点名，不提问，上课也不怎么管秩序，就是讲的内容有些许的乱，课堂拓展内容很丰富
143819,1500,张立程,2021-12-07 12:53:36,7,11,4,很无语，不尊重女性，认为女同学被猥亵谁让你女孩子去酒吧，请问什么规定了女生不能去酒吧，成年人去酒吧有问题？还说宗庆后女儿30多岁不结婚不正常，拜托，大清亡了100多年了，可惜没录音不然就举报
145332,1500,张立程,2022-01-09 06:02:31,6,7,1,建议别选\n\n鼓励鹅颈，论文手写，上他的课需要交听课笔记，每周有讨论题。\n\n还有，价值观不同不代表他可以随意贬低教室里一半的学生。“女生不适合学历史”这种话，由思政老师说出口比较讽刺
145479,1500,张立程,2021-12-30 02:38:56,4,5,1,老师社死了吗
146087,1500,张立程,2022-01-05 12:22:16,3,4,1,除了学校要求的点名以外不点名，不过也可以远程签到。去不去无所谓不影响，他也不知道。\n\n作业不太多，小组展示挺无聊挺不正式的
146244,1500,张立程,2022-01-06 04:05:03,-6,4,10,zju是包容的地方，兼听则明，没必要老师讲课的价值观和你不同就给打低分。
147236,1500,张立程,2022-01-09 08:01:22,4,5,1,乱给分，绩杀......不知道怎么说，上课也很不好听。建议大家能换老师则换。
148029,1500,张立程,2022-01-11 11:06:55,2,2,0,建议当听故事。上课的时候会听到那么几个很有趣的点。其他时间建议自己翻书自习。
148089,1500,张立程,2022-01-11 13:10:27,4,4,0,绩杀不解释，选了赶紧跑
148090,1500,张立程,2022-01-11 13:11:28,3,3,0,上课比较乱
148099,1500,张立程,2022-01-11 13:26:21,3,3,0,快跑！
148101,1500,张立程,2022-01-11 13:33:31,1,1,0,绩杀呜呜呜
148120,1500,张立程,2022-01-11 14:20:39,-1,1,2,个人觉得蛮不错的
148121,1500,张立程,2022-01-11 14:23:16,0,1,1,最好别选，上课无聊，而且很喜欢怼学生观点，略油腻，给分差。
148176,1500,张立程,2022-01-11 18:42:08,1,2,1,选上了直接退课吧，真的不想说什么
148255,1500,张立程,2022-01-12 03:42:07,2,2,0,课可以水
148397,1500,张立程,2022-01-12 10:42:41,10,10,0,上过老师两门课。\n\n    其中一门（期末无考试）还是很用心学的，论文花了很大工夫写，还修改过很多次，还请学长来教我改过排版，最后给分很不好。课友有不少很水的绩点不错。\n\n    另一门课有期末考，不过三七开，占三成（应该大家都懂），虽然我平时比较水，但凡是作业都花了不少工夫，期末两个星期还花了不少时间在复习考试上，最后分比较平庸。\n\n    综合我的经验，分给的不算很求是。很多东西很看机缘。我对自己要求是比较高的，所以有些同学可能有我一样的分数时已经挺满足了。不过我不觉得在比较充足的付出下得到的这些是合理的，就和资本家榨取工人劳动的剩余价值，工人的时间和精力的付出无法得到相应回报一样。只是我想我们这些普通的读书的人没有把资本家吊上路灯的能力。\n\n    最后，我的建议是，选课一定要慎重，充分考虑多种因素后再去选择。以前一个学长和我说，选择和运气要远远重要于实力。我现在逐渐很认同这句话了。像浙大的选课彩票系统其实在某种程度上也告诉我们，选择和运气真的很重要。\n\n    望看查老师的诸位能有所获。
148438,1500,张立程,2022-01-12 12:49:40,2,3,1,我并不知道为什么我成绩这么低，所有签到都签了，小组报告分数也是中上。撇开成绩不说，这个老师的讲课有时候观念有些怪怪的，听着令人有些不舒服。不过一个老师有不好的地方很正常，也有一些好地方比如最后考试前提了一些建议等等。但是总体来讲我不怎么喜欢这个老师。
148829,1500,张立程,2022-01-13 15:34:48,1,2,1,感觉老师没有那么讨厌，但确实不会帮调分，唉:-(
149121,1500,张立程,2022-01-14 13:08:11,5,6,1,歧视湖南人，无语-----
149316,1500,张立程,2022-01-15 05:17:17,-1,0,1,给分一般，但上课听故事还是挺有趣的
150004,1500,张立程,2022-01-18 09:11:18,2,2,0,不建议选，尤其是那些比较看重绩点的同学，击杀不解释，别人班轻轻松松上4，张老师的班努力也3开头，实在没办法也稍微卷卷，不至于很低很低吧，一门史纲绩点没必要太在乎。
150290,1500,张立程,2022-01-21 14:29:19,14,14,0,打1只因没有0分。给分巨烂。每次点评小组展示都一副嘲讽模样。言论总有一股性别歧视的味道。大一新生选课不要怕别人说什么什么预置课程尽量别动，没那么夸张，能换就换，不然就绩杀。
150388,1500,张立程,2022-01-24 03:55:44,3,3,0,上网课直接开始打电话，几十分钟。直接点开视频让我们看，好家伙，一看一个下午过去了
150838,1500,张立程,2022-02-19 10:00:13,-7,3,10,给分可以的，不像说的那么不好
150844,1500,张立程,2022-02-19 10:47:28,1,1,0,课水，我也水，最后给分也水
151034,1500,张立程,2022-02-22 05:58:43,8,9,1,奔着均绩3.9去吧
151074,1500,张立程,2022-02-23 00:00:52,2,2,0,前进四
152261,1500,张立程,2022-03-31 15:03:03,3,3,0,给分巨烂，随便给
152486,1500,张立程,2022-04-13 02:28:08,3,3,0,垃圾！
154381,1500,张立程,2022-05-31 11:11:51,2,2,0,sssss
155364,1500,张立程,2022-06-11 15:02:06,13,16,3,摊上这种史纲老师真是晦气 事最多给分最烂，展示结束直接说学生的展示一个都看不上，三观不正评价丰县事件秉持受害者有罪论，以劝反想深造的女学生回去结婚生孩子为荣你没事吧?
155602,1500,张立程,2022-06-14 14:34:51,1,3,2,给分不好
156425,1500,张立程,2022-06-19 14:37:27,-3,5,8,虽然老师平常事情确实有点多，但老师人是很好的，而且讲课的内容很丰富，上他的课压力也不大，比较轻松。至于有些同学说催眠可能大概率本身就对中国近代史不在那么感兴趣吧
158186,1500,张立程,2022-06-27 11:07:46,9,11,2,1分奉上喽
159550,1500,张立程,2022-08-08 14:42:42,1,2,1,会数字点名，小组展示会评价很多，讲课可能有时会跑偏。
161510,1500,张立程,2022-11-08 03:24:40,2,2,0,快跑！我是预置上的他的课，手写读书报告，鹅颈，老师本人的一些思想也很奇怪。现在就是很后悔当时没有退课。静静等待绩杀的到来。（已经看不到希望惹）
161712,1500,张立程,2022-11-11 02:56:10,0,1,1,...
163800,1500,张立程,2022-12-16 06:35:10,5,6,1,对学生的展示尽是批判。上课的进度从来不加控制，最后一周疯狂赶。课件用的都是网上下载的中学历史，光标停留在PPT上来源看的是一清二楚啊。观点偏激，很难想象作为一个历史专业出身的人，是怎样说出这些话的。
164118,1500,张立程,2022-12-18 07:58:55,0,3,3,老师讲课挺好的，一次小组展示，一份读书报告，事情不多，老师也很好说话，
165711,1500,张立程,2023-01-09 11:09:10,3,3,0,懂哥😅
165830,1500,张立程,2023-01-10 03:39:42,-9,0,9,老师讲的课很有趣也很吸引人，线下课一直坐在第一排，讲的真的很好，而且不会只局限于课本，最后给分也很高。可惜后面转线上了就没有认真听了😭😭😭
165839,1500,张立程,2023-01-10 05:21:06,-1,1,2,不错的老师
166079,1500,张立程,2023-01-11 04:51:30,7,10,3,史纲课。说实话不太喜欢老师。上课不按课本讲，会讲很多其他的东西，但似乎又只是提一嘴没有什么逻辑，并且给人卖弄学识的感觉。除了期末考一篇读书报告手写，一次小组pre，一节讨论课，另外每周需要学在浙大上完成讨论题和上传笔记。小组展示全由其他组评分，个人认为不太公平，也导致一定鹅颈。我的绩点不太好，不知道整体怎么样。
166094,1500,张立程,2023-01-11 05:56:44,12,13,1,给分迷，课不去上作业不写分数跟老老实实完成的一样
166129,1500,张立程,2023-01-11 07:20:46,-3,5,8,给分竟然还不错！
166152,1500,张立程,2023-01-11 07:54:43,0,5,5,给分意外还不错，没有绩杀，哭死，感谢老师，感谢助教。个人感觉老师上课还有一些观点确实有待……但是，总体体验还是不错的。只要不逃课、好好做作业、把学在浙大上的东西都做了，期末好好考，绩点还是不错的。主要还是靠自己。
166177,1500,张立程,2023-01-11 10:07:44,1,6,5,有一说一给分真的不好，比起给分好的老师付出相同的努力大概绩点会差一个档，努力了一个学期，最后一4.5也算满意了，退不了的UU也不用太过焦虑了，只要努力去完成任务最后得分起码不会差的。
166185,1500,张立程,2023-01-11 10:57:47,-5,1,6,挺好的啊
166229,1500,张立程,2023-01-11 13:03:26,-6,1,7,翘的课比上的多 从未听过一堂课 绩点竟然还不错 挺好的老师😀
166370,1500,张立程,2023-01-12 05:54:24,4,6,2,翳眼丁真\n\n鍳定為：\n\n緋霧初升東兮，似瑪在中
166374,1500,张立程,2023-01-12 06:02:45,-16,6,22,我其他三个舍友预置得同一节课，几千字读书报告还有很麻烦的小组作业和展示，一度很煎熬。我预置到了张老师的课，事很少，上课很水，虽然会暗戳戳提醒不要看手机了但也不会多管，感觉挺轻松的，读书报告甚至只要求一页信纸；我学在浙大有几个错过了截止日期没完成，但是其他能看的都看了、也尽快补了，最后有4.8，也没卡绩，据我了解我们小组其他同学得分也都不错。
166531,1500,张立程,2023-01-12 15:56:33,5,7,2,客观的评价在史纲老师中事算少的，只有一次小组展示一篇读书报告，没有论文，学在浙大上的讨论题要写，其实想水几分钟就能水完。给分据我了解也还不错，没有之前评论的那样差，绝对是可以接受的老师
166570,1500,张立程,2023-01-13 01:02:22,10,12,2,难道这就是幸存者偏差吗？学在浙大认真完成了，包括上传笔记、讨论啥的，从来没翘过一节课，期末也是80＋，最后得分很凄惨，我不理解但大为震撼，我还当了组长（可能这不是加分项）一学期结束他的课堂我真的什么也没收获，除了心惊胆战，还是选评分好一些的老师吧，真的挺难受的，被史纲拉了一截。
167032,1500,张立程,2023-01-14 16:34:18,0,3,3,没有想象中的那么绩杀，平时认真完成学在浙大的作业（个人感觉挺麻烦的），一篇读书报告和一次小组展示（我担任了小组长），没有旷过一次课，平时上课经常提问（加平时分），最后4.5，分数还行但和自己的付出确实配得上，所以个人感觉不好也不差吧，给分只能说一般
167487,1500,张立程,2023-01-16 15:59:42,2,3,1,也中中的也中
169776,1500,张立程,2023-02-28 00:53:59,7,7,0,作为几年前的史纲课代表留个评论。\n\n讲课比较自由，可能更多会散发地讲自己的见解，直白一点说就是不太会讲这门课的具体内容，不知道现在是怎么样的。\n\n关于给分，确实是按照第一节课就给出的，点名+读书报告+讨论课+小组展示+期末考试等按照百分比来给的，一部分由老师打分，一部分由同学的给分（不知道现在改了没），最后excel按比例算分得到的；随机性在于老师打分的那些部分，总体比较“中庸”，低分高分都少，集中在88分附近（意味着大多数人再被期末考试搞一轮分数就很难高了）。如果你的成绩很差的话，可能是期末考确实炸了，也可能平时写的东西老师“不欣赏”吧，只能说至少该做的都要做，给分确实是这样构成和计算的。\n\n最后，20年左右的评价很多都拐到课代表上去了；首先提醒一点，评论讨论的课代表可能不是一个人，19年春夏和秋冬的评价明显混一起了；那个时候老师的课代表权利确实可能比较大，选到不好的体验会差；为自己申辩几句，我选课代表的时候男生只有我报所以显然没法有什么黑幕，分数也尽力为大家统计计算了，同学的打分和老师的打分我是没法改变的；最后出现了差错——助教那边一些人的读书报告找不到，我以前确实有些丢三落四因此怀疑是不是自己弄丢的（但其实那天是点清数量才交的），赶紧告知同学补救，结果过两天老师通知我助教找到了丢失的读书报告，唉；猜测因为这件事所以有人指名道姓骂我SB，只能说我尽心尽力做了，多少有些委屈。\n\n给后来的同学：就史纲这门课而言，讲课确实不如赵晖、甘均先（实际上我一开始选的甘均先，甘老师生病变成张老师代课了）讲的更落实课程内容，更精彩；老师大概东拉西扯讲自己的更多，给分情况前面已经说过了，可以参考一下要不要选。
170108,1500,张立程,2023-03-01 11:34:53,2,2,0,还不错，老师上课讲得内容比较杂，很天马行空，适合文科生或者对历史有一些了解的人。任务不多，小组展示、读书报告、讨论课、学在浙大，都是史纲课程组统一的内容，相比其他老师要求略少一些（字数等方面）。本届应该不存在评论中说的“全班最高89”的情况。总结：正常水平的老师。
171796,1500,张立程,2023-04-06 01:56:00,6,6,0,作业多给分还差
174722,1500,张立程,2023-06-16 07:38:52,5,7,2,不建议选，此人上课水，水也就算了，还有严重认识问题。他看不起学生，特别看不起女学生；教学质量比较一般，我指的是大部分时间都在吹自己光辉的人生
178858,1500,张立程,2023-07-26 06:22:07,3,3,0,给分不怎么样吧。主要是对比之下，讲得确实没有其他很多史纲老师有趣，个别话题可能会吸引我吧
186037,1500,张立程,2024-01-08 03:38:21,4,4,0,客观来讲老师知识储量很大，但有些观点比较高傲，而且上课节奏很乱，讲超时了就把小组展示直接推到下周，讲慢了就直接跳过某些章节
186741,1500,张立程,2024-01-13 01:41:22,-11,1,12,很好的老师，大赞！
188331,1500,张立程,2024-01-18 15:48:21,-8,1,9,我一开始看到评论是挺慌的，觉得上一节课先试试，大不了退课。上完一节课后觉得老师人还不错，没有出现之前评论的情况，不过分还没出。点名都是数字点名，上课中规中矩吧，有时候会拓展一些历史，我对这些比较感兴趣，不过大部分情况下没有时间，都是在过ppt。我史纲课很少听，比较喜欢看小组展示，不过史纲这门课的成绩听没听课其实关系不大。事情是确实很少，在意绩点的建议一开始就把分数占比弄清楚，老师一开始说有新的标准但是后面忘记发了，建议自己去问清楚。\n\n不论上课水平，整个教学设计我是很喜欢的。有一节讨论课，主题是假如穿越为慈禧如何振兴中华（在此夸赞zmr姐姐），我觉得思维有启发。有一节课去艺博馆参观。\n\n\n\n小组展示的主题选取也很好，微观视角，不过不知道是不是整个课程组统一的，我觉得我学习地方历史知识都是从小组展示中学到的。
189122,1500,张立程,2024-01-22 05:03:05,9,9,0,上课水，给分差
189137,1500,张立程,2024-01-22 05:42:20,9,9,0,给分差
189138,1500,张立程,2024-01-22 05:43:04,8,9,1,我只能说，史纲老师里面他是事情最多的了，绩点呵呵呵，别期待了
189140,1500,张立程,2024-01-22 06:09:28,6,6,0,分比别的老师低了一个档次，喝喝，不看重绩点的可选
189147,1500,张立程,2024-01-22 07:21:26,3,3,0,一股爹味…
189150,1500,张立程,2024-01-22 07:25:02,3,3,0,兢兢业业，也就拿他平均绩点。自己看着办吧。
189162,1500,张立程,2024-01-22 08:10:45,-3,1,4,没什么事，挺好
189296,1500,张立程,2024-01-23 03:17:39,14,14,0,hhh这老师😁😁😁😁💢💢💢💢💢😁😁😁，选上了就偷着乐吧，绩点都给你偷没了💢😁😁😁
189311,1500,张立程,2024-01-23 05:24:44,5,5,0,给分差
189331,1500,张立程,2024-01-23 09:06:23,6,6,0,给分不行，比其他班低啊
189412,1500,张立程,2024-01-24 03:26:00,12,12,0,很无语，给分差，之前学长叫我别选我没有听进去，现在我的亲身经历告诉学弟学妹千万别选这个老师
189630,1500,张立程,2024-01-26 07:00:10,9,9,0,讲课不知所云不成体系，给分烂到爆炸
190222,1500,张立程,2024-02-26 04:56:35,1,2,1,快跑！！！！
192049,1500,张立程,2024-05-08 07:39:13,5,5,0,天大的shit，纯纯ex人，三观很迷，讲话语气让人恶心，平时屁事一堆搞得恶心死，期末给分更是直接把你打入地下，比其他老师的给分低了不止一个档次，选他的课就是倒了八辈子霉
192615,1500,张立程,2024-05-25 06:26:28,0,0,0,上发展对象培训班，来评一个。\n\n\n\n太修了
193015,1500,张立程,2024-06-02 12:35:25,2,4,2,构思一样，作业多事情多，给分还差，兢兢业业一学期就4.2，别的老师那里水水就有的绩点。。。
198822,1500,张立程,2024-09-12 02:58:16,6,7,1,第一节课坦白了说90分以上不会超过百分之一，后面又改口为百分之五，说全班3.5到4.0是正常的，4.1，4.2都不不怎么不可能。我嘞个史纲，能看看均绩？居然还在查老师diss也是无敌
199069,1500,张立程,2024-09-15 03:57:44,6,7,1,这很难评。第一节课就说拿高分不容易。问题是他的高分 woc。他说满绩是4.2.。。。我勒个满绩啊。
199160,1500,张立程,2024-09-18 09:43:04,4,5,1,不知道是不是我们课代表的问题，就感觉这门课特别离谱…放假最后一天过来说后天开始小组展示，请问谁来得及做ppt做报告啊…消息还都发组长群里不发大群里，组长真是左右为难啊。然后第一节课也不说怎么上课不说怎么评分知识点是直接翻过去根本没来得及看没来得及划的
199230,1500,张立程,2024-09-19 12:40:15,4,4,0,事太多
199232,1500,张立程,2024-09-19 13:50:10,7,8,1,真的垃圾，通知和考核方式是不及时通知的，事情是多的，和主课抢时间，你怎么有脸的啊？又要考试，又要小组展示，又要网课讨论，又要交上课笔记，一个人是怎么整出那么多活的，真的无语
199305,1500,张立程,2024-09-20 15:11:01,7,8,1,碧阳的晚意，初生的东曦
199452,1500,张立程,2024-09-24 02:40:04,5,7,2,这位老师简直是个畜生！上课拖拖拉拉，不仅浪费我们的时间，还毫无尊重可言，真是恶心透顶！他的三观扭曲得让人想吐，根本不配做教师！故意给学生打低分，均绩低的让人不敢想象，明显是想让我们难堪和绝望！而且布置的作业多得离谱，根本不考虑我们的承受能力，简直是在逼我们崩溃！这种人只会给学校带来羞耻，真希望学校能把他踢出去，别再让他祸害学生了！\n\ngpt写的，我觉得很满意
199589,1500,张立程,2024-09-26 02:51:52,4,5,1,大哥你听不见铃声的吗？？？
199735,1500,张立程,2024-09-28 11:27:13,5,6,1,纯纯的构思，B事情要多少有多少，真当我们一天72个小时是吧
199768,1500,张立程,2024-09-29 10:02:35,5,6,1,一堆破事，巨麻烦，上课也巨无聊，没有什么收获，能跑赶紧跑
200712,1500,张立程,2024-10-21 08:10:28,5,6,1,1分是评分系统的下限，不是老师的下限
201393,1500,张立程,2024-11-01 13:38:49,6,7,1,我的天哪，从没见过事这么多的老师，小组展示、读书报告、书上和笔记本上都要记笔记、智慧树和学在浙大都要上课，上的我想死，太太太贱了，恶心恶心恶心恶心恶心恶心恶心恶心恶心恶心
201530,1500,张立程,2024-11-04 06:19:42,7,7,0,垃圾，难评，哭了
201531,1500,张立程,2024-11-04 06:20:06,7,7,0,快跑！！答辩啊
202510,1500,张立程,2024-11-13 02:46:12,5,5,0,也是个神人了
203272,1500,张立程,2024-11-18 17:00:55,-8,2,10,这些负面评论是之前只限于那一届还是一直是这样啊？给老师10分，目前看还不错
204796,1500,张立程,2024-11-28 02:43:38,7,7,0,事太多，还天天贬低学生
208137,1500,张立程,2024-12-26 01:49:48,9,9,0,赤石一般的体验
209281,1500,张立程,2025-01-05 10:10:58,-10,0,10,事少，上课条理清晰
209655,1500,张立程,2025-01-06 12:18:24,6,6,0,给分烂的很
210364,1500,张立程,2025-01-09 03:56:32,-8,0,8,打分还行
211326,1500,张立程,2025-01-11 08:06:05,-9,1,10,实话实说，我觉得张老师上课风格我不是很喜欢，就是说比较求是的那一派，然后也要求大家认真一点听讲，而且看了查老师的评论我一直很担心给分问题，但是最后为什么给八分呢，因为出分之后我真的蛮惊喜的，lz史纲上课并不发言，作业我自我感觉也就是一般，但是可能我是文科生然后期末考还可以，最后拿到了4.8，或许老师真的有改进给分了（也可能是我幸存者偏差），至少对于我来说，这个给分不至于我打低分。\n\nps老师上课虽然希望大家认真听但是其实没听讲也没人管，作业也不多，整体还是比较宽松的一个氛围，而且学在浙大上虽然有很多东西要提交，其实也没什么要求，因为我真的交的很随便、每个笔记就是画两条横线
211410,1500,张立程,2025-01-11 10:49:09,0,2,2,其实还行，感觉有点像纸老虎。又好又不好的。上课会不让做别的事情，但就坐在中间做别的事也没人管。事情有点多，但是水水的做也很快做掉。平时有什么问题去找老师，感觉老师还是很和蔼的。给分不评价，做了挺多事情的且有文科生期末考优势，最后4.8感觉意料之中。
211446,1500,张立程,2025-01-11 12:20:39,3,3,0,给分不太得劲
211543,1500,张立程,2025-01-12 01:48:19,6,6,0,sb东西 给分巨差
211709,1500,张立程,2025-01-12 08:41:40,1,2,1,我不知道他评分为什么比隔壁scy要高。。。。
214913,1500,张立程,2025-02-19 05:32:03,0,0,0,懂得挺多的
220028,1500,张立程,2025-06-13 16:36:48,0,0,0,拉低一万个绩点
221576,1500,张立程,2025-06-24 14:41:45,0,0,0,老师现在挺好的，助教和老师把平时分都调的很高了
221780,1500,张立程,2025-06-26 07:50:30,0,0,0,讲课中规中矩，但是给分一般，还卡绩
55,1512,熊卫平,2015-03-14 15:33:28,4,11,7,还好\n\n
65,1512,熊卫平,2015-03-14 15:35:28,2,16,14,挺好的老师啊。思政课要求不能太高。
207,1512,熊卫平,2017-12-27 05:12:36,3,10,7,口音还挺可爱的呀
266,1512,熊卫平,2015-03-14 23:45:01,5,11,6,尼玛，毛概原来拖后腿了……
454,1512,熊卫平,2015-03-15 02:39:52,-1,4,5,三观很正
486,1512,熊卫平,2015-03-15 03:09:42,103,178,75,公共关系学超棒！很有趣！
500,1512,熊卫平,2015-03-15 03:32:54,1,8,7,公共关系学上得很棒！给分一般
691,1512,熊卫平,2015-03-15 13:13:57,1,3,2,很铿锵有力的老师啊 要点名 要发言
757,1512,熊卫平,2015-03-16 10:24:59,0,4,4,很有意思的体验
1001,1512,熊卫平,2015-03-21 07:22:35,22,35,13,毛概挺无聊的
1353,1512,熊卫平,2015-03-22 00:45:08,6,14,8,h还阔以～老师挺激情的～上课节奏把握不是太好
1450,1512,熊卫平,2015-03-22 04:45:25,54,109,55,毛左，背教科书上的段子反复给学生洗脑，说话完全是新闻联播逻辑。四门思政课上下来加旁听，左中右派都见过，但是没谁这么奇葩，搞得有点像高端黑但又不是。
3643,1512,熊卫平,2015-06-17 01:58:57,0,2,2,不错的
3754,1512,熊卫平,2015-06-17 03:24:28,-2,3,5,公关讲的很好
3797,1512,熊卫平,2015-06-17 04:37:45,4,6,2,很棒喔
4401,1512,熊卫平,2015-06-21 11:38:15,22,24,2,不舒服
4714,1512,熊卫平,2015-06-26 12:07:42,-3,4,7,很好的老师，能学到很多东西\n\n
5146,1512,熊卫平,2015-07-05 03:31:05,38,50,12,又五毛又公知很矛盾的一个人
5506,1512,熊卫平,2015-07-08 03:56:01,0,1,1,还可以吧。。。不知道给分怎么样
6103,1512,熊卫平,2015-07-11 01:33:07,-1,5,6,熊妈的思政是我目前思政最好的…
6148,1512,熊卫平,2018-12-25 02:46:00,47,55,8,毛概非常喜欢点名！点名！点名！重要的事情讲三遍，一学期至少点了四五次
6536,1512,熊卫平,2015-08-06 03:00:49,5,13,8,给分坑爹
7172,1512,熊卫平,2015-09-09 13:55:50,9,18,9,给分还可以。但是98上说她有多与众不同我也没看出来，她的观点挺普通的。
8851,1512,熊卫平,2015-09-29 02:51:22,10,15,5,洗脑中'
12838,1512,熊卫平,2015-12-24 06:17:08,0,4,4,非常棒哦
13948,1512,熊卫平,2017-12-24 15:11:03,31,46,15,毛左。。不允许学生有不同观点
15763,1512,熊卫平,2016-01-16 08:38:36,0,4,4,公关课挺有趣哒
16764,1512,熊卫平,2016-01-19 02:37:31,0,4,4,公关课上的很好 觉得收获还是挺大的 给分也不错 只要做了事分就不会太低
19572,1512,熊卫平,2016-01-24 17:44:17,2,5,3,一般般，强烈推荐林小芳
20612,1512,熊卫平,2016-01-29 04:16:47,2,5,3,毛概给分很差
20806,1512,熊卫平,2016-02-01 02:52:33,0,2,2,还是能学到点东西的
20961,1512,熊卫平,2016-02-05 12:46:33,0,3,3,听完瞬间不想出国了
22633,1512,熊卫平,2016-03-09 03:06:08,-4,5,9,浙大确实缺少这样的思政老师。三观正。
23686,1512,熊卫平,2016-04-12 08:38:49,0,1,1,老师挺有风采的
27162,1512,熊卫平,2016-06-23 09:12:49,3,4,1,珍爱生命。
27453,1512,熊卫平,2016-06-26 09:52:26,-2,2,4,一学期基本没怎么去过。只有最后快下课要讨论的时候去发言。最后平时分基本满。
28183,1512,熊卫平,2016-06-28 08:13:27,0,2,2,像邻家阿姨
29325,1512,熊卫平,2016-06-29 15:12:28,0,1,1,喜欢熊妈说话的尾音～
29559,1512,熊卫平,2016-06-30 03:21:22,0,1,1,还可以，分数很好
29630,1512,熊卫平,2016-06-30 05:35:27,0,0,0,给分真的超级好！！！
29952,1512,熊卫平,2016-06-30 14:41:18,0,0,0,毛概给分很好啊
31111,1512,熊卫平,2016-07-03 08:30:15,-3,0,3,能把毛概讲得让人不那么厌烦，挺好的。
31793,1512,熊卫平,2016-07-05 02:24:19,13,18,5,公关课不是一门“正义”的课吧…给分 嗯 起码我的话是一般。
31825,1512,熊卫平,2016-07-05 03:17:31,0,2,2,期末有一个小剧，中间有小组讨论。给我们讲很多公关的案例。真给了我们一个看待事情的新视角。很棒
32738,1512,熊卫平,2016-07-12 07:29:04,3,13,10,公关课讲的真是好，给分见仁见智吧，因为平时分全看组长，组长喜欢给组员高分就高分，全部60就全部60(组长自己的分数由老师来打)，我们组就因为组长普遍给80然后各种被正态-_-||
33730,1512,熊卫平,2016-09-21 07:34:11,8,10,2,感觉老师挺自我的，挺自负的。毛概和公共关系学就是政治正确VS寻求利益最大化，连着上精分
38043,1512,熊卫平,2016-11-23 12:23:59,0,3,3,极端左思想
39300,1512,熊卫平,2016-12-22 03:47:07,5,20,15,公关虽然不点名但是组内每堂课都要讨论，没到的话组长都会知道，期末还要表演，还有考试，蛮麻烦的一点都不水，不对老师进行评价，只是个人实在不喜欢这门课，这个学科
40352,1512,熊卫平,2019-09-04 14:24:57,82,171,89,求问熊老师的公共关系学这门课如何
42574,1512,熊卫平,2017-01-14 13:16:39,4,7,3,声音真难听啊\n\n
42849,1512,熊卫平,2017-01-15 16:39:52,0,1,1,\n\n
42857,1512,熊卫平,2017-01-15 09:55:06,-2,1,3,公共关系学，还是挺有意思的上课讲了很多有意思的案例
42858,1512,熊卫平,2017-01-15 09:55:41,0,4,4,挺好的！公共关系课挺有意思的。给分很好啊。虽然有点辛苦，但还挺值的(/ω＼)
42873,1512,熊卫平,2017-01-15 10:21:17,0,2,2,公共关系学不错，老师讲的也好
42881,1512,熊卫平,2017-01-15 10:40:09,0,5,5,公关课\n\n想拿高分进策划组，起码争取个组长吧。\n\n点名组长来做哦，老师不管，被抓肯定拉平时分，看组长怎么样了。\n\n感觉组长给的平时分还很好看，结果总评被正态，不爽。不知道是不是案例分析没写好？写满整张试卷了……\n\n另外看一些慕课，感觉“公关”不全是老师讲的样子，还有其他方面吧~
42884,1512,熊卫平,2017-01-15 10:44:56,-3,1,4,给分还不错哦～小惊喜只要最后一堂课表演一下案例就可以了，期末考就是案例分析好好写。听老师讲课会有收获的，如果当组长给分比较高吧。
43124,1512,熊卫平,2017-01-15 23:30:28,0,2,2,公共关系学课内容很吸引人，大到以后走上社会，小到经营一个微信公众号，它都会对你有帮助！
43213,1512,熊卫平,2017-01-16 03:44:34,11,17,6,好好准备了期末考试的案例分析，在组长给八十多平时分的情况下还是拿了4.8。分组很重要，我们组就是组长和组里面几个人以前就认识，打分很有内幕。
45379,1512,熊卫平,2017-01-19 13:28:44,-6,0,6,毛概挺好
45386,1512,熊卫平,2017-01-19 13:39:43,-6,1,7,挺好的，给分好
45500,1512,熊卫平,2017-01-19 15:38:32,-10,0,10,给分挺好的，考试应该是炸了，不过平时分蛮高所以最后结果不差。
46629,1512,熊卫平,2017-01-22 04:25:42,-6,1,7,老师给分超级超级好～
48924,1512,熊卫平,2017-03-16 11:52:01,-6,0,6,人挺好的，很有趣，毛概给分不错
49427,1512,熊卫平,2017-04-12 04:31:08,-10,2,12,?老师对同学真的好温柔啊！！！还会替毛概展示的同学回答别人的提问 春学期结束了还没点名～思政课还能有啥其他要求呢  推荐大家选这个老师！
50967,1512,熊卫平,2017-05-10 12:01:35,-6,2,8,公关课不错
52583,1512,熊卫平,2017-06-21 07:46:07,-1,4,5,老师毛概课给分不好，没有详细的分数细则明确
55361,1512,熊卫平,2017-07-01 11:08:37,-6,1,7,老师对学生非常好
55857,1512,熊卫平,2017-07-02 13:18:51,-6,1,7,谢谢老师
55884,1512,熊卫平,2017-07-02 14:29:40,-6,0,6,公共关系学超棒，案例生动学到了不少东西，老师鼓励小组合作，公关小组的小伙伴超棒，给分也很不错
57630,1512,熊卫平,2017-07-11 06:36:43,1,3,2,不好给分差
60547,1512,熊卫平,2017-10-24 01:13:17,7,10,3,别的不说，展示课阴阳怪气就很令人生气了，感觉挺自负的，不尊重学生的观点，不会从积极的角度来评价学生。
60822,1512,熊卫平,2017-10-31 01:41:15,4,11,7,不容许和她不一致的观点\n\n叫学生不要评论别人 自己却疯狂评论\n\n更可笑的事 在上课举手发言加分的环节\n\n她说我们今天就照顾女生同学吧 然后就一直叫女生 啥意思？ 因为女生是弱势群体？
60827,1512,熊卫平,2017-10-31 01:58:11,3,3,0,总批评学生
62087,1512,熊卫平,2018-01-22 16:53:07,38,51,13,我们组组长分了自己最多平时分，其他组员背了它的锅，平时分评分太不公平，组长权利膨胀。有黑幕，慎选。
63922,1512,熊卫平,2017-12-19 11:19:26,-3,0,3,毛概课挺好 老师会帮回答问题 大课上对自己班学生多有照顾
65441,1512,熊卫平,2018-01-04 03:06:41,3,3,0,旗帜鲜明 立场坚定 大浙江主义者 一副语重心长的样子 从来不允许反驳 也罢 也罢
65606,1512,熊卫平,2018-01-07 05:39:11,21,23,2,墙裂不建议不热衷于小组（大组）讨论的人选公关这门课。。。每节课都在讨论讨论讨论。。。
65901,1512,熊卫平,2018-01-10 05:25:56,6,7,1,很lj的老师了，自负不说，回邮件一点礼貌都没有的，别的班都会在上课前把小组成绩放出来，她一定要到上课打分...有毛病吧
65929,1512,熊卫平,2018-01-10 09:41:15,2,4,2,展示课帮她喜欢的组怼提问的人，说好的公平对待，这怎么让人打分？而且公开歧视了汉服复兴运动，说太作？提问人说的是重大节日仪式的事情，直接怼汉服都作不该穿出来？
66163,1512,熊卫平,2018-01-12 08:16:40,8,9,1,第一节课听得最认真 而且觉得讲的很好\n\n后来分组后 课堂体验直线下降\n\n每节课都要提早很多去占一整个小组的座位\n\n课堂发言也很重要\n\n
66875,1512,熊卫平,2018-01-19 15:08:03,5,17,12,公关#1.关于点名：点名是最后一节课展示用到，没到直接扣五分，但是也有帮忙喊的，而且是男生帮女生喊；2.关于展示：恶竟比较严重，公共表演一个组全正装，看得高年级生无语凝噎；3.关于考试：一道案例题，主要看三观和细心程度
66975,1512,熊卫平,2018-01-19 13:25:43,-1,4,5,小组合作很黑幕，小组长给自己打了最高分，exm？
67002,1512,熊卫平,2018-01-20 00:20:57,1,4,3,我觉得公关课上得很好啊，虽然讨论占了很多时间，但是老师很厉害很可爱
68194,1512,熊卫平,2018-01-22 17:18:22,-6,0,6,听的是公关，讲的蛮有意思的。\n\n考试只有一道题，不知绩点如何，安静等待...如果绩点好的话，是个很好的通识老师。
68787,1512,熊卫平,2018-01-24 01:46:09,8,10,2,课挺有意思，就是绩杀，绩杀，绩杀!\n\n
68789,1512,熊卫平,2018-01-24 01:50:10,1,5,4,不推荐性格偏内向的选，事算多的，而且有点烦，老师讲得还行，但给分差。
68801,1512,熊卫平,2018-01-24 05:56:30,15,18,3,绩杀h h h h h
68808,1512,熊卫平,2018-01-24 02:23:53,9,14,5,课代表权利膨胀。。
68813,1512,熊卫平,2018-01-24 02:43:04,-12,1,13,我觉着吧，上通识不是为了拿绩点的，学一些新东西，找一个看问题的新角度，不是很好？反正这两件事在公关课上都有体现了。
69256,1512,熊卫平,2018-01-24 11:16:55,5,5,0,第一节课感觉还行，后面就在不停的讨论讨论，不喜欢讨论的人真觉得没什么意思。很水。小组打分有不合理的地方
69366,1512,熊卫平,2018-01-24 14:26:28,-6,4,10,公共关系学超棒！可以看出老师是一个很有智慧有自己独特看法的人，上课讲的案例也很有趣很有干货！期末不用怎么复习，要靠在课上学到知识的运用。菜鸡4.2很满意了(｡･ω･｡)ﾉ♡。
69630,1512,熊卫平,2018-01-25 06:00:55,8,11,3,这么说吧 随便听听课还可以 但是老师毛左 境外敌对势力也会挂在嘴边 挺没意思的。评分太随意太随意 还有小组展示上来评分的打扮的花枝招展的男生女生自我感觉特别良好（也不知道哪里来的） 有些人为了反驳而反驳 为了发言而发言 逻辑不通还死撑。很迷很现实的一节课
69791,1512,熊卫平,2018-01-25 11:46:14,-8,1,9,公关课，挺有趣的，平时分蛮重要，平时分不太高的（比如我）最后期末考试好好考（开卷，就看大家造化的时候，我写到考场最后一个人才交卷），分是还可以的。推一下这门课！
70254,1512,熊卫平,2018-01-26 09:54:11,30,32,2,emmmm，感觉组长权利有点大。\n\n
70899,1512,熊卫平,2018-01-27 23:07:52,20,22,2,毛概课上有些人的发言也太sb了吧，明显强答，尬的一批，，，
72199,1512,熊卫平,2018-01-29 14:19:49,-7,4,11,这里针对的是公关学一门课，绝好的一门通识课，上了你绝对收获很多。老师在公关学方面的水平很高，公关学案例知识张口就来，几乎不用ppt，讲的都是干货，感觉课上很多公关学的案例为我打开了观察事物的新大门。每节课会给小组讨论的时间讨论一到两个案例，然后每个小组发言后再点评总结。认真听课，小组展示好好做，期末考不用复习但是要写很多东西，一面空白A3纸至少，这样绩点也是不错的。（Ps：最后一节课要点名，很重要，没来你就再见了...）
72897,1512,熊卫平,2018-01-31 09:31:00,-3,1,4,上课有收获哟~
73085,1512,熊卫平,2018-02-01 01:46:47,-9,2,11,很喜欢的风格，上课很流畅自然，平时事情好好做了最后给分不会差的
73392,1512,熊卫平,2018-02-01 13:15:30,15,16,1,个人不是很喜欢公关这门课。你说学些啥吧，老师就是以一个专业大咖的角度来给我们这些门外汉讲课，每次上课自己分析几个案例，小组讨论讨论，并不能收获什么。组长打分情况不知，个人认为这个方式有利有弊吧。最后的小组表演，感觉如果组里面有个稍微懂一点的带带会好很多。考试感觉无从准备。绩点出来也不是很理想。
74808,1512,熊卫平,2018-08-29 12:23:23,-2,2,4,讲得很好
76689,1512,熊卫平,2018-04-18 08:46:56,5,6,1,毛左，完全无法沟通，不允许同学有其他观点，喜欢打断同学发言，素质极差
78007,1512,熊卫平,2018-05-09 04:44:57,2,3,1,一般般
79479,1512,熊卫平,2018-06-06 10:52:23,16,18,2,非常不喜欢的老师，老师自己的实践经历的确是有，讲故事水平也是有。但就只知道强调公关第一重要，眼界也太低了。还说什么国际公关比国家金融还重要，真的是无语。而且自以为上课让同学上去说一些套话就能培养学生的思维。考核方式也不行，完全由组长打分，组长的权力没有监督。上课给的案例大多是危机公关，学生大多选题也就是危机公关，然后自己看到名单后给出结论：看来危机公关真的很重要啊，我有必要多说一些。除此之外，每次发言老师都有标准答案了。这种课完全就是低档职业培训课+讲故事，完全没有思维含量。引用之前的同学的说法：“不接受不一样的观点”。对时事的评价是“看起来高端黑”。不知道上面很多所谓“学到了很多”的同学是不是就是“听了”很多很多故事，就觉得很厉害了。一个小组将近20个人，太难协调了……总之真的不建议选，慎选！！！
79656,1512,熊卫平,2018-06-12 11:50:12,6,9,3,公共关系学要慎选，上课很有意思，但期末要排舞台剧，还有考试，而且占占70%！给分一般，要慎重
82544,1512,熊卫平,2018-07-08 12:48:02,2,3,1,我觉得老师人很棒啦 讲课也还可以 给分规则讲的很清楚 平时分也给的很高 考试好好背一下上4没问题
82557,1512,熊卫平,2018-07-08 13:33:29,0,2,2,被正太惹 老师是觉得我名字很难读才这么干的吗？ 有事吗？
83074,1512,熊卫平,2018-07-09 15:16:54,1,1,0,我觉得蛮好的。最后展示了点过名。小组平时自己分工好，平时成绩也占比较大分了…
83843,1512,熊卫平,2018-07-11 10:04:00,6,6,0,真的是辣鸡老师。。。。\n\n给分真的成迷。。。。\n\n上课总是要叫人发言。。。。。。\n\n小组展示＋期末考，真的是太差了。。。。
83852,1512,熊卫平,2018-07-11 10:17:53,3,3,0,绩杀慎选
83853,1512,熊卫平,2018-07-11 10:20:58,0,0,0,其实挺有意思的
84355,1512,熊卫平,2018-11-19 01:36:40,-15,2,17,蛮好的，组长靠谱，啥都没干，4.2，满足了
84575,1512,熊卫平,2018-07-13 08:17:18,5,5,0,课还可以，老师也还行，认真听收获也挺多的。但恶竞比较严重
86996,1512,熊卫平,2018-09-20 02:04:14,2,2,0,很有意思的一门课，给分也不错，不过小组评分有失公正
87688,1512,熊卫平,2018-10-10 05:16:33,0,3,3,ljljlj，不多说
89211,1512,熊卫平,2018-11-17 02:04:24,0,2,2,非常差
89948,1512,熊卫平,2018-11-21 11:02:12,0,1,1,哈哈哈
90992,1512,熊卫平,2018-11-28 13:40:46,13,14,1,讲故事讲得挺好，就是不喜欢管事，非要分组，那个组长……不是我说，有的没有能力，偏偏还要抢着当组长，结果全组被坑
91316,1512,熊卫平,2018-12-05 12:56:53,1,8,7,我不知道毛概怎么样，反正我认为公关课老师还是讲得很好的，分小组表演形式也很有趣。给分的情况我现在还不清楚，但是就从老师讲课而言，老师分析得十分清晰，课堂也很生动，不知道为什么有人要恶评？恶评是对老师的不尊重也是对看查老师的学生的不尊重，如果你觉得老师讲的不好，就请说出理由，而且有礼貌一点，不要直接ljlj的ok吗？谢谢大家。
91465,1512,熊卫平,2018-12-11 03:38:31,2,3,1,我太无语了，不想发言有错嘛
92517,1512,熊卫平,2019-01-01 14:28:23,15,16,1,楼下说的是。希望能够减少表演的环节。太累啦。
92519,1512,熊卫平,2019-01-01 15:18:22,33,44,11,老师很好，公共关系学上得很不错。但是2018届的课代表就是一个傻逼。为什么我这么说呢？一门通识，是学知识的，不是一门表演艺术课！期末展示搞得那么正式干嘛？策划组不就是为了恶竞拿高分嘛！我累了，不和你们这群傻逼斗。
93399,1512,熊卫平,2019-01-09 11:55:04,1,4,3,老师讲课很精彩，知识基础也很牢，但是仔细想想发现这门课有很多有问题的地方。1.平常根本不讲教材，也很少系统讲知识，主要是讲案例，然后就是讨论，然而最后考试占一半以上，不知道什么逻辑。2.权力都在课代表和组长身上，自己很少管事，没有一个权威的考核方法，一直都很迷。3.平常讲那些危机公关好像这些事本来可以不用发生一样，把公关的作用吹的很大，但是仔细想想那些大公司的公关水平会不高吗，她说的这些东西会没有考虑过吗，事后诸葛亮，到后期让我听着很不舒服。所以如果喜欢听味道的话可以选，分还没出所以不太了解。
93915,1512,熊卫平,2019-01-14 08:35:31,0,2,2,挺好的，干货挺多，教你如何说套话～
94180,1512,熊卫平,2019-01-15 12:58:31,2,3,1,很烦人，太水
96597,1512,熊卫平,2019-01-21 07:16:22,21,24,3,除了第一节课感觉良好外，课堂体验极差，每节课讨论发言，特别碰到sb组长，受不了，自己没什么能力，就整天给别人要求这要求那，bb没完没了，组长权利大，里面有认识的，内幕给分也是醉了，
96984,1512,熊卫平,2019-01-21 13:54:36,1,4,3,窒息窒息窒息……什么鬼啊考试的时候每写一个字就后悔一次为什么没有退课书上都有一模一样话毕竟是她自己出的所以听课也没什么用纯属看老师炫专业吧
97568,1512,熊卫平,2019-01-22 10:57:31,3,5,2,熊老师的毛概，没出分前来评价。熊老师专业水平是不错的，这一点上我可以打8-10分，我就来单纯吐槽一下某些课友和某些组长的吃相真的难看，为了点分数节操都不要了
98806,1512,熊卫平,2019-01-24 03:05:27,10,12,2,呵呵 给分是真的不好?
98876,1512,熊卫平,2019-01-24 04:27:09,-5,3,8,老师人很好
98999,1512,熊卫平,2019-01-24 06:38:29,0,3,3,公关课，就内容来说，我觉得挺有意思的，第一次上这门课感觉打开了新世界的大门。至于给分的话，平常主要靠小组展示吧。小组展示的风格严谨些会比较好，尽量展现公关知识。期末考的话，反正我比较懵，一共三道思考题，两个小时，就在胡扯。老师也是严格正态的。总之，非常感谢公关第七组的朋友们。小组合作挺愉快的。
99019,1512,熊卫平,2019-01-24 07:08:18,18,24,6,给分真的差，已经被正太。一门通识拉低我均绩...
99136,1512,熊卫平,2019-01-24 10:03:39,3,7,4,公关听课还行 但是容易被正态 特别是没有当组长 慎选
99186,1512,熊卫平,2019-01-24 11:26:00,-4,10,14,成绩出来我有点懵，一门1.5的通识能拉低那么多均绩我也是第一次见。本来以为是运气不好惨遭正态，结果老师在群里直接说有40个同学是低于80分的（一共就80个人）呵呵。
99489,1512,熊卫平,2019-01-25 00:59:31,-2,4,6,课很好，其实不存在楼上的问题。只要你够认真，并且体现在期末考答卷上，成绩就不会被sb组长拖累，亲测有效。
101701,1512,熊卫平,2019-01-29 01:47:07,7,11,4,我纠正一下，18届秋冬80分以下是有40个，但是总人数不是80，只不过微信群里当时正好80。公关一共11个组，平均下来每组10人略有余，总人数120+应该是有的。老师在第一节课也是明确说了80分以下不少于30%，要怪还是怪正态吧
102643,1512,熊卫平,2019-02-17 05:27:01,11,12,1,公关这课除了给我一个3.3以外没有任何收获
104437,1512,熊卫平,2019-03-20 12:58:38,-5,0,5,真好，喜欢
107671,1512,熊卫平,2019-05-08 06:40:15,13,15,2,看了你们的公共关系学的评论，我，果断退了(害怕)
108125,1512,熊卫平,2019-06-05 12:23:56,1,6,5,一副劳资天下第一的逼样，事多分少，谁选谁知道
108126,1512,熊卫平,2019-05-15 11:31:43,1,5,4,臭弟弟你可往后稍稍吧\n\n
109843,1512,熊卫平,2019-06-19 15:51:05,0,1,1,一般般
110334,1512,熊卫平,2019-06-25 16:18:21,0,0,0,老师不错 不过夏学期的课代表(策划组？)真得太差了…
112333,1512,熊卫平,2019-07-04 01:58:37,6,7,1,首先强调：确实喜欢点名，必到。\n\n其次强调：选个好的组，你的组长能把全组搞到90+，平时分就稳了。\n\n以上，我不管公关课怎么样，毛概给分真的好。举例给你看：同样平时分92，同样期末错两道辨析，我同学wxm班3.3，我4.2。
112455,1512,熊卫平,2019-07-04 08:37:11,1,5,4,毛概的确喜欢点名，一定要去。但是人挺好的，额外的事情也不多，找个好的小组。展示课记得找机会举手发言1-2次，基本上分数不会差。4.5+会有的。安利！
112492,1512,熊卫平,2019-07-04 12:30:19,1,5,4,反对楼上，根本不调分，期末考试才决定多少绩点，平时就算满了，考试没有80，4.5没戏
112693,1512,熊卫平,2019-07-05 00:37:26,6,9,3,我觉得老师毛概讲的不错，也没有什么乱七八糟的要求和额外的事情。期末考应该会有适当的调分，但肯定是你答的不错的情况下，靠考前看一晚上考试写点自己的话肯定不行。老师给分挺好的，平时参与度多的回报自然也不会少。90。
112985,1512,熊卫平,2019-07-05 17:15:57,3,5,2,老师喜欢正态人，无语了，公关课学不到东西
113250,1512,熊卫平,2019-07-06 02:43:52,-1,4,5,广告专业学生上公关通识课，被正态，用脚给分，改卷态度恶劣
115367,1512,熊卫平,2019-07-20 03:52:44,2,2,0,...
116520,1512,熊卫平,2019-09-11 03:27:01,-2,8,10,广告专业学子上公关通识课，本来以为是来碾压绩点的，结果被正态？？？老师你改卷看我写的东西了吗？分析专不专业看不出来？？？公关专业课分都很高，结果公关通识课只有3.3？？？
118254,1512,熊卫平,2019-10-24 01:57:04,4,8,4,点名，毛概课不能用电脑，鼓励组内斗争，毛左，形式化过于严重。
119552,1512,熊卫平,2019-11-13 13:03:41,-1,3,4,本来看了查老师有点担心，去上了公共关系课才发现讲的真个有声有色引人入胜，我TM吹爆
119568,1512,熊卫平,2019-11-14 00:30:16,7,8,1,无礼而且狂妄
120204,1512,熊卫平,2019-11-23 15:37:46,2,4,2,这老师不行，酷爱点名考勤，毛概课的理论水平让人困惑
121368,1512,熊卫平,2019-12-17 12:36:32,-8,0,8,大一冬学期最有趣的一门课√
123931,1512,熊卫平,2020-06-17 03:12:11,3,4,1,2020.6.公共关系学通识，今天一点钟出的分。课还是比较有意思的，拿了4.8，组员也都分不错吧？，但是①做组长事情非常多，投入了好多时间；②老师有点点口音，加上网课，我不大能听得懂；③公关这门课是教你处理非理性善变的公众的，我可能潜意识里不大喜欢这一点。综上，给老师打9分吧
124423,1512,熊卫平,2020-07-01 02:52:56,9,11,2,这个学期本来就是网课，所以给分还行。但是老师真的是偏心课代表，他们组展示的不好就改规则重新加个“老师打分”，互评最高的那个组到老师宁这里就是倒数第二了？课代表那个组互评最低宁就给他打高好几分？护犊子也不至于这么不要脸吧？群众的眼睛是雪亮的，宁是真的瞎，硬说什么理论展现少就打低分，我们真的心知肚明课代表跟你有啥裙带关系，不愧是“公关”学老师
124917,1512,熊卫平,2020-07-19 23:11:13,0,2,2,
129654,1512,熊卫平,2021-01-10 05:53:43,0,6,6,熊老师的毛概课我给10分~超级棒的，最终给分客观公正，非常照顾海宁校区的同学们，没有正太分布~平时分基本上都给满的，强推！！！
130276,1512,熊卫平,2021-01-20 12:10:27,-3,3,6,听不见他人意见，阴阳怪气的老师
130283,1512,熊卫平,2021-01-20 12:36:53,2,3,1,熊老师为人师表 很厉害的 但是很喜欢点名 一节课投影仪坏了二十分钟 换教室五分钟 换回来五分钟 点名两次十分钟 实在离谱。可以说老师只准备了一半的内容 硬是水了三个小时
131510,1512,熊卫平,2021-01-28 00:02:03,8,12,4,一学期点了三次名，都在讨论课。老师没啥问题，但课代表权力太大，遇上sb课代表是真的恶心人。
131631,1512,熊卫平,2021-01-28 08:45:34,-9,3,12,公共关系学 好好学了 3.9 拉低绩点
131970,1512,熊卫平,2021-01-29 16:05:29,5,10,5,给分一般，课代表权力太大，几乎统揽朝政
131972,1512,熊卫平,2021-01-29 22:31:41,5,7,2,挺好的，比较喜欢学生自治
140510,1512,熊卫平,2021-09-13 07:46:50,8,8,0,组织管理能力弱的一批，毛概课把问题交给学生，评分经典转移矛盾手法到人民当中了（流汗黄豆
140902,1512,熊卫平,2021-09-17 13:29:22,1,8,7,这个老师纯纯的sb\n\n\n\n挑起学生内部矛盾，不维护课堂秩序，听她的课就是侮辱毛泽东的伟大思想\n\n\n\n建议学她课的同学和她友好交流一下，顺便慰问一下她的家人们
145242,1512,熊卫平,2021-12-28 11:40:01,0,0,0,。。。
145698,1512,熊卫平,2021-12-31 08:35:53,7,8,1,2021秋冬毛概某组组长来给个分\n\n熊老师平时分给分真的无敌好。。。我们班91-94均分，（如果展示互评能提前组间说好打高分的话还能再高）最摆烂的组都跟其他班最好的组一样，其他班好像大部分88-91？
149184,1512,熊卫平,2022-01-14 16:06:40,5,7,2,不点名 佛系 给分好 都给我选xwp
149600,1512,熊卫平,2022-01-16 06:56:57,2,2,0,从习概角度，老师还行，有正态没办法，还得看期末考抄的怎么样
150827,1512,熊卫平,2022-02-19 06:13:13,1,1,0,。。。
152040,1512,熊卫平,2022-03-24 02:24:48,8,10,2,老师水平不高啊，就会吹我党的成就，eg.生育率配套政策，人均寿命高(然而资本主义国家的人均寿命也不算低？）。好红好专，我根本听不进去，有一说一，第一节课听高永的课，还有我们主课老师的课，感觉他们对现在社会还是有思考的，而她，emmmmmm
152863,1512,熊卫平,2022-04-21 02:26:03,6,8,2,最不明白的是一旦上课没有同学回答问题就开始讲课程分数，就像企图用分数绑架学生一样。
153741,1512,熊卫平,2022-05-10 03:05:06,2,2,0,上课也太水了…
154752,1512,熊卫平,2022-06-04 14:31:22,0,1,1,。。。
155548,1512,熊卫平,2022-06-14 08:11:37,5,8,3,平时分各组分布在91-94，看前面的评论好像应该稳定的这么打
155684,1512,熊卫平,2022-06-15 07:51:39,-3,0,3,。。。。。。
157652,1512,熊卫平,2022-06-24 08:10:22,0,5,5,老师最后会调分～
161392,1512,熊卫平,2022-11-06 00:19:59,9,11,2,上课是真的水\n\n为了说明西式民主制度在我国并不适用\n\n硬是把南橘北枳的典故\n\n从头到尾，细致地，语重心长地讲了一遍……
161541,1512,熊卫平,2022-11-08 11:33:23,0,1,1,上课内容并不求是。
162128,1512,熊卫平,2022-11-17 02:38:05,2,3,1,毛概又点名！！！
165230,1512,熊卫平,2022-12-30 10:36:27,10,12,2,依托答辩
177234,1512,熊卫平,2023-07-02 10:58:31,4,4,0,老师真的挺好的，给分很捞的
177559,1512,熊卫平,2023-07-03 17:06:35,6,6,0,给分还行吧，不过有点无为而治的感觉，很多事情如果细化得更明确一些就好了
178367,1512,熊卫平,2023-07-11 03:12:13,6,7,1,我这种废物最后还能有4.2真的感动
184533,1512,熊卫平,2023-12-21 12:44:06,3,5,2,习概，第一次点名没提前说，后几次点名都在前一节课提前预告了，但是上课水平比较平常。打个七分
188380,1512,熊卫平,2024-01-19 01:07:10,2,4,2,事少分高
189035,1512,熊卫平,2024-01-21 10:14:49,6,6,0,习概事情挺少的 平时分给的也高 拉不开差距
189704,1512,熊卫平,2024-01-27 06:17:13,4,4,0,事少分高放心选
189866,1512,熊卫平,2024-01-31 12:32:41,10,10,0,习概小组每组的平时分最低92，最高95，给得挺高且各组差距不大。按部就班地完成课程任务，考前熟悉课本内容，刷刷最新的肖四肖八材料题，最终成绩不会差到哪去。要是还想再拿高点，那就1.当课代表或小组长；2.小组内部分任务时活跃点，到时候组内分配分数可以多拿点；3.平时课堂多举手发言，老师不看发言质量，只要举手回答or提问就能计入个人发言一次。
192258,1512,熊卫平,2024-05-13 05:31:41,10,12,2,（习概）还没结课但是忍不住来评一下。点名会提前说。基本上事情都是小组内的锅。上课很无聊废话非常非常非常多。。上课前放的歌声音好大而且不好听。很好的补觉课。
192859,1512,熊卫平,2024-05-31 05:07:44,1,2,1,语速特别快
193046,1512,熊卫平,2024-06-03 03:12:13,6,6,0,端水大师，小组总分只给939495三个分数，反而是组内分配分数的时候比较麻烦，建议开始前就定好规则，这样大家都不会太为难，想卷的话就多举手发言，当课代表。
193865,1512,熊卫平,2024-06-20 10:33:06,8,8,0,考完了来评一下，平时分给得真高，“保卫平时分”的大师
195315,1512,熊卫平,2024-06-27 17:25:16,4,4,0,习概。怎么说呢……相比之前上过的一些思政课 老师上课挺没意思的 但也不太管学生。一个小组平均11个人隔三周一次pre，一共一次大作业。平时分都在92-95，然后组内分配。最后给分感觉还挺不错的。
195333,1512,熊卫平,2024-06-27 18:05:08,3,3,0,建议选，老师给分非常好，这学期平时分一共四档，93/94/95/96，发言有大量加分。最后期末自己感觉答得跟💩一样（因为做不完了），出分一看好得出人意料，看来是期末改卷也有捞捞的。
195352,1512,熊卫平,2024-06-28 00:25:42,0,0,0,【习概】平时分给的好，大家都高而且区分度不大，这一点很棒。最后给分也不错，试卷应该是统一流水线批的
195412,1512,熊卫平,2024-06-28 03:46:43,0,1,1,给分好
195424,1512,熊卫平,2024-06-28 04:06:03,3,3,0,平时分会端水，给分很慷慨，平时事情少，上课发言有加分，建议选！！
195434,1512,熊卫平,2024-06-28 04:26:51,0,0,0,无敌，调分的神
195437,1512,熊卫平,2024-06-28 04:33:33,0,0,0,事少分高，给分好，点名提前通知，神
195628,1512,熊卫平,2024-06-29 05:40:13,-8,1,9,上课发言三次，考试复习抄了书和问答，但感觉也是随便抄的，没有缺勤，最后满绩，xwp我的神
195632,1512,熊卫平,2024-06-29 06:06:11,8,8,0,牢熊，给分的神
196584,1512,熊卫平,2024-07-04 06:27:34,1,2,1,习概，给分很好
197294,1512,熊卫平,2024-07-10 12:21:13,6,6,0,缺点主要是讲课一般，分配任务有点混乱，其他都挺好，特别是给分
197534,1512,熊卫平,2024-07-18 05:43:43,5,7,2,给分好中好，重要事情会跟同学们说清楚，原因也会讲明白，很为同学考虑
208700,1512,熊卫平,2024-12-31 05:50:24,1,1,0,给分好，思政就不考虑讲课能力了吧hh，不鼓励鹅颈，小组展示给分差距很小。
211526,1512,熊卫平,2025-01-12 01:08:44,0,1,1,很好的老师，大赞！！！！！！
211561,1512,熊卫平,2025-01-12 02:29:14,1,2,1,给分不错，也不卷，很不错的选择
211591,1512,熊卫平,2025-01-17 15:48:06,4,4,0,给分好，小组平时分差距很小，点名提前通知，发一次言就有大量加分。上课有点啰嗦，考虑到这门课恐怕没有多少人会听，总体的体验还是可以的。
212595,1512,熊卫平,2025-01-14 09:01:10,0,0,0,给分好
213225,1512,熊卫平,2025-01-16 11:42:29,0,0,0,给分好
214582,1512,熊卫平,2025-02-13 13:49:37,-18,7,25,纯sb，少一次签到扣5分
216150,1512,熊卫平,2025-03-11 05:16:13,4,4,0,为啥课前要放巨响的音乐，睡不着觉啊😫
221138,1512,熊卫平,2025-06-21 12:04:56,-5,0,5,希望习概能满绩，这样就不用再上思政课了
221190,1512,熊卫平,2025-06-22 01:42:50,1,2,1,卷举手发言可以加分但很看运气，每节课都举手但是永远点不到太难受了。平时分其实也一般
221191,1512,熊卫平,2025-06-22 01:45:45,-6,2,8,总评和平时成绩一样，给分真没得说，回答问题加分也很多
221217,1512,熊卫平,2025-06-22 04:30:42,1,2,1,抢不到发言很简单，你去坐前面的座位就好了，反正我前几次就把发言混完了，我是被抬上上一档最低分了
221239,1512,熊卫平,2025-06-22 06:58:06,0,1,1,给分真的不错。稍微有个一两次发言就能捞一档
221288,1512,熊卫平,2025-06-22 13:39:34,-1,0,1,发言真的有不少加分，很有用，平时分给的也很不错
221707,1512,熊卫平,2025-06-25 10:37:12,-1,0,1,好老师，给分好
35,1546,赵晖,2015-03-14 15:29:48,89,105,16,酣畅淋漓，如沐春风
96,1546,赵晖,2015-03-14 15:50:16,284,304,20,老师讲课时将多种史料信手拈来，如数家珍，有一种听百家讲坛的味道
97,1546,赵晖,2019-09-01 16:03:10,617,640,23,百家讲坛现场版\n\n
165,1546,赵晖,2019-03-08 08:36:03,763,889,126,绝妙的课堂！每次都被老师讲历史的方式感染弄得我总有学历史的鸡血。不点名，但任务比较多，讨论课展示课小组报告个人论文还是很繁琐的。给分机制也很复杂
228,1546,赵晖,2015-03-14 17:12:57,195,203,8,赞！知识渊博。要是有问题他不是很清楚，下次碰见他就会告诉你这几天看了几篇文献几本书得到科学的解决。
362,1546,赵晖,2015-03-15 01:25:08,22,34,12,爱抖机灵的老师……
680,1546,赵晖,2015-03-15 11:54:09,14,18,4,很好很强大
793,1546,赵晖,2015-03-17 04:00:15,10,15,5,绝对很赞的老师！
818,1546,赵晖,2015-03-17 12:52:39,11,18,7,博闻强识
863,1546,赵晖,2015-03-18 02:59:03,8,11,3,挺好的
935,1546,赵晖,2015-03-21 16:40:40,1,6,5,赞
983,1546,赵晖,2015-03-20 06:55:42,6,14,8,上课老师不管你干什么，但是大家都很认真听，很少玩手机
1064,1546,赵晖,2015-03-21 16:03:49,164,179,15,非常棒的老师，知识渊博且敬业，希望老师可以更注意自己的身体
1092,1546,赵晖,2015-03-21 16:08:29,3,6,3,真的很赞
1101,1546,赵晖,2015-03-21 16:10:04,26,31,5,老师的课让你觉得全程无尿点…尤其是阐发自己的观点的时候
1189,1546,赵晖,2015-03-22 00:08:09,31,37,6,享受
1227,1546,赵晖,2015-03-21 16:48:17,404,418,14,每次上完课都掌声雷动，在浙大上过的课里这是唯一一个
1277,1546,赵晖,2015-03-21 17:17:43,16,21,5,业界良心
1297,1546,赵晖,2015-03-21 18:00:27,453,480,27,赵晖老师是大一一年改变了我对文科男偏见的四个人中最主要的一位，也让我发现史学研究其实是非常严谨厚重的。在他身上可以感受到一位学者对历史的温情与敬意。
1382,1546,赵晖,2015-03-22 01:25:55,36,40,4,比百家讲坛好!
1405,1546,赵晖,2015-03-22 01:51:56,15,20,5,说书
1407,1546,赵晖,2015-03-22 01:56:20,121,131,10,每次上完课都是下意识的鼓掌，心思却仍然在课堂里。
1423,1546,赵晖,2015-03-22 02:25:40,69,74,5,赵晖是一位真正的老师！
1427,1546,赵晖,2017-09-20 07:10:06,8,11,3,百家讲坛的水平
1460,1546,赵晖,2015-03-22 05:24:28,90,98,8,就连我这个听不懂歷史的理科生都觉得雖然不懂可是依然很明显地讲得很好。。
1583,1546,赵晖,2015-03-22 16:32:33,11,16,5,老实说史纲课我没太认真听【因为自己对近代史了解太少也不太感兴趣，但还是对赵老师很敬佩，博闻强识又逻辑严谨，每次下课都有掌声
1678,1546,赵晖,2015-06-17 13:13:08,13,17,4,好
1710,1546,赵晖,2015-03-23 10:53:33,7,11,4,超级棒
1816,1546,赵晖,2015-03-25 11:16:01,-1,8,9,有趣\n\n但给分不高\n\n
1846,1546,赵晖,2015-03-26 01:49:42,19,23,4,怎么只有九点五分！！！
1867,1546,赵晖,2015-03-26 02:59:35,11,15,4,口才太好，因有干货。与其说是百家讲坛，不如说是近代那些事儿。
1875,1546,赵晖,2015-04-17 02:29:15,8,10,2,好
1958,1546,赵晖,2015-03-27 02:30:25,6,10,4,一个字，好！
2136,1546,赵晖,2015-04-02 08:39:06,0,3,3,绝对精彩！虽然有读书作业之类的
2231,1546,赵晖,2015-04-12 06:42:51,1,3,2,除了好就是好
2302,1546,赵晖,2015-04-19 03:46:22,1,4,3,黑色幽默大师
2398,1546,赵晖,2015-04-28 15:21:07,3,5,2,欲罢不能\n\n\n\n
2442,1546,赵晖,2015-05-02 10:56:59,12,15,3,最好的老师没有之一，知识渊博，认真敬业，喜欢与同学交流
2513,1546,赵晖,2015-05-04 13:21:37,1,4,3,棒！特别有趣！\n\n
2533,1546,赵晖,2015-05-04 13:38:37,258,270,12,目前在浙大遇见的最好的老师。他今年要参加心平奖的竞选，大家一起支持哦，哈哈，目前赞同最多的评论也是我写的～
2540,1546,赵晖,2015-05-04 13:44:19,2,4,2,非常爽…讲课风格很好…
2581,1546,赵晖,2015-05-04 14:58:48,0,3,3,百家讲坛
2609,1546,赵晖,2015-05-04 17:07:57,2,4,2,讲课非常棒
2673,1546,赵晖,2015-05-05 07:14:18,31,32,1,很棒很棒，最后一节课很难过，因为以后上不了了
2752,1546,赵晖,2017-01-12 08:18:31,74,79,5,目前为止在浙大遇见的最认真的老师之一 你找他修改论文 他会给回电话跟你把文章从头到尾的问题都说一遍 来来去去几个来回 老师都十分耐心
2776,1546,赵晖,2015-05-07 06:33:46,1,4,3,讲得非常好，相信这点是大家公认的吧
3016,1546,赵晖,2015-05-13 01:02:12,2,4,2,直播百家讲坛
3319,1546,赵晖,2015-06-01 07:45:33,0,4,4,太棒了！听他的课会突然爱上历史，但表示课后一看历史还是…依旧…你懂的
3500,1546,赵晖,2015-07-07 06:05:39,3,5,2,百家讲坛现场版
3521,1546,赵晖,2015-06-17 01:26:55,-1,3,4,真心不错。
3589,1546,赵晖,2015-06-17 12:11:31,-72,13,85,差
3596,1546,赵晖,2015-06-17 01:46:32,1,5,4,棒棒哒
3618,1546,赵晖,2015-06-17 01:50:28,0,3,3,好老师
3722,1546,赵晖,2015-06-18 05:48:33,3,5,2,负责，公平公正，非常和蔼，学者风范
3870,1546,赵晖,2015-06-17 07:07:23,104,111,7,老师竟然本科是工科的！
3892,1546,赵晖,2015-06-17 07:36:28,0,3,3,特别特别好 每次周五史纲H都想翘不忍心那种
3903,1546,赵晖,2015-06-17 07:56:39,37,41,4,选了他的通识课～平心而论，老师知识很渊博～但是感觉自己知识储备不够没有实现准备的话只能是听热闹
4011,1546,赵晖,2015-06-17 13:48:18,1,3,2,所遇到过讲课最好的老师
4046,1546,赵晖,2015-06-17 15:24:17,55,56,1,绝对的百家讲坛！收获超多 很幽默风趣！就是任务很多很繁琐 不过很有收获。论文要求高 会让你回去改 很锻炼人 真正学到东西
4188,1546,赵晖,2015-06-18 03:40:43,4,6,2,还行 论文要求有点高\n\n
4234,1546,赵晖,2015-06-18 08:34:02,1,2,1,真是好老师，只要你上课认真，积极发言，加分机会特别多\n\n
4257,1546,赵晖,2015-06-18 10:58:33,77,86,9,若是一个老师讲课真能像赵老师这样好，给分再低我也愿意上。胜似百家讲坛，幽默有趣，知识渊博，让我重新认识了中国近代史。
4265,1546,赵晖,2015-06-18 12:30:36,1,2,1,很棒，好老师
4291,1546,赵晖,2015-06-18 15:13:50,2,3,1,很有意思，值得一听。
4323,1546,赵晖,2015-06-19 03:47:35,-1,2,3,超赞
4561,1546,赵晖,2015-06-24 11:50:42,111,115,4,和室友的近代史纲老师比起来总是有满满的自豪感.赵晖老师是一个真正的教师和学者，传道授业解惑，肚里有货又非常风趣睿智，不为难学生，也能够引导我们如何看待问题.
4592,1546,赵晖,2015-06-25 00:09:16,146,158,12,从此走上了光明的道路！
4694,1546,赵晖,2015-06-26 06:59:45,246,256,10,喜欢拍我肩膀 我喜欢被拍
4779,1546,赵晖,2015-06-28 15:11:39,2,3,1,很好
4920,1546,赵晖,2015-07-01 02:25:32,0,2,2,很好的老师 很认真 上课有趣 给分也好
5017,1546,赵晖,2015-07-02 05:30:05,2,3,1,享受上的每一节课，老师超认真负责
5018,1546,赵晖,2015-07-02 06:32:31,1,2,1,太赞了
5023,1546,赵晖,2015-07-02 07:58:14,43,50,7,老师人很好，从不点名，每一堂课都能听的津津有味.赵老师让我意识到真正的好老师是用人格魅力留住学生的，真希望能选到老师的通识课
5034,1546,赵晖,2015-07-02 11:12:02,3,3,0,好老师\n\n
5089,1546,赵晖,2015-07-03 15:39:18,1,2,1,好
5153,1546,赵晖,2015-07-07 04:43:16,2,3,1,每次老师讲的差不多的时候风度翩翩的说 那么今天就讲到这里 简直百家讲坛
5170,1546,赵晖,2015-07-05 14:31:22,1,2,1,讲课超赞 内容丰富
5238,1546,赵晖,2015-07-06 03:24:32,3,3,0,没有更赞的啦
5511,1546,赵晖,2015-07-08 04:15:30,2,3,1,觉得老师把思政类的课讲得生动有趣，老师超棒！
5639,1546,赵晖,2015-07-09 02:11:41,12,16,4,此生遇见最好的历史老师没有之一
5727,1546,赵晖,2015-07-09 08:01:32,3,4,1,大学以来最受益匪浅的课，把思政课变成了一种享受。真的是一位好老师~
5791,1546,赵晖,2015-07-09 11:26:55,3,3,0,老师讲的政治史、军事战争史是一绝
6258,1546,赵晖,2015-07-12 11:22:40,0,2,2,课很好，不过绩点不高，不过貌似史纲都不高。
6323,1546,赵晖,2015-07-13 03:48:40,4,4,0,非常认真负责的老师，讲课幽默风趣，选上了他的课真是很幸运
6415,1546,赵晖,2015-07-14 00:13:23,2,2,0,蛮有趣的老师
6432,1546,赵晖,2015-07-14 02:46:45,2,2,0,讲课生动有趣，认真负责，从不点名，给分好
6436,1546,赵晖,2015-07-14 03:19:58,9,9,0,棒棒哒\n\n
6440,1546,赵晖,2015-07-14 03:50:12,13,14,1,真的是超级超级好的老师，每天上课都听的痴迷，长得又帅，想到以后听不到这么好的老师上课简直悲伤，只要你认真上课认真做作业了分数也是绝对超级高！
6476,1546,赵晖,2015-07-20 02:12:46,-54,11,65,不点名，给分不咋地，刷脸狂魔太多，实在受不了
6747,1546,赵晖,2015-07-20 16:22:21,14,15,1,真的是一位好老师、很有意思、让你感觉身临其境，听了课绝对不会后悔！
6878,1546,赵晖,2015-07-28 11:10:36,12,13,1,如沐春风，业界良心。历史可以很有趣
6994,1546,赵晖,2015-08-24 09:35:02,2,3,1,百家讲坛现场版，不听一次赵老师的课是种损失
7059,1546,赵晖,2015-09-01 06:24:45,1,2,1,好
7237,1546,赵晖,2015-09-12 04:01:45,22,25,3,推荐史纲我都会说赵晖老师，用一个个故事一段段史料将第一次鸦片战争以来的中国历史讲的精彩纷呈~知识渊博而精深，待人认真而负责。最喜爱的两三老师之一
7265,1546,赵晖,2015-09-12 11:13:01,1,2,1,课讲得好 给分我觉得一般
7307,1546,赵晖,2015-09-13 10:22:02,3,3,0,只能说超级棒
8125,1546,赵晖,2015-09-17 05:51:28,2,3,1,真正有学问的老师，听过课之后才知道，为什么大家说像百家讲坛
8179,1546,赵晖,2015-09-21 11:41:15,5,6,1,特棒啊！
8331,1546,赵晖,2015-09-25 04:59:24,0,2,2,讲得非常好 幽默风趣
8351,1546,赵晖,2015-09-19 01:58:03,1,2,1,先生是个好老师
8375,1546,赵晖,2015-09-20 01:45:51,3,3,0,很棒的
8524,1546,赵晖,2015-09-22 05:24:39,1,2,1,百家讲坛
8573,1546,赵晖,2015-09-22 13:44:19,3,3,0,绝对是百家讲坛级别的！
8574,1546,赵晖,2015-11-24 07:41:00,4,4,0,非常棒！
8579,1546,赵晖,2015-11-11 12:24:09,20,23,3,老师很好，像百家讲坛。我们的课代表长得好漂亮，这是最关键的！
8705,1546,赵晖,2015-09-24 08:02:19,0,2,2,赞赞赞
8747,1546,赵晖,2015-09-25 07:23:18,38,39,1,腹中饱含书卷气，口出古今大世界
8758,1546,赵晖,2015-09-25 13:45:45,18,18,0,真人版百家讲坛，不听会后悔，但是给分机制太复杂，讨论内容太多了
9059,1546,赵晖,2015-10-12 02:39:35,1,2,1,绝对百家讲坛
9099,1546,赵晖,2015-10-13 03:14:56,2,3,1,就是感觉作业略麻烦
9223,1546,赵晖,2015-10-18 01:31:22,2,3,1,享受   很渊博又很可亲的老师
9289,1546,赵晖,2015-10-20 05:28:52,17,18,1,是一 种想睡也睡不着的感觉
9451,1546,赵晖,2015-10-27 16:45:25,0,2,2,享受\n\n
9567,1546,赵晖,2015-11-01 14:22:36,0,2,2,详细，深刻，清晰，好老师
9641,1546,赵晖,2015-11-03 15:20:33,1,2,1,赵晖老师的课超棒！唯一不想睡觉的课
9926,1546,赵晖,2015-11-12 23:51:52,2,3,1,棒棒棒，老师人很好
10346,1546,赵晖,2015-11-18 07:08:13,7,9,2,特别值得去听赵老师的课，非常享受！有疑问问老师，老师还会找资料来做解答！会把自己的藏书借给我们参考！
10484,1546,赵晖,2015-11-19 05:27:43,1,3,2,每次听完课都有想鼓掌的冲动
10774,1546,赵晖,2015-11-23 05:01:08,1,2,1,老师认真负责，课堂很有趣。赞
10787,1546,赵晖,2015-11-23 05:18:57,2,3,1,非常厉害
10871,1546,赵晖,2015-11-23 07:57:58,2,3,1,爽\n\n爽\n\n爽\n\n
11043,1546,赵晖,2015-11-24 03:50:47,0,2,2,非常负责任
11129,1546,赵晖,2015-11-24 11:28:38,3,3,0,好！老！师！
11140,1546,赵晖,2015-11-24 12:47:01,3,3,0,听完想转历史系
11333,1546,赵晖,2015-11-27 06:34:57,-72,11,83,听课很爽，就是论文要求太高，我们只是学生，并不是学者，随便一点不行吗？竟然打回来重写，重写竟然还降低分数上限
11367,1546,赵晖,2015-11-29 04:04:11,3,3,0,生动幽默，治学严谨，只要努力能从那里学到不少东西。
11438,1546,赵晖,2015-12-01 08:47:52,1,2,1,很有趣的历史
11717,1546,赵晖,2015-12-12 08:30:54,4,4,0,真的很不错
11978,1546,赵晖,2015-12-24 12:58:04,1,2,1,听赵老师的课永远坐在第一排，因为老师的课实在太精彩。能从老师的课中体会到那些岁月钩沉，不由得产生对历史厚重的敬畏与热爱。
11999,1546,赵晖,2015-12-21 13:04:32,2,3,1,赵老师的课炒鸡棒！每次上完课收获很多
12190,1546,赵晖,2015-12-22 09:04:26,1,2,1,就和评书一样，很有意思
12217,1546,赵晖,2015-12-22 11:26:27,2,3,1,幽默风趣，博文强志，一位真正老师
12267,1546,赵晖,2015-12-24 07:42:55,0,2,2,知识渊博，虽然我不是很了解历史，不过他的课真的可以让你有认真研究历史的冲动！超级好的老师！
12305,1546,赵晖,2015-12-23 02:22:50,2,3,1,讲课非常有意思
12308,1546,赵晖,2015-12-23 02:25:02,10,13,3,迷之眼神攻击
12327,1546,赵晖,2015-12-23 03:31:00,-1,2,3,让历史变得狗血有趣，让现场有了百家讲坛的感觉而又不失幽默！
12333,1546,赵晖,2015-12-23 03:52:25,1,2,1,事情挺多的 课讲得真的好
12376,1546,赵晖,2015-12-23 06:53:46,12,14,2,太好了，赵晖老师干嘛不去百家讲坛啊
12453,1546,赵晖,2015-12-23 10:08:59,1,2,1,太充实…以至于…\n\n
12506,1546,赵晖,2015-12-23 11:45:25,2,3,1,百家讲坛哈哈哈，把历史讲活了
12533,1546,赵晖,2015-12-23 12:10:30,0,2,2,这才是历史，真的，他让所谓的“水课”变成了我大一一年最精彩的一门课程。不听赵老师，枉学史纲。
12573,1546,赵晖,2015-12-23 13:44:08,0,2,2,百家讲坛现场版\n\n
12576,1546,赵晖,2015-12-23 13:54:53,2,3,1,无论你是文科生还是理科生，你对改变你对历史的看法，并让你爱上历史。
12616,1546,赵晖,2015-12-23 15:31:07,0,2,2,老师讲课一级棒啊！历史在他口下生动幽默鲜活，真的不舍得史纲课做别的事情，自己会做笔记记下他讲的佚事。虽然事情比较多，成绩不是很好，但还是很荣幸听他的课。
12657,1546,赵晖,2015-12-24 00:22:08,1,2,1,老师讲得很好
12747,1546,赵晖,2015-12-24 03:11:05,3,3,0,宽厚长者 渊博学者
12750,1546,赵晖,2015-12-24 03:13:39,3,3,0,老师超级厉害的，听他的课确实是一种享受，诙谐有趣，各种笑料
12780,1546,赵晖,2015-12-24 04:00:00,1,2,1,百家讲坛，带给你不一样的感受
12793,1546,赵晖,2015-12-24 05:13:07,3,3,0,百家讲坛
12841,1546,赵晖,2015-12-24 06:19:53,4,4,0,比百家讲坛更好一点而已，真的很荣幸能够上老师的课。学史纲必备
12929,1546,赵晖,2015-12-24 10:47:35,4,5,1,中国好老师\n\n
13009,1546,赵晖,2015-12-24 13:24:25,2,3,1,史纲快要结束了真的很难过（泪奔）赵老师是最最最最最棒的老师！！
13021,1546,赵晖,2015-12-24 14:10:01,1,2,1,知识渊博，史料丰富，理得清楚，幽默风趣，他的课我没有落下一节
13105,1546,赵晖,2015-12-25 01:44:09,2,3,1,每次都对史纲课充满了期待
13135,1546,赵晖,2015-12-25 02:39:43,2,2,0,挺有趣，老师会尽量让课堂不生闷
13217,1546,赵晖,2015-12-25 08:29:21,8,8,0,作为一名史纲老师，我给满分
13903,1546,赵晖,2016-01-02 06:45:26,3,3,0,叼叼叼
14097,1546,赵晖,2016-01-04 08:38:59,0,2,2,极其推荐
14149,1546,赵晖,2016-01-05 04:20:28,1,2,1,享受\n\n
14164,1546,赵晖,2016-01-05 06:15:51,2,3,1,怒赞啊
14234,1546,赵晖,2016-01-05 13:42:14,3,4,1,声情并茂
14434,1546,赵晖,2018-09-17 06:07:18,13,16,3,突然发现老师还是一个有趣的段子手，很有趣的课堂，真正的学者，真正的博学，来浙大不听一节他的课是遗憾
14497,1546,赵晖,2016-01-07 09:06:29,1,3,2,炒鸡好的老师！居然还有人没打10分……
14554,1546,赵晖,2016-01-07 15:01:47,1,2,1,超级有趣！！！！
14748,1546,赵晖,2016-01-08 15:06:23,4,4,0,有古时文士才子之风
14961,1546,赵晖,2016-01-11 09:41:07,2,3,1,享受！和评书一样\n\n
15029,1546,赵晖,2016-01-11 14:44:47,1,3,2,非常有趣的课堂！真正的师长！
15083,1546,赵晖,2016-01-12 02:54:49,-1,2,3,很棒很棒
15103,1546,赵晖,2016-01-12 05:20:55,0,2,2,男神不解释～
15136,1546,赵晖,2016-01-12 07:21:23,1,2,1,很棒，不给十分不行
15160,1546,赵晖,2016-01-12 09:20:26,2,3,1,可以这样说吧，你会觉得他讲的没有一句是废话\n\n
15193,1546,赵晖,2016-01-12 14:02:01,2,2,0,老师上课和说书一样的，超级棒！只要认真听，老师跟你的互动还是蛮多的！
15355,1546,赵晖,2016-01-14 03:53:29,3,3,0,讲课绝对吸引人，最喜欢的老师。
15625,1546,赵晖,2016-01-16 01:30:05,4,4,0,百家讲坛
15638,1546,赵晖,2016-01-26 10:07:03,1,2,1,赵晖非常棒！知识渊博。非常照顾同学！讲课的非常清楚。。谢谢老师！
15802,1546,赵晖,2016-01-16 09:58:11,5,6,1,上课特别好，特别认真。论文老师给了修改意见，提供了参考文献，期末论文用的书我都是问老师借的，很nice，给分也很好
16022,1546,赵晖,2016-01-17 04:46:03,2,3,1,没听过他的课会后悔一辈子
16076,1546,赵晖,2016-01-17 06:52:01,3,3,0,讨论课挺多的
16164,1546,赵晖,2016-01-17 10:59:49,0,2,2,老师很棒，赵老师是我在查老师里看到评论最多的老师而且全是好评！老师注意身体，有机会再上您的课！
16192,1546,赵晖,2016-01-17 12:54:43,2,3,1,知识渊博，讲的精彩！
16284,1546,赵晖,2016-01-17 16:08:19,1,3,2,很不错，有意思，大学唯一上课认真听完的课，唯一一个没有睡过觉或者水过手机的课
16591,1546,赵晖,2016-01-18 12:42:01,5,5,0,真是绝妙的老师，对历史有自己的一份感情，而且讲课很棒，让你全程无尿点。
17284,1546,赵晖,2016-01-20 03:40:50,2,3,1,史纲的确是一门思政课，但赵晖老师讲的不是政治，是真正的历史。真的能让人一分钟都不走神听完半年史纲的好老师！
17516,1546,赵晖,2016-01-20 10:24:37,3,4,1,喜欢喜欢喜欢喜欢喜欢最喜欢的老师没有之一！
17732,1546,赵晖,2016-01-20 22:30:36,4,4,0,依然很怀念赵老师的课堂
17907,1546,赵晖,2016-01-21 03:44:30,3,3,0,听他的课根本舍不得水
19229,1546,赵晖,2016-01-23 15:01:28,3,3,0,好的不能再好
19773,1546,赵晖,2016-01-25 09:03:40,6,6,0,男神，给分高，讲课棒，不多说
19873,1546,赵晖,2016-01-25 12:40:29,1,2,1,
19978,1546,赵晖,2016-01-25 17:42:25,4,5,1,知识渊博、真心赞
19981,1546,赵晖,2016-01-25 23:39:19,2,3,1,一个字棒
20036,1546,赵晖,2016-01-26 02:51:59,3,4,1,学识渊博 会为学生考虑 完全没有距离感 特别喜欢! 给分也不错
20057,1546,赵晖,2016-01-26 03:48:08,4,4,0,好老师！！！
20059,1546,赵晖,2016-01-26 04:01:49,6,6,0,讲课真心赞(≧▽≦)
20077,1546,赵晖,2016-01-26 04:56:44,5,6,1,啥都好
20354,1546,赵晖,2016-01-27 06:10:50,1,3,2,十足的好老师
20695,1546,赵晖,2016-01-30 02:22:49,3,4,1,很厉害的老师～超级nice
21339,1546,赵晖,2016-02-28 05:33:54,7,7,0,百家讲坛！
21348,1546,赵晖,2016-02-28 06:37:10,2,3,1,确实是好老师，建议选
21717,1546,赵晖,2016-03-01 01:34:00,2,3,1,你值的拥有
21736,1546,赵晖,2016-03-01 02:30:30,2,3,1,好非常好
22008,1546,赵晖,2016-03-02 05:46:32,5,7,2,史纲里良心好老师
22101,1546,赵晖,2016-03-02 10:47:00,3,3,0,讲得好
22246,1546,赵晖,2016-03-03 06:07:19,4,4,0,百家讲坛啊 麦克风都不用的啊
22287,1546,赵晖,2016-03-03 08:12:07,11,15,4,老师 你知道的太多了！
22295,1546,赵晖,2016-03-03 09:39:35,6,8,2,百家讲坛现场版那位说出了我的心声hhh
22370,1546,赵晖,2016-03-04 03:07:52,0,3,3,讲得好 给分一般
22449,1546,赵晖,2016-03-06 05:53:36,6,6,0,老师讲课非常好，特别像电视的历史故事还很幽默，强烈推荐他的课\n\n
22487,1546,赵晖,2016-03-07 01:58:54,4,5,1,选上他的课是福气
22815,1546,赵晖,2016-03-12 10:20:23,5,5,0,不能更好了
22903,1546,赵晖,2016-03-14 12:04:12,3,4,1,极好，不会后悔的！
23083,1546,赵晖,2016-03-17 05:23:28,1,2,1,棒棒哒
23222,1546,赵晖,2016-03-22 04:34:58,2,3,1,渊博的知识，风趣的言谈
23323,1546,赵晖,2016-03-24 08:26:47,0,2,2,好！！
23348,1546,赵晖,2016-03-25 13:07:35,-25,7,32,个人感觉给分肯定不好
23398,1546,赵晖,2016-03-29 01:07:39,14,15,1,你是写不成别的课作业的，因为精彩
23590,1546,赵晖,2016-04-08 02:54:36,1,3,2,超级好\n\n
23729,1546,赵晖,2016-04-14 01:47:28,4,5,1,听课简直就是一种享受。辉哥，我爱你⊙ω⊙（）
26076,1546,赵晖,2016-06-21 02:07:53,6,7,1,炒鸡好！
26077,1546,赵晖,2016-06-15 11:13:12,3,4,1,上课超级精彩！百家讲坛现场版！棒！
26095,1546,赵晖,2016-06-15 16:26:37,2,3,1,非常好
26141,1546,赵晖,2016-06-16 05:54:06,4,4,0,太爽了
26241,1546,赵晖,2016-06-16 11:02:14,3,4,1,课堂幽默风趣，值得一选
26246,1546,赵晖,2016-06-16 11:30:23,4,4,0,讲得好
26263,1546,赵晖,2016-06-16 12:27:56,9,11,2,每次上课都带作业去，但是每次都沉迷于他的讲课而忘记写
26344,1546,赵晖,2016-06-17 04:09:27,2,3,1,特别好
26345,1546,赵晖,2016-06-17 04:16:01,3,4,1,学期结束，值得满分
26380,1546,赵晖,2016-06-17 08:54:19,2,3,1,是享受
26484,1546,赵晖,2016-06-19 03:14:56,7,7,0,好老师！讲得好！给分好！
26850,1546,赵晖,2016-06-21 09:59:41,4,4,0,真的……最后一节课有想哭的冲动……不舍得啊
27149,1546,赵晖,2016-06-23 07:56:48,5,5,0,炒鸡棒！
27464,1546,赵晖,2016-06-26 10:51:01,5,6,1,绝笔好
28150,1546,赵晖,2016-06-28 08:09:59,3,5,2,不能更赞，治学严谨，讲课生动
28181,1546,赵晖,2016-06-28 08:13:09,3,3,0,太好了，百家讲坛
28262,1546,赵晖,2016-06-28 08:22:49,5,5,0,从来没有这样学过历史，课上有火花，讨论锋芒对。一个思政课真是上出了人文的高度。
28331,1546,赵晖,2016-06-28 08:34:37,12,14,2,你永远不懂赵老师到底知识有多渊博，就像白天永远不知道夜的黑
28423,1546,赵晖,2016-09-21 06:57:25,6,7,1,内容充实，的确是懂历史，可以讲好历史的好老师！
28837,1546,赵晖,2016-06-28 18:16:27,11,11,0,满分，不解释，能把这种思政类课程上成每周最期待的一节课
29592,1546,赵晖,2016-06-30 04:28:09,1,3,2,难得一遇的好老师！
31522,1546,赵晖,2016-07-04 05:04:46,6,7,1,老师人超好，和学生互动很到位！很喜欢这样的课堂氛围，讨论课能给出有用的建议，重点是给分高！谢谢老师！
31523,1546,赵晖,2016-07-04 05:05:13,7,7,0,是好老师，讲课风趣，内容充实，推荐的史料很多，读完颇有感悟。讨论课设置也很好。开卷考试，写的内容有点多，给分非常好。非常感谢老师，有幸做您的学生很幸福。
31642,1546,赵晖,2016-07-04 10:33:04,1,4,3,还好吧
31703,1546,赵晖,2016-07-04 14:03:16,1,3,2,讲课超棒给分也好
31705,1546,赵晖,2016-07-04 14:21:46,-26,8,34,讲课好，给分好，翘了一半的课还有4.2
31722,1546,赵晖,2016-07-04 15:06:54,17,18,1,什么？你说这是思政课？
31947,1546,赵晖,2016-07-05 08:15:03,4,5,1,讲得非常棒!有一种百家讲坛的体验。老师会很耐心地回答你的问题，也会很耐心地指点你报告中的问题。
31978,1546,赵晖,2016-07-05 10:17:54,7,7,0,原谅我听不进去历史。不过老师上课的氛围的确很百家讲坛。有三次讨论课，还有读书报告和小论文，想选的同学不能轻视这门课哦
32717,1546,赵晖,2016-07-11 14:03:42,16,18,2,听了老师的课，从此走上了光明的道路.
32778,1546,赵晖,2016-07-13 05:37:10,4,5,1,我遇到最好的老师没有之一。选过史纲和现代中外关系，可以看出老师是真的热爱历史啊，会极其认真的回答问题，提供很多参考资料，讲课多精彩就不用再讲了，课程要求不算轻松，但老师的优秀、认真足以让你心甘情愿写一万字论文真的。
32935,1546,赵晖,2016-08-09 13:18:12,2,4,2,即使不能全说真话，也绝不说没有根据的假话。
32948,1546,赵晖,2016-12-14 10:28:14,2,4,2,理科生也能听的很开心
33244,1546,赵晖,2016-09-16 12:21:30,5,7,2,没去上课会有罪恶感o>_<o
33288,1546,赵晖,2016-09-18 01:41:11,0,4,4,一个字，好！
33374,1546,赵晖,2017-01-11 07:58:44,10,13,3,生动有趣的课堂，带我们领略的不是又红又专的历史，而是那些真正发生的大到轰轰烈烈的历史转折，小到缓缓的生活平常的历史，真正的历史。而且赵晖老师的眼神杀和拍肩杀很棒哦！
33436,1546,赵晖,2016-09-19 09:31:22,7,9,2,告诉我，为什么赵老师不是满分！？
33559,1546,赵晖,2016-12-26 10:31:41,4,6,2,特别棒，就算分低也甘心
33820,1546,赵晖,2017-01-06 06:49:23,0,3,3,老师很认真，讲课很有激情，唯一就是事情比较多，还是很好的一个老师
33911,1546,赵晖,2016-09-22 13:21:53,2,4,2,会玩，博闻强识 我的天，怎么做到的，历史怎么能这么好玩
34083,1546,赵晖,2017-01-13 06:57:27,6,9,3,百家讲坛浙大学生专属奢华版\n\n课堂特别生动有趣，也因为老师喜欢上了史纲课。\n\n笔芯。
34205,1546,赵晖,2016-09-28 10:41:08,1,2,1,总让你觉得世界还有更丰富的一面
34786,1546,赵晖,2016-10-22 09:35:30,27,29,2,老师好，但是分数包机制组长不要脸就没办法\n\n
34804,1546,赵晖,2016-10-23 16:59:36,5,7,2,老师挺好的 真的是对历史十分热爱 知识渊博 而且能用通俗风趣的话讲出来。\n\n没给满分的原因是，事情有些多。而且，分数包机制有点不合理。
35229,1546,赵晖,2016-11-07 10:13:21,-27,8,35,无聊至极
35788,1546,赵晖,2016-11-10 08:10:02,1,2,1,有意思
36237,1546,赵晖,2016-12-25 15:12:10,3,4,1,真心有趣
36439,1546,赵晖,2016-11-13 13:25:14,1,3,2,超级棒！！！老师很渊博，人很好！
36440,1546,赵晖,2016-11-13 13:46:46,2,3,1,风俗幽默，能把历史讲的这么有意思，让我后悔高中报理科，也就是赵老师了
38107,1546,赵晖,2016-11-24 08:35:03,17,19,2,太可怕了，我已经中毒了，大学四年近代史纲听了三次，外交史听了两次，毕业了还去慕课找了老师的视频，恳求大家拍一些他课上的视频分享一下，万谢！
38552,1546,赵晖,2016-12-08 10:28:14,0,2,2,好老师！！！
39079,1546,赵晖,2016-12-21 04:09:03,1,2,1,百家讲坛
39222,1546,赵晖,2016-12-21 15:49:08,-1,1,2,大一遇上的最好的老师！
39313,1546,赵晖,2016-12-22 05:07:49,1,1,0,听完老师的课，想转历史系了
39431,1546,赵晖,2016-12-22 15:49:30,1,1,0,听课就像听故事一样，很幽默；很佩服老师的学识
39817,1546,赵晖,2016-12-28 01:26:15,2,3,1,我又选了他的现代中外关系，还有他别的课吗，还想继续上他的课
39989,1546,赵晖,2016-12-28 12:41:58,0,2,2,感觉听他的课就是一种享受！！！完全被他折服，作业再多都甘心
40212,1546,赵晖,2016-12-30 04:55:57,2,3,1,课讲得超级好，史纲课强推赵晖！
40286,1546,赵晖,2017-01-01 07:52:09,0,2,2,赵晖老师对历史的负责任的态度和历史真实的执着以及他为人的胸襟是我最为钦佩的
40336,1546,赵晖,2017-01-03 03:27:50,2,4,2,每堂课结束时都掌声雷动，没有其它的老师了吧…
40750,1546,赵晖,2017-01-05 08:19:53,0,1,1,中国近现代史纲要： 老师很好，讲课也很好，对留学生很好，很关心。给分也很好!!
40925,1546,赵晖,2017-01-06 12:39:52,1,1,0,工科出身 因为热爱阅读与历史转去学历史 不仅收获了知识 更感受到赵晖老师人格魅力 绝对男神
41056,1546,赵晖,2017-01-09 01:52:33,3,3,0,得师如此 生复何求?
41419,1546,赵晖,2017-01-11 11:47:15,1,2,1,非常好！
41583,1546,赵晖,2017-02-28 10:29:56,2,2,0,棒极了
41601,1546,赵晖,2017-01-12 08:43:37,1,3,2,最震撼的就是 每一次下课都 掌声雷鸣
41614,1546,赵晖,2017-01-12 09:07:06,1,3,2,听课是一种享受0.0
41621,1546,赵晖,2017-01-12 09:12:21,0,3,3,后悔没好好听他的课了
44797,1546,赵晖,2017-01-18 09:10:29,8,9,1,浙大现场版百家讲坛！！！每次想水水过，做点别的事情，最后总是被老师精彩的讲课吸引，真的，老师的课特别有趣，涨姿势！不过，不要再抱着应试教育的那一套，老师讲的内容，考试基本都不会考，所以上老师的课，记得收起自己的功利心，只是为了涨姿势，为了增长历史知识，就会感到很有收获！
45330,1546,赵晖,2017-01-19 11:05:50,1,2,1,老师真的很好！虽然我只是上通识课，但是几乎每节课都会被老师的幽默风趣吸引得认真听课，真的可以学到东西。不过论文和讨论课对于我一个纯种工科狗来说难度有点大，即使最后得分不是很好，我也觉得上得值得，希望还有机会听老师的课。
46104,1546,赵晖,2017-01-20 15:14:19,-15,6,21,给分哪里好了，期末选择题简直了
46109,1546,赵晖,2017-01-20 15:19:15,3,5,2,老师上课绝对好评。。。但是付出与回报不成正比。给平时水水过的成绩差的调了分。苦了平时不突出但努力的人和他们同样的绩点
46669,1546,赵晖,2017-01-22 06:06:56,2,3,1,好老师，上课超级棒
48037,1546,赵晖,2017-02-28 06:02:12,4,4,0,上课绝对是百家讲坛现场版，平时有一次展示两次讨论课
48558,1546,赵晖,2017-03-07 07:45:25,1,2,1,讲课真的深刻，而且不是党课
48574,1546,赵晖,2017-03-07 14:15:15,-1,1,2,第一堂课就被老师的讲课风格吸引了，崇拜老师！
49393,1546,赵晖,2017-04-10 06:01:18,-42,9,51,感觉吹捧过盛，言过其实
49616,1546,赵晖,2017-04-20 09:57:22,6,6,0,男神！！讲得好，温和
51471,1546,赵晖,2017-06-06 06:41:52,10,10,0,带我们走向光明道路
52166,1546,赵晖,2017-06-15 09:10:08,2,2,0,上课很好听 跟说书一样 可惜我基础太差 听过就忘了qwq
52312,1546,赵晖,2017-06-18 08:28:37,0,1,1,
52653,1546,赵晖,2017-06-22 03:16:09,3,6,3,老师上课太有感觉了，一种听百家讲坛的体验。期末论文写了9000来字(别担心，要求只要3000，我只是刹不住车)，差点走火入魔，一度怀疑自己对历史的热情是不是超过自己的专业。
53453,1546,赵晖,2017-06-26 15:44:07,2,3,1,绝对的业界良心\n\n
53461,1546,赵晖,2017-06-26 16:05:38,24,24,0,作为一名理科生去听赵晖老师的课最大的收获是学会怎么去客观地看待历史与扎实地分析问题。\n\n原来一直以为所谓的近现代史是教一些歌功颂德的东西。但赵晖老师也讲我们民族过去的苦难、我们党的光辉与历史选择。但是却是从更加全面的角度去分析，而不是停留在书本中几句简单的中流砥柱开天辟地之类的话。老师会让我们去读很多本关于同一历史主题的书，从不同的角度，从外国，大陆，港澳台多个视角去还原历史去展现历史的原貌，让我们明白什么才叫真的客观。同时他也会以自己的研究告诉我们研究不是路边的地毯文学也不是朋友圈里的文章，而是一个讲究证据实事求是的学科，绝不是根据流言蜚语就能胡编乱造。老师上课讲究同学的参与，研讨课和展示课尽管有些繁琐但能让人收获良多，特别是穿越主题的展示让我们带入一个历史的大背景下去思考问题做出选择，让我们更加理性地去看带一个人。老师讲课颇有百讲讲坛之风，录成mooc肯定能成为网红?。
53583,1546,赵晖,2017-06-27 05:20:24,2,3,1,博学多闻，待人亲和
54036,1546,赵晖,2017-06-28 09:36:54,4,4,0,很爽的上课体验，真心推荐这老师贼棒的
54875,1546,赵晖,2017-06-30 11:02:57,1,2,1,可爱的大象
56558,1546,赵晖,2017-07-04 03:34:44,11,11,0,讲课好，给分好哭。史纲这种本来应该又红又专的课，讲成了让我上课从不水手机，还想再听一遍的课。无比庆幸退掉了预制换了老师的课，感动哭。
56816,1546,赵晖,2017-07-04 16:19:44,4,5,1,上的现代中外关系 课非常有趣 赵老师在客观和细节上做的非常好 但这种分组给分制度真的很恶心 确实有些人是值得打高平时分的 但某些组长的给分分配就很黑 而且大多情况下机会不均等 可能老师并不知道 学生提的问题是内通的 分配给分看似非常公允 其实也根本不是同台竞技 还有互评其实感觉也没多大必要 事情多了点但其实也无所谓 历史类的东西看起来还是有趣的 一学期下来给我的感觉就是课很好 但不如旁听
57109,1546,赵晖,2017-07-05 14:17:58,9,11,2,其实分数包给分还是很好很公平的。之前上过一门所有组员展示分相同的通识课，根本调动不起来组员的参与热情，都在划水，组织个讨论也没人来。赵老师的给分机制起码可以多劳多得，给那些付出多的人相对公平的待遇。
57111,1546,赵晖,2017-07-05 14:24:11,1,2,1,老师真的好啊
57338,1546,赵晖,2017-07-06 23:42:14,3,3,0,讲得精彩，老师紧跟潮流，时常冒出几个流行词。就是任务真的真的很重。
57479,1546,赵晖,2017-07-08 13:01:04,2,2,0,非常棒，讲课生动，给分好。我上课根本就不想玩手机，实在是太有意思了
57865,1546,赵晖,2017-07-16 11:45:04,5,6,1,上课认真听，及时做好笔记；写一篇论文肯定需要有一定论文的阅读量，及时做好准备。
58549,1546,赵晖,2017-09-02 02:07:57,8,8,0,让我知道了我这种历史票友和真正的历史学者的差距，也让我知道了历史学者更有一份和历史票友一样的热爱和真心
58660,1546,赵晖,2017-09-13 02:41:13,6,7,1,上个学期上了老师的通识课，虽然自己并不是历史爱好者，还只是个历史渣渣，课程的任务是比较多，但是也因为这些阅读的任务了解了很多东西（有些论文不怎么看得懂）老师上课也超棒的，每一次课都讲得让人放下手机放下作业，积极参与组内的事情，好好写论文的话，分数不会差的。想水水过的还是慎选吧|дﾟ)没时间但是想上课的建议来蹭课！
59391,1546,赵晖,2017-09-21 06:11:22,1,2,1,表示给分复杂
59819,1546,赵晖,2017-09-27 07:36:59,2,2,0,酷毙了
60168,1546,赵晖,2017-10-12 05:18:12,0,1,1,好老师
60233,1546,赵晖,2017-10-15 03:51:55,3,4,1,听了党课五体投地
60237,1546,赵晖,2017-10-15 08:34:32,2,3,1,论享受二字如何写
60247,1546,赵晖,2017-10-15 12:54:53,3,3,0,两个字：享受
60609,1546,赵晖,2017-10-25 07:19:47,0,2,2,一切尽在不言中
60632,1546,赵晖,2017-10-25 13:23:03,3,3,0,有一种被带入他的故事中的感觉，改变了我对历史教学方法的认知。
60698,1546,赵晖,2017-10-27 03:16:23,1,3,2,超好的老师 听他的课就是享受
61812,1546,赵晖,2017-11-21 05:30:11,3,4,1,日常10分\n\n
61820,1546,赵晖,2017-11-21 06:14:32,1,3,2,一位真正的历史老师，身上的儒雅与大气令人钦佩！
62941,1546,赵晖,2017-11-27 11:49:21,2,2,0,儒雅风度，完美的老师
63153,1546,赵晖,2017-11-28 16:20:26,8,9,1,两个字，男神！\n\n一个下课必定有掌声的老师！\n\n从来没有遇到过这样学识渊博的老师，每节史纲课我都会坐在第一排超认真地听！\n\n想说很多又不知道怎么表达……大概只能用男神两个字概括了吧！！
63498,1546,赵晖,2017-12-05 08:44:42,1,1,0,好好好
63557,1546,赵晖,2017-12-28 22:48:00,27,28,1,好的，那么我们今天就先到这里。忘不了这句超有感觉的课堂结束语，一想到以后没那么幸运能继续听赵老师的课，忍不住有点忧伤
63573,1546,赵晖,2017-12-07 05:38:57,2,2,0,超棒的老师
63773,1546,赵晖,2017-12-14 12:45:29,4,4,0,从未有老师像他这样，明明我想窝在后排补作业，还是忍不住听他讲～
64187,1546,赵晖,2017-12-21 08:41:08,2,3,1,多帅哦 讲的好的不提了
64339,1546,赵晖,2017-12-22 14:20:47,0,3,3,男神！人特别好，特别能讲，希望我自己上课不要那么尴尬……作为一个忘记了大部分历史知识的正宗文科生，还是男神史纲班上唯一一个人文的学生……但是男神很包容我了……希望绩点能高叭。
64464,1546,赵晖,2017-12-24 07:39:09,4,6,2,博古通今，缺一次课都是错误
64474,1546,赵晖,2017-12-24 10:30:11,1,2,1,现场版百家讲坛\n\n
64490,1546,赵晖,2017-12-24 13:36:34,4,4,0,赵老师人很好，很喜欢对视，平易近人，很有知识的一位老师，真的很喜欢很喜欢这位老师！
64547,1546,赵晖,2017-12-25 06:09:32,2,3,1,美滋滋\n\n
64843,1546,赵晖,2017-12-27 11:39:59,4,4,0,我想中国共产党你们都很熟悉了……\n\n其实，我觉得吧……
64903,1546,赵晖,2017-12-28 01:56:41,1,2,1,太酷了
65011,1546,赵晖,2018-01-12 00:04:33,9,9,0,男神真的是男神，知识，学术修养，人品方面无论哪一个都能被称之为男神！！！
65100,1546,赵晖,2017-12-29 00:40:55,3,4,1,如沐春风，超级享受
65221,1546,赵晖,2018-01-01 08:41:12,3,3,0,本来想在课上做作业，结果不知不觉听了一节课，讲课超好。
66042,1546,赵晖,2018-01-11 06:53:51,7,8,1,真正有意义的课堂！魅力惊人的老师！还有就是长得好像《飞屋坏游记》的那个老头，233
66052,1546,赵晖,2018-01-11 07:39:46,3,3,0,超级棒真的
66054,1546,赵晖,2018-01-11 07:44:18,2,2,0,老师非常棒，每个历史人物都记得清清楚楚，最后一节课非常不舍得老师，讲的故事非常有趣，就是给分机制有点复杂…
66157,1546,赵晖,2018-01-12 07:59:06,0,2,2,深厚的学术素养，独特的课堂体验。\n\n讲很多很多历史，听了之后觉得自己一无所知。\n\n论文要求很高，但是在写论文的过程中能积累很多知识。
66253,1546,赵晖,2018-01-14 06:31:34,1,2,1,每一节课都认认真真听完的现代中外关系，真的学到了很多东西，课程论文要求比较高，但可以说是这几年写过论文里最有用最满意的了
66420,1546,赵晖,2018-01-16 07:45:48,4,5,1,选错通识课 对内容不感兴趣 老师是好 论文写得难受呀
66581,1546,赵晖,2018-01-17 11:12:31,2,2,0,真的好
66822,1546,赵晖,2018-01-19 07:19:41,2,3,1,好老师，好课，成绩不重要了…来自工科生
67027,1546,赵晖,2018-01-20 04:41:05,0,1,1,后悔没有好好听老师的课，最棒的老师之一！
67342,1546,赵晖,2018-01-21 01:19:43,6,7,1,老师太棒了 还有五分钟就要考试了 希望老师保佑我
67382,1546,赵晖,2018-01-21 05:05:48,10,10,0,记得做研究性论文向老师借书，最后他很耐心的给了我一大串地址（去他家的路线），瞬间被老师感动到爆炸，上老师的课，有些东西还要靠自己争取的，让我一个看到历史就头疼的人都心甘情愿作报告，不管最后怎么样，平心而论，我给10分。
67846,1546,赵晖,2018-01-22 08:13:15,5,5,0,超级棒！！！果然名不虚传，百家讲坛即视感，第一次听到这么风趣幽默的历史课！
68036,1546,赵晖,2018-01-22 13:46:09,5,6,1,好好听课了，好老师真的，人生导师，绩点不重要，好老师，人生导师！！！\n\n史纲考试很迷
68714,1546,赵晖,2018-01-23 15:55:30,5,5,0,十几年来，，第一次不觉得历史课枯燥，，第一次认真听过历史课
69277,1546,赵晖,2018-01-24 11:50:45,1,1,0,绝对的好老师，但是事情真的不算少（如果你要拿高分的话），我对历史一点也不感兴趣，但感觉还是收获很多。悄咪咪地说、要当课代表或者组长
69789,1546,赵晖,2018-01-25 11:45:45,2,4,2,好老师，讲得好，但事情多，想拿高分不容易，要做很多事情。当课代表和组长拿高分会容易很多
70575,1546,赵晖,2018-01-27 08:48:13,0,2,2,非常棒
71124,1546,赵晖,2018-01-28 03:44:16,1,2,1,极好的老师
71155,1546,赵晖,2018-01-28 05:01:23,3,4,1,现代中外关系这门课，老师上课超有趣，而且老师学术知识很渊博，各种历史人物事件随手拈来，能学到非常多的东西。平时也没有什么事，一次小组展示一篇书评一篇期末论文，给分很好。很棒的老师，很棒的课程！
71273,1546,赵晖,2018-01-28 08:28:48,1,2,1,男神！上课超有趣！
71357,1546,赵晖,2018-01-28 10:46:08,12,12,0,百家讲坛！老师人博学 记忆力极好！！！讲课思路超级清晰 而且中气十足声如洪钟！！！根本不需要麦克风好吗！！！还会跟学生眼神互动！！！上赵老师的课划水都是觉得是罪恶！
71384,1546,赵晖,2018-01-28 11:23:00,13,13,0,老师上课很精彩，老师好，但是分数包机制如果你的组长不要脸就没办法。
72029,1546,赵晖,2018-01-29 08:36:07,2,3,1,这学期上了老师的现代中外关系，听老师上课真的很享受，娓娓道来，有种在听百家讲坛的感觉。最感动的是临近期末把论文发给老师希望得到建议，老师非常认真地和我通了电话，给了我很多的建议。真的是很负责任的老师，通过这门课程真的能够学到很多。非常感谢老师啦。
72176,1546,赵晖,2018-01-29 13:56:27,1,4,3,大学第一门满绩!给分真的很好，事情稍微多一些，但是很有趣
72395,1546,赵晖,2018-01-30 05:06:29,3,3,0,非常棒的一位老师，对20世纪以来的中国对外关系有较深入的研究，是少数讲课不会让我睡着的老师之一。老师同时也非常注重学术的严谨性，期末论文的要求还是很高的，我也从中学会了很多查找文献、参考文献的方法，受益颇丰！
72396,1546,赵晖,2018-01-30 05:07:32,3,8,5,课讲的挺好，给分一般，不是组长和课代表，4.2
72403,1546,赵晖,2018-01-30 05:19:42,7,8,1,老师好，讲得真心不错?佩服老师能记怎么多，讲得时候也与流行文化结合，那么今天我们就讲到到这里...从此走上了光明的道路...晓以大义...在qq群里还会和我聊金庸和股票哦...唯一不足事多分数少
72458,1546,赵晖,2018-01-30 07:07:40,2,2,0,超棒的老师，知识超级渊博，上课和听百家讲坛一样。给分会根据平时的小组展示，讨论课，小组论文来评定，超级公正公开，最后给分也很好!
72589,1546,赵晖,2018-01-30 12:52:48,4,4,0,课讲的超级无敌宇宙第一棒，我一个工科学生都听的入迷，就好像听百家讲坛一样，然后给分也不错。很好，很和蔼的一个老师。
72641,1546,赵晖,2018-01-30 15:07:36,4,5,1,就给分超级棒了 上课特别有意思也能学到很多 后悔没仔细听 论文只要认真就ok 就是课代表不喜欢
73763,1546,赵晖,2018-02-03 05:14:31,3,4,1,老师对同学十分热心，提的问题都认真回复，有次凌晨还在回复群里提的问题，真的是非常负责。课堂就更不用说了，个人觉得比百家讲坛还要精彩。有的评论说绩点不太友好，个人觉得可能是作业要求比较高，但你只要按要求认真做，绝对是有回报的，不想某些随缘水课（不吐槽了）。总之强烈推荐！
74763,1546,赵晖,2018-03-05 23:38:41,3,4,1,百家讲坛式的课堂，对历史感兴趣的小伙伴一定很喜欢，我这种对历史一点也不了解的人，就只能听听过把瘾了。会有两次讨论课，一次展示课。
74891,1546,赵晖,2018-03-06 09:24:11,6,6,0,老师多开几门课可好？有空定再听一遍现代中外关系和史纲！
75152,1546,赵晖,2018-03-07 14:33:33,4,8,4,老师人真的很棒，但是想拿高分会很难，不知道大家对通识的要求是什么，如果下四就接受不了的慎选，真想听课可以来旁听\n\n
75334,1546,赵晖,2018-03-09 03:38:54,9,9,0,只有四个字可以评价:\n\n百家讲坛
75836,1546,赵晖,2018-03-19 13:16:09,2,3,1,超级赞的老师，虽然平常任务还是蛮多的，但用心做真的很有收获，一个学期上下来居然如此怀念，给分也是超级好的。
78296,1546,赵晖,2018-05-10 13:14:25,0,1,1,很好的一个老师?‍?
78784,1546,赵晖,2018-05-15 07:04:12,1,2,1,百家讲坛
79381,1546,赵晖,2018-06-02 02:33:58,1,3,2,能听满三节不瞌睡的课
79389,1546,赵晖,2018-06-03 03:46:50,2,3,1,妈妈问我为什么跪着听课系列！
79769,1546,赵晖,2018-06-13 11:43:27,27,27,0,赵晖的史纲课是大一期间最喜欢的课堂了，比百家讲坛实际还要有个人特色，时常融入流行词汇，伴随微笑和眼神交流。老师本人就超能讲，问他问题时就开启讲故事模式。非常负责，写论文时老师甚至愿意电话交流，推荐书目等等。但是，非常建议那些会在赵晖课上经常水其他作业，甚至不来上课的同学不要选赵晖的史纲课，实在是浪费了这样美妙的课堂！何况事情还是较多的，而且小组分数包分数分配不公的情况也时有发生。不对课堂有要求的同学，建议把机会留给其他同学。分数还早，先给老师打个满分。真想打十一分啊。
80028,1546,赵晖,2018-06-19 05:21:03,2,3,1,老师对我来说就是神一样的存在，太厉害了，厉害得有点过头
80166,1546,赵晖,2018-06-21 02:16:28,31,34,3,喜欢水通识课的同学不要占用其他真想听的同学的名额，真的。
80752,1546,赵晖,2018-06-30 10:32:24,-1,6,7,课讲得不错，但给分机制很不好，让同学和助教打分的占比占到了70%，很容易出现不客观的给分情况。希望赵晖老师可以改进一下。
82025,1546,赵晖,2018-07-07 01:47:59,1,2,1,唉，本学期的百家讲坛又结束了。
82347,1546,赵晖,2018-07-08 03:03:04,0,0,0,真的很棒，但有几节课忙着做自己的作业没有听进去感觉很可惜。
83976,1546,赵晖,2018-07-11 15:49:11,2,2,0,讲的好，小组坑，有点遗憾了。
84427,1546,赵晖,2018-07-12 23:27:53,5,5,0,史纲是赵老师，念念不忘要再选一次老师的课，大二终成所愿。能上老师的课，是一辈子的荣幸了。
84673,1546,赵晖,2018-07-13 13:11:38,-2,0,2,
84999,1546,赵晖,2018-12-13 15:45:35,0,0,0,真的很棒，说实话一开始我是做自己东西的，后来因为讲的太有趣连听三节课都不会想要碰手机。给分也挺好，平时分机制有点复杂，而且一半看小组分配。老师幽默风趣，亲切和蔼。
85146,1546,赵晖,2018-07-15 23:10:26,2,2,0,虽然很不想给分之后再评论 但..但是这给分也太好了叭！感觉被老师拉了一把 生生高了一档 简直空前绝后..我觉得老师的评分机制虽然复杂 但是合理 很抱歉我并没有每节课都在好好听 后面开始做自己的事情了..但老师讲的是真的好 老师本身也特别渊博 有一次在校外遇到了老师 在过马路等红绿灯 老师拿着一本书低头在看 而且除了上课内容 我觉得通过小组任务我也学到了很多东西 虽然事情还是有点多的 但是作为一个理科生 我这学期真的学到了处理文献材料的能力吧..组长也很公平 真的很开心了！是分数最高的思政课..
85155,1546,赵晖,2018-07-16 00:29:20,3,3,0,超棒啊啊啊啊！当时百家讲坛结束的时候真的超级不舍啊T_T 下学期有机会还要去蹭赵老师的课。
85170,1546,赵晖,2018-07-16 01:27:10,1,2,1,选上老师的课真是太幸运了+太幸福了！
85381,1546,赵晖,2018-07-20 09:47:30,3,5,2,老师讲的还不错，另外千万要注意给分权绝大部分不在老师手中，千万注意！
85435,1546,赵晖,2018-07-18 00:40:53,-7,13,20,把赵晖吹得太神了吧~讲课是不错，学识也是真渊博，但思想上我觉得比起有些文科老师还有一定差距，没有让人非常受启发的感觉，但是还是会去忍不住听课的。最大的问题是事情太多，给分太细，保留小数点后两位，如果有能力建议当组长把分配权掌握在自己手里！另外论文虽然只占二十分但还是要重视，最好能抱到大腿。
86536,1546,赵晖,2018-09-17 05:23:11,-1,2,3,最好的老师，但是机制太复杂\n\n\n\n\n\n\n\n\n\n\n\n\n\n\n\n\n\n
88722,1546,赵晖,2018-11-06 12:37:36,3,3,0,你们绝对想不到老师本科学的是工科。然后讲历史却普通谈家常一样，太厉害了
89488,1546,赵晖,2018-11-19 10:02:11,0,2,2,10分!!真的不能再低了，虽然不点名，但是逃他的课真的是一种浪费!!他的课太幽默风趣了，总是能把原本看起来枯燥无味的历史讲的那么生动!听他的课真的有一种听百家讲坛的感觉!!
89516,1546,赵晖,2018-12-09 15:06:13,0,0,0,炒鸡棒！！1
90064,1546,赵晖,2018-11-22 04:27:40,-1,0,1,老师不仅十分幽默，上课还可以学到很多的历史知识，对一些历史人物的看法也有所改观
91306,1546,赵晖,2018-12-13 15:46:08,1,1,0,老师真的很厉害，让你心服口服，很幽默，很亲和，史料等等信手拈来
91399,1546,赵晖,2018-12-08 06:23:21,-21,10,31,"傻逼老师(﹁""﹁)"
91544,1546,赵晖,2018-12-13 02:35:11,-16,10,26,垃圾老师
91924,1546,赵晖,2018-12-25 03:08:19,0,1,1,真正意义上的历史老师
91937,1546,赵晖,2018-12-25 04:35:46,1,2,1,上课的时候突然被盯还是有一点紧张的...
92091,1546,赵晖,2018-12-26 09:16:44,-1,1,2,老师课上的很好呀，只是每次他等人提问题没人举手就很心酸。
92220,1546,赵晖,2018-12-27 06:03:19,0,3,3,教你什么叫做历史上最牛的历史老师，什么袁腾飞，还是袁崇焕都是渣渣
92389,1546,赵晖,2018-12-28 07:51:19,1,2,1,老师的确给分机制的确负责，但那是为了增强学生的参与度，避免划水的人混个高绩点，我觉得是很有道理的。老师上课讲的真的是很有意思，改变了我之前的一些不那么正确的观念。
92731,1546,赵晖,2019-01-04 04:25:57,0,0,0,绝妙啊，都舍不得离开老师，虽然人物形式多样，给分机制也很复杂，但绝对是一门你听完之后无论得几分都觉得值的课，讲的太好了
92790,1546,赵晖,2019-01-04 12:22:35,1,2,1,我遇到的最好的老师！
93008,1546,赵晖,2019-01-07 01:46:53,1,1,0,还能说啥，给赵老师满上！
93238,1546,赵晖,2019-01-27 12:52:05,-27,6,33,真的狗屎
93563,1546,赵晖,2019-01-10 11:45:43,-1,0,1,不多说，给男神打10分就完事了
93639,1546,赵晖,2019-01-11 04:12:45,0,0,0,有情怀的好老师
93931,1546,赵晖,2019-01-14 10:51:08,0,0,0,上课就是一种享受
94023,1546,赵晖,2019-01-15 05:20:15,1,1,0,简直是……巨好巨好巨巨巨好
94133,1546,赵晖,2019-01-15 09:04:22,-1,0,1,我还想再上一次老师的课！！！
95072,1546,赵晖,2019-01-18 16:10:25,0,1,1,老师真的太太太负责了！我上完他的史纲特别鸡血地签了他的通识课的条子，史纲讲的人很多了我就讲下通识课⑧，我上的是上个春夏的（还没改成3分），事情真的有点多，但是看你想不想水了，我觉得我学到了很多很多，特别是最后那篇3000+的论文，虽然老师的要求挺高的，写的过程好点痛苦，但那篇论文确确实实是我最最有收获的一篇论文。老师还问我是否方便打电话，特别特别负责，给我思路的启发（因为之前有问他不知道怎么写），还给我发了很多资料555。论文写了3礼拜学得比专业课还认真_(:з」∠)_。想水的同学建议旁听，不过写论文做展示确实受益匪浅。老师讲得多好我就不说了，听了老师的课我对50，60年代中国外交真的有了很大改观！！
95565,1546,赵晖,2019-01-19 15:28:42,0,0,0,极佳的
96267,1546,赵晖,2019-01-20 15:44:34,18,18,0,我们寝室三个人都预置赵晖老师的课，每周三中午不吃饭也要占第一排最中间三个座，赵晖老师肯定对我们三个很有印象（尤其是当他提问时三双透着无知迷茫但勇敢直面凝视的双眼整齐地看向他）哈哈哈哈哈哈真的好爱老师的死亡凝视！他让我真正感受到历史的魅力！明天就要考试了保佑保佑?
96329,1546,赵晖,2019-01-21 00:22:18,1,1,0,老师超有趣，知识储备超级丰富！！！真的棒！听课是一种享受！
97207,1546,赵晖,2019-01-22 00:21:01,2,3,1,百家讲堂啊 锅挺多但是收获也更大 大学历史和高中的真的不一样 老师有好多好多有趣的历史故事而且无缝衔接 真的太厉害了
98042,1546,赵晖,2019-01-23 04:16:43,2,2,0,老师没的说，非常棒!
98306,1546,赵晖,2019-01-23 09:53:25,0,2,2,超好的！讲课很有趣！
98971,1546,赵晖,2019-01-24 06:03:31,1,2,1,每次上完课都掌声雷动，在浙大上过的课里这是唯一一个
100465,1546,赵晖,2019-01-26 07:13:46,1,1,0,赵晖老师真的超级超级好，上课幽默风趣，作业量不大，有付出就有回报，而且给分超级好
100515,1546,赵晖,2019-01-26 08:38:27,-1,1,2,太棒了，讲课比百家讲坛好，老师人很和蔼给分也好
100540,1546,赵晖,2019-01-26 09:15:56,2,2,0,把思政课上成百家讲坛的男人?
100628,1546,赵晖,2019-01-26 12:47:20,0,2,2,不用多说，不上他的课是人生一大损失。
100630,1546,赵晖,2019-01-26 12:50:18,0,0,0,百家讲坛即视感。
100689,1546,赵晖,2019-01-26 14:35:18,2,2,0,老师讲课超级有趣，知识很丰富，也真心希望我们能喜欢他的课～有同学论文没写他就推迟出分让他们补完～给分也很棒，我想再去旁听呜呜呜
100703,1546,赵晖,2019-01-26 15:01:33,4,6,2,老师讲的特别好，简直就是听百家讲坛，但是组长给分的话，emmm，有点看个人关系的感觉，不想说什么。
100846,1546,赵晖,2019-01-27 02:49:53,107,114,7,很遗憾，这里只能打10分，不能打100分，1000分\n\n讲课如百家讲坛这就不必再提了\n\n作为一名混合班的学生，我和另外两个同学犯了一个愚蠢的错误，一篇占平时成绩25/100的论文，我们因为理解错误根本没有写。我想大多数老师，都会让我们直接挂科，然后退院。但是赵晖老师，主动来找我们，抢救我们的分数，为了我们三个后进生，晚了两天出分，让我们补写论文，并且根据我们的论文质量给了我们那篇不长的一个公正合理的分数。\n\n教育的本质是一个灵魂唤醒另一个灵魂。赵老师的学识让我们钦佩不已，他的人品和对学生的理解与耐心教会了我们更多。\n\n如果我是一位老师，我是否会为了这样三个后进生，反复推迟我的安排？是否会理解学生因非主修课挂科退院的痛苦？我很惭愧，经历这件事之前，我多半不能像赵晖老师做的那样好。\n\n但经历了这件事，我的一些想法也变得不太一样了。可能有些矫情，但赵晖老师真的做到了上段的第一句话，可能只是在无意之中。\n\n
100888,1546,赵晖,2019-01-27 04:23:30,0,2,2,对你们的善良是对他人的不公正
101025,1546,赵晖,2019-01-27 09:26:19,1,1,0,作为一名文科生，每堂课都听的津津有味，给分也好，真·历史男神！
101174,1546,赵晖,2019-01-28 01:08:20,1,1,0,赵老师的课非常值得听，博古通今！
101370,1546,赵晖,2019-01-28 05:59:59,4,5,1,每节课都坐在最前排直接面对老师的位置的我有资格说：“赵老师的课坐在后面真的是吃大亏！！”
101398,1546,赵晖,2019-01-28 06:45:45,-1,0,1,非常好
101454,1546,赵晖,2019-01-28 08:28:07,3,4,1,选上就偷着笑吧，无懈可击！
101760,1546,赵晖,2019-01-29 04:10:54,-18,4,22,绩点超乎意料啊啊啊4.5我要去跳启真湖了
101860,1546,赵晖,2019-01-29 09:47:59,0,0,0,百家讲坛现场！
102323,1546,赵晖,2019-02-01 02:09:51,1,2,1,事情多但也好水。老师真的讲的太棒了！
102730,1546,赵晖,2019-02-22 04:01:56,10,12,2,老师讲课讲得特别棒！但是要做的事太多了。每次让组长分配分数包，导致组里恶竞挺严重的，心很累……
102851,1546,赵晖,2019-02-24 06:57:14,7,8,1,竟然第三轮选课能选上这门课，积德了。
103129,1546,赵晖,2019-02-26 05:56:55,0,1,1,简直太棒了啊
103697,1546,赵晖,2019-03-04 08:42:00,1,3,2,男神好嘛！
103821,1546,赵晖,2019-03-06 05:21:10,3,4,1,18级大一一位听过一节课的学生前来报到，吹爆赵老师，原因我不解释，听一节课就知道了啊！！！
105141,1546,赵晖,2019-04-04 09:03:35,14,14,0,百家讲坛现场版，事情多，要水请抱好大腿。
107906,1546,赵晖,2019-05-22 15:21:26,18,18,0,什么问题才能难倒赵老师?
108679,1546,赵晖,2019-05-31 05:08:41,1,2,1,好老师！好老师！
108746,1546,赵晖,2019-06-01 08:34:09,2,2,0,厉害了
108763,1546,赵晖,2019-06-01 14:19:58,-1,1,2,给分好\n\n任务合理\n\n上课有趣\n\n我爱赵晖老师一辈子！对学生超级好！！！
108866,1546,赵晖,2019-06-03 11:08:26,0,1,1,如老师最后一节课所言：希望我讲的，对大家有所启发。
109159,1546,赵晖,2019-06-10 13:38:34,2,2,0,老实人很好，讲课就像百家讲坛
109222,1546,赵晖,2019-06-12 04:29:40,0,1,1,不舍得下课去卫生间，去了就会错过课间众多幽默的史料段子。
109241,1546,赵晖,2019-06-12 07:38:23,0,4,4,私以为诸如“百家讲坛”之类的评价是对史学研究的侮辱和贬低
109533,1546,赵晖,2019-06-16 15:26:41,4,4,0,理科生第一次完全陶醉于通识课
110010,1546,赵晖,2019-07-06 18:16:08,1,4,3,我爱赵老师
110077,1546,赵晖,2019-06-22 07:48:49,12,13,1,“如果这门课能给大家带来一点思考和启发，那我就很满意了。”\n\n打卡赵晖老师史纲课，无论态度还是学识都令人敬佩。\n\n不想说再见。
111134,1546,赵晖,2019-06-30 04:18:01,1,1,0,超级好，收获很大。
113140,1546,赵晖,2019-07-06 00:12:21,1,1,0,虽然平时事不少，但是老师真的超级棒！
113401,1546,赵晖,2019-07-06 16:56:14,2,2,0,老师人超好
113443,1546,赵晖,2019-07-06 17:23:32,-1,2,3,讲的内容确实不错，但是给分... （通识有人挂了）
113542,1546,赵晖,2019-07-06 23:29:27,4,5,1,喜欢他的上课，生动有趣，给分也不错，只要认真写论文，讨论活跃一些，老师会尽力给你高分的
113570,1546,赵晖,2019-07-07 00:11:24,0,2,2,跟着老师上了一年的课，老师超级好，给分也不错
113666,1546,赵晖,2019-07-07 02:43:34,3,3,0,，。，
113761,1546,赵晖,2019-07-07 09:54:58,2,3,1,很喜欢老师的现代中外关系，给老师10分。
113774,1546,赵晖,2019-07-07 11:50:12,0,2,2,炒鸡赞，虽然最后分....但上课还是学到很多！
113957,1546,赵晖,2019-07-08 02:52:29,15,15,0,能把历史讲得这么好，在浙大应该无出其右。
114082,1546,赵晖,2019-07-08 18:30:30,5,5,0,老师超级好！这学期同时上了老师的史纲和中外关系，emm虽然老师是公认的讲得超级好但我也常常听不太进去，当然是我的原因啦。两门课事都不少，分数包形式比较繁琐和心累，但老师给分还是很不错的，而且有和我们说尽量不卡绩点。老师人很好很好，是真的喜欢历史、研究历史，提供很多电子版参考文献，群里的消息会一条一条看下去、给回复，说话给人感觉特别舒服。今年教务网隔天一点出成绩，老师就在登成绩一天后的凌晨（就是马上可以查到了）提醒我们，真的非常贴心了！
114105,1546,赵晖,2019-07-08 23:18:21,2,3,1,无论从上课，考评方式，还是最终成绩，在赵晖老师班上都能在一定程度上走出思政课的阴霾
114137,1546,赵晖,2019-07-09 00:54:23,1,1,0,想问什么，都能得到解答。
114315,1546,赵晖,2019-07-09 17:53:43,0,1,1,真好
114701,1546,赵晖,2019-07-11 04:20:09,1,3,2,比张某程不知道高到哪里去了
114706,1546,赵晖,2019-07-11 04:30:47,3,4,1,赵晖老师讲课水平没得说，即使是我这样下午的课必犯困的人，上老师的课也能在无手机辅助情况下清醒续航三节课，老师真的nb。而且专业知识非常扎实，甚至怀疑近代史里没有他不知道的事和不认识的人，不管怎么提问都能回答一二，这是开了上帝视角吗。
114762,1546,赵晖,2019-07-11 12:00:19,2,2,0,有人说他事情多，但我觉得也还好，特别是我们交上去的作业也都有认真反馈，作业感觉也还是比较有趣或者有意思的。最重要的是上课实在太好了，感觉就算作业多一倍也是值得的，能够听到这样的课
114813,1546,赵晖,2019-07-12 00:22:25,-1,2,3,能够听赵老师的课实在是一种幸运！
115047,1546,赵晖,2019-07-15 00:41:17,3,5,2,男神！原来一个人可以博学至此又兼具风趣，原来历史可以这么好玩（来自一个纯理科生的惊叹❗️
115118,1546,赵晖,2019-07-16 00:14:39,3,4,1,水平超高
115338,1546,赵晖,2019-07-19 01:37:49,4,4,0,感觉赵老师每个历史事件都记得非常清楚，就算是同学偶然问到的一个事件都能准确地回答，太厉害了！
115908,1546,赵晖,2019-08-25 08:45:34,4,4,0,课讲得有多好大家都夸了。\n\n说话带参考文献，大概这就是求是吧。
116240,1546,赵晖,2019-09-06 13:17:07,0,0,0,223
116419,1546,赵晖,2019-09-10 06:33:19,5,6,1,感觉事情有点多……
116488,1546,赵晖,2019-09-11 02:10:52,1,2,1,经常看到不认识的校外的叔叔偷偷溜进来听老师讲课
116638,1546,赵晖,2019-09-12 06:11:51,5,5,0,现场版百家讲坛，人也很好。但是给分机制有点复杂\n\n
116655,1546,赵晖,2019-09-12 09:26:11,1,2,1,太好了！百家讲坛一班的课
116696,1546,赵晖,2019-09-13 11:39:06,2,2,0,真的很好，很久没有这样的感觉了。
116704,1546,赵晖,2019-09-13 15:29:31,0,1,1,爽到爆
116995,1546,赵晖,2019-09-18 05:12:21,2,2,0,非常棒
117328,1546,赵晖,2019-09-23 03:24:28,1,1,0,tsl
117461,1546,赵晖,2019-09-24 18:24:38,-1,1,2,非常好
117856,1546,赵晖,2019-10-06 06:25:37,5,7,2,喜欢直视你的眼睛?
117867,1546,赵晖,2019-10-06 14:11:28,0,2,2,很有趣
118000,1546,赵晖,2019-10-18 03:25:56,0,1,1,绝妙。
118072,1546,赵晖,2019-10-20 08:48:12,3,4,1,就好像说书人给观众细述历史上的奇闻趣事
118212,1546,赵晖,2019-10-23 05:45:54,1,3,2,让人爱上历史
120321,1546,赵晖,2019-11-28 10:15:50,1,3,2,每堂课下课会全班鼓掌
120468,1546,赵晖,2019-12-09 04:46:10,0,2,2,舒服！！
120472,1546,赵晖,2019-12-09 05:34:08,1,2,1,超级优秀的一位老师 上课会讲到很多有趣的有关各国领导人的小故事 而且可以感受到老师真的对自己教的这门课相当热爱并且想让我们真正地学到点知识 虽然作为一名大一的文理偏科的理科生完成课程任务很自闭 但本来就是抱着学习的心态才选这门课的而从中确实也学到了很多 所以还是挺开心的 而且就我个人而言其实还收获到了一些无关课堂本身的东西 如果是对历史等等这方面感兴趣的同学强推
120536,1546,赵晖,2020-01-12 08:47:20,2,3,1,有趣，会捞人，唯一不足就是史纲H课任务有点重
120941,1546,赵晖,2020-01-19 00:21:54,-1,2,3,您给分太好了
121131,1546,赵晖,2020-01-19 21:55:52,0,1,1,感想老师！来浙大遇到最好的老师没有之一！
121174,1546,赵晖,2020-01-20 02:37:25,0,1,1,好到无话可说
121180,1546,赵晖,2020-01-20 02:44:27,-2,2,4,老师打分没有4.8
121319,1546,赵晖,2019-12-20 05:45:35,6,6,0,无论史纲还是现代中外关系，总是让人可惜他只有这两门课
121344,1546,赵晖,2019-12-19 01:36:24,1,1,0,可以了解许多知识，上课很有意思
121729,1546,赵晖,2020-01-21 08:50:37,5,6,1,呜呜呜因为我历史能力不强在大家激昂的学习热情中明显感受到了差距，老师的教授很好的，就是如果想水课或者能力实在窒息的差还是慎重一点点吧QAQ（史纲
122058,1546,赵晖,2020-02-08 15:28:33,-22,2,24,水到4.8
122654,1546,赵晖,2020-03-12 07:43:50,3,4,1,老师上的课炒鸡有趣的，知识又很广，很喜欢和同学交流，面对一些复杂历史也能既客观又幽默地娓娓道来，爱了爱了
122740,1546,赵晖,2020-03-27 11:49:37,-1,1,2,真的很好呀
122832,1546,赵晖,2020-04-12 10:39:26,19,21,2,我上学期的课是赵老师教的。这学期我并不是他的学生。面对一个他（可能）已经不认识的普通浙大学生，晚上八点多他亲自打电话过来，为我讲解我在看历史书的时候产生的疑惑…试问天底下有多少人能做到愿意为明确已经不是自己学生的人在课堂外占有自己晚上的休息时间专门打电话（钉钉）来答疑（尤其只是闲暇时间看书产生的问题）？
123699,1546,赵晖,2020-06-11 15:41:54,7,8,1,趁着还没考试，仅凭课程来评价一下。这学期因为疫情的缘故，上的是史纲的网课。这学期的课里，他和周黎明老师是唯二的保持露脸的老师。个人觉得露脸对于史纲和经济法这类偏重于“讲故事”的课有比较好的效果。尽管是网课，老师也会尽可能互动，提一些小的问题等同学回答，可能算是课堂提问的网课版吧，每一章结束会等同学提问。课程方面，上课不无聊，时间足够的情况下，每一个事例都可以引出更多故事，同学们有时候提的一些问题略略偏题了也会顺着讲解一下。\n\n作业方面，两次讨论课（参考前几届，好像是雷打不动的穿越慈禧、陈独秀）、论文、读书报告，讨论课有参考资料，这学期慈禧这个因为一些原因不是讨论课变论文之类的东西了，我用老师给的资料搭的框架，丰富了一下；陈独秀还是讨论课，蛮有意思，类似小辩论吧。论文是从近代的一些事件里找一些角度切入写篇论文。读书报告这学期因为浙江精神不给版权改读博士论文了。\n\n综上，想要认真完成这些，时间是要耗的，如果希望史纲能水一下给其他课程留点时间，那赵老师是不太合适的。历史有点基础，又爱听故事，个人担点任务不太介意的，选赵老师的课是很不错的。\n\n另外插点题外话吧，高中选考了历史，其实被高考弄得对历史有点恶心了，专业又不是历史类的，本来想着史纲像思修那样水水过就好，赵老师的这种讲故事上课方式（没上过其他史纲课，不全面）算是让我又回到刚接触历史，初中高一还不需要因为考试而是因为兴趣背历史的时候，算是因为好玩而学吧。
123933,1546,赵晖,2020-06-17 03:17:13,8,9,1,9.98分就不用我都说了，事情多，给分不一定很好，但分数依然这么高，你可以想象老师是多有魅力了（个人觉得老师是我目前见过的把理性客观与民族情感结合得最好的人了）
124062,1546,赵晖,2020-06-23 03:44:09,8,11,3,史纲：客观地说，如果历史不好并且对历史没太大兴趣并且想水过必修史纲课的同学，没必要选zh。任务虽重，但小组分着干其实还好；重点是平时分计算机制过于复杂（还要精确到小数点后绝了。。。），感觉我和别人做的付出的没有太大区别，不拖ddl认真完成自己的部分，每次在小组里拿小组均分（或略低）的分数，最后平时分在班里就倒数了，也是很无语，还没出分，有丶难受。
124101,1546,赵晖,2020-06-24 01:58:37,2,3,1,趁还没出分来评价一下。老师讲得很好，从他身上真的能看到对历史的温情与敬意，其他的楼下都夸过了hhh只是评分机制确实复杂，组长分配分数包也很难做到客观公正，平时分占比又高，对最终成绩影响应该挺大的...
124514,1546,赵晖,2020-07-02 08:02:34,11,11,0,算分数太复杂，跟其他一些老师形成了两个极端，一种是完全不公布小分数，用脚趾头乱给分的；另一种如赵老师，给分精确到小数点，甚至每个分项的小分数，都精确到小数点；任务很多；上课很不错；最后小组这个事情，我们组的分配挺和谐的，没出什么问题，但是有些队友让我觉得有些严谨过头了，重视课程是好事，过度严谨甚至鹅颈，这就变味了。最后感谢一下老师吧，辛苦了。
124526,1546,赵晖,2020-07-02 10:32:47,-4,5,9,认真是真的 想水别选 组内恶竞 没有给分好这回事 不恶竞别想上4
124549,1546,赵晖,2020-07-02 23:54:02,8,9,1,每次上网课我爸总要端把凳子过来一起听，还和我说他想把这些视频都保存下来…
124597,1546,赵晖,2020-07-03 11:48:56,0,1,1,绩点3路过
125020,1546,赵晖,2020-08-13 07:17:29,6,6,0,讲得很好，老师水平不是一般得高，也非常非常认真，但事情确实非常多，这学期花时间最多的一门课了
125110,1546,赵晖,2020-08-31 14:25:57,3,3,0,没有充足的时间别读H，有的话真的建议听一下，很有收获，平时任务非常重
125776,1546,赵晖,2020-09-14 07:57:51,1,2,1,真 好老师，讲课幽默风趣，事虽多但值，认真做了给分也好，名师风范
125781,1546,赵晖,2020-09-14 08:25:50,0,0,0,赵晖老师nb，话不多说，懂得都懂！
128097,1546,赵晖,2020-12-07 07:22:43,1,2,1,老师很负责，很关心学生
128765,1546,赵晖,2020-12-25 08:04:37,2,4,2,赵晖老师：请听下回分解
129101,1546,赵晖,2020-12-30 06:38:30,-1,2,3,讲的太好了
130058,1546,赵晖,2021-01-16 04:22:57,7,7,0,绝对的好老师！很有礼貌 很尊重和关心学生 我之前对评分细则有一个地方没看懂 钉钉上问了一次 他直接打电话过来帮我解答 期末的时候慕课上有个要讨论区回复的任务我忘了 他也主动来钉钉上提醒 至于课讲得也很好 很有趣 前面有人说他身上有“对历史的温情” 我觉得是概括的极好的 快选 绝对不亏！！！！！！！
130173,1546,赵晖,2021-01-18 11:49:42,5,7,2,啊啊啊啊啊啊老师真的太好了！！！今天最后一次“现代中外关系”课 我提了一个问题，老师觉得没有解答好，刚刚老师直接用钉钉找到我打电话给我解答，啊啊啊啊啊老师回去真的查阅了好多资料，还记住了我的名字（感觉我好像只在讨论课上说了自己的名字？）。宝藏老师 学弟学妹们冲！
130212,1546,赵晖,2021-01-19 04:40:51,9,10,1,赵老师脑子里装下了整个历史！！！
130230,1546,赵晖,2021-01-19 14:17:09,0,2,2,超级超级棒，完全改变了我对历史的印象，听他的课真的没空水，对学生特别特别细心！！
130403,1546,赵晖,2021-01-27 02:57:49,0,1,1,好想再听老师上课呀
131517,1546,赵晖,2021-01-28 00:44:20,1,2,1,老师太强了
131698,1546,赵晖,2021-01-28 13:12:24,3,5,2,喜欢历史、国际政治的选就是了，虽然事情蛮多的，但是终归满绩了
131791,1546,赵晖,2021-01-29 03:38:27,-1,4,5,真想再上赵晖老师的课
131863,1546,赵晖,2021-01-29 07:02:13,-4,1,5,不好，我瞎说的
131888,1546,赵晖,2021-01-29 08:35:50,6,7,1,老师人很好！就是你有任何问题可以在钉钉上找他，他一定会很认真很热心地回复你的好老师！上史纲课很有趣，知识渊博而且给分特别好！小组有dl更能带飞你！讨论课的题目也很有趣。
132332,1546,赵晖,2021-02-01 00:07:01,5,8,3,老师讲课真的很棒，他历史素养超级好，同样的布置出来的作业也更加难一些，有时候觉得作为一节通识课事情未免多而杂了，挺硬核的，很认真干锅，不知道是组长分配问题还是老师问题，最后得分并不好，有点失望
132429,1546,赵晖,2021-02-01 13:23:15,0,1,1,真的很好
132785,1546,赵晖,2021-02-03 14:57:47,0,2,2,听老师讲历史就像听故事，很有趣。自己看史书时常会觉得有些枯燥，但赵老师就是能够把它讲得生动活泼。实在是太佩服了！
132989,1546,赵晖,2021-02-06 01:35:16,0,2,2,准备下学期旁听
133445,1546,赵晖,2021-03-01 01:00:35,4,6,2,超级好的老师，非常关心学生。上课会和你有眼神交流。我一般都坐第一排哈哈哈，一开始有点压力山大后来就觉得挺好。给分特别公平，给分细则很复杂，都是征求学生意见之后定下来的，最终分数完全是看水平和付出的。给分不错。4.8
133533,1546,赵晖,2021-03-02 01:42:58,2,4,2,赵老师真的很好，推荐选课！\n\n不过要认真学习。
133767,1546,赵晖,2021-03-05 02:26:16,1,3,2,老师讲课很幽默！
134234,1546,赵晖,2021-03-20 06:22:47,9,14,5,在发展对象培训班划水，听了一会突然发现是赵辉老师在讲，我该死，赶快好好听
134342,1546,赵晖,2021-03-24 08:31:45,3,12,9,新中国史 老师讲的很好，但希望前排的同学不要老是自以为是，很影响听课体验
134461,1546,赵晖,2021-03-29 10:13:39,-1,1,2,静观其变
135133,1546,赵晖,2021-05-02 10:49:27,6,9,3,男神！男神！男神！浑厚的声音讲起历史来是最好不过，更重要的是知识储备太丰富了，很多历史史料信手拈来，并且还会结合一些年轻人所经历的事情，比如知乎上的钓鱼文也会说。十分不多说了！
135269,1546,赵晖,2021-05-07 08:13:52,-1,3,4,言之有物
135409,1546,赵晖,2021-05-10 02:59:32,10,13,3,老师真的学识渊博，听他上课绝对是一种享受。但是实事求是地说确实事情比较多，给分机制复杂，造成一定程度上的分数局限（毕竟很多项目不可能打满不是？），只想水课拿分的同学还是别选了，把机会留给比较注重课堂质量的同学。
135428,1546,赵晖,2021-05-10 08:08:19,7,12,5,慎选新中国史和现代中外关系，有的同学好不容易选到，一听任务比较重就退课了，这不是浪费教学资源吗？
136818,1546,赵晖,2021-06-25 05:17:55,20,29,9,赵老师是浙大为数不多的真正学者，教会了我真正的历史学者从不会肆意指点江山，而是冷静客观地去剖析每一道历史事实，怀着憧憬看向前方。\n\n老师坚定的政治立场也无愧于一位优秀的共产党员和马克思主义者。较之浙大课堂上某些冠冕堂皇、顶着各种头衔光环，却明里暗里阴阳怪气对党和国家政策恶言中伤的所谓“教授”，赵纲老师才更配的上那些赞美和荣誉。\n\n有机会还会再选老师的通识课的！赵老师有缘再见！
137163,1546,赵晖,2021-07-01 15:02:26,1,4,3,爱了爱了
138899,1546,赵晖,2021-07-11 15:42:54,10,14,4,老师人挺好的，能力不足慎选。
139779,1546,赵晖,2021-07-26 10:04:13,8,10,2,在第一堂课的前半个小时，我就感觉到这个老师绝非等闲之辈【滑稽】\n\n很幸运能选上他的史纲课
140570,1546,赵晖,2021-09-14 02:33:30,4,6,2,讲的真的很好！完全是那种信手拈来有理有据的！
142021,1546,赵晖,2021-11-04 04:51:20,4,7,3,好老师，大师风范
143001,1546,赵晖,2021-11-18 05:46:05,0,2,2,好，很有精神
144441,1546,赵晖,2021-12-21 13:32:06,11,13,2,老师讲得好 讲的贼有趣\n\n\n\n问题就是事情太多···\n\n\n\n1.你是1884年的慈禧，如何让甲午海战中国战胜日本\n\n\n\n2.你是四·一二事变前几个月的陈独秀，你怎么应对四·一二\n\n\n\n3.你是抗美援朝战争前的毛泽东，你会如何打抗美援朝战争？\n\n\n\n小组作业 事情挺多 还有答辩 但是老师超好
144891,1546,赵晖,2021-12-25 13:56:44,0,2,2,讲课一流，原来历史也能这样讲。
144956,1546,赵晖,2021-12-26 04:48:39,-3,3,6,。。。
145511,1546,赵晖,2021-12-30 05:31:11,10,10,0,老师 行\n\n讲课内容 行\n\n任务重 行\n\n小组作业 不行
146279,1546,赵晖,2022-01-06 06:27:44,5,7,2,老师非常博学多闻，很荣幸这学期有两门都是老师的课（现在想想这大概是我这学期最幸运的事了吧），对于各种历史史实信手拈来：名人传记、解密档案，甚至一些穿越小说…同时，老师还特别的开放包容，从来都没有把是否精通历史作为评判的标准，即使你不了解这个历史问题，他也会鼓励你多说一点。上课至今，只觉老师是一个十分温良、敦厚之人，是一个学者，更是一位良师，无愧于每节课后同学们热烈的掌声。
147634,1546,赵晖,2022-01-10 10:44:01,1,3,2,啥都别问，选中外关系，学到很多，给分很好，老师讲的很精彩，都给我选！
147776,1546,赵晖,2022-01-10 22:19:29,2,4,2,老师很好很好，从老师角度出发，很希望选上老师的课；但是从小组作业角度来说，唉，小组作业吧，唉，实在不明白那个组长，没怎么干事情，然后自己的分数最高，分配分数也是自己搞，搞完直接给结果，，，好歹民主投票一下通过你的方案不。于是最后，组长分数好高，大多数组员分数好低，锅也分的离谱，小组作业，唉。
148037,1546,赵晖,2022-01-11 11:30:47,1,3,2,真的很棒的老师 很儒雅很博学很幽默
148245,1546,赵晖,2022-01-12 03:22:21,-1,2,3,老师绝对好
149281,1546,赵晖,2022-01-15 03:52:21,6,8,2,上的是史纲课，出分后来答一波～～\n\n赵老师学养深厚，上课水平绝对一流，哪怕最想摸鱼的同学也会迷上赵老师的课，所以说选上绝对不亏～～\n\n关于考核内容，有30%期末考试分，70%平时分。平时分中课堂展示与提问占20%，小组论文占40%，小组书评占20%，线上发帖占20%，前三项都需要以小组为单位完成，所以建议能者担任组长，分数会很高\n\n我们组就很好，组内每个人平时的贡献都量化，记录在表格里，分工也很合理，小组平均分是最高的————最后28人有里11个人平时分上90（一共才16个人……）\n\n关于考试，基本上考前准备一下就好了，不过批改会很恶心，我们班110个人上80的只有3个人，平均分69…
149428,1546,赵晖,2022-01-15 09:56:43,3,5,2,老师讲得很好，听老师的课是一种享受，可惜下个学期没时间选老师其它的课。绝对值得10分，甚至可以打更高。\n\n作业都以小组为单位，量也不多。但每组的分数和分数分配与组长的关系很大，碰上一个给力的组长，全组分数会普遍较高。所以上赵老师的课，建议积极参与组内事物或争取当组长。（本人仅上过近现代史纲要）
150786,1546,赵晖,2022-02-18 13:41:57,0,4,4,怎么会有这么好的老师？
150961,1546,赵晖,2022-02-21 10:55:08,1,6,5,赵老师是我在cls写的第一个评价，教课风趣幽默，会在下课时候鞠躬“那我们今天 就上到这里”每次听完有一种意犹未尽的感觉。每次讲完一部分会问我们有没有听懂
151566,1546,赵晖,2022-03-08 03:03:50,0,5,5,我谁啊，配评价赵老师
151705,1546,赵晖,2022-03-13 04:41:18,11,13,2,小组作业要吐了
151714,1546,赵晖,2022-03-13 11:12:47,4,5,1,除了分数包不太好，其他都好
152187,1546,赵晖,2022-03-30 00:12:42,1,3,2,如坐春风
153641,1546,赵晖,2022-05-07 01:58:01,14,18,4,每一次点进赵老师的评论区都能回想起上课、课后和老师相处的那种感动。很赞同大家所说的，老师是真正的学者，师德无比高尚。原本设想史纲课是对高中知识的重复，但赵老师讲了很多教科书叙事下真实的历史细节，他的讨论课的形式也锻炼了我们的历史思维。第二个学期我有幸在新中国史作为通识课第一次开课的时候选上了，弥补了史纲对建国后历史较少叙述的空白，写论文的过程虽然非常痛苦，但也是我第一次查地方志，买书写论文，真的非常有成就感。很多很多感激地话已经写信跟老师说了，但还是想跟大家分享一个瞬间：教室的上一堂课还没有下课，我看到赵老师拿出阅读器在读文献，真的感受到了一种校园生活象牙塔般的美好和充盈，祝愿赵老师的学生都能在他的课上和课后学习中享受到历史学习纯粹的快乐！
154535,1546,赵晖,2022-06-02 05:11:57,3,6,3,从来没有听过这么有意思的历史课
155041,1546,赵晖,2022-06-08 00:57:35,9,11,2,必须十分！上赵老师的史纲课，真的是一种享受。百家讲坛一样~\n\n只不过上课有看老师习惯的要慎重！老师只要看到你的眼神就会和你对视，甚至会走到你面前跟你对视。每每此时我就惭愧地低下头遮住我的大英课本...
156498,1546,赵晖,2022-06-20 04:52:42,-1,2,3,男神！
156932,1546,赵晖,2022-06-21 10:58:08,0,3,3,百家讲坛紫金港分坛，来上绝对不亏！
156991,1546,赵晖,2022-06-21 13:18:44,2,6,4,老师讲课好，但是平时分分数包什么的真的很坑人，然后听说不调分orz，那不是普通一点的同学平时分都扣光了嘛）所以想给分好水过的同学还是慎选吧
157115,1546,赵晖,2022-06-22 03:09:10,5,7,2,先打个十分，在这里期望一下赵晖老师捞捞
157633,1546,赵晖,2022-06-24 06:53:21,0,3,3,就说给分，老师肯定是会捞的，你的分数都很清楚，自己算出来然后大概预想一下升1-2档
157703,1546,赵晖,2022-06-24 11:44:35,4,7,3,史纲H，赵老师讲的超级好！！！！浑厚的声音+生动的历史故事+充足的课堂交流。一直很愧疚没有完整地听过三节史纲（作业写不完）。平时分会反复提醒，怕大家拿不满（课堂回答问题+mooc视频测试考试+小组展示+书评）。真的非常好！但是要拿高分的话期末也不能考太差，史纲是统一阅卷的，考试分数还是要靠自己。事情稍稍有点多但是很有意思，特别是课堂展示，有好几个穿越话题。
157734,1546,赵晖,2022-06-24 13:25:00,2,5,3,现代中外关系，讲课很精彩，百家讲坛现场一般，认真负责，然而小组这块，评分制度太复杂了。\n\n但是感觉论文给分挺好，自己认认真真写，还是会收获一个相对不错的成绩的。给我男神10分！
158286,1546,赵晖,2022-06-28 05:33:45,23,25,2,那我们今天就讲到这里
160089,1546,赵晖,2022-09-13 06:21:45,2,2,0,老师比咖啡提神！！！
161400,1546,赵晖,2022-11-06 03:10:38,0,0,0,赵老师讲课真的把历史讲活了，居然能预置到赵老师的史纲课！
161720,1546,赵晖,2022-11-11 05:54:33,1,2,1,好人！作业过了ddl没有交还能补交！
162376,1546,赵晖,2022-11-21 07:35:33,2,3,1,百家讲坛紫金港分坛好好好！！！
162384,1546,赵晖,2022-11-21 09:19:48,-1,0,1,噫！满了，感谢老师让我重燃对国家史的热情！
162578,1546,赵晖,2022-11-26 06:42:08,6,6,0,神中神，上过赵老师的史纲感觉老师讲课非常好，于是又选了老师的新中国史，每周去上课不亚于听一回百家讲坛，喜提4.8
163843,1546,赵晖,2022-12-16 08:19:45,6,8,2,人生四大遗憾：海棠无香，鲥鱼多刺，红楼未完，来zju不听赵老师讲课\n\n认真讲，还是要签到的，史纲预计一学期签六次，不过因为疫情改线上授课也没有签那么多。mooc要写作业，但是就算错过了截止时间老师也会给你再开放的。\n\n讲课讲的真的好，百家讲坛紫金港分坛了属于是
163908,1546,赵晖,2022-12-16 13:45:30,1,1,0,老师的现代中外关系，讲的妙趣横生，喜欢听，如果没有认真听会有负罪感
163926,1546,赵晖,2022-12-16 14:39:09,3,4,1,今年选的现代中外关系，赵晖老师神中神，节节课百家讲坛，时常让我因为听课太专注而忘记了摸鱼...
164117,1546,赵晖,2022-12-18 07:52:17,0,0,0,无脑选
164272,1546,赵晖,2022-12-20 06:08:34,11,15,4,学生不配评价老师，只希望老师永远不要离开他挚爱的讲台
164312,1546,赵晖,2022-12-20 08:30:18,1,1,0,老师讲的很好 听完老师的新中国史想去选现代中外关系了qwq
164474,1546,赵晖,2022-12-21 07:25:05,3,3,0,炒鸡厉害的老师好不好！！！！！！
164535,1546,赵晖,2022-12-21 13:09:25,-11,2,13,上他的课不要坐前排和过道旁边的位置，否则会被喷一脸口水......虽然上课很有激情，但是上课后不知道自己收获了什么
164656,1546,赵晖,2022-12-22 15:05:21,0,0,0,给我选！
164872,1546,赵晖,2022-12-27 05:42:37,2,3,1,还没考试就来给老师评10分！上的是史纲，赵老师真的讲课很好很好，虽然不太讲书里内容，但会给你很多补充，充满学者风度。ddl 截止他会照顾同学然后一拖再拖，没有点名加分过的同学会再最后一次统一安排回答加分作业😭😭真的如果你想卷真的上老师的课直接飞起还能学到好多😭
165183,1546,赵晖,2022-12-30 02:18:30,0,2,2,老师真的太好了，各种故事信手拈来，充满学者的风采！
165280,1546,赵晖,2022-12-31 02:11:15,5,5,0,赵老师的课是我这学期以来收获最多的课，上课注重交流互动，参与感满满。上课的内容广阔又不失深度，受益匪浅。最让人敬佩的是赵老师鼓励学生提问，也耐心的回答，非常平易近人，虽然任务较多，但也确实是这些线下自学的过程让我收获了更多！不论打分多少都不会后悔选了这门通识课！
165485,1546,赵晖,2023-01-07 04:03:25,13,14,1,我现在正在激动中打下这段评论，所以如果有语义不清的地方还请见谅。\n\n老师的课程中有一部分是在慕课网上进行的，里面有一个期末测试的部分需要完成。而我在截止期前因为感染新冠睡得昏天暗地错过了提交的截止日期。整整50分眼看就要被我丢掉了。\n\n但是，但是。赵老师主动联系我，问我情况，然后要我把客观题和主观题的题目做完后私发给他，他来帮我批改并把分数加上去。\n\n我甚至前一天因为睡得早错过了老师的消息，老师都没有为此有丝毫的生气。\n\n我真的觉得我何德何能遇上这样善良的老师。\n\n确实，老师上课的流程比较复杂，但是从某种程度上来说，正是这种复杂和精确到小数点后两位的计分方法和愿意为我这种麻烦精网开一面的对比感让我觉得，赵老师真的很爱每一个学生。
165503,1546,赵晖,2023-01-07 10:55:43,9,11,2,想水的话，把名额留给想听的人吧。
166036,1546,赵晖,2023-01-11 01:55:02,7,8,1,遇到一位这样的老师，也算人生一大幸事。学生确实不配评价这样一位老师\n\n君子气度，大家风范
166123,1546,赵晖,2023-01-11 07:14:56,3,4,1,百家讲坛，选就对了
166179,1546,赵晖,2023-01-11 10:18:39,9,10,1,大家能体会到那种 就是你在休息时间钉钉上问老师一个很愚蠢的问题，本来不抱任何期待，结果五分钟之后直接一个电话打过来的感觉吗\n\n还有mooc，老师看到我们很多人ddl前没完成，多次推时间\n\n上课就更别说了，第一节课拿出微积分作业，到第三节课硬是一个字没写哈哈\n\n虽然只是大一学生，但我还是想说 好老师
166202,1546,赵晖,2023-01-11 11:49:03,1,1,0,赵老师真的好厉害，人也很好，也很关心学生，建议大家选他！upupup
166535,1546,赵晖,2023-01-12 16:21:22,15,15,0,毫无疑问的10分，先说点现实意义的评价：老师真的做到了坚持原则且不失弹性，mooc上的考试、作业DDL错过都可以私戳老师；问任何幼稚的问题都会得到重视且认真的回答；可能事情会有点点多，但绝对不会耗费时间以及精力；已读不回的情况也绝对不会发生……\n\n再说点感性的话，真的，“先生之风，山高水长”，老师真的有在用心对待讲堂，我也是头一回切实地感受到：原来热爱真的能从一个人对待所从事工作的态度上看出来！希望先生永远都不会离开他所热爱的讲堂🫶
166538,1546,赵晖,2023-01-12 16:25:06,1,2,1,先生之风，山高水长！
166557,1546,赵晖,2023-01-12 23:13:23,4,7,3,单看老师，绝对打十分。为什么打十分？因为这里最高只有十分。赵老师的人格魅力，大师风范不是我能够评判的。就单单讲一下他对于学生的态度，你发给他消息，钉钉消息及时回，如果你还有什么疑问还没解决，钉钉电话和你交流，很细致地慢慢解决你的问题。赵老师非常对学生负责，为学生着想，期末论文ddl甚至因为部分学生新冠阳性而延期。赵老师真的是一位非常好的老师。
166591,1546,赵晖,2023-01-13 02:50:02,2,3,1,老师学识丰富，讲课幽默风趣，上的现代中外关系，老师分析的很透彻，对待学生的问题也会耐心细致的回答。过程内容虽然较多，但是会收获满满，能极大提高史学素养和水平。老师给分也很好，不提倡内卷，是可以上百家讲坛的人文学者。
166675,1546,赵晖,2023-01-13 08:05:26,1,1,0,支持，绝对的好老师
166720,1546,赵晖,2023-01-13 10:02:05,1,2,1,给分超好，老师很有意思的
166737,1546,赵晖,2023-01-13 11:22:43,2,2,0,赵晖老师很不错
167026,1546,赵晖,2023-01-14 16:00:30,2,2,0,绝对给老师打十分！大一上的史纲H，讲课有趣事情少，课堂提问会顺便点名，慕课的作业过期忘记提交也会很耐心地帮忙重开，虽然我水课很严重，但是给了4.8！！！
167159,1546,赵晖,2023-01-15 04:28:56,3,3,0,听老师的课是一种享受，虽然平时分结构比较复杂，但是每个任务都去认真对待成绩绝对不会差，感谢赵老师给了我大学以来第一个满绩！
167598,1546,赵晖,2023-01-17 14:03:17,4,4,0,老师超有水平！真的是百家讲坛！而且他非常非常会捞！\n\n不管是学知识还是卷绩点，赵老师都是史纲首选！！！
167756,1546,赵晖,2023-01-19 02:38:01,-1,0,1,qiangtui
167906,1546,赵晖,2023-01-20 05:04:13,4,4,0,不多说了，快来听百家讲坛！给分也特别好，快冲快冲！
168153,1546,赵晖,2023-01-30 10:41:20,5,7,2,很有趣的老师，但是坐在第一排下课后会发现自己满脸口水
168203,1546,赵晖,2023-02-02 03:51:11,0,0,0,老师真的很好
169728,1546,赵晖,2023-02-27 14:24:27,7,8,1,时隔八年还是对赵老师当年上课的感觉意犹未尽，可以说在浙大遇到讲课最好的老师了
173375,1546,赵晖,2023-05-22 04:05:40,0,3,3,学者。
173692,1546,赵晖,2023-06-01 12:51:42,1,1,0,6666
173802,1546,赵晖,2023-06-03 05:58:04,3,4,1,真的好
174503,1546,赵晖,2023-06-13 08:44:26,2,3,1,我爱赵晖老师
174679,1546,赵晖,2023-06-15 13:01:03,1,2,1,老师真的好棒，从来没听过这么棒的思政课
174729,1546,赵晖,2023-06-16 08:52:48,7,7,0,先生之风，山高水长！
174748,1546,赵晖,2023-06-16 15:12:22,7,9,2,有大家之风，意犹未尽。\n\n每次看到签到完空了一半的教师就非常心痛和愤懑，虽然知道老师并不在意这些，但是老师所讲授的令听者津津有味，不觉时间流逝。
175323,1546,赵晖,2023-06-23 20:52:44,1,3,2,老师讲课水平特别好，可惜当年不懂事没怎么去上课，现在真的特后悔
175737,1546,赵晖,2023-06-26 11:00:54,10,12,2,分数包机制组长给自己满分，其他人平均给分（呵呵），不过赵晖老师yyds！
176909,1546,赵晖,2023-06-30 16:00:16,4,5,1,赵晖老师你是我的超人😭😭!!讲课有趣深入，给分又好!!
177024,1546,赵晖,2023-07-01 06:36:57,2,3,1,老师很好呢
177460,1546,赵晖,2023-07-03 10:34:47,0,2,2,老师 你真的太好了 会捞 讲课又好 真的 把历史给讲活了 史纲事情还算比较多 但是老师真的很好 很体谅我们 爱死爱死wwwwww\n\n我看谁不给老师好评
177470,1546,赵晖,2023-07-03 11:02:38,0,0,0,先生之风，高山流水
177752,1546,赵晖,2023-07-04 14:54:38,10,10,0,先生之风 山高水长\n\n真的是我上大学遇到的非常好的老师\n\n你能感慨四年的那种\n\n不仅自身学识渊博，讲课水平很高\n\n也很关心同学，给分很好\n\n就是所有同学心中的那种完美老师吧\n\n真的很爱
178268,1546,赵晖,2023-07-09 06:21:05,1,1,0,十分不解释，史家学者风范，改变了我很多认知，新中国史选就对了，并且强烈建议认真听课
178444,1546,赵晖,2023-07-12 00:53:43,2,3,1,不多说了，新中国史我看谁不冲！！
179017,1546,赵晖,2023-08-21 11:29:41,5,5,0,暑假的时候在智云上学习了赵老师的《新中国史》，老师可以说知无不言，言无不尽，特别是对于新中国前三十年的历史讲解得特别深刻细致（比如教科书上讳言的dyj、wg，老师从历史根源、发端、过程到历史得失都讲解得清清楚楚，贯穿其中的历史唯物主义分析范式更是让人叹服），如果能认真听下来，肯定能对中国特色社会主义的伟大实践收获更为深刻的理解
179064,1546,赵晖,2023-08-27 06:33:09,-1,1,2,最佩服的老师之一
179231,1546,赵晖,2023-08-31 10:08:31,2,3,1,来浙大不上赵晖老师的课实在是遗憾。虽然绩点最后没多少，但根本不后悔当初的选择。
179420,1546,赵晖,2023-09-15 04:16:33,0,1,1,真的是个好老师!
179556,1546,赵晖,2023-09-18 07:56:10,0,2,2,上课很有意思
180234,1546,赵晖,2023-09-20 15:56:04,1,2,1,喜欢喜欢喜欢！
180415,1546,赵晖,2023-09-21 13:21:26,1,2,1,第一次上新中国史，爱了爱了
180481,1546,赵晖,2023-09-22 02:45:18,5,6,1,大师风范
180517,1546,赵晖,2023-09-22 07:58:51,3,4,1,真的是个很幽默风趣的老师，知识渊博，却能把课上得深入浅出，所谓名师不过如此
180947,1546,赵晖,2023-09-28 17:16:29,3,4,1,好老师 很棒！
181287,1546,赵晖,2023-10-13 04:16:47,3,3,0,老师讲得太好了！
181350,1546,赵晖,2023-10-15 12:59:42,34,35,1,“好，我们今天，就到这里”【鞠躬】\n\n【掌声】
181734,1546,赵晖,2023-10-30 09:01:11,6,6,0,赵老师人真的巨好！作业昨天截止，我没有看到，他给我延期了一天让我补交！真的很少见到这么善解人意的老师了！！！必须狠狠地推！！
182120,1546,赵晖,2023-11-10 08:57:35,2,3,1,很喜欢老师讲课风格，各种历史事件熟然于心，信手拈来，听他的课如图百家讲坛，是一种享受
182637,1546,赵晖,2023-11-18 15:44:05,4,5,1,赵老师真的，听他上课简直就像是一种享受，比听说书还带劲。
183304,1546,赵晖,2023-11-23 14:54:06,1,1,0,坐标新中国史，zh老师真的非常博学，讲课很有趣
183305,1546,赵晖,2023-11-23 14:56:25,-1,0,1,讲课特别好，给分也很好
183307,1546,赵晖,2023-11-23 15:04:04,8,8,0,老师讲课很有意思，不虚美，不隐恶，敢说真，说真的。目前为止上过最有意思的思政课。
183313,1546,赵晖,2023-11-23 15:16:17,0,1,1,新中国史\n\n讲课生动有趣，学识丰富，娓娓道来，有如百家讲坛！且任务不多，给分不错！
183314,1546,赵晖,2023-11-23 15:24:18,5,6,1,论文和读书报告感觉没发力到点上，再加上自己时间分配出现问题导致完成的有点仓促，文章质量没那么好，不过最终也拿到了4.5绩点，还是比较满意的。\n\n赵晖老师这门课真的很推荐，努力写好论文绩点还是很好刷的，课程考核也没那么多花里胡哨的，也没有考试和小组，只有一篇期中读书报告和一篇期末论文，可以说是事情少、给绩好的一门课，课程签到也很友善（懂的都懂）。
183316,1546,赵晖,2023-11-23 15:38:47,0,0,0,这老师也太好了吧
183324,1546,赵晖,2023-11-23 23:47:22,1,1,0,后悔当初没找老师修改论文，不然感觉4.5对不起这么好的老师和这么好的课
183337,1546,赵晖,2023-11-24 02:40:56,3,4,1,老师讲课很幽默风趣，新中国史讲的一点也不枯燥，给分也很好，考核就一篇读书报告和一篇论文，认真写绩点不会差的。就是有点遗憾没让老师帮忙看看论文，就自己瞎查资料瞎摸索出了一篇，不知道自己的论文有没有什么问题。
183353,1546,赵晖,2023-11-24 04:54:11,0,0,0,给分好！
183400,1546,赵晖,2023-11-25 03:01:39,1,2,1,讲课好，给分也好👍👍👍
183405,1546,赵晖,2023-11-25 05:09:11,1,2,1,老师相当博学，各种史料信手拈来，给分也相当好
183569,1546,赵晖,2023-11-27 11:58:37,1,1,0,入股不亏，老师超好，回捞人，给分棒，知识渊博
184310,1546,赵晖,2023-12-16 14:00:43,-1,1,2,老师好
184677,1546,赵晖,2023-12-22 06:54:43,5,5,0,心目中一位大学文科老师应有的样子
185074,1546,赵晖,2023-12-26 06:02:34,8,8,0,极其博学，极其儒雅，听课即享受，不过建议选现代中外关系的同学稍微补补基础的历史知识（本理科生有点迷糊）\n\n现代中外关系真是上过最好的通识课。作业是期中一篇发帖一篇回帖、阅读读书组合的文献并进行读书考核（注意每组只抽取一个人考核，代表全组分数），一次小组pre，期末一篇正式的论文。对于没什么历史基础的同学小有难度，但结合文献的话还是比较容易的。好课，好课，好课！
185267,1546,赵晖,2023-12-27 12:15:11,2,3,1,中国近代史纲要\n\n很好的老师速速来上，幽默风趣，知识渊博，儒雅随和，会分享很多历史事件的细节以及名人的逸事，上课很有意思\n\n娓娓道来，结构分明，很有逻辑层次，回答同学奇奇怪怪的提问的时候也非常专业完美\n\n大老师，大先生\n\n在他的课，作业都有趣了起来
185399,1546,赵晖,2023-12-29 01:16:24,2,2,0,老师知识渊博，现代中外关系很有意思👍👍
185769,1546,赵晖,2024-01-04 08:11:22,5,5,0,赵晖老师必须是绝对的 10 分！！！为什么查考试不能打 100 分？？！！绝对的渊博，绝对的优雅，是我见过价值观最正的老师之一！
185866,1546,赵晖,2024-01-05 05:02:43,11,11,0,10分是查老师的上限，不是我给晖哥打分的上限
185868,1546,赵晖,2024-01-05 05:18:05,0,0,0,赵老师yyds
186077,1546,赵晖,2024-01-08 07:59:15,6,7,1,赵老师的课让我每周都盼望着周一，从此周末结束不再那么恐怖。
186204,1546,赵晖,2024-01-09 10:51:48,4,7,3,上了赵老师的新中国史和近现代史纲要，上课旁征博引，真的很好，真的像百家讲坛现场版。新中国史只要认真写好一篇读书报告、一篇论文即可，而且赵老师真的非常有耐心，你缺资料他会发给你，论文发给他也会修改，真的很负责。
187977,1546,赵晖,2024-01-18 02:40:02,6,7,1,新中国史，现场版百家讲坛！只有读书报告和课程论文。\n\n老师讲的很好但我在摸鱼，我忏悔！
188623,1546,赵晖,2024-01-19 12:16:19,0,3,3,现代中外关系，事有点小多，但是认真付出好好写论文就有收获！而且听赵老师的课是一种享受！强推！
188634,1546,赵晖,2024-01-19 12:34:30,-23,5,28,课讲的不错，就是事情超级多，给分很不好，所以打一分
188699,1546,赵晖,2024-01-19 15:09:53,-4,2,6,赵老师是个很好的老师，但是为什么给分比我预期的低了好多
189403,1546,赵晖,2024-01-24 02:43:50,5,5,0,mooc作业截止时间过了，他还主动私发消息，把作业发给他，改了后把分加上去
189569,1546,赵晖,2024-01-25 11:55:03,1,2,1,好好好
189595,1546,赵晖,2024-01-25 13:57:03,4,6,2,赵晖老师，强推！！！！\n\n老师讲课超级超级好，声音浑厚有磁性，很有趣，坐在第一桌可以和老师有超多互动（bushi），而且可以感受到老师真的看过很多书研究过很多资料，学识非常渊博！\n\n老师还特别认真负责，会提醒mooc快要截止了大家赶紧完成，对于逾期未完成的同学还会延后截止日期，特别特别人性化！事确实和其他老师相比多一些，但是也没多多少。我觉得老师主要是为了给分尽量公平才设置的非常非常详细的给分规则。\n\n最后的给分也很好，把均绩拉高了0.1www
189600,1546,赵晖,2024-01-25 14:58:35,11,12,1,好好好好好好好好好
189824,1546,赵晖,2024-01-30 08:52:56,6,10,4,男神嗷嗷嗷嗷嗷嗷嗷！！！\n\n纯理科生绩点5（别打我呜呜呜qwq），但究其原因，大概是平时花了比较多的时间对待任务。一些相对分不高的，有可能是不太积极，小组任务被组长打低了（我们组最高14.6，最低9.6，9.6的人确实全程划水，14.6的同学付出了很多努力），或者不怎么重视平时任务呜呜\n\n而且成绩不是最重要的 老师才是宝藏啊！！！
190026,1546,赵晖,2024-02-11 03:27:05,4,5,1,男神！
190650,1546,赵晖,2024-03-13 05:47:09,4,4,0,早日趋于10.00
190706,1546,赵晖,2024-03-15 07:05:09,0,1,1,好，好，好！
192807,1546,赵晖,2024-05-30 15:27:54,5,5,0,神中神\n\n上大学以来遇到的最好的历史老师
193242,1546,赵晖,2024-06-05 04:29:32,3,4,1,学识超级渊博！！！温文儒雅的学者类型。新中国史吹爆他，像百家讲坛，每次课都掌声雷动。每节课都要点名，但去了绝对不亏，听他讲课超级赞。给分也很好，事情不多。
193397,1546,赵晖,2024-06-09 09:33:34,1,1,0,haolaoshi
194439,1546,赵晖,2024-06-24 02:48:50,2,2,0,老师很好，学识渊博，本人上的史纲，上课气氛很好，mooc没做还会给你调时间
195027,1546,赵晖,2024-06-26 11:47:15,1,2,1,赵爹是真的硬捞啊，不必多言，选到就是赚到！！！
196243,1546,赵晖,2024-07-02 13:13:10,2,2,0,新中国史，事巨少，一个读书报告，一个期末论文，且明确说了除了第一二周剩下6次课都点名。理科生也能轻松拿分，因为老师给分特别好哇!
196530,1546,赵晖,2024-07-04 02:51:30,9,10,1,感觉老师有佛像\n\n像如来佛祖
196848,1546,赵晖,2024-07-05 13:05:51,0,1,1,史纲课讲的很棒，很惭愧没好好听；老师很好沟通，错过了一次mooc互评也给补了；事情比较杂，有小组讨论课和读书考核，但给分不错
196971,1546,赵晖,2024-07-06 07:03:27,2,4,2,我敢说他的新中国史是个人就能拿4.5，可惜以后他再也不上这门课了，上过的就是赚到了
197068,1546,赵晖,2024-07-07 05:48:12,0,0,0,新中国史真的无敌，就五次点名，一个读书报告和一篇论文，给分很高，并且上课讲得也很好，本来以为思政类的课都很无聊，但赵老师讲得特别有意思，强烈建议大家都去听一下
199035,1546,赵晖,2024-09-14 08:07:41,3,3,0,找不出形容词了，只能说wc太好了
199680,1546,赵晖,2024-09-27 11:49:03,0,0,0,不是，真是匿名？
200382,1546,赵晖,2024-10-16 12:03:38,1,1,0,讲的很好，上课不无聊，给分也特别好
201725,1546,赵晖,2024-11-05 16:06:20,2,3,1,上的近现代史纲，感觉老师讲课堪比单口相声，主要用故事呈现历史，讲得也很有趣
205928,1546,赵晖,2024-12-13 00:45:43,9,10,1,史纲H，还没到期末周先来打分，10分是下界\n\n每节课最后都掌声雷动，赵老师人格魅力很独特\n\n“我一直想找到一个历史人物模拟张少帅，但一直没成功，直到王思聪横空出世”（教室内外顿时充满了快活的空气）
205993,1546,赵晖,2024-12-13 02:45:00,7,7,0,"必须满分\n\n见过最好的历史老师，上课超级生动有趣，就算是理工科学生也会听得津津有味\n\n""那我们今天，(鞠躬)就上到这里"""
206042,1546,赵晖,2024-12-13 03:46:13,2,2,0,史纲\n\n讲得很好！！还会附书单，虽然没空看，也会拍照保存！讨论课需要费点心思，上课干别的不管，偶尔点名。\n\n讲得真的很生动丰富精彩，挥洒自如，滔滔不绝，我就算干着别的事也经常干着干着忍不住就开始听
206089,1546,赵晖,2024-12-13 05:10:32,8,8,0,“那我们今天，就上到这里。”（鞠躬，掌声雷动）
206483,1546,赵晖,2024-12-15 12:53:30,1,1,0,好诶！！
207067,1546,赵晖,2024-12-19 06:28:51,3,3,0,目前遇到过的最有先生之风的老师
207276,1546,赵晖,2024-12-20 05:03:48,4,4,0,打10分是因为只有10分，能把知识讲清楚的可以称为好老师，像赵老师这样把历史讲活的应该称作大师。什么样的老师什么样的课能让人一想到要上课就兴奋，下课铃响却不愿离开……无法想象比他更好的历史老师，因为大概率不存在
207574,1546,赵晖,2024-12-23 07:11:02,5,5,0,zju不能失去赵晖，就像西方不能失去耶路撒冷
207652,1546,赵晖,2024-12-23 12:18:16,1,1,0,赵晖老师是神
207719,1546,赵晖,2024-12-24 03:36:28,3,3,0,助力向10分收敛！
208007,1546,赵晖,2024-12-25 07:51:45,-1,1,2,老师超级有意思，生动的历史课堂！！
208009,1546,赵晖,2024-12-25 07:54:42,1,2,1,非常好老师！
208414,1546,赵晖,2024-12-27 12:00:34,3,3,0,神中神中神中神，特别特别好的老师预置到您的史纲是我莫大的幸事
208528,1546,赵晖,2024-12-29 02:52:43,0,0,0,很好的老师
210147,1546,赵晖,2025-01-08 08:47:19,1,1,0,没啥多说的，神
212103,1546,赵晖,2025-01-13 07:38:52,1,1,0,神，无需多言
212352,1546,赵晖,2025-01-14 01:59:34,0,1,1,现代中外关系这门课对历史不感兴趣的uu们慎选哦，老师人很好但学起来太痛苦了，有认真写论文但真的写不来，最后4.2
212925,1546,赵晖,2025-01-15 09:19:55,3,3,0,赵晖老师，真正的历史学大师，完美符合了我对于大学教授国学大师的所有幻想，讲课各种史料资料人物语录信手拈来，对历史不仅有简单的史实，更有不少他自己的理解与感悟，听赵晖老师一节课，真的是对于灵魂的升华，给分方面也是超级好。
213082,1546,赵晖,2025-01-16 03:07:44,3,3,0,好到给十分都不够！！！！！课堂生动有趣，老师有时还会眼神互动哈哈哈哈
213134,1546,赵晖,2025-01-16 05:26:47,0,1,1,不用说，赵晖老师！永远的神！！！！！！！
213135,1546,赵晖,2025-01-16 05:31:52,0,0,0,神中神，伟大无需多言！
213876,1546,赵晖,2025-01-21 01:46:11,2,2,0,赵晖老师是我遇见过最和蔼最负责的老师。不仅上课幽默有趣，对学生也很宽容，线上作业有学生迟交他甚至会延长提交通道的时间！
215099,1546,赵晖,2025-02-21 04:30:44,2,2,0,有趣，有干货，有收获👍👍👍
219064,1546,赵晖,2025-05-20 07:42:04,0,0,0,高中历史很少及格，带着偏见来上红课，但是依然听得进去，必须10分
219372,1546,赵晖,2025-05-26 04:45:01,0,0,0,上学期上他的史纲，有一次线上作业忘交了，看到截止日期过了也认栽了。结果赵老师居然在放假之后专门打电话给我说让我提交，我直接惊愕了，最后绩点也不错！\n\n不得不说，绝对是我见过最负责也最捞的老师！
219569,1546,赵晖,2025-05-30 02:04:21,0,0,0,行走的百家讲坛，上到赵老师的课真的有福了
219643,1546,赵晖,2025-06-03 02:42:13,0,0,0,老师我爱你
219694,1546,赵晖,2025-06-04 08:53:01,0,0,0,坐标史纲，老师讲的很好，但事情真的挺多的，得分比较吃小组运气
221676,1546,赵晖,2025-06-25 08:01:16,1,1,0,给分好是您最小的优点
221816,1546,赵晖,2025-06-26 12:02:41,1,1,0,感觉并不需要我来再向大家介绍老师有多好了。第一次听老师讲课不是在史纲课，而是在一次培训讲座，全场人山人海其实不少都在玩手机，赵老师讲课的时候，我玩着玩着手机，不知道什么时候就放下手机开始听课了，我看向周围，旁边的同学也不知道什么时候突然就开始听课了，赵老师讲完的时候，全场掌声雷动，我当时就想我一定要上赵老师的史纲课。这个学期上史纲的时候，其实第一节课我还带了个比较简单的作业，结果三节课过去一点没写全听课去了。这是魔力吧，一定是魔力吧。
221934,1546,赵晖,2025-06-27 13:22:33,0,0,0,好老师，平时事情稍微有一些（不太确定其他班什么情况）
3193,1559,金建伟,2015-05-20 02:06:20,16,35,19,事情多 课无聊 讲不通
3282,1559,金建伟,2015-05-26 12:31:17,-2,8,10,无聊
3481,1559,金建伟,2015-06-16 11:59:16,22,48,26,教马原课实际讲哲学，较有深度，但一部分问题没有做出较好回答
3860,1559,金建伟,2015-06-17 06:47:01,1,13,12,令自己哲学水平有了进一步提高
4732,1559,金建伟,2015-07-13 06:10:58,0,15,15,必须好老师，除了有些问题解答不清晰，讲课有趣，给分好
5475,1559,金建伟,2015-07-07 23:53:14,2,12,10,一学期三张ppt，全是老师独角戏，不讲教材满水的……
6200,1559,金建伟,2015-07-12 02:51:40,11,29,18,很好的老师，其实是哲学课
6332,1559,金建伟,2015-07-13 04:40:30,3,10,7,独角戏一词恰到好处
6421,1559,金建伟,2015-07-14 01:45:32,8,14,6,事情不多。上课不用ppt不讲课本，总是提问，但每次就那几个人回答问题，所以没人举手他会点人。最后考试他会集体性的给高一点。
9332,1559,金建伟,2015-10-22 03:13:46,2,8,6,黄课没发现，只知道是哲学课
11554,1559,金建伟,2015-12-04 13:35:58,-7,5,12,黄课不好说，但是他自己说自己黄。。。不过偶尔能讲点有哲学的话。。上课他自己不讲学生分组做PPT讲，他点人回答问题主动回答的加分，不回答的扣分。每节课排队签到。
11725,1559,金建伟,2019-09-12 03:59:10,52,92,40,老师将主要的哲学问题都探讨了一遍，破除偏见，启发思考，对于能够积极参与的同学来说，十分有趣有益。老师虽其貌不扬但颇有哲人气质，从不贩卖观点或强制洗脑。
14435,1559,金建伟,2016-01-07 05:22:41,33,65,32,用固定座位点名，每节课基本是学生在讲ppt。而且此人还喜欢在群里面转一些微信上的弱智谣言段子，感觉很差
15074,1559,金建伟,2016-01-12 02:00:52,0,7,7,蛮好的
15154,1559,金建伟,2016-01-12 08:41:57,0,10,10,哲学老师，有思想
17930,1559,金建伟,2016-01-21 04:13:56,-1,9,10,我喜欢金老师的课。
18199,1559,金建伟,2016-01-21 09:16:23,-1,8,9,真的是一个好老师 给分还可以，马原基本上裸考
19405,1559,金建伟,2016-01-24 06:05:38,45,87,42,对很多问题谈了很多，但却经常流于表面，而且他的很多观点我都无法赞同。BTW，每节课必谈猪和性。
19573,1559,金建伟,2016-01-24 17:48:40,-3,3,6,水比老师事情不多给分好，真心水！
20499,1559,金建伟,2016-01-28 01:43:16,0,8,8,对哲学有兴趣，可以选他，多数时间讨论哲学问题，收获很多.
22625,1559,金建伟,2019-06-13 05:17:05,155,176,21,想知道老师的头发是如何做到这么蓬松的
23002,1559,金建伟,2016-03-16 03:26:07,1,7,6,把除了人以外的生命体看得很低的狭隘的老师
23514,1559,金建伟,2016-04-03 04:52:24,17,30,13,每节课都讲到大便和猪。。
26179,1559,金建伟,2016-06-16 07:17:21,1,9,8,和这位老师每节课都有灵魂的交流
26624,1559,金建伟,2016-06-20 11:51:31,2,12,10,哲学课，老师会谈很多问题，认真听会有很多收获。上课会提问，或者让同学提问，自己提问可以有加分，从来都是组长点名。虽然说有个人展示，但是从来没有展示过。有一次小组展示，但是比较水。总体来说课挺水的，比较适合忙的同学，事情很少。
28265,1559,金建伟,2016-06-28 08:23:09,2,7,5,还可以吧，完全不是想象中马原老师应该有的样子。课上一直在讲哲学话题。小组展示之后想不去上课就不用去了，没有限制
30577,1559,金建伟,2016-07-02 04:01:07,0,6,6,不知道，这个老师给分儿怎么样，但讲课，学不到东西。不按照教材天马行空的讲
32248,1559,金建伟,2016-07-06 04:50:55,4,12,8,本来就不打算好好听思政课的同学可以选这位老师，有一定哲学基础的也可以选金老师，但没有哲学基础，而且不想在哲学上费太大力气，却想在马原课上学到一些的同学，请不要选这位老师，真心不要选。
32255,1559,金建伟,2016-07-06 05:13:03,0,12,12,垃圾老师，毁我青春，平时一天到晚性性性，猪猪猪，狗狗狗，屎屎屎也就算了，出分这么晚，给分这么差，没脑子的老师！！
32491,1559,金建伟,2016-07-07 05:36:52,3,11,8,很幸运！老师讲得是哲学而非马原
32518,1559,金建伟,2016-07-07 10:49:03,-2,2,4,特别想知道张柏芝多少分
33331,1559,金建伟,2016-09-18 08:29:33,29,54,25,在医学院上中特，这位老师不断嘲讽同学们对“如何做一位好医生”的理解，甚至说出“缓解他痛苦可以直接杀了他嘛”这样的话……？？？一下午什么主题都没有，没有学到任何的哲学知识，老师只知道扯皮，分组，换座位。反复质疑别的专业，不懂装懂指手画脚。：）
33833,1559,金建伟,2016-09-22 04:18:36,54,81,27,没有哲学家的命，却得了哲学家的病
34542,1559,金建伟,2016-10-13 03:58:51,34,64,30,我想知道他学习帝是评分为什么这么高。。。他上课完全是诡辩啊。。。停留于在文字词汇表面上的纠结，不好好研究哲学问题。。。唉，难道哲学老师都这样吗
34588,1559,金建伟,2017-01-22 13:32:12,0,6,6,还好吧
34636,1559,金建伟,2016-10-17 05:14:37,1,9,8,垃圾……这种人也好意思说自己研究的是哲学……
35008,1559,金建伟,2016-11-17 04:08:27,1,9,8,垃圾老师 毁我青春
35127,1559,金建伟,2016-11-03 02:40:10,-1,2,3,全程诡辩
39424,1559,金建伟,2016-12-22 14:38:01,2,10,8,太顾及自己，一点也不考虑学生的感受。问问题的时候咄咄逼人，今天把一个女生弄哭了。真心垃圾！一个老师教的差就算了，口上还不留德
40340,1559,金建伟,2017-01-03 03:44:22,10,27,17,非常好的老师，讲的是哲学，好多问题要认真想想。老师举偏激的例子前都会澄清观点，如果能把课听完整了就不会觉得偏激了，老师已经尽量不带入个人观点了。老师喜欢驳斥好多观点，但也不反对，喜欢用两个观点相互驳斥然后不指明道路让我们自己选择，觉得还挺难得的。老师喜欢和同学探讨问题，只要你问他，他都会比较重视。
40674,1559,金建伟,2017-01-05 02:40:14,19,40,21,1.每节课必谈养猪，性，言论有歧视女性倾向，大概翻遍全世界也没有更好的例子了。2.不划重点，不讲书，倒数第二节课放了一节课养猪视频。3.诡辩，怼人。4.在群里转发弱智微信言论，中国中年政治家典范。只恨没有零分可打！
40716,1559,金建伟,2017-01-05 06:04:57,0,9,9,为什么分数突然变这么低了，我感觉老师上的很好啊，讲的话题还挺思辨的，事情也不多。。。
40718,1559,金建伟,2017-01-05 06:23:25,-2,3,5,不知道这位老师和猪有着什么样的关系以至于每节课都会提到
40748,1559,金建伟,2017-01-05 08:15:37,1,3,2,马克思主义基本原理：老师一直说话。平时讨论哲学的东西。有时候会拖时间。给分还好。
42905,1559,金建伟,2018-12-24 17:15:49,11,19,8,他有自己的想法，会介绍很多哲学思想，但也不强加于人。讲的内容和马原涉及的内容相关，但不拘泥于教材，按他的话说，他讲的对于考试来说不一定是对的。他的课也许对马原的考试没什么作用，不过会带给人一些思考。每个人上课的目的不同，根据个人喜好吧。
43742,1559,金建伟,2017-01-22 09:11:44,-1,4,5,还好吧
45852,1559,金建伟,2017-01-20 07:29:24,0,3,3,这出分也太慢了吧
46628,1559,金建伟,2017-01-22 08:32:42,5,10,5,出分慢而且给分一般 上课诡辩
46687,1559,金建伟,2017-01-22 07:11:05,-1,6,7,哲学课 无聊 反正马原课基本也都这么无聊\n\n平均水平还是有的
46721,1559,金建伟,2017-01-22 08:21:36,-3,6,9,好老师 不多说
46777,1559,金建伟,2017-01-22 10:01:15,1,3,2,给分一般，很一般
46834,1559,金建伟,2017-01-22 12:05:33,7,12,5,上课成天讲废话，害得我们最后一组展示都没有时间，最后我们组的分数都很低，这是什么意思！
46900,1559,金建伟,2017-01-23 00:04:52,-1,1,2,基本上是老师在讲，平时作业挺少的\n\n
46908,1559,金建伟,2017-01-23 01:19:52,-6,6,12,说老师诡辩的人自己没学过哲学吧
48315,1559,金建伟,2017-03-02 06:03:42,27,44,17,这不是哲学。是什么给了大家这是哲学的错觉。还不如自己读书。\n\n每节课必谈性和歧视女性的言论加一，诡辩加一，恕我直言，金师仿佛是一位自以为是哲学家的民科学者。\n\n我是真心想骂一声…的。作为一个女生，我要吐了。真的很恶心那些把女性比做动物和田地的言论。恶心。难受。
48344,1559,金建伟,2017-03-02 07:59:34,15,23,8,楼上有同学说“每节课必谈到猪和性”…我觉得老师做到了(⊙_⊙)
48662,1559,金建伟,2017-03-09 04:09:24,6,12,6,不客观地说，不听不听，王八念经
48694,1559,金建伟,2017-03-09 13:18:30,15,27,12,从一个人的谈吐就可以看出来他脑子里都在关注些什么 老师每次说到歧视女性的言论之前总是要强调 注意啊 这不是我说的我只是引述一些观点 但是提到这些观点的频率太高比重太大 很难相信这些不是他内心的看法 讲黄色笑话的频率也很高 讲完了之后自己还觉得很好笑 殊不知这些笑话令人反感 不是说上课讨论性不好 我上过沈坚老师的西方文明史 沈老师讲到这方面的时候让人感到性是一种美学 但金老师只是让人觉得不堪入耳 我是来学哲学的 真的没想到会听到这么多辣耳朵的东西 眼界真的很狭隘 甚至不如学生 关注点只是这么点低俗的方面 和同学聊天收获的东西都比听他讲课要多多了简直是浪费时间 不知道这种人怎么教书育人
49459,1559,金建伟,2017-04-14 06:50:51,22,32,10,时间原来可以这样浪费！
49467,1559,金建伟,2017-04-15 01:50:35,-2,5,7,体验极差
49599,1559,金建伟,2017-04-20 02:54:13,-2,4,6,讲的很好，听得很爽！
49704,1559,金建伟,2017-04-24 12:55:49,1,8,7,讲课水平烂，倒浙大牌子
51536,1559,金建伟,2017-06-07 03:27:07,-2,3,5,别的不说，金老师的浓浓师生情是不假的，真的不会给你挂，课不上都不会给你挂
51652,1559,金建伟,2017-06-08 03:31:02,2,7,5,老师挺好的，不知道为什么评分这么低
51935,1559,金建伟,2017-06-13 15:52:15,1,8,7,感觉老师上的挺好的，改变了我对马原课的印象。虽然举例子的时候比较偏激，但是陈述的都是不同哲学家的观点，能启发思考。但是必须认真完整的听，有时候一走神就跟不上思路了。不过还是建议老师换不那么会引起争议的例子
56055,1559,金建伟,2017-07-03 03:46:21,2,7,5,上课一群人发言刷分。但是每节课就那几个人。给分很不好，上课有毒。没想到最低的绩点是马原。再见
56083,1559,金建伟,2017-07-03 04:42:33,0,3,3,其实老师上课讲的虽然有些偏激，但还是有所启发的，如果觉得听不下去可以睡觉水手机，老师也不管的，反正感觉没有有些人说的这么差
56106,1559,金建伟,2017-07-03 05:26:39,-5,3,8,平时分很重要，要多做贡献咯，给分不错
56198,1559,金建伟,2017-07-03 08:42:55,-5,5,10,挺好的。
58030,1559,金建伟,2017-07-24 08:12:02,-6,4,10,值得听
59702,1559,金建伟,2017-09-26 03:43:06,-2,2,4,怪怪的
60169,1559,金建伟,2017-10-12 05:36:22,5,14,9,混淆概念，玩诡辩，这根本不是哲学
60395,1559,金建伟,2017-10-19 03:45:00,11,19,8,诡辩家，只会提问题但自己绕来绕去也讲不清
60453,1559,金建伟,2017-10-20 15:49:07,9,15,6,整天就是讨论讨论讨论。预先假定马原课本你已经看完了（手动微笑）
60858,1559,金建伟,2017-10-31 11:16:21,16,29,13,手动1分，马原课都扯的什么东西。每次上课都是一群人恶竞发言，几个说的东西有营养？靠着读过哲学书，掉书袋！
60903,1559,金建伟,2017-11-02 04:00:17,-2,5,7,怎么可以这么有意思啊！！！
60909,1559,金建伟,2017-11-02 07:04:22,14,23,9,真希望老师先学好数学和物理再来教课，在论辩一些事情的时候喜欢歪曲事实 而且.....一天到晚想些这有的没的有个什么屁用呀 不太明白他的课和马克思哲学有什么关系
61143,1559,金建伟,2017-11-09 05:22:25,15,20,5,能引出很多问题 但是很多问题都解决不好 常常把牛顿力学欧氏几何挂在嘴边 可是他并不了解吧?有些人为了恶竞也真是做足了功夫
63568,1559,金建伟,2017-12-07 03:37:50,2,17,15,那些说发言是恶竞的人，要明白，并不是所有人都为了分数而学习的，发言只是真的有话要说，有理要讲。这样揣测别人，未免有些狭隘。
63763,1559,金建伟,2017-12-14 06:44:47,3,7,4,听过两次课，经常打断学生发言然后说自己观点不知道这算不算贩卖观点。但是每次听老师的观点都有种很气的感觉是怎么回事呢？
63865,1559,金建伟,2017-12-18 03:39:47,2,4,2,老师习惯性拖堂
64543,1559,金建伟,2017-12-25 05:24:12,1,3,2,不错的
65144,1559,金建伟,2017-12-29 10:51:30,0,4,4,很有深度的老师，不强加自己的观点
65443,1559,金建伟,2018-01-04 03:19:58,-1,1,2,………
65727,1559,金建伟,2018-01-08 14:08:22,9,15,6,很奇怪，不知道查老师上面为什么这么多差评，在这种先入为主的影响下我听了几节课，仍然感觉老师很有内涵，和想象中的马原老师完全不同。所以这是老师长相和口音的问题吗？不可思议。
66131,1559,金建伟,2018-01-12 04:06:09,7,14,7,老师并没有想象中的那么偏激那么执拗。更开放讨论，也很谦虚。
66181,1559,金建伟,2018-01-12 14:53:41,7,12,5,平心而论，老师很多话题的讨论不够深入，大言不惭讨论一些物理数学问题，却连基本概念都不清楚。并且整个讨论节奏比较跳跃，东打一枪西打一枪，对于矛盾的回应总是隔靴搔痒逃避重点，往往一节课下来没有一个点说清说透了，的确是没有哲学家的命却有哲学家的病
66915,1559,金建伟,2018-01-19 09:26:36,7,14,7,虽然我是真的不懂哲学也听不进去哲学…但是老师和课堂氛围真心还不错
69539,1559,金建伟,2018-01-25 03:11:31,-1,2,3,出分贼慢。。。
70131,1559,金建伟,2018-01-26 07:02:16,-1,1,2,给分烂over
70133,1559,金建伟,2018-01-26 07:05:32,0,3,3,其实我感觉老师挺可爱的呀……
70138,1559,金建伟,2018-01-26 07:11:44,2,3,1,简直吃力不讨好
70141,1559,金建伟,2018-01-26 07:14:21,-1,0,1,一般般，但讲了很多，我没什么兴趣，也就低分飘过了
70170,1559,金建伟,2018-01-26 07:54:11,5,9,4,感觉老师并没有评论的那么差，只是课堂讨论参与的人比较少。
70180,1559,金建伟,2018-01-26 08:01:18,0,2,2,就像他第一节课说的，如果想要好好讨论问题可能别的课都没时间学了；也是时常证明自己课的重要性。有几次想发言但是因为种种原因没显式的发言；最后期末均绩。期末好好考，问答题老师应该是按照自己的标准改的。
70197,1559,金建伟,2018-01-26 08:20:47,16,24,8,上课最难受的是一群什么都不懂的学生瞎讲
70238,1559,金建伟,2018-01-26 09:22:22,4,8,4,谁选谁知道
70418,1559,金建伟,2018-01-26 15:03:32,7,14,7,像金老师这样既有自由思想又能坚守马原老师底线的老师应该不多吧，真心欣赏金老师！上课不讲马克思主义，这是实话，但我觉得启发大家思考比灌输课本知识要强的多
72724,1559,金建伟,2018-01-31 03:34:17,0,2,2,比想象的好
73092,1559,金建伟,2018-02-01 01:56:21,3,6,3,其实老师讲的课蛮有意思的，所以导致每次马原课想做作业结果最后都在听他讲课……虽破给了我一个很差的j点 但是老师确实还可以 没有那么糟
73754,1559,金建伟,2018-02-03 05:06:59,0,2,2,还不错，课比较有意思
75498,1559,金建伟,2018-03-12 12:49:33,-3,0,3,小组展示分数第一，个人展示和论文都非常认真写的，考试选择题基本都对，主观题写到手快断，最后均绩，原因是上课没发言被正态了
75923,1559,金建伟,2018-09-28 04:18:01,10,19,9,诡辩。很多没有哲学基础的同学听他讲课可能会觉得新鲜或有启发，但实际上他的很多诡辩完全可以用马哲捅破，再加上他基本上不讲马原，我一直怀疑他的意图是来反马原或黑马原的。另外，其个人德行水平也在教学过程中显露一二——独裁而无知，自大不虚心，不懂反思自己只会抱怨和阴阳怪气地讽刺挖苦，狭隘非常。
75929,1559,金建伟,2018-03-22 05:21:22,0,2,2,楼下的真是666，冷冷地看着他? ?
76709,1559,金建伟,2018-04-19 02:18:55,6,8,2,没有任何数理基础仍然要提出自己的观点，服气。
76915,1559,金建伟,2018-05-24 03:19:48,25,33,8,我想知道给老师发邮件能加分吗?
79490,1559,金建伟,2018-06-07 02:23:10,21,26,5,听说从前必谈猪和性?嗯，今年又加上了狗和大便……
79805,1559,金建伟,2018-06-14 02:00:07,24,29,5,弱弱地问一句，当组长有加分吗?
79821,1559,金建伟,2018-06-14 04:14:09,2,5,3,上了一学期马原，感觉老师的头发越来越少越来越白了。
80178,1559,金建伟,2018-07-04 01:44:41,-11,1,12,保佑我的马原上4.2?
80559,1559,金建伟,2018-06-28 02:03:56,5,6,1,我觉得，老师上课非常认真 虽然基本不讲课本，但事情比较少，人也很好，很后悔一学期没有好好听课。
83401,1559,金建伟,2018-07-10 08:09:30,5,9,4,事情少，给分巨好
83574,1559,金建伟,2018-07-10 15:37:34,0,2,2,给分还不错
83604,1559,金建伟,2018-07-10 23:11:43,1,3,2,老师真的很有见解，他经常说要好好想想他说的话，想明白了对一生都有好处。可能他讲的内容和课本联系不大，也不是很适应考试，但是真的充满哲理性啊。
83620,1559,金建伟,2018-07-11 00:01:33,2,8,6,浙大比较好的马原老师之一，知识渊博，上课总喜欢和大家一起讨论各种流派的哲学。而且还说，在课堂上讨论无论什么都没关系，出了事他负责(◦˙▽˙◦)。很棒很棒，讲了几堂很精彩的课
84558,1559,金建伟,2018-07-13 07:30:12,0,2,2,我觉得老师超级好啊
84767,1559,金建伟,2018-07-13 23:35:02,3,6,3,很多观点和论证不敢苟同
86353,1559,金建伟,2018-09-14 00:40:32,0,2,2,有不少启发
86947,1559,金建伟,2018-09-19 13:36:20,-1,2,3,老师实在是太好了\n\n事少分还可以
87183,1559,金建伟,2018-09-21 12:07:22,-1,2,3,他是不是被法学生抢过女朋友?法学院招他惹他了?
87316,1559,金建伟,2018-09-27 03:21:48,10,13,3,今日打卡：妓女鸭子性交排泄?
87384,1559,金建伟,2018-09-28 02:08:53,1,1,0,想问有人知道群的密码是什么吗？之后回来改评论的
87400,1559,金建伟,2018-09-28 04:16:53,0,2,2,上了两次课，不可否认老师有的时候举的例子确实有一些不妥，但是能全面的介绍各派思想，说这些不是哲学的人是不了解吧。\n\n
87733,1559,金建伟,2018-10-17 07:43:16,1,1,0,固定座位点名，讲课都是所谓的哲学，课后事情还很多，还非得什么个人展示，还有各种作业，wcld
87975,1559,金建伟,2018-10-19 04:19:39,6,8,2,喜欢拖堂！！！
88581,1559,金建伟,2018-11-02 02:49:21,-2,4,6,按我理解，马原课至少应该主要讲讲述马克思主义理论，并且用这种理论指导我们的生活。其他哲学流派和观点可以作简要介绍，但绝对不能把它放在和马原同等重要的位置。老师上课讲神，同学展示也讲神，我真的服了。我们从小接受的教育就是把神送走，崇尚科学，在这里又重新把神迎了回来，玩起了思辨游戏。更不要说，这门课还兼有宣传教化的作用，并非普通通识课。
91814,1559,金建伟,2018-12-21 04:22:49,-1,4,5,五分，这是我给过的最低的分数。\n\n希望老师自己不了解理科就不要随便引证信口开河，这样得出的结论只会让人觉得可总是笑，且无法令人信服。\n\n沉浸在自己的逻辑里自我陶醉，and今天拖堂八分钟了，吐了。
92076,1559,金建伟,2018-12-26 04:15:52,4,6,2,浙大难得的左派老师，讲的基本都是哲学，很适合大家哲学入门。并不觉得举例猪、性有什么难听的，反而觉得很容易理解。
97776,1559,金建伟,2019-01-22 15:52:13,1,3,2,棒棒棒！
98469,1559,金建伟,2019-01-23 13:14:17,1,4,3,强制安排座位，不知道其他班是不是这样。会递话筒，不回答会扣分。上课内容和考试基本没有关系，最后一节听一下，其他时间只要不被抽中没什么大问题。
98471,1559,金建伟,2019-01-23 13:15:52,-2,2,4,讲猪、性、排泄物、跳楼都没什么关系，但是每节课讲就过了吧？？上课讲不听马原十年以后一定后悔说不定就跳楼了？？跳楼早晚和跳楼地点选择？？各种诡辩乱来批驳学生观点讲到最后都是自己说的对没法反驳太高深了呢?不跟书本前后跳着随便讲，讲的啥主题也不知道，手动1分拿好不谢?
98483,1559,金建伟,2019-01-23 13:24:31,-2,1,3,听的难受\n\n
98485,1559,金建伟,2019-01-23 13:26:47,0,5,5,傻逼，刷新绩点新低，严重怀疑班长考勤把我和另外一个人弄反了...那个人经常缺课，我的分比他还低...
98497,1559,金建伟,2019-01-23 13:42:20,6,7,1,要不上选不上别的老师的课，我也不会选他呀，哭
98728,1559,金建伟,2019-01-24 00:34:09,1,3,2,我哭了，你呢
98745,1559,金建伟,2019-01-24 01:17:00,1,3,2,上查老师一看发现自己成绩还没到平均水平，难过?
98975,1559,金建伟,2019-01-24 06:07:47,-2,2,4,如果忽略掉一些猪啊什么什么的，老师讲课还是很深刻的，最重要的是老师给分太好了。
98995,1559,金建伟,2019-01-24 06:35:40,3,5,2,看出来老师在使劲捞我了\n\n给分比起我的其他思政课还是可以的\n\n上课固定座位，讲的和课本无关\n\n然后因为坐的靠前，被老师指着举了一学期的例子?\n\n建议大家利用好马原课的时间学别的课程\n\n
101472,1559,金建伟,2019-01-28 09:11:03,3,3,0,我觉得给分还可以
105121,1559,金建伟,2019-04-04 04:04:11,4,8,4,首先，为什么没有零分负分可以打？这个老师的观点和讲话方式让人感到十分不适。讲性不一定是前卫或者开放，不正常的观点只会让人觉得被冒犯。
105372,1559,金建伟,2019-04-11 02:15:48,-2,3,5,真的是诡辩
105491,1559,金建伟,2019-04-15 10:04:07,1,1,0,不少观点被改变了\n\n
105657,1559,金建伟,2019-04-18 03:41:42,6,7,1,听老师课是一种让手机迅速没电的体验
111252,1559,金建伟,2019-06-30 19:09:57,-3,0,3,给分好
111428,1559,金建伟,2019-07-01 12:48:21,1,2,1,老师讲课很有逻辑，能在黑板上把一节课的重点抽象成简单的等式或逻辑图，虽然高中政治学过辩证法，但毕竟过了三年，结合自己的经历，再听一遍会有很不一样的感觉，最大的启发可能是，马克思的“资本”指的不是财富，而是人与人之间的关系，听完老师的课后很想去看一下《资本论》
116606,1559,金建伟,2019-09-12 03:43:57,0,0,0,哲学最难的问题就是证明公理
116641,1559,金建伟,2019-09-12 06:23:50,-3,3,6,“你们的专业课都不重要，多上思修少上专业。”\n\n哟那些科技的创新和企业的创作是思修带来的是么？
116642,1559,金建伟,2019-09-12 06:31:55,16,21,5,我连睡觉都要来上马原课
117086,1559,金建伟,2019-09-19 05:28:10,7,9,2,第一次碰见把思政课当成哲学课对待的老师
117092,1559,金建伟,2019-09-19 05:59:08,5,10,5,很多人气评论都是在骂金老师不懂哲学，但哲学这种东西，各位上马原课的大学生又怎么会辨别呢？一些评论虽然人气不高，但肯定了老师哲学的思维和上课方式。关于歧视女性，现在老师上课也不提这些了，可以看出他也在不断接受我们的意见和建议并做出了一些改变。他是我遇到的第一位将思政课上成哲学课的老师，所讲的一些哲学观点，他自己也说我们不一定要接受，更重要的是要有哲学的思想。大学里能遇到这样的老师，我觉得很幸运。
117413,1559,金建伟,2019-09-24 04:46:19,2,5,3,内容很有深度，感觉比多数同学给的评价要好不少啊。
117561,1559,金建伟,2019-09-26 03:46:17,-2,1,3,事贼多
117994,1559,金建伟,2019-10-18 02:08:09,0,2,2,无聊、啰嗦。自己定了一大堆规则，还非常起劲。讲课让人心烦。\n\n偏激的哲学观点，真的是在讲哲学吗？老师活在自己的世界里太久了。
118106,1559,金建伟,2019-10-21 03:29:23,3,3,0,我觉得讲的挺好的啊，真正有干货的老师，那些自己不喜欢听这类思政课的请不要恶意攻击
118257,1559,金建伟,2019-10-24 03:15:06,4,4,0,我谈强x谈自愿被x谈圣经里面的人性原罪\n\n但这些都不是我说的\n\n我还是个坚持马克思主义的好老师
119706,1559,金建伟,2019-11-15 02:57:48,3,3,0,嗯。\n\n「我觉得文革中思想工作的做法是很好的...比如举个例子，有个女生不幸被强奸，但在这之后她还想再被强奸。其实这就是出现了坏的思想，是需要矫正的」\n\n你懂吧？
120429,1559,金建伟,2019-12-04 14:25:24,3,3,0,怎样做一条好狗？
120911,1559,金建伟,2020-01-22 15:58:25,10,14,4,老师很好 希望可以活到下学期
120924,1559,金建伟,2020-01-19 15:58:03,7,13,6,我只想说，如果马原课程组都是一样的成绩分布，您给我们这么低的分数，我真的没意见。可是在别的老师普遍给高分而你给我们这么低的分数是什么意思？这公平吗？我上课积极发言期末不说背了整本书好歹也辛苦背了两天 室友完全裸考大题什么都不会感觉卷面没及格都有4.2 我3.0 保研计划什么的因为这一门分数可能没戏了 我只想问 你真的不懂你给的分数对学生可能造成的影响吗
120950,1559,金建伟,2020-01-19 01:25:07,9,12,3,他是一位哲学思辨而不是马原应试的导师。
121051,1559,金建伟,2020-01-19 10:32:25,5,6,1,不想要分的大胆选
121112,1559,金建伟,2020-01-19 15:47:22,0,6,6,恶心的垃圾，性、狗、猪永远挂在嘴边，哲学只是幌子，内在完全是流氓的本质
121126,1559,金建伟,2020-01-19 18:54:58,2,3,1,评卷有毒
121188,1559,金建伟,2020-01-20 03:15:04,7,7,0,给分很差....反正就出分了 别的班的同学激烈地讨论着自己4.5+ 吹爆老师啥的 我们的群里问老师为啥没有公布平时成绩 为啥马原课程组老师给分档次不一样 老师也没个回应
121714,1559,金建伟,2020-01-21 05:33:15,4,6,2,认认真真学习复习\n\n辣鸡给分打回原形\n\n一门马原拉低0.2\n\njjw不愧是你 够狠
123649,1559,金建伟,2020-06-11 07:07:02,2,3,1,挺不错的老师，至少这学期上课没有其他同学说的问题，最后还问我们有没有什么对于上课的建议。
123650,1559,金建伟,2020-06-11 07:09:33,0,2,2,老师讲课比较深入，又鼓励学生讨论，作业也不是很多，是一位不错的老师。
123864,1559,金建伟,2020-06-15 08:16:47,3,4,1,老师这学期挺好的，他有意识到去年学生对他的评价不太好，还让我们向他提建议，鼓励鼓励
126823,1559,金建伟,2020-10-21 13:00:14,0,2,2,服了，每节课都拖课
127069,1559,金建伟,2020-11-05 03:23:14,3,3,0,个人感觉金老师其实挺好的，就可能是我等级太低，听不太懂吧。
128414,1559,金建伟,2020-12-22 13:52:56,6,6,0,金建伟老师举的各种例子虽然庸俗，但说低俗还是稍微言重了点；虽然言必称柏拉图亚里士多德黑格尔就是不讲马克思，但至少还是有点东西的——我本想那么说的，但是在课上找同学上讲台念浙大自杀学子的遗书来思考什么“生命意义”这活实在是太阴间了。
128698,1559,金建伟,2020-12-25 04:46:50,11,15,4,老师的专业是哲学，看的书很多，为人谦逊，上课多半讲哲学史，政治经济学一般，我上的时候也没有扯猪和性……个人感觉是上大学以来最有思想深度的老师！为人和善总是笑嘻嘻的，相比之下同学们的发言和展示相形见绌，没看什么书便可笑地发表自己的观点。
129585,1559,金建伟,2021-01-08 02:54:40,13,16,3,浅听会觉得他只再讲猪和性和女人\n\n深一点理解能感觉到他的不凡之处\n\n你们上课要是收起手机，也收起书本，不要干别的事，静下心来跟着老师的节奏走，真的会有不同的感觉\n\n这名老师上课不是为了考试，他完全不会讲书，考试要考自学，谁的马原课还不是靠自学了，但他对哲学的探讨很深刻，能感觉出来他很想跟我们讲一些他对哲学的感触但可能由于代沟或者表述的问题，同学们往往不能接受，反而会觉得他在浪费时间。\n\n只能说听得懂的人会觉得他是个哲学家，听不懂的人会觉得他只是个空谈者。
131777,1559,金建伟,2021-01-29 01:51:41,0,4,4,别人我不清楚，但老师对我给分是仁至义尽了。老师的哲学功底相当深厚，但分析社会现象就有点令人无语了，而且老师总给我一种优越感很强的不适感，最后一学期上下来只记得自杀了。另外，老师口音过重，听着很不舒服，事倒是很少。
131785,1559,金建伟,2021-01-29 02:48:17,5,5,0,不要被评分耽误了
134336,1559,金建伟,2021-03-24 06:18:54,-10,1,11,事贼多
134337,1559,金建伟,2021-03-24 06:19:56,0,1,1,哲学课
136812,1559,金建伟,2021-06-25 03:52:48,28,33,5,考虑到仍然存在的一些缺陷，给了九分，作为文科生我对理工所知不多，觉得很多理工学生说的金老师对一些观点理解不够深入但还是自己提一些不正确的观点，这一点就是缺陷吧。但是术业有专攻，一个学哲学的人，如果没有富兰克林的水平和能力，在很多方面做到精通是很难的，很多深思熟虑的观点对于水平高的专业学生来说确可以说确可以说“贻笑大方”。\n\n按下反感的情绪希望大家仔细思考，为什么不了解就不能去讲了呢？这不是著书立说，也没有灌输思想，而是阐述他自己的思考。思考可以辩驳，你不会因为当面驳斥被扣分。为什么在思考哲学的时候选取的例子成了这么多人的关注点？他是农村人，每个人最先想到的是贴紧自己生活的事情并没有什么罕见奇怪，只是和我们丰富多彩的生活相去甚远罢了，那为什么只是刺耳就需要那么反感呢？乍一听来确实是刺耳，认真听几节课，仔细想一想，很多例子是切题的，虽然有些不够透彻（这个老师语言水平确实有限），思想深度是有的，那些最简单的例子是能起到真正启发人进入哲学世界思考的效果，除了乍一听刺耳一点又怎么样了呢？小大之辩是真的那么难以分清吗？\n\n老师土吗？确实土，但也真诚，这样的思政课老师不多，并没有那么多人冒着质疑或者上面的压力来做这样的工作，有些人用马原课本糊弄一下学生就够了。
137291,1559,金建伟,2021-07-03 02:31:34,11,12,1,金老师看过的书非常多，作为一位哲学系毕业的老师，讲解一些观点也是非常深刻的。但可能是因为书读的比较多，导致举例子毫不避讳，一些情况下，举的一些例子虽然仅仅想要说明观点。但难免给被举例子的人带来困扰。特地在给分前来评价，也避免主观上的误判。
138749,1559,金建伟,2021-07-10 16:06:39,16,18,2,抱着不好的期待来听马原课，但是老师并没有出现曾经评价中的那些频繁谈及令人反感词汇和案例的缺点，老师也会看查老师评价，而且看的出他是想努力改进的。至于课堂本身，老师讲课本内容较少，会介绍很多其它的哲学思想，而且由于老师书读的很多，会引用其它学科的内容来论证，虽然有时候可能有些门外汉指手画脚的感觉，但是能get到老师得意思就好。如果想考试考的好的话需要自己额外花时间。根据老师自己的说法他会在正态规定的范围内给同学打最高的分，而且平时作业也不多，总体来说老师人还是不错的，个人认为不像评分那么不堪，可以一选
138797,1559,金建伟,2021-07-11 01:39:50,8,10,2,上课的准备很认真，讲的内容也很有深度，虽然有时候例子举的比较俗，但是讲的真的很好，老师人也很好相处，评分不能说明一切
138799,1559,金建伟,2021-07-11 03:06:10,16,17,1,终于拖到现在才来说几句。不要被当前的评分欺骗了。一个人的行为总是受到他此前的经历影响的，金老师本科是学自然辩证法的，也学了不少自然科学的知识，所以会谈几何、量子力学、用物理学举例，另外对于计算科学的前景也非常肯定；研究方向是西方哲学，所以会拓展许多这方面的思想观点，虽然烧脑，但确实能使你从以前固定的思维模式中挣脱，去思考一些东西，而不是单纯的刻录。可能这些观点中有点唯心的吧，但是有无相生（说起来，考试有个题，“万物负阴而抱阳，冲气以为和”，选了朴素辩证法，而不是客观唯心），你不了解唯心，却就直接说自己是坚持唯物的，这有点盲目吧？这个世界太复杂了，请先思考再形成判断，哪怕表述是正确的（比如一元论是什么的那道题，或许真的会有几个人直接因为“惯性”选了唯物论吧）。\n\n   至于考试的内容，自己多看书吧（我想在别的教学班应该也是相似的，毕竟这还全都是选择题，有不少定式，肯定是得自己过一遍书的，建立好映射（X））。至于平时分，同意楼下，我觉得是拉的挺高的，而且事确实少。
139436,1559,金建伟,2021-07-15 13:39:19,4,5,1,老师上课的内容的确不太容易理解 但评分也不至于那么低
140803,1559,金建伟,2021-09-16 07:51:26,-3,1,4,第一个让我在第一节课给他1分的
141414,1559,金建伟,2021-10-08 00:14:48,-5,0,5,就会分组
141417,1559,金建伟,2021-10-08 01:31:25,-3,0,3,代课的不行
141508,1559,金建伟,2021-10-12 13:38:09,-6,1,7,事情多的要死，和别的老师合上的课不是挂他的名半路来上突然要小组讨论还是和别的组辩论，就一个星期准备时间，这门课现在又要论文又要小组讨论又要考试，负担极重。上课也不知所云，毫无逻辑，点学生起来回答不听人家说完就开始反驳，说的话一点根据都没有，就感觉是村头大爷在倚老卖老无理取闹
141552,1559,金建伟,2021-10-14 06:49:10,2,2,0,讲的有点慢，但是挺好的呀，不知道为啥分数这么低
141929,1559,金建伟,2021-11-01 06:11:31,2,3,1,挺好的，与从小到大的思政课不太一样
142797,1559,金建伟,2021-11-16 08:21:57,2,2,0,给分真好
144516,1559,金建伟,2021-12-22 04:08:33,8,10,2,虽然关于哲学，我只是门外汉，上课也没认真听\n\n但是我认为\n\n凭金老师上马原课时展现出的博闻强识\n\n完全有资格担任哲学系主任\n\n带马原课着实有些屈才
145508,1559,金建伟,2021-12-30 05:27:53,6,6,0,其实老师是一个很有思想的人，认真听的话是会有收获的。也很考虑学生的意见，一开始是固定座位的，但是在学生反映意见之后也通过投票来决定。
145509,1559,金建伟,2021-12-30 05:29:16,3,4,1,事情一般，主要是想把东西讲明白，想拓展的可以学学，应试人快逃~
145513,1559,金建伟,2021-12-30 05:38:37,3,3,0,看出来老师很努力地想提高同学的评分在改进课程了……但是又不想讲得很应试，哲学部分讲得比较难而多，注定是比较有争议的 然后个人感觉无关的话有点多 还是祝愿老师讲课越来越好趴
146773,1559,金建伟,2022-01-07 11:59:36,6,6,0,我是今年春夏学年上的老师的课，一开始看到査老师的评分还有点害怕，但一整个学期上下来，感觉老师真的有很努力的在听取学生们的意见，甚至关于上课是否要签到都选择让同学们投票决定。前几次课上课容易走神所以感触不深，但后来由于那个据说三个月的检查，课上手机平板电脑都不让使用之后发现老师上课其实挺有意思的，讲的内容更哲学一些，虽然我本人哲学素养不够但能看出老师学识渊博。最后马原考试多看几遍课本问题都不大，不要被以前的一些评论影响了，老师现在真的有很认真在改进。
148069,1559,金建伟,2022-01-11 12:34:17,7,8,1,老师好的地方也是老师不好的地方吧。金老师非常看重哲学部分也用了很多心思去备课，如果能用心去听收获会很不错的。但这一点也是辩证的，好的地方恰恰就是不好的地方，不同的主体有着不同的评价标准吧。
148127,1559,金建伟,2022-01-11 14:33:05,0,2,2,金老师属于那种比较沉浸在哲学里的学者，显得比较呆，说话不分场合，比喻也很不雅观，言语不恰当，表意不明，可以说他比较适合做研究，与人交流还是有点障碍\n\n哲学与思辨吧，跟上老师的思路不简单，可以看出在努力教学了
148157,1559,金建伟,2022-01-11 16:30:05,6,6,0,老师是好老师，至少对教学这件事很在意，是想认认真真交给学生知识的，就这一点已经比那些天天念ppt无心教学的老师强太多了
148851,1559,金建伟,2022-01-13 17:36:12,-14,5,19,含泪打一分
149124,1559,金建伟,2022-01-14 13:15:20,3,8,5,大家真的不要被评分耽误了，金老师的课上只要你按照老师的要求来，积极发言，认真完成作业，不用卷也能得90+。
151427,1559,金建伟,2022-03-03 03:59:38,4,6,2,给分超好
152544,1559,金建伟,2022-04-14 09:58:03,6,9,3,真的不要被评分耽误了，绝对的好老师！虽然有时候同学认为他的比喻或者观点有点不妥，但是不可否认老师是一个哲学大家，而且鼓励大家思辨。事少分好！
154989,1559,金建伟,2022-06-07 08:35:36,0,1,1,好好好
156983,1559,金建伟,2022-06-21 13:11:42,1,2,1,感觉老师已经很努力了…
157103,1559,金建伟,2022-06-22 02:39:00,3,5,2,老师非常虚心接受意见，看得出来他希望上好这堂课
157162,1559,金建伟,2022-06-22 06:02:12,3,5,2,老师是哲学系出身，所以从授课方式上来看更像是哲学课而非思政课；\n\n事情很少，就小组展示+平时3000字读书笔记，大家也不卷，最后平时分给满了。
158305,1559,金建伟,2022-06-28 08:05:51,7,13,6,金老师很有思想，不幸的是金老师因为“查老师”中各种批评而做出了妥协，满足了学生，逐渐失去了原有的光辉。更不幸的是，不知道有多少好老师同样因为“查老师”而妥协，原本平庸的老师成了好老师，而原本的好老师也走向平庸。悲夫！我浙学生！
159702,1559,金建伟,2022-08-23 14:21:37,0,1,1,感觉老师很用心
162130,1559,金建伟,2022-11-17 03:12:15,8,8,0,金老师真的是一个真心希望学生能够学到东西的老师！
163370,1559,金建伟,2022-12-14 03:09:38,3,3,0,老师备课很认真，拓展的东西有难度，但会体谅学生，尽量讲我们能理解的知识
165082,1559,金建伟,2022-12-29 04:19:35,-2,1,3,尊重学生，但不太适合做老师吧。讲课风格对于马原这种课而言，似乎是很不讨喜的一种。
166388,1559,金建伟,2023-01-12 06:43:50,3,5,2,金老师10保命
166420,1559,金建伟,2023-01-12 08:24:23,10,10,0,虽让上课很哲学，让人不想听，但是给分还不错。没有发言（没听课），期末背了三天（摸鱼占多数时间）给了4.5
166422,1559,金建伟,2023-01-12 08:34:36,5,5,0,老师人挺好的，能看出是有自己的思想的老师，但哲学零基础的同学慎选吧。高中没学过政治，上课不太听得懂，哲学小白也很难参与到讨论里面，总的来说就是没什么参与感。读书报告花了点心思，期末断断续续补了一周的天，勉强上4了，还是谢谢老师。
166423,1559,金建伟,2023-01-12 08:35:09,5,5,0,金老师比较偏哲学（马克思主义最基础的就是哲学了），只能说上课听的内容能加深你的思考，但不能提高你的分数。\n\n本人平时不听课不发言，考前刷完考研课+狂背，最后4.8，想卷高分，今年的选择题非常简单，考研课讲的重点就够用了，主要还是靠押题和背吧，听说大题扣的挺狠的。
166429,1559,金建伟,2023-01-12 08:47:09,-3,0,3,上课听不懂，给分一般，事情几乎没有。
166443,1559,金建伟,2023-01-12 09:30:36,6,6,0,金老师上课风格真的改进了很多！经常顾虑学生的上课体验，如果太难还会讲得简单一些。事情不多，期末最后还有往年的真题讲解，最后给分也是能捞则捞！
166456,1559,金建伟,2023-01-12 09:47:06,5,5,0,金老师上课喜欢启发人思考问题 独立思考就会被认真对待 我读书报告写的都是自己的思考（一篇学术垃圾）然后期末好好背了原理方法论 绩点很不错
166696,1559,金建伟,2023-01-13 08:52:18,-11,2,13,卡绩大师
166875,1559,金建伟,2023-01-14 04:36:35,6,6,0,给分还行吧，读书报告4800字（封顶5000），上课发言四次，别的平时作业也认认真真完成。我工科生，高中没选政治，考前复习两天也拿了90分。
167002,1559,金建伟,2023-01-14 14:28:13,16,17,1,就内容而言，本人高中政治选考生，上过哲学基础，个人而言说实话上课是真听不下去。一是老师要讲哲学但又讲不清楚，讲到关键点处又来一句“这个又太难了就先不说了”，让人极为疑惑；二是思路不清楚，讲话没有重点，颠来倒去浪费时间，听着莫名会上火，所以结果就是一旦试图听课就真的会很烦躁。但是老师似乎觉得自己上课挺好，甚至展示学生夸他的邮件之类（还挺多次）……我也不是很明白为什么……抛开这些不谈，点名和排座位和要不要小测都民主决定，以及给分而言，都挺好的，平时分可能拉满了，最后4.8。所以我的建议就是上课不用听，认真按提纲背书就行，毕竟都是水课，不用锱铢必较课堂质量了。
167632,1559,金建伟,2023-01-18 01:30:59,18,27,9,金老师的课现在完全高出査老师现在这个评分，从上课、给分、平时作业的量的情况来看，上9.0完全不是问题，大家如果预置课是这个老师或者选上他的话，完全不用后悔，老师上课很有自己的思想，挺有意思的。平时作业和事情都少，给分也不错。
167711,1559,金建伟,2023-01-18 13:21:40,4,6,2,马原4.8，考前狂背+刷题。金老师上课有一种哲学家的气质在，在我们班上可以和一位哲学专业的同学聊得很投机，但很抱歉我认真听了大半个学期之后还是不可避免地走向了摸鱼的深渊……真不太听得懂啊QAQ，能感受到金老师为了照顾听不懂的同学，在尽量降低课程难度，跳过了很多更难的东西，同学给他发的邮件他也都认真读了，奈何本人的水平有限，实在跟不上老师……课程任务应该不算重的，书评和小组展示应该是所有马原课都有的吧，上课签不签到和展示选题之类的都是民主投票决定的，我觉得挺好。一开始被预置金老师的时候看到查老师的评分还有点慌，但是上了一个学期下来感觉还可以，老师值得更高的评分。
171170,1559,金建伟,2023-03-17 08:34:57,-1,1,2,“真正的课堂是讨论，不是简单的知识的灌输”
171560,1559,金建伟,2023-03-29 00:48:23,3,3,0,诡辩，新中特不讲马哲也没有其它的哲学深度，稍微有点哲学知识和思辨的就能看出他讲的既无深度也无组织，民科的感觉。低俗梗现在没有讲了。
172123,1559,金建伟,2023-04-20 03:11:54,1,3,2,有点诡辩...
175487,1559,金建伟,2023-06-25 07:36:11,2,3,1,事情挺少的，小测改自己出题了—金老师估计看过查老师，现在是小心翼翼战战兢兢，给分、要求已经是尽量顺着同学们了，纯功利角度也是不错的。\n\n讲课的想法还是很不错的（苏格拉底式的教学），确实对马哲有了更深的一点认识。但拓展的部分有些还是讲不太清楚，有时候讲到关键又戛然而止略难受，另外他上课压迫感也很强，略坐牢。“诡辩”这一点我觉得需要为金老师辩护，金老师这节课从头到尾没有阐发过“自己的意见”只是在讨论问题，他“诡辩”的形式只用于启发同学。好比运用马哲时必然有异见出现，对付这些异见需要的是对自己的理论“否定之否定”，阐述异见的荒谬性，而不是给异见贴一个诡辩的标签。
176516,1559,金建伟,2023-06-29 07:29:51,3,6,3,虽然说老师现在的评分是6点几，但我觉得他完全值得一个9+\n\n就上个学期的情况来看，事情很少，一篇小论文或读书感想，一次小组展示，以及期中自己出题，还有就是给他发自我介绍，都是马原课比较常规的\n\n就是如果你想摸鱼，那么上课有点坐牢。但如果能投入讨论，那我觉得还是不错的，至少你能收获很多，老师本人也非常博学，我觉得比好些自以为懂很多的人要好
176543,1559,金建伟,2023-06-29 08:34:08,3,7,4,今年改分严教的好教的不好感觉高下立判。所谓哲学不是讲不清楚的哲学，想好好学习马原的同学不是很建议来上金老师的课。
181172,1559,金建伟,2023-10-10 14:43:39,7,12,5,哲学系学生表示他就是骗子🤣简单东西讲不清楚故弄玄虚，难的东西根本不懂🤣🤣🤣🤣浙大的郭教授就是他了🤣🤣🤣
181746,1559,金建伟,2023-10-30 14:33:24,-3,2,5,史史史
183530,1559,金建伟,2023-11-27 06:40:02,2,5,3,下面的哲学系学生，不知道的还以为是哲学系大师呢。。。这个发言的高度。。不像个学生
183644,1559,金建伟,2023-11-28 06:28:51,2,4,2,感觉普通话有点不清楚不过还行，讲着讲着就不知道在讲什么但是他自己会讲得有点急了，有的时候我感觉逻辑不是很顺，有点诡辩的意思，总结是我本人不是很爱听
185122,1559,金建伟,2023-12-26 11:30:08,-1,2,3,特别喜欢诡辩，上课必谈性，让人生理不适。
186054,1559,金建伟,2024-01-08 05:11:58,0,2,2,喜欢对自己不懂的东西夸夸其谈，楼下说得好，浙大郭子
187238,1559,金建伟,2024-01-15 09:40:56,-5,1,6,给分不好，上课也烂。
187275,1559,金建伟,2024-01-15 11:13:51,3,3,0,总共点过两次名，事情不多，老师人真的很好，绝对是会捞捞的。
187278,1559,金建伟,2024-01-15 11:22:00,0,0,0,事很少 上课可以干自己事情 教学水平不好评价但是给分好
187658,1559,金建伟,2024-01-17 03:42:09,4,4,0,下面说给分不好的？？？？？给分很好，期末考九门没怎么复习（没看过书，刷了两章选择题，13分钟b站马原大题教程）上4了，虽然是88，但是很感谢老师捞捞，平时分应该满了的，期末我最后一题机器人肯定答错了，虽然88但是已经很满意了，谢谢老师，上课很认真但比较难懂，想学到东西建议看看往年智云看看合不合适自己
189027,1559,金建伟,2024-01-21 09:54:39,0,0,0,还行，给分不错
189945,1559,金建伟,2024-02-03 10:47:08,0,2,2,金老师是很博学的，给分很好！！
193128,1559,金建伟,2024-06-04 02:08:51,4,4,0,认真听课的话会发现是一个很好的老师，一直都在尝试着启发思考，举的例子确实很清奇，但是很有趣。老师经常上课的时候自己跟自己辩论起来，很可爱，有时候喜欢诡辩。事情不是很多，给分还不知道。
193467,1559,金建伟,2024-06-11 07:19:12,3,3,0,老师学识渊博，事情不算多，很努力地想让我们学一点马原的知识（但我想大部分人都不想学）
194866,1559,金建伟,2024-06-25 18:19:08,-2,1,3,事情少，给分好
199796,1559,金建伟,2024-09-30 03:22:16,8,8,0,纯民科，听他的课就是一种折磨
199806,1559,金建伟,2024-09-30 04:28:06,5,5,0,拖堂。。
201490,1559,金建伟,2024-11-04 01:08:16,0,1,1,感觉他自己都不明白
204893,1559,金建伟,2024-11-28 10:43:40,0,1,1,神经一个
205110,1559,金建伟,2024-12-01 15:58:54,4,5,1,让学生出80个选择题真有你的
207014,1559,金建伟,2024-12-19 03:47:32,2,3,1,事情少，给分好，课不听就好，没必要骂 \n\n以下是一些对之前评论的客观答复\n\n1.“听他的课就是一种折磨 神经一个 感觉他自己都不明白”我想说你不会认真听了课吧 \n\n2.“出80个选择题”我想说ai只需五分钟，不会善用科技那是你的问题\n\n3.“拖堂”我想说这学期确实有这一现象，但是看得出来老师在极力避免了（而且我并不太在意多几分钟来学习或刷视频）\n\n综上不至于6.7，是补选的不二之选
207541,1559,金建伟,2024-12-23 03:13:14,2,2,0,还没结课，但老师一定不只6.7\n\n期中考试被换成了80个选择题，而且要求8个题原创就行，其他都可以直接找网上现成的题\n\n老师可能上课有点难懂，平心而论可能与课本是有些不贴合的，他自己也经常说课本不太好\n\n老师人很好，课上直接说了平时分按最高给\n\n总而言之，分不至如此低，给了十分
207890,1559,金建伟,2024-12-25 02:19:02,-1,1,2,老师人还行，8分差不多，不过要回复下面那个说用ai出题的人，凭什么不用ai就是学生的问题，你自己面对这么庞大的作业量用科技偷工减料还要对自己的丑行说的冠冕堂皇，你很骄傲吗，出80个选择题这种作业量就是不合理，这也要护吗
209542,1559,金建伟,2025-01-06 08:15:10,4,4,0,上课确实折磨，一学期没学会什么，不过给分确实很好，几乎顶格给分，还是建议选的
209546,1559,金建伟,2025-01-06 08:37:00,1,1,0,还可以
209558,1559,金建伟,2025-01-06 08:51:21,1,1,0,老师人很好的
209560,1559,金建伟,2025-01-06 08:51:44,4,4,0,1.因为我思政课都不咋听，所以不评价讲课吧。老师有很多特别的要求，有时候讲的不是很清楚（比如排座位大家都没听懂到底要咋坐），但是他应该经常看查老师，感觉有在努力改变一些同学对他吐槽的点。\n\n2.期中我室友老师是小测，金老师让我们出80道选择题并且标明在课本的出处，上交的时间也临近期末。老师的用意是不要过早拉开平时分差距，并且让我们顺便复习一下，其实我完全可以理解！（虽然80道真的有点多…）然后我这个好好做了，没有去网上抄，期末考前没再翻书，考到的一些内容的确在我出题的时候复习到了（算运气好吧）。\n\n3.如果从成绩的角度，我感觉金老师已经把平时分努力拉满了，想要给分好选他应该没错。\n\n4.不太清楚金老师有没有划重点，但我背了一个cc98上的提纲（其实就是辩证唯物主义、历史唯物主义、政治经济学，我看历年回忆卷也是大题就考这三个），再凭借一点三年前高中政治学考的模糊印象，期末考试大题基本就可以咔咔写了，感觉应该考的还可以的。\n\n5.出分很开心，谢谢金老师和助教！
209562,1559,金建伟,2025-01-06 08:53:30,1,1,0,水是真的水，事情比其他老师要少，给分也不错，感觉同学反应的一些问题也有在改正，虽然最后被卡绩了，但是水成这样我觉得也还行
209639,1559,金建伟,2025-01-06 11:47:14,0,0,0,好好好
209689,1559,金建伟,2025-01-06 14:22:01,6,6,0,大一新生，没听过课，复习了两个下午，第一个4.8，感谢老师，感谢党和人民，感谢马克思恩格斯
209734,1559,金建伟,2025-01-07 01:57:02,0,0,0,时不时点名，但是上课你干啥他只是说说不会真正管（建议最好是前几节课多回答一点问题然后给班长报告，我就有好几次都没给班长说导致平时分没有拿满😭）。虽然期中作业要求出60多个选择题但是至少没有期中考试不会狠狠扣分。一学期下来课几乎没听拿了个85，虽然卡绩但是也很满足了
209956,1559,金建伟,2025-01-07 14:36:07,0,0,0,虽然不太听，但个人觉得讲课水平还是不错的，比较有深度。给分这个方面必须好评，平时分不仅给得高，而且会比较平均化防止内卷过度。我作业迟交了一项，没想到最后绩点还被捞到4.2了👍
210536,1559,金建伟,2025-01-09 10:17:50,0,0,0,很偶尔会点名，是雷达点名，但是是可以找他下课补签的。学期初刚选上老师评分很低，但是老师确实是有在看查老师，也有自己的调整的，至少这个学期的体验绝对不止6、7分。平时事情很少，一个辩论，一个自己出题目，还有选课后的自我介绍邮件。老师平时是要求课堂听课的，但是实际也不怎么管。讲的也没有听不下去的感觉，而且马原确实主要靠背书。老师平时分应该是尽量给了，总之如果想要水一点混绩点肯定是没有问题的，老师人也挺好的
211064,1559,金建伟,2025-01-10 12:41:14,0,0,0,社会主义发展史：点名但不多（2次）两次小测＋3k-5k的论文（小测开卷）总体事情比较少，给分也不错（满了），这门课还是比较推荐选的（我是没学过政治，历史的工科生）
212240,1559,金建伟,2025-01-13 13:50:59,0,1,1,老师是的马原课超级有水平，讲很多哲学的东西，启发思考，本人超爱听\n\n老师给分也很好
214603,1559,金建伟,2025-02-14 08:48:35,1,1,0,上的老师的马原，感觉老师现在改了挺多，＂逆天”言论少了很多。而且老师人挺好，课后也给补签。上课任务不多，一个自我介绍，一次小组辩论展示，一篇文献综述或论文，个人感觉给分不错，平时分给的挺高，如果想水一水的话放心选。如果追求对马哲的学习探讨我就不确定了。
214651,1559,金建伟,2025-02-15 19:43:33,1,1,0,好好好
215444,1559,金建伟,2025-02-26 06:36:20,0,1,1,非常好哇非常好，大学第一个4.8
220039,1559,金建伟,2025-06-14 03:48:06,0,0,0,还可以
220686,1559,金建伟,2025-06-19 08:24:01,0,0,0,签到三次没签上拿了4.2
221916,1559,金建伟,2025-06-27 11:43:56,0,0,0,虽然偶尔上课签到，但是下课都可以补签\n\n虽然上课喜欢在教室里逛来逛去，但是你做啥老师也不会管你\n\n虽然上课学不到什么东西，但是马原课似乎都差不多，考试前还是会告诉你考哪里\n\n好老师，可冲👍
1360,1569,封丽萍,2017-12-25 11:52:28,86,117,31,老师上课好好听收获还是很大的，课堂互动多，上课挺开心的。封老师人也很好，经常和学生交流
2144,1569,封丽萍,2015-04-02 13:57:46,2,7,5,老师人真的超级超级好 上课也特别认真 思修被她讲得还挺有意思的
2913,1569,封丽萍,2015-05-11 03:03:52,4,7,3,老师人超nice，选了老师的所有课
3338,1569,封丽萍,2015-06-02 11:30:18,2,5,3,人很好，上课按小组坐，小组作业和展示压力不是很大，上课发言有加分，讲得不错。
4077,1569,封丽萍,2015-06-17 16:11:33,2,3,1,很好呀 老师人很和蔼
4093,1569,封丽萍,2015-06-17 16:44:27,15,21,6,老师讲的很好，但上学期思修没有翘过一节课，作业也好好完成了，但分数不高，还是我自己没好好复习吧
4300,1569,封丽萍,2015-06-18 17:55:49,11,12,1,老师人很好 很亲切
4332,1569,封丽萍,2015-06-19 04:37:38,2,5,3,老师人很nice的，给分也不错
4434,1569,封丽萍,2015-06-23 03:00:29,0,2,2,老师人很好，交流多！
5167,1569,封丽萍,2015-07-05 13:12:30,0,5,5,人很好，很亲切～上课也很有趣，不水但也不会作业繁重～大力推荐～
5213,1569,封丽萍,2015-07-06 01:08:28,0,7,7,特别特别好，讲的很有意思，给分还很棒，特别体谅学生～果断推荐～
6132,1569,封丽萍,2015-07-11 05:51:31,4,8,4,呵呵
6283,1569,封丽萍,2015-07-12 15:38:08,2,5,3,认真负责的老师，不错。
7482,1569,封丽萍,2015-09-14 16:57:31,2,4,2,特别好的老师
10242,1569,封丽萍,2015-11-17 15:17:09,0,3,3,很好的思修课。
11087,1569,封丽萍,2015-11-24 05:49:46,0,6,6,卧槽，她的普通话真的。。。。z，c，s和zh，ch，sh她完全分不清!
11878,1569,封丽萍,2015-12-20 03:54:19,1,2,1,排空呢个(⊙o⊙)…
12034,1569,封丽萍,2015-12-21 14:32:24,43,48,5,老师不直接点名，但是会小组固定座位，就是说前排没来的一眼就能看出来，人很温柔不发脾气，讲课还不错虽然没什么用，其实思修还是看自己的，这老师挺好的
12317,1569,封丽萍,2015-12-23 02:57:36,2,3,1,和蔼可亲
12504,1569,封丽萍,2015-12-23 11:44:20,3,4,1,老师好温柔的说
12698,1569,封丽萍,2015-12-24 02:10:40,3,9,6,总是在过道里走啊走，在大家没有觉察的情况下就把人数查明白了，然后让各个组长汇报本组没来的人。所以绝对不能翘课啊！
13810,1569,封丽萍,2015-12-31 07:36:41,12,18,6,可以，老师挺好，思修我们组另外五个人都不需要思修成绩，原来以为被坑惨，还好，刚上4\n\n
14264,1569,封丽萍,2016-01-06 02:50:51,0,4,4,考试很棒 思修课不无聊 很有趣
14466,1569,封丽萍,2016-01-07 07:20:01,24,32,8,封老师真心很温柔，法律部分讲的超级好，注重与学生的交流，循循善诱，只是作业稍有一点多。
15054,1569,封丽萍,2016-01-11 16:59:14,73,96,23,人挺好，作业也不算多，但是翘不了课！！而且发言加分，个人真的不喜欢这种方式。
15211,1569,封丽萍,2016-01-12 15:41:04,4,10,6,公平正义善良的思修课却展现给我不公平不正义不善良 这课真是不能再糟糕了
15364,1569,封丽萍,2016-01-14 04:48:36,1,2,1,老师很和善、很开放
18374,1569,封丽萍,2016-02-08 15:43:14,0,2,2,还好吧
18904,1569,封丽萍,2016-01-22 17:39:33,9,14,5,按小组不能翘课 讨厌发言加分 好多人课前演讲很糟糕完全浪费大家时间
19147,1569,封丽萍,2016-01-23 10:57:02,19,23,4,人很好，有气质，上课有干货，案例分析有趣，给分超好
19217,1569,封丽萍,2016-01-23 14:19:48,0,3,3,给分不公啊，随便发个言比真正学的人给分要高……老师人倒还好啦
19299,1569,封丽萍,2016-01-23 23:55:04,-1,1,2,表示上课没发言没做课前演讲也上4啦，老师挺好的，案例很有趣
19306,1569,封丽萍,2016-01-24 00:43:35,1,5,4,给分差
19341,1569,封丽萍,2016-01-24 02:27:23,0,3,3,点名，分组，文章，微电影（感受），网络学习，案例分析，发言、演讲加分，关键最后考试，核心价值观记一下，最后大学生怎么做看一下，别提前交卷，检查
19355,1569,封丽萍,2016-01-24 02:51:43,0,2,2,老师很棒，这学期发言，做演讲，给分还不错，就是差一分就多0.3啦。。。不过对于期末还是没怎么认真复习的我来说，也知足啦
19360,1569,封丽萍,2016-01-24 02:58:04,0,0,0,封老师很耐心，讲课很细致，很喜欢封老师
19375,1569,封丽萍,2017-11-26 07:23:26,-1,3,4,很好的老师 虽然只给了我3.6但还是给9分
19386,1569,封丽萍,2016-01-24 04:33:50,1,1,0,无聊…
19417,1569,封丽萍,2016-01-24 07:19:40,0,1,1,非常好的老师 上课很有意义
19432,1569,封丽萍,2016-01-24 08:14:18,0,1,1,棒呆啦
19495,1569,封丽萍,2016-01-24 11:24:18,20,24,4,思修能上成这样真的很厉害了！事情不多，讲得不错，给分也高~
19537,1569,封丽萍,2016-01-24 14:57:58,0,1,1,反正和这门课一样，上课的内容没意思，作业评的也烦
19540,1569,封丽萍,2016-01-24 15:11:08,3,6,3,老师人很好很温柔，就是回答问题和课前演讲太功利，而且给分也不好，付出的不一定能有回报！思修给我拉分了…
19644,1569,封丽萍,2016-01-25 04:01:14,0,2,2,温柔，课不水，给分好
19649,1569,封丽萍,2016-01-29 06:46:44,0,0,0,变着法子点名
19757,1569,封丽萍,2016-01-25 08:47:20,-1,4,5,我不在的那节课，专点我名。绩点3  无论你作业做多好 期末考多好 一次翘就完蛋 如此残忍
20074,1569,封丽萍,2016-01-26 04:53:55,0,0,0,作业多
20365,1569,封丽萍,2016-01-27 07:10:42,0,3,3,给分实在是好，真的很体谅学生，作业的话不算麻烦，很好的。讲的也很生动，如果想提高思修分数建议平时要认真，课堂展示什么的要做好要积极，要拿出认真的态度来。
21319,1569,封丽萍,2016-02-28 04:12:31,-6,2,8,思修\n\n有几次变相点名，让回答几道判断题之类的。\n\n上课讲得其实有点无聊，但是如果想刷高分还是挺容易的。最后4.8，感谢老师
21815,1569,封丽萍,2016-03-01 07:18:33,6,19,13,老师还好吧。我上的是法学基础，作业真的多而麻烦。一门通识课为何比思修还麻烦，简直了。希望想选这门课的同学多多考虑一下。
22005,1569,封丽萍,2016-03-02 05:38:09,0,2,2,法学基础 梁清华思修的翻版 无语了
24846,1569,封丽萍,2016-07-08 04:53:18,2,3,1,封老师人超级好，给分也不错。
25603,1569,封丽萍,2016-10-19 08:08:34,11,14,3,老师我爱你，工信边淞强推！！
25936,1569,封丽萍,2016-06-14 12:37:35,0,0,0,给分比较好。。。。
26697,1569,封丽萍,2016-06-21 02:42:44,0,0,0,要拍微电影 有点麻烦 上课最好随堂演讲 个人认为没有什么意义 还要发言 事情还是蛮多的
29927,1569,封丽萍,2016-06-30 14:01:14,3,4,1,法学基础课主要会讲一些有趣的民法案例，认真听还是有一些收获的，平时事情略偏多，给分似乎还不错
29935,1569,封丽萍,2016-06-30 14:15:01,0,0,0,讲很多贴近身边的案件 很有意思
29939,1569,封丽萍,2016-06-30 14:22:30,-1,1,2,法学基础，我选做作业没做，上课没发言也4.5了。上课看个人爱好了，自觉得还是有点干货的，不过每节课都要到啊
30185,1569,封丽萍,2016-07-01 04:52:09,2,2,0,法学基础，老师很亲切，案例讨论也很有意思，给分不错，要记得多发言呀
33802,1569,封丽萍,2016-09-22 01:04:09,1,1,0,对一个不喜欢听这种课的人来说封老师的课很不错，能听进去
33907,1569,封丽萍,2016-09-22 11:57:35,3,4,1,通识课事情多，但是认真做给分就蛮不错的。
34145,1569,封丽萍,2016-09-27 12:30:17,1,1,0,很给力啊
38364,1569,封丽萍,2016-12-01 02:15:48,1,4,3,不说啥了…怪我自己没好好学思修吧。但是真的不太习惯要背一本书的闭卷期末考试。楼上说的没错，从不点名，但是按小组坐能看到谁没来然后记录??很温柔这是加分点，但是…思修对于理科生来说就是一场屠杀。好多历史政治的东西忘得差不多了还要从头再背??
38570,1569,封丽萍,2016-12-09 04:34:34,-2,0,2,尼玛。真烦。课水的要死还事情多。\n\n
39365,1569,封丽萍,2017-01-21 01:48:19,14,15,1,小组大作业gg了，以为会被正态，结果最后给分好还是上4.2了！封老师人温柔讲课好轻松不正态哦
40054,1569,封丽萍,2016-12-29 02:59:42,0,0,0,老师挺好的，很温柔，你没来也不会说什么
41332,1569,封丽萍,2017-01-10 15:22:54,2,2,0,老师很漂亮有气质
45542,1569,封丽萍,2017-01-19 17:21:11,0,1,1,挺好的老师，上课挺自由，给分也很不错。
45570,1569,封丽萍,2017-01-19 22:59:34,0,0,0,老师很温柔啊，上课挺有趣的
45578,1569,封丽萍,2017-01-20 00:52:10,0,1,1,不错的
45600,1569,封丽萍,2017-01-20 00:18:52,0,1,1,给分好，上课很耐心很温柔，强烈建议学弟学妹们选择
45607,1569,封丽萍,2017-01-20 01:53:09,-1,1,2,发言加分真的伤，作业和考试分数都很好，因为没有平时分直接完蛋
45608,1569,封丽萍,2017-01-20 00:34:41,3,3,0,平时发言很重要
45613,1569,封丽萍,2017-01-20 00:46:42,1,1,0,呵呵呵呵
45665,1569,封丽萍,2017-01-20 02:20:21,0,1,1,老师人很好啊，很温柔，很耐心地解答问题，最后的小组案例讨论课很有趣，表白老师！
45698,1569,封丽萍,2017-01-20 02:56:00,0,1,1,课程参与度大大滴。
45704,1569,封丽萍,2017-01-20 03:13:08,0,1,1,老师给分太好啦！表白封老师
45719,1569,封丽萍,2017-01-20 03:40:45,0,1,1,老师人很温柔，讲的很好。
45748,1569,封丽萍,2017-01-20 04:17:37,0,1,1,老师很好，思修讲法律的时候启发很大，好像发言会加分，不过一次也没发过言也没事，两次大作业好好做。中途有一次选择题小测，其实只要认真按老师要求做就好了，给分棒棒哒~
45798,1569,封丽萍,2017-01-20 06:07:28,0,1,1,老师很有钱啊，很和蔼，作业需要上心一点
45832,1569,封丽萍,2017-01-20 07:03:26,2,6,4,老师教得hin好，参与课堂轻松满绩啦!老师家的花园可漂亮了!
45976,1569,封丽萍,2017-01-20 10:28:52,2,3,1,不点名但是安排小组座位，迟到和缺勤看得出。作业只有两三次小组一起的，整个小组有没有好好想创意认真做很重要，各小组互评分会影响你的分数，最后会有自评互评组长评。我们小组期中做了访谈视频拿了各小组第二，我做的相对多一点，期末没怎么复习靠三观考试拿了4.5。老师上课很不错，人也温柔，第一节课缺勤了跟老师一解释就让跟班听了没算缺勤。
46065,1569,封丽萍,2017-01-20 14:12:59,0,1,1,老师真的很温柔超级棒 考试基本靠三观但其实还是要看看书的 给分也很好的
46100,1569,封丽萍,2017-01-20 15:12:50,1,1,0,呵呵呵
50193,1569,封丽萍,2017-05-01 06:03:27,0,1,1,好老师，案例生动，好好看书好好写论文成绩不会差的。不动声色点名。
50219,1569,封丽萍,2017-05-01 11:57:57,2,2,0,有兴趣去听还有点儿意思\n\n没兴趣凑学分的，还是算了
51043,1569,封丽萍,2017-05-15 05:15:30,0,1,1,案例讲解很有趣，推荐法基
53456,1569,封丽萍,2017-06-26 15:48:17,2,4,2,人好给分好！
53502,1569,封丽萍,2017-06-27 01:06:34,0,1,1,老师超好超温柔，给分也很棒
53504,1569,封丽萍,2017-06-27 01:09:17,2,6,4,法学基础次次去，平时没发言，两个大作业都很认真在做，最后被正太了，79分，慎选啊
53945,1569,封丽萍,2017-06-28 06:01:46,2,2,0,没发过言所以错失满绩……老师很棒
54006,1569,封丽萍,2017-06-28 08:03:53,1,2,1,非常好！只要认真，绩点就高！\n\n
54175,1569,封丽萍,2017-06-28 15:09:59,1,1,0,棒棒哒
54777,1569,封丽萍,2017-06-30 08:10:45,2,2,0,没回答问题没做课外作业拿了84分，老师给分还是很厚道的
55380,1569,封丽萍,2017-07-01 11:48:51,2,2,0,事情的确多了点 不过大爱老师啊 讲课超有趣 绩点也很棒啊
56072,1569,封丽萍,2017-07-03 04:23:25,1,3,2,老师讲的很好，上课也很用心，一个没有考试的通识课，也非常认真的对待，给分也好。只是固定座位，可能会招某些同学黑。一句话，没兴趣不想上，你别选啊
57578,1569,封丽萍,2017-07-10 03:28:34,2,3,1,老师的法学基础很好 上课的案例分析很有意思 不过作业是有一点多啦 早做准备比较好 给分很不错～
59118,1569,封丽萍,2017-09-20 00:04:44,1,2,1,老师讲得很不错，人也很温柔。
60852,1569,封丽萍,2017-10-31 09:06:34,1,2,1,本来想写作业来着，总是被老师的课堂吸引，真心棒，还有就是总会收获不少东西，说不出来，但是对自己有帮助的东西~喜欢
65000,1569,封丽萍,2017-12-28 07:17:44,-2,1,3,老师真的很棒棒！人特别好，就是微电影比较尬，感觉人生做过的最羞耻的事情莫过于微电影了。
65001,1569,封丽萍,2017-12-28 07:20:05,-1,0,1,挺好的，不错的老师
65004,1569,封丽萍,2017-12-28 07:26:38,0,1,1,比较有人生感悟。
65012,1569,封丽萍,2018-01-26 11:41:48,-8,2,10,其实思修课上成这样很不错了，11级制没有正态给分也很好。没当组长，没发言，没展示，凭着1w＋的志愿者报告成功满绩。
65013,1569,封丽萍,2017-12-28 08:04:21,0,1,1,期末不考试开心
65073,1569,封丽萍,2017-12-28 13:27:19,0,1,1,温柔有气质的老师
65157,1569,封丽萍,2018-01-10 06:43:16,2,4,2,老师很好说话，但事情也挺多的，选择志愿者活动替代期末考，平时会忙一点，但考试周会轻松些，很多的小组作业，绝对不水
65398,1569,封丽萍,2018-01-03 15:05:37,0,2,2,预置思修老师，太幸运了\n\n上课会用mita签到或者抽同学回答问题\n\n作业不算多，上课很有意思\n\n我是免考班，拍了一部微电影，学到了很多\n\n
65846,1569,封丽萍,2018-01-09 13:42:18,2,4,2,不知道你们对好老师的定义是什么，但是我觉得封老师真的是一位善解人意的好老师，能师从封老师真是我一生的荣幸
66744,1569,封丽萍,2018-01-18 16:36:52,-1,0,1,预置封老师的思修是极大的幸运！
67348,1569,封丽萍,2018-01-26 16:51:24,-2,1,3,没发过言 讲课比较枯燥 但是给分好4.2
68290,1569,封丽萍,2018-01-23 02:41:58,0,1,1,这是一种享受
69418,1569,封丽萍,2018-01-24 15:32:05,5,7,2,女神！多揽活，认真对待。满绩很轻松
69425,1569,封丽萍,2018-01-24 15:41:53,8,9,1,老师人很好 很温柔 经常和蔼地笑 上的思修  这学期也就点了两次名  最后一次临近考试周还放了假  没有期末考试 用志愿者报告代替的  个人觉得整个学期思修基本不占时间和精力  除了写志愿者报告的时候飞了一点功夫  堪称绩好 谢谢老师
69428,1569,封丽萍,2018-01-24 15:50:44,1,1,0,很好的老师，温柔美丽大方，上课不落窠臼，作业有新意
69435,1569,封丽萍,2018-01-24 16:02:40,-2,0,2,老师真的超级温柔超级棒!交志愿者报告的免考班是五级制，给分超棒!
69436,1569,封丽萍,2018-01-24 16:03:53,0,3,3,老师太棒了！！！一次发言也没有也可以满绩！！
69437,1569,封丽萍,2018-01-24 16:04:46,-2,0,2,老师上课很和蔼耐心，讲的很好，给分也超好的！！
69439,1569,封丽萍,2018-01-24 16:05:40,0,1,1,有收获
69440,1569,封丽萍,2018-01-24 16:06:58,2,5,3,老师人很温柔，讲课也很有特色，可水，期末考试可免，认真听也很有收获，来浙第一门满绩！谢谢老师！
69441,1569,封丽萍,2018-01-24 16:09:24,1,2,1,人挺好的啊，给分也很好
69448,1569,封丽萍,2018-01-26 01:22:22,1,5,4,给分炒鸡好啊！！！！班里可以自己选择考试还是做志愿者活动，慢慢师生情
69450,1569,封丽萍,2018-01-24 16:24:52,5,6,1,不考试但是给分比较随意
69451,1569,封丽萍,2018-01-24 16:33:22,-3,1,4,课很美好，感动到哭，我真的快哭出来了，谢谢老师，我爱你❤❤❤。
69452,1569,封丽萍,2018-01-24 16:43:01,2,4,2,感动!大学的第一个满绩!谢谢老师。平时事不多，期末考试也不用特别复习，老师人太好了。
69455,1569,封丽萍,2018-01-24 17:23:26,5,8,3,被正太了
69466,1569,封丽萍,2018-01-24 19:42:52,11,15,4,没有缺课没有漏交作业只有3.2
69471,1569,封丽萍,2018-01-24 22:58:20,0,0,0,分舒服，事少，特别好
69476,1569,封丽萍,2018-01-24 23:34:26,0,0,0,很好的老师，能给我们讲很多东西
69478,1569,封丽萍,2018-01-25 00:13:56,-4,2,6,不算好吧，只有3.9，这种课真的还是要当个组长或者科代表什么的
69481,1569,封丽萍,2018-01-25 00:28:40,-3,0,3,老师给分好！！！老师很严！事情也多！但是不水！学到了很多！老师修养很高，很喜欢大一的思修课，感谢老师！教会我做人的道理和法律知识
69484,1569,封丽萍,2018-01-25 00:34:58,0,0,0,就是上课水水 思政课里比较舒服的老师
69490,1569,封丽萍,2018-01-25 01:00:09,9,10,1,一个优雅的女子，温柔又知性。\n\n善解人意，体谅学生，自由选择期末考或志愿者报告。\n\n可水可不水，法律案例分析十分有意思。\n\n提升思想修养，拍摄微电影、写读书报告、完成志愿者报告（感觉更像是一种对自己志愿活动的一个仪式），回望一学期的志愿旅程。\n\n不是组长或课代表，没有发言、没有展示，害羞如我，也可以拿到满绩。\n\n谢谢老师~
69498,1569,封丽萍,2018-01-25 01:20:09,0,0,0,给分
69519,1569,封丽萍,2018-01-25 02:13:06,0,1,1,老师会由全班投票决定思修期末是否要考试，免考班小组需要做调研报告或者拍微电影还有案例讨论，个人需要做读书报告和志愿者报告。老师上课很温柔，课堂也很生动，发言可以加平时分。虽然在平时没有发过言，但是每一次作业都认真完成，最后给了满绩，也学到了很多，很感谢老师！推荐选老师~也可以尝试一下思修期末免考哦~
69617,1569,封丽萍,2018-01-25 05:33:14,0,0,0,别的不说，我室友是最骚的
69712,1569,封丽萍,2018-01-25 08:57:59,2,3,1,hhh，认真完成了所有作业，最后拿了满绩。没有发言没有展示，拿到这个成绩挺意外的。\n\n老师人超级好，推荐选，给分很棒！
69745,1569,封丽萍,2018-01-25 10:09:46,-1,1,2,看什么查老师，封老师还用查嘛？封老师人超好，大爱封老师，选上这门课是你的幸运
69878,1569,封丽萍,2018-01-25 15:16:15,0,0,0,满分满分！不用考试，上课又有意思！
69882,1569,封丽萍,2018-01-25 15:19:16,0,1,1,没有发言没有展示～但是有在认真完成作业～满绩～还不用考试～老师人也很温柔很可爱～QAQ！敲棒！！！！！10昏是不够哒！给100昏！
69884,1569,封丽萍,2018-01-25 15:21:02,0,0,0,老师讲课特别好，人超温柔，救人于水深火热之中
69886,1569,封丽萍,2018-01-25 15:22:33,0,1,1,可以选择不用期末考试！没有发言和展示只要好好做大作业  就能满绩！强推封老师！
69889,1569,封丽萍,2018-01-25 15:25:27,0,0,0,没期末考试，绩点好评，感恩师生情
69894,1569,封丽萍,2018-01-25 15:33:38,0,0,0,棒棒棒棒！！！
69896,1569,封丽萍,2018-01-25 15:34:14,0,0,0,老师人超好，实验班不用考试，虽然平时有一些大作业，但给分超好！笔芯！
69898,1569,封丽萍,2018-01-25 15:36:23,0,0,0,超棒～
69900,1569,封丽萍,2018-01-25 15:39:57,1,1,0,我要表白封女神！！她太太太棒了！！点名很少，讲课有趣，期末可以选考试或者作报告拍短片，形式很创新。而且人超好超温柔，也很幽默，给分也超级良心！！！遗憾没选上她的法学基础！！尽管我不用学法，可是我想上她的课！！！
69902,1569,封丽萍,2018-01-25 15:42:06,1,1,0,好老师啊
69904,1569,封丽萍,2018-01-25 15:42:23,1,1,0,很温柔，是个好老师\n\n无身份，认真完成作业上4了，给分还可以
69905,1569,封丽萍,2018-01-25 15:45:12,1,1,0,老师人特别好
69911,1569,封丽萍,2018-01-25 16:00:09,5,8,3,思修课绝对最佳人选。 封妈真的体谅我们、理解我们，让我们收获颇丰却任务不太繁重，给分真心感动。可以不考试，增加一份小组大作业，却节省了宝贵的期末复习时间。 对于大一新生，思修课教师是封老师，如同母亲在身边，内心超暖。 思修课选她就对了，个人是预置的，真的幸运。\n\n
69913,1569,封丽萍,2018-01-25 16:01:04,0,0,0,超棒的老师！给分也很好！赞！
69914,1569,封丽萍,2018-01-25 16:01:31,0,0,0,人超美！！讲得超好！！考核方式民主！！给分好！！爱您
69915,1569,封丽萍,2018-01-25 16:01:55,2,2,0,没有发言过，没有当组长或课代表，只是认真完成了作业，然后老师竟然给了满绩。感恩~
69923,1569,封丽萍,2018-01-25 16:13:32,0,0,0,真的给分超好哦 然后真的拍微电影学了超多东西 上课干货也很多的
69926,1569,封丽萍,2018-01-25 16:20:03,1,2,1,给分好到炸裂！！！老师人也很温柔，平时事情也少，重要的是给分超好啊！！！！难掩激动
69930,1569,封丽萍,2018-01-25 16:30:39,0,0,0,很好的老师o(^o^)o
69941,1569,封丽萍,2018-01-25 19:50:35,0,1,1,老师很漂亮，很有经验，上课挺好的，课后作业认真做，课上没发言过，老师给了4.5 感觉很可以啦，真心谢谢老师
69946,1569,封丽萍,2018-01-25 22:54:48,1,1,0,就很好
69957,1569,封丽萍,2018-01-26 00:07:03,1,1,0,思修课。老师真的很用心，人美声甜课好，很温柔耐心，案例很有趣，每次带着作业去都会不知不觉听起了课。给分也超赞的！
69958,1569,封丽萍,2018-01-26 00:20:26,1,1,0,老师人超好，很亲切，上课也超级棒
69966,1569,封丽萍,2018-01-26 00:55:46,3,4,1,没有期末考，给分超级赞！
70024,1569,封丽萍,2018-01-26 03:53:03,1,2,1,给分超级好！！基本不点名！！考核方式民主！！强推！！
70251,1569,封丽萍,2018-01-26 09:51:47,5,5,0,每次都到了作业也好好做了，期末分那么低真的很伤心
70380,1569,封丽萍,2018-01-26 14:18:15,2,2,0,老师很温柔！很漂亮！讲法律部分很有意思！每个班投票选择考试还是志愿者报告。我们班是写志愿者报告的，节省了很多期末复习的时间。课前偶尔点名。没发言，没展示，没当组长，绩点4.5，很满意啦
70476,1569,封丽萍,2018-01-26 16:35:26,1,1,0,绝对好老师
70785,1569,封丽萍,2018-01-27 13:47:53,1,1,0,超级棒！人很好很温柔！给分也很棒了！
71406,1569,封丽萍,2018-01-28 11:51:12,1,1,0,老师非常温柔有气质，思修可以免考，老师给分也很好
71692,1569,封丽萍,2018-01-29 01:12:38,1,1,0,很棒！！！
72333,1569,封丽萍,2018-01-30 02:20:18,1,1,0,老师上课讲的很详细，你听的话收获很大的。虽然平时事情比较多，但是期末可以不考试，认认真真完成的话绩点不会差的。
72819,1569,封丽萍,2018-01-31 06:28:20,1,1,0,女神老师！思修课封老师上的真的很好，还能学到法律相关的知识，最好坐前面边听边做作业老师又不会说什么。读书报告和志愿报告都认真写，小组活动积极参加最后绩点肯定不低。而且老师气质高雅，真的很好。我不是小组长4.5满足了
72859,1569,封丽萍,2018-01-31 08:07:56,-2,5,7,很温柔很宽容的一个老师，只要你认真学，积极承担任务，期末一定能拿高分，不要听评论里的负面消息……我这个学期选了两个评分为5的老师照样两门4.8……顺便说一句思修满绩。
72892,1569,封丽萍,2018-01-31 09:25:45,4,4,0,感谢老师！！！老师的课总是会把不打算认真听课的我吸引过去变成认真听课……
73650,1569,封丽萍,2018-02-02 09:22:43,2,2,0,大爱封丽萍老师！人很温柔，为学生着想
73927,1569,封丽萍,2018-02-03 14:55:39,2,3,1,老师超赞～期末可以自己选考不考试～没当小组长没发言过但是作业很认真完成了，另外，期末满绩真的超惊喜(//∇//)
74533,1569,封丽萍,2018-03-03 05:10:49,0,0,0,老师人超级好，给分也很公道?点赞（｡ò ∀ ó｡）
74568,1569,封丽萍,2018-03-03 16:30:05,2,2,0,这个老师太好了，第一个满绩！\n\n
76966,1569,封丽萍,2018-04-26 15:45:45,1,1,0,超好的老师，很热心解答我的疑问，第一门满绩，开心。
76968,1569,封丽萍,2018-04-26 15:59:15,1,1,0,封老师简直是女神老师呀!首先，封老师的谈吐衣着十分有气质。其次，老师的课非常生动有趣，即使没有法学基础知识也绝不会感到枯燥。最最重点是，老师特别为同学着想，没有考试，只有一个读书报告PPT（小组内展示），一篇论文，还给了额外加分的选做小作业，最后给分超级赞呀!
76969,1569,封丽萍,2018-04-26 16:02:29,1,1,0,老师讲课真的非常有意思，法学基础，无关绩点，真的可以学到东西，感兴趣的推荐选~作业个人感觉不算多，如果时间安排的好不会很赶，当然掐着ddl也就痛苦一阵。
76970,1569,封丽萍,2018-04-26 16:13:14,0,1,1,法学基础，事情少，给分好，我认识的十几个全4.5，强推
76973,1569,封丽萍,2018-04-26 23:39:13,0,0,0,讲得很好，认真听会有收获
76982,1569,封丽萍,2018-04-27 03:34:13,0,0,0,老师真的很有气质很温柔，法基课认真听是比较有趣的。任务不多给分很好
76985,1569,封丽萍,2018-04-27 06:06:43,2,3,1,授课内容是基础性的法律知识，重视案例分析，兼顾趣味性。老师的谈吐超赞，很有气质。课程任务不重，论文选题也比较广泛。最后给分超级赞\(≧▽≦)/~
77594,1569,封丽萍,2018-05-07 00:54:23,-1,1,2,非常喜欢这个老师啊，温柔，干货多，讲的都是与我们日常相关的，比起一些老师作业并不算多。给的分也高，真心喜欢呀！
77956,1569,封丽萍,2018-05-09 03:10:48,2,4,2,老师可以嫁给我吗?
78439,1569,封丽萍,2018-05-12 00:16:52,1,3,2,法学基础，课程内容很基础，没什么意思，老师事情也很多……给分也一般……
78641,1569,封丽萍,2018-05-14 05:50:01,3,4,1,上课干货很多，小组读书报告，发言加分，最后论文一篇正常写就好，最后满级了，付出和回报还是成正比的｡◕‿◕｡
79584,1569,封丽萍,2018-06-11 00:58:28,-14,1,15,思修本身的性质决定了课很难有趣，感觉得到老师尽力了。没有展示过，没有发过言，但还是满了。意外之喜。补评。
82382,1569,封丽萍,2018-07-08 04:48:39,9,13,4,思修老师的上确界：1、老师漂亮温柔；2、课程事情少没考试；3、课堂内容丰富，老师声音好听；4、给分好；5、老师关心学生。\n\n表白女神。
87842,1569,封丽萍,2018-10-15 11:17:12,-3,5,8,不喜歡思修課
89813,1569,封丽萍,2018-12-20 09:16:26,-4,6,10,很不好，糟糕极了
94061,1569,封丽萍,2019-01-15 05:19:22,0,1,1,体验很不错
95422,1569,封丽萍,2019-01-19 11:00:22,-2,0,2,就是想评分
97155,1569,封丽萍,2019-01-21 21:32:29,1,3,2,老师的给分真好！！感觉自己的努力得到了应有的回报！！
97158,1569,封丽萍,2019-01-21 22:12:42,1,2,1,(´▽｀)ノ♪\n\n谢谢老师\n\n我上4了
97159,1569,封丽萍,2019-01-21 22:41:43,2,2,0,老师的课堂睡觉的现象还是比较少的，活跃度相比较高，但就是这门课本身性质问题不大好讲。最后努力成正比！
97162,1569,封丽萍,2019-01-21 22:56:07,2,4,2,老师超级温柔，给分超好，另外劝大家期末一定要多背背课本，我平时分低但是是组长+期末考分高，结果4.5。
97164,1569,封丽萍,2019-01-21 23:00:56,2,3,1,老师讲的不错，而且给分太好了呜呜呜
97168,1569,封丽萍,2019-01-21 23:22:14,3,6,3,太感人了 给分太好了 哭泣了555555
97214,1569,封丽萍,2019-01-22 00:36:23,1,3,2,这门课本身很无聊，但可以看出老师已经在努力丰富这门课的内容了。平时要求不高，给分也好，为老师打call！
97226,1569,封丽萍,2019-01-22 00:48:58,2,3,1,老师很温柔，给分很好。
97235,1569,封丽萍,2019-01-22 00:58:54,0,1,1,hhhhh思修课水了一学期 小组的研究学习认真完成分到的锅 小组成员分工很好没有什么争议 最后考试之前背了背 成绩还不错啦
97241,1569,封丽萍,2019-01-22 01:05:19,0,1,1,老师还是挺温柔的\n\n但我的分真的不高
97331,1569,封丽萍,2019-01-22 08:12:17,1,3,2,老师太好了叭
97409,1569,封丽萍,2019-01-22 08:41:26,0,2,2,虽然没有发言，可还是得到了不错的绩点，老师超好
97712,1569,封丽萍,2019-01-22 13:57:11,0,1,1,棒棒哒\n\n
97800,1569,封丽萍,2019-01-22 16:59:57,0,2,2,5555老师也太好了吧5555平时上课超级温柔超级善解人意，事情不多，考前好好把书过了一遍，考试写的也不算太多，最后因为小组展示成绩不高公示出来的时候我还觉得我凉了，结果绩点出乎意料地不算太低5555谢谢老师了！！！
97810,1569,封丽萍,2019-01-22 19:02:55,0,1,1,很棒推荐
97827,1569,封丽萍,2019-01-22 23:00:47,0,1,1,老师太棒了吧！！人又温柔讲得又好给分又好！
97859,1569,封丽萍,2019-01-23 00:24:19,0,1,1,很温柔的老师o(^o^)o
98500,1569,封丽萍,2019-01-23 13:43:58,1,2,1,发言加分，任务不多，不能翘课，嗯，说实话略水，但是给分还是很好的，满分
98722,1569,封丽萍,2019-01-24 00:28:58,0,1,1,老师很温柔 人挺好的 虽然最后被正态了_(:_」∠)_
98972,1569,封丽萍,2019-01-24 06:03:34,0,1,1,超级棒！老师人美又温柔，上课的时候挺水的，一篇读书报告，一份志愿者ppt和小组的研究性学习，小组好好协调，配合默契的话事儿不多，个人认为，绩点给得很高！谢谢老师！
99017,1569,封丽萍,2019-01-24 07:04:24,1,7,6,心中意难平\n\n平时的任务有好好做\n\n读书报告好好写了\n\n小组分全班第一\n\n最后被正态，分低得我想重修\n\n说是我期末考分太低\n\n那我就要上查老师告诫学弟学妹了\n\n上这位老师的课，给我背书！背整本思修！像背有机那样背！不信期末考考不高！\n\n好好刷题，像刷有机那样刷！\n\n别到时候看到绩点目瞪狗呆，问老师，老师说你卷面分数太低\n\n我记得占百分之三十叭，真的占比很大\n\n平时不重要，有个小组最后一名的同学还上4了呢
100144,1569,封丽萍,2019-01-25 15:45:37,0,2,2,很温柔很温柔的一位女老师呀，结课的时候还给我们一些人生的忠告，很喜欢，因为思修是水课所以一个学期都没有好好听，感觉挺对不起她的
100691,1569,封丽萍,2019-01-26 14:39:14,0,0,0,多位老师一起授课就能感受出区别，老师真的讲的很好～给分也好，强烈推荐～（非常希望大家分区坐好），也非常支持同学们的微电影～
102105,1569,封丽萍,2019-01-30 12:42:19,1,1,0,虽然小组拖后腿，但是绩点不难看 \n\n老师给分肯定是好的
102726,1569,封丽萍,2019-02-22 03:55:36,1,1,0,老师讲的课很有意思，给分也很好！
103115,1569,封丽萍,2019-02-26 04:23:08,1,1,0,超赞！
103309,1569,封丽萍,2019-02-27 08:21:41,1,3,2,法学基础...事情贼多.
103352,1569,封丽萍,2019-02-27 11:57:05,1,1,0,总能被思修老师莫名吸引过去～
103483,1569,封丽萍,2019-02-28 10:54:09,1,1,0,会要求按小组坐，然后让组长看看组员有没有来的。上课发言有加分。老师人很温柔，但是这门课我真的没听讲，上课都是做别的事情的。\n\n作业应该思修课都是统一的，一份读书报告，一份志愿者PPT，一次小组研究性学习成果展示。志愿者PPT没有像一些别的老师强行要求小组一起做志愿者活动，挺好的。小组展示可以选择拍视频（但是拍视频有风险需谨慎，拍好也不容易的）。
105706,1569,封丽萍,2019-04-18 23:30:32,1,1,0,好！！！！！！老师人很好，讲的也很仔细，很耐心。老师也注重和我们互动。会让我们讨论。给分好。而且老师很漂亮！
105708,1569,封丽萍,2019-04-19 00:03:42,1,1,0,很不错
105710,1569,封丽萍,2019-04-19 00:21:33,1,1,0,满满的爱
105712,1569,封丽萍,2019-04-19 00:34:33,4,4,0,我上的是封老师的法学基础，对一个理科生来说也很友好的。老师鼓励大家随便说说，反正我是瞎讲的，但是也只是回答过一次问题。论文没有鹅颈，胡乱写了四千多，PPT也是稍微做了一下，好丑的说。老师给分超好，感谢老师！虽然分数可能不是特别高，但是已经很满足了，吹爆封老师!(后悔思修没选上她的课)
105714,1569,封丽萍,2019-04-19 00:53:35,7,7,0,法学基础这门课是进大学以来第一门自己想学知识的通识课。所以一个学期下来没有水都在认真听。真的学到了很多。事情也不是很多吧，个人感觉挺好的。建议做一下选做的案例分析，到期末才发现有那么多分加要枯了。\n\n就是排座位要看运气了如果排到了后排可能发言会比较难点到，其他都挺好的。\n\n最后给分是11档五级制。
105720,1569,封丽萍,2019-04-19 01:46:57,2,2,0,啊封老师我爱！！我没有发言但是最后给分很好！超好的那种！课很轻松，而且老师很温柔！
105725,1569,封丽萍,2019-04-19 02:22:56,2,2,0,第一门满?的通识课啊要哭了，上课都没发过言，论文好好写就能拿高分的，老师人超好
105954,1569,封丽萍,2019-04-23 13:17:37,-1,0,1,！！！
106197,1569,封丽萍,2019-04-25 13:16:57,1,1,0,老师挺好的！法学基础上课会讲很多案例，对思维也挺有启发，学期一开始就会把所有需要做的事情写得明明白白。不过这门课真的不水……案例分析读书报告加论文还挺耗时间的。
109084,1569,封丽萍,2019-06-07 14:05:27,0,0,0,法学基础，事情我觉得不少，ddl比较靠近考试周，上课需要到，但可以不听，综合一下我觉得还行吧。
109237,1569,封丽萍,2019-06-12 06:46:28,0,0,0,老师气质很好～讲课也好～
110429,1569,封丽萍,2019-06-26 15:04:47,-1,1,2,老师很温柔，给分也超级好！超级喜欢！
110430,1569,封丽萍,2019-06-26 15:05:54,-2,1,3,谢谢老师！大学第二次满绩！谢谢老师！
110431,1569,封丽萍,2019-06-26 15:08:42,-1,0,1,能收获很多
110432,1569,封丽萍,2019-06-26 15:13:42,0,0,0,中规中矩
110438,1569,封丽萍,2019-06-26 15:51:34,0,0,0,老师喜欢养花，最后一节课讲同学上交的案例时还特地分享了自己种的和拍的花。是个有耐心且可爱的老师呢，助教也超赞！总之，好课好老师，选就完事儿了。
110439,1569,封丽萍,2019-06-26 15:53:12,0,0,0,老师上课很有意思，有很多有趣的案例。而且老师又温柔又开朗，课堂气氛很好！且给分真的很好，事情也算很少了
110450,1569,封丽萍,2019-06-26 23:15:08,0,0,0,法学基础给分很好啊。上课没发言，读书报告也一般，但是选做的案例分析做了，论文好好写一写，最后竟然有A(⑉꒦ິ^꒦ິ⑉)
110467,1569,封丽萍,2019-06-27 04:00:58,0,1,1,老师人挺好的！也温柔！给分好！我上的是法学基础
112117,1569,封丽萍,2019-07-03 15:35:43,0,0,0,老师很棒呀，讲课认真。给分也好，认真去做的话老师感受得到。就是后面一次换座位的时候被换到后面去了，得伸长脖子听，可太辛苦了
112395,1569,封丽萍,2019-07-04 04:00:42,0,1,1,法学基础 letter grading 感觉助教有点不认真，有一次作业很认真但给我打了很低的分，还好找老师argue了一下，不然估计凉凉
117233,1569,封丽萍,2019-09-20 23:21:06,2,2,0,法学基础特别难忘
120925,1569,封丽萍,2020-01-18 23:27:35,2,2,0,呵呵呵
120929,1569,封丽萍,2020-01-18 23:39:30,-3,2,5,好！极好，感谢老师的满绩。
122235,1569,封丽萍,2020-02-20 09:12:50,-5,1,6,老师超级温柔超级好！要想拿高分每一个作业都认真做！（读书报告、志愿者ppt1-3页、小组合作微电影或调研报告）考试不用说了闭卷好好考！课堂上要主动发言（发言计分）！谢谢老师的4.8
122559,1569,封丽萍,2020-03-04 05:22:06,10,10,0,老师讲的很好 还是周深粉 你会在课上听到很多很多案例 我觉得把法学讲的挺有意思\n\n但是天嗷 改成网课后恶竞也太可怕了 利用自己社科专业疯狂鹅颈可还行
123049,1569,封丽萍,2020-05-06 01:47:54,2,2,0,老师讲课很好，给分不错哦
123316,1569,封丽萍,2020-06-02 13:39:02,0,1,1,法学基础组长最后展示都是我 绩点4.2 还行吧 我也知道我论文写得太捞了
123555,1569,封丽萍,2020-06-10 01:59:20,-1,0,1,老师人挺好的，但是讲得比较基础，基本是高中政治法律基础选修的内容
124365,1569,封丽萍,2020-06-29 16:10:38,-1,2,3,老师非常好 收获很多 绩点也可以
129428,1569,封丽萍,2021-01-05 08:12:54,11,16,5,思修。老师人挺不错，就是期末小组分数分配机制有点不太好，感觉会挑起矛盾啊（给成员加分必须从其他的人身上扣下来）。非要分出来的话，建议可以排序啊………
131872,1569,封丽萍,2021-01-29 07:35:42,1,2,1,出分在即，求封老师捞捞
131890,1569,封丽萍,2021-01-29 08:42:21,6,10,4,小组合作是组长，小组作业成绩公布也是全班最高的，上课有两次发言加分，志愿者展示活动也抢着展示了，志愿者PPT已经做够了67小时（大一第一学期），读书报告按照要求思维导图也做了好几个，最后被卡绩了，认识的人绩点也很低，慎重选课吧。
131950,1569,封丽萍,2021-01-29 13:30:05,2,4,2,认真复习结果绩点爆炸
131983,1569,封丽萍,2021-01-30 01:16:50,1,1,0,认真学习好好背书，但是绩点不好。但老师人不错
131990,1569,封丽萍,2021-01-30 01:55:13,1,3,2,老师人很美，小组合作拉胯情况下靠自己后期努力上了4.5，谢谢老师，心满意足了
132159,1569,封丽萍,2021-01-30 17:30:42,-2,3,5,老师很温柔知性，上课也很不错。读书报告认真写，小组微电影认真剪辑，期末真-裸考，最后拿到了4.5，还是比较符合自己的努力预期的(回想起剪视频的日夜…)
132623,1569,封丽萍,2021-02-03 02:24:36,1,2,1,老师人很好，上课很用心，给分挺好
135397,1569,封丽萍,2021-05-09 18:55:28,5,5,0,上的法学基础 老师人很好 上课很有意思 作业也不多 蛮轻松的  进浙大以来第一门满绩！
135553,1569,封丽萍,2021-05-13 10:14:23,4,4,0,法学基础：事情不多，不过发言有加平时分，老师对学生很关心，会分享很多法律的干货，钉钉找老师老师也回复得很及时，而且老师看得到你的努力付出，强推
135556,1569,封丽萍,2021-05-13 12:09:48,-5,2,7,课讲得感觉一般，而且事情有点多
137700,1569,封丽萍,2021-07-05 16:15:25,3,3,0,法学基础，事情少给分好，老师能从我读书报告的笔记里发现私下的努力，平时案例大家有时间也要做一做的。太开心了第一门满绩，谢谢老师！
137751,1569,封丽萍,2021-07-06 03:32:21,1,2,1,给分高，事少，感谢人生第一个满绩
137782,1569,封丽萍,2021-07-06 06:21:21,3,4,1,满绩加一，案例选做最好要做一下，平时发言也积极一些，作为大三老狗看学弟学妹们发言都不积极真是有点捉急啊，想当初自己就是这样导致思政通识都不高。小组里大部分都不错，但也有同学说自己超低，所以还是有正太的，要小心。
137883,1569,封丽萍,2021-07-06 13:01:30,5,5,0,法学基础\n\n感觉身边好多满绩\n\n自己没有发言也没有写额外的作业\n\n最后收货4.2绩点\n\n也还是挺满意的\n\n哦对了\n\n没有考试永远滴神
141109,1569,封丽萍,2021-09-23 15:25:02,1,2,1,老师很和蔼可亲，上课气氛超好，不会有回答问题的紧张感；会为每位上台分享读书报告的同学拍照留念；法学基础课想水能水，想学能学，而且老师给分也超好。会用学在浙大不定期点名，会按照小组就坐。总之选她的课绝对稳赚不亏
141931,1569,封丽萍,2021-11-01 06:38:43,-10,4,14,给分烂又无聊
144116,1569,封丽萍,2021-12-18 07:14:31,0,1,1,事少分高人美。选她！
144954,1569,封丽萍,2021-12-26 04:40:58,0,0,0,。。。
145135,1569,封丽萍,2021-12-27 15:24:00,1,1,0,老师大美女，选她，人又温柔，作业也不多
145186,1569,封丽萍,2021-12-28 06:05:07,0,0,0,人好啊
147136,1569,封丽萍,2022-01-09 00:43:03,2,4,2,卡绩了
147152,1569,封丽萍,2022-01-09 02:00:12,3,4,1,绩杀，出成绩就已读不回
147200,1569,封丽萍,2022-01-09 05:22:36,3,3,0,封老师人很好，很温柔，作业只有比其他老师少，肯定不会多，给分也很棒。
147234,1569,封丽萍,2022-01-09 07:59:17,0,2,2,绩杀。。。
147246,1569,封丽萍,2022-01-09 08:34:10,0,0,0,这个学期是不同老师交替授课，就是说思修课一学期不同时间段由不同老师来上（但最后总评还是由封老师来评），在遇见的数个老师中还是觉得封老师的上课风格我最喜欢。\n\n另外绩点想要拿高最好课堂上要多回答问题，回答问题的次数会有记录；点名的时候尽量全到；期末考就感觉比较随缘……貌似多选题比较拉分？总之个人还是比较推荐选封老师的
147262,1569,封丽萍,2022-01-09 10:13:20,0,0,0,封老师真的很好！！
147741,1569,封丽萍,2022-01-10 15:29:06,0,0,0,哈哈哈
148010,1569,封丽萍,2022-01-11 10:11:23,0,0,0,好好好
148285,1569,封丽萍,2022-01-12 05:10:59,1,2,1,老师不错，就是3.3我还是挺失落的。。真的不想卷上课举手发言（苦笑）
148796,1569,封丽萍,2022-01-13 14:34:13,3,3,0,回答问题给分，社死人快逃
150154,1569,封丽萍,2022-01-19 13:04:56,-10,0,10,老师特别温柔，最后差一分满绩，应该是期末考的问题，证明还是要背书的。
150868,1569,封丽萍,2022-02-20 09:09:49,1,1,0,封老师我爱了呜呜呜大美女 听她上课很舒服！上网课的时候还给大家放歌听！\n\n作业都讲的清清楚楚，考前和我们说不要去做一些题库，不如好好看书！给分也挺好的！
150907,1569,封丽萍,2022-02-21 03:00:01,1,1,0,思修，已经讲的很好了，人美，温柔，，
151626,1569,封丽萍,2022-03-10 02:29:16,-6,3,9,读书报告思维导图画了两天，还加了2000字感想，上课回答了很多次问题，小组展示我去讲的，但是最后我们小组长搞平均。期末考试最后全写满了，最后绩点3.9卡绩，老师人蛮好的，但是我不能接受这个绩点
152169,1569,封丽萍,2022-03-29 07:52:37,1,1,0,法学基础 人超温柔 出分前求一个满绩
152935,1569,封丽萍,2022-04-22 03:03:23,4,5,1,【法学基础】因为是第一门满绩的通识课，所以我就来说说吧。思修上的也是老师的课，但发言不积极加上小组比较佛系，期末考也没写几页纸（当时太年轻了）最后收获一个3.9；法学基础又选了封老师，主要是很喜欢她温柔优雅的性格，三个最主要的作业全都认真做了，思维导图真的是一边看书一边梳理的，所以框架很丰富；平时案例也做了，框架就是案件梳理+案例分析+引用法律条文+总结+相关图文资料，注意是身边案例就好了；论文是最后做的，有点累就刚好比3k多一点，从一个小切口来写，写详细点就好了，然后做好老师要求的论文格式就好。老师的课就是只要你用心，就不会辜负你的。
153055,1569,封丽萍,2022-04-24 11:34:27,3,3,0,感谢封老师使我获得了第一个满绩！\n\n上的是《法学基础》课程内容蛮有意思的，老师会结合很多实例讲课，比较适合非法学专业的同学拿来了解一些常识性和基础性的法律问题。作业是一篇读书报告（思维导图或者ppt）、3000字小论文和平时的案例分析（选做），没有期末考，五级评分制。偶尔课上会有小组讨论但都没有什么硬性要求，大家可以随意聊随便谈。上课也可以摸鱼，我一般也是听到感兴趣的时候多听一会，后来到期中阶段直接写三节课数学题了。想要高绩点的话读书报告和小论文需要认真写，多查找一下相关资料不要泛泛而谈。老师会看到大家的用心的。另外老师真的很温柔，讲课会等同学们理解，对大家很随和，一共只点了两次名。\n\n再次感谢老师！！
153108,1569,封丽萍,2022-04-25 14:18:17,0,0,0,挺好的老师
153251,1569,封丽萍,2022-04-27 05:51:24,0,0,0,上的通识 给分好事不多冲冲冲
155339,1569,封丽萍,2022-06-11 05:51:45,0,0,0,秋学期上的 满啦 封封大美女 没鹅颈 从不发言 论文和案例好好做啦
155933,1569,封丽萍,2022-06-16 15:22:36,5,5,0,谢谢老师，法学基础给分好好，没鹅颈也满了。现在是百分制了 大家放心冲！
155989,1569,封丽萍,2022-06-17 04:24:44,0,1,1,老师很不错，第一次拿满。。。给分真的好
159640,1569,封丽萍,2022-08-22 12:07:13,1,1,0,一言难尽，我太菜了
166694,1569,封丽萍,2023-01-13 08:50:35,3,3,0,温柔滴很，我很喜欢
168135,1569,封丽萍,2023-01-30 02:22:26,1,1,0,温柔体贴，非常愿意解答同学的问题
168890,1569,封丽萍,2023-02-23 08:46:12,1,1,0,好人一生平安
169082,1569,封丽萍,2023-02-24 08:41:27,0,0,0,封姐姐超级棒！授课也挺好，人超级温柔体贴人，给分也很不错！
169480,1569,封丽萍,2023-02-26 11:21:34,0,0,0,老师很温柔 给分很好 给了我大学第一个满绩 所以法学基础继续选她的 希望能有好成绩
169606,1569,封丽萍,2023-02-27 05:58:45,1,1,0,温柔且优雅
170100,1569,封丽萍,2023-03-01 11:08:57,6,6,0,不点名，老师很温柔很好\n\n但是小组贡献度那个感觉不太好，或许分组可以更好一些，例如加一些小组守则(有些组员太摆，和努力的学员拿同一个分)之类的
172078,1569,封丽萍,2023-04-19 02:43:01,0,0,0,昨天上完了法学基础的最后一堂课，也是老师职业生涯中的最后一节课。感觉参与了一个人人生中很重要的时刻。老师非常温柔、负责，讲课备课都能看出来认真。从课上也能学到不少知识。封老师身上的那种attracting的气质也不被她的优雅和漂亮所掩盖。非常幸运能够遇到封老师，能够听她一学期的法学基础课。
172397,1569,封丽萍,2023-04-27 13:33:06,1,1,0,封老师我的超人
172421,1569,封丽萍,2023-04-26 13:51:07,0,0,0,老师非常非常非常好！\n\n有幸上了她教学生涯最后一节课，又温柔讲课又好的老师，给分也很好
172445,1569,封丽萍,2023-04-27 03:23:57,0,0,0,上了封老师的法学基础课，温柔优雅，上课可以不听，但如果愿意听的话内容也很有意思，各种案例可以当故事听，只有最后一节课点了名，作业是读书报告和期末论文，有个案例作业写了可以多加分。上课不用卷，小组其实相当于各读各的书，老师给两节课小组内讨论。这门课我没有特别卷，上课都是干自己的事，论文参考了蛮多文献也copy了不少（老师应该更看重格式还有态度吧），最后4.8，很满意了。
172470,1569,封丽萍,2023-04-27 10:49:11,0,0,0,2023春 法学基础 \n\n最后一次课点名，一学期仅有一次的点名\n\n真正意义上的最后一次课，封老师退休前的最后一次课\n\n祝老师退休生活快乐，身体健康，万事如意！
172569,1569,封丽萍,2023-04-30 09:52:35,1,1,0,赶上封老师退休前最后一次法学基础课，老师看起来好年轻。上课轻松有趣，任务压力也不大，给分也好
173875,1569,封丽萍,2023-06-04 04:01:31,0,0,0,老师真的很有气质~祝老师退休之后身体健康 天天快乐吧~
183884,1569,封丽萍,2023-12-02 12:52:20,1,1,0,T_T看了评论才知道封老师退休了……老师真心好老师，很有气质，老师上的每一堂课都很认真。大学里遇见的最好的老师之一！
2590,1627,黄铭,2017-09-18 01:11:16,6,23,17,怎么没有0分这个选项？
2596,1627,黄铭,2015-05-04 15:54:27,2,3,1,反正政治课我觉得都差不多……
2961,1627,黄铭,2016-06-16 01:00:32,29,55,26,本来想打2分，看在他容忍了上课小组展示六---四的主题的份上，给他加一分。
3265,1627,黄铭,2015-05-25 05:37:04,1,7,6,无聊 应该去当小学老师
3280,1627,黄铭,2015-05-26 07:40:25,-12,11,23,很负责、很有激情的老师、虽然上课阿让玩手机但是听着不无聊、值得选。
4965,1627,黄铭,2019-09-08 14:14:02,48,66,18,
5052,1627,黄铭,2015-07-02 15:52:29,-6,7,13,还可以的，上课有值得听地方，人很好。
5665,1627,黄铭,2015-07-09 05:36:04,-2,6,8,口音好可爱。上完一学期看书的时候脑子里都是他特殊的语调
5666,1627,黄铭,2015-07-09 05:36:35,4,7,3,生无可恋
5761,1627,黄铭,2015-07-09 08:49:20,-2,9,11,超级负责，每节课讲的很有趣，虽然没能爱上马克思主义，但是至少听他的课学习了很多东西。
6114,1627,黄铭,2015-07-11 02:26:22,-27,8,35,平时成绩前五的人，最后成绩没破4.5，
7455,1627,黄铭,2015-10-29 08:29:37,15,26,11,觉得他讲得还挺好的，就是对号入座这点令人抓狂！我想坐第一排还不让
11376,1627,黄铭,2015-11-29 10:32:45,-1,0,1,………
13253,1627,黄铭,2015-12-25 16:14:32,4,13,9,按号坐位很不爽
16323,1627,黄铭,2016-01-18 06:48:22,8,17,9,按号码就座究极污，发言占10分我也是醉了，不喜欢发言的赶紧退了。
16352,1627,黄铭,2016-01-18 03:39:05,13,23,10,血的教训。不喜欢上这种课发言的。千万别选他。。少见的发发言占10分的。。。我一次都没说。然后。狗带
16368,1627,黄铭,2018-06-14 02:44:13,5,7,2,上他的课一定要发言。没发言的人少发言的人肯定给分很惨。
16444,1627,黄铭,2016-01-18 05:54:12,1,2,1,老师觉得你们就听听高中政治的水平够了，这个课嘛总是红专的
16452,1627,黄铭,2016-01-18 06:17:25,-1,2,3,想要发言满十次简直做梦\n\n十次发言十分太蛋疼了 \n\n给分不好 口音让人难受
16456,1627,黄铭,2016-01-18 06:34:40,-1,1,2,平时上课一般，给分略坑
16458,1627,黄铭,2016-01-18 06:38:35,-10,4,14,讲的挺好的，平时听听考试肯定上4
16482,1627,黄铭,2016-01-18 07:53:15,0,1,1,上课想水不想发言的别选这老师
16691,1627,黄铭,2016-01-18 21:51:28,0,4,4,不发言惨跪系列，被社科同学血虐
16730,1627,黄铭,2016-01-19 01:12:35,-2,2,4,发言占十分太坑，一次才给一分！！小组全部70+，给跪了
16962,1627,黄铭,2016-01-19 10:10:37,-1,1,2,给分不好
20218,1627,黄铭,2016-01-26 14:28:00,2,3,1,理智来说上课很好。但是对于一个不擅长人文的同学就会很吃亏。因为座位一定要对号入座，发言10次算平时的10%。
22776,1627,黄铭,2016-03-11 03:00:09,-1,1,2,对号入座不喜欢！给分不怎么好
28624,1627,黄铭,2016-06-28 11:10:42,8,15,7,虽然有点名，对号入座，要求发言.但是就老师讲课态度来讲，是一个十分负责任的老师，讲的知识点框架容易理解，就考试而言选择这个老师可能有助于复习，但是如果想要平时十分吸引人的，观点独到的老师，就选斟酌选择其他老师吧
33402,1627,黄铭,2016-09-19 06:01:15,0,1,1,菜的抠脚
34033,1627,黄铭,2016-09-26 02:36:50,2,4,2,一些观点不敢苟同，用语不恰。看完其他同学在学习帝上的评价简直生无可恋。
34056,1627,黄铭,2018-07-07 08:18:42,-5,11,16,傻逼
34413,1627,黄铭,2016-10-10 04:00:14,2,6,4,理工科的别选。
34435,1627,黄铭,2016-10-10 10:12:47,1,6,5,对自然科学一无所知还拿自然科学装逼。。
36449,1627,黄铭,2017-01-24 20:41:59,4,7,3,逻辑略混乱，经常用正确的依据强行推理出符合政治需要的结论，听课略憋屈
38240,1627,黄铭,2016-11-28 03:11:58,2,4,2,话废/不喜欢发言的不要选。\n\n给分惨烈。
39740,1627,黄铭,2016-12-27 08:19:19,15,18,3,老师人很好，这学期听同学的意见把发言改成7次，3次就6分，上课讲的还可以
44004,1627,黄铭,2017-01-17 07:52:06,-1,3,4,给分低哦 自己感觉听得还挺认真的 笔记也做了 发言也满了。但是给分真心一般般。和预期不一样
44071,1627,黄铭,2017-01-17 09:00:10,-1,0,1,老师上课还是很有激情的，而且讲得也不错。不过按号就坐这个就有点不是很舒服了。。。。
44137,1627,黄铭,2017-01-17 10:19:22,1,2,1,还可以吧
44200,1627,黄铭,2017-01-17 11:54:39,1,4,3,发言和对号入座确实太坑，感觉上课有一点洗脑
44658,1627,黄铭,2017-01-18 05:37:47,3,7,4,除了对号入座以外真的很棒的老师。讲的非常好，让马原不再成为一门无聊的课。还有我旁边那位同学真的太臭了他是从来不洗澡的吗？？？就是因为对号入座座位固定我就这样忍受了一学期???
47951,1627,黄铭,2017-02-27 12:38:17,11,16,5,100人的容量，我们班只有20人，选不选大家自己看
52062,1627,黄铭,2017-06-14 11:18:02,2,2,0,上课挺好啊(虽然真的要看发言……)
54634,1627,黄铭,2017-06-30 02:59:58,-1,1,2,上课讲得还是很细的，给分一般吧，发言什么的挺重要
55174,1627,黄铭,2017-07-01 02:45:19,-13,4,17,简直要疯掉。。。作死选了这样看发言的课。。马原给我拉低的绩点，我用了两门满绩的课再加上一门上4的课才给补回来。。，老师讲的好是真的，绩杀也是真的，我已经是这辈子与奖学金无缘！
56119,1627,黄铭,2017-07-03 06:04:33,2,6,4,对于其他老师来说，黄老师给分实在太过严苛实在。所以，期望有个好的绩点的同学去选别的老师的课吧。而且老师对于一些现象的看法有些保守，虽然这是思政课老师普遍的特点，但是。。。上课真的好无聊，而且发言分占十分，处在角落的我瑟瑟发抖，想发言都没机会。嗯，就酱
58804,1627,黄铭,2017-09-18 02:03:20,5,6,1,日式普通话？？
59171,1627,黄铭,2017-09-20 05:30:31,1,2,1,莫名其妙的口音。。。
59632,1627,黄铭,2017-09-25 05:07:46,1,3,2,还不错的\n\n
63471,1627,黄铭,2017-12-05 00:10:14,3,5,2,总体来讲还可以吧，对课本知识吃得很透，但作为思政课老师，水平和格局有限，思路也有些保守刻板了；对一些新颖的话题也提不出一针见血的分析，但都要强行套上最基本的马原原理去解释一通，反而占用了大家发言讨论的时间；对大家的政治正确性看得也很重，当然这并不是不好，但还是会对大家的思路产生限制。
64525,1627,黄铭,2017-12-25 02:39:19,6,6,0,怎么说呢？刚开学第一节课觉得很严，规定不准睡觉，不准看别的书，不准玩手机，还要对号入座等！不过到后来发现除了对号入座，其他的都没怎么管。（现在我就是上课在写）\n\n   发言的情况，要发言7次，前3次占6分，我发言了5次，平时一般听不懂(=_=，都是小组展示完了的讨论发言的，发言不要好，随便说些什么，老师会帮你扯一些原理出来的? 我看下还有4节课能不能再水两次。\n\n        1号开头和6号开头的当小组长，然后我一个大一的就成为了一群大二学姐学长的组长，小组要做一次展示，占平时分的40%，展示完大家讨论，感觉就是水发言哈哈（有些小组讲的内容还是挺深刻的）\n\n        总之，老师挺能讲的，能一直说的不停，应该还是有一些深度的，不过我作为一个工科生，很多都听不懂(=_=)，而且作为一门“洗脑课”，宣传的一般都是红专的，各种吹马原，所以也没很认真的去听，接下来就看期末考了，听说要刷选择题，论述题靠编，祝我期末好运吧！
67817,1627,黄铭,2018-01-22 07:48:10,-4,3,7,发言就算了 搞个课代表根本就不会用心办事的 挤破脑袋抢发言抢了六七次 就给我记了一次 意思说不报序号你他妈座位不会数的？你小学没毕业还怎滴？更何况报序号都报过两次了 你搞笑的吧
67841,1627,黄铭,2018-01-22 08:10:51,2,3,1,按号入座，坐在角落的人举手回答问题很容易被忽略！\n\n
69520,1627,黄铭,2018-01-25 02:17:29,0,2,2,3.6报道，菜鸡从来不敢发言，论文34分，小组讨论36分，卷面背了两天每道大题都五百字左右。总的来说还可以，比我预料中的“惨跪”好一点吧，毕竟辣鸡
69521,1627,黄铭,2018-01-25 02:22:58,-1,1,2,课水展示水，只要发言够了，考试对文科生很友好
69528,1627,黄铭,2019-02-21 10:37:50,1,4,3,好不容易抢了五次发言，希望自己不要跪得太惨，然而事实还是跪了。我知道自己期末考试没有考得很好，但想想也不至于这么差吧！！历史新低！但说实话，老师平时讲课还是不错的，但给分真的太严了吧！！！！
69533,1627,黄铭,2018-01-25 02:57:05,4,6,2,对号入座点名占平时分十分..重点是你坐教室中间每节课举手他一整个学期都不会叫你一次?️
69538,1627,黄铭,2018-01-25 03:09:39,5,12,7,老师你好，老师再见，再也不见????，思政课3.0，平时发言10分满的，小组展示和论文都不错，3.0微笑脸\n\n顺手一分回去过年吧老师
69917,1627,黄铭,2018-01-25 16:05:25,-1,5,6,老师很敬业，每节课都准备充分，给分也还不错！
70797,1627,黄铭,2018-01-27 14:07:34,6,7,1,囋囋囋。一生噩梦
71921,1627,黄铭,2018-01-29 05:46:33,2,3,1,我就呵呵了
73749,1627,黄铭,2018-02-03 05:05:11,0,1,1,除了平时分不好拿以外其他都挺好\n\n感觉上课发言的永远是那几个人
81859,1627,黄铭,2018-07-06 10:18:57,3,6,3,对号入座，第一节课会公布规则并问大家有没有意见……其实没有感受过的人如何提得出意见？建议你们不要选，选的话一定要勇敢地提意见，直接建议给分别太坑！还有建议小组展示打分按100分来打！全班统一意见把别人组的展示分打高一点，这样你的也会高！千万别想我们一样傻啊呜呜呜\n\n有人觉得他讲得好，不是很赞同，至少不能叫好，只能叫不差。后悔选了啊！！！
82144,1627,黄铭,2018-07-07 08:27:49,3,4,1,现在老师已经放宽对发言的要求了，老师每节课都给很多发言机会；单纯就上课来说还是讲得很不错的，虽然有的时候显得有点古板，但至少论文给分蛮高的。而且他的课人数就在几十人左右，比那种100多人的课堂感觉要舒服很多…
90114,1627,黄铭,2018-11-22 06:45:42,-5,3,8,这个老师说“没有必要学四书五经，我们学习马原就可以了”我不敢相信我听见一个大学老师说这样的话。
93667,1627,黄铭,2019-01-11 09:34:43,-2,0,2,很烦人
96927,1627,黄铭,2019-01-21 12:35:28,-2,0,2,绩点就这样……还卡绩了
107546,1627,黄铭,2019-05-06 11:13:41,0,2,2,好老师！
109714,1627,黄铭,2019-06-18 17:09:31,1,3,2,热评第一让我见识到了什么叫有文化。?
116790,1627,黄铭,2019-09-16 01:58:50,-3,2,5,上课语调声音好做作...听着让人很难受
116818,1627,黄铭,2019-09-16 05:29:00,-4,4,8,普通话还不如我二大爷养的八哥呢
117094,1627,黄铭,2019-09-19 06:13:20,4,6,2,课堂还是很舒服的
118101,1627,黄铭,2019-10-21 03:00:21,-12,4,16,他言语中透露的对女性的歧视我无法忍受
120794,1627,黄铭,2020-01-17 05:26:34,3,4,1,只点一次名。论文给分高。纯工科生考完模电之后一个半小时速成期末，总评91感恩戴德
120838,1627,黄铭,2020-01-17 17:43:33,4,4,0,裸考无发言总评83供参考
120963,1627,黄铭,2020-01-19 04:36:26,1,7,6,一学期就点了一次名 事情少 讲课好 有自己的体系 简直是宝藏老师 被这该死的查老师害了 下学期老师的课太少人报取消了 太可惜啦
122457,1627,黄铭,2020-02-28 11:31:18,10,11,1,老师就点了一次名，平时任务也不多，高中不考政治的我凭理解和期末一点点准备也能4.2，作为我水过去的思政课，给分挺好了。如果不想水的话也可以好好做展示、和老师讨论什么的，老师对于学生的观点和疑问都挺耐心的。至于发言，五次就够，老师平时给了很多机会的，也不用多么高质量，我觉得自己发言不够也不能怪老师吧。至于前面说的歧视女性，本人女生感觉并不至于。总之出分好久了，回来看看黄老师还是这么点分，感觉他有点惨😂
123900,1627,黄铭,2020-06-16 04:15:45,15,15,0,已经改掉了很多以前评论里的臭毛病了，不用对号入座，发言也只有5分，可以快乐摸鱼，最后拿了4.2，满足了
126942,1627,黄铭,2020-10-29 02:26:03,1,2,1,老师讲的很好呀，可惜我太菜了，点名也少，也不必对号入座，就是要求上课互动多
128807,1627,黄铭,2020-12-25 13:01:46,12,13,1,个人感觉挺不错的，能感受到老师的水准，评分这么低确实出乎意料，但都是好几年前了，现在也没有太大问题吧
128993,1627,黄铭,2020-12-28 05:14:17,-2,4,6,拿着马克思主义研究的资金写着初中生议论文
129218,1627,黄铭,2021-01-01 05:36:53,-1,1,2,zzzz
130394,1627,黄铭,2021-01-26 08:09:00,13,16,3,下面的那位同学要我说思政课不回答问题不点名，平时分60分都白给你?你咋想这么美呢？什么时候这种不合理的要求反而变成评判老师的标准了，是不是老师那里都不好，就给分好，就能给10分，老师哪里都好就是给分求是你就会给低分?要是真全白给你，那就是对所有同学都不公平不负责
130434,1627,黄铭,2021-01-22 09:58:54,3,3,0,提一下分
130885,1627,黄铭,2021-01-25 06:04:28,-18,2,20,唉，浪费时间，lj一个
130888,1627,黄铭,2021-01-25 06:19:57,0,5,5,点名次数较多，要多次回答问题才能拿到10分平时分，社恐/咸鱼慎选，当初怕掉课，现在就是后悔，非常后悔，平时分惨淡
130912,1627,黄铭,2021-01-25 08:26:34,33,36,3,黄铭老师真的很好，大家不要因为评分低就不敢选。我那时候选也没抱很大希望，但是上了课就觉得挺好的，老师不是按照书本一模一样来，有自己的逻辑。虽说要发言，但是老师在最后几节课都会提供很多发言机会的。而且论文分数给的很高，平时分给很好。考前好好复习，分数不会差！选他没错。
132405,1627,黄铭,2021-02-01 10:22:21,8,8,0,挺好的老师，上课交互性好，给分合理
133333,1627,黄铭,2021-02-26 01:46:11,14,17,3,谁能告诉我这么好的老师为什么评分能这么低？他上课讲的不好吗？上课有思维有深度欢迎同学和他深入讨论，平时成绩真的有很努力给我们了好吗!!为啥还有人说这样的老师不好！各位真的去上上，不会后悔的，发言现在也能用听课札记顶，就算不喜欢发言也能选啊虽然事实上发言和老师交流实在是一大乐事。
134981,1627,黄铭,2021-04-25 14:52:57,3,4,1,老师非常不错
139790,1627,黄铭,2021-07-27 02:34:00,9,10,1,一学期过去了，发现黄铭老师的评分还在五分徘徊，实在是不应该。特地来帮老师提个分。
141191,1627,黄铭,2021-09-26 03:39:04,-4,3,7,跑吧….不要抱着侥幸心理\n\n他不会变的
141194,1627,黄铭,2021-09-26 04:04:11,2,2,0,讲课很有自己的观点，能学到很多，一直在想办法帮学生提平时分，很好的老师，他值得更高的分数！
143891,1627,黄铭,2021-12-10 10:36:57,1,2,1,好老师，打十分\n\n分十次给
145535,1627,黄铭,2021-12-30 07:41:27,1,1,0,老师人很好！！讲课也很博学
145615,1627,黄铭,2021-12-30 16:26:00,2,6,4,一学期课程下来，很负责的老师，讲课也很好，想各种办法提高课堂的分数，这样的老师值得十分
146697,1627,黄铭,2022-01-07 08:23:52,13,13,0,老师很善良，很好！！
146713,1627,黄铭,2022-01-07 08:54:03,16,16,0,3.9，不算高，但我平时也比较摸鱼，老师上课这次就要求一次发言，还有一次小组展示，剩下的写感悟就好了，讲课说实话我没怎么听，但还是能看出来老师有自己的想法，加上这次碰上好助教领，线上授课的时候直接计每个人一次发言，所以还是没什么压力的，推荐大家玩了命的选
146763,1627,黄铭,2022-01-07 11:29:01,6,6,0,老师出分好快2333\n\n说实话马原这种课很难有兴趣听吧，但能看出老师努力把课讲的生动了。而且这学期平时分给的很好看~
146920,1627,黄铭,2022-01-08 05:01:19,3,7,4,还好吧，平时分相差不大（据说所有班级平时分都是统一的标准），老师把6次发言改成了可以课后写感想，这次论文题目是读共产党宣言，主要看期末吧。总结，老师现在分不高，但其实可以选的，主要是每个分数构成认真做做。
146955,1627,黄铭,2022-01-08 07:11:46,4,5,1,老师好，哈哈哈哈
147000,1627,黄铭,2022-01-08 11:11:46,7,7,0,水课 选！
147287,1627,黄铭,2022-01-09 12:10:13,10,10,0,考核是很清晰的
147899,1627,黄铭,2022-01-11 06:21:09,22,23,1,老师人很好。能看出来是努力在把马原课讲生动的。鼓励我们上课发言也是希望我们把马原知识应用起来，即使害羞上课不敢发言也可以课后写三百字左右听课感想作为发言。上课也有新思想，能把马原灵活应用在当代社会中。老师的目的是让马原不再是一门水课，虽然我马原绩点不高，但我真的觉得黄老师是个好老师。给老师十分（ps:zm助教xgg人也超级棒，给他点赞）
150493,1627,黄铭,2022-01-26 18:12:33,8,8,0,很好的老师
157965,1627,黄铭,2022-06-26 00:12:41,4,5,1,老师平时分给的挺不错的，讲课也蛮好的。助教xgg也很负责，课后答疑很有耐心
160648,1627,黄铭,2022-09-29 07:40:21,3,3,0,老师讲的非常好，收获很多
165654,1627,黄铭,2023-01-09 06:37:56,6,6,0,老师讲得很生动，人也有耐心，宝藏老师
165928,1627,黄铭,2023-01-10 12:05:48,17,17,0,超级喜欢付洋洋助教~老师也不错，按部就班完成，平时分应该挺不错的。可以选!上的是马原。
165934,1627,黄铭,2023-01-10 12:28:12,11,11,0,老师上课水平其实很不错，前面几节课因为看了查老师评论有点害怕，没怎么认真听就自己看书，后来仔细听发现老师讲课很清晰很有条理，课件也是简明扼要，仔细听老师讲课收获还是不少的。助教姐姐也非常nice，特别温柔而且认真负责，答疑也非常及时。这学期上黄铭老师的马原课感觉非常棒，给分也很不错，比我预期的要高，学弟学妹们可以放心选黄铭老师的课哈
166644,1627,黄铭,2023-01-13 06:38:38,8,8,0,老师的平时分好好做可以很高 每个部分的平时分都很清楚 助教学姐也非常非常好 值得一选
171942,1627,黄铭,2023-04-13 04:52:40,8,8,0,老师上课非常生动有趣，对待同学也很好，教授给了我们很多哲学上的思考
175488,1627,黄铭,2023-06-25 07:38:15,3,4,1,就点过几次，老师讲的很好
175520,1627,黄铭,2023-06-25 10:11:19,4,5,1,不要被这个六点几的评分迷惑（可能是历史遗留问题？）。老师给分很好，助教姐姐人美心善，真的不要怕。
175553,1627,黄铭,2023-06-25 12:58:22,3,4,1,好老师，不要被评分吓到啦～
175865,1627,黄铭,2023-06-27 04:01:01,3,4,1,老师真的不错，讲课很好。如果你是喜欢上课做自己的事的话可能需要考虑别的老师，老师上课会有提问与分享的环节（平时分既可以发言写感想也可以不发言写感想，社恐人也没事）。实际上马原这种会有优秀率限制的课，最后的得分真的和自己的关系很大，老师只能帮助你尽量拉高平时分。
178135,1627,黄铭,2023-07-07 05:42:05,3,3,0,老师给10分，助教给10分，但是有一说一，课程有些内容真的有时候很无聊。不过老师是学哲学的，有自己独到的见解，也很认真听同学回答问题。但是有些同学干自己的事连老师走到面前问他问题都没发现，有点太过分了吧。但是这样，老师也没有生气。挺和蔼的一个老师，经常请大家抬头听他讲课，至少我在课上收获了挺多，也主动发言几次，最后给分也不错。
178467,1627,黄铭,2023-07-12 05:26:33,4,5,1,不要被评分吓到了，23春夏马原体验良好~课程有些内容真的有时候很无聊，感觉老师虽然是学哲学的，但是在表达自己的见解的时候过于民哲。上课互动很多，不管同学回答什么废话或者回答不出来都会认真听并加以鼓励。老师人很好很和善，经常请大家抬头听他讲课，不怎么听也问题不大，因为老师上课基本不讲考试相关内容，都是讲自己的理解并启发同学们理解。。。
178599,1627,黄铭,2023-07-16 10:09:03,4,5,1,选课的时候看到这个评分挺害怕的。。但是注意到最新评论都是比较好的，于是就选了。老师人很好，上课也看得出很用心在上。事情稍微有点多，成绩构成为平时分50分（读书报告30%+6次心得30%+点到10%+小组展示10%）+期末考50%，给分很好（本人所有作业认真完成，上课没听课考前几小时速成，最后89）。另外就是老师上课喜欢和同学们互动，喜欢让同学们回答问题。。可能有些同学会不太喜欢吧。\n\n总之我认为就最近一两年的情况来看，老师6.几的评分过低了，至少应该9以上（我打10分），大家可以放心选。
180914,1627,黄铭,2023-09-28 06:17:34,1,1,0,老师真的很关心学生，上课也很有趣，速来打分
186861,1627,黄铭,2024-01-13 09:26:23,4,4,0,马原考完光速出分，感谢黄老师捞的这么猛，助教姐姐也很好，本来以为要寄了
186865,1627,黄铭,2024-01-13 09:30:58,3,3,0,出分超级快，速来打个分，老师人特别真诚，很好！不会强制对号入座，上课很热情。
186868,1627,黄铭,2024-01-13 09:33:42,2,2,0,点名挺多的，黄老师上课有自己的逻辑体系，最后一节课是展示。\n\n上课比较喜欢和同学互动，会点同学起来回答问题，但是很和蔼，无论发言怎么样都会肯定你。\n\n主要给分很好！表白黄老师和助教fyy姐姐！黄老师值得9+的分数
186869,1627,黄铭,2024-01-13 09:36:51,1,1,0,后悔没听老师的课，感觉老师很好也很负责，大爱助教姐姐，真的很好。考前背了一个晚上，给分很好！（本人理科真的是助教在捞了
186889,1627,黄铭,2024-01-13 11:55:53,1,1,0,24小时速捞。神！
186910,1627,黄铭,2024-01-13 13:31:11,1,1,0,老师出分光速一样！虽然平常课上有些细细碎碎小任务比如发言之类，但老师态度很好也是真的希望学生学点知识的感觉！
186995,1627,黄铭,2024-01-14 05:07:48,2,2,0,老师很好！喜欢和同学互动，但是互动的话写课后感想可以加分呐，平时没有小测。助教姐姐人也很好！
187030,1627,黄铭,2024-01-14 07:51:54,2,2,0,老师超级捞！助教姐姐也人美心善！老师上课会提问但是回答不出来也问题不大的。老师希望你上课认真听，会漫游课堂点人回答问题。本学期是6次感想+1个小组合作pre+共产党宣言读后感论文 任务量还算可以 推荐选选选！
187201,1627,黄铭,2024-01-15 04:38:44,3,4,1,老师太好了，给分应该普遍可以，不过稍有失望，6次感想都发言了，期末背了一个礼拜。本来以为能冲4.8以上的
187829,1627,黄铭,2024-01-17 14:06:04,4,4,0,老师完全不止查老师上这个分\n\n平时的workload也不是很重\n\n主要是 六次课后心得 + 共产党宣言读后感 + 点名\n\n虽然老师平常上课互动很多 但是能感受到老师的真诚\n\n从钉钉群的谢谢老师来看 老师的给分应该整体都很好\n\n大爱黄老师和助教jj
194157,1627,黄铭,2024-06-22 09:07:29,1,2,1,老师讲课很有自己的思想，是把书本越读越薄地那种。平时没有小测，负担比较小，只需要写六次发言心得就可以（上课也可以划划水，但建议听课），助教fyy也很好，很nice。总之欢迎大家报黄铭老师的马原课！
194170,1627,黄铭,2024-06-22 10:08:16,2,2,0,完全不止查老师上这个分！！其它评价说的很对。\n\n我感觉老师心里很希望学生能好好上课，对于“课上很少有学生听讲”这一现象老师挺无奈失望的。
194174,1627,黄铭,2024-06-22 10:23:03,3,3,0,我分好低
194186,1627,黄铭,2024-06-22 11:16:31,1,1,0,挺有思想的老师，满分！
194428,1627,黄铭,2024-06-24 01:59:26,2,2,0,看得出来老师在很努力地讲课了，平时六次心得、一次pre、一次期中论文，也不算太忙，考前认真背背书给分不错的
194533,1627,黄铭,2024-06-24 09:08:20,1,1,0,黄老师很可爱，讲课不水，每次都很认真。事情也不多，最后给分很好！没想到他会给我这么高分，特别感动。
195406,1627,黄铭,2024-06-28 03:33:04,0,1,1,老师非常好，学识渊博，喜欢互动，不过不管你站起来说什么老师都会鼓励你，顺着你的发言展开说两句，助教姐姐人也很好，背了1天最后4.5也满意了
197522,1627,黄铭,2024-07-18 03:31:37,1,1,0,很有思想深度的老师。作业满分30，貌似有1-2次点名没到，期末认真复习作答，93分，给老师比心
2273,1884,崔浩,2015-04-16 07:34:28,12,30,18,激情澎湃
12125,1884,崔浩,2015-12-22 02:34:55,11,21,10,老师思想很正 党性句高 但是上课太砖 感觉与当代思想脱节了
25573,1884,崔浩,2016-05-26 05:05:25,5,10,5,形式化 思想古板 酷爱点名
30361,1884,崔浩,2016-07-01 11:46:45,1,5,4,一次点名不到妥妥的6分没了，秒跪
30369,1884,崔浩,2016-07-01 12:06:11,1,3,2,死于点名
32128,1884,崔浩,2016-07-05 16:29:53,4,5,1,只能说期末考很重要...
38469,1884,崔浩,2018-12-25 09:29:57,4,9,5,完全不想说什么，也不讲道理
38474,1884,崔浩,2016-12-06 09:07:07,7,9,2,不知道在干些什么，活在梦里\n\n
38543,1884,崔浩,2016-12-08 09:07:21,1,2,1,啥也不说了 都是泪
38545,1884,崔浩,2016-12-08 09:46:43,1,2,1,不讲道理
40109,1884,崔浩,2016-12-29 07:52:02,-4,5,9,辣鸡毛概课，每次去都不点名，害我每次都浪费几节课时间
44037,1884,崔浩,2017-01-17 08:34:51,3,5,2,给分奇差
47136,1884,崔浩,2017-01-24 04:06:42,0,1,1,给分一般
48031,1884,崔浩,2017-02-28 05:38:54,-1,1,2,唉，我就试试
48131,1884,崔浩,2017-02-28 15:50:46,1,2,1,…呵呵呵
49918,1884,崔浩,2017-04-27 06:46:35,7,13,6,太直男癌，思想太落后，太傻逼了，气得受不了来打差评
51359,1884,崔浩,2017-06-01 17:12:37,-2,1,3,混日子
52448,1884,崔浩,2017-06-20 07:05:17,6,8,2,花了一个小时批评医疗系统（自己想像中的），然而对医疗系统的实际情况了解很少。。。
53911,1884,崔浩,2017-06-28 04:21:30,2,3,1,直男癌 酷爱折腾留学生 .....\n\n一次点名不到平时分就gg了\n\n给分奇差无比\n\n千万别选 血的教训
53918,1884,崔浩,2017-06-28 04:26:17,3,5,2,他的课一定要去啊，会点名，一次不到期末扣6分，血的教训
54469,1884,崔浩,2017-06-29 10:54:26,12,16,4,平时分并没卵用，考后24小时内就能出分? \n\n
54549,1884,崔浩,2017-06-29 15:10:08,2,4,2,长叹一口气
78937,1884,崔浩,2018-05-29 06:31:05,1,13,12,我觉得老师还不错，大家不要人云亦云说他不好?
81026,1884,崔浩,2018-07-05 16:44:01,19,27,8,猜一猜48小时 会不会出分
81783,1884,崔浩,2018-07-06 07:27:06,21,24,3,给分奇差无比\n\n莫名其妙的给分\n\n真的令人发指
81785,1884,崔浩,2018-07-06 07:28:57,9,10,1,给分令人发指
81786,1884,崔浩,2018-07-14 07:42:56,9,16,7,崔老师是不错的，你们不要有太大的刻板印象。
81787,1884,崔浩,2018-07-06 07:30:15,7,9,2,讲的烂
81792,1884,崔浩,2018-07-06 07:37:53,10,11,1,用脚给分，令人发指
81793,1884,崔浩,2018-07-06 07:39:50,9,11,2,随机给分，令人发指
81795,1884,崔浩,2018-07-06 07:49:20,-19,7,26,老师还不错吧，平时分叫我们都打高一点，就是说考试范围的时候和最后考试时完全不一样(｡･ˇ_ˇ･｡:)，最后应该是用脚指头给分的...86划过
81798,1884,崔浩,2018-07-06 08:01:52,7,8,1,按理来说，就算大家真的对于思政课学的不太好，也没必要改卷子这么狠吧？
81801,1884,崔浩,2018-07-06 08:11:23,-1,16,17,出成绩前那个不要人云亦云说老师不好有6个赞同 出成绩后现在只有1个赞同了 平心而论老师人挺好的 不过有的观点确实比较陈旧 毛概的期末考试真的很难 如果没有记的话真的拿不了高分 平时分拿得很低的话最后的成绩也不会高 老师算分还是好好算的 努力和收获在我看来还算成正比 这门课大家都不想上但是必修 还是靠自己多努力吧 也希望毛概课的同学互相体谅一下 展示打分打高一点 大家都不容易= =
81806,1884,崔浩,2018-07-06 08:29:54,5,8,3,毛概大课点名，给分靠脚 NB
81814,1884,崔浩,2018-07-06 08:40:34,5,7,2,辣鸡老师嘤嘤嘤QAQ
81818,1884,崔浩,2018-07-06 08:51:44,5,7,2,辣鸡，绩点给那么低
81917,1884,崔浩,2018-07-06 13:10:43,8,10,2,老师课上得怎么样我不想评价，但是这个期末卷子？？？？请问是当成开卷考出了吗？？？？
81928,1884,崔浩,2018-07-06 13:27:37,13,16,3,给分也太差了吧……真的吐血了，后悔当初为什么还要花这么多时间背书…付出得不到一丝回报
82172,1884,崔浩,2018-07-07 10:19:31,7,8,1,听我一句劝，选了他的课就退了吧
82221,1884,崔浩,2018-07-07 12:56:17,3,4,1,不知道是怎么给分的 背不背的 唉
82281,1884,崔浩,2018-07-07 16:10:47,-4,6,10,全班16.7%的挂科率\n\n最高分3.6\n\n自己选择退不退吧
82282,1884,崔浩,2018-07-07 16:11:26,-1,1,2,我没选。。不过学习帝均绩没过1.5。。
82302,1884,崔浩,2018-07-07 23:03:44,1,6,5,那个说全班17.6%的挂科率，最高分3.6的能不能不要造谣，你哪里来的数据，光我知道的就有两个4.2的了。
82396,1884,崔浩,2018-07-08 05:30:04,0,5,5,我在学习帝查到均绩2.8，我3.0居然还算高分，不清楚是学习帝的问题还是老师的问题，慎选
82784,1884,崔浩,2018-07-09 06:28:38,2,3,1,平时分一般，期末复习时又没时间把整本书背下来的，基本就凉了。
83279,1884,崔浩,2018-07-10 04:04:51,-15,6,21,我4.8 ，客观来讲，课很水，虽然毛概都一样，但是崔老师还是很负责，自己统计平时分，算了两遍，平时有一次点名，没到平时分直接扣五分，然后只要考试前看书认真一点，应该基本不会太差
91991,1884,崔浩,2018-12-25 08:29:02,2,3,1,这老师听展示的时候开始diss，但是没有依据和风度。观感极差
98036,1884,崔浩,2019-01-23 04:12:23,-3,1,4,支持一下，好歹有4.2了
98067,1884,崔浩,2019-01-23 04:44:03,0,0,0,无话可说，惨遭正态，都怪我三个代表没选对。
98075,1884,崔浩,2019-01-23 05:00:07,-3,2,5,如果不是真的喜欢，谁又愿意当SHZY的舔狗呢？
98090,1884,崔浩,2019-01-23 05:12:26,1,1,0,其实老师挺好的。很和蔼，毛概整体给分都是很求是把。主要是平时课上的问题讨论一定要发言！！
98133,1884,崔浩,2019-01-23 05:58:59,-2,0,2,我感觉老师还行吧。听大课感觉和老师们都差不多。4.5我已经很满意了。可能考试还是不能放松的，得背
98167,1884,崔浩,2019-01-23 06:46:37,0,1,1,说实话老师挺好的，毛概得背
98178,1884,崔浩,2019-01-23 06:58:43,1,3,2,毛概有三宝，发言选择加报告，发言全满报告好好写平时分就快满了，选择好好做背点什么就4+了，老师很好的别听楼下人瞎说
98179,1884,崔浩,2019-01-23 06:59:00,-2,1,3,只要认真准备，认真发言，平时分是可以很高的，而且只要每个人都认真小组里每个人都可以拿很高的分数。老师人也很好，最后考试有一点遗憾，但是很满意，谢谢老师。
98203,1884,崔浩,2019-01-23 07:35:32,2,2,0,今年可能变得善良了，没有立刻出分，和其他老师一起出的，给分也还不错。
103128,1884,崔浩,2019-02-26 05:54:38,0,1,1,挺好的~
105284,1884,崔浩,2019-04-09 05:39:25,3,4,1,学生按流程请假，外出实习交了正规请假单，他开地图炮批评学生和院系态度不对，“对习近平新时代中国特色社会主义是什么态度，这是个政治问题，比你专业课程不及格重要得多”，服了
108415,1884,崔浩,2019-05-23 08:35:25,1,3,2,这么左废话这么多的老师\n\n受不了了……
108416,1884,崔浩,2019-05-23 08:41:42,-2,2,4,真的，傻x老师…没有水平还瞎bb，自己讲话讲太多说展示的人超时，让人无语
108459,1884,崔浩,2019-05-25 02:07:41,-2,0,2,呵呵呵p
108551,1884,崔浩,2019-05-28 06:38:23,0,2,2,听他的课犯恶心
108644,1884,崔浩,2019-05-30 08:20:07,-1,1,2,来上他的课真的要闭耳朵，多听一句话都会被气死……
108658,1884,崔浩,2019-05-30 14:07:55,24,30,6,今天听完课特地来评论，7分。说实话老头确实比较固执，和学生毫不讲理地杠。但作为一位老教师，比较在乎尊严也算情有可原。讲的内容中规中矩，不能说好，也不能说差。以前一直佛系水课，但今天上完课我却被他的几句评论所触动。作为他这种年纪的人，他对现代科技的一些观点竟然可以说是超前。现代科技的一些方向是不是真的正确；是不是科技“高”了，就一定是好；所谓的科技发展到底是应该放任自由，还是得有主观的把控。不管是老师从别的地方看来的，还是自己想出来的，我觉得就凭这几句话崔老师上的毛概课就有属于他自己的价值。
109174,1884,崔浩,2019-06-11 06:35:16,1,1,0,恶心死了
112197,1884,崔浩,2019-07-03 22:10:41,-7,5,12,辨析题错了一题还能有4.5，感谢老师的师生情。
112345,1884,崔浩,2019-07-04 02:22:52,0,2,2,努力才有回报，老师还是不错的。期末考试卷子略难。听说先出分的班都炸了，分数没有调，平时分92，最后3.3。老师出分这么晚，大概是考虑了一下师生情吧?
112363,1884,崔浩,2019-07-04 02:53:54,1,3,2,用脚给分
112916,1884,崔浩,2019-07-05 10:43:49,0,0,0,老师很好！认真学习就行！
113254,1884,崔浩,2019-07-06 02:57:06,1,1,0,给分奇低
119619,1884,崔浩,2019-11-14 07:13:20,0,0,0,老师上课不知咋一直在吐槽（收入分配不均等等），还是觉得认识和价值观有偏差
120328,1884,崔浩,2019-11-28 14:29:33,2,2,0,听得直犯恶心
124458,1884,崔浩,2020-07-01 12:31:18,1,1,0,还行。。。出分又是第一快 平时分92最后才3.9晕了....感觉有的班给分还不错，崔老师班就....
131793,1884,崔浩,2021-01-29 03:44:12,0,1,1,不调分，毛概这种5学分的水课一定要选个给分好的老师，这学期选不上就下学期再修。一般年轻老师给分都比较好
171755,1884,崔浩,2023-04-04 05:42:30,3,3,0,上课真是煎熬
174986,1884,崔浩,2023-06-20 14:28:20,1,1,0,听过他讲课的都懂
174997,1884,崔浩,2023-06-21 01:12:52,2,2,0,上课读教科书，照本宣科，毫无思想和心意
176263,1884,崔浩,2023-06-28 07:36:50,0,0,0,小组平时分比较高，考试一秒钟没复习，最后3.9。虽然上课一坨但是给分是真的很好
197487,1884,崔浩,2024-07-17 02:12:13,1,1,0,不否认老师思想很正、很红专，但是上课是典型的照本宣科，直接读课本，毫无独立思想和创新意识
1676,1935,张彦,2015-03-23 07:29:07,-1,11,12,给分挺好的 人也很好
3431,1935,张彦,2015-06-16 05:37:51,5,12,7,上课事情巨多
5433,1935,张彦,2019-04-20 12:16:48,8,24,16,蛮好的美女老师！和旭平搭配很不错！哈哈哈哈
6811,1935,张彦,2015-07-23 06:13:38,3,8,5,事情比较多 给分一般
6848,1935,张彦,2015-07-25 07:13:27,4,13,9,枯燥无味，故弄玄虚，实在乏味
7406,1935,张彦,2015-09-14 08:19:08,9,16,7,气质很好的美女老师，声音也很好听。最后虽然被正态了但我也理解啦，毕竟自己没考好。
33659,1935,张彦,2016-09-21 01:46:09,-8,1,9,还没上课\n\n\n\n
33667,1935,张彦,2016-10-25 08:35:30,2,5,3,事情太多了 而且很多烦人的要求 还组内分配分数 无语 受不了
39841,1935,张彦,2016-12-28 03:18:51,2,5,3,老师上课真的很有激情，几乎是我大二上学期最好玩的课，虽然事情有些多，但是收获也很多，而且老师性格也好
40258,1935,张彦,2016-12-31 03:00:19,2,5,3,老师人很好，上课讲的是哲学，很有激情，风趣幽默。只要自己愿意，认真去做，平时分就可以满。
40907,1935,张彦,2017-01-06 08:04:42,7,12,5,很好的老师，上课很有趣，给分全靠自己。一切从实际出发，理论联系实际，实事求是。?
43305,1935,张彦,2017-01-16 06:15:32,4,14,10,绝对的好老师哦，虽然据说下个学期不开课了，力推啊，基本不点名，平时分可以自己努力到满，出成绩也太快了吧哈哈哈哈
43306,1935,张彦,2017-01-16 06:16:29,5,9,4,努力一点平时分就可以满，期末再努力就可以高分了，给分全靠自己。老师本身讲的也很不错。
43315,1935,张彦,2017-01-16 06:38:34,13,16,3,出成绩速度惊呆
43320,1935,张彦,2017-01-16 06:42:43,1,7,6,平时分很多人可以拿满分，但是不拿满分的人考试好好考也能拿到好成绩的。老师出分真是神速神速啊。
43327,1935,张彦,2017-01-16 06:53:07,3,10,7,本学期最喜欢的通识课老师，所有思政课中听得最认真的一门，老师真的超级好，上课会和大家分享自己的经历，讨论的问题也都很有趣，课上得很好，给分也很好，有平时分满分通道。误打误撞选了老师的课真的很幸运呀
43342,1935,张彦,2017-01-16 07:15:27,9,14,5,点了一两次名，平时分要靠自己挣，但是给分还不错。上课同学发言的问题比较浅显，老师应该挺有涵养的，感觉问题深入些更好。出分快。
43369,1935,张彦,2017-01-16 07:49:30,-3,1,4,nice
43429,1935,张彦,2017-01-16 09:02:47,3,4,1,呵呵呵
43780,1935,张彦,2017-01-17 03:00:22,-2,1,3,听就有收获
44075,1935,张彦,2017-01-17 09:01:43,0,5,5,老师人很好，不会给挂科!!!
44164,1935,张彦,2017-01-17 11:07:53,6,10,4,平时分有满分通道，但大多都只是多交论文，上课发言刷刷脸。讲课非常有激情，可惜没什么深度，听了没有收获。不过作为思政课不来管东管西烦人就不错了吧。主要靠平时
44943,1935,张彦,2017-01-18 14:45:39,-3,2,5,美女老师
59288,1935,张彦,2017-09-20 12:37:36,6,8,2,想水不可能，用功也可能正太
64720,1935,张彦,2017-12-27 02:33:15,-3,3,6,人炒好，考前会把考试内容告诉我们，开朗爱笑的美女老师
66898,1935,张彦,2018-01-19 08:36:09,-2,4,6,超级可爱和善的老师 很美很厉害 简直是人生楷模呀 不管给分怎样 关键还是要靠自己努力啦 老师真的很好很好
68433,1935,张彦,2018-01-23 08:00:07,-1,5,6,老师很棒！讲课很有意思！上课前还会发红包，从来不拖课！
68594,1935,张彦,2018-01-23 12:21:42,14,18,4,我觉得 我不应该.....得这个绩点.............差评
68943,1935,张彦,2018-01-24 06:51:39,-4,2,6,随和有收获
69348,1935,张彦,2018-01-24 13:47:50,-2,3,5,老师很棒，拿分主要靠自己！
79922,1935,张彦,2018-06-15 07:49:50,-3,4,7,全校性的党课上，老师很棒，把马克思讲的很平易近人
80095,1935,张彦,2018-06-20 02:57:56,-4,5,9,老师是一个很赞的老师，枯燥的马原也讲的超有趣，10分！！！
81511,1935,张彦,2018-07-05 08:56:33,2,5,3,其他都挺好的，就是上课按照固定的位置坐有一点小难受
81702,1935,张彦,2018-07-06 02:48:03,-3,2,5,讲课真的超有意思！能把原本略显枯燥乏味的马原课上的趣味盎然，给分也相当好！只要你认真去对待课程了，分就不会低
81713,1935,张彦,2018-07-06 03:02:40,-2,2,4,平时分有满分通道，而且占百分之七十，所以只要两次展示多用用心以及参与满分通道（一般比较容易的事写两篇论文），就可以拿高分了。老师人好，出分快，上课会讲自己的有趣经历，非常推荐
81739,1935,张彦,2018-07-06 04:47:17,10,13,3,事情巨多，想水的话，是不存在的了。亲测身边的工科生没有走满分通道的，都被正态了。老师人很好，讲课内容比较浅，喜欢到处乱走活跃课堂氛围，叫人回答问题。不能用电脑，看闲书。位置按号座，每节课统计缺勤和发言。
81918,1935,张彦,2018-07-06 13:12:06,-8,6,14,【不是我说 郑强来的那堂课让我真真实实对张老师产生了好感】老师事情是真的不多 本人不喜恶竞最后满绩 挺愉快的思政课上课体验
82032,1935,张彦,2018-07-07 01:59:27,0,3,3,课程比较浅，没有太多有营养的东西。平时上课必须对号入座就有些烦。考试周花5个小时精心准备了ppt，内容也精心构思了，结果没有选上。选上的同学上去照着ppt念……怎么说呢，老师人很好，照顾学生，给分也不错，但是没有真正的启发性，不能算一节真正优秀的课。事情不算多也不算少，给个8分吧\n\n
82303,1935,张彦,2018-07-07 23:18:30,-5,4,9,作为工科生，高中理科生，觉得张老师讲课听起来很舒服。对于很多问题都可以参与讨论，哪怕自己对哲学没有什么认识……（这也可能是前面同学提到的浅显）但浅显紧跟着就是易懂。真的认真听一节课会觉得老师的重点很突出。【而我只是去当了1次观察员+平时1次发言】\n\n对于前面那位精心准备5个小时招标课题的同学，有点心疼你，可能那次竞争的同学太多了吧。但是，我用了至少8个小时准备，完全从零开始理解。被选上后，又用了10来个小时改稿子和PPT，整体结构变了两次，PPT改了七稿，自己练了十几遍，以至于到考试的时候都能把讲稿中最核心的部分背出来。即便这样，老师也只给了两颗星，有同学是三颗星。所以看大家觉得值或者不值得了。 对给分的问题，我觉得确实可以通过自己的努力做好。我前面参与了招标课题，既是想锻炼自己，也是想不写论文，就没有参与满分通道。听到20多人，50分的平时分直接满了，感觉自己就有点凉了。但期末考试之前用了差不多15-18个小时，看了一遍书（老师要求看两遍，但我实在没时间）虽然什么都没记住。考试时按照老师给的技巧能写的都写上去。最后总评成绩出乎意料地好。\n\n对于按序号坐的问题，我也觉得很难受，但听同学说马原课都这样（可能我问的同学比较少）就不管它了。
82463,1935,张彦,2018-07-08 09:11:49,-9,1,10,老师上课气氛轻松\n\n一定要有学习马原的积极性\n\n老师给予的满分通道、招标课题的机会一定要去试一试，上课好好听，书认真看。\n\n不努力就会像我一样垃圾
82494,1935,张彦,2018-07-08 10:36:44,-11,4,15,马原很活泼 后来叫别的老师来上啦两章 才知道张彦把这门无聊的马原上的有多不无聊 很赞 老师很好看
82551,1935,张彦,2019-01-21 14:40:01,13,30,17,郑强老师说，张彦老师是有颜值的老师。
87153,1935,张彦,2018-09-21 02:58:21,26,29,3,说实话，老师在小组讨论上过于注重形式了，基本上每个小组在展示时都会表演节目。而面对以讲内容为主的同学，老师不会认真听，也很少给予肯定。
87684,1935,张彦,2018-10-10 04:38:04,52,68,16,我本来对马克思政治经济学和哲学很感兴趣，但张老师的课成功把我的兴趣扑灭了。说实话，从张老师的课上我没有看到一点哲学的思考，我只看到了恶竞。如果说给分好就算好老师，那么当一个好老师也太容易了吧
88299,1935,张彦,2018-10-27 10:58:28,11,17,6,简单评价下： \n\n1、授课内容广且浅，举例较多，理论剖析几乎没有；作为马哲普及很不错，但容易使想深入了解马哲原理的同学失望\n\n 2、每学期一次论文（或个人展示），两次小组展示，任务繁重程度一般，但仍不可懈怠；此外，该老师的成绩分配方法略有问题（满分通道），易造成恶竞 \n\n3、按序号坐座位，一学期不可变动（相当于点名），迟到坐后排 \n\n4、老师爱笑，课堂氛围活跃；但个人感觉她有时是纯粹为了开玩笑而开玩笑，有点不大舒服 \n\n5、给分很好（据说，因为我还正在上这门课）\n\n
91855,1935,张彦,2018-12-23 07:30:03,9,16,7,这就是浙大马院的水平？
96753,1935,张彦,2019-01-21 09:55:01,17,19,2,讲课看似笑容满面，其实毫无生趣，最后一节课最后时刻划了一章的重点，但是连选择题都没考到。\n\n还有我不明白满分通道的意义在哪里，鼓励恶竞压榨不恶竞的同学吗
96799,1935,张彦,2019-01-21 10:04:36,13,13,0,这就是个垃圾老师 之前说的别信 节节课都得到 而且上课极差 给分不好 对于想学的和想水的都是一种折磨
96856,1935,张彦,2019-01-21 10:51:51,10,10,0,只要不努力，一定会被正太，如果努力，最好当个组长，课代表什么的，（我感觉我就被组长坑了），别人说过的我就不说了，如果不想正太，一定要满分通道，老师说没差多少呵呵其实绩点也就差1分……论文自己写还不如别人40分钟抄的，真的没办法，总的来说就是恶竞。
101180,1935,张彦,2019-01-28 01:19:02,6,7,1,及其鼓励恶竞.上课不知所云毫无重点抹杀兴趣。第一次给差评，献给张彦
105422,1935,张彦,2019-04-12 11:40:51,6,7,1,原本对于张老师印象良好，上课幽默风趣，虽然讲的比较浅感觉很多观点没有解释清楚，但是至少不是特别无聊。直到做展示的时候老师全程看手机……瞬间印象负分
108904,1935,张彦,2019-06-04 03:14:37,8,8,0,我觉得张老师有点过于注重形式了。她没有很好的阐明知识点背后的道理也没有与实际结合，她的玩笑是单纯用来活跃气氛的，她的知识点是照着PPT读的。\n\n我觉得招标课题展示还可以理解，但是期中多写一篇论文也可以进入满分通道感觉像是在鼓励恶竞。讨论课分组展示就是去看戏，没办法，演戏老师觉得更好看，得分也更高啊。\n\n我以为马原课就是这么无聊，直到有一次张彦老师感冒请假另一个男老师帮忙代课。那个男老师讲话也并不是很风趣，也没有很吸引学生的点，他只不过是把每个知识点都展开解释了一下。我忽然觉得马原课原来还能听懂，马原的知识原来还蛮有趣。\n\n张老师的另一个满分通道是做视频。我觉得她收到视频的最大用处就是放给下一批选她课的同学看。\n\n但是张老师在点名方面挺认真的，认真出勤的同学一定会得到公正的对待。家庭生活也挺美满的。上课面带微笑，有时唠唠家常，除了马原有关的内容，剩下都挺好。
115562,1935,张彦,2019-08-04 05:25:23,-1,0,1,Hehehe
117520,1935,张彦,2019-09-25 09:43:10,6,6,0,鼓励恶竞而不自知
117709,1935,张彦,2019-09-29 14:17:17,7,7,0,鹅颈的极点，上课无营养发言，听了两次课就受不了了，我想去吐一会儿。最关键的是，当我们提出可以在哪里防止鹅颈之后，老师还以鼓励兴趣为由否定了我们的建议。真是形式主义呢～呵呵
117936,1935,张彦,2019-10-16 02:21:44,6,6,0,讲的什么玩意，认真上课不行吗？能不能不要恶竞蛤？
119039,1935,张彦,2019-11-10 01:05:29,3,3,0,鼓励恶竞
120264,1935,张彦,2019-11-26 13:57:18,8,9,1,恶竞女王
120766,1935,张彦,2020-01-16 21:39:21,6,6,0,说句实话，这样的课堂看似很多样，但真的是充满恶臭。首先，上课的内容就不够深入，更不够吸引人。其次，花样太多，反而失去了上课的初衷。真的请同学慎选，除非你认为自己可以在恶竞种脱颖而出。
120790,1935,张彦,2020-01-17 03:01:16,1,2,1,鼓励各种形式的恶竞，得分很大程度上取决于你想不想恶竞\n\n恶竞了之后的给分都还行
126603,1935,张彦,2020-10-07 02:29:36,-13,9,22,这秃头丑逼臭狗屎整天傻逼一样的傻笑，而且普通话讲得真烂！还“万人拔尖”人才？臭三八垃圾一坨屎！！长的真他妈丑，给1分都嫌多！
128105,1935,张彦,2020-12-07 10:09:04,10,10,0,课堂内容无深度，嬉皮笑脸，浪费时间
131458,1935,张彦,2021-01-27 14:39:59,-2,0,2,。。。
132450,1935,张彦,2021-02-01 15:50:05,2,10,8,大姐你谁啊，上课不给看电子设备？亏你还是我老乡，我们慈溪真是耻辱啊培养了你
143256,1935,张彦,2021-11-22 12:27:56,4,4,0,习概课她那两节，庙小妖风大，卷，就硬鼓励卷
150757,1935,张彦,2022-02-17 13:08:29,6,6,0,不想多说啥，自己领会去吧
151258,1935,张彦,2022-03-05 16:56:10,10,11,1,垃圾老师，骗子，总喜欢傻逼一样地笑，笑里藏刀，恶心的丑三八，呸！
153895,1935,张彦,2022-05-16 05:08:26,7,8,1,全程嬉皮笑脸，鼓励内卷，上课很会制造和渲染焦虑情绪，只可惜没有0分选项，不能打0分
161053,1935,张彦,2022-10-25 04:08:09,-9,3,12,🤢🤢🤢🤮🤮🤮💩💩💩🖕🖕🖕your mother is a⌚️ who had been fucked to death.
172677,1935,张彦,2023-05-04 06:32:46,8,8,0,今天她上马原，的确是个纯正的傻逼
179020,1935,张彦,2023-08-21 12:51:44,-1,3,4,张老师我的女神！
179643,1935,张彦,2023-09-19 04:17:14,1,3,2,纯纯的傻逼
188888,1935,张彦,2024-01-20 11:14:29,0,0,0,。。。
191227,1935,张彦,2024-04-12 15:01:21,-1,4,5,张老师是我的女神！
207880,1935,张彦,2024-12-25 00:06:38,1,1,0,道法\n\n老师的课相比一同上课的另一个老师更硬核，本来没意思的课变的更无聊了\n\n第一节课的时候分享故事配合知识点的形式明明这么好让同学们这么投入，为什么要改成读ppt呢？\n\n希望改改吧
210430,1935,张彦,2025-01-09 06:59:43,-2,0,2,完全女神
212411,1935,张彦,2025-01-14 03:16:59,1,1,0,老师人还可以，但是思修给分有点莫名其妙
216804,1935,张彦,2025-03-26 02:05:52,3,3,0,吴旭平张彦的马原课。这厮上来就是全场巡视，关掉电脑手机，然后开始赔笑脸做亲切状，实属恶心无聊。
216822,1935,张彦,2025-03-26 06:59:33,0,0,0,还我wxp老师！！！
903,1977,詹兴敏,2015-03-18 15:24:16,-2,9,11,略无聊\n\n
4058,1977,詹兴敏,2015-06-17 15:36:56,0,18,18,每节课必点名，上课也很无聊，千万不要选！后悔死我了！
4181,1977,詹兴敏,2015-06-18 03:16:32,5,17,12,无聊\n\n
5322,1977,詹兴敏,2015-07-06 14:59:56,-2,7,9,老师很和蔼的
7386,1977,詹兴敏,2015-09-14 06:09:27,17,32,15,无聊死了
7568,1977,詹兴敏,2015-09-15 04:36:24,-14,2,16,棒棒哒
8415,1977,詹兴敏,2015-09-21 06:10:55,2,5,3,好无聊
9280,1977,詹兴敏,2015-10-20 03:43:22,0,4,4,超无聊，强迫自己都听不进去
10429,1977,詹兴敏,2015-11-18 15:22:30,-3,5,8,必点名\n\n强迫关电脑关手机
10841,1977,詹兴敏,2015-11-23 06:59:29,2,6,4,无聊死了
11747,1977,詹兴敏,2016-06-16 15:23:54,91,174,83,不知道楼上什么学年听的课-。 -反正15-16学年秋冬这老师不点名..来的人只有三分之一也不点名..展示从来不给任何意见特别水......作为马原老师我给满分
11775,1977,詹兴敏,2018-01-27 14:56:49,-3,20,23,sb老师，真无聊。讲也讲不清
13543,1977,詹兴敏,2015-12-29 05:44:49,0,3,3,呵呵呵\n\n
13661,1977,詹兴敏,2015-12-30 09:02:48,0,2,2,。。。
15646,1977,詹兴敏,2016-01-16 03:28:10,0,6,6,虽然很无聊。。。但是老师挺和蔼的。。。
16504,1977,詹兴敏,2016-01-18 09:10:27,4,14,10,慎选！无聊枯燥乏味烦闷！
18547,1977,詹兴敏,2016-01-22 03:43:14,-8,2,10,给分出乎意料……好老师~
18612,1977,詹兴敏,2016-01-22 06:25:05,5,18,13,讲课真的很无聊 给分也差 听课完全学不到东西 建议大家别选他的课 之后补选一个好老师
18620,1977,詹兴敏,2016-01-22 06:48:15,0,6,6,哈哈哈哈，给分还行
18640,1977,詹兴敏,2016-01-22 07:36:10,5,14,9,我也没见老师点名，虽然讲得无聊，但给分不错，老师事情也少。
18693,1977,詹兴敏,2016-01-22 10:42:34,-1,2,3,无聊\n\n
21018,1977,詹兴敏,2016-02-10 04:29:56,-2,0,2,不点名是关键
21121,1977,詹兴敏,2016-02-18 23:23:00,-5,3,8,非常好，给分奇高\n\n
21191,1977,詹兴敏,2016-02-26 03:38:09,1,2,1,无聊死了
21802,1977,詹兴敏,2016-03-01 06:43:28,-12,3,15,略无聊，人善良，给分好..不听课4.5+
23679,1977,詹兴敏,2016-04-12 05:30:12,-2,0,2,上课好像不点名，但是要提问啊。。
30836,1977,詹兴敏,2016-07-02 15:24:31,1,11,10,绝对绩杀
30852,1977,詹兴敏,2016-07-02 16:04:32,24,44,20,老师讲课有些无聊，但也绝对不是照本宣科念ppt。而且要求很少，就一篇论文和一个小组展示。我上课没发过言，没听过课，但是每次签到都到课，最后期末复习了一整天给了4.8，真是吓到了，感觉给分很不错。
33231,1977,詹兴敏,2016-09-16 04:37:53,-1,2,3,给分还可以
34852,1977,詹兴敏,2016-10-25 06:52:40,-1,4,5,讲课水平尴尬，认识水平不高，和微信鸡汤文差不多\n\n
35031,1977,詹兴敏,2016-10-31 02:16:06,-1,3,4,直男癌
35055,1977,詹兴敏,2017-03-02 03:04:31,12,23,11,为什么老师的声音这么难听。。。。。。
35299,1977,詹兴敏,2018-03-12 05:14:30,46,74,28,讲话跟个鸭子一样
35667,1977,詹兴敏,2016-11-10 07:41:11,-1,3,4,讲话都讲不清楚，超级烂
35896,1977,詹兴敏,2016-11-10 08:46:55,2,4,2,不喜欢
37949,1977,詹兴敏,2016-11-22 07:30:09,-1,2,3,次次点名，但事情是真的少！
38783,1977,詹兴敏,2017-01-22 05:08:58,-1,1,2,虽然课有点无聊，但事儿少给分还行
40407,1977,詹兴敏,2017-01-03 07:29:20,69,83,14,这样的老师还不够好？作业少期末告诉你考点在哪里上课睡觉做作业也不会管的很严等等，已经够好了吧？那么喜欢听课选夏婉婉去呀~反正我给詹老师10分【微笑】
40566,1977,詹兴敏,2017-01-04 06:00:44,-1,3,4,非常认真负责的老师，同学有什么要求基本上都会满足。然后打平时分之前还会征求所有组长的意见。一切为学生着想的好老师。
41058,1977,詹兴敏,2017-02-15 12:27:09,48,65,17,我没发言，没做组长，论文好好写老师认真考了，给了我3.9，就凭这个我就给10分。
42208,1977,詹兴敏,2017-01-14 01:54:14,10,17,7,事情少，上课可以水，展示就是简单展示没有别的马原老师展示完还一堆屁话，作为马原老师真的不能更好了.我给满分
46468,1977,詹兴敏,2017-01-22 02:47:47,4,5,1,为啥这学期的课都是分段绩点中最高的那个分，神tm亏啊。
46477,1977,詹兴敏,2017-01-22 00:33:45,0,0,0,。。。。
46487,1977,詹兴敏,2017-01-22 01:04:06,0,1,1,嗯除了上课有点无聊。。其实老师人不错，给分也还好的
46535,1977,詹兴敏,2019-01-06 11:03:10,40,59,19,帮他评分上6吧，毕竟他让我上4了
46537,1977,詹兴敏,2017-01-22 02:09:13,8,9,1,一般都是助教让组长点名……然后就一篇论文一次小组展示……我感觉还蛮轻松的。最后给了4.8，但是我上课没发言过，感觉这个老师蛮注重最后考试成绩的。考的好就行了。
46552,1977,詹兴敏,2017-01-22 02:41:04,-1,2,3,大绩杀
46558,1977,詹兴敏,2017-01-22 02:47:42,-1,0,1,略无聊，但是人很好，给分好
46562,1977,詹兴敏,2017-01-22 02:53:17,0,0,0,一般般
46567,1977,詹兴敏,2017-01-22 03:00:39,6,8,2,一个比较一般的老师，但是事情少，真的少，愿意水的可以选，期末看点书刷题库
46577,1977,詹兴敏,2017-01-22 03:06:49,0,2,2,马原就是一场噩梦 马原考试就是一颗毒瘤长在我心中 考完割掉就好了 老师给分不错
46582,1977,詹兴敏,2017-01-22 03:13:56,0,1,1,平时一次没有发言，上课没听过，居然上4了~作为马原老师，我给满分~
46625,1977,詹兴敏,2017-01-22 04:21:19,0,1,1,还行，竟然不点名……哎
46673,1977,詹兴敏,2017-01-22 06:30:36,0,0,0,没去过几次  老师没给挂  礼貌性十分
46703,1977,詹兴敏,2017-01-22 07:36:09,-2,2,4,给十分 上课从没听过考试前看了一遍书刷了题就4.5了 特别水给分又超好
46711,1977,詹兴敏,2017-01-22 08:01:48,1,5,4,老师上课不给看电脑，用手机，讲得还特别差，给分不负责任
46722,1977,詹兴敏,2017-01-22 08:21:46,4,4,0,老师给分挺好的！其实认真听老师讲课，莫名觉得很萌！
46852,1977,詹兴敏,2017-01-22 13:29:57,1,1,0,可以的
47022,1977,詹兴敏,2017-01-23 09:44:19,6,7,1,马原课看你定位如何，没什么兴趣的话，那这位老师确实事少，但讲课水平有待提高。小组展示做好考前复习一下刷题库给分不错。
47139,1977,詹兴敏,2017-01-24 04:14:19,2,6,4,绩杀绩杀，隔壁班马原都是4.5，这里一片三点几
47530,1977,詹兴敏,2017-01-30 01:04:45,0,1,1,无语凝噎
47614,1977,詹兴敏,2017-06-14 07:48:11,0,4,4,成绩出来完全懵逼啊！从未翘课，发言5次，小组展示ppt做的够认真，考试前花了半天看书而且我是文科生背景觉得题目都蛮简单的，最后给我3.6？？？
47755,1977,詹兴敏,2017-02-23 11:11:10,1,4,3,绝对的绩杀
47805,1977,詹兴敏,2017-02-25 08:04:03,1,1,0,可以熬
48406,1977,詹兴敏,2017-03-03 02:19:22,1,1,0,总算领教了.......感谢各位前辈指点......
49113,1977,詹兴敏,2018-05-13 13:01:08,-7,15,22,一位没有灵魂，缺少风骨的老师
50882,1977,詹兴敏,2017-09-21 03:30:42,-1,5,6,这是我第一次给一个老师这样的平分，即便不想听他的课，在他的课上写作业也是一种痛苦。
52368,1977,詹兴敏,2017-06-19 07:05:59,0,1,1,画重点
52444,1977,詹兴敏,2017-06-20 06:08:54,4,5,1,老师确实事少，讲课不太爱开玩笑，也有点催眠。但是老师讲得其实很好，书本知识非常清晰明白，时事热点联系得很紧密，对各种哲学理论原文信手拈来。不亏。
55519,1977,詹兴敏,2017-07-01 22:41:45,27,33,6,我的绩点没出，所以没什么偏见。讲真的，在浙大众多辣鸡马原毛概老师里，詹老师算不错的了。虽然讲课没什么激情，很古板的感觉，认真听下来，对历史上人物的观点还有著作都信手拈来，还可以吧。而且他的课可水可不水，他不点名，你要不想发言也没什么关系，作业还可以，就一个小组展示和一篇论文，期末刷刷题库。对不想水的人有点亏，对想水的人还可以。
55686,1977,詹兴敏,2017-07-02 07:39:17,0,2,2,先给老师七分，成绩怎么还不出来
56889,1977,詹兴敏,2017-07-05 02:32:31,-2,1,3,他让我上4，我给他满分， 更不论他事情少不会搞事情了
56893,1977,詹兴敏,2017-07-05 02:44:02,0,3,3,事情真的少。
56903,1977,詹兴敏,2017-07-05 03:02:28,-1,2,3,詹老师的课蛮轻松的
56907,1977,詹兴敏,2017-07-05 03:07:30,6,8,2,讲道理，马原这样的思政课大家都懂的。像老师这样事少给分好的老师已经很少了。很感谢老师。推荐！
56910,1977,詹兴敏,2017-07-05 03:11:18,0,1,1,老师的课就是普通的马原课，? 有点失望吧，课讲的不是很有趣，但是课上事情比较少。\n\n
56912,1977,詹兴敏,2017-07-09 10:14:29,-1,2,3,打卡上班
56913,1977,詹兴敏,2017-07-05 03:13:42,1,2,1,事情真的少，就只有一次展示，一次论文。虽然上课挺差的，但是事情少就好。\n\n给分主要看考试了。这是我听到过的最水的马原课了
56919,1977,詹兴敏,2017-12-28 04:49:37,30,43,13,事情极少，整个学期一次展示一篇论文，分数主要就看论文和考试，上课可听可不听，不会主动点人起来。\n\n或许在别的课上这样的老师是不负泽任的，但是马原课我给詹老师满分。给分看自己，你要是平时不听考试又不看书不刷题，随便你上哪个老师的课，你能上4算我输。\n\n
56920,1977,詹兴敏,2017-07-05 03:23:15,0,5,5,辣鸡詹兴敏，马原一出，这学年绩点跌到谷底
56929,1977,詹兴敏,2017-07-05 03:38:07,-7,6,13,楼上一群说给分差的，自己考前不背怪谁？我平时不听，考试周前花了一个星期全在看书背书，考前一天空的时间刷了两套选择题。考试的时候选择题基本都刷到过，主观题写了1000多个字全是书上切合题意的原文，最后给了我95分。只能说比某些随缘给分的思政课好多了。
56931,1977,詹兴敏,2017-07-05 03:40:31,-1,2,3,辣鸡老师，给分极低
56951,1977,詹兴敏,2017-07-05 04:36:30,4,6,2,老师绩点给的好，但是我愧对老师的高绩点。就是这样。
56964,1977,詹兴敏,2017-07-05 05:00:39,0,2,2,算可以的了
56987,1977,詹兴敏,2017-07-05 05:54:58,0,2,2,水水水
57075,1977,詹兴敏,2017-07-05 12:09:42,-1,1,2,老师讲的其实很好
58027,1977,詹兴敏,2017-07-24 04:12:01,-7,1,8,事少给分好，像我这种选择全靠蒙，大题看选择的都80+了，詹老师很好了！
59853,1977,詹兴敏,2017-09-27 14:19:47,5,6,1,评价不能批评老师的声音不好听吧\n\n作为马原的老师，我感觉他知识很渊博，上课也很认真，没有点名，也不给学生布置作业，挺好的老师
60955,1977,詹兴敏,2017-11-05 08:30:58,3,5,2,事情真的少 只要展示 论文 考试 都认真一点 绩点不会低的 平时真的超级轻松 作为马原老师我给满分
61007,1977,詹兴敏,2017-11-07 02:14:46,0,3,3,我只想知道为什么他的声音这么难听。
65672,1977,詹兴敏,2018-01-08 07:10:47,0,1,1,声音有点奇奇怪怪的，但是讲的还不错，而且事少……
70100,1977,詹兴敏,2018-01-26 06:03:48,1,1,0,反正上课水是真的，考试占的比重好大，没好好背混个3.9还行吧
70121,1977,詹兴敏,2018-01-26 06:42:48,1,1,0,上课水，事情少，考试看自己，下来的绩点也还行，作为马原老师还是可以的
70187,1977,詹兴敏,2018-01-26 08:08:35,-1,0,1,事少分好
70195,1977,詹兴敏,2018-01-26 08:15:59,-1,0,1,事少，上课也水
70199,1977,詹兴敏,2018-01-26 08:28:20,2,2,0,给分不好\n\n
70217,1977,詹兴敏,2018-01-26 08:54:34,-6,1,7,平时没发言过 考前也没刷题没背书 靠一本哲学与生活上4哈哈哈哈 虽然对其他同学不太公平但是我疯狂满足了 老师事情少 想水课不在意玄学鸡点的强推！
70219,1977,詹兴敏,2018-01-26 08:58:04,1,2,1,哇看到成绩真的是太感谢老师了。\n\n真的是事少很水，但是老师很好了
70223,1977,詹兴敏,2018-01-26 09:02:39,1,1,0,论文好好写 期末好好考 上四\n\n老师真的是很好了 基本不点名 也没有很多事 作为马原的老师给满分
70242,1977,詹兴敏,2018-01-26 09:31:23,5,6,1,没听过课，没发过言，论文认真写，复习了一个下午和一个上午，给了4.8。我觉得老师OK
70273,1977,詹兴敏,2018-01-26 10:31:05,1,3,2,点名要点的楼上的朋友们 小组点 可能你们小组来齐了吧。没听课 没背书 3.9 不好不差吧。
70407,1977,詹兴敏,2018-01-26 14:48:04,14,17,3,虽然上课一样不听，但是觉得老师是很想把课讲好，让我们有所思有所益的，可惜这是马原课。。。心有余而力不足吧。很多人都提到他的声音难听，是有点怪，但没有到无法忍受的地步。上课除了用电脑他一般都不说什么，不会抽人回答也没有发言恶竞，最后不紧不慢复习一天4.8，谢谢老师！
70489,1977,詹兴敏,2018-01-26 17:12:15,6,6,0,讲道理，作为马原老师，我只能说真的很满意了，给分也很好
70665,1977,詹兴敏,2018-01-27 10:44:52,1,2,1,上课从来没听过最后背了一天书给了4.2，我觉得可以。够水，我喜欢。
70851,1977,詹兴敏,2018-01-27 15:40:55,4,5,1,一整个学期没怎么听课发言，最后背了半天书4.5，给分很好了。老师是个很有自己想法的人，认真听应该能收获蛮多的。哦，还有，上课不准用手机电脑
70971,1977,詹兴敏,2018-01-28 01:16:15,4,4,0,课程任务轻，给分好(其实老师也知道学生都不爱听马原)。讲课怎么样不知道，因为我一般都做其他科目，最后一节睡午觉。
70979,1977,詹兴敏,2018-01-28 01:25:09,0,1,1,还不错的，但对于想听课的同学可能不太友好，毕竟听不明白他讲话，但是对于马原来说已经是很好的老师了
71372,1977,詹兴敏,2018-01-28 11:04:02,19,19,0,把上课录下来晚上听着催眠睡觉是极好的
71799,1977,詹兴敏,2018-01-29 03:21:07,2,3,1,正规马克思主义教师
72276,1977,詹兴敏,2018-01-29 17:21:33,1,4,3,作为马原老师真的是很好了，上课主要以老师讲授为主，一篇论文一次展示，不占太多课余时间，给分好无恶竞。老师人很好，上课都在做别的作业，感觉有点对不住老师……
73042,1977,詹兴敏,2018-01-31 17:14:51,-1,2,3,事不多，分好
73669,1977,詹兴敏,2018-02-02 12:57:19,0,3,3,事少，课水，分好不好就不知道了。我分挺好的
74716,1977,詹兴敏,2018-03-05 08:57:34,13,21,8,老师第一节课说大一的永远考不过大二的，真的吗
74764,1977,詹兴敏,2018-03-06 02:43:46,35,41,6,以前可能没有发言恶竞，这学期开始有了……
75549,1977,詹兴敏,2018-03-13 06:54:11,20,21,1,只有我觉得老师讲故事还行吗.. 滔滔不绝地讲，为人还很温顺
75562,1977,詹兴敏,2018-03-13 10:38:34,-2,0,2,666
76287,1977,詹兴敏,2018-04-02 05:32:33,1,4,3,这个老师上课的声音高高低低（注意不是抑扬顿挫），举例非常陈旧，讲课时在听的不超过十个。总之各种意义上都很…
78646,1977,詹兴敏,2018-05-14 06:18:35,5,6,1,上课声音一下子大起来真滴很醉
80770,1977,詹兴敏,2018-06-30 13:49:37,5,5,0,记得不要旷课了 下第一节课课代表查人 旷一次课总评扣10+?
81567,1977,詹兴敏,2018-07-05 12:17:17,4,6,2,出成绩前来评价，老师的态度没得说，每节课兢兢业业，讲的内容听一听其实是很有道理的。这学期开始好像有点名，发言加分，但是没有恶竞，都是凭自己意愿，每节课都做自己的事也没问题。论文要求也不高。挺轻松的，可以水水过，也可以好好准备展示(每组一次)，写论文。只要不旷课，分数不会差，付出多收获会更多。
81655,1977,詹兴敏,2018-07-05 16:56:30,6,9,3,怕绩点影响判断，出分之前来给老师评个9分。看评论有人说老师声音难听，讲课无聊，有点难过，或许是有一些吧，但作为一门思政课，讲课有趣你就真的会每节课认真听吗？任务少，要求松，马原课我认为选詹老师没错的。
81660,1977,詹兴敏,2018-09-17 04:51:35,-79,2,81,不明白为什么只有4.8
82015,1977,詹兴敏,2018-07-07 01:04:04,2,4,2,事少可水，第一节课可以不来，老师按时下课中间五分钟记得过来，第二节课会点人的。小组作业也比较简单，但注意小组间打分恶竞严重，老师一开始就讲了基本分数85分，还有很多组被打到85分以下的
83795,1977,詹兴敏,2018-07-11 08:39:16,6,6,0,出分好慢啊，都急死我了，啊啊啊啊
83866,1977,詹兴敏,2018-07-11 11:25:38,-1,5,6,上课发言8次+，展示分数小组全班第二，身位组长，论文认真写了，考试认真复习了，绩点4都没
83869,1977,詹兴敏,2018-07-11 11:42:42,6,7,1,真的不知道怎么给的分。
83872,1977,詹兴敏,2018-07-11 11:55:14,7,9,2,下面那条说自己发言8次还是组长展示分数全班第二的那位是鲍逸牧吧
83879,1977,詹兴敏,2018-07-11 12:15:52,-5,3,8,恶竞，大家还是积极发言？！我没发言，但认真复习了，到最后拉低我绩点(┯_┯)，想哭
83884,1977,詹兴敏,2018-07-11 12:24:31,-10,3,13,全靠考试，没发过言，小组分数倒数，论文一般，背了一天＋通宵的书，绩点总算tmd上4了
83895,1977,詹兴敏,2018-07-11 12:55:06,-11,2,13,像我这样高中不学政治的 微积分和马原同一个上午考 复习侧重微积分 最后还是上四了 而且平时事情真的不多
83912,1977,詹兴敏,2018-07-11 13:38:55,5,5,0,上课确实无聊，声音确实难听，但讲课还是挺认真的事也少，对展示不会过多发表意见，最后给分也超过了我的预期。虽然我真的不听课，但还是感谢老师一学期的分享
83914,1977,詹兴敏,2018-07-11 14:25:08,0,4,4,谢谢老师啊！自己认真努力分不会低的 很感恩！
83919,1977,詹兴敏,2018-07-11 13:51:55,19,19,0,说几点吧：老师教学态度没得说，教材熟悉程度相当高，即使是新版教材，上课也会结合一点时事；上课其实还是有内容的，哲学家的名言和轶事也有，但课程性质在那里，也不必期许过高吧；声音确实不好听，但不至于难以接受；上课不想听可以写作业睡觉甚至偷玩手机，用电脑是不行的；补充一点，老师对其它老师以及学校工作人员也很礼貌友好，这一点让我印象深刻。给分问题，我普通的论文普通的展示，发了2次言，考试认真背书刷题库，给分还是不错的。
83921,1977,詹兴敏,2018-07-11 13:56:14,10,10,0,讲真是不错的。应该是思政类事情极少，课堂很轻松的了。老师为人也很好。
83923,1977,詹兴敏,2018-07-11 14:00:45,3,4,1,如果对马原课堂要求不高，喜欢水思政课的同学，那选詹老师的课没什么问题。事情真的少，就一次论文一次小组展示，且老师要求不苛刻，分数普遍都还可以。平时上课可水可听，期末复习一下就好。
83927,1977,詹兴敏,2018-07-11 14:05:29,6,8,2,老师人还是不错，教材相当熟悉，另外是个相当坚定的马克思主义者。如果高中有比较好的政治基础的话课是可以不听的，上课发言个人感觉对刷绩点也挺重要的。期末考试书本内容太多的话可以去背一下高中政治哲学生活那本书的提纲，够用了。
83993,1977,詹兴敏,2018-07-11 16:11:46,4,6,2,老师虽然上课气氛很沉闷，但是给分真的很好，很客观，他很注重最后的期末考情况，马原就需要这样的老师，任务少，上课基本不管(除了不能电脑)。
84025,1977,詹兴敏,2018-07-12 01:08:24,3,8,5,发言四次 没翘课 没当小组长 考前一天背书 没刷题库 4.2 仅供参考
84056,1977,詹兴敏,2018-07-12 03:00:23,2,5,3,出分慢但是给分很好\n\n事情不多 一次论文一次展示 闭卷考试 很不错了
84153,1977,詹兴敏,2018-07-12 06:54:31,-8,5,13,上课声音确实难听，不让用电脑。玩了一学期手机，上课没发言没当组长，考前给划重点，复习了两天，期末考试只占百分之三十，给了4.5太良心了。
84620,1977,詹兴敏,2018-07-13 10:42:57,-2,3,5,老师给分挺公正的
85082,1977,詹兴敏,2018-07-15 09:13:08,-1,1,2,很水真的很水
86535,1977,詹兴敏,2018-09-17 05:18:42,13,15,2,声音真的很神奇，超级水，十分。
88400,1977,詹兴敏,2019-09-02 15:38:55,6,7,1,点名体验也太差了，点就点吧固定座位是干啥！每节课都前排很绝望啊！
89453,1977,詹兴敏,2018-11-19 07:38:03,3,5,2,但是，所以说这也就是啊~是不是是不是也就是啊。
93127,1977,詹兴敏,2019-01-07 12:52:33,-3,3,6,马原课。感觉分组很有问题。老师把同一个专业或者说一个班的基本分到一个组里，人数不够就补上其他专业的。\n\n于是，除了两三个人，其他几个人还有组长都同一个专业的。然后就被组内“民主评议”的打分结果恶心到了。劝大家如果是全班已经一起预置一节马原课了，就不要自己再换课了（虽然我也不知道其他班的情况）。\n\n希望大家都能遇上好课友吧。\n\n对了，感谢老师在冬学期开始的时候就收了论文，让我这只菜鸡在期末少了一个头秃的理由。
93169,1977,詹兴敏,2019-01-08 02:37:36,-3,5,8,看到了前面的同学说的马原小组内评分的事情，估计我们不是一组的，不过我也想说说哈。首先，我们的评分肯定要有区分度嘛。那怎么区分？组里那种自以为是、一心恶竞的队友会有人愿意给他高分吗，那种就只知道简单做一下分配的任务就完事的人可以给他高分吗，收集资料的有做展示的辛苦吗。有人低分，当然也有人高分。别说我甚至都不认识您，我们连学号都是连号的，我评分不给自己人高分给谁？要是真的对组长有什么意见，怎么刚分组的时候一群人都不想当组长。再说，平时分（不只是小组展示分）只占60%，展示分最低也只低别人十来分，自己算算折算后才低了几分。
94804,1977,詹兴敏,2019-01-18 08:12:45,2,3,1,觉得老师还是蛮有意思的。声音习惯之后也没什么感觉了，课反正很水，老师也不讲书上什么概念，都是自己拓展开了讲。可以看得出他理论功底还是很扎实的，平时对各种时事新闻也有很好的了解。没好好复习最后考得不好也怪不了老师ಠ~ಠ
100160,1977,詹兴敏,2019-01-25 16:17:43,-15,2,17,事少上课水，考试背背，发言个一次就满了
100217,1977,詹兴敏,2019-01-27 12:31:32,1,26,25,说文科生的那位，期末占60％的思政闭卷还不背请问你是打算抄选择题吗？以及高数微积分这种课对文科生岂不是更不公平，毕竟学分更高。最后说文科生考试周闲的，怕是不了解以法学为代表的某些文科专业。
100219,1977,詹兴敏,2019-01-25 23:33:23,-1,2,3,听詹老师的课其实不是很愉快，但由于给分好，所以还是不错的
100223,1977,詹兴敏,2019-01-25 23:47:58,-2,1,3,固定座位，节节点名 给分还低…无话可说
100249,1977,詹兴敏,2019-01-26 00:43:30,1,3,2,固定座位固定的我无话可说，每节课都点名555，不过事情不多，给分也不错！考试应该还是很重要的吧！
100260,1977,詹兴敏,2019-01-26 01:26:47,-44,6,50,心态崩了，3.3，选这个老师就是因为看他比较水，上课一直带着耳机写作业（反正不用电脑他就不管）一个学期也还算没耽误我时间。小组评分很高，发言过2次，就是因为没背，看来很注重考试成绩，考前不想背的别选他了吧，真的觉得很多专业为应付考试背这些毫无意义的东西一丁点用都没有，不如好好读共产党宣言，多看看新闻。还有，这老师偏爱文科生，第一节课就说希望文科生的几个组搞一些大动作，选课代表也是文科生优先，真没啥diss文科生的意思，就是觉得这种课和文科生一起上特别不公平，至少我的专业考试周是不可能有留给马原的时间的，一共10门考试，而我身边的文科生考试周基本就像放假了隔好几天才一门，还有这老师大概不知道主修给这么低的分会给学生多大的人生影响，我不努力怪我？那我认了，反正我思政课再也不发言
100280,1977,詹兴敏,2019-01-26 02:00:18,-52,1,53,就是感觉有点无聊，上课很水，发言了很多次，论文也好好写了，最后4.2拉低均绩，不过可以接受吧，毕竟考试自己也没好好准备，同考试周10门考试。
100285,1977,詹兴敏,2019-01-26 02:08:06,-1,0,1,每节点名，上课比较水，猜测很注重期末
100591,1977,詹兴敏,2019-01-26 11:12:38,-2,3,5,每节课点名 给分差 讲的还烂
100747,1977,詹兴敏,2020-01-17 12:03:52,-255,2,257,不明白为什么只有4.8
100812,1977,詹兴敏,2019-01-27 01:06:23,-2,0,2,我很喜欢听
101256,1977,詹兴敏,2019-01-28 02:51:13,1,3,2,超级好！！！！！！上课非常非常水，平常就一组一个展示，不过经验教训就是展示如果分低平时还是多发言吧。给分超级超级好，完美马原老师
102490,1977,詹兴敏,2019-02-03 11:45:52,2,3,1,小组评分高，发言一次。考前也背了两天左右。某林资料细读记忆两遍，刷题刷了五六套，不能讲很通透，但至少不差。一起复习的同学复习将将一遍，很多都问我，实话实说掌握的肯定没有我牢固，最后都是3.6。可能是她吴xp班。不过感觉还是和预想的有点差距。不会因为我是工科生的缘故吧…但讲实话考试最后几题资本的，复习资料上真没这么细…不过应该没有很多人背书的吧？
104246,1977,詹兴敏,2019-03-14 16:20:27,4,5,1,老师人很好啊 也很注意结合时政 不存在案例陈旧的情况吧 对课本熟悉度很高 中规中矩 但尽心尽责
110766,1977,詹兴敏,2019-06-28 07:53:37,-5,2,7,垃圾老师
116817,1977,詹兴敏,2019-09-16 05:19:53,50,55,5,也叫也就也就是也叫作也就是说也就是说啦
118156,1977,詹兴敏,2019-10-22 02:35:13,3,5,2,这个公鸭嗓真的受不了
120516,1977,詹兴敏,2020-01-12 01:29:30,3,6,3,考前评个分攒点人品\n\n老师事少是真\n\n希望能抬我一手
121170,1977,詹兴敏,2020-01-20 02:29:19,1,3,2,我不是组长，上课也没有认真听，论文写得一般吧，好在小组展示还不错。但是期末考试好好复习了，书全部看了一遍题库也刷了，最后得分很好啊。虽然老师上课有点催眠，声音不太好听，但是毕竟是马原课，已经很好了。大家态度稍微端正一些就好啦
122365,1977,詹兴敏,2020-02-25 14:01:10,0,4,4,今日主播猫猫康德背后的主人
122634,1977,詹兴敏,2020-03-09 12:48:35,-5,3,8,狗老师
122638,1977,詹兴敏,2020-03-10 08:12:28,3,5,2,做个人吧...
123243,1977,詹兴敏,2020-05-25 05:58:54,1,4,3,也就是那个，社是（是不是）？\n\n\n\n（我怎么知道你口中的那个是哪个……
124076,1977,詹兴敏,2020-06-23 09:12:33,-4,5,9,傻逼老师，傻逼老师，傻逼老师。重要的事情说三遍
124079,1977,詹兴敏,2020-06-23 11:11:40,3,6,3,线上考完之后直接在群里说一个同学做的很差？？实在是伤人，很过分
124256,1977,詹兴敏,2020-06-28 05:31:31,-1,1,2,马原，上课挺啰嗦的，大概是因为课程内容吧，这学期是一篇疫情感想+小组展示+期末论文，其实事不多的
124464,1977,詹兴敏,2020-07-01 15:03:36,0,2,2,给分不错!
124468,1977,詹兴敏,2020-07-01 15:55:42,-3,1,4,线上马原平时占比50%，期末占比50%，而且期末题真的时间又紧又难写。我大概是期末考太差了（保守估计期末-10以上）。最后也有80，老师给分还不错。
124481,1977,詹兴敏,2020-07-01 23:56:14,-39,2,41,没交论文，最后87，谢谢老师捞我
126478,1977,詹兴敏,2020-09-28 03:50:39,20,23,3,那么也就是…也叫做……那么像比如说……也就是说……也就是……就是……也就……然后呢话……像我们……
126678,1977,詹兴敏,2020-10-13 05:52:01,1,6,5,老胡说八道
127428,1977,詹兴敏,2020-11-23 03:00:57,0,3,3,先来评价下，非常喜欢老师的课，很不错！
128458,1977,詹兴敏,2020-12-23 09:47:11,2,4,2,老师三观挺正的，比较喜欢这一点
131746,1977,詹兴敏,2021-01-28 16:44:19,-5,6,11,学弟学妹们。别选就是了。千万别选，快逃，认真找找，肯定能选到比这个好的，后悔没有弃修。快逃!!!
131771,1977,詹兴敏,2021-01-29 01:01:32,7,8,1,事少给分好，唯一的缺点可能是上课有点无聊
132422,1977,詹兴敏,2021-02-01 12:23:27,-6,2,8,绩杀！
132674,1977,詹兴敏,2021-02-03 09:28:24,-6,4,10,讲课无聊 公鸭嗓 给分太差 莫名其妙 可能这就是不卷的代价吧 真是谢谢老师了呢
134222,1977,詹兴敏,2021-03-19 15:49:43,1,1,0,上课挺水的，给分还不错
138417,1977,詹兴敏,2021-07-09 04:43:04,12,15,3,老师给我4.5，那我当然要给他10分啦！\n\n老师上课中规中矩，可能以教材内容为主线，会结合一些经典著作和实际案例，所以相比于其他几位比较火的老师的课可能略无聊，但该有的内容一定会有。然后第一节课会说不能用电子产品不能睡觉不能写其他作业，到后期其实只要别太明显就好，当然电脑是绝对不能用的！\n\n事情不多，小组展示+个人论文，展示和论文都是有推荐选题的，所以绝对不会无题可做。老师几乎不在小组展示中间插话，只是到展示全部结束后临下课前作个总结，有时谈一些自己的思考，还是对学生比较尊重的，要求也并不高。发言的话会有鹅颈，但很一般，而且对成绩影响不大，像我就只发过一次言，成绩也不错。同时小组展示具体到每个人的成绩老师都会在期末公示，还是很透明的。\n\n至于给分的问题，从我的成绩而言我当然认为他给分不错，但个人感觉可能还是和期末考会有比较大的关系，因为我小组展示成绩并不算高。我具体也没问期末考分数，纯属个人猜测。\n\n然后谈谈期末考试。马原是闭卷全选择题（90单10不定项，都是1分），所以从命题上面很真切地体会到了老师的捞心，题干里有大量的原著语句呈现，还有很多试题可以互相印证，所以考试侧重理解＞记忆，还是减轻了考试压力的。复习的重点还是要放在剩余价值理论，马哲高中老本多多少少有一点的。如果课比较多没什么时间看书（比如我这学期的情况），可以去网上找考研政治马原选择题核心考点，我考前就看了两小时左右这玩意，还是知道了很多原本不知道的东西，像不变资本、可变资本这些生疏的概念，看一遍这样提纲性的东西很有助于建立一个大概的印象，了解一些核心的表述。\n\n至于有些人说老师说话声音难听，这是事实，但我觉得用声音好不好听来评价一个老师并不妥当。\n\n所以总体上我还是很推荐詹老师的！谢谢老师一学期的教诲！
138424,1977,詹兴敏,2021-07-09 05:48:59,1,1,0,认真复习考试，偶尔发言，给分很好，老师上课也不错
138654,1977,詹兴敏,2021-07-10 06:32:05,1,1,0,事情少给分好，但是很可惜老师上课的时候我有点听不太明白，课程结构不是很清晰。
139017,1977,詹兴敏,2021-07-12 07:57:37,2,5,3,上课水\n\n事情少\n\n不卷\n\n给分一般\n\n说话听不懂，真的听不懂\n\n“那～么，也就是，也就是”\n\n如果你也是喜欢上课做其他事情，偶尔发个言，指望考前刷题复习的选手，选吧\n\n如果你想真正学点东西，跑吧
141441,1977,詹兴敏,2021-10-09 04:13:09,-24,10,34,上课水平极低，说话无逻辑，总用一些毫不相干的例子，发表一些价值观极其落后的评论。\n\n\n\n1. 上课不让用电脑。\n\n“还有同学在用电脑。现在大家都有电脑，你还拿出来用”。\n\n怎么，是觉得同学用电脑属于一种炫耀行为，大家看了会眼红？\n\n\n\n2. 上课毫无逻辑、老迷信、对科学一窍不通。\n\n“现在很多凶宅，都是科学不能解释的。后来科学家研究了，发现凶宅都建在经纬线交界的地方。这个解释也不知道对不对，但有比没好”。\n\n怎么，地球上有哪个点不是经纬线交界的地方？哦，极点啊，好，只有极点上的房子不是凶宅。初中毕业了吗？能当大学老师？\n\n\n\n3. 公知。\n\n“美国之前有一个小镇，说发现了金矿，政府要来开采，小镇里的人反抗，说污染环境，后来政府就不开采了。所以你说外国的这个民主啊…”
141743,1977,詹兴敏,2021-10-24 05:19:59,10,10,0,哈哈哈哈哈哈哈楼上，这根正苗红的老师也算是公知，公知的评判标准真是日新月异了\n\n别，我也不喜欢红课，但是就感觉公知这个词对于这个老师的评价很有意思
142130,1977,詹兴敏,2021-11-07 08:19:37,7,11,4,笑死我了，如果这也是公知，那么贵校70%都是汗尖🐮
144282,1977,詹兴敏,2021-12-21 04:01:11,9,10,1,很和蔼并且有见识、有自己观点的老师，上课值得一听\n\n整个长学习有1~2次平时作业，有期中论文1篇和课上的小组展示每组1次，期末考是闭卷单选+多选题\n\n上课不让用电脑和手机是因为“换你在台上你也不想看下面的同学都在用电脑和手机”，其实真的用了也并不会怎么样（
145140,1977,詹兴敏,2021-12-27 16:24:37,0,2,2,事少，上课不用听，也听不进去，，\n\n想水水过的选\n\n想认真学马原的跑
145870,1977,詹兴敏,2022-01-03 13:21:54,23,23,0,我觉得詹老师绝对无愧于一名马原老师，只要想学一定可以学到东西，只看你自己愿不愿意去听。思政课很少有老师能讲得引人入胜，詹老师也不例外，但是他的渊博学识、温和的态度以及对于教学的认真值得一个10分。而且他真的很尊重学生。小组展示前他会和班上的同学说：“你们可以不听我讲，但是不能辜负同学的学习成果。”听到的时候真的有一点感动。
148548,1977,詹兴敏,2022-01-13 00:51:29,3,4,1,挺好的。。
154988,1977,詹兴敏,2022-06-07 08:34:24,1,2,1,哈哈哈
165960,1977,詹兴敏,2023-01-10 13:38:57,1,1,0,给分真的可以
165989,1977,詹兴敏,2023-01-10 15:29:44,0,0,0,神中神一伯昏
166024,1977,詹兴敏,2023-01-11 01:02:05,9,9,0,如果他是一名专业课老师，我只能给他7分，但他是一名思政课老师，我就给他9分了
166962,1977,詹兴敏,2023-01-14 11:18:44,2,2,0,给分好好~
167624,1977,詹兴敏,2023-01-17 20:51:22,-14,0,14,卧槽，均绩4.17是认真的嘛？！\n\n我在均绩4.17的马原老师这里拿3.6，在均绩3.95的毛概老师处拿3.6（均非本学期），我也是个人才
167715,1977,詹兴敏,2023-01-18 14:35:36,4,6,2,如果想听“马原”，我觉得快跑；但如果只想获得一个相对不错的绩点，老师挺好的。\n\n课程任务主要有，一篇3000-5000字的论文（读书报告也可），两次小作业（课本后的练习题里选择一题回答），一次大概15min的小组展示，期末考试。\n\n平时有发言加分，但不发言影响也不大，社恐友好。老师经常说要点名，但最后经常不点名，本学期应该只有分小组的那次点名了。
167901,1977,詹兴敏,2023-01-20 04:20:00,4,4,0,22秋冬马原，平时事情较少，只有一篇论文和两次小作业。想刷分可以做组长或者小助理和多发言，中间几次课有点名（当然也可能是因为后面是上的网课）。上课可以不听，考前会讲重点，给分还好。推荐选
169753,1977,詹兴敏,2023-02-27 16:09:44,8,11,3,这位老师对党和国家很忠诚，我认为这是一位思想政治老师应有的品质，他做到了，这就很好了。
175815,1977,詹兴敏,2023-06-26 23:46:53,4,5,1,讲的怎么样不知道，基本没听过\n\n但是他的课事情真的不多，小组展示一次，课程论文，两次小测都是开卷课后习题几道里挑一道写就可以了，也没点过名。小组展示发言，当组长课助可以加点平时分，展示发言还是满水的，可以多说几次\n\n上课会强调不要用手机和电脑，但你坐后面点其实也不会管你
177323,1977,詹兴敏,2023-07-03 02:24:17,1,1,0,给分不咋地
177374,1977,詹兴敏,2023-07-03 05:15:42,-1,0,1,老师很好，很随和
177375,1977,詹兴敏,2023-07-03 05:15:43,-1,0,1,老师很好，很随和
177405,1977,詹兴敏,2023-07-03 07:14:31,-1,0,1,佛口蛇心
177716,1977,詹兴敏,2023-07-04 11:43:28,0,1,1,虽然下面认真听的人真的很少 但是老师讲的还是津津有味的\n\n会告诉大家考试的重点 最后4.8 老师人还是很好的
179558,1977,詹兴敏,2023-09-18 08:12:48,2,3,1,发了一次言，不是组长，小组展示的分我们组还是全班最低的，论文好好写考试好好考，给了我4.5。
180859,1977,詹兴敏,2023-09-27 08:28:21,-2,2,4,爱党爱国，解疑答惑，我很喜欢
181145,1977,詹兴敏,2023-10-10 03:54:31,12,14,2,这位大叔说话是真的一点逻辑都没有🥲分数构成也讲不清，课程要求也讲不清，更别说课程内容本身😇
183509,1977,詹兴敏,2023-11-27 02:57:21,4,6,2,老气横秋。胜在事少。
184430,1977,詹兴敏,2023-12-19 13:08:07,9,10,1,也就是
188942,1977,詹兴敏,2024-01-20 17:21:41,-1,3,4,9/10\n\n有些太特色的东西也怨不得老师，至少老师事情真的不多，想学东西，可以直接读原著
193916,1977,詹兴敏,2024-06-28 06:50:39,4,6,2,讲课不行，全靠自己
194356,1977,詹兴敏,2024-06-23 10:38:52,0,1,1,马原课肯定是无聊，思政类都大差不差。主要是事少还可以发言加分，出成绩前给老师评个高分，希望老师也能给我高分乌乌乌
195479,1977,詹兴敏,2024-06-28 08:38:59,1,1,0,讲课没什么意思，但是平常就算坐在第一排用电脑也不会来管你。事情还是比较少的，给分不错。多发发言绩点会比较好。
195482,1977,詹兴敏,2024-06-28 09:01:06,0,0,0,吹爆这个老师 小测内容很简单 课后题很多道题里选一道写就可以 一次没发言最后也接近满绩 虽然说发言占5% 但是不发言也是有基础分的 老师真的海底捞 好老师
195488,1977,詹兴敏,2024-06-28 09:58:40,0,0,0,老师人超级好，不要看评论区的恶评，马原都给我去上他的课。超级捞，而且事情少，发言还可以加分，而且不鹅颈，我就发了两次言但是 4.8
195607,1977,詹兴敏,2024-06-29 03:58:13,-4,0,4,分高事少，知识渊博，超级好老师
196024,1977,詹兴敏,2024-07-01 07:44:51,6,6,0,作为一个马原老师可以给十分。\n\n\n\n不点名，上课不强制听，发言是加分班上不鹅颈，两次小测问答题开卷一节课很轻松，一学期下来丝毫没有思政课的压迫感。不过相应地是期末好像老师没能给什么帮助（逆天的是考完了在钉群发复习提纲？？？）。好在马原前人资料十分详尽，自己复习也就好了。\n\n\n\n给分挺好，复习了一天，认真背了原理，最后比较满意（居然是目前思政最高）
196987,1977,詹兴敏,2024-07-06 09:32:37,-3,1,4,课讲的垃圾 教学公式化 毫无特点的思政课 一学期一节课没听过 相当之无趣\n\n期末全靠高中政治撑着 考前复习了半天 最后4.5 无可挑剔的分数（对我的努力程度而言） 所以给分对我来说不错\n\n平时有两三次线上小测（很简单 网上开卷在教室做）和一次pre 平时分想拿高分要在pre的时候提问（大概吧） 蛮无聊的
197973,1977,詹兴敏,2024-08-22 03:17:17,-11,3,14,这个老师是不是不太愿意给满绩...高中选考政治，期末卷子没感觉有难度，出分4.8。感觉是给分不错，但是会压高分
208430,1977,詹兴敏,2024-12-27 13:45:31,5,5,0,也就是说，也就是说，没什么重点，全都是重点。
211732,1977,詹兴敏,2025-01-12 09:40:37,0,0,0,上课无聊，给分不错
211759,1977,詹兴敏,2025-01-12 10:36:46,0,0,0,感觉给分还是比较捞的
212323,1977,詹兴敏,2025-01-14 01:31:56,5,5,0,也就是 也就是 也就是
212357,1977,詹兴敏,2025-01-14 02:07:42,-1,0,1,上课无聊到爆，讲课水平真的不行。给分也一般，问期末成绩好几天也不回，估计是不会回复了。
213098,1977,詹兴敏,2025-01-16 03:50:58,0,0,0,事少，反正考试都是自己背的
217057,1977,詹兴敏,2025-04-01 04:07:16,0,0,0,讲得就不多说了，比较一般，给分也一般
219377,1977,詹兴敏,2025-05-26 07:02:29,1,1,0,作为马原老师给满
220774,1977,詹兴敏,2025-06-19 15:18:08,2,2,0,讲得一坨，给分垃圾
220778,1977,詹兴敏,2025-06-19 15:51:30,0,0,0,帅，爽，好
221171,1977,詹兴敏,2025-06-21 16:32:08,0,0,0,讲得一坨
221839,1977,詹兴敏,2025-06-26 15:43:26,0,0,0,给分不错
23,1982,郭汾阳,2015-03-14 15:27:24,-3,28,31,大力推荐！
646,1982,郭汾阳,2015-03-15 10:07:03,-1,45,46,郭老师是一个很有才华也很有个性的人，上他的课一定会有所收获。只要努力，绩点不低。
659,1982,郭汾阳,2015-03-15 10:55:40,8,62,54,老师上课很有趣，笔记根本停不下来
774,1982,郭汾阳,2015-03-17 00:56:35,8,28,20,给分不好
810,1982,郭汾阳,2016-06-08 15:27:59,22,111,89,点名是课代表点的，给分只有你自己有努力肯定不低，重点是听了绝对有收获，不失为良心教育
866,1982,郭汾阳,2015-03-18 05:03:50,9,42,33,大一上的，当时听的还蛮热血
892,1982,郭汾阳,2015-03-18 12:18:46,-3,20,23,热血沸腾
1083,1982,郭汾阳,2015-03-21 16:06:54,10,45,35,当年的紫金第一杀只是一个传说，如今分数是助教敲定的＠(￣-￣)＠
1230,1982,郭汾阳,2015-03-21 16:50:14,-4,16,20,给分不高 但收获蛮多的
1433,1982,郭汾阳,2015-03-22 03:16:26,-4,23,27,精彩课程，良心老师。不过学分婊还是不要来了
1476,1982,郭汾阳,2015-03-22 06:35:48,-1,18,19,听的是活历史。
1630,1982,郭汾阳,2015-03-23 02:35:49,-3,18,21,上课很刺激
1632,1982,郭汾阳,2015-03-23 02:37:27,-5,16,21,精彩  活历史  给分其实很好
1820,1982,郭汾阳,2015-03-25 15:26:58,2,18,16,刺激刺激!简直就是生死时速
1937,1982,郭汾阳,2015-03-26 11:50:59,29,35,6,害怕害怕
2350,1982,郭汾阳,2015-04-25 11:43:32,-8,9,17,感觉收获很大，每节课都在听很多很多故事，觉得老师有深度。
2388,1982,郭汾阳,2015-04-28 05:10:04,-3,17,20,历史因细节而生动
2400,1982,郭汾阳,2015-04-29 02:28:12,-4,10,14,郭老师讲课很棒，力荐~
2621,1982,郭汾阳,2015-05-05 00:23:51,-2,15,17,他人说话风趣讲课也很有意思，能让人学到新的更宏大的历史观，评分方式简单，注重课堂发言，只要努力，会很有收获
3945,1982,郭汾阳,2015-06-17 10:53:21,-14,5,19,不能好太多！
4044,1982,郭汾阳,2015-06-17 15:22:25,-13,5,18,讲的真好  良心课
4194,1982,郭汾阳,2015-06-18 04:13:27,-11,10,21,上的超棒，这么一比绩点什么的反而不重要了【并不】现在给分不错的，可惜已成绝唱
4261,1982,郭汾阳,2015-06-18 11:56:22,-12,6,18,爽
4311,1982,郭汾阳,2015-06-19 01:35:45,-2,16,18,郭老师阅历丰富，能把历史课讲的生动有趣。课堂上经常提出发人深省的问题，一学期下来感觉获益匪浅。
4419,1982,郭汾阳,2015-06-22 11:50:45,-4,11,15,肚子里有货，上的精彩
4490,1982,郭汾阳,2015-07-10 10:48:40,73,88,15,紫金第一杀果然名不虚传
4594,1982,郭汾阳,2015-06-25 00:42:24,-12,4,16,真的超值！很棒
4629,1982,郭汾阳,2015-06-25 08:31:06,-12,16,28,绝唱版史纲被我赶上，何其幸运，又何其哀叹。大学太缺这般的好老师。
4724,1982,郭汾阳,2015-06-26 13:02:04,-12,6,18,像百家讲坛
5093,1982,郭汾阳,2015-07-04 01:44:19,-12,6,18,赞
5397,1982,郭汾阳,2015-07-07 07:56:16,63,73,10,选个好的课代表吧，课代表好，给分就好，要是课代表傻逼，那就等死吧
5412,1982,郭汾阳,2015-07-07 08:27:06,-12,6,18,很有个性的老师，绝对意向不到的收获
5426,1982,郭汾阳,2015-07-07 10:35:35,-12,5,17,特赞！！！
6039,1982,郭汾阳,2015-07-10 12:09:51,44,54,10,一个很主观的老师
6707,1982,郭汾阳,2015-07-19 09:01:47,31,43,12,给分太烂
6864,1982,郭汾阳,2015-07-27 03:55:25,-4,13,17,郭老对历史有很多独到的观点，很有批评怀疑的人文精神。另外，郭老鼓励课堂互动，从其他同学发言中也能学到很多。
6874,1982,郭汾阳,2015-07-27 13:33:06,-11,7,18,必须给满分的老师
7647,1982,郭汾阳,2015-09-15 07:27:22,-9,9,18,老师的课特别棒！感觉能真正学到历史，并且对历史感兴趣！感谢郭老 ⊙ω⊙
7897,1982,郭汾阳,2015-09-16 04:15:59,-10,5,15,非常难忘的课堂
7966,1982,郭汾阳,2015-09-16 09:04:52,-10,7,17,郭老师会让你对历史产生独特的兴趣的
8189,1982,郭汾阳,2015-09-17 10:51:48,-11,7,18,非常好的老师！可惜退隐了
8278,1982,郭汾阳,2015-09-18 02:48:07,-11,4,15,很个性\n\n
8282,1982,郭汾阳,2015-09-18 03:14:28,-11,5,16,全新感受
8298,1982,郭汾阳,2015-09-18 04:23:41,-5,13,18,讲课精彩至极，可惜已是绝唱
8299,1982,郭汾阳,2015-09-18 04:51:17,9,16,7,奇葩，跟不上节奏
8411,1982,郭汾阳,2015-09-24 14:22:37,16,50,34,会装逼，200人教室没坐满说来了300多。\n\n说自己保证内幕消息，结果就是在那扯犊子。\n\n感觉就是社会上过得失败来学校里头装逼的一个煞笔。
8684,1982,郭汾阳,2015-09-24 03:42:26,36,71,35,烂老师，看似学识丰富，看似很有个性，其实心气高的很而无法发泄而已。各人有各人的价值观。我不喜欢。而且他给分纯粹瞎给，不信上一下他的课试试。
8726,1982,郭汾阳,2015-09-24 14:20:06,8,21,13,心气高没地发泄的装逼货色
9023,1982,郭汾阳,2015-10-10 02:16:31,7,13,6,不好……
10017,1982,郭汾阳,2015-11-14 09:06:11,-11,6,17,良心老师！\n\n
10060,1982,郭汾阳,2015-11-15 06:55:20,49,65,16,其实就是心气高找发泄，认真讲课还有收获，平时跟灌了酒一样一样，喜欢他的学生估计也是喜欢嘈点喜欢噱头吧，个人问题\n\n
10731,1982,郭汾阳,2015-11-23 03:39:36,-10,6,16,不听不是浙大人
10853,1982,郭汾阳,2015-11-23 07:15:31,-11,6,17,真的超级赞不会睡觉
11947,1982,郭汾阳,2015-12-21 11:26:01,-2,11,13,大学之所谓大学，非有大楼也，盖有大师也
12274,1982,郭汾阳,2015-12-22 16:47:54,5,12,7,感觉不太适合很多人的节奏…像混脸熟的请首先称为历史大神靴靴
12451,1982,郭汾阳,2015-12-23 10:06:46,-6,5,11,挺好的。
12459,1982,郭汾阳,2015-12-23 10:30:29,5,10,5,北京/宁波/西安/……的站起来，加分了啊！\n\n全班就我一个和某名人是老乡，每逢老乡必点我名Orz
12636,1982,郭汾阳,2015-12-23 16:39:24,7,17,10,没见过这么差的老师
12682,1982,郭汾阳,2015-12-24 01:29:23,17,28,11,很有个性喜欢提问常抱怨学生知道的少但是历史不全是知道xx记得##啊讲课跑火车声称掌握很多黑幕但有些真实性存疑ps我来自山西汾阳但无卵用而且他并不是汾阳人
12689,1982,郭汾阳,2015-12-24 02:02:14,-17,2,19,不听后悔
13304,1982,郭汾阳,2015-12-26 12:44:55,-7,11,18,有幸选了郭老的课，能真正学到东西，并且让我开始知道历史的价值，上完郭老的课之后开始对历史感兴趣
13708,1982,郭汾阳,2015-12-30 11:21:38,-11,3,14,有故事的老师
13718,1982,郭汾阳,2015-12-30 11:47:02,-11,6,17,一个教会了我人文关怀的老师，一个将历史讲活、让我们如临其境、感先人之所感的老师
13938,1982,郭汾阳,2016-01-02 14:52:40,-11,7,18,上完了郭老师的课才知道他是一个真正的还老师
14228,1982,郭汾阳,2016-01-05 13:17:14,-12,4,16,这样的好老师不多了
14413,1982,郭汾阳,2016-01-07 02:36:47,-12,4,16,有干货，想听课的来
14438,1982,郭汾阳,2016-01-07 05:48:08,-14,3,17,很有心的老师，一年过去后郭老师还能认识我
14548,1982,郭汾阳,2016-01-24 03:07:46,-12,5,17,虽然分不高，不过真的是个好老师
14584,1982,郭汾阳,2016-01-08 01:16:20,33,41,8,看课代表 碰到不好的就雪崩\n\n郭老师个人价值观念很强\n\n感觉老有一种要强加给学生的感觉\n\n有共鸣的会觉得讲的很好\n\n没共鸣的就不多说了
14645,1982,郭汾阳,2016-01-22 02:37:49,-14,3,17,真不错
15023,1982,郭汾阳,2016-01-11 14:22:04,-18,1,19,不简单是历史课
15244,1982,郭汾阳,2016-01-13 03:22:58,24,31,7,一个字，吭
15313,1982,郭汾阳,2016-01-13 13:43:54,-10,7,17,绝唱版史纲，讲得很有意思，分数是要自己争取的：回答问题，课前演讲。
15691,1982,郭汾阳,2016-01-16 06:48:26,-18,2,20,超级棒\n\n
15831,1982,郭汾阳,2016-01-16 11:43:05,-12,4,16,超级好老师 可惜要退休了 刷分
16179,1982,郭汾阳,2016-01-17 11:56:57,-18,2,20,少有的能让大家都听课的老师～
16357,1982,郭汾阳,2016-01-18 03:45:59,102,135,33,绩点是随便给的，上课讲的与考试完全无关，整天瞎bb，你要是不是历史吊b千万别去，学长忠告。差评！顶我上前排 给大家看看
16363,1982,郭汾阳,2016-01-18 03:52:01,13,19,6,上课讲的考试不考…感觉说相声能力和罗永浩有的一比…给分是课代表和助教一起给的…你如果不能把五千年历史精通就别选了…真心的我已经挂了
16365,1982,郭汾阳,2016-01-18 03:53:59,15,21,6,太垃圾了。上过你就知道了。
16692,1982,郭汾阳,2016-01-18 21:55:42,-15,5,20,(☆_☆)郭老的课不听绝对是人生一大憾事，敢讲真话，有风骨，ps已经不绩杀
16732,1982,郭汾阳,2016-01-19 01:19:38,-20,5,25,一切黑郭老师对的人都是嫉妒他的才能而已。
17228,1982,郭汾阳,2016-01-20 02:12:50,-12,4,16,是个好老师，虽然有时喜欢装装逼，但是满身正气，少见
17482,1982,郭汾阳,2016-01-20 09:35:05,-10,4,14,天马行空，热血沸腾。这是我们需要的历史\n\n
18316,1982,郭汾阳,2016-01-21 12:38:29,-16,2,18,幽默风趣，内容充实，受益匪浅
18527,1982,郭汾阳,2016-01-22 02:07:38,9,13,4,给分渣，超级渣
18534,1982,郭汾阳,2016-01-22 02:22:26,-10,7,17,超超超超超超喜欢大叔，真的，讲课就是哪怕给我零分我都坚持上他的课这种好，大学第一个让我觉得这是在大学的老师。给分真的超好，但是助教略坑啊
18574,1982,郭汾阳,2016-06-20 04:55:32,3,14,11,心气高，能力差，人品差的垃圾。
18575,1982,郭汾阳,2016-01-22 05:04:10,20,24,4,绩杀不是传说
18578,1982,郭汾阳,2016-01-22 05:21:03,11,16,5,我只想说 我同学被坑傻了\n\n他认真学习这么久 得了这么点分 让我怀疑这个绩点制的科学性
18579,1982,郭汾阳,2016-01-22 05:25:40,9,13,4,可惜找不到0分
18745,1982,郭汾阳,2016-01-22 12:45:14,-11,1,12,唉唉唉
19002,1982,郭汾阳,2016-01-23 03:11:01,3,10,7,心高气傲 自以为是，不喜欢这种老师，绩点给的又低
19060,1982,郭汾阳,2016-01-23 07:11:19,1,7,6,老师其实上课还好，能学到一点东西。但是给分太坑了。真的绩点不好。
19206,1982,郭汾阳,2016-01-23 13:51:38,11,17,6,哦。那就是个洒碧
19209,1982,郭汾阳,2016-01-23 13:55:54,22,25,3,紫金港绩杀名不虚传，给分如此低，简直让人叹为观止。不求高分，但要努力，但每每思及分数如此之低，只觉痛心。望老师上课能关注到每一个努力了的同学
19832,1982,郭汾阳,2016-01-25 11:04:09,6,11,5,如果对历史没什么了解的人尤其是理科生千万不要去，最后分数也有点小坑
19853,1982,郭汾阳,2016-01-25 12:17:40,5,11,6,确实够绩杀，，，但是他会让你发现自己不足，，会推荐很多书，，因为他我居然开始看书了，，
20013,1982,郭汾阳,2016-01-26 01:54:32,4,12,8,大一上强调绩点还是不要选了吧旁听最好
20050,1982,郭汾阳,2016-01-26 03:12:34,18,23,5,感觉有些哗众取宠，只会搞些噱头，说是要培养学生，实际上又有多少人学到真正的东西
20472,1982,郭汾阳,2016-01-27 16:58:03,25,32,7,他的某个课代表真的是傻逼 \n\n还以为自己很屌 \n\nRP
20986,1982,郭汾阳,2016-02-07 09:08:28,-12,9,21,分低的是你们上课不发言论文不努力考试不准备，老师真的很好，因为他我对历史有了一点兴趣，层主是理科生，高中历史没及过格，超讨厌。
21035,1982,郭汾阳,2016-02-13 02:09:17,2,12,10,超级傻逼
21236,1982,郭汾阳,2016-02-27 07:57:20,-11,4,15,很不错\n\n
21270,1982,郭汾阳,2016-03-20 10:14:10,9,13,4,呵呵呵
21548,1982,郭汾阳,2016-06-30 04:20:45,8,19,11,给分太随便！绩杀我日
21838,1982,郭汾阳,2016-03-01 07:58:54,-8,5,13,上课多回答问题，论文写好，多参加课程活动，小组活动好好搞分不可能低的，讲课很有趣
22106,1982,郭汾阳,2016-03-02 10:55:51,-5,3,8,任性啊！
22248,1982,郭汾阳,2016-03-03 05:39:52,-6,4,10,超级有趣哈哈哈哈哈\n\n
22259,1982,郭汾阳,2016-03-15 00:19:42,12,13,1,真的是不知道在拽什么
22263,1982,郭汾阳,2016-03-03 06:27:58,-2,5,7,可以这老师\n\n
22284,1982,郭汾阳,2016-03-03 07:41:29,5,8,3,呵呵。老师您心气太高，学生不才，实在无法恭维。
22569,1982,郭汾阳,2016-03-08 04:38:08,3,5,2,不想体验
22667,1982,郭汾阳,2016-03-09 14:18:32,16,25,9,这样说好了。我们一个课代表3.6的均绩。没犯过错。郭老师说好平时分占70%考试只占30%。凭他的个性，我信了他不管正太的原则。我看过的平时分是89分（助教给的），也和课代表多次确认过，不会错。但是最后我总分80。也就是说我期末考试是59分的样子。呵呵。我想说，我史纲课本事先全看过，考试也觉得不错。就算再差，我59的试卷分是个人都不相信。如果郭老师确实给了我们70%的平时分呢，我就得谢谢他给了我平时分没入让我挂～\n\n但是我就算史纲3.6，我均绩也有4.2+，我真不懂我难道史纲开卷真的连60都没有？\n\n我觉得郭老师讲的确实TM不错，但是给分太坑，而且有骗人嫌疑。
22728,1982,郭汾阳,2016-03-10 07:23:04,3,8,5,真的是个超级垃圾，从未见过这么无聊的老师
22900,1982,郭汾阳,2016-03-14 11:54:57,-4,2,6,旁听就好
23694,1982,郭汾阳,2016-07-05 01:44:43,-1,3,4,真的是绩杀 刷了我新低
23911,1982,郭汾阳,2016-04-21 02:17:32,-3,3,6,老师很坑但是很真实，说话直爽，讲得很有道理，学到的更多是书上没有的历史，不是那些被官方挑选千百遍的死知识。
24138,1982,郭汾阳,2016-04-28 00:15:12,-5,1,6,听大叔课巨爽
24545,1982,郭汾阳,2016-06-24 07:44:20,3,5,2,整个一2货，开始以为有情怀，其实是装逼\n\n
24585,1982,郭汾阳,2016-05-02 04:12:20,-4,2,6,绝版好老师
25276,1982,郭汾阳,2016-05-09 07:24:20,8,8,0,为什么没有零分
25578,1982,郭汾阳,2016-05-26 10:16:45,110,123,13,这个老师学术不端！已经被全国多家媒体报道了！
25583,1982,郭汾阳,2016-06-14 10:05:06,16,19,3,政治倾向和我不和
25605,1982,郭汾阳,2016-05-27 15:59:07,16,18,2,很多观点都是噱头，不敢恭维。\n\n\n\n另外最近爆出学术造假。
25667,1982,郭汾阳,2016-06-01 02:52:37,7,10,3,学术造假 学校为何不开除这种垃圾？说好的求是精神呢？
26122,1982,郭汾阳,2016-06-16 04:57:46,7,7,0,不尊重学生 太自恋 不知道在拽什么
26801,1982,郭汾阳,2016-06-21 06:38:56,3,5,2,学术不端的垃圾。
26869,1982,郭汾阳,2016-06-21 11:29:00,5,5,0,没什么收获。。很多事情他讲的不对。
27139,1982,郭汾阳,2016-06-23 06:54:03,-6,0,6,老师其实挺好的
27243,1982,郭汾阳,2016-06-24 02:10:02,6,7,1,个人觉得讲授历史还是应该以史实为主，可以加以自己的评论，也可以语言风趣幽默，但他说相声搞噱头实在太多，已经不是客观的风趣幽默了，而是强行传播自己观点的愤青。给分不想说，简直快是其他班的一半了。刚入学第一个学期这样，搞得我对绩点彻底失望
27296,1982,郭汾阳,2016-06-24 13:53:12,9,11,2,讲得怎样不谈，就学术造假这一点，不能给及格分
27308,1982,郭汾阳,2016-06-24 15:01:24,1,8,7,客观地评价他的话，是个很不错的老师。也许算不上什么史学大家，但教史纲还是不错的。很有人文情怀，总体上支持现代化。还记得他讲某次不宜公开讨论的政治内容时的感伤。如果对历史、人文感兴趣的学生，他的课还是值得一听的，有些史料的真伪可能接到消息自己也要判断。批评他提问说历史不只是知道XX的，说实话你连那点东西都不知道，更不会懂历史
27447,1982,郭汾阳,2016-12-27 12:38:22,3,7,4,王八蛋不要脸，学术不端，歧视学生。
27951,1982,郭汾阳,2016-06-28 07:03:03,1,2,1,反正我觉得很好啊！
28025,1982,郭汾阳,2016-06-28 08:00:08,-1,1,2,爽翻了\n\n
28692,1982,郭汾阳,2016-06-28 12:25:24,-3,0,3,哈哈哈
28737,1982,郭汾阳,2016-06-28 13:32:13,1,1,0,论文抄袭不知道是不是真的
28836,1982,郭汾阳,2016-06-28 18:03:11,2,2,0,老愤青。
29578,1982,郭汾阳,2016-07-01 02:09:54,2,5,3,绩点杀
29586,1982,郭汾阳,2016-06-30 04:22:39,2,2,0,垃圾郭汾阳毁我一生
29606,1982,郭汾阳,2016-06-30 04:44:06,2,4,2,有人觉得郭老上课很有意思…大概只是我和他政见不合，反正我觉得他上课确实讲的很歪…平时分不好好挣期末考90也只能接受2.7?
29610,1982,郭汾阳,2016-06-30 04:56:27,8,8,0,老师给我多少分我就给他多少分。。这逼绩杀我都要报警了！！！！！！！！！！！！！！！！！！！！！！！！
29628,1982,郭汾阳,2016-07-01 05:58:19,5,8,3,上课乱七八糟，有一次讲了整整3节课的日本，呵呵。。。。。。平时分有明确指标，然而期末考试分给得超低。。。。。我平时88，总分81，期末只有65分。。。。。。得批得多严。。。。。。2个室友是别的老师，选择全错总评也有88，90。。。。。。我真是呵呵
29684,1982,郭汾阳,2016-06-30 07:37:50,3,4,1,千万不要去，简直绩点没了
29702,1982,郭汾阳,2016-06-30 08:08:48,7,7,0,抄袭.然后上课各种扯犊子.讲的就是些自己内心牢骚，没什么好听的.他的个人观点有些偏激有时就是为了吸引眼球
29738,1982,郭汾阳,2016-06-30 09:08:53,1,2,1,学术不端，给分不高，上课bb
29769,1982,郭汾阳,2016-06-30 09:53:05,-1,2,3,史纲考试选择题好坑
29942,1982,郭汾阳,2016-06-30 14:23:43,4,5,1,上课还行，但这给分真的差
29999,1982,郭汾阳,2016-07-05 10:41:11,1,4,3,简直胡来
30106,1982,郭汾阳,2016-07-01 02:49:09,10,11,1,对，我也是卷面分57，我选择题打保票找到三分之二以上，论述题也是只有一道不是很确定，文科生跪了，平时分肯定是班里前十，展示回答都很积极，论文90分左右，期末成绩我跪了，不相信付出与收获
32486,1982,郭汾阳,2016-07-07 05:32:03,1,5,4,这种学术造假的垃圾 你有什么资格待在浙大教书 只会抄袭的伪君子真不要脸 浙大有你这种人脸都丢光了
32677,1982,郭汾阳,2016-07-09 07:55:30,0,2,2,呵呵呵
32925,1982,郭汾阳,2016-08-04 04:24:39,5,7,2,紫金港的最后一朵奇葩即将凋谢
33037,1982,郭汾阳,2016-09-10 10:55:44,2,4,2,学术不端 恶意抄袭 呵呵
33806,1982,郭汾阳,2016-09-22 01:21:16,0,2,2,最近又被曝光了
33915,1982,郭汾阳,2016-09-22 23:09:36,2,4,2,网上搜索 王古鲁访书记 有真相
33989,1982,郭汾阳,2016-09-24 12:41:14,2,4,2,马院老师公然学术不轨 啧啧啧
36632,1982,郭汾阳,2016-11-15 06:33:14,-1,2,3,负分滚粗。
38676,1982,郭汾阳,2016-12-28 04:02:23,3,9,6,我知道老师出现了学术不端的事情，但凭良心，上课很有水平，每次坐第一排，把笔记记了一本本子，看完了蒋介石日记，张学良传记，中国近代史，镜像里的中国等等书籍，我以前不知道历史可以如此精彩！！很感恩老师的循循善诱，毕竟我们确实是历史水平很低的理科生。这是这门课的意义，不是那些读着PPT讲稿水一节课手机的通识课可以比的。另外，作为浙大学子，是不是可以注意言辞，垃圾、傻逼这样的词语去形容一位有丰富经历的老师真的有辱校风！
39852,1982,郭汾阳,2016-12-28 04:00:02,1,3,2,是不是退休了？学术造假还成天吹逼，早点退休回家玩去吧
57967,1982,郭汾阳,2017-07-19 00:20:06,3,3,0,实在想不出什么优点
2062,2055,董海樱,2015-04-27 03:40:04,0,19,19,无聊，讲课腔调很奇怪，听多了感觉特难受，最和不要选
2185,2055,董海樱,2015-07-10 03:12:40,18,60,42,话很多，作业多。喜欢打断同学发言。但是很细心\n\n
2246,2055,董海樱,2015-04-13 16:09:45,6,14,8,很好，能学到很多东西
2435,2055,董海樱,2015-05-01 07:42:59,4,16,12,感觉太一般…听她说话感觉很难受
2595,2055,董海樱,2015-05-04 15:54:11,5,25,20,我觉得很好！真的  不一样的感觉  但是老师会有课上发言环节 其实就是一堆刷绩点的乱说   总之老师讲就听 同学讲就玩手机  而且负担还是有点
2781,2055,董海樱,2015-05-07 07:25:35,4,40,36,说话语调像幼稚园老师，爱打断同学发言。作业很多。
3238,2055,董海樱,2015-05-22 12:36:23,4,11,7,事好多
3391,2055,董海樱,2015-06-08 04:19:11,-3,10,13,课还好，事太多，人太嚣张
3450,2055,董海樱,2015-06-15 15:35:59,3,8,5,其实还是有干货的，但是思政课。。。你懂的
3451,2055,董海樱,2015-06-16 01:17:57,0,8,8,喜欢打断发言。。而且像小学老师。。
3600,2055,董海樱,2015-06-17 01:47:18,-8,2,10,差！
3884,2055,董海樱,2015-06-17 07:23:42,0,9,9,讲课非常向党向人民...对于反面发言中途常有质问...也就是打断....人还不错
4166,2055,董海樱,2015-06-18 02:48:44,-8,14,22,傻逼 作业多 喜欢叫人起来发言又喜欢打断 上课会管你睡觉玩手机 非常自以为是 讲课的腔调很恶心
4702,2055,董海樱,2015-06-26 09:39:58,-3,5,8,总喜欢打断同学发言
4879,2055,董海樱,2015-06-30 06:38:44,6,11,5,上课交流机会多，给分还可以，人很有趣
4905,2055,董海樱,2015-06-30 07:37:40,4,9,5,讲得很一般，语调跟幼儿园上课一样，不要选，不要选！
5966,2055,董海樱,2015-07-10 05:08:30,-8,2,10,呵呵了
5969,2055,董海樱,2015-07-10 05:25:58,-12,6,18,老师讲的极差，还特别喜欢打断别人发言，可是为了刷绩点又必须说。作业也有一大堆。
5972,2055,董海樱,2015-07-10 05:27:29,-8,3,11,差!还被正态了……
6289,2055,董海樱,2015-07-12 17:25:11,-7,5,12,文理科歧视心理，作业奇多，给分也，总之能不选别选。
7127,2055,董海樱,2015-09-03 09:55:39,4,10,6,打断同学讲话这一点真的很反感。但她确实挺负责的，方式可能有点不受欢迎，但备课看得出很用心，一直鼓励大家发言，且记录发言的同学加分什么的（个人不太喜欢这种方式）
7297,2055,董海樱,2015-09-13 08:05:14,-4,1,5,和
7419,2055,董海樱,2015-09-14 09:52:34,-3,3,6,讲课像哄小孩子
7656,2055,董海樱,2015-09-15 07:38:03,-17,1,18,烦！恶心
8877,2055,董海樱,2015-11-24 06:05:14,15,16,1,课挺有趣
10168,2055,董海樱,2015-11-17 05:48:32,32,38,6,老师讲课讲的很好，同时也注意培养学生辩证，独立思考的能力。
11076,2055,董海樱,2015-11-24 05:13:25,-5,1,6,水手机~
11764,2055,董海樱,2015-12-14 11:11:40,-8,1,9,作业死多
11839,2055,董海樱,2015-12-30 08:05:14,15,18,3,有启发，有收获，认真负责。\n\n
13863,2055,董海樱,2016-01-01 10:49:56,16,20,4,老师看似特别喜欢学生发言，尊重每个人都意见，可是。。。总感觉有点别扭
16540,2055,董海樱,2016-01-18 10:35:29,115,159,44,不知道为啥她评分这么低，但我为她正名一下这个老师真的挺好的，选了的人才知道，就是人太多了，晚去的人常常上课找不到位置
19150,2055,董海樱,2016-01-23 11:03:06,73,100,27,前排的几位，老师打断你发言就不要喊冤啦。有些人基本历史常识都没有，在网上看了些所谓奇谈野史就在那里胡说八道，振振有词，也怪不得老师打断你们，我听了都着急呀。
19525,2055,董海樱,2016-01-24 13:52:03,0,2,2,给分不公平
19531,2055,董海樱,2016-01-24 14:47:30,10,11,1,老师还是蛮好的
19556,2055,董海樱,2016-01-24 16:27:13,23,28,5,很喜欢跟学生交流 给分超好！不得不叹一句师生情啊！
19558,2055,董海樱,2016-01-24 16:30:21,6,7,1,董老师其实讲的挺好的。
19604,2055,董海樱,2016-01-25 02:11:29,8,9,1,我觉得还好，能学到知识，只是喜欢和同学交流，懂得体谅同学。真的好老师
19615,2055,董海樱,2016-01-25 03:00:15,2,4,2,从没听过课，上课不是水手机就是睡觉写作业，最后还给了84分，还算好吧
19656,2055,董海樱,2016-01-25 04:35:23,24,34,10,如果你真的想学习，想拿高绩点这个老师是提供了足够的机会的。想水水过的就散了。
19687,2055,董海樱,2016-01-25 05:43:04,5,7,2,给分不错\n\n
20319,2055,董海樱,2016-01-27 04:02:40,53,69,16,作为历史老师，能力水平是挺高的，知识挺丰富，也注重开导学生看问题。很有耐心。楼上因为讲话被打断就给低分，实在很不公正！
20346,2055,董海樱,2016-01-27 05:45:15,6,6,0,讲课不照本宣科，能学到很多东西
21610,2055,董海樱,2016-02-29 10:28:35,6,10,4,老师人很和蔼，根本不像楼上所谓的绩杀一说，最后给分也很好！
21672,2055,董海樱,2016-02-29 14:04:09,10,12,2,很和蔼的老师，并没有发现什么打断说话很不好的现象，给分挺好的，教的很努力很用心
21805,2055,董海樱,2016-03-01 06:54:29,-5,0,5,困死了
22085,2055,董海樱,2016-03-02 09:48:58,13,14,1,还好，认真对待展示和论文就行~4.2表示能接受
23552,2055,董海樱,2016-04-06 01:54:29,5,6,1,作业其实还好，老师给分不错
25928,2055,董海樱,2016-07-01 05:30:11,1,6,5,就像很多人说的，讲话像幼稚园老师，一个问题停好久，好让人着急。整个是又红又专，她鼓励提出一些反对意见，但是最后她会按照自己的思路去反驳，好像很有道理的样子，其实很牵强。总之，水平不怎么样。
26729,2055,董海樱,2016-06-21 03:38:08,10,10,0,很好啊，很可爱的一个女老师，完全没有前排的那些事情。
27123,2055,董海樱,2017-12-21 03:26:29,6,7,1,老师真的很认真，给分蛮合理
31868,2055,董海樱,2016-07-05 04:48:26,4,5,1,挺好的，但历史课总有学婊爱bb。
31891,2055,董海樱,2016-07-05 05:34:06,-2,2,4,讲课起来比较激动！
32702,2055,董海樱,2016-12-30 12:37:02,7,9,2,蛮有趣的，老师很认真。
33147,2055,董海樱,2016-09-14 05:28:19,5,7,2,很好的一个老师，有启发，不知道为什么评分这么低
33256,2055,董海樱,2017-01-03 06:11:12,4,7,3,老师其实挺好的，上课很细心，讲的也很贴合史实，当然，作业多是真的
33596,2055,董海樱,2016-09-20 07:51:12,8,10,2,不枯燥，是我理想的历史老师
34031,2055,董海樱,2016-09-27 09:07:39,-6,3,9,讲课枯燥，还很做作。还不如我初中老师。
34038,2055,董海樱,2016-09-27 09:07:58,-19,3,22,声音尖锐刺耳\n\n思想又红又专\n\n想法落后迂腐\n\n整节课光装逼\n\n还不如靠自己
34106,2055,董海樱,2016-10-11 05:14:45,-9,1,10,没什么想法⋯⋯\n\n
34841,2055,董海樱,2017-01-20 08:46:54,26,31,5,老师人很好，讲的也很细致，还把课件啊论文要求啊都传到app上，考试的时候还专门强调做题顺序，不过史纲这个多选题真的做哭了……事情不算很多，但是小组内部给分只能说组长老好人有点当的过分了，平均分上下0.1浮动和都给平均分有什么区别，违背老师的本意了吧……不过最后老师给分还行，虽然我考试选择题只对了两道，还是给了88分，对于史纲这门课来说也算满意吧，当然要是组长做得好一点就更好了。总结：董老师上课有趣，给分不错，推荐！
35057,2055,董海樱,2017-01-20 07:39:47,20,23,3,不懂为什么评分那么低……老师明明人很好。讲话萌萌哒，上课也挺好。作业的话，也就一篇个人论文，一篇小组合作读书报告，还有都有的小组展示。讲真，推荐选，给分也不错的。
35568,2055,董海樱,2016-11-10 07:28:12,-7,2,9,讲话语气听着和幼儿园老师一样，别扭的很
35986,2055,董海樱,2016-11-10 09:34:34,6,7,1,没有我期盼的文科老师的那种神采飞扬，才华横溢。人挺好，认真负责。
39694,2055,董海樱,2016-12-27 03:49:59,8,9,1,我觉的老师很好啊，我很喜欢，虽然上课我不怎么发言，但是老师很用心，那些作业是阶段性的每个史纲老师都会有的吧！论文给老师发邮件，会回复很认真！真的很好！
39781,2055,董海樱,2016-12-27 12:41:50,7,7,0,很棒的体验呀
40410,2055,董海樱,2017-01-03 07:36:09,8,11,3,挺好的，她是真的属于喜欢教书这样的，事情讲道理也不是很多
40416,2055,董海樱,2017-01-03 07:46:54,5,5,0,老师很负责，虽然作业有点多，但能学到很多课本外的知识，经验
40586,2055,董海樱,2017-01-04 07:32:06,4,4,0,还不错
41068,2055,董海樱,2017-01-09 03:53:04,-11,1,12,老师讲课语气很。。。对她的讲的内容学感兴趣，没怎么去上。每次去上的时候发现教室里人都不是很多。
41499,2055,董海樱,2017-01-12 05:14:04,3,6,3,老师尊重每一个同学的发言，但是有些人为了平时分强行发言，尤其在展示的时候，真的让人无语。而且老师喜欢发散的问题，真的…
42608,2055,董海樱,2017-01-14 14:40:53,5,7,2,老师的课还是很有意思的，会思考一些特别的历史问题。认真思考还是能收获不少的。
44674,2055,董海樱,2017-01-18 06:02:45,11,14,3,老师上课讲的挺好的，会讲很多课本之外的小故事，还会发表自己对历史事件的评价，而且尊重每一个同学的看法。上老师的课事情真不算多。
45679,2055,董海樱,2017-01-20 02:42:17,5,6,1,老师上课很好呀，给分也不错
45682,2055,董海樱,2017-01-20 02:43:22,3,5,2,虽然老师上课真的有些无聊 \n\n但是给分好hh\n\n事情也不大多啦\n\n感恩师生情
45683,2055,董海樱,2017-01-20 02:43:43,5,6,1,老师人很好，上课多和老师互动最后得分不会差的～
45686,2055,董海樱,2017-01-20 02:49:17,15,18,3,对历史了解不是很多，看法也不是很透彻，所以上课没发过言，老师上课很活跃，看得出她是真心喜欢教学也对历史很有研究探索的兴趣的，她的课还有实践课不过名额有限，去参观名人故居，革命根据地等对加深历史了解很有帮助。上课像听故事一样，不过我对历史了解不深，也没有参与课上研讨，都是在听别人的意见看法，论文感觉也写得不是很好，感谢老师给的高分。对了老师会很耐心的回答问题，发邮件联系也超nice。
45700,2055,董海樱,2017-01-20 03:02:36,17,19,2,对于一个个人论文只写到规定字数不恶竞的渣渣而言，老师给分真的超好！
45707,2055,董海樱,2017-01-20 03:15:25,11,13,2,老师上课很有见解，对于我这样一个上课没发言的人来说，给分是真好！老师很棒哦！
45715,2055,董海樱,2017-01-20 03:36:25,7,8,1,一篇个人读书报告和小组论文，有情景剧展示，老师人很好，讲课也讲的很好，很和蔼，绩杀，史纲不要花时间复习，没卵用
46010,2055,董海樱,2017-01-20 11:41:37,44,57,13,我一开始上她的课时确实是不怎么喜欢的，一个她的声音确实很难让人适应，并且我感到她讲的很多都是我们早就知道的。但这个老师真的是一个慢热型的老师，到后半学期你会发现她真的是个不错的老师，你可以在她的课上自由发表你的观点，并且发言的机会挺多的。至于前面一些同学说的打断发言的情况至少在我那个班级不怎么出现。对学生态度不错，我们小组研讨成绩是位居末流的，最后还是拿到了不错的分数。她对历史的观点其实是挺辩证的，并不完全按照教科书来讲。至于前面一些同学说她又红又专的，是你自己思想太右倾了吧？
46272,2055,董海樱,2017-01-21 06:11:32,6,7,1,读书报告，小组展示都好好做了…绩点…唔…还行…有点失望
47407,2055,董海樱,2017-01-26 05:17:54,6,7,1,按照她的要求好好做，论文好好写，好好发言，小组展示其实拉不开多大差距，小组长评分老好人只有零点几分偏差，只要自己按照要求做了，绩点会很好。
47993,2055,董海樱,2017-02-28 02:28:14,-12,1,13,感觉逻辑有点乱，有些牵强。语言表达能力也不怎么样
48125,2055,董海樱,2017-02-28 15:08:15,6,7,1,偶尔点名，课算是挺水的，有一次小组展示很重要几乎可以说占很大比例的分数，小组展示第一名，期末考不知道多少分，4.5
48179,2055,董海樱,2017-03-01 05:59:14,4,5,1,还行。。shsj
52541,2055,董海樱,2017-06-21 03:09:19,7,7,0,老师虽然表达确实相对平淡，但内容还是比较丰富的，史料内容足够，也比较关心学生。
52719,2055,董海樱,2017-06-22 09:51:56,8,9,1,老师人很好，很会圆场，任务不是很多，很亲切，给分好
56637,2055,董海樱,2017-07-04 06:21:02,6,8,2,\n\n董老师超级好啊，认真听的话，可以学到很多东西。坐等绩点。HHH
56736,2055,董海樱,2017-07-04 13:08:37,5,6,1,给分好 很重视学生展示 鼓励同学
56744,2055,董海樱,2017-07-04 13:34:52,5,5,0,老师蛮好的哈哈
56771,2055,董海樱,2017-07-04 14:53:50,5,5,0,老师人很好
56802,2055,董海樱,2017-07-04 15:56:37,-18,3,21,辣鸡老师，展示评价机制十分糟糕，语调怪里怪气，事多，给分差。
56811,2055,董海樱,2017-09-27 10:25:26,7,7,0,很不错的老师，有干货。
56925,2055,董海樱,2017-07-05 03:32:45,5,6,1,老师讲课很好，很不错！
56967,2055,董海樱,2017-07-05 05:03:28,5,6,1,老师人很好讲课很温柔 给分也不错\n\n
57205,2055,董海樱,2017-07-06 04:44:40,7,8,1,老师其实非常和蔼可亲，讲课的内容也是满满的干货啊，想听老师的品评，值得一选
58148,2055,董海樱,2017-08-07 05:27:15,6,6,0,会讲课本上没有的东西，良心老师
59067,2055,董海樱,2017-09-19 09:55:36,1,2,1,说话语调有点怪，强行发出的儿化音。但是老师讲课体系清晰，经常提到时政热点，是一个不错的老师。
60326,2055,董海樱,2017-10-17 10:52:49,4,4,0,上课挺有趣，认真负责。
61223,2055,董海樱,2017-11-12 14:33:29,4,4,0,干货多，也蛮有趣。
63632,2055,董海樱,2017-12-11 02:51:51,0,0,0,qqqq
65757,2055,董海樱,2018-01-09 04:09:29,1,1,0,还可以
65763,2055,董海樱,2018-01-09 05:05:43,0,1,1,偶尔没有去，不过幸好没有点到我
65776,2055,董海樱,2018-01-09 05:30:06,1,2,1,老师人好，上课也有趣。考核方式也很合理。不知道为什么评分这么低
65799,2055,董海樱,2018-01-09 07:34:06,1,1,0,老师讲的其实不错  会有视频  小组展示也很有趣
65801,2055,董海樱,2018-01-09 07:39:05,1,2,1,老师很不错哒~偶尔的口音还会虚心求教，真的很戳萌点(๑˙❥˙๑)对历史问题有自己独到的看法，而且每次讲课都很有逻辑，介绍了很多历史研究的方法，分享了很多好书，还会给自己小小拉分，嘻嘻嘻总而言之很棒噢~
65802,2055,董海樱,2018-01-09 07:42:09,1,1,0,难得的好老师，你会发现结课的时候真的很不舍。
65808,2055,董海樱,2018-01-09 08:38:54,1,1,0,老师人挺好的，也特别有意思。史纲课有两次任务，小论文和小组研讨。期末的时候会点名！史纲课我已经水水过了? 不知道给分怎么样，反正，不管怎么说，给个好评先。。。
65812,2055,董海樱,2018-01-09 09:19:08,1,1,0,老师人很好，小组展示记得要积极参与，不然自己分低也怪不了老师。
65822,2055,董海樱,2018-01-09 11:02:54,1,2,1,今天结课了，老师很可爱啊，事情也不是很多，都是必须的论文和小组讨论。就是不知道成绩会怎么样，毕竟上课都没举手过，(捂脸。
65860,2055,董海樱,2018-01-09 15:13:32,0,1,1,很好的老师，认真负责，虽然上课也想水，但是她讲的就有一种你忍不住想听的感觉，不知道给分怎么样，但是只有论文和小组展示，先好评。很不舍。\n\n
66314,2055,董海樱,2018-01-15 04:13:46,0,1,1,我觉得很好啊
66315,2055,董海樱,2018-01-15 04:14:08,0,1,1,老师人挺好的，挺公平，上课也挺有意思
66316,2055,董海樱,2018-01-15 04:15:00,1,2,1,很棒的老师！确实好！也遇到了一个很棒的小组！
66317,2055,董海樱,2018-01-15 04:17:10,0,1,1,老师很可爱，上课的时候喜欢跟我们讲讲笑话，平时给我们讲课的时候也总是面带微笑，十分和蔼。我觉得她的课还是很有趣的，不会让人睡着。小组探讨展示的环节也很有收获。希望期末能有个好成绩。嘿嘿
66328,2055,董海樱,2018-01-15 06:30:26,5,5,0,认真听会很有收获，给分很公平，不会有异议。虽然是水课，但老师真的很棒！评分应该更高些，9分差不多。我们一起把评分刷上去！
66339,2055,董海樱,2018-02-04 09:44:31,4,4,0,老师认真负责，有思想。
67394,2055,董海樱,2018-01-21 05:39:39,6,6,0,多好的老师啊，真不理解评分为什么这么低
70421,2055,董海樱,2018-01-26 15:06:55,7,8,1,超级超级好老师，满分！
70432,2055,董海樱,2018-01-26 15:16:35,4,7,3,老师挺好的，事少，干货多，上课比较有意思，放小视频，小组任务也比较轻松，上课水水就能过，只不过后几堂课会点名，给分也挺好，我没发过言，绩点都上4了，就是口音吗，大家多包容一下吧。
70437,2055,董海樱,2018-01-26 15:21:19,12,14,2,董老师太好了！！！上课有意思，有收获！虽然我们小组展示评分倒数，但是谢谢老师给了我一个我满意的成绩！我永远爱董海樱！！！
70439,2055,董海樱,2018-01-26 15:34:34,-6,0,6,我也想知道为什么1分
70440,2055,董海樱,2018-01-26 15:35:02,6,7,1,挺不错的老师，虽然我的绩点不是太满意
70468,2055,董海樱,2018-01-26 16:11:16,5,5,0,老师很棒
70472,2055,董海樱,2018-01-26 16:20:31,4,4,0,哈哈哈 比较水 但绩点已经很满意了?
70486,2055,董海樱,2018-01-26 16:52:39,8,9,1,有些人回答问题真是满嘴胡说八道，我一次都没发过言，最后绩点4.5，老师人很好，讲的很棒 给分也好\n\n
70497,2055,董海樱,2018-01-26 20:47:09,3,7,4,不是，在这里正名一下这个老师是随机抽点的，很少点名，为什么70%点名啊。最后一节课小组会点评抽点60%。本人作为只去了3堂课（第一堂，小组展示，最后一堂）绩点4.2的表示可翘啊。虽然绩点不是最高的但挺满意了。
70499,2055,董海樱,2018-01-26 22:50:19,4,4,0,是一个有爱的老师啊！点名只是最后几堂课点了，展示很重要，也很有趣！
70502,2055,董海樱,2018-01-26 22:57:49,7,7,0,我认为不错啊，真的水平可以，爱教学，事不多，实事求是，很好的人，自己绩点低，不认真，不听课，怪老师，什么想法
70510,2055,董海樱,2018-01-26 23:45:03,6,6,0,老师上课蛮有激情的，讲得也不错。任务量合理。
70524,2055,董海樱,2018-01-27 00:38:51,5,6,1,感动，老师真乃好人也
70525,2055,董海樱,2018-01-27 00:47:05,7,7,0,老师不错，力荐！
70708,2055,董海樱,2018-01-27 12:17:32,7,7,0,不错的老师，挺有趣的，知识面也广。历史观是正的，但不算红专，评价历史事件还比较公道。课上任务不多，可听可水。
70805,2055,董海樱,2018-01-27 14:14:14,-7,0,7,给分一般
71006,2055,董海樱,2018-01-28 01:46:38,3,3,0,超级棒噢
72898,2055,董海樱,2018-01-31 09:31:22,12,13,1,遇到傻逼组长是什么体验(微笑脸)
72990,2055,董海樱,2018-01-31 13:41:19,7,7,0,老师讲话特别可爱呀⁄(⁄ ⁄•⁄ω⁄•⁄ ⁄)⁄
73180,2055,董海樱,2018-02-01 06:10:48,1,3,2,上课还好吧，主要小组展示很有趣，但给分有点不公平～
73250,2055,董海樱,2018-02-01 08:35:18,5,5,0,很棒的老师
73404,2055,董海樱,2018-02-01 13:45:22,3,3,0,老师很可爱哦
73554,2055,董海樱,2018-02-02 03:12:00,0,1,1,勉勉强强
74651,2055,董海樱,2018-03-05 03:21:17,2,2,0,老师真的认真负责
75130,2055,董海樱,2018-03-07 12:00:11,1,1,0,讲得还不错
75519,2055,董海樱,2018-03-13 02:08:27,3,3,0,老师很有激情很棒啊 给分也很好
76229,2055,董海樱,2018-03-29 10:58:51,5,5,0,好老师，鼓励同学
76702,2055,董海樱,2018-04-19 00:15:06,1,1,0,给分好
79995,2055,董海樱,2018-06-19 02:18:52,6,6,0,挺好的老师
82658,2055,董海樱,2018-07-09 02:30:19,6,6,0,感觉可以的，在史纲老师里算是上游了~
84632,2055,董海樱,2018-07-13 11:47:25,1,1,0,老师蛮好…可是为什么考完一周了还不出分呐煎熬T^T
84746,2055,董海樱,2018-07-13 17:15:19,5,5,0,给分很好，很有激情
84747,2055,董海樱,2018-07-13 17:21:34,6,6,0,老师水平很高，上课有热情，很有自己的看法，人不错。事少，给分不错
84755,2055,董海樱,2018-07-13 22:16:23,6,6,0,很不错
84766,2055,董海樱,2018-07-13 23:34:05,6,7,1,老师人挺好的，平时作业真的算少了，而且给分也好！
84774,2055,董海樱,2018-07-14 00:19:40,-27,8,35,给分垃圾，小组展示只看学生评价自己不管，上课啰嗦
84784,2055,董海樱,2018-07-14 01:09:16,1,2,1,老师挺好的
84796,2055,董海樱,2018-07-14 01:48:46,3,5,2,个人感觉事情有点多，但是给分好，考前会告诉做试卷要注意的事情。平时没有发言，小组展示中等，能有这个分数很满意了。
84981,2055,董海樱,2018-07-15 00:21:19,3,4,1,老师真的很用心的在讲课啊
85089,2055,董海樱,2018-07-15 09:31:02,1,2,1,小组分数最差，还认为一定被正态，结果分还不错。
85525,2055,董海樱,2018-07-19 03:19:23,3,4,1,老师讲课内容还是很多的很丰富的，认真听不会觉得无聊。这门课你小组展示主动一些平时分高一点几点就好看了，老师给分很好。
85695,2055,董海樱,2018-07-26 07:25:24,5,6,1,史纲给分真的不错！老师上课声音很爽朗哈哈哈，观点也深入，还有踏青实践也很有意思。小组展示的分主要看组长吧，平时做好自己的事，尽量不要缺席活动。开卷考试真的，题量太大，空白又多，只能尽力写。
87019,2055,董海樱,2018-09-20 03:12:58,2,3,1,给分不错的，上课也轻松
87081,2055,董海樱,2018-09-20 07:25:27,1,2,1,可爱的董老师～如沐春风
91949,2055,董海樱,2018-12-25 05:37:56,1,2,1,和蔼可亲
93822,2055,董海樱,2019-01-14 02:29:52,1,2,1,很好啦，事很少的，老师也很可爱
94139,2055,董海樱,2019-01-15 09:11:48,1,2,1,老师很好很可爱
94150,2055,董海樱,2019-01-15 10:38:07,3,4,1,老师绝对是接近10分的水平啊，为什么连9分都没有？讲得很生动，任务也不重。别被评分骗了，力荐啊啊啊啊啊！！！
95432,2055,董海樱,2019-01-19 11:27:14,0,1,1,很好的
96953,2055,董海樱,2019-01-21 13:19:03,3,4,1,很和善，经常面带微笑，没有我印象中大学老师那种高冷的样子，而且和学生很亲近。在我史纲渣渣成绩出来之前赶紧给老师打10分。。。
98147,2055,董海樱,2019-01-23 06:20:20,1,2,1,老师人很好，历史讲得也很有趣，充满活力。很用心，把每个小组的展示都录了视频还发给了我们。好！
101362,2055,董海樱,2019-01-28 05:38:57,0,2,2,分好事少
101364,2055,董海樱,2019-01-28 05:46:36,0,3,3,课比较水，那高绩点还是容易的
101383,2055,董海樱,2019-01-28 06:15:53,3,4,1,老师真真正正的底蕴内涵修养，上课视频图片超级有趣，展示仔细的给意见还帮忙拍精彩片段，给分好事情少，平时很多教导对其他课程也有帮助（比如论文！）十分！预置到老师真的太幸运了！
101428,2055,董海樱,2019-01-28 07:50:58,3,4,1,小组展示真的让我收获了很多，不仅仅是知识了，更多的是组员之间的羁绊，同时认真确实会有回报，小组展示拿了高分，作为一个论文瞎写上课不发言的人，老师给的分数真的很好了。老师上课讲的很有趣（像听故事x)，总之非常推荐～
101435,2055,董海樱,2019-01-28 07:58:57,6,8,2,事少分高，很好的老师
101480,2055,董海樱,2019-01-28 09:34:26,3,4,1,老师人很好，上课很认真，看同学们表演也很投入，非常专注。学术水平感觉挺好的，而且也不会一味追求所谓正确史观，有很多自己的推荐。
101484,2055,董海樱,2019-01-28 09:38:54,1,2,1,给分舒服
101520,2055,董海樱,2019-01-28 10:45:19,6,8,2,真的不知道为什么老师分数这么低。上课好好听，积极发言（主要是向小组展示的小组提问），论文认真地按照要求写，期末考试（开卷）按照要求认真抄，给分真的良心。我反正水到了4.5绩点。
101613,2055,董海樱,2019-01-28 15:21:19,3,4,1,没发过言，所以对自己的成绩特别担心，认真做了其他作业，给分非常满意！老师本人对历史很有研究
102094,2055,董海樱,2019-01-30 12:07:27,1,2,1,感谢老师！！！
102532,2055,董海樱,2019-02-05 06:36:53,1,2,1,声音特别爽朗，讲课棒棒的\n\n（史纲可能普遍都在讲故事）\n\n（个人觉得有时候会有点尬）
102779,2055,董海樱,2019-02-23 03:19:40,3,4,1,很棒啊，给分也好，能了解很多知识，重视小组的历史情景剧展示
102838,2055,董海樱,2019-02-24 03:10:49,2,3,1,人很和蔼，给分好！
103007,2055,董海樱,2019-02-25 10:30:42,8,9,1,老师偶尔点名啦，上课能接住老师的包袱其实也是很开心的课。一开始是被当组长但是后来通过跟老师的接触完全爱上了史纲（悄咪咪表白一下组员们），小组研讨报告做的认真，论文按要求写格式不出错没有错别字，考试主观写满分数不会低。亲测当组长能够拉绩点，平时没听课最后差一点就给满了。老师很可爱很可爱！绩点这个跟组长组内分配也是很有关系的！要积极参加小组研讨啊！
103042,2055,董海樱,2019-02-25 14:43:58,0,2,2,温柔的好老师，是的，隐藏的温柔哦，而且小组展示结束还能收到老师为我们拍的照片
103149,2055,董海樱,2019-02-26 07:35:02,0,2,2,第一节课，很好，有意思，老师活泼
103497,2055,董海樱,2019-02-28 13:55:28,1,3,2,很好的老师，课堂活跃度还不错，小组活动体验很好，分有点低大概是自己历史实在菜
103503,2055,董海樱,2019-02-28 15:34:22,1,3,2,老师很好很可爱的呀！！上课有趣认真 小组展示认真做 论文好好写 给分挺不错的
104539,2055,董海樱,2019-03-23 05:19:13,0,2,2,很舒服
104547,2055,董海樱,2019-03-23 10:34:25,5,7,2,讲课值十分以上
104677,2055,董海樱,2019-03-26 03:01:04,-12,2,14,无聊透顶
104722,2055,董海樱,2019-09-22 17:31:27,3,5,2,很温和、有思想的好老师！
107777,2055,董海樱,2019-05-09 10:59:26,2,2,0,收获挺大的
107808,2055,董海樱,2019-05-10 01:37:07,2,2,0,不错的
108083,2055,董海樱,2019-05-14 07:32:29,2,2,0,有时会点名
108983,2055,董海樱,2019-06-05 04:10:51,1,1,0,好可爱的老师，喜欢
109627,2055,董海樱,2019-06-18 04:09:39,1,1,0,喜欢董老师！！
109655,2055,董海樱,2019-06-18 07:22:49,1,1,0,很可爱的老师呀，上课讲的也挺有意思的，嗓门特别大哈哈，课间休息时还会给我们放歌~老师还去过陈望道故居呀就在我奶奶家对村呢感觉好亲切hhh
109662,2055,董海樱,2019-06-18 07:41:10,1,1,0,挺好的吧
109663,2055,董海樱,2019-06-18 07:42:51,0,1,1,老师很好\n\n
109671,2055,董海樱,2019-06-18 08:47:31,3,4,1,太友爱了，处处为学生着想
109775,2055,董海樱,2019-06-19 06:37:17,3,4,1,老师人很好，绝对值10分
112041,2055,董海樱,2019-07-03 09:11:26,1,2,1,这个老师确实好
112570,2055,董海樱,2019-07-04 17:59:36,1,1,0,老师还是很友善的，我们小组的展示是第三档的，但是认真完成好课堂论文，考试尽量写满得的分数还是比较可以的。嗯嗯
112653,2055,董海樱,2019-07-04 23:42:52,5,7,2,老师真的很好，上课很有激情。本来以为自己小组分数分配最低，绩点会很难看。没想到还是有4.2，谢谢老师！
112701,2055,董海樱,2019-07-05 01:15:20,1,1,0,喜欢可爱又认真的老师 喜欢小组里的大家 喜欢东二201以及东一A301！
112767,2055,董海樱,2019-07-05 02:46:45,-1,2,3,真的是超级可爱的老师！很棒！虽然小组展示分略低，但是最后论文认真写考试尽量写满，给分还有4.5！
112773,2055,董海樱,2019-07-05 02:49:31,0,1,1,老师真的很好很可爱！
112783,2055,董海樱,2019-07-05 03:04:56,7,9,2,我觉得任务都认真完成了，最后给我3.3
113050,2055,董海樱,2019-07-05 21:41:20,-11,2,13,炒鸡好\n\n期末考选择题基本没几个做对，大题还有一道只写了一半，最后4.5抱回家
113063,2055,董海樱,2019-07-05 22:13:09,1,3,2,老师人超级可爱，讲课也非常有趣，重点是给分超级好
113256,2055,董海樱,2019-07-06 03:03:43,-10,3,13,给分超好～人也超好～上课发言了一次加上小组展示当了小小组长期末乱写写满 4.8\n\n给老师笔芯
113329,2055,董海樱,2019-07-06 07:21:52,0,3,3,给分很好 真的很好
113815,2055,董海樱,2019-07-07 17:05:14,2,3,1,给分真的好
114150,2055,董海樱,2019-07-09 01:24:36,1,3,2,感谢老师呜呜呜
114435,2055,董海樱,2019-07-10 02:54:37,7,8,1,给分好呼呼。不过感觉我们小组展示互评不错，本来以为可以上一档的，结果没有。感觉是不是我们说了蒋介石很多好话，上课提问也有同学这么怼我们，老师好像比较不太能接受我们不那么又红又专的思想嘤嘤嘤。（在一大波好评下说一点小小的建议，因为高中历史老师当时还跟我们义愤填膺地讲天安门事件巴拉巴拉。也可能是我比较喜欢“反动”的老师。）
115070,2055,董海樱,2019-07-15 06:33:53,0,5,5,我觉得事情很少了，一篇论文和一个小组论文(小组论文大家一起写)，一个情景剧，上课发言(但我感觉这个占比不大，反正我只发了一次，分数也上4了)，期末考(真的选择题都写一样的答案吧！)\n\n但是老师的声音我有点不太适应。。。。\n\n老师很好，平时不点名，但有两次上课的人比较少，然后就随机点名了。\n\n课上可以做自己的事，我就坐在三四排，书都不带了。。。。。\n\n史纲真的不用复习！上课感兴趣就听，不听也没事，真的！！！！！
115095,2055,董海樱,2019-07-15 12:01:15,6,7,1,给分超好啊，没发过言也上4了，上课也很好
115252,2055,董海樱,2019-07-17 04:27:18,56,61,5,冲她一句上海交通大学当然不如我们浙江大学，给她10分！
115617,2055,董海樱,2019-08-09 12:56:17,2,3,1,挺棒的，要和老师有些交流和互动哦~
116894,2055,董海樱,2019-09-17 04:18:02,3,4,1,老师人超好，讲得也好
116956,2055,董海樱,2019-09-17 15:02:49,3,4,1,特别好，随和，注意学生感受
117243,2055,董海樱,2019-09-21 05:04:17,0,2,2,感觉老师像外星人
117246,2055,董海樱,2019-09-21 06:48:32,1,2,1,有历史见地
118512,2055,董海樱,2019-10-28 00:08:17,-2,1,3,太那个了
119711,2055,董海樱,2019-11-15 03:09:36,6,8,2,"在我们上课看手机被zq骂个狗血喷头之后，董老师说""我觉得提高学生抬头率要靠我，所以我要不断提高自己讲课的生动性。""老师您讲课已经很棒很棒了?。"
121142,2055,董海樱,2020-01-20 00:44:32,3,3,0,讲课很棒，只是她的语调可能要适应一段时间233，老师注重学生发言和课堂表现，所以一定要积极参与课堂讨论
121148,2055,董海樱,2020-01-20 01:03:57,3,3,0,老师人真的特别好！！！
121152,2055,董海樱,2020-01-20 01:16:20,3,3,0,老师讲得超棒超生动，人也很好，只是小组研讨最后是组内自主分配分数实在是不好，我们组吵了几天，害。
121594,2055,董海樱,2019-12-12 09:39:48,3,3,0,非常好，但是还不知道打分怎么样
121720,2055,董海樱,2020-01-21 06:14:54,5,6,1,适合认真听课积极回答问题认真考试的同学，老师人挺好(✪▽✪)
122397,2055,董海樱,2020-02-26 06:18:30,6,6,0,真的挺喜欢董老师的.
123662,2055,董海樱,2020-06-11 08:18:23,11,19,8,不知道为什么有那么多同学说给分好。我承认老师讲的真的不错，能感觉到老师的知识丰富以及对历史有独特见解。展示也不死板，鼓励同学们用创新的方式去解读历史。我虽然是理科生，但是也比较喜欢历史，小时候也读过很多书。上课没有缺勤，论文好好写，展示报告用心做，考试也写满了，不知道为什么最后3.3。心里真的很难过，努力和分数根本不成正比。我就实话实说我的经历，给后面的同学一个参考吧………
124017,2055,董海樱,2020-06-20 10:57:06,-4,2,6,事少，论文，小组展示就没了；电子书多，影视资料多，史料丰富，可以白嫖，可以留着慢慢看。声音有点不习惯；不知道是不是线上上课不习惯的原因，讲课贼慢，感觉上了跟没上差别不大，不如高中历史老师
124476,2055,董海樱,2020-07-01 19:12:04,6,6,0,非常好的老师
125485,2055,董海樱,2020-09-13 05:40:27,0,1,1,？？？
125888,2055,董海樱,2020-09-15 09:59:01,-19,1,20,无聊死了
128921,2055,董海樱,2020-12-27 03:06:34,3,3,0,当她的课代表，感jio就能混脸熟。另外论文什么的特意要求不能卷，太好了叭！（反正相当好，预置上了千万珍惜）
128986,2055,董海樱,2020-12-28 02:42:15,5,5,0,很棒的老师！！
129511,2055,董海樱,2021-01-06 12:02:38,2,3,1,有历史见地、很温和的好老师
129707,2055,董海樱,2021-01-11 07:41:57,2,2,0,上课很有趣，对学生很耐心，对作业很认真，希望她能给我一个好分数
130075,2055,董海樱,2021-01-16 11:02:23,3,3,0,很好的老师
130491,2055,董海樱,2021-01-23 03:21:52,8,9,1,讲到老兵会流泪的好老师，严谨又温柔，好老师！
130610,2055,董海樱,2021-01-24 02:59:01,3,3,0,非常好的老师，有共情有思想，课真的很值得一听！
131841,2055,董海樱,2021-01-29 06:08:29,9,10,1,互评是真的无语。都把自己的分拉高，挑一个人踩低。无话可说
131844,2055,董海樱,2021-01-29 05:59:33,5,7,2,出分了来评价一下。上课讲的虽然有点无聊但我觉得这很正常，理科生也可以听听了解历史，课堂展示会有提问但是一次也不回答，也完全没有问题！给分很好，事情也不是很多，是一个很温柔的老师。理科生完全没有被难为到
131861,2055,董海樱,2021-01-29 06:57:27,5,8,3,理科生没复习4.2，必须顶董老师人太好了吧
131865,2055,董海樱,2021-01-29 07:07:23,5,5,0,不卷！
131870,2055,董海樱,2021-01-29 07:30:28,10,11,1,出分了来评老师\n\nPo高中文科，老师讲的知识点其实和高中区别不大，但po还是认真听了一个学期，因为老师从与高中老师完全不同的角度解读历史\n\n老师历史观很正，评价问题很客观。很多人会吐槽马院老师的历史能力，但老师是正儿八经学历史出身，专业过硬\n\n老师真的很细致负责，传到学在浙大上的ppt都是重新删减过的，留的是重点，补笔记也非常快，很方便\n\n老师是有共情能力的，讲到老兵会热泪盈眶，这让我看到了钱穆先生所言的对历史的“温情与敬意”，这也是我们学历史的目的所在\n\n总之，史纲课不水，遇到好的老师，便是一种难得的有历史厚重感的交流。董老师就是如此
131897,2055,董海樱,2021-01-29 09:18:28,5,5,0,好老师推荐
132057,2055,董海樱,2021-01-30 04:50:59,3,4,1,坐前排听董老师的课是一种享受，很有趣，经常看一些关于历史的几分钟的小视频。作业真的不多，一篇论文，一次小组展示，一篇小组报告(一起写的，如果有神仙组员就太好了)，小组展示和报告相差分数不大的。问老师问题，她会很认真地解答。只要认真对待，分数不会差的。
132074,2055,董海樱,2021-01-30 06:03:19,5,5,0,评分构成有小组展示、小组研讨报告、个人论文和考试。综合来说，史纲是我大一上体验最好的一门课了，老师人非常热情，她真的在尝试把课讲得有意思，认真听的话收获会很多。
133066,2055,董海樱,2021-02-07 12:13:22,7,7,0,老师温柔善良，关心同学\n\n课堂很精彩，成功吸引了我坐前排听课，而不是简单地水过去\n\n任务就是小组展示+论文，要做好还是需要花一定时间和精力的\n\n给分很好
133441,2055,董海樱,2021-02-28 16:47:21,12,12,0,我们班小组展示分给的都特别好，普遍高\n\n个人论文踩字数最低线写的，不过还是花了些精力的\n\n多提问题，平时分会高，毕竟占70%\n\n老师点名还挺刺激的\n\n上课基本划水，期末确实没必要复习\n\n期末开卷考，翻书快一点，书上基本都有，反正我直接照着抄的\n\n老师很温柔耐心的，给分很好的
133880,2055,董海樱,2021-03-09 00:46:14,-5,1,6,这……还带删评的？
134046,2055,董海樱,2021-03-14 06:49:06,3,3,0,可以让理工科同学都爱上史纲
135035,2055,董海樱,2021-04-27 13:06:24,2,2,0,只要小组展示认真弄，基本上分不会低的
138234,2055,董海樱,2021-07-08 06:03:55,2,3,1,老师挺好的，成绩不好是我自己的原因
138877,2055,董海樱,2021-07-11 12:14:58,5,5,0,均绩真的有这么高吗......
139201,2055,董海樱,2021-07-13 08:22:10,10,10,0,可能是最后为数不多能学到东西的思政课了吧。（ps：史纲这个学期都不调分，但有些人是秋冬修的，感觉对同一届学生有点不公平）
144105,2055,董海樱,2021-12-17 15:06:56,3,3,0,蛮好的，讲的很有意思，能把历史讲有趣属实不易
144710,2055,董海樱,2022-01-07 10:10:27,5,5,0,董老师yyds
145464,2055,董海樱,2021-12-30 01:11:55,3,3,0,真的好老师！！！！幽默风趣事情少
147826,2055,董海樱,2022-01-11 03:05:58,1,2,1,上课记得回答问题，别人小组展示后多评价，存在感刷起来
147847,2055,董海樱,2022-01-11 03:54:52,1,1,0,谢谢老师😓
147882,2055,董海樱,2022-01-11 05:34:53,3,3,0,一般般老师，被绩杀了。
147883,2055,董海樱,2022-01-11 05:34:53,3,3,0,一般般老师，被绩杀了。
147884,2055,董海樱,2022-01-11 05:37:41,1,2,1,董老师挺好的，偶尔点一下名，上课总的来说还挺有趣事情也不多。上课多发言回答问题老师肯定会记住的。就是声音可能有一点怪，第一次上课会不习惯，后面就好啦
147912,2055,董海樱,2022-01-11 07:02:33,1,3,2,莫名其妙
148361,2055,董海樱,2022-01-12 08:48:07,3,3,0,老师非常热爱教学，对于学生也很和善，上课有趣，有收获，挺好。
148661,2055,董海樱,2022-01-13 06:51:44,0,1,1,大学第一堂课就是董老师的史纲，竟然过去这么多年了！
148662,2055,董海樱,2022-01-13 06:51:53,1,1,0,课堂挺有趣的，平时事情也不太多，老师挺亲切的，就是给分有些小小失望...
151377,2055,董海樱,2022-03-02 01:50:30,0,1,1,给分好
151782,2055,董海樱,2022-03-15 13:32:18,2,3,1,抑郁症状看医生找老师请假，她真的好好，还安慰鼓励了我呜呜~
152750,2055,董海樱,2022-04-19 07:58:05,-3,2,5,董老师的课，懂得都懂，从来不讲书上有的没的，都是干货还有有趣的课外内容，讲的很详细和全面；\n\n可能某些老师的课堂战士是闹着玩的，但是董老师每一组的课堂展示都与组员交流并且给予启发！\n\n有些老师给分乱给，董老师绝对良心好吧，4.8飘过，帮顶！！！
154743,2055,董海樱,2022-06-04 12:34:55,-2,3,5,震惊，居然9.4
154836,2055,董海樱,2022-06-06 06:06:22,0,1,1,很好的老师，严谨而温柔。
155489,2055,董海樱,2022-06-13 13:37:45,1,2,1,真的很好，讲课很有趣，很喜欢她。\n\n“2035建成社会主义现代化强国，那时我还活着吧，（🤔？）我都50岁了哈哈”\n\n而且她去过很多地方，给我们讲美国的火车，日本的垃圾分类...
155677,2055,董海樱,2022-06-15 06:48:49,1,3,2,2022春夏课堂体验（出分前）\n\n希望大家少看过去很久的评价\n\n看看最近的\n\n开始觉得慢热且语气有一点怪\n\n但后来发现讲起课来根本不想摸鱼 声音洪亮语气激昂 内容和教材有一定互补而且有很多补充内容比如影像资料\n\n下课放好听的歌曲 \n\n和同学关系也很好\n\n我们组内部没有鹅颈 展示每个人都付出了很多 全班第一 最终机制下决定分配一样的分\n\n思政课性质都懂的\n\n不和老师交流怎么知道她功底在哪里呢\n\n但正经中山历史系学生怎么会纯马院讲法呢）\n\n看到了有些恶评 觉得那些所谓嫌烦的举动 在我看来就像我大姨关心我一样
156753,2055,董海樱,2022-06-21 01:55:16,10,10,0,我是一个工科生…阴差阳错地进了她那绝大多数是人文社科同学的班里。最后得了不高不低的绩点…下面都是从工科生角度出发谈谈感受，对文科的同学们可能并不适用。\n\n她上课有思想也比较有趣（虽然我听得不多，对历史并没什么兴趣）。平时没什么事情，期中一个论文（命题难度比其他老师略高，我舍友的老师都是读后感）。期末小组研讨展示以及研讨报告。感觉起来比较卷，小组展示前基本一两周就要排练一次，最后排了足足七八次。然后大家展示的质量都非常高，形式也比较多样。我不擅长记忆，背台词背的昏天黑地…最后小组展示得分还不错，算是投入回报成正比。\n\n组间有互评，最后小组得分取决于排名。\n\n组内有分数比例分配，多劳多得，我们组里有一个平时非常摆的（排练只去了1次）然后我们把他宰了分了他的分（当然他剩的分也没有很低）\n\n期末考的时候翻书翻慢了，老师在我旁边咳嗽提醒时间，我翻页了她才走…很感谢，不然真的容易写不完。\n\n总而言之虽然给分不水，或者说是同学太卷（emm），但总之她肯定还是一个好老师的。
160027,2055,董海樱,2022-09-12 03:27:46,0,0,0,上课很舒服
164356,2055,董海樱,2022-12-20 11:09:20,1,1,0,声音洪亮，很有激情但又很温柔的讲课方式，太对我胃口了
164372,2055,董海樱,2022-12-20 12:58:55,1,1,0,董老师太好啦，还没结课就来评价
164933,2055,董海樱,2022-12-28 01:59:00,1,1,0,老师讲的非常好，娓娓道来的感觉！理工科不太擅长历史，写论文的时候总是抓瞎，私信问论文的事情，她会非常非常认真的帮忙改！
165995,2055,董海樱,2023-01-10 16:18:12,-3,3,6,明明论文写得很认真，上课也认真听了，绩点还很低，真的不是很理解老师的给分标准
165996,2055,董海樱,2023-01-10 16:03:34,-4,2,6,明明论文写得很认真，绩点还很低，真的不是很理解老师的给分标准
166000,2055,董海樱,2023-01-15 06:02:23,11,12,1,毫无意义董老师是一个各种意义上的好老师\n\n阳了不舒服在每节课的状态也是充满激情活力的\n\n课上绝不仅局限于教材，她讲叙利亚地区的难民讲到几乎流泪，讲他在美国研学时候去友人家做客的经历，从现在庙里面供奉日本战犯理性地分析中日关系，讲那十年的时候不避讳地给我们推荐研究文章和书目\n\n真的能让人感受到历史的轻盈与厚重\n\n老师在讲孙中山的时候会提到自己好几年没回家，眼泛泪光，在放开之后会提醒我们注意身体，告诉我们自己一个人在学校如果真的不舒服，老师在，可以发消息给老师\n\n事情也不多，平时只有论文小组展示，相对其他老师的读书报告感觉论文给了更多发挥空间，可以写一些自己感兴趣的话题\n\n总而言之，在大一一开始碰到有情怀有关怀的老师，是一件幸运的事情\n\n最后给分也相当不错，从来没发过言被老师狠狠地捞到高分
166028,2055,董海樱,2023-01-11 01:28:24,7,8,1,老师非常温柔，阳了之后坚持上课还关心我们的身体，上课不水 ，在上课之前会放课题影片来吸引学生兴趣。老师讲到历史上的苦难时总是会哽咽，非常善良。上课主要是一个小组展示和一篇课程论文，他还特地提醒过不要太卷。老师给分也很好，努力学习的话肯定有高分
166034,2055,董海樱,2023-01-11 01:53:59,-6,3,9,老师人挺好的，但是绩点给的一般
166056,2055,董海樱,2023-01-11 03:36:41,3,3,0,真心很喜欢董海樱老师，很用心，很动情
166246,2055,董海樱,2023-01-11 14:11:20,1,3,2,她讲课真的很好。\n\n通过她讲课能看出来她的知识储备很足，而且讲课真的很有感情，也会关心同学们。\n\n如果想好好学习并且拿高分的同学们速来\n\n而且我感觉她很捞，我论文字数严重超限+上课基本没发过言+每次上课坐在第一排正大光明的摆最后也拿了4.2
166730,2055,董海樱,2023-01-13 10:37:11,5,6,1,老师非常好！！！上课半摸鱼考前看了一晚上人喜提4.5 虽然感觉没有个别老师海底捞但给分非常求是（孩子感觉自己论文写得很认真 但整体下来就是值这个分数）课堂特别有激情 事情也少（小组展示➕小组报告➕论文）且反鹅颈\n\n老师真的对历史有温情与敬意！对我这个文科生来说，能通过董老师的课与历史告别真的很幸运～\n\n老师特别特别随和可爱 （一个小插曲是我染了绿色的头发 交论文的时候她还夸我好看啊啊啊真的很可爱 像邻家奶奶一样的感觉qwq
172428,2055,董海樱,2023-04-27 01:05:38,2,2,0,1.讲课带有激情\n\n2.思想辩证，历史素养很高\n\n3.内容丰富，不一定按课本但是都在学在浙大ppt上，有很多补充的小电影，课前会放，也会上传学在浙大\n\n4.大一第一次被那样细心教论文如何去写\n\n5.老师很和善。会给你糖果和小礼物，很喜欢笑，还会主动和我们说拜拜～\n\n董老师是俺滴神ε٩(๑> ₃ <)۶з
173852,2055,董海樱,2023-06-03 15:34:52,2,2,0,董老师是马院为数不多的好老师
173855,2055,董海樱,2023-06-03 15:47:06,-9,0,9,龏餐蘯屎可不再以了
174433,2055,董海樱,2023-06-12 06:32:38,2,2,0,很好啊，事情又少人家老师都要刷慕课她不用，我的论文就是学术垃圾她也不计较
174563,2055,董海樱,2023-06-14 06:01:27,4,4,0,好老师 上课富有激情 会给我们推荐很多书籍 （虽然我只看过其中几本但是都激发了我许多对历史新的思考）上课前之间会放映一些电影电视剧片段 一些纪念日时会在钉钉群里发庆祝图片 提到十年探索会流露出对被破坏的书籍的惋惜，是真正的学者 对那段时间的遗憾惋惜毫不避讳 愿意倾听我讲话 对于上课时同学们在做自己的事也没意见 很温柔的老师\n\n由于还没考试暂时也不知道给分怎么样
175291,2055,董海樱,2023-06-23 10:15:21,3,3,0,董老师是一个非常认真负责的老师，她是真的希望你在课堂上能学到点什么，而非水完
176644,2055,董海樱,2023-06-29 14:20:35,-5,0,5,我觉得老师挺好的，给分也不错，期末考试一道大题写错半题，平时挺认真的，但上课基本没听，4.5分
179651,2055,董海樱,2023-09-19 05:41:00,1,1,0,为什么不是十分
179970,2055,董海樱,2023-09-20 05:31:15,1,1,0,上课好有激情呀
184055,2055,董海樱,2023-12-07 11:10:28,0,0,0,讲课很有特点，听史纲比听微积分还认真
185593,2055,董海樱,2024-01-02 13:15:41,0,0,0,很认真，很真诚
185636,2055,董海樱,2024-01-03 07:26:44,5,5,0,老师在提到触人的历史事件的时候会眼泛泪光，在老师的课上真的可以感受到历史的厚重与轻盈。每个小组上台展示的时候老师都会拍视频记录，在最后一节课的时候做成了一个汇总的PPT，真的很少见这么真诚的老师🥹
185732,2055,董海樱,2024-01-04 02:50:26,5,5,0,上董老师的史纲不太建议写别的作业，因为写着写着就不由自主听课去了（真
185803,2055,董海樱,2024-01-04 12:51:17,1,2,1,老师真的很好，特别温柔，而且真的很理解我们，讲课也好好，爱了
187055,2055,董海樱,2024-01-14 09:28:02,0,0,0,虽然我没听课，但是老师上的不错，给分可以
187864,2055,董海樱,2024-01-17 15:24:53,1,1,0,本学期教学班改革了连论文都不用写只有小组展示了爽死我了...老师讲得不错人也很好！！很关心学生！！坐等出分www
188251,2055,董海樱,2024-01-18 13:30:13,1,1,0,董老师上课非常认真翔实，也很风趣幽默，尽管我高中是历史选考生，但听老师的课，也同样能给我带来了很多的启发和思考。老师私下也非常愿意和学生交流，回复也非常认真。非常荣幸能够上董海樱老师的史纲课
188806,2055,董海樱,2024-01-20 04:44:00,1,1,0,给分超好，非常非常好的老师，强推！！！
188811,2055,董海樱,2024-01-20 04:53:41,1,1,0,作为一名史纲课老师，认真对待每一节课，将近代史讲的非常生动，又有自己独特的见解。同时对同学们真的特别好！最重要的是给分还炒鸡好！
188813,2055,董海樱,2024-01-20 04:58:22,1,1,0,特别好老师，温柔负责，真正敬重历史并能感染学生的人。
188834,2055,董海樱,2024-01-20 06:59:20,1,1,0,董老师真的非常好!她对教学和历史非常有热情，课堂教学和小组展示也结合得很紧密，她真的非常用心!虽然我一整个学期都是水过去的，但最后给分我觉得也很好。考完试她还安慰我们“天塌了个高的顶着”，非常可爱的老师。史纲这门课本来就有点水，如果水过去，只要考前稍微复习一下，还是能取得不错的成绩的。如果你想认真听，董老师的课也是非常有内容的!
188964,2055,董海樱,2024-01-21 01:33:33,2,3,1,给分特别好，上课从来没发过言，最后考试认真考4.5，老师上课也很有激情，是很好很温柔的老师，为学生着想，可以学到很多东西！
190184,2055,董海樱,2024-02-24 14:32:52,0,0,0,董老师上课真的很好！！不卷发言
190641,2055,董海樱,2024-03-13 02:19:24,1,3,2,超级好的董老师！讲课非常有激情，在学在浙大上会分享很多影片资源。有小论文和小组展示的要求，但是不卷发言，我是从没有发过一次言，最后4.8
190790,2055,董海樱,2024-03-19 07:06:35,1,1,0,讲的很好，让人没有心情写别的作业，能学到很多知识，给分超好，还不卷发言
192557,2055,董海樱,2024-05-23 12:13:10,4,4,0,上了董老师的史纲课之后又选了有她讲课的党史课，很后悔没认真听她的课，讲课很有意思，也很有激情，下课的时候会给我们放一些有意思的视频（是我遇到过唯一一个这样做的老师，真的很棒！）我不明白为什么有些人对老师的声音这么挑剔，我认为这样可爱的老师总比一些只会念PPT上课就催眠的老师好很多吧？？？总之董海樱老师对得起10分，推荐学弟学妹们选她的课~！
193510,2055,董海樱,2024-06-12 03:50:20,0,0,0,好。好
194931,2055,董海樱,2024-06-26 03:10:30,2,2,0,老师讲的真心不错，很有趣味，很多史实材料一般教科书上都不会写。上她的课我能感受到近代史是有趣而鲜活的。
195165,2055,董海樱,2024-06-27 03:55:58,4,4,0,国之大者，教授风范。
195166,2055,董海樱,2024-06-27 03:55:58,3,3,0,国之大者，教授风范。
195949,2055,董海樱,2024-07-01 02:34:01,5,5,0,董老师必须满分，伟大无需多言。选到就是赚到
196028,2055,董海樱,2024-07-01 08:06:33,0,0,0,伟大无需多言
197041,2055,董海樱,2024-07-07 01:49:43,5,5,0,点名是评分需要，可以理解，除此之外我不允许任何人说老师的坏话
198719,2055,董海樱,2024-09-11 06:04:23,1,1,0,感谢高分救我
201137,2055,董海樱,2024-10-29 08:13:15,1,1,0,很好的👌🏻
206603,2055,董海樱,2024-12-16 11:43:59,5,5,0,老师很热心，很温柔，帮助我很多。
208255,2055,董海樱,2024-12-26 11:38:01,5,5,0,特别好
208384,2055,董海樱,2024-12-27 09:29:55,2,2,0,很好的老师
209759,2055,董海樱,2025-01-07 03:43:07,2,2,0,董老师是一名很关爱学生的老师，非常注意和学生们的沟通，小组展示时还会给我们拍照片
209877,2055,董海樱,2025-01-14 08:43:49,2,7,5,很好的老师 看得出来课程准备也很用心 可惜的是由于史纲课的水课性质没人在听 甚至后期没什么人来上课 有时候在上课的时候看她如此激情而座下鸦雀无声时有点心酸😔但我似乎确实改变不了什么//出分4.8 谢谢
210881,2055,董海樱,2025-01-10 05:54:09,1,1,0,党史课很好！冲！捞的
210983,2055,董海樱,2025-01-10 09:20:22,0,0,0,党史真神，每个老师讲的都很好，在主题深刻的同时生动有趣。最关键的是给分巨好。给董老师磕一个！
211344,2055,董海樱,2025-01-11 08:22:40,1,1,0,党史啥也没干给分4.5
211705,2055,董海樱,2025-01-12 08:26:12,1,3,2,老师上课很有激情，但是由于史纲课的水课性质，没什么人听，其实挺可惜的
211969,2055,董海樱,2025-01-13 03:01:48,1,1,0,4.8给分超级超级超级好
212197,2055,董海樱,2025-01-13 10:50:45,0,0,0,党史课很好！
212590,2055,董海樱,2025-01-14 08:53:52,2,4,2,4.8给分超级好
212631,2055,董海樱,2025-01-14 10:06:50,3,3,0,史纲：\n\n老师人很好。期末学在浙大考试，老师说不补测。然而在老师多次的上课提醒后，lz还是忘了这件事。。但老师很善良，最终还是帮忙安排了补测。lz理科生，期末主观题感觉抄书都抄错地方，担忧了好久，最后出分卡线上4.5，感觉老师狠狠捞过。\n\n老师讲课赞。要拓展有拓展，要深度有深度，形式也很多，看得出来是用心备课。lz大一上的一大后悔就是没有仔细听那么精彩的史纲课。\n\n老师对同学用心，哪怕课堂展示没有很出彩，也会用心倾听用心记录。\n\n强推！
212654,2055,董海樱,2025-01-14 10:54:01,1,1,0,预置到董老师的史纲就偷着乐吧朋友们，给分太好了
212657,2055,董海樱,2025-01-14 11:06:16,2,2,0,董老师太和蔼可亲了，为老师写的课程评价老师居然认真看了，讲课水平也好，给分更好！大家选董老师绝对没错！！
212688,2055,董海樱,2025-01-14 13:03:51,0,0,0,一学期五次点名，俩次没去，期末老师捞到4.5，董老师就是神
212748,2055,董海樱,2025-01-15 00:06:26,1,2,1,上课有激情，对历史有共情，有独到的见解，很有启发性，也非常关心学生，很好的老师。
215719,2055,董海樱,2025-03-04 15:50:25,1,1,0,老师讲课还是比较有意思的，我当了史纲组长，也是能给我们小组展示提出建议的，还会给我们发自己小组展示的图片作为留念，点名都是为了满足要求才点的
218432,2055,董海樱,2025-04-23 11:54:31,3,3,0,上课很有激情又幽默，喜欢历史的真的来听，知识很渊博
220077,2055,董海樱,2025-06-14 16:12:54,1,1,0,党史拼盘课，老师负责最后的打分（一般第一个老师负责最后的打分），老师挺温柔的～平常任务是学在浙大上的视频，一个论文作业，最后一节课开卷考试（可以带纸质资料），推荐带史纲和党史课本。\n\n考试不管怎么样多写一点，给分真的超好！如果要高绩点就回答一下老师的问题！字迹工整的话4.5应该是不太难的。
220934,2055,董海樱,2025-06-20 11:34:00,0,0,0,伟大，无需多言
221059,2055,董海樱,2025-06-21 05:19:54,0,0,0,捞神！伟大无需多言\n\n此外董老师上课讲的也很有意思，是可以放心选的好老师！
243,2119,夏婉婉,2015-03-14 17:39:41,9,44,35,老师讲的不是思政课那种洗脑的东西，非常有思辨性～有收获！
316,2119,夏婉婉,2015-03-15 00:45:59,23,75,52,很有灵性气质的老师，第一眼看到就感觉很有范，上课不是讲枯燥的知识，学习活动安排得很好玩，给分很好！
497,2119,夏婉婉,2015-03-15 03:29:46,56,143,87,很好的老师。觉得实际是在讲哲学。而非马原。
720,2119,夏婉婉,2015-03-16 03:58:41,1,21,20,课讲的很好～
2289,2119,夏婉婉,2015-04-16 10:35:43,73,108,35,我觉得老师只是在读她的教学资料…虽然不点名但是有四次讨论课感觉有点麻烦，如果想水马原不适合选她。
3796,2119,夏婉婉,2015-06-17 04:35:58,-4,7,11,不水。。。事情还是很多的，但是讲得挺好，偏哲学。
3833,2119,夏婉婉,2015-06-17 05:47:47,-4,4,8,超棒的老师啊！
4082,2119,夏婉婉,2015-06-17 16:34:47,-5,4,9,老师讲课超棒的，很有思辨性，也很有哲理，受益匪浅呢
4116,2119,夏婉婉,2015-06-18 00:14:53,-5,4,9,很好
4167,2119,夏婉婉,2015-06-18 02:50:18,22,34,12,讲得好但是4次讨论太不水了。。。
5177,2119,夏婉婉,2015-07-05 14:36:07,-3,3,6,很棒的老师。和蔼
5643,2119,夏婉婉,2015-07-09 02:17:23,-3,3,6,赞
5646,2119,夏婉婉,2015-07-09 02:30:06,-3,3,6,马原这种课上的一点都不恶心。
5648,2119,夏婉婉,2015-07-09 02:40:43,-3,8,11,非常认真负责的老师～
5744,2119,夏婉婉,2015-07-09 08:27:17,0,9,9,事情挺多 有四次讨论课 但是给分挺好 还是很有内容的
5782,2119,夏婉婉,2015-07-09 10:36:35,-4,5,9,很好的老师～赞！
5862,2119,夏婉婉,2015-07-09 15:50:42,-4,4,8,好
5922,2119,夏婉婉,2015-07-10 02:37:48,-5,7,12,虽然事儿多但给分赞！喜欢
6005,2119,夏婉婉,2015-07-10 07:31:24,-5,5,10,上课很有意思 不仅仅只是讲马原  就是讨论课什么的很复杂
6028,2119,夏婉婉,2015-07-10 10:26:18,0,10,10,好
6208,2119,夏婉婉,2015-07-12 04:27:22,-5,6,11,老师讲课很赞，讨论课不水～
6483,2119,夏婉婉,2015-07-14 09:51:41,-21,25,46,绩杀！！大家不要选！
9886,2119,夏婉婉,2015-11-12 01:33:30,-4,3,7,好想爱
10339,2119,夏婉婉,2015-11-18 06:32:34,-4,3,7,讲得很好，也许我应该多听听
11448,2119,夏婉婉,2017-06-05 11:26:30,39,47,8,讲的不是马原啊喂，上课好麻烦...三次展示...
12865,2119,夏婉婉,2015-12-24 07:02:33,-4,2,6,一个用课程吸引学生的老师，上课内容丰富，有思想\n\n
13484,2119,夏婉婉,2015-12-28 10:43:05,-4,3,7,非常好
13761,2119,夏婉婉,2016-12-29 06:48:04,20,26,6,人各有需，没有高深理论
13820,2119,夏婉婉,2015-12-31 12:49:36,-4,4,8,好老师！善解人意和蔼可亲！
13865,2119,夏婉婉,2016-01-01 10:51:21,-3,3,6,讲得很透彻\n\n
15323,2119,夏婉婉,2016-01-13 16:05:34,-3,3,6,收获很多
15488,2119,夏婉婉,2016-01-14 16:34:37,-3,3,6,喜欢她
15518,2119,夏婉婉,2016-01-15 04:45:24,34,41,7,事儿妈。。
16598,2119,夏婉婉,2016-01-18 13:44:52,-3,3,6,老师的课很好～
16600,2119,夏婉婉,2016-01-18 13:25:09,-4,3,7,老师上课不拘泥于课本，对思维很有开拓性，讨论课有点多但给分很好，总之很棒的老师
16602,2119,夏婉婉,2016-01-18 13:29:44,-2,5,7,特好～补选老师帮我选上哒
16609,2119,夏婉婉,2016-01-18 13:52:04,-2,6,8,三次讨论课比较麻烦，听说夏老师给分很好？？？ （不过我的分好像不高吖 - -
16616,2119,夏婉婉,2016-01-18 14:20:10,15,17,2,被正态了\n\n
16657,2119,夏婉婉,2016-01-18 16:02:09,-4,3,7,很亲切，喜欢
16686,2119,夏婉婉,2016-01-18 18:39:21,-4,4,8,一个很好的老师，为学生着想～
16854,2119,夏婉婉,2016-01-19 05:41:05,-2,3,5,666
17273,2119,夏婉婉,2016-01-20 03:21:18,-4,3,7,老师讲课很棒很棒的
17461,2119,夏婉婉,2016-01-20 08:51:24,-4,3,7,讲的很棒啊！
17573,2119,夏婉婉,2016-01-20 12:20:39,-4,3,7,超级棒的 给分很好很出色
17594,2119,夏婉婉,2016-01-20 12:47:39,-4,6,10,比思修史纲的烂鸡汤不知道高到哪里去了。她跟我们谈笑风生。
18173,2119,夏婉婉,2016-01-21 08:35:10,-2,5,7,好老师，强烈推荐选
19259,2119,夏婉婉,2016-01-23 16:17:57,-5,1,6,上课很有趣
20353,2119,夏婉婉,2016-01-27 05:58:08,-5,2,7,不是照本宣科
21224,2119,夏婉婉,2016-02-27 00:30:17,59,68,9,事儿多，讲得都是正确的废话
21309,2119,夏婉婉,2016-02-28 03:36:50,42,48,6,一本正经地讲着废话，有事情从来只知道推卸责任
21808,2119,夏婉婉,2016-03-01 06:59:22,-6,2,8,老师讲课真的特别有感觉 平时好好准备讨论什么的 成绩可以上4.5➕的
22003,2119,夏婉婉,2016-03-02 05:28:59,-4,0,4,好好好
22182,2119,夏婉婉,2016-03-03 01:48:55,-2,3,5,好老师，私信聊天很开心
22573,2119,夏婉婉,2016-03-08 05:43:26,-15,8,23,给老师负面评价的一定是某类理工科学生……事实上正确的废话也不是人人能说的了的，个人修养在说话中高下立判。老师讲课的节奏很喜欢，不刻意传达些什么，也不刻意填鸭。
22619,2119,夏婉婉,2019-01-16 07:15:01,18,40,22,老师讲的都是一些自己的生活经验吧，马原课讲成这样也很不错了。只是评分方式什么的就有待商榷，也总得搞个规则出来。不过总体还是很不错的。
23673,2119,夏婉婉,2016-04-12 03:09:24,62,75,13,平时分完全由课助掌控
23932,2119,夏婉婉,2017-01-04 06:07:04,21,26,5,每次上课前半节课是讲的是“我和阿里巴巴不得不说的故事”，后半节课是马原。
23975,2119,夏婉婉,2017-05-02 12:45:52,-5,11,16,也就骗骗文科生
25587,2119,夏婉婉,2016-11-16 00:39:28,-6,3,9,当你去听了其他人文课程，才回越加珍惜这样一位睿智开放儒雅的女老师。
25608,2119,夏婉婉,2016-05-28 01:12:17,-2,2,4,你好啊！
26289,2119,夏婉婉,2016-06-16 15:04:37,-5,0,5,还好吧
26429,2119,夏婉婉,2016-06-18 11:38:03,-5,1,6,没什么不好
26556,2119,夏婉婉,2018-07-06 02:01:15,82,107,25,好好好，课助说什么就是什么。\n\n写了篇论文说我是抄的让我重写，呵呵了自己写的还不敢上传百度文库了。考试周你让我重写！一个月吃屎去了考试周才通知我！抄了篇现成的你告诉我合格了！
28010,2119,夏婉婉,2016-06-28 07:58:55,2,6,4,讲道理 老师是讲的不错而且也不是想象中的马原那么无聊 但是课助实在是太混乱了【x
28258,2119,夏婉婉,2016-06-28 08:22:39,-5,0,5,人很好，平时分给的比较多
28486,2119,夏婉婉,2016-06-28 09:21:02,-4,1,5,人超级好，上课更多的是启发我们思考而不是埋头讲课本。课上的读书分享内容很开放，三次讨论课貌似有点烦但小组合理分工也不会累。
29018,2119,夏婉婉,2016-06-29 06:38:06,16,24,8,平时分神烦，有毒。。写的文章同学互评。太不负责了。。想水的人别选
29732,2119,夏婉婉,2016-06-30 09:05:50,-5,3,8,马原出分了。按捺不住来安利的心情！老师给分真心好！大题都没踩什么点，纯自己瞎BB写满了，给分出乎意料的高。三次讨论课，小组里面分组做，还是很轻松的。强势安利么么哒
29734,2119,夏婉婉,2016-06-30 09:07:03,-2,4,6,给分很好的，上课的方式也很创新的，读书分享，讨论课，老师讲的也很不错
29746,2119,夏婉婉,2016-06-30 09:23:33,-4,0,4,哲学课。负责。\n\n
29796,2119,夏婉婉,2016-06-30 10:28:51,-6,2,8,……平时分确实给得好，期末给分又松垮，总分上90并不太难，对于马原这种课，一来上课讲得不招人烦，二来期末不需要花太多时间就能拿想要的分数，还能要求别的什么呢？
29797,2119,夏婉婉,2016-06-30 10:29:40,-3,1,4,讲课视野挺宽的，人特别好~
29798,2119,夏婉婉,2016-06-30 10:31:34,-5,0,5,老师讲的很有哲理，听她的课其实是一种享受，给分也棒棒哒
29807,2119,夏婉婉,2016-06-30 10:36:52,-4,0,4,很不错的
29808,2119,夏婉婉,2016-06-30 10:37:42,2,7,5,给分挺好的，平时分比较多，但是讨论课事情比较多，如果很在乎绩点的话，建议一定要做课堂书目分享
29827,2119,夏婉婉,2016-06-30 11:14:01,-4,0,4,老师很好，很喜欢
29836,2119,夏婉婉,2017-01-17 17:43:43,-6,1,7,女神！ 给分棒~
29862,2119,夏婉婉,2016-06-30 12:12:42,-4,1,5,老师大好人T T
30102,2119,夏婉婉,2016-07-01 02:32:17,-4,0,4,老师上课很有激情，也很负责
30292,2119,夏婉婉,2016-07-01 07:57:10,-6,0,6,老师人超级好给分也棒！
30303,2119,夏婉婉,2016-07-01 08:23:57,-4,2,6,挺好的 虽然确实有一点朋友圈 但是讨论课和读书分享可以学到很多
30771,2119,夏婉婉,2016-07-02 12:33:06,-4,0,4,给分好！
32789,2119,夏婉婉,2018-01-23 02:58:48,48,65,17,老师人还是挺好的。。。课助制度真的需要改进…大部分分数是课助掌握的…但是标准是现成讨论出来的，并不是很清晰。看得出来老师一直在做尝试和改进，可能以后会更好吧。还有讨论课讲的东西其实挺虚的，有的时候觉得没什么意义。
33849,2119,夏婉婉,2016-09-22 05:45:48,41,51,10,平时分全部给课助\n\n想高分可以当个课代表\n\n论文互评真的很坑，不同同学有不同见解，比如有的只给你评70+那你分数就拖下去了，其中还有人情分\n\n上课不是很积极的还是不要选了。
38197,2119,夏婉婉,2017-01-18 04:27:16,39,50,11,垃圾，负分
38870,2119,夏婉婉,2016-12-19 15:32:19,78,87,9,只能说被楼上的好评误导了选了她的课。。。真的神麻烦
39461,2119,夏婉婉,2016-12-23 02:13:48,51,63,12,讲道理 那些说夏老师讲的好有哲学范的同学我觉得也就是朋友圈鸡汤水平了 \n\n真的想学哲学请出门右转上哲学系老师的课 \n\n关于给分 本人一学期没听过课 平时好好准备讨论 论文分数太随机 考试不用复习 最后给分还可以吧
40231,2119,夏婉婉,2017-01-15 09:21:09,27,43,16,呵呵了点名批评2016秋冬学期周三上课助文琦，出的讨论方案造成两次课很大争议分歧，自己不反省下自己问题口口声声说自己尽责令人作呕，这门课平时分数都是课助想怎么计算就怎么计算的，讨论课发言控制也没有规定，发言率最后也没公布，课助也不是选出来的是自己报名就能进，观察员也是什么素质的阿猫阿狗都能做，说不定你一不小心就被没能力却玻璃心的课助和素质差嘴巴臭的观察员控制了分数呢，到时都无处申冤呵呵
40573,2119,夏婉婉,2017-01-04 06:18:03,-4,3,7,学到了很多东西。讨论课真的是每个人都在努力参与进行思维的碰撞。非常非常好的老师。为同学们着想
40675,2119,夏婉婉,2017-01-18 02:50:51,-2,4,6,给分好呀
41044,2119,夏婉婉,2017-01-08 15:20:05,-8,4,12,真不知道该怎么说，客观来说课助负责任被骂不负责任也被骂，夹板气受着。评分有问题直接找老师啊，老师干嘛的不找？评分细则有问题找课助？有用吗？有用吗？有用吗？智商被吃了？站在道德高地上冷吗？评分细则是课助有权利决定的吗？小学生都知道出现问题找老师，你脑子是被书海泡了吗？    双商感人真让人长见识
41076,2119,夏婉婉,2017-01-14 05:35:37,-9,4,13,某条几个小时八个赞，一个班都不用考试这么默契跑过来评价？分低就用这种手段找课助撒气，你怎么不去当差评师呢？对得起教你一个学期的老师？点名你倒是直接去找人家说呀？辣鸡。
42371,2119,夏婉婉,2017-01-14 05:37:25,11,12,1,被骗补选，想水勿上
42960,2119,夏婉婉,2017-01-15 13:49:47,11,15,4,不满意的就是论文评分规则。\n\n真的很讨厌，受不同小组影响程度很大，也会有一定的随机性。\n\n当然你写的超级好没话说。。。但毕竟认真写完了，最后成绩那么低，欲哭无泪。
44399,2119,夏婉婉,2017-01-17 19:09:37,0,3,3,可能因为补选的时候很好沟通对老师先入为主地有了好印象吧，觉得老师还是很好的，至少听她说话很舒服。两次讨论课比赵晖的史纲还是要轻松得多。我平日咸鱼，平常分后20%，最后成绩也还过得去，老师应该有调分的
44402,2119,夏婉婉,2017-01-17 21:22:56,1,2,1,自身体验很多，但深度稍差，总体不错
44407,2119,夏婉婉,2017-01-17 22:28:50,-2,3,5,老师很可爱。平时分就要看课助了。大部分课助还是会尽量给大家高分的，要是自己什么都不参与也就不要想着拿好看的分数了。
44412,2119,夏婉婉,2017-01-17 23:02:06,0,2,2,给分还可以
44432,2119,夏婉婉,2017-01-17 23:43:22,2,6,4,马原课不水是真的，不过把读书分享做最好，论文一定要有新意，讨论课多发言，思维激荡也说几次。。。就差不多了。\n\n
44441,2119,夏婉婉,2017-01-17 23:58:28,8,12,4,真的朋友圈水平，讲课很烂，主观性很强，炒鸡zz。最后给分还一般
44454,2119,夏婉婉,2017-01-18 00:23:10,-2,2,4,很好很温柔的老师，又有自己的坚持，有自由而无用之遗风，遇见过的最好的思政课老师之一。
44523,2119,夏婉婉,2017-01-18 02:24:48,-2,6,8,老师人超nice。分数确实把握在课助手上，但是你有意见和建议，或者你们组有什么困难，提前和老师讲，老师都会认真的考虑，还会感谢你提出问题来，从这个角度讲，分数最后还是在自己手上。上课讲的比较偏哲学，不是洗脑式教育，虽然很多她的观点我并不认同，但老师是个很包容的人，你的观点她都会尊重。是个很好的人。
44530,2119,夏婉婉,2017-01-18 02:31:48,4,8,4,挺好，就是不喜欢论文互评和讨论课的制度
44542,2119,夏婉婉,2017-01-18 02:42:11,-3,2,5,撇开思政课给分问题，夏老师真的是很用心的讲哲学，授知识，传智慧。的确事情是很多，平时分课助和同学掌控也有点多，但是就老师讲课内容而言，我觉得是非常丰富的。而且老师对学生的态度特别好，很温柔很智慧的老师，个人认为马原课最佳！
44596,2119,夏婉婉,2017-01-18 03:55:56,-2,2,4,老师人很棒，总是在讲很多具体的故事，对马原的理论内容可能还是课本说的比较多，但是能够分享自己的阅历和启发同学的看法，这才是一个好老师真正应该做的吧。
44628,2119,夏婉婉,2017-01-18 04:58:40,16,20,4,感觉老师自己任务轻松，论文互评是谁想出来的，任务太多，评分也不合理，但是那些因为分低就爆粗也应该想想自己平时努力了没。虽然看不惯那些为了加分上课总是提一些毫无意义的问题的人，但如果在意分数的话，我们也可以发言，但自己选择了沉默又能怪得了谁呢
44847,2119,夏婉婉,2017-02-03 07:03:00,10,11,1,呵呵哒
44863,2119,夏婉婉,2017-01-18 11:54:14,-2,2,4,给分很好
45149,2119,夏婉婉,2017-01-19 05:01:02,6,8,2,给分差
45355,2119,夏婉婉,2017-01-19 12:36:53,8,9,1,看到79知道老师已经尽力了……2333
47118,2119,夏婉婉,2017-01-24 02:39:55,-1,2,3,老师对于现实、社会有自己的看法，上课可以睡觉，不准带耳机。
48148,2119,夏婉婉,2017-03-01 02:08:05,-2,1,3,思辨之课
48281,2119,夏婉婉,2017-12-27 05:17:34,13,29,16,讲课很多例子，事也也还好，喜欢红砖的同学可能觉得不好，但我觉得还不错，而且还在课上跟一个女生熟络了起来，现在是我女票
48426,2119,夏婉婉,2017-03-03 06:49:53,0,2,2,啊啊啊
48492,2119,夏婉婉,2017-03-06 05:29:51,-1,5,6,让夏老师上八嘛\n\n
48723,2119,夏婉婉,2017-03-10 06:24:52,9,10,1,逼事贼多，千万别选，真的！
49018,2119,夏婉婉,2017-03-28 06:30:39,10,11,1,事儿妈一个
49222,2119,夏婉婉,2017-03-30 01:35:46,10,15,5,贬低文科生的那位，文科生招你惹你了，恕我直言，这种课也就让某些没接触过马哲的理科生装装逼，
49313,2119,夏婉婉,2017-04-05 02:47:01,5,6,1,马原事多很麻烦
51125,2119,夏婉婉,2017-05-18 05:35:43,21,24,3,感觉老师的三观有点奇怪，不喜欢，利己主义者
51126,2119,夏婉婉,2018-02-02 12:55:33,123,151,28,说直接给课助满绩的我很纳闷。绩点是衡量学习情况的。课助一不参加思维激荡，二不参加讨论课的辩论过程，只是扮演了引导者的角色，恕我直言，只要老师把流程讲清楚，根本不需要课助“串词”之流。哪天课助工作不和绩点挂钩，那才叫真正的课助。课助=较多的程序化劳动+较少的课程内核参与。普通学生=较少的程序化劳动（填表，打分，汇总等）+较多的课程内核参与。就这样，课助只是老师转嫁自身“负担”的一种手段，不愧是“复旦”大学的，培养出“自由而无用的灵魂”，但改变不了浙大大多数人求是务实的品质。
51140,2119,夏婉婉,2017-05-18 09:38:12,0,1,1,。。。
51315,2119,夏婉婉,2017-05-31 05:43:08,7,9,2,你要认真上马原课的话 去吧不拦你 我不知道大家怀抱什么心情来听课。心情变化是这样的:好奇    不错     事多     好烦     我靠怎么还有事  赶紧告诫别的同学别选她的课\n\n唉老师为了吸引同学注意力 一直在讲故事 有些可怜 讲道理和书本压根没啥关系 另外我觉得上马原课没必要搞这么多事啊 你有一到二项品牌的活动就好了 硬是按自己的思路做了这么多活动 效果并不如何吖 可能和课助水平有关 唉 感觉说多都是泪 最后有种竹篮打水一场空的感觉 奉劝各位 她的课越少人应该越好吧
51316,2119,夏婉婉,2017-05-31 06:31:02,12,15,3,事情多，讲的也很不专业，这是我最后悔的一次选课！\n\n
51736,2119,夏婉婉,2017-06-09 02:19:43,1,5,4,mmp～
52020,2119,夏婉婉,2017-06-14 07:21:58,11,17,6,上大学以来最不喜欢的老师没有之一。平时分评分混乱，评分原则是最后一节课由课助自己讨论决定（课助是当堂课的学生，课助产生机制不明）。讨论课怎么给分、论文怎么给分也都是课助自己决定……有的课助随便就gg。课程任务超多，每堂课需要到，课助点名。每节课有思维激荡（小讨论）/读书分享，两次大的讨论课，反正不是很闲的超喜欢课堂参与的不建议选。平时分由组长给……老师上课理论部分言论个人不是很喜欢，看上去人很温和（笑
52149,2119,夏婉婉,2017-06-15 07:19:08,4,5,1,废话多，上课时间都在炫耀坐过哪个公司的飞机。上课水平???感觉讲课很少，大部分都是展示和讨论，感谢我们的四位课助……
52280,2119,夏婉婉,2017-06-17 10:44:55,1,3,2,制度更成熟就好了，很有想法
52521,2119,夏婉婉,2017-06-21 00:47:12,4,6,2,只想给0分，可能大多数人评分很高，万一你被正态，真的是无话可说，做了那么多事！结果最后不考好点，都快不能及格了？？？
52843,2119,夏婉婉,2017-06-23 07:16:12,7,8,1,平时成绩课助和组长掌管，组长一个心情不爽，你的平时分就是班级倒数几名了，你一点办法没有，赶紧当组长或者课助吧
53707,2119,夏婉婉,2017-06-27 10:38:58,5,5,0,上课上得一般吧，有种看朋友圈的感觉。而且平时分完全由课助（学生）安排，不管有多不合理。总共有两次讨论课，每节课的读书分享还有思维激荡，一篇论文。论文学生互评比重很大。事多学到的知识少。
53767,2119,夏婉婉,2017-06-27 13:32:09,3,3,0,对老师的上课内容不太喜欢，感觉三观和自己不符，事多，不过论文给了我一个不低的分，不像互评那样乱给，
53922,2119,夏婉婉,2017-06-28 04:27:53,5,8,3,老师非常好，很温柔，讲的内容也很充实。。。但是能不能把课助制度取了，哪怕是助教评分也好啊，坑
54574,2119,夏婉婉,2017-12-22 00:12:10,2,19,17,出分前来评一下，看到评论其实蛮心疼老师的，说什么麻烦，老师如果就照着讲义念她也很省事，她这样做也是为了让我们收获多点，同时也是减轻考试压力。课助制度的确有待完善应该事先制定好，但是我们三下课助都很好很负责，我觉得直接给他们满绩都可以因为真的付出很多还要被一些人吐槽。课助怎么选出来的，什么叫机制不明，第一节课主动发言的只有他们，自己不争取怪谁咯？私下问老师问题和老师聊天老师都非常亲和，老师讲课也蛮生动的(和其他马原老师比)，我不明白一个马原课上成这样，一个马原老师做了这么多为什么都要骂她。洗白夏老师，你们爱踩就踩吧。
54733,2119,夏婉婉,2017-06-30 06:11:27,5,8,3,瞎玩玩\n\n三观不正\n\n喜欢推卸责任\n\n什么事都以自己为中心\n\n事情都交给课助做，课助瞎搞也不来管管。\n\n考试题型范围都不告诉你\n\n看起来事情多，都是我们的事情，她可闲的很
55161,2119,夏婉婉,2017-07-01 02:24:22,3,7,4,老师很好，虽然课上事情确实多，但我觉得老师是真的在授课。论文好好写不会被埋没，期末考试好好准备也不难。老师给分很好，课助们也很辛苦，想对他们说声谢谢～
55189,2119,夏婉婉,2018-05-14 06:40:09,1,3,2,平时事情很多很多 当然主要是看课助 我们每周都有思维激荡/读书分享 还有两次讨论课 可以说每次马原课都是有事情要准备的 除外论文的互评其实不是很合理了 完全也可以相互串通 老师就是太放权了 不知是自己懒还是别的原因…给分的话 我平时分54总评84 3.9 个人感觉不是很高了 并没有想象中给分好 想水的慎选
55195,2119,夏婉婉,2017-07-01 16:26:32,0,2,2,是一位非常好的老师 上课会讲一些让你思考很久的东西 认真听是会有很大收获的
55221,2119,夏婉婉,2017-07-01 04:21:50,-2,1,3,老师上课讲的很好啊 感觉人也很和蔼 平时虽然事情多（其实真正水的人并不觉得） 可是给分很好啊 期末只要选择题做的好 绩点不会太低的
55242,2119,夏婉婉,2017-07-01 05:30:36,1,4,3,注重平时分吧主要，最后考试花一下午准备上4的话还是很简单的\n\n
55338,2119,夏婉婉,2017-07-03 15:47:43,5,8,3,课助并不满?，很难水，有收获，但有很多不合理orz...
55368,2119,夏婉婉,2017-07-01 11:31:05,0,2,2,从学识上看不能算一个很厉害的老师，感觉比较自我，每天都在讲故事，有时候显得有些三观不正。事情都是课助做，但是给分不错。一定要做读书分享！比较注意独立思考能力？但是只有初步的引导
55466,2119,夏婉婉,2017-07-01 14:10:25,0,3,3,讲道理 是很好的老师 想要绩点高的话上课好好发言啊 提高课堂参与度啊 论文认真想啊 老师不会又红又专讲马克思的 是很思辨的哲学 反正也不会管你在干嘛 不听就算咯 给分还不错啊 认真复习的话就上四了
58163,2119,夏婉婉,2017-08-13 04:52:57,1,2,1,辣鸡老师
59020,2119,夏婉婉,2017-09-19 06:47:21,2,4,2,课助并不满绩，下面的同学不要听风就是雨，要有自己的判断。
59236,2119,夏婉婉,2017-09-20 10:30:43,1,2,1,学哲学的……还可以吧，就是忙
59301,2119,夏婉婉,2017-09-20 14:57:57,0,2,2,我觉得……在课上学到了很多。认真做一定会有收获。
59408,2119,夏婉婉,2017-09-21 07:21:11,1,2,1,怎么会有这么事多的人，你是老师啊不是干策划的
59797,2119,夏婉婉,2017-09-27 04:52:25,-1,2,3,一位优秀的马克思主义者\n\n
61332,2119,夏婉婉,2017-11-14 14:51:56,1,1,0,不是很喜欢...
61532,2119,夏婉婉,2017-11-18 09:44:54,-1,0,1,老师很好
63276,2119,夏婉婉,2017-11-30 02:51:03,4,5,1,课助机制很迷，课助水平参差不齐，希望以后可以筛选一些比较负责的课助吧。
63731,2119,夏婉婉,2017-12-13 15:26:47,5,6,1,事情多
64233,2119,夏婉婉,2017-12-22 00:14:23,1,2,1,课助真的看脸，我们这一班整个人都炸了课助还在那bb
65296,2119,夏婉婉,2018-01-02 14:55:44,3,3,0,课助制度实在是一大败笔，事情多，其他还行
65426,2119,夏婉婉,2018-01-04 01:48:22,5,8,3,课助筛选制度一生黑
65428,2119,夏婉婉,2018-01-04 01:57:07,9,11,2,课助制度真的烦，制度给分规则不清楚，现场讨论就算了，什么都让课助管的样子，论文互评什么鬼东西，平时事情贼多，思维激荡，读书分享，辩论，想水马原的千万别选！！PS:真心不喜欢课助制度！
65445,2119,夏婉婉,2018-01-04 03:44:09,11,11,0,真的辣鸡，评分制度不完善，上课还很迷，感觉说什么多样化其实就是自己懒，千万别选，这是血与泪的教训
65458,2119,夏婉婉,2018-01-04 05:32:59,-1,2,3,钻石级老师配上一个青铜三课助，呸，青铜三都不如！神逻辑，神特么课助！
65733,2119,夏婉婉,2018-01-08 14:55:48,4,5,1,我觉得这个老师就是很好笑，一开始没有一个合理的评分机制，完全是学生觉得分数低了就可以改，改了以后又乱来，分数很可笑。各种不靠谱吧，反正能别选就别选，给分就跟玩游戏一样的。
66066,2119,夏婉婉,2018-01-11 09:12:41,11,12,1,老师讲的好不好另说，但是这老师的事情真的多的难以想象。六次思维激荡（小组课后讨论加课上演讲）四节课的读书分享，还有每组一次的辩论赛。论文需要自评互评加师评。给分问题特别大，思维激荡小组之间分数差距特别大，能差0.9的绩点，论文的互评所占比重过大，同学给分很不稳定，导致很多人对论文分数有所不满。
66156,2119,夏婉婉,2018-01-12 07:46:37,2,3,1,期末考核评分一点都不公平，真是醉了
66166,2119,夏婉婉,2018-01-12 08:29:17,0,2,2,一般般
66179,2119,夏婉婉,2018-01-12 14:07:16,2,6,4,垃圾老师定的垃圾制度 完全课助掌控平时分 论文打分水分很大 千万别选她的马原课 血的教训！！！
66283,2119,夏婉婉,2018-01-14 15:16:05,-1,0,1,菩提将军路
66322,2119,夏婉婉,2018-01-15 05:01:27,-1,0,1,没感觉\n\n
66773,2119,夏婉婉,2018-01-19 03:32:05,0,3,3,有些课助还是很好的，比如罗同学等。再说了叫你去当当看，你有别人的水平吗？一门马原能拉你多少绩点，一般吐槽的也都是那种其他也学不好的吧。
66894,2119,夏婉婉,2018-01-19 08:29:04,4,6,2,不要听评论区带节奏，想水的人肯定会不适应，但是我们班的平时分还是相当好的，四个课助也很认真负责，读书分享、思维激荡和辩论赛给分都基本是满分。
68057,2119,夏婉婉,2018-01-22 14:21:20,0,2,2,事情多，给分差
68059,2119,夏婉婉,2018-01-22 14:24:37,3,3,0,老师其实是知识很渊博的，讲的很不错，但是自己不太喜欢这种课所以节节水过来……事情的确比较多，但过来了也就好了哈哈哈，课助工作很ok，组长带飞，期末复习比别的思政努力了一把，绩点还是棒棒的~
68062,2119,夏婉婉,2018-01-22 14:27:04,1,1,0,感觉老师没有讲深，只是引导，但是给分很好
68065,2119,夏婉婉,2018-01-22 14:29:49,3,3,0,课比较有意思，给分也不错。活动比较多，但是很锻炼能力。最后，分组分到的队友特别重要!
68066,2119,夏婉婉,2018-01-22 14:32:37,3,4,1,事情多，一样水的同伴，摊上好队友结果高了十几分，呵呵
68087,2119,夏婉婉,2018-01-22 14:44:58,-2,2,4,老师讲的确实很不错。上课很有趣，而且确实锻炼思维。辩论赛真的刺激哈哈哈哈。重要的是，给分，超级好！！！
68092,2119,夏婉婉,2018-01-22 14:46:22,-2,1,3,老师真的很好！平时上课挺水的，课助会点名，事情真的不算多，马原都这样！给分真的很棒！完全意想不到的成绩！
68093,2119,夏婉婉,2018-01-22 14:47:49,-5,3,8,呀呀呀！水了一个学期，绩点还能上四！开心！\n\n
68094,2119,夏婉婉,2018-01-22 14:47:58,1,2,1,平时分挺高的，结果没想象的高，不过还不错，事情较多，平时水
68096,2119,夏婉婉,2018-01-22 14:49:02,3,6,3,夏老师是一个负责任又热心的老师，经常会因为跟同学讨论问题而顾不上吃饭，又因为还有课，只能在麦斯威买面包和奶茶垫肚子，挺心疼的。希望大家多多支持她，难得的好老师！
68098,2119,夏婉婉,2018-01-22 14:49:54,3,4,1,老师上课很用心，很努力地让课堂不单调，给分也很好的，平时分很重要要多付出一些，总之值得选课～
68105,2119,夏婉婉,2018-01-22 14:53:58,0,2,2,前排表白老师(๑• . •๑)
68106,2119,夏婉婉,2018-01-22 14:54:56,4,4,0,主要看平时分，平时分靠课助和小组
68109,2119,夏婉婉,2018-01-22 14:56:22,1,3,2,正态呵呵，你有本事公布期末成绩阿？
68117,2119,夏婉婉,2018-01-22 15:01:03,3,4,1,老师人很温柔，上课超级努力，准备了很多材料和话题，平时认真听的话会有挺多课堂以外的收获的，而且平时分给分也还不错。课助很负责，有几位好厉害啊超级nice！论文评分制度一言难尽，互评占比太大，标准不够统一，希望以后能改进吧。
68169,2119,夏婉婉,2018-01-22 16:06:31,3,4,1,考试30，平时分70(到课，读书报告，论文，辩论，思维激荡)\n\n我参加一次读书报告，因为是深入阅读过的，展示的时候也比较流畅所以拿了最高分，但是辩论没参加过。最后4.8超过了预期，以为差不多4.2。\n\n总体来说平时分大家差距不大，还是看考试更多。
68176,2119,夏婉婉,2018-01-22 16:32:18,20,38,18,首先课助拍个身份^_^，关于课助的问题，我觉得同学们吐槽很正常，这个制度确实是需要改进的，像我的水平就不是很高。其实我们平时和老师也有交流，能感觉到老师的努力，希望能让大家都满意。思政课和别的课不是很一样，很多都是凭主观意愿的东西，老师真的很好很负责，一切问题都是我们课助太水。。不过想水的同学要么别选，要么找好队友*^o^*\n\n其次说一下课助的问题。作为一个大一新生，我没有另外三位课助的水平，直博的，专业第二的，竺院的（心疼抱住成为狼群哈士奇的自己）我管理辩论赛，尽量给大家一点思考和趣味交织的体验，让大家参与其中。但是在分数制度上确实也欠考虑，在这里给大家道个歉。还有就是后来点名的问题，我不是针对哪位同学，我就是觉得“我不过一次点名没来”这种话我是说不出口的，的确我们一次没来扣十分，但是个人觉得这是一个态度问题。我不太想用什么“来浙大你来玩来了”这样的话，我只是觉得，既然逃课，你一定是做好了承担后果的准备，我们虽然不是社会人，但是我们输的起。\n\n还有，不管同学们怎么想我，都非常谢谢你们，还有亲爱的老师的配合。我PPT上写的每一句话都是真心的。感谢有了这么一场盛大的遇见，所往之地皆为热土，所遇之人皆为挚友。\n\n嗯。。。老师嘛，仁者见仁，智者见智，要我说，只能用可爱形容了。点不点名嘛，看你们的课助了。。。\n\n哦哦，最后一句，你们有什么埋怨，冲着我们男课助来，老师和女课助毕竟都是女士嘛，谦让一点。虽然我也因为你们的问题生气摔过手机，返回头再看看，也挺有意思的。\n\n总之，非常谢谢马原课上每一个人~\n\n――来自工信一只弱的不行的天天混在大佬堆中的野生（处变不惊）课助~
68179,2119,夏婉婉,2018-01-22 16:35:22,3,6,3,感觉老师讲的不是很马原 \n\n感觉有点哲学混合鸡汤\n\n有几次把我讲到眼角湿润\n\n幸好我的理智告诉我这是毒鸡汤\n\n课程设置十分用心\n\n（而且平时分给得不错呀）\n\n总是还是不错啦\n\n（可能事儿有点多 记得要争取读书分享）
68303,2119,夏婉婉,2018-01-23 02:59:20,1,3,2,授课方式很有趣，成绩绩点也可以
68349,2119,夏婉婉,2018-01-23 04:39:20,0,0,0,好事多磨
68687,2119,夏婉婉,2018-01-23 15:25:35,2,3,1,平时事情超级多，马原打算水一水的不要选她。最后考试大概就过过形式吧，几乎按平时正态。PS:平时分出来的时候千万别高兴，因为大家都是90分以上。最后按正态来给最终成绩的。。。
68881,2119,夏婉婉,2018-01-24 04:54:58,6,7,1,我摸着良心写的\n\n事多，评分标准混乱，点名（点名技术极强，切记不要第三节课走。。。）都是真的\n\n但是你做多少的东西就能拿多少的分，比如辩论，比如读书分享，比如小论文，同学会拿脚投票帮你把你从不愿意认真写论文的人里区分出来的，起码没有py什么的事情，平心而论算得上公正，但不能算好混分。\n\n最后。。。绩点很高，不过我觉得我付出的和我得到的基本一致，算是可以了。
73058,2119,夏婉婉,2018-01-31 22:57:06,-2,0,2,感觉气氛挺好的
73447,2119,夏婉婉,2018-02-01 14:41:46,1,1,0,老师人很好，这其实是课程的问题别纠结了...
73760,2119,夏婉婉,2018-02-03 05:12:24,3,3,0,平时太过于流于形式，但是好好做平时分不会低。。。但是期末考就怪不了老师了（自己算了算，期末刚及格）
75925,2119,夏婉婉,2018-03-22 03:29:02,2,2,0,事情多到窒息 先码一个学期末给了分再看
75927,2119,夏婉婉,2018-03-22 03:32:09,9,9,0,我已经被评分规则弄懵了……
76340,2119,夏婉婉,2018-04-03 14:00:00,14,16,2,被好评误导，真的神烦。\n\n请问真的在讲马原么？我怎么觉得是鸡汤？\n\n教学安排及其迷醉。不知道这样多的问答制度与辩论有什么意义？完全感受不到与马原的联系。\n\n真的，第一次给老师差评。
76370,2119,夏婉婉,2018-04-05 01:03:48,9,10,1,事情真的巨多，超级麻烦，而且讲课真的不好，政治部分讲的不如高中政治老师，哲学部分更不谈了，上学期学过哲学问题再听她的课简直就是折磨。。而且各种炫耀自己在上海的朋友关系，浓浓的成功人士鸡汤味
76683,2119,夏婉婉,2018-04-18 08:13:18,21,22,1,最后悔的选课，没有之一。最讨厌的老师，没有之一。不要选，千万不要选，浪费时间，浪费生命。\n\n首先，我是抱着学哲学的想法来的。老师的马克思主义哲学，一大堆无聊故事外加自己同学、妹妹……儿子女儿的故事，哲学问题含含糊糊，认识论、实践观都讲不清楚，真的还不如去学高中哲学生活。不不不，自学或者去选哲学专业的课。\n\n其次，课助制度，大家吐槽很多，我就不细说。我有一个同学也是课助，他说也是一天天忙到死，老师要求巨多，不断的改制度。所以，真的是老师的问题，不是我们。要么你好好讲课，要么挑一两个讨论、辩论好好弄，想弄的挺多，都不好。\n\n最后，不要选，千万不要选她的课！！！
78366,2119,夏婉婉,2018-05-11 06:42:29,4,4,0,论文格式抄吕强男神的，期末还给我非正态卡档，事情巨j2多，差评不解释了
78367,2119,夏婉婉,2018-05-11 06:44:22,5,7,2,无止境偏心课助。课助做的特别差，宛如智障也满绩，要脸吗？能不能让我们给课助评分制约？傻逼吗？普通同学的分数都掌握在课助手里，遇到智障课助真的分低。事情多，考试周前一天还要做课堂问答，每一周都有问答展示辩论，事多分低。千万别选。\n\n
79287,2119,夏婉婉,2018-05-30 04:13:22,2,2,0,没有学到任何知识，事情贼多很麻烦
79493,2119,夏婉婉,2018-06-07 13:32:25,-13,1,14,老师还好，课助真的神了。一堆骚操作，令人目瞪口呆。
79549,2119,夏婉婉,2018-06-09 03:33:19,0,2,2,神奇课助。严重降低课堂体验。
80155,2119,夏婉婉,2018-06-21 12:16:35,5,6,1,首先，课助和组长干活重无加分。美其名曰:应当收获其他更多的东西。难道多劳多得不是分配制度的思想?\n\n其次，上课特别喜欢套上经济学的帽子。作为经济学专业的人，发现她都是不懂装懂，大多乱用。以及喜欢扯物理，特别是量子力学和相对论，好像就能显得她高大上似的，也不想想下面坐着的也有物理系的。\n\n再次，给分巨差，老师打分比同学互评低20+考虑一下。每次问答都会出现老师打了70分同学互评都是85-90。最后一次讲马克思主义经济学，一些专业性很强的问题都被老师打了低分。我就不懂了，你不是喜欢经济学吗？\n\n总结:我们的平时分最后怎么算的:同学评分占70，老师占30，最后所有人+10，这样子大多数才平时分80多，换算之后只有60或者出头，各位考虑一下吧。以及不知道老师是怎么评分的，但是她会给一些组(听起来并不突出)打95-100，再加上前十论文(实际分数90不到)可以评为满分论文(平时分+2.1)，最后绩点估计很多人还是能看。只想要3.6左右的朋友可以了解一下
80210,2119,夏婉婉,2019-04-01 00:31:06,-29,8,37,其实要说锅的话还应该是正态分布的锅；\n\n老师有些制度可能会加剧了恶竞，有些规则值得商榷。只要正态不死，思政课学分仍如此之高，地位仍然猖狂，这老师就永远有争议。我也的确不懂，思政课真的要做这么大区分度吗？这里有多少人能真正从思政课学到东西？即使是看似认真的人，无非更多扮演的是“老师的舔狗”。这就是我们眼中的浙大，看看你还要不要做这样的“舔狗”。\n\n关于这门课的话，其实好多事情不是强制的，不去完成的话，如果队友靠谱，平时分也不会太难看。主要别缺席，论文甚至都关系不大，从而其实大家平时分都差不多。\n\n最后考试，选择题才是重点。那些分数不高的同学，多半是期末没考好，或者选择题没有答得太好。（几百号人，第二天出分，想必老师大概也就是扫了一眼选择题吧……）\n\n所以针对这门课的策略，如果想上4.2，期末选择题好好刷，其实没什么问题（个人平时分其实蛮低的，64/70）希望大家有所方向，别把精力全部放在平时。（虽然4.2也拖了我不少绩点，但对于平时付出不多的我来说也可以接受）。\n\n但若想要更高绩点，论文可以好好写，活动的话建议还是按照兴趣来。如果真的是为了成绩而做“舔狗”，个人觉得其不是很值得，而且其他同学会以怎样的眼光看你？为了分数卑躬屈膝？\n\n所以，这一切都是根源制度的锅。大家可以吐槽一些制度，但是情绪的发泄，应该还是从源头上来。因为，思政课的正态，原来就是在培养一群舔狗，这就是浙大的培养目标？\n\n
80236,2119,夏婉婉,2018-06-22 09:16:23,5,6,1,"事情真的巨多，而且警惕摊上神一般的队友。这学期队友简直了，然后导致问与答与辩论都是垫底，平时遇上什么事我都急死，就那种已经迫在眉睫，其他小组都搞定了我们小组啥都没的时候，各位大爷都是""反正凭什么落到我头上爱管不管""的态度在水手机。我论文写的还可以，中等偏上，期末就算考满分也就88顶天了。自认为自己算认真负责积极的，无奈平时分太与队友挂钩，上大学以来最恶心队友手动再见，只能自己多问答问题争取一下了我呵呵了个去。感觉大家都平时分扣的挺多的，并没有想象中好! 公平来说还行，但是公平的结果就是普遍的绩点可能偏低"
80297,2119,夏婉婉,2018-06-24 14:30:02,6,6,0,事情贼多，讲的内容和马原一点关系都没有，想听哲学请到哲学系，心灵鸡汤，或者她自己认为有趣（其实并不）的事情，组织各种活动都推给课助，每节课都点名，论文互评，辩论，读书分享，论文分享，慎选！
80570,2119,夏婉婉,2018-06-28 03:29:05,5,5,0,她希望德国：韩国 0:2！德国吹不想说话
80655,2119,夏婉婉,2018-06-29 02:28:35,3,3,0,别选！！！
80779,2119,夏婉婉,2018-07-01 03:26:00,3,4,1,平时分低的一批  付出就有回报论不可信
80896,2119,夏婉婉,2018-07-02 12:55:52,4,4,0,别选别选。
80897,2119,夏婉婉,2018-07-02 12:55:55,4,4,0,别选，事多
80898,2119,夏婉婉,2018-07-06 05:20:13,10,15,5,很垃圾，期末一天就出分，请问是不是随机给分？？？个人认为虽然我不是平时最活跃的最恶竞的人，但至少出勤没问题，论文还可以，没事还参加个辩论，当个评委，发个言，然后最后给我卡绩79？？？\n\n真可谓拉绩老师
81560,2119,夏婉婉,2018-07-05 11:35:17,-2,3,5,出分了，感动到哭……其实自己并不是很活泼的人，只是一直有在小组认真做事，然后考试好好复习，凭文科生的水平写满了答卷，就收获了这样惊喜的成绩。其实老师是一直在锻炼我们的能力，课堂上也见到了很多优秀的人，让我一直有更努力一点的动力。老师很棒，想有收获的同学，选择不会错！
81577,2119,夏婉婉,2018-07-05 12:38:13,5,5,0,虽然听了一学期课不是很喜欢这个老师，事情也多，但是最后好好复习一波还是上4了，算了吧算了吧。慎选
81584,2119,夏婉婉,2018-07-05 12:50:46,-2,3,5,首先4.2工科生对马原零基础的我很满足了\n\n夏老师讲课很有意思，虽然有些观点比较奇怪我不太认同而且并不按照课本来但是真的很有意思。总的来说还是挺好的老师了，毕竟是马原课嘛。但是事很多是真的，各种乱七八糟的点名手段，课堂辩论，互相提问回答，论文互评还要求查重率……但是平时分只能说一般吧\n\n关于饱受诟病的课助制度，主要是因为课助本身并不是那么专业所以可能同学们猜疑会比较多，但是说实话我觉得课助还挺负责的。嗯，总的来说还是挺不错老师，推荐！
81590,2119,夏婉婉,2018-07-05 13:08:41,-9,1,10,毫无马原基础的理科生，考试只写了一小时就走人了，最后4.5……平时分占比很大（70%），适合我这种背不了书考试也竞争不过文科生的人……事情多也是真的，但想水的话也可以水…比如我在她课上敲了一学期的代码……
81601,2119,夏婉婉,2018-07-05 13:45:54,3,3,0,表示上课很没意思，几乎没人听，事情很多，不知道老师到底想说什么。最后成绩出乎意料，大概是刷夜看选择题起了作用，平时分一般般，最后还不错。如果有其他老师能选，不建议上她的课。最后想说，看查老师最近评论，感觉满世界马原都上四了。。。
81602,2119,夏婉婉,2018-07-05 13:49:36,2,3,1,唉，一言难尽\n\n
81604,2119,夏婉婉,2018-07-05 13:51:21,-5,1,6,听老师讲课比较像哲学!老师人很好啦。
81612,2119,夏婉婉,2018-07-05 14:16:13,2,4,2,虽然平时事情非常多，但是都可以不参加水过去……期末只要认真看看书刷点题，给分还是很不错的！
81616,2119,夏婉婉,2018-07-05 14:30:10,-2,4,6,事多点名是真的 不过辩论之类的认真参与会很有意思 不去上课的话记得请假因为请假真的不扣分啊2333 应该是马原出分最快的老师 给分爆好 推荐
81625,2119,夏婉婉,2018-07-05 14:59:52,1,3,2,瑟瑟发抖…平时分70就扣了10… 分数包宿命… 最后还能裸考上4真是谢天谢地
81628,2119,夏婉婉,2018-07-05 15:04:23,1,3,2,老师很轻松总说压力大？
81629,2119,夏婉婉,2018-07-05 15:03:03,9,9,0,课助没有加分，没有加分，没有加分。老师规则什么的几乎不管，课助组长要主持很多工作，制定规则还要在老师和同学的夹缝中生存，一不小心就里外不是人。老师美其名曰“给课助和组长的不是分数，而是锻炼自己的能力……”所以，想水的千万别选，实在选上了别当课助组长，抱大腿比较重要Õ_Õ
81633,2119,夏婉婉,2018-07-05 15:22:08,12,16,4,首先，证实一下课助没有加分。不知道老师是不是受了那些在查老师上看到评论说课助满分的人的diss的影响，加之有人居然在群里匿名公开diss老师（素质不敢恭维），所以她很明确的表示课助不加分。但是，我不说所有的课，绝大多数课，包括思政类，课代表有加分难道是什么耻辱的事情吗？本来就是老师的二把手，付出自己时间去完成老师的任务，和那些抓住加分机会去演讲的同学有什么不同，抓住机会锻炼自己的课助组长为什么不加分？这是所谓的公平还是自我觉悟？其次，作为老师和同学沟通的桥梁，课助很容易就是里外不是人的东西。许多人在查老师上疯狂批课助制度，说课助怎样权力很大，怎样怎样控制平时分。但是我要说了，所有的制度都不是课助想的，是老师主观授意的，只不过没在大群里公开讲而已。课助为什么要背被骂的锅？给分不合理、有问题难道是课助的错？我只想说搞个似乎权可通天的课助出来就是给自己挡刀用的，一学期课助当的有多憋屈就不说了（每个班总有些先入为主对课助印象不好，对其各种工作很不友善的人）。最后，概括来讲，这个课基本学不到什么。马哲和政经时间分配很不合理，马哲是高中有接触过的，政经呢？考试一脸懵逼好不好。老师也是哲学出身重视马哲没问题，政经出那么难干什么。政经的内容基本学不到，还不如去上大类的政经。反正，上课体验真的不咋样。付出和收获不对等很正常。如好多评论讲的，与其锻炼自己，不如抱大佬大腿。那种一人得道 鸡犬升天的真的羡慕了（被队友拖累还要分给他们成绩也是够了）。
81636,2119,夏婉婉,2018-07-05 15:46:49,9,9,0,作为课助，认为课助不是一件人干的事情，事情巨多而且里外不讨好，还容易背骂名。最重要的是！课助并没有在平时分上有额外的加分，感觉很亏，不要被前面的热评误导，兴冲冲地选择去当课助……
81637,2119,夏婉婉,2018-07-05 15:49:16,7,7,0,认认真真打了辩论，提问过，回答问题过，论文成绩中等偏上，考前搁置微积分刷了马原选择题，看了大题，3.3
81642,2119,夏婉婉,2018-07-05 16:04:28,3,4,1,老师的课可听可水，事情可多可少，马原期末记得刷选择题
81658,2119,夏婉婉,2018-07-05 17:16:25,-3,2,5,给分好好啊！
81661,2119,夏婉婉,2018-07-05 18:16:57,13,14,1,"表示身为课助真的没有加分，付出了这么多真的感觉很不公平，平时会耗费很多心力，最终却又没有回报，考试周前还赶着我们帮她算同学的平时分，还在班上公开说找同学当课助而不是请研究生是为了省钱！？？？那我们付出了那么多精力为什么却毫无回报，课助直接满绩我觉得确实不公平，但毫无加分真的很不公平，难道真的是怕所谓的查老师上的评论吗，其他的思政课组长课助加分都是大家心照不宣的，为什么到了这里就变成我们""义务""浪费时间了？而且还卡绩，真的不想说什么了，感觉很不公平。当然作为授课老师，感觉讲的也确实没法让我听进去，而且部分理工科知识感觉讲的就是错的......诶，后悔当了课助，后悔选了这个老师，后悔浪费这么多时间，对了，组长也应该差不多，没有加分的...劝大家别选她，来自一个心累还被卡绩的课助"
81662,2119,夏婉婉,2018-07-05 20:07:46,4,4,0,讲真是没学到什么东西 也没当课助也不是组长 一直靠吃哲学问题和高中政治老本到现在 没有心理准备做一个学期辩论和很奇怪的 问与答环节 就还是别选了 事情真的贼多
81686,2119,夏婉婉,2018-07-06 01:47:24,5,7,2,这个老师的马原课让我真正明白了一个道理：付出，真的不一定有回报。辛苦了一学期，竟然换来这样一个绩点，真的心有不甘，先让我哭会儿......
81690,2119,夏婉婉,2018-07-06 02:11:11,3,4,1,课助没有加分，心疼楼上被正态的课助一波，求顶
81693,2119,夏婉婉,2018-07-06 02:19:54,3,4,1,课助没有加分，心疼楼上被正态的课助一波，求顶
81718,2119,夏婉婉,2018-07-06 03:15:56,3,3,0,事情多主要集中在课上，分为问答和辩论，其中辩论需要课后准备，但大多数是为了让大家参与进入课堂，相应的优惠很明显那就是提早下课。\n\n没上过别的老师马原课，给分这东西不好做对比，论文主要依据查重，期末考试选择题一定要好好复习，大题言之有理老师会给你拉很多，选择题各凭本事。\n\n上课挺有趣，基本上离开书本讲实际例子与人生阅历。\n\n课助从这届开始明确不加分，可能也是迫于压力，这是无法满足所有人的。平时分主要都着落在论文与发言。
81752,2119,夏婉婉,2018-07-07 15:03:16,-7,2,9,客观来讲，作为一门思政课，事情有点多，但是老师超级nice
82012,2119,夏婉婉,2018-07-07 00:11:49,0,0,0,做了小组长。上课事情很多。对于小组长来说压力很大，有什么课上问与答，还有辩论赛以及评论提问。想拿高分的必须积极参与吧。想水的就不要选了。如果认真对待的话，会有很大收获，不仅仅是学习方面。\n\n分组也很重要，可能有点不公平，和大神分在一组的人，不做什么平时分也比较高。\n\n但老师人还是很好的。也很有想法。收获颇多吧
82229,2119,夏婉婉,2018-07-07 13:50:27,0,3,3,虽然不是课助，但觉得课助确实得加点分吧，毕竟这门课的课助事情是真的多，让人家白干一学期不大好吧。那个出勤课助就少加点嘛。woc上课起来讲一些扯蛋的东西，真的有加分吗？？？
82294,2119,夏婉婉,2018-07-07 17:25:04,4,6,2,帮朋友跳出来说句话 朋友是某节课的课助 管出勤 平时和我抱怨 说自己的活看着最闲 实际上干起来最麻烦 特别容易得罪人 说用学号点名这种奇葩方式自己也没听过 还是老师说从“前人”那里流传下来的 不知道是不是真的 反正有毒 还说缺课几次的就直接平时分扣完 朋友怕被diss就只扣了一点点 还是能不扣就不扣的那种 这样还要被吐槽也是orz了......还有反对楼上说的课助加分但出勤课助少加点分 你见过有人让无偿劳动力在考试周帮她核分的吗 不瞒您说这就是出勤的人干的 室友要考试没空弄还让我帮着用函数对了对 也是迷醉 还有别的杂活之类的 这个课助机制如果这样奴役课助还是早点废了吧 麻烦老师请个助教谢谢 另外 我是另一节课既被正态又被卡绩的 手动再见老师 体验真的差 江湖不见
82312,2119,夏婉婉,2018-07-08 00:29:44,-1,1,2,老师人挺好的，上课没什么干货，这学期是问答和小组辩论，感觉比评价里的啥思维激荡轻松多了。小组大部分成员跟死了一样也是呵呵哒
82684,2119,夏婉婉,2018-07-09 03:09:29,3,4,1,老师估计期末卷子看都不看的，前一天考试后一天就出成绩了，还可别爱卡绩点
83823,2119,夏婉婉,2018-07-11 09:04:23,1,2,1,在讲阿里巴巴？
84279,2119,夏婉婉,2018-07-12 12:12:24,-4,1,5,好喜欢呀，给分超好
85710,2119,夏婉婉,2018-07-27 06:29:40,4,4,0,别选，上过才知道，事巨多，给分也差，认真干事分低，混的反而分好
87244,2119,夏婉婉,2018-09-26 05:23:08,10,10,0,不知所云，没有逻辑，全程自嗨，没有真才实学
87552,2119,夏婉婉,2018-10-04 14:06:41,-7,1,8,能学到很多东西，很开心
87681,2119,夏婉婉,2018-10-10 03:45:09,0,5,5,上课基本没听过，老师基本不会讲考试要考的知识，我没参加论辩，上课也不积极，论文分数刚上平均分，考试基本靠第六感，结果给了我4.2的绩点，本来以为要凉凉的，真是神奇，老师给成绩难道真的是抽签抽出来的吗。?
87690,2119,夏婉婉,2018-10-10 05:49:25,7,9,2,毫无内容，毫无内容！浙大缘何让如此水平之人任教？
87894,2119,夏婉婉,2018-10-17 05:33:20,9,9,0,10.17打卡\n\n上课到现在还没开始讲内容，自嗨中
88851,2119,夏婉婉,2018-11-10 03:59:51,3,4,1,第一次上课，最后听完老师讲完，各种事，还有奇葩的恶竞制度，拜拜，您自己上去吧，我退了
91602,2119,夏婉婉,2018-12-15 10:05:09,7,7,0,我有一个朋友..
92541,2119,夏婉婉,2019-01-02 10:06:37,5,5,0,每次课不是辩论就是小组讨论发言，我还能说啥
92890,2119,夏婉婉,2019-01-05 10:58:07,0,2,2,给分依据很迷，很认真结果3.6
93090,2119,夏婉婉,2019-01-07 09:02:49,3,5,2,讲课内容一点也不高端深入，每次课都有一节课要展示，完了平时成绩占比还调低，先让你努力，努力完了以后再让你的努力不值钱一点
94675,2119,夏婉婉,2019-01-19 15:18:46,25,25,0,成绩还没出来课程群就直接解散了
94814,2119,夏婉婉,2019-01-18 08:40:53,23,23,0,一考完就删群，逗我呢！
95707,2119,夏婉婉,2019-01-20 02:23:50,0,3,3,谢谢老师 呜呜呜\n\n很棒的老师
95747,2119,夏婉婉,2019-01-20 03:32:19,0,4,4,第一次写查老师评论。客观地说，夏老师的上课内容真的和书上一点关系都没有，虽然还挺有意思的，但是考试的时候要自己全部预习一本书压力很大。但是如果用心上马原课，从不功利的角度讲，参加课上的思维激荡和辩论赛是真的能收获到很多东西，私下和夏老师沟通论文她也会非常耐心地指导，还会推荐很多书目，是非常和善可亲的老师。如果你只是想水个学分，对哲学不感兴趣，千万慎选，因为会压的喘不过气来。
95763,2119,夏婉婉,2019-01-20 03:56:10,3,6,3,什么垃圾老师 上课讲的东西完全无关紧要 考试复习了不少最后给分也很迷 我可qnmdb
95768,2119,夏婉婉,2019-01-20 04:18:22,6,11,5,这分数真的绝了 我都怀疑改卷的是不是少看了一道大题 平时分中等水平 考试认真复习 加上高中政治积累 结果给我3.0 你NB
95788,2119,夏婉婉,2019-01-20 04:51:47,0,6,6,老师是好老师，上课主要都是哲学的内容，而且喜欢让同学思考哲学问题，教学内容很有意义，事情略微偏多，不过也还好。不过给分比较一般般。看中思政教育课绩点的人就不要选了，想学习一些哲学意识，绩点被马原3.6、3.9影响一下也关系的人强烈推荐。（拿了3.6还是有一点点小不开心
95791,2119,夏婉婉,2019-01-20 05:09:09,0,0,0,现在评论的是四上的同学吗…我还没查到分 好害怕
95811,2119,夏婉婉,2019-01-21 09:14:37,10,22,12,趁着还没出分，答一波。先说结论，8分。我觉得前面对夏老师的评价还是有失偏颇的。夏老师没有前人说的那么不堪，但是作为一个老师在处理事情方面还是有问题的。\n\n首先，说她事情太多，我并不那么赞同。夏老师没有课外阅读写作，不需要你读《政经批判》《gcd宣言》，课外写文章的事情比其他班少很多。即便课堂上是需要参与，思维激荡和辩论轮着来，但是试问大家，真正需要课下准备的是不是只有轮到一次的辩论赛？思维激荡课堂讨论随意发言，其他小组辩论赛时也只需要点评或者提问。到期末也就是读三五篇论文打个分而已，真的比你自己绞尽脑汁写晦涩的读后感难吗？\n\n当然夏老师有自己的问题。比如互评机制问题很大，互评出问题时老师的态度也是回避的，完全推给课助，不知道老师是怎么想的。面对质疑，也不正面回答。这是作为一个老师不应该的。\n\n至于上课我觉得中等上游水平，只听过隔壁金建伟的马原，夏老师算中规中矩。但是对你个人的想法她是很包容的，你去找她面对面(注意是面对面)商量，她会给你很好的建议，并且提出她自己的想法。这次满分论文里有唯心主义的文章就是一个很好的证明。
95887,2119,夏婉婉,2019-01-20 07:31:48,9,15,6,事情多，给分差，一言不发解散群
95889,2119,夏婉婉,2019-01-20 07:37:17,-8,3,11,给分好，期末刷了题库草草看了一次书，平时课上也挺水的，一次辩论赛一次思维激荡，最后的成绩真是很感恩了！其实事情真的不多，思维激荡辩论赛真的都几乎是课上的事情，老师分享生活经验比较多，身边同学也反映给分好，总之很感恩！
95895,2119,夏婉婉,2019-01-20 07:43:56,-2,6,8,人不坏，挺直率的老师。讲的没什么深度和逻辑是真的，文科生表示不如高中政治老师讲的有条理。事情说多但基本都是课上能完成的，课下没什么负担。我是组长，所以觉得还是有点烦吧，每节课都要和组里同学商量谁去展示、评分、最后还要分分数包…建议就是抱好大腿，别做组长/课助。给四个课助比个心叭，真的挺辛苦的。
95916,2119,夏婉婉,2019-01-20 08:18:13,20,23,3,和我一样不敢相信自己期末成绩的请赞我！！！
95972,2119,夏婉婉,2019-01-20 09:48:30,-8,6,14,这么说吧 平时总分70分 平时分顶尖的 只扣了两三分 论文满分了 然后84 我知道我考试没怎么看 基本上半裸考去的 考个五六十分很正常 但我就想问一句 你tm就一点都不调分的吗？？？
96002,2119,夏婉婉,2019-01-20 10:55:20,-17,0,17,课助直接满绩这个操作是真的骚。。。。我说怎么一开始群了报名一个个都那么积极。。算了不说了，葡萄太酸。。。夏老师上课还是很有意思的，不过对于考试似乎没什么帮助，还要靠自己背和理解，马哲思辨性强，理解了会套路了也就差不多。。。后面一些该背的东西确实是要背的，讲真期末看到劳动价值论基本观点瞬间觉得几天的马原书没白背。。。至于绩点，心中有党，成绩理想！！
96266,2119,夏婉婉,2019-01-20 15:38:34,11,11,0,破事多打分不合理给分差\n\n差差差
96397,2119,夏婉婉,2019-01-21 02:20:07,0,9,9,平时分扣5分也能满绩
96713,2119,夏婉婉,2019-01-21 09:39:15,5,5,0,分数低
96851,2119,夏婉婉,2019-01-21 10:47:18,-6,5,11,我是课助，但是我没满绩，OK？这都哪儿听来的说课助就一定满绩.../擦汗
96883,2119,夏婉婉,2019-01-23 16:08:52,-7,1,8,老师人很好，讲得很有趣，给分也好
96928,2119,夏婉婉,2019-01-21 12:36:56,9,10,1,还能说什么呢?马原她的课全是看心情给绩点吧。平时认真辩论，写论文，考试看了题库和把知识点全部背了一遍，但是获得的成绩真的不和付出的收获成正比，我室友和我上一样的课，他吊儿郎当的，和我一样……接受不了!
96931,2119,夏婉婉,2019-01-21 12:41:11,13,14,1,怎么说呢？！对成绩有疑问无奈老师早早把课程群解散了，我就去加了她qq也发了邮件给老师，28小时没消息呵呵
97571,2119,夏婉婉,2019-01-22 11:02:54,14,17,3,考完马原，第三天就出分了。全校最快。\n\n出完成绩立马解散群？老师联系方式也没有，呵呵，想查卷面成绩无处寻人。\n\n我们组马原最高3.3，呵呵。\n\n事情贼几把多。\n\n说实话，我不信任她。课助满分无疑，平时分课助决定，程序公开，但论文互评，期中猫腻就不知道了。\n\n这个出分这么快，我不信任。我马原刷题背题也刷了很多，我相信我们组卷面都不会低于别的老师班里4+的人的。怎么样，说到这里了，你们大概有个数了。大绩杀。老师人不错，但我对于她的给分很怀疑，很怀疑。这也许是助教的锅吧。
97715,2119,夏婉婉,2019-01-22 13:59:37,10,11,1,出成绩前一天，莫名其妙的解散班级群。卡绩不调，事多，平时分也不高，别选。
98479,2119,夏婉婉,2019-01-23 13:20:16,4,4,0,唉?
98769,2119,夏婉婉,2019-01-24 02:13:21,9,9,0,只能说浙大思政课学分太高了。。
98809,2119,夏婉婉,2019-01-24 03:10:57,-9,0,9,挺好的老师，非常希望改变制度，让每个人得到公平，当然不可能所有人都满
100469,2119,夏婉婉,2019-01-26 07:24:17,6,7,1,恶竞之源  毁人不倦
100471,2119,夏婉婉,2019-01-26 07:26:18,0,6,6,组长也十分配合把群解散了，连炫耀的机会都没有
102050,2119,夏婉婉,2019-01-30 08:21:14,7,7,0,什么鬼，小组里面每一个人上3.6
104234,2119,夏婉婉,2019-03-14 08:50:47,1,1,0,首先必须说一句，老师人挺好的。但是弄的制度真的很差，不是一般的差。课助干了活然后没啥好处，如果遇见不干活的课助，感觉就和遭了灾一样。辩论赛也不想说什么了，在下面的学生评委随便说话，然后不听辩论赛的学生胡乱投票，没啥公平也没啥趣味性。思维激荡我觉得算是一个比较好的地方了，能听到一些比较好玩的东西，可惜给的准备时间太少了，而且真的事情多。希望水水的人还是别选这门课了吧。愿意选这门课的人建议当组长，或者祈祷遇到一个好组长。平时分是组长分配的，但是组长，事多。上课挺枯燥的，念ppt比较多。言尽于此，愿各位能取得好成绩。
104473,2119,夏婉婉,2019-03-21 07:08:43,0,3,3,给后来人几个忠告：找个厉害的小组；做好选择题；稍微参与一下活动（当评委、准备辩论赛资料就行了）；论文不要太浪。有这些条件就可以满绩，亲测！
105696,2119,夏婉婉,2019-04-18 13:10:55,0,0,0,读书分享一定要参加一定要参加一定要参加
106087,2119,夏婉婉,2019-04-25 02:12:52,6,6,0,太差了
107779,2119,夏婉婉,2019-05-09 11:01:08,4,4,0,恶竞啊
107782,2119,夏婉婉,2019-05-09 13:04:24,-2,2,4,有点后悔，上课没有好好的听，但是，唯一听过的几节，就收获颇丰。至于水不水的问题，我只想说 没有哪一门课是用来水的，它有自己的价值，老师能认真的付出，我们为什么不一起努力和付出呢？
117975,2119,夏婉婉,2019-10-17 08:57:52,1,1,0,恶竞实在严重
2428,2174,卢旭东,2015-04-30 15:23:26,32,48,16,想水能水，不想水也很有意思。老师的口音也很有意思。
2544,2174,卢旭东,2015-05-04 13:46:33,1,7,6,上课内容听上去比较新颖，但是读书比较多的人听他讲的东西没什么意思的
4195,2174,卢旭东,2015-06-18 04:15:12,1,4,3,上课比较轻松，偶尔会抽人回答问题
5772,2174,卢旭东,2015-07-09 09:40:22,1,7,6,老师人很好，如果做了个人展示分应该不会太低（虽然我分还没出）。讲课内容也很有意思，有自己的看法。点名也是自己打勾签到，你们懂得。
18409,2174,卢旭东,2016-01-21 14:41:10,2,5,3,嗯……反正呃没听课……强烈推荐高永老师
26332,2174,卢旭东,2016-06-17 02:58:32,-5,2,7,没去过
28206,2174,卢旭东,2016-06-28 08:15:50,10,14,4,感觉是话都说不清楚的老师。。人比较随便。毛概课改革以后真是醉了。。
28984,2174,卢旭东,2016-06-29 05:08:35,0,3,3,老师很有趣！
29033,2174,卢旭东,2016-06-29 06:56:50,-1,4,5,老师人很好！
29046,2174,卢旭东,2016-06-29 07:29:17,0,2,2,还行吧
29567,2174,卢旭东,2019-02-27 00:29:29,23,33,10,老师平时分打分差距太大了吧。最高96最低76。其他班最低也85啊。手动白眼
29721,2174,卢旭东,2016-06-30 08:39:37,4,6,2,老师蛮好的，给分也不错
29894,2174,卢旭东,2016-06-30 13:17:36,9,11,2,老师人挺随意的，要求不是很高~反正毛概课老师别让人觉得很烦就行了，所以还可以吧~
33051,2174,卢旭东,2016-09-11 07:39:55,0,2,2,呵呵。
38383,2174,卢旭东,2016-12-01 13:31:07,2,10,8,上展示课在旁边玩手机打哈欠。完全没有老师的样子。上课假大空，辣鸡
40477,2174,卢旭东,2017-06-21 00:48:58,16,25,9,毛概平时分真心不好，我们班很多小组81左右，别的班平均小组都有88这样子，吐血。
45439,2174,卢旭东,2017-01-24 11:04:56,3,6,3,给分好
47506,2174,卢旭东,2017-01-28 12:19:34,5,10,5,卢老师是个很有趣的老师，可能平时分给的相对于其他班稍微低了些，但是最后会给大家提分数的。总之，选他的课是不错的。
49254,2174,卢旭东,2018-06-29 01:22:24,0,8,8,有同学想举报他你知道吗（手动微笑）
50630,2174,卢旭东,2017-05-04 02:42:01,0,8,8,千万别来，千万别！(>﹏<)
52534,2174,卢旭东,2017-07-02 02:20:40,8,16,8,拉我绩点 无话可说
52584,2174,卢旭东,2017-06-21 07:50:01,4,7,3,给分真的看小组努力啦，付出了才会有收获
55223,2174,卢旭东,2017-07-01 04:25:11,6,7,1,老师最后给分还可以，需要小组一起努力才好，然后考试也要尽力去做，可能才会有比较大的收获
55225,2174,卢旭东,2017-07-01 04:33:47,7,9,2,选他，你很大的可能性是3.3-3.9之间。。自己斟酌
55267,2174,卢旭东,2017-07-01 07:03:41,4,6,2,小组分数高的话成绩还是会很理想的。找个靠谱的组。
55451,2174,卢旭东,2017-07-01 13:41:46,9,11,2,平时分太低了
57738,2174,卢旭东,2017-07-13 08:42:34,3,4,1,老师私下人不错的。
69385,2174,卢旭东,2018-01-24 14:49:55,4,4,0,平时小组认真抢答，认真完成两次展示，认真完成报告，认真考试，总分不会低的
69395,2174,卢旭东,2018-01-24 15:02:40,0,3,3,楼下说的不错，你很可能就是3.3-3.9徘徊
69416,2174,卢旭东,2018-01-25 06:42:36,5,6,1,啦啦啦
80554,2174,卢旭东,2018-07-09 05:42:35,13,15,2,小组评均分80的情况下 上4了？？？老师调分了 超级感谢
80562,2174,卢旭东,2018-06-28 02:44:13,5,6,1,好好好
81311,2174,卢旭东,2018-07-04 15:37:22,13,14,1,评论很多说要小组努力的我同意，但是碰到好组长的概率要自己斟酌，组长要是不负责，拿一个小组最高分可能也没有别人最低高
82040,2174,卢旭东,2018-07-07 02:33:05,6,6,0,组长负责，整组好
82753,2174,卢旭东,2018-07-09 05:17:56,5,6,1,嘻嘻，喜欢，就像政客一样的老师，给分好。
82767,2174,卢旭东,2018-07-09 05:39:52,0,3,3,最后一门思政课，却是第一次为了思政课考试复习，成绩果然比想象中的好。毛概我觉得考试背原话也没啥大用处，就大小题目记住，知道答题套在哪个内容里面就好了，复习俩小时，卷面80，满足了
82801,2174,卢旭东,2018-07-09 07:01:13,6,10,4,老师人挺好的，课都去认真听认真复习小组作业认真弄最后4.8?小组真的很重要了，老师会在早课点名
82893,2174,卢旭东,2018-07-09 09:22:08,1,1,0,本来以为卷子写的狗屁不通会死的很惨，结果还有80分，老开心了
82896,2174,卢旭东,2018-07-09 09:25:34,1,6,5,平时分真的给太低了 慎选
82899,2174,卢旭东,2018-07-09 09:31:46,5,6,1,给分很棒！只要平时分高，分数一定不错的！组队要抱紧大佬，多发言，多提问！事情很少的，就2个小组展示，期末小组调查报告，很优秀！
82955,2174,卢旭东,2018-07-09 10:58:53,5,5,0,组长人好，考前看十九大报告，万事大吉
82975,2174,卢旭东,2018-07-09 11:39:48,2,5,3,慎选 抢不到发言你们组平时分就是七十多
82990,2174,卢旭东,2018-07-09 12:12:18,3,4,1,小组平均分76 大概是全班最低了叭 然后最后上4了 留下了感激的泪水 我爱老师❤️
85156,2174,卢旭东,2018-07-16 00:32:40,2,3,1,说实话，在毛概课的老师里算可以的了。认真作平时的事情，考前复习一下，成绩不差
87319,2174,卢旭东,2018-09-27 05:21:24,1,1,0,?️????
88542,2174,卢旭东,2018-11-01 04:15:41,0,0,0,垃圾！
91767,2174,卢旭东,2018-12-19 15:17:30,-1,0,1,太好了
93588,2174,卢旭东,2019-01-10 16:08:07,2,2,0,平时分给的毫无逻辑可言
93589,2174,卢旭东,2019-01-10 16:08:30,1,1,0,给分还能更差点?
97441,2174,卢旭东,2019-01-22 09:01:07,3,4,1,别的毛概老师不清楚，卢老师反正符合我心目中思政课老师应有的特点：事情不多，偶尔点名，分数靠自己鹅颈拿。平时分的话要找一个靠谱的小组和组长，然后上课厚着脸皮多发言；考试按着老师画的重点稍微背背，上4问题不大。
98791,2174,卢旭东,2019-01-27 08:05:44,0,1,1,还行吧
98918,2174,卢旭东,2019-01-24 05:12:02,-8,1,9,上面的扯淡，我们小组平时分就有92，还知道有一组94的，一共12个组你咋知道的那么清楚呢？
103530,2174,卢旭东,2019-03-01 02:10:47,0,0,0,好老师！事少声音小不bb
104408,2174,卢旭东,2019-03-20 02:09:25,-3,0,3,事儿妈，不让玩手机用电脑，还站你旁边讲课，烦
109982,2174,卢旭东,2019-06-21 02:32:35,3,4,1,考前评价 就 听这课吧 说不出的难受\n\n说话语气很奇怪 一天到晚乱扯
109990,2174,卢旭东,2019-06-21 03:16:14,0,0,0,(⁎⁍̴̛ᴗ⁍̴̛⁎)
111127,2174,卢旭东,2019-06-30 03:38:45,1,4,3,老师有权因为学生考试没写序号而扣分吗？？
113061,2174,卢旭东,2019-07-05 22:09:04,0,2,2,垃圾，因为没写序号被正态了
113277,2174,卢旭东,2019-07-06 03:33:58,0,1,1,哈哈哈
117267,2174,卢旭东,2019-09-22 01:53:54,-3,2,5,简直乱来
126513,2174,卢旭东,2020-09-29 03:50:46,0,1,1,专题课钦点发言
128136,2174,卢旭东,2020-12-08 05:01:37,0,1,1,没有好感
131552,2174,卢旭东,2021-01-28 03:45:28,5,5,0,给分极差，平时分比其他老师低一大截\n\n慎选，慎选
135770,2174,卢旭东,2021-05-25 01:37:44,1,1,0,叽里咕噜不知道在说啥
136903,2174,卢旭东,2021-06-28 02:47:38,3,3,0,吃了时代的福利
138203,2174,卢旭东,2021-07-08 02:13:56,3,3,0,习概 不好 sad
138283,2174,卢旭东,2021-07-08 10:24:53,1,1,0,毛概点过几次名，平常比较水，期末稍微背了下4.5，想水课的朋友还是可以选的～
138482,2174,卢旭东,2021-07-09 12:40:41,2,2,0,老卢真的是很佛的一个老师，对于一些课程的既定要求标准很低的！
146750,2174,卢旭东,2022-01-07 10:19:38,0,0,0,评分比别的老师班低10分，这个班最高89，别的班最低93，不知道会不会调分，如果调了的话我再回来改评价。
149049,2174,卢旭东,2022-01-14 08:10:31,-1,0,1,给分不好
151633,2174,卢旭东,2022-03-10 03:26:54,1,1,0,口齿、思路不清
152151,2174,卢旭东,2022-03-29 02:18:22,0,1,1,不仅讲得烂，而且讲话经常发出刺耳的假声。史实错误张口就来，随便拉个中老年人可能都比这强.....
156536,2174,卢旭东,2022-06-20 08:01:23,2,2,0,大爱卢老师！！事少给分高，相比其他班的毛概已经非常不卷了，认真完成平时任务积极发言，最后成绩也很满意～
156708,2174,卢旭东,2022-06-20 17:04:16,-5,0,5,给我震惊了 \n\n一学期没去上过课，两次签到都无，平时分也很一般，期末实打实也就复习了三天，还能拿4.8？？\n\n爱你哟旭东gege~
161786,2174,卢旭东,2022-11-13 09:50:24,1,1,0,果断10分！！\n\n首先在教学方面，卢老师讲课内容其实很有自己的想法，即使年龄比较大，也一直在努力与同学们亲近，也会考虑大家忙碌的课业情况，尽力给同学们减负；\n\n在给分方面，虽然平时分相较于其他教学班会略低一点，但最后老师都会调分，只要认真准备，好成绩很容易得到。
7915,2263,卢军霞,2015-09-16 06:04:46,3,6,3,炒鸡棒\n\n
13558,2263,卢军霞,2015-12-29 07:35:55,2,6,4,一般般，她是跟马建青一起叫我们思修，比马建青教的好。但是课堂过于死板，讨论也流于形式
16030,2263,卢军霞,2016-01-17 04:53:10,0,2,2,和马建青一起上思修，给分没有良心，差评!
16408,2263,卢军霞,2016-01-18 05:04:41,2,5,3,回答问题有加分 人不错
19305,2263,卢军霞,2016-01-24 00:36:08,3,5,2,人不错，回答问题有加分，比马建青负责，似乎没什么教学经验。
22235,2263,卢军霞,2016-03-03 05:03:59,2,3,1,人很好 有加分所以愿意回答问题
25303,2263,卢军霞,2016-05-13 06:34:48,-2,1,3,回答问题有加分\n\n
112297,2263,卢军霞,2019-07-04 01:05:07,1,3,2,老师气质好好啊
126978,2263,卢军霞,2020-11-01 11:02:24,9,11,2,愣是把单周上课改成了双周上课，星期日晚上害的一大帮同学等了半天
138872,2263,卢军霞,2021-07-11 12:01:02,3,3,0,给分可能中规中矩吧……但是事情是真的很少！！！两学期只有一次小组的时事分享和一点寒假作业！！每周不用写作文上课也可以摸！
156902,2263,卢军霞,2022-06-21 10:11:10,1,3,2,拖课半小时起步给分一般
156954,2263,卢军霞,2022-06-21 12:14:40,0,1,1,卢老师yyds~
156955,2263,卢军霞,2022-06-21 12:14:52,-1,0,1,事情特别少，给分中规中矩。（连浙大精神都没写出来的人hh有3.9）两个学期总共只有一次点名与一次作业和一次小组展示～
176340,2263,卢军霞,2023-06-28 12:43:58,4,4,0,给分真的好低啊，我都不知道为什么会这样。复习了很久而且差不多都背出来了才3分。
192675,2263,卢军霞,2024-05-27 13:28:04,1,1,0,老师不好
194843,2263,卢军霞,2024-06-25 16:59:45,2,2,0,不知道给分标准是什么，每次上课都坐前排，调研报告写得很认真，考试内容也都背了，不理解为什么分会这么低，好像还被卡绩了，真的真的搞不懂，太难过了，真的很想哭
194965,2263,卢军霞,2024-06-26 05:42:16,1,1,0,给分乱给，分数巨低，很差
195018,2263,卢军霞,2024-06-26 10:20:43,1,1,0,给分极差，而且评分规则令人摸不着头脑
195108,2263,卢军霞,2024-06-26 23:38:30,0,0,0,给分真的好烂啊啊啊啊
195881,2263,卢军霞,2024-06-30 13:55:57,0,0,0,给分真的玄学……
2040,2476,代玉启,2015-03-30 06:46:21,2,10,8,一视同仁
2561,2476,代玉启,2015-05-04 14:12:27,17,32,15,平常很水给分很差，完全不知道为什么
7449,2476,代玉启,2015-09-14 12:09:30,-3,1,4,还行啊
7506,2476,代玉启,2015-09-15 01:05:12,-3,2,5,讲课很有趣
7525,2476,代玉启,2015-09-15 02:02:09,1,3,2,一般
7546,2476,代玉启,2015-09-15 03:13:06,-4,3,7,挺有趣的，感觉不错
7604,2476,代玉启,2015-09-15 06:25:36,-6,2,8,很好！很关心学生！
7957,2476,代玉启,2015-09-16 08:33:50,30,42,12,平时很水给分很差！太坑了！
8342,2476,代玉启,2015-09-18 15:05:13,-6,1,7,很少点名
8769,2476,代玉启,2015-09-26 01:45:30,1,4,3,点名少
8886,2476,代玉启,2015-09-29 11:32:52,-5,3,8,上课有趣
10873,2476,代玉启,2015-11-23 07:58:55,-6,1,7,很好呀
11016,2476,代玉启,2015-11-24 00:51:36,-7,2,9,很认真，讲的好
12306,2476,代玉启,2015-12-23 02:23:00,7,12,5,老师，你上课真的在讲课嘛？
12309,2476,代玉启,2015-12-23 02:28:05,14,21,7,老师敢不敢走点心
12337,2476,代玉启,2015-12-23 03:56:57,3,5,2,敢不敢再凶一点
12448,2476,代玉启,2015-12-23 09:53:12,13,18,5,烂的一逼
14324,2476,代玉启,2016-01-06 08:42:21,15,18,3,不怎么样
14387,2476,代玉启,2016-01-06 17:00:00,2,26,24,老师很幽默，主要把课堂交给学生，没点过名，见识很广。有一点就是玩手机的问题，他会来回走动，看到玩手机的同学会提醒你，但很多时候沉迷手机世界中的我会被吓一大跳！
15394,2476,代玉启,2016-01-14 08:08:10,1,3,2,123
17159,2476,代玉启,2016-01-19 17:26:57,-5,2,7,其实还是不错的，仔细听能学到道理。
18552,2476,代玉启,2016-01-22 05:07:21,4,8,4,上课还是比较水的啦，而且不准玩手机，上课轻松
18554,2476,代玉启,2016-01-22 04:10:05,8,13,5,课超级水 给分超级坑 基本没讲过东西 真是醉了
18555,2476,代玉启,2016-01-22 04:13:27,-3,3,6,老师很有趣噢
18582,2476,代玉启,2016-01-22 05:26:35,8,15,7,给分并不好（手动再见）
18591,2476,代玉启,2016-01-22 05:49:55,14,18,4,真不知道给分怎么给的。。
18630,2476,代玉启,2016-01-22 07:14:29,3,9,6,课上的挺好但是。。绩杀啊T T两眼都是泪
18632,2476,代玉启,2016-01-22 07:20:44,3,7,4,给分就是个坑
18661,2476,代玉启,2016-01-22 08:45:00,3,5,2,呵呵了
18676,2476,代玉启,2016-01-22 09:17:43,-2,5,7,老师人很好很负责 小组展示前会要求我们交ppt给他审核 然后提出一些意见 自己讲课也很有趣 上课气氛很好 给分只要你有付出得到的就是应有的分数
18683,2476,代玉启,2016-01-22 09:46:17,7,11,4,他是绩杀！不要选他！
18721,2476,代玉启,2016-01-22 12:00:39,4,10,6,绩点低得无缘无故
18898,2476,代玉启,2016-01-22 17:07:27,-5,5,10,给分高
18932,2476,代玉启,2016-01-22 23:33:42,6,10,4,整个学期下来除了小组展示，还是小组展示……给分一般。
19331,2476,代玉启,2016-01-24 01:56:32,2,3,1,呵呵呵
19464,2476,代玉启,2016-01-24 09:39:22,3,4,1,看人品
19557,2476,代玉启,2016-01-24 16:29:25,-1,4,5,喜欢查手机查睡觉 但不会阻止你写作业 给分超级好！
19778,2476,代玉启,2016-01-25 09:07:09,2,5,3,老师给人很亲切的感觉，不过最好加上组长评分表，要不然有点水，不过自己最后绩点还是很棒的
20215,2476,代玉启,2016-01-26 14:23:39,1,3,2,因为SQTP的原因和老师深入交流过，是一个对学生一视同仁的人，想想如何平时做得更好来拿高分吧
20270,2476,代玉启,2016-01-27 00:40:38,2,3,1,人还好，基本不上课，都是学生展示。但是上课虽然可以看其他的书做其他作业，就是不能玩手机。给分，没看到，不算太差
20487,2476,代玉启,2016-01-28 00:20:41,5,9,4,真心很坑，千万不要选他的课
20583,2476,代玉启,2016-01-28 15:14:48,-1,2,3,1.小组展示\n\n2.给分尚可
21050,2476,代玉启,2016-02-13 13:48:05,1,3,2,水水的
21750,2476,代玉启,2016-03-01 03:16:56,-1,1,2,老师很萌，讲得很好啊，给分也不错
26571,2476,代玉启,2016-06-20 07:00:29,6,13,7,老师给分还不错啊我们小组除了一个其他都上4了 上课会查手机 要做PPT 但是平时人很好超可爱 发邮件回复也很及时
63579,2476,代玉启,2017-12-07 07:56:58,1,2,1,呕 ...
64494,2476,代玉启,2017-12-24 14:06:49,1,3,2,还不错的
69710,2476,代玉启,2018-01-25 08:51:39,2,5,3,平时很水，志愿者活动好好做就行了
69724,2476,代玉启,2018-01-25 09:20:04,2,16,14,志愿者好好做，报告好好写，课虽然水但一定要来，这是最起码的尊重。老师给分真的太好了，给老师打call！楼上那些说老师给分不好的想想你们平时都在干些什么，叫你们做志愿者写报告都是水水的心态。以水水的形态绩点会好那还有天理吗？不让你们挂就不错了。老师的给分绝对与你自己的付出成正比！！学习认真的同学力荐。
69738,2476,代玉启,2018-01-25 09:45:19,3,4,1,事情少，风趣幽默，不点名，分不错~
69753,2476,代玉启,2018-01-25 10:22:21,1,10,9,没出分前我很虚，出了分，除了男神还有什么说的？！所有课最高绩点，太感谢老师了～
69785,2476,代玉启,2018-01-30 06:33:28,9,11,2,给分很差 不知道怎么给的！
69820,2476,代玉启,2018-01-25 12:52:18,5,8,3,不用考试，绩点靠队友
69967,2476,代玉启,2018-01-26 00:56:32,1,1,0,全靠我的队友带
70249,2476,代玉启,2018-01-26 09:49:46,2,3,1,给分迷，上课抓你玩手机。
72345,2476,代玉启,2018-01-30 02:36:29,6,10,4,今年教学改革，没有期末考试，有什么事情都和学生商量，最后给分也不错
72985,2476,代玉启,2018-01-31 13:24:26,4,7,3,作为课代表只有这点分数挺无语.......以为课代表分数至少高很多吧
73905,2476,代玉启,2018-02-18 03:36:26,-2,0,2,很不错
74530,2476,代玉启,2018-03-28 10:13:19,12,17,5,没有期末考试，没有上课发言记录，没有小组展示打分，老师所有打分的依据就是期末一份所谓的志愿者活动报告。请问这位老师一份志愿报告能够体现一位学生多少的素质修养，从这些堆砌起来的文字里，你能够看出他多少背后的付出，你是否能够判断他是虚情假意还是全新投入，你是否有勇气仅仅凭着这样一份报告就给一位学生一学期的努力付出打下分数盖棺定论，你是否能够给所有的学生一个答复，告诉他们你的评价依据是什么。在你的眼中思想品德修养这门课就是这么随随便便的一门课吗？一学期的课程下来才明白思修课上学生的心不在焉完完全全是由你这样一位毫无责任心的老师所导致的必然结果，因为大家都清楚最终大家的成绩只是那份志愿报告中的文字游戏而已，或者说，只是老师的心情而已。一门没有任何制度，没有任何原则的课程，只剩下躯壳下垃圾而已
75297,2476,代玉启,2018-03-08 23:40:26,-1,2,3,老师给分还好啊\n\n
76302,2476,代玉启,2018-04-02 09:05:39,0,0,0,害怕。
81838,2476,代玉启,2018-07-06 09:40:42,-4,2,6,给个中规中矩的分，因为我一节思修课没听过……_(:з」∠)_所以取消期末考试挺好的，但是根据志愿报告来评分就不太科学了吧……我连夜编了一个5000+的志愿报告最后给了我4.2，是不是字数少一点绩点就要低了？不是很懂这个操作
87934,2476,代玉启,2018-10-18 03:28:31,4,4,0,上课都在睡觉
94266,2476,代玉启,2019-01-22 07:55:58,9,12,3,垃圾老师，不要选他，听话，别选
94668,2476,代玉启,2019-01-17 15:52:27,-7,1,8,还行吧
97260,2476,代玉启,2019-01-22 07:31:39,2,5,3,老师说话有时还挺幽默的，就是给分迷得一批
97262,2476,代玉启,2019-01-22 07:32:51,17,20,3,辣鸡老师，组长什么事情都做了，结果最后被正态？我学你? 呢
97269,2476,代玉启,2019-01-22 07:35:11,-8,4,12,事情比较少。读书报告加志愿报告加小组展示。期末考好好考，会有高绩点的。貌似…已经不是绩杀了？？？
97278,2476,代玉启,2019-01-22 07:43:04,16,19,3,每节课都到，组内工作做的也最多，还是组长，绩点低的要死，还没次次翘课不怎么工作的组员高。。。无语=_=
97291,2476,代玉启,2019-01-22 07:53:10,-5,3,8,千万不要在课上玩手机!认真完成研究性学习和志愿者作业，最后分不会低的
97303,2476,代玉启,2019-01-22 08:15:19,15,18,3,我后悔没有听学长学姐的话，没有退掉他的课，3.3啊啊啊啊啊啊啊啊啊啊啊
97306,2476,代玉启,2019-01-22 07:58:27,-11,2,13,课上的挺无聊的，但给分其实还可以。
97352,2476,代玉启,2019-01-22 08:20:12,9,10,1,一个字:呸
97390,2476,代玉启,2019-01-22 08:32:31,9,10,1,真的垃圾，呕
97428,2476,代玉启,2019-01-22 08:52:07,11,13,2,听课很认真，给分却很坑。
97570,2476,代玉启,2019-01-22 11:19:41,12,15,3,给分迷，认真的人回报没看见。
97852,2476,代玉启,2019-01-23 00:10:31,8,10,2,给分坑
97913,2476,代玉启,2019-01-23 01:39:47,-9,3,12,老实人很幽默，上课讲的也挺好，只是后来没怎么听，但给分也还可以吧，比我想的要高一些，说是绩杀的话，可能有一点吧，但你认真完成每项作业和考试，怎样都不会差。
99173,2476,代玉启,2019-01-24 11:09:05,3,4,1,总比ymm好吧，我知足了，虽然给分迷
101962,2476,代玉启,2019-01-30 01:26:16,2,4,2,很努力想得到学生们的喜爱吧，但评价标准比较主观，不知道老师能不能够区分认真努力和精致利己。
102064,2476,代玉启,2019-01-30 08:46:46,-2,1,3,期末绩点似乎比较多看小时数？...逃~
102560,2476,代玉启,2019-02-08 09:20:04,-5,3,8,老师还是蛮好的，很有幽默感，但感觉有的给分不太好，整个还是蛮好的，只要认真完成了报告调查的，考试稍微准备一下就成，我了解到好些孩子4.5还是不错的。
115318,2476,代玉启,2019-07-18 12:00:18,4,5,1,瞎打分。
121773,2476,代玉启,2020-01-21 23:41:10,3,6,3,辣鸡！超级水，毕竟思修也就是又红又专的东西，自己觉悟就行了。给分超级差，没话讲了，每项任务都认真做了，最后成为绩点最低的一门？？我高中政治是白选的吗？？辣鸡，平时上课人看着挺好，给分真是背后捅一刀…
121778,2476,代玉启,2020-01-22 01:04:46,2,3,1,给分巨坑。读书报告，小组展示，志愿者报告，每项任务都认真完成了，给分这么低，不知道怎么搞得，我吐了。
121876,2476,代玉启,2020-01-23 05:07:31,-3,0,3,给分巨坑，直接均绩下拉0.1心都在滴血。。小组组长+志愿服务读书报告研究性学习每样都上心认真做+期末考前复习了考试感觉还挺顺=3.9？？我真的不知道我做错了啥要给我这么低的绩点 我服了 果然是绩杀
123811,2476,代玉启,2020-06-14 12:23:56,2,3,1,思修 绩杀！我们组的展示是肉眼可见的好（相比于别的组我们时间刚刚好，内容也不枯燥，老师频频点头）。个人在考前看了一下题库和书，在考试的时候拿出高中做政治的套路（先书中概念，再加材料）分点写得满满当当。最后只有3.3？？给老师发了好几个邮件，他也只是含糊其辞…无语…
132498,2476,代玉启,2021-02-02 03:41:50,2,2,0,辣鸡老师，什么都干了只给3.9？传统美德
132503,2476,代玉启,2021-02-02 04:20:35,3,3,0,lj老师，真的绩杀，大家快逃
132508,2476,代玉启,2021-02-02 04:34:35,3,3,0,绩杀 垃圾
132511,2476,代玉启,2021-02-02 05:10:18,2,2,0,绩杀 嘻嘻
132997,2476,代玉启,2021-02-06 04:24:54,2,2,0,100多人的课出成绩只有十几个谢谢老师
133091,2476,代玉启,2021-02-08 02:57:24,0,0,0,老师讲的还是不错的，虽然有些人说绩点不高，但是老师还是尽力给分了
133199,2476,代玉启,2021-02-16 12:41:25,3,3,0,绩杀
133517,2476,代玉启,2021-03-01 12:46:34,1,1,0,认真听课作报告，分不及水课人高
148070,2476,代玉启,2022-01-12 03:06:25,5,5,0,刚出分了  挺好的  查老师不能尽信
148162,2476,代玉启,2022-01-11 17:10:26,1,2,1,老师讲课真的非常非常好 真的是出生以来听过讲思政课最好的老师了 听课从来没低过头 刚刚出分 分数也不错！
148458,2476,代玉启,2022-01-12 14:09:28,1,1,0,我觉得老师给分真的挺好的，读书笔记什么的都认认真真地做了，最也得到了理想的绩点，我并不是小组长，而且思修绩点竟然是我目前最高的绩点，查老师真的有时候不可信啊
161371,2476,代玉启,2022-11-05 08:57:48,0,0,0,没内容，要求还高
167927,2476,代玉启,2023-01-20 10:22:53,0,1,1,傻逼一个
171384,2476,代玉启,2023-03-23 04:09:47,0,0,0,和蔼友善的好老师！
191152,2476,代玉启,2024-04-09 05:34:51,1,1,0,助教给分迷幻，莫名其妙，非常形式主义
208479,2476,代玉启,2024-12-28 07:43:36,0,1,1,助教傻逼，特别形式主义，事巨多，还是个PUA高手。
170,2761,章清祥,2018-09-16 11:44:44,4,109,105,传说中的绩杀，但突然变成了给分超好的老师。认识的同学基本都在4以上。课堂收获还是有的，尤其是现场提问
618,2761,章清祥,2015-03-15 07:26:59,1,51,50,讲课绝对没的说，律师出身，有案例有分析。而且现在给分相当好，只要你不混，上4没问题！
811,2761,章清祥,2015-03-17 10:58:32,-15,8,23,虽然我自己分数不高，但是他讲的让我很有收获，而且，我们组里面分数高的还是不少的
1505,2761,章清祥,2015-03-22 08:45:31,32,43,11,楼上的怎么都说给分高？两年前我们小组就两个人过了，班长只有3.4....
1768,2761,章清祥,2015-03-24 07:25:59,22,37,15,认真完成了这么多作业竟然只给75没见过这么变态的老师
2037,2761,章清祥,2015-03-30 02:35:05,-4,21,25,今年突然转性，给分超好。讲课也确实有趣、有案例分析
2605,2761,章清祥,2015-05-04 16:41:28,2,12,10,不想吐槽他，可能之前给人骂多了，今年才会变性吧
3437,2761,章清祥,2015-06-12 10:47:22,-13,7,20,去年给分超级好，讲课也很有意思
3918,2761,章清祥,2015-06-17 08:27:56,-4,28,32,老师个人能力很强 听他讲课也蛮有收获 上课不点名 但估计也没几个人敢翘。至于给分 这一次突然转性了 绩杀到给分小能手的华丽转身～
3937,2761,章清祥,2015-06-17 10:27:28,-7,17,24,老师挺好的，不是绩杀，严格的论文要求也使得我在几门通识课的论文写作中收益不小，讲课也蛮有意思的，人很热情。
4469,2761,章清祥,2015-07-05 16:36:26,0,10,10,听不懂
4834,2761,章清祥,2015-06-29 11:57:16,16,31,15,马上大三了，今天看到这个评价系统，我立刻想到给这个老师的思修评分…你们感受一下吧。
5091,2761,章清祥,2015-07-03 17:50:59,20,55,35,据说是他之前一直以为75跟85没区别所以给分充满了任性…去年某同学说他给分低点醒他后性情大变… 只想说为这位同学的勇气点赞
7154,2761,章清祥,2015-09-08 15:57:30,-10,5,15,享受
7344,2761,章清祥,2015-09-14 01:59:31,38,45,7,当年全班最高84。。。全班过80的目测不超过10个。。。你们感受下。。
7400,2761,章清祥,2015-11-23 03:38:37,0,10,10,严肃的课
7548,2761,章清祥,2015-11-22 08:57:58,7,21,14,作业很烦，也很多，虽说有时上课蛮轻松的，但觉得没有重点。
7752,2761,章清祥,2015-09-15 12:05:53,-9,8,17,有干货
7766,2761,章清祥,2015-09-15 13:03:09,9,14,5,理科僧慎入，作业报表
7867,2761,章清祥,2015-09-16 00:52:59,-2,18,20,还不错啦，喜欢给学生分组？
8301,2761,章清祥,2015-09-18 04:54:09,27,33,6,好多破事，写论文规定标点
8715,2761,章清祥,2015-09-24 09:25:28,-5,8,13,课堂生动\n\n
9020,2761,章清祥,2015-10-09 23:45:03,103,118,15,作业蛮多
9301,2761,章清祥,2015-10-20 14:11:40,-7,6,13,当时有同学被他挂了，后来听说性情大变，给分很好了
11247,2761,章清祥,2018-01-17 13:44:18,206,254,48,骂学生认真完成的作业是垃圾\n\n
11284,2761,章清祥,2015-11-26 08:51:03,96,118,22,直接骂同学是垃圾也是不能忍了，手动微笑\n\n\n\n
11828,2761,章清祥,2015-12-16 13:16:00,0,5,5,没感觉
12976,2761,章清祥,2015-12-24 12:18:40,-13,21,34,世界上最好的课，没有之一\n\n
13456,2761,章清祥,2015-12-28 06:21:56,1,38,37,不知道楼上都什么心态，zqx课干货多得飞起好吗？自己不学谁教都一样，难道只有可以随便翘课的老师才好？那你为什么来浙大呢？？？
13530,2761,章清祥,2015-12-29 03:19:56,-7,9,16,真正学到了东西，有感悟，好老师！
13824,2761,章清祥,2015-12-31 15:05:14,9,13,4,呵呵呵
14054,2761,章清祥,2016-01-04 03:35:24,-7,19,26,上课超有意思，作业其实也没想像的多，有收获，情操高雅，他经常和他的朋友谈人生然后就跟我们讲。人挺好的。想混混得分走人的就算了吧。比起其他老师真是把思修上出了彩
14103,2761,章清祥,2016-01-04 09:01:46,-7,8,15,路上遇到你会和你打招呼，喜欢足球，讲课激情澎湃，让人惊喜的老师。
14236,2761,章清祥,2016-01-05 14:04:11,-7,6,13,讲课超有激情，听他的课可以学到很多社会上的东西。最喜欢的课，没有之一。
14577,2761,章清祥,2016-01-08 00:03:44,-1,26,27,虽然要求很严格但实际上收获很大，上过老师的课其他课的论文再也不用慌了。同学说思修都是用来刷作业水手机的，但是老师把思修上出了不同的感觉。
15842,2761,章清祥,2016-01-30 01:07:57,-9,5,14,nice
16391,2761,章清祥,2016-01-18 04:40:00,-7,8,15,为我章老师刷一发\n\n实力在寝室里秀我的思修老师有多好\n\n还会散布迷之笑容\n\n还是有想法的有意思啊\n\nps还在我们的帮助下学会了上哔哩哔哩\n\n这一点我给满分
17338,2761,章清祥,2016-01-20 04:59:52,-7,4,11,老师讲课还是蛮好的 有很多案例 希望能有个好绩点2333
17596,2761,章清祥,2016-01-20 12:53:00,-7,9,16,律师出身的老师，讲课很好，没问题。
18678,2761,章清祥,2016-01-22 09:24:58,-7,6,13,有案例分析，有课堂讨论，不错
19662,2761,章清祥,2016-01-25 07:29:55,10,17,7,绩杀不解释
19688,2761,章清祥,2016-01-25 05:43:33,8,13,5,不爽分数超低 我也好好完成作业了给分不公开公正\n\n
19706,2761,章清祥,2016-01-25 06:32:42,-14,6,20,不水，事情有点多，虽然不点名但最后会让小组长统计。虽然不认同部分观点，但是比起其他思修课算可以了。最后，满绩出乎意料，虽然本人不水，但是还是觉得给分好棒！
19716,2761,章清祥,2016-02-06 03:28:49,7,16,9,渣比老师不解释
19728,2761,章清祥,2016-01-25 07:36:35,-14,4,18,老师能力很好  给分挺好
19730,2761,章清祥,2016-01-25 07:37:48,11,18,7,績杀...績杀
19732,2761,章清祥,2016-01-25 07:47:55,9,16,7,……绩杀
19740,2761,章清祥,2016-01-25 08:07:42,11,17,6,认真完成了读书报告也只有3.3的呵呵了
19751,2761,章清祥,2016-01-25 08:34:08,-7,6,13,律师出身 讲课激情 干货满满 小组讨论比较多
19759,2761,章清祥,2016-01-25 08:50:11,-7,5,12,不背书就考试还想要很高的分那就真的不能怪老师是绩杀
19792,2761,章清祥,2016-01-25 09:23:21,-7,6,13,讲课真的真的很不错，很有启发性，只要不水总是好的
19813,2761,章清祥,2016-01-25 10:14:06,-2,6,8,真的转性了，给分没得说，说实话，看成绩时吓呆了。但是，觉得上课还是挺无聊的。
19820,2761,章清祥,2016-01-25 10:28:45,-6,5,11,不水的思修，作业相比其他老师的多，但能学到东西，给分真的变好了，不过注意还是不能水。
19955,2761,章清祥,2016-01-25 16:06:11,-7,4,11,给分很厚道，上课学的到东西
19962,2761,章清祥,2016-01-25 16:33:01,-6,6,12,我15-16绩点4+，老师现在给分挺合理的，要小组作业与展示名词间的关系解释清楚、ppt版面清晰（不要花里胡哨的东西，主要是态度，不要敷衍）个人作业正常完成
19963,2761,章清祥,2016-01-25 16:36:19,-7,6,13,有讨论课，个人和小组都有。老师视野开阔，还是律师，教了我们很多法律知识，包括国外的法律特点。另外尽管不点名但是期末会有到课统计，还是每节课都来吧，收获不少。
19967,2761,章清祥,2016-01-25 16:45:04,-14,4,18,虽然作业比较多但是给分超级好！
19996,2761,章清祥,2016-01-26 00:58:37,-14,3,17,真的很不错
20465,2761,章清祥,2016-01-27 16:40:25,-11,8,19,事情超级少，相比那些拍微电影做问卷的我们真的事儿少，只有两次小组作业加一篇读书报告，冬三周前全部搞定！给分也很好啊！！他是我大一上分最高的课！！
20587,2761,章清祥,2016-01-28 16:07:17,-14,7,21,虽说我个人不是很喜欢思修这种课，上课也很讨厌与人撕逼，但老师人不错，作业少，给分很好，我从没回答过问题，就是好好做作业，最后90+
20906,2761,章清祥,2016-02-03 11:53:10,-11,5,16,天道酬勤
20933,2761,章清祥,2016-02-04 09:51:42,-7,7,14,老师是律师，教学认真，尽管看上去有点凶但其实是对事不对人型。思修这门课课本知识很无聊，老师上课的案例分析还挺值得听的，今年变成了给分小能手~
21357,2761,章清祥,2016-02-28 08:00:19,-10,4,14,经常分析一些时事，很有收获
21452,2761,章清祥,2016-03-29 03:28:32,47,51,4,给分低。。啊 好难过 明明认真完成了作业 和同寝的人给的差别也太大了吧
21505,2761,章清祥,2016-02-29 05:20:12,-16,3,19,真的有干货的老师 给分也是已经很好的了
21629,2761,章清祥,2016-02-29 11:04:32,0,5,5,瞌睡！
21830,2761,章清祥,2016-03-01 07:34:30,-14,2,16,棒棒哒
21961,2761,章清祥,2016-03-02 02:27:43,-10,5,15,好老师 讲课好
22270,2761,章清祥,2016-03-03 06:52:58,-13,4,17,除了口音有点重，上课还是很有意思的，案例分析真的很有趣，最后给分也不错嘛。
22902,2761,章清祥,2016-03-14 11:56:52,-17,1,18,好好好
23147,2761,章清祥,2016-03-20 04:40:00,-11,5,16,有干货，有思想，上他的思修可以学到很多。
23533,2761,章清祥,2016-04-05 07:01:33,-7,6,13,有干货有收获
23978,2761,章清祥,2016-04-23 10:14:22,11,19,8,对理工科学生有偏见，说我们不如文科生之类的话，不能忍！！文科生分数高，理工科得分低(╯°□°）╯︵ ┻━┻
25218,2761,章清祥,2016-05-08 11:25:33,-11,5,16,上的很不错，老师专业水平很高，给分好像从今年开始变得很高的样子，总之推荐！
25406,2761,章清祥,2016-05-17 10:54:43,-16,6,22,发现告知老师他是“绩杀”之后，他的悔改之心和实际行动大家有目共睹…其实，我认为，所谓“绩杀”不过是你和别人一样想水水过“水课”偏偏这门课的老师又是实事求是的那种。章老师人很好，而且，真心有点可爱，上课有时要预习（他说主要是怕大家平时不看书闭卷考试要挂）课上讨论很有时效性和深度。他是我在浙里遇见的第一个好老师，真心支持他！（不给10分主要因为他竟然不给满绩…
26203,2761,章清祥,2016-06-16 08:14:51,-16,2,18,传说中的绩杀突然转性成了给分小能手 上课经常讲案例 很有意思 不像其他很多老师只讲书上的东西\n\n
26551,2761,章清祥,2016-06-20 05:36:38,122,134,12,百年浙大思修不挂 章清祥一个班挂七个(╯°□°）╯︵ ┻━┻
27134,2761,章清祥,2016-06-23 06:50:06,-14,3,17,很棒的老师，上课的时候，意气风发，文采飞扬。而且从我们那一年开始也不是绩杀了超级棒。
32746,2761,章清祥,2016-07-12 07:51:55,8,11,3,作为12年他的第一届学生……绩点受害颇丰……我们组4次作业全部前两名，我还是小组组长，两次个人作业我也都是有封面有目录有页眉有页码的（感受下那可是4年前大一刚开学的时候……那时有这样觉悟的人几乎根本没有好嘛）……貌似也都写了5000字+……最后抱着能不能上90的期待去等待的……最后给了我75……我就不说啥了……给分充满了随意和任性……\n\n我承认他讲的确实不错，毕竟律师出身……但是这个给分真心没法给他高分。。\n\n据说现在从良了……
33376,2761,章清祥,2017-01-17 09:29:32,91,100,9,真的很努力 但是给的绩点很低 期末考试也不差 不知道为什么 说绩杀就绩杀\n\n
33792,2761,章清祥,2016-09-21 22:44:17,7,9,2,认真完成作业，还是组长。。。并没有什么卵用，不推荐
34014,2761,章清祥,2017-10-24 00:39:13,14,19,5,思修这种课只有照着讲书的老师才能算靠谱好么
34048,2761,章清祥,2016-12-26 01:43:15,32,36,4,大绩杀
34059,2761,章清祥,2016-09-26 08:18:07,16,21,5,傻逼老师，分组要分几节课，口口声声民主，根本是独裁啊啊啊
34406,2761,章清祥,2016-12-16 05:18:32,23,27,4,辣鸡思修，毁我青春
34431,2761,章清祥,2016-10-10 08:51:27,12,17,5,老师上课几乎没有什么提纲，连课堂大标题都不给说，坐在后排的小伙伴们不认真听就很容易走神，很快就听不下去了！可能老师本人是有思路的，但是我是表示听得云里雾里，不知道他在说什么┐（─__─）┌
35267,2761,章清祥,2017-03-03 02:59:35,-17,11,28,讲道理不知道为什么会说老师是绩杀（或许是我要求太低？）总共两次小组展示一次论文作业也不是很多啊上课还是能听到很多东西的同学展示的时候不喜欢直接说不喜欢确实直白了些可是喜欢的也会直接夸奖呀最后4.2如果这样还算绩杀的话只能说各位都是大佬以满绩为目标?
35378,2761,章清祥,2017-01-17 10:04:43,48,56,8,绩杀！同寝最低，选陈小英吧。太垃圾了，看不出哪好，懒得骂了。
36926,2761,章清祥,2016-12-26 02:05:34,43,46,3,呵呵他一脸，将自己的私人感情带到课堂，心情不爽就辱骂学生，不念别人的辛劳成果让人重修。
39778,2761,章清祥,2017-01-17 16:32:09,-35,4,39,这个老师呢，水还是有一套的，给分呢，我就不说了，班长3.6，副班长3.3，而我天天翘课4.2，论文乱写，颜值高就是不一样
40818,2761,章清祥,2017-01-05 18:07:07,-7,4,11,有思想  上课会让我们讨论近期的案例  律师出身能从专业角度分析  虽然课堂挺严肃但是我觉得收获挺大的  干货很多  虽然我是理科生但也觉得很有意思
42839,2761,章清祥,2017-01-19 08:09:47,-29,9,38,看不下去重评一遍，有些人满嘴喷粪作为浙大人素质堪忧。查老师大概就是让那些自以为付出了足够的努力结果最后没有得到想要的成绩的人拿来发泄情绪的地方吧。老师要求严格，给分不好是事实，我自己也没上四，不过确实学到了东西，绩点无所谓。说自己多么多么努力的就免了吧，一学期下来只有一组做的展示我自愧不如，其他基本念PPT念讲稿、内容复制粘贴再加点瞎扯。个人作业5000字我写的8000，小组作业太废我一个人从头改到尾，最气的就是一组人基本想着水，组长带着自己认识的那几个人瞎搞，其他人可有可无基本无视，中间跟他们摊牌可能就被当个笑话吧，老早就骂老师是翔真的看不下去。整个小组没人上四不是没有原因的。在这么严格的要求下随机分组风险实在太大，自己掂量吧。
43895,2761,章清祥,2017-02-22 08:14:21,-10,10,20,两次小组展示  要求很高
43907,2761,章清祥,2017-01-17 06:07:16,-15,1,16,平时有点凶，但是我的分数不错。\n\n律师出身，很不错哦。
43923,2761,章清祥,2017-01-17 06:30:38,-15,2,17,老师上课挺好的。就是有点凶。各种恐吓会挂科。其实给分还是很好的
43932,2761,章清祥,2017-01-17 06:39:19,13,21,8,老师上课还是讲得挺好的，只是期末绩点好低，有点惊讶，也不说自己多么努力啥的，只是保证完成好作业，写读书报告论文而已，但这绩点真的很难受
43938,2761,章清祥,2017-01-17 06:47:42,23,24,1,给分不怎么样 感觉分组这种东西太坑
43939,2761,章清祥,2017-01-17 06:48:11,21,23,2,绩杀。
43941,2761,章清祥,2017-01-17 06:49:35,-16,1,17,好老师，有干货，上了他的课，考试不复习也差不多会做\n\n只是平时有点严
43943,2761,章清祥,2017-01-17 06:50:20,1,11,10,对老师还是很欣赏的，老师讲得挺好的，但是我很认真听课和写报告，最后得分并不高啊（不怪老师，严重怀疑我摊上了一个根本不负责任的小组/微笑)
43946,2761,章清祥,2017-01-17 06:55:31,-17,1,18,老师真的不错，干货很多。。事情也不算很多。作业考试好好对待分数不会低。。之前上课态度也一直非常好。就是后来一节课大概心情不爽把作业做的不好的同学骂的很惨。个人感觉这个处理欠妥。。不过总的来说，章鱼哥还是蛮好的。
43950,2761,章清祥,2017-01-17 06:58:19,-2,10,12,真真是个大绩杀，给分坑，不过老师挺可爱
43960,2761,章清祥,2017-01-18 05:20:48,71,76,5,思修课平时分给80。。。真的要考满分才有4了。对于不符合他的逻辑的观点全盘否定，很喜欢对学生的思路指手画脚。事情很多很严格，摊手不说话
43964,2761,章清祥,2017-01-17 07:14:15,25,27,2,说好不绩杀了呢？
43974,2761,章清祥,2017-01-17 13:51:48,24,31,7,上课还是不错 但是客观来说 给分真的太差 平心而论 文科生考试写的很认真平时作业也都认真做了 但是成绩很不正常  全组分都很低 一种付出日了狗的感觉
43975,2761,章清祥,2017-01-17 07:21:59,40,46,6,这老师事儿多，大绩杀。同寝没有比我绩点低的，但是事儿比我多的。一学期两次展示。每次展示都还要有论文版的。个人还要有论文，还要网上学习。给分垃圾，同组没有上4的。\n\n
43977,2761,章清祥,2017-01-17 09:17:55,87,94,7,别信，还是绩杀，先说小组，要是分到一群坑就呵呵了，还有论文，一定要按格式写，还要做封面，要求特别严，上课同学做报告莫名其妙就发火，做的再好也能给你挑点错，一共两次报告还有一篇4000字论文格式的书评，说事少的都是大佬，我舍友一学期就一次报告，还没有论文，报告好好做，论文5000➕，最后期末好好复习自己整理手抄了十几页资料就给个三点几，拉低均绩0.1，不会搞事，不会写论文的还是别选了，能退就退吧
43987,2761,章清祥,2017-01-17 07:36:17,68,77,9,那些得了高分的真是把老师夸的花枝招展，每次作业都认真做了，考试写了三篇小论文，3.3，绩杀还是绩杀，这种课还是运气比较重要呵呵
43992,2761,章清祥,2017-01-17 07:40:44,13,16,3,讲得好但没有用，大绩杀大绩杀大绩杀\n\n
44019,2761,章清祥,2017-01-17 08:13:39,30,32,2,认真学习认真听课认真写论文但只有3.3\n\n你们感受一下
44022,2761,章清祥,2017-01-17 08:17:35,15,16,1,他正态了我们家小姐姐妈的生气
44092,2761,章清祥,2017-01-17 09:12:02,29,30,1,对过程要求很严格，一不小心就说作业给你零分...我真的很认真的做完了每个作业，最后还是只有3.9?真的服了...
44141,2761,章清祥,2017-01-17 10:24:30,18,18,0,绩点没上3，说多了都是泪
44143,2761,章清祥,2017-01-17 10:33:45,27,27,0,瞎给分\n\n和认真做小组展示的同学撕逼\n\n台下的我不能忍
44163,2761,章清祥,2017-01-17 11:07:11,12,16,4,课不错，只不过绩点出来有点惊奇的低了，说好的给分小能手，我也有很认真的做作业啊。
44188,2761,章清祥,2017-01-18 05:29:33,-15,6,21,客观的评价一下老师虽然平时有些严肃，但是专业只是还是很强的，也是一个很有人情味的人，平时展示认真做，期末多写点，绩点不会太低！
44339,2761,章清祥,2017-01-17 15:44:45,-17,1,18,其实，主要还是靠自己。考试挂了说明没好好准备，论文低说明不太符合要求。我觉得自己的绩点还好，可以接受。
44510,2761,章清祥,2017-01-18 02:06:00,35,36,1,退掉谢谢
44524,2761,章清祥,2017-01-18 02:25:19,14,15,1,呵呵呵
44679,2761,章清祥,2017-01-18 06:09:15,27,31,4,绝对绩杀，两次小组展示，一次4000字的读书报告，还有期末考试。平时事情作业多的要死，本以为给分会不错，没想到最后思修成了超级拉低绩点的一门课，真的没什么想说了，大家慎选慎选啊！心情被思修搞得暴躁！
44801,2761,章清祥,2017-01-18 09:16:11,12,14,2,我没打算思修课还能学到点什么，课堂无聊，很正常。因为没有好好听过课，就不知道老师专业知识怎么样了。不过，老师不太容易接受同学的不同观点，有时候可能就直接否决了。报告，论文，展示什么的，我真的搞不懂评判标准。期末给分，因为没有期待，所以没有失望。
44914,2761,章清祥,2017-01-18 13:32:38,22,23,1,绩杀，大绩杀
44941,2761,章清祥,2017-01-18 14:40:11,24,25,1,认识的上别的老师思修课的同学 绩点都是4以上 还有满绩的 这位 我就呵呵 谁选谁倒霉
45057,2761,章清祥,2017-01-19 07:08:30,21,22,1,绩杀！
45275,2761,章清祥,2017-01-19 08:51:22,27,27,0,以一己之力推翻浙大评分系统，3.8分不是吹的?
45285,2761,章清祥,2017-01-19 09:09:49,-20,6,26,呃…我们组展示也一直被骂啊 我最后4.5 说句公道话 老师这里上课真的可以学到点东西 比如最后那个遗产继承啊 其实小组怎么样真的不是问题…挺一下老师
45850,2761,章清祥,2017-03-08 08:44:15,16,18,2,太垃圾
46183,2761,章清祥,2017-01-21 01:09:30,15,17,2,给分不好哇 明明认真复习了 刷题了 分数都没有别的班只看了目录的人高 平时也认真完成任务了哇 有点难过
47467,2761,章清祥,2017-01-27 07:53:02,11,14,3,有点无聊，而且绩杀啊为什么！！！老师很注意细节，比方说论文格式之类的，心累
47900,2761,章清祥,2017-02-27 07:52:41,13,14,1,我想说  全校平均好像3。9吧   他的班3。3   \n\n(▼皿▼#)
47949,2761,章清祥,2017-02-27 12:34:14,16,17,1,我真的无f**k说，作为一个勤勤恳恳的组长，作业每次认真完成，考试之前认真复习，期末给我一个呵呵的分数【手动微笑】什么绩杀悔过的话，憋信了。
58527,2761,章清祥,2017-08-31 03:22:28,6,6,0,真的绩杀
58571,2761,章清祥,2017-09-04 15:41:39,-16,0,16,讲得太好了
59610,2761,章清祥,2017-09-25 01:32:02,4,5,1,hhh
59613,2761,章清祥,2017-09-25 01:58:41,12,12,0,脑残，分组分半个小时，说话冲蛮横无理，无fuck说
60049,2761,章清祥,2017-10-09 01:05:12,53,54,1,课水，人糊，字烂，作业坑。
60224,2761,章清祥,2017-10-14 05:04:52,10,11,1,无聊\n\n
60232,2761,章清祥,2017-10-15 01:27:58,16,16,0,sb老师 作业格式要求贼多 4000字论文 题材局限
60240,2761,章清祥,2017-10-15 10:20:26,16,16,0,垃圾老师，给一星期的时间让交一篇四千字的论文，屁事多。
60256,2761,章清祥,2017-10-16 02:02:21,-12,3,15,讲的还行 条理不是很清楚
60292,2761,章清祥,2017-10-31 00:35:57,12,12,0,无比垃圾
60298,2761,章清祥,2017-10-17 00:58:39,10,11,1,无语。
60389,2761,章清祥,2017-10-19 00:25:58,11,11,0,垃圾老师逼事多
60396,2761,章清祥,2017-11-07 01:11:14,34,37,3,作业非常非常多，三篇四五千的论文还有展示，经常有小组作业，必须要非常认真的准备，要求很严格，观点和他不一样就开始骂，一点都不尊重学生，辛辛苦苦准备的作业说给零分就给零分，绩杀。思修是门什么课自己心里没点13数吗?没选的千万别选了，选了的能退就退。\n\n
60546,2761,章清祥,2018-01-22 05:55:41,31,33,2,讲课逻辑混乱，几乎没有主题，脱离理论知识，上完两节课不知道他讲了什么。小组作业评分标准很迷，一言不合就给零分。
60672,2761,章清祥,2017-10-26 09:05:18,18,18,0,这是真的垃圾，上课只有废话，课后作业他妈蛇皮棒棒多
60765,2761,章清祥,2017-10-30 00:42:13,21,21,0,老师比较变态，上课无聊，小组讨论要求特别高。别的老师小论文3000字，有的甚至没有要求，没有格式，这个老师要4000字，而且格式要求特别高。经常要求小组讨论，小组发言每组五分钟，超过时间批评，调理不清批评，然后就小组分数特别低，甚至打零分。总之，这个老师的课能不上就不上，能换老师就换老师，否则期末绩点不保。然而，思修课的绩点和各类评奖评优有关。
60770,2761,章清祥,2017-10-30 02:40:20,13,14,1,千万不要选他的思修，如果你不想用太多精力在上面。相信我，有时你不得不这么做。
60816,2761,章清祥,2017-10-31 00:05:57,11,11,0,垃圾啊
60818,2761,章清祥,2017-10-31 00:26:01,10,10,0,辣鸡\n\n
60820,2761,章清祥,2017-10-31 01:30:33,17,17,0,事多，不尊重学生
60821,2761,章清祥,2017-10-31 01:35:48,4,9,5,对作业要求严格。做得好的不吝赞美；做得不好，不符合他的要求，没有好的内容组织，打零分也是毫不手软的。
60867,2761,章清祥,2017-10-31 16:18:24,24,27,3,是根JB
60868,2761,章清祥,2017-10-31 16:17:26,27,27,0,我舍友快被他逼疯了，真的
61002,2761,章清祥,2017-11-07 00:53:31,15,15,0,上课无聊，负能量满满，给分很主观，对小组作业要求还很高，绩杀老师=(
61003,2761,章清祥,2017-12-12 10:58:45,16,16,0,完全看心情给分，用心准备了分还是很低，浙大有这样的老师真的是败笔
61013,2761,章清祥,2017-11-07 02:51:16,11,11,0,垃圾老师
61206,2761,章清祥,2017-11-12 03:03:53,17,17,0,整天就知道吹嘘自己
61305,2761,章清祥,2017-11-14 05:45:39,20,20,0,看到大家都在骂他我就放心了
61544,2761,章清祥,2017-11-18 11:51:38,6,7,1,小组讨论课简直了。。。
62866,2761,章清祥,2017-11-27 07:35:42,8,8,0,事太多，瞎骂学生。
63633,2761,章清祥,2017-12-11 02:57:31,16,16,0,事情特别多，整个寝室我的思修作业最多。室友的读书报告没有字数要求，他要求4000字，还要写成小论文形式。对格式要求非常高，不符合格式就扣分。各种论文各种讨论还有展示，一言不合就给零分。能退还是退吧。是预置课程我就没退，现在已经疯了。嗯，准备重修。手动再见。
63655,2761,章清祥,2017-12-12 03:50:59,19,19,0,每次展示都是一次惊险刺激的猜老师思路的过程。稍有偏差就是0分。
63663,2761,章清祥,2017-12-12 04:11:00,18,18,0,大绩杀！！！！垃圾老师毁我青春！作业死多花了大功夫完成说给0分就给0分。不想多说了，准备论文去了。
63700,2761,章清祥,2018-01-07 11:41:06,43,48,5,法律上很专业，其他很一般，逻辑体系在除了法律以外的方面都很有问题。作业太多，用处不大，讲课条理性不强，没有体现出提高法律意识与法律基础的作用。对同学的思路指手画脚，固执己见，这个是很难接受的，尤其是骂同学认真做的是垃圾。有些既得利益者比如班长什么的别洗了，他真的配不上现在的6.19分，也配不上思修这门课
63722,2761,章清祥,2017-12-13 12:52:58,16,16,0,真的垃圾，垃圾老师只会骂同学垃圾上的课非常垃圾
63840,2761,章清祥,2017-12-25 01:12:21,32,32,0,他今天早上终于记得吃药了？
63855,2761,章清祥,2017-12-18 00:30:22,19,19,0,又一组被他骂的体无完肤，听着都心疼
63856,2761,章清祥,2017-12-18 01:47:30,11,12,1,太垃圾
63858,2761,章清祥,2017-12-18 02:57:47,11,11,0,无奈 悔不当初
63863,2761,章清祥,2017-12-18 03:23:22,-1,3,4,没退他的课\n\n
63894,2761,章清祥,2017-12-19 00:04:37,30,33,3,首先 要点名 你逃不过的 其次 作业贼jb多 一学期个人作业两篇 每篇4000 小组作业5000  还有电子版 打印版 PPT 我他么 。。对格式要求还贼jb严  再次 评分超级烂 就看他开不开心 他要是看你不顺眼 你做的再好也没用  前面贬完一个组 在批评另个组的时候 说的他以为正确的思路就是前面一个组的思路 mmp 从次 上课垃圾 完全学不到东西 就会讲乱七八糟的法律 自己的思路毫无逻辑 我他妈 cnm 最后 能推掉赶紧退 不退那就只能重修了   （我不想说脏话 但是真的没有另外的词语能表达我的愤懑）
63896,2761,章清祥,2017-12-19 01:12:06,15,15,0,不小心报上了他的课一定要退啊！不要犹豫！Do not try him.
63897,2761,章清祥,2017-12-19 01:25:30,-17,0,17,老师很严格，不过分析很到位。如果排除自己的主观偏见还是能学到很多，虽然平时很难受，但对未来还是有帮助的。
63904,2761,章清祥,2017-12-19 04:01:29,14,16,2,我这么说吧，选了他的课你就别想水过思修。事儿真的多 而且给分非常严格甚至不讲道理。\n\n但是最关键的还是组，分到一个不干事的组真的gg ，我就是这样，小组作业你一个人就得干一半，群里怎么找人都没啥用。\n\n客观地说，他的一些探究问题的方法和角度还是值得学习的，虽然有些死板（？） 但也让我看到了论文中没注意到的问题，也提供了一些角度。
64196,2761,章清祥,2017-12-21 10:40:52,13,13,0,事情贼多，请不要试着挑战自己！！！作业布置的乱七八糟，个人作业小组作业混着来，很难搞清楚。老师有自己的所谓逻辑，但其实自己的逻辑也有点问题。然后评价同学的作业都是一点不好就全都不好。
64199,2761,章清祥,2017-12-21 11:05:23,10,10,0,为什么没有零分 我想打负分
64210,2761,章清祥,2017-12-21 13:57:28,-6,3,9,不太喜欢这个老师，但在他的课上能学到很多，写论文做PPT的水平蹭蹭蹭地提高
64343,2761,章清祥,2017-12-22 15:15:57,8,9,1,真的是胆战心惊，稍有不小心或是不合心意就零分。作业多不说，认真做了还说是敷衍是抄网上。要选上了赶紧退选?
64357,2761,章清祥,2017-12-23 02:09:21,7,7,0,垃圾老师 绩杀
64398,2761,章清祥,2017-12-23 07:57:30,9,9,0,体验极差
64424,2761,章清祥,2017-12-23 12:26:52,12,12,0,老师说 别的老师都有三份个人论文 我只给你们两份 已经很好了。微笑jpg。两份个人论文每份4000字不说 还有小组论文5000字还有小组ppt还有数不清的额外小组讨论案例讨论都要做展示都要做发言都要准备稿子。别的老师呢？读书报告800字要么1000字………这都还好……小组分到一群坑真的是最惨 坑的有苦难言。还不如一个人独立作业。
64634,2761,章清祥,2017-12-25 23:38:06,10,10,0,真的建议，看到是他就退选了吧
64725,2761,章清祥,2017-12-27 03:21:51,-3,2,5,紫薯布丁
64742,2761,章清祥,2017-12-27 04:32:26,7,7,0,对不起我窒息：）
65227,2761,章清祥,2018-01-01 15:59:53,15,15,0,假民主。要求严格，表面之下又做出一种接受意见的姿态，然而最里面还是固执己见的。\n\n法律上很专业，但在其他一些方面并不是这样；有时候逻辑有问题。他是真的不适合思修这门课。
65230,2761,章清祥,2018-01-02 00:23:46,16,16,0,我同学在作报告，被打断两次，还被说没有总结，是在浪费大家时间。他准备了好久，被说成这样。现在他一遍讲话一边声音在抖，我觉得他都要哭了。
65261,2761,章清祥,2018-01-02 06:17:25,8,9,1,无fuck说
65492,2761,章清祥,2018-01-07 11:34:56,-8,12,20,说章老师不好的不知道怎么想的，我上了一学期并没有发现老师会针对学生好好做的作业，相反的他只是直接地指出了你存在的问题，让你真正的学到很多东西，而且章老师也一直会给我们分享自己做律师遇到的案例，学到的非常多，虽然作业有点多，但平心而论也没有这么不可忍受吧！
66233,2761,章清祥,2018-01-15 03:46:32,-16,1,17,大绩杀是大绩杀，口齿不清是口齿不清，但有时候还是很可爱的，复杂
66692,2761,章清祥,2018-01-18 09:50:59,13,14,1,我室友是他的班长，可能要挂科了
66693,2761,章清祥,2018-01-18 09:51:09,21,21,0,我室友上她的课，头发都变油了。。。(｡•ˇ‸ˇ•｡)
66732,2761,章清祥,2018-01-18 15:01:30,10,10,0,无聊 还凶\n\n
66834,2761,章清祥,2018-01-19 07:25:33,15,16,1,真的恶心?上课只会讲自己的光荣事迹？一学期两篇5000个人一篇4000小组10分钟ppt展示两次大讨论还要求会议纪要各种格式连ppt做的好不好都算！一次报告下来全班一半被打了0分就因为自己跟他观念不符！贼恶心贼恶心！
67654,2761,章清祥,2018-01-22 04:08:36,-8,5,13,老师其实还不错。只要按照老师的要求来，绩点不会低的。
67656,2761,章清祥,2018-01-22 04:09:42,-17,2,19,作业贼多，要求很严格，诸君皆已言及，此不赘述……\n\n但是给分很好啊，认真做作业，考试多写点，分数会很不错的。感觉飘过了，好评。
67663,2761,章清祥,2018-01-22 04:21:32,-18,5,23,良心老师，上课有趣，不再绩杀了！！！
67666,2761,章清祥,2018-01-22 04:40:12,14,15,1,课嘛不讲 作业他妈蛇皮棒棒多\n\n给分巨坑无比
67672,2761,章清祥,2018-01-22 04:49:52,3,8,5,请各位看好均绩。成绩出来的时候想后悔的，请毫不犹豫地选他。
67677,2761,章清祥,2018-01-22 04:54:32,-5,9,14,其实还好，看运气吧。平时论文认真写，展示平实一点，按时签到，4.2。\n\n但事情和别人比真心多
67682,2761,章清祥,2018-01-22 05:02:22,-11,8,19,老师终于不再绩杀！我爱老师哈哈哈！
67690,2761,章清祥,2018-01-22 05:22:40,-6,6,12,Emm\n\n事多\n\n头秃\n\n论文要求严格\n\n但心地很好
67691,2761,章清祥,2018-01-22 05:22:53,13,16,3,绩点高的几位就不要以己度人了，老师还是绩杀。也不要唯绩点论，说实话老师平常对待学生真的不怎么样
67699,2761,章清祥,2018-01-22 05:28:24,8,13,5,呵呵。大一上进来听学长组的不敢退课。
67706,2761,章清祥,2018-01-22 07:26:36,13,13,0,就是呵呵咯
67708,2761,章清祥,2018-01-22 05:37:10,4,8,4,作业多事多，会有一些收获，但是给分和整个过程真的不太好
67716,2761,章清祥,2018-01-23 01:36:45,5,10,5,垃圾老师
67722,2761,章清祥,2018-01-22 05:56:15,-7,10,17,几乎每节课都点名，作业多，在写论文方面有一定收获，毕竟一学期写了三篇5k字+论文。对课堂展示和讨论的评分，条理清晰为最重要指标，同时受他本人当时心情影响。我认真完成作业写论文不缺课，最终4.5。没说的那么烂，只是不适合希望完全水的同学，写论文的过程很痛苦但是绝对有收获。
67723,2761,章清祥,2018-01-22 05:56:42,13,17,4,欸欸那个班长，去拿一下电池~录音笔又没电啦~
67737,2761,章清祥,2018-01-22 06:13:10,-11,4,15,上课讲各种案子，律师作风，小组作业比较严格，但期末给分还不错
67747,2761,章清祥,2018-01-22 06:27:40,-8,7,15,可爱又严厉的老师～～～会教给你一些进入社会必不可少的知识
67754,2761,章清祥,2018-01-22 06:36:24,5,9,4,不适合想水课的学生
67758,2761,章清祥,2018-01-22 06:42:42,-10,7,17,绩点还可以，好感动啊
67766,2761,章清祥,2018-01-22 06:51:05,-11,9,20,老师是个律师，本身法律素养很高，上课也挺有趣的，不是个一板一眼只讲课本的老师……小组在他的课堂上扮演一个很重要的角色，所以加入一个好的小组非常重要（偷偷表白我思修组长? ）。平时作业很多，但认真做的话以后就不怕写论文了。总之，不适合想水的同学。
67771,2761,章清祥,2018-01-22 06:59:01,9,11,2,不想说什么，作业很认真完成，小组展示也做得很好，他自己还评价了的，结果我的绩点。。和预想完全不一样，真是
67791,2761,章清祥,2018-01-22 07:23:07,-19,8,27,老师是个很有个性的人，很有趣。上述那些说老师强行打断的描述，我是没有见过。小组作业会打0分，但是会给他的理由和见解，还会给重做的机会? 。\n\n因为老师似乎是个律师，所以总会结合一些他的案例，还是很有趣的。\n\n给分的话也还挺好的。\n\n总体来说很有个性个性个性个性。\n\n也能学到一些知识的。
67793,2761,章清祥,2018-01-22 07:23:46,-18,2,20,认真完成作业价值观符合老师的考前看看题库论述题多答点就不会太低
67820,2761,章清祥,2018-01-22 07:54:01,-10,7,17,在一个有大佬的组里真的很重要很重要。水过思修课绩点居然出奇的好(✪▽✪)
68006,2761,章清祥,2018-01-22 13:06:55,18,30,12,听老师的课受益良多，其中最大的一点就是学会放宽心态。\n\n老师曾经说他的课对走上社会后的我们是有帮助的。的确，以后我们会遇见许多麻烦的人，他们有意无意地刁难自己，而你却无可奈何。既然无法敬而远之，就只能安然处之。，上老师的课一学期，我们的心灵更加坚韧，我们的心胸更加豁达。\n\n这可是老师的良苦用心啊，他不给我们讲大道理，而让我们自己领悟。比起人生的益处来，作业和绩点又算的了什么！
68415,2761,章清祥,2018-01-23 07:17:09,-10,3,13,学会了怎样写论文
68486,2761,章清祥,2018-01-23 09:06:49,0,5,5,老师挺认真的，每节课签到。事儿也挺多的，不适合想水的同学。老师是个律师，会经常分析案例给我们，确实长见识。但有时老师会按照自己的逻辑思路来评判学生小组的任务，真的可能是0分，不是很会考虑学生的思路。绩点一般，平时成绩也不知道怎么给的。
68588,2761,章清祥,2018-01-23 12:02:52,5,7,2,心累啊，没有受苦的准备就别去了
69924,2761,章清祥,2018-01-25 16:17:03,9,10,1,绩杀，给他发email，也不告诉为什么杀你。冷淡，心痛。
70209,2761,章清祥,2018-01-26 08:43:38,6,9,3,关于论文，我想说这位老师给的只是论文的格式，上了其他老师的课我才明白真正的论文应该怎么写，写论文关乎学术，不是一个模板就能让你学会写论文的。
71555,2761,章清祥,2018-01-28 15:21:09,3,4,1,傻逼老师
72320,2761,章清祥,2018-01-30 02:00:00,23,24,1,原本以为思修平均分都是3点几，自从我看到室友的满绩，我知道该给老师打一分了
72721,2761,章清祥,2018-01-31 03:22:03,3,5,2,港真，傻逼
72768,2761,章清祥,2018-01-31 05:11:41,4,6,2,我自己过去就过去了 这种人渣不知道我多想 但是还可以退的一定要退啊
72862,2761,章清祥,2018-01-31 08:12:09,4,5,1,呵呵选上遭罪
73101,2761,章清祥,2018-02-01 02:11:03,-32,7,39,不是很懂你们这些均绩4.5+的大佬，什么叫绩杀？4.5以下就是绩杀了吗？老师明明人很好，上课也挺有意思的，一学期就2篇4000字个人论文，1个小组的论文+展示，讲真，真不多。那，要什么都不想干的话那还真是多了，那我也只能呵呵了
73441,2761,章清祥,2018-02-01 14:39:33,1,3,2,辣鸡不解释
74237,2761,章清祥,2018-02-07 12:14:53,18,18,0,很棒的老师，让我明白了什么情况下应该果断退课
74336,2761,章清祥,2018-02-11 14:57:33,3,3,0,emmmmmm一言难尽
74350,2761,章清祥,2018-02-13 04:31:58,5,5,0,每节课都点名，不听学生观点。给他1分那是因为没有0分。差评差评！
74521,2761,章清祥,2018-03-03 01:52:45,3,4,1,辣鸡老师
74987,2761,章清祥,2018-03-07 02:13:14,2,2,0,无话可说 就那样吧
75001,2761,章清祥,2018-03-07 03:01:22,8,9,1,每日一分
75194,2761,章清祥,2018-03-08 02:35:56,4,5,1,垃圾，真的垃圾
75983,2761,章清祥,2018-03-23 03:53:46,3,4,1,自己感受，不想多说话
76292,2761,章清祥,2018-04-02 07:03:41,5,7,2,每日一分
76632,2761,章清祥,2018-04-17 00:58:29,-13,4,17,上过他的课我自然知道他的严厉，但是，一年后你发现好像受了他的影响你养成了严谨的习惯
78665,2761,章清祥,2018-05-14 09:46:29,12,13,1,这个老师有毛病的，不管你实力怎么样，不合他的思路，就是全盘否决＋超低分。他是不是要把所有人才扼杀在摇篮里？素质低，态度恶劣，不配当浙大老师。
79056,2761,章清祥,2018-05-21 16:36:48,5,6,1,恶心死人
79349,2761,章清祥,2018-05-31 09:56:46,62,68,6,老师明明很好啊。天天布置几千的论文和报告。要求也讲的很清楚。对学生们的成长和适应大学生活非常有帮? 。\n\n这么好的老师。我给一分
81039,2761,章清祥,2018-07-03 11:51:03,23,25,2,是导致我大一上过得很丧的原因之一……抛开绩杀不说，刚开始上他的课真的陷入了深深的怀疑——一直以来期待的大学课堂是这样子的吗?高高在上，言语偏激，讲课没逻辑，一言不合就怼人……真心觉得他格局有点小，没有大学学者的风范。
82981,2761,章清祥,2018-07-09 11:52:27,5,5,0,不想评价 不怕不水的可以上
86280,2761,章清祥,2018-09-12 03:03:38,7,7,0,日常一分
87567,2761,章清祥,2018-10-07 03:33:29,7,8,1,事儿多，人家读书报告1k-1.5k字，他3k还不加标点，马院的老师真把自己当回事
87612,2761,章清祥,2018-10-08 07:31:43,3,3,0,呵呵 自己体会
87976,2761,章清祥,2018-10-19 04:40:32,4,4,0,课水事多人烦分低，能退尽量退。
88090,2761,章清祥,2018-10-22 05:09:16,5,5,0,垃圾中的垃圾
88130,2761,章清祥,2018-10-23 00:27:46,3,3,0,认真，吹毛求呲，认真到我想自闭。
88262,2761,章清祥,2018-10-25 07:13:37,7,7,0,章清祥个垃圾
88263,2761,章清祥,2018-10-25 07:13:56,1,2,1,。。。。。。
88592,2761,章清祥,2018-11-02 08:16:05,7,7,0,会被恶心死的，你认真做了作业也一样
88639,2761,章清祥,2018-11-05 01:55:22,5,5,0,自大狂
88694,2761,章清祥,2018-11-06 02:46:28,7,7,0,太自以为是了，直接说课本上的概念是错的，小组讨论必须按照他的观点来，真是醉了。。
88807,2761,章清祥,2018-11-08 11:46:45,5,5,0,偏执无能垃圾狂
88904,2761,章清祥,2018-11-12 03:51:12,10,10,0,最大的错误就是没有退课，认真做的展示，被说毫无逻辑，讲课天马行空，讲真的，还是选择查老师评分好的老师吧，我是预定的，有经验了。
88905,2761,章清祥,2018-11-12 04:01:55,7,8,1,垃圾老师，教的不好，极度自负，自以为是，不知天高地厚，总有一天多行不义必自毙，惹多了人以后死都不知道怎么死的
89690,2761,章清祥,2018-11-20 09:25:56,5,6,1,是个sd，够厉害（fnmlgp）\n\n事儿多，评价标准迷
90968,2761,章清祥,2018-11-28 07:19:50,10,10,0,形式主义官僚主义的绝佳表演者
91185,2761,章清祥,2018-12-03 01:35:17,9,9,0,烂透了
91228,2761,章清祥,2018-12-04 01:03:10,10,10,0,时运不济，命途多舛
91653,2761,章清祥,2019-01-03 05:12:30,8,8,0,日常来刷刷1分
93132,2761,章清祥,2019-01-09 07:50:52,7,7,0,呵呵呵
93147,2761,章清祥,2019-01-07 16:24:42,5,5,0,唉，要成为思修挂科了
93152,2761,章清祥,2019-01-09 10:32:47,29,29,0,绩杀狗，来自学姐的忠告，希望19届没人选它，真的… 无语…预制的都退吧，情愿不上，也别选，如果不想有阴影的话 就这样
93590,2761,章清祥,2019-01-10 16:28:17,15,15,0,辣鸡章清祥辣鸡章清祥\n\n辣鸡章清祥辣鸡章清祥\n\n辣鸡章清祥辣鸡章清祥\n\n辣鸡章清祥辣鸡章清祥\n\n能退就退，史上最恶心老师。\n\n讲真，看到就烦。
93673,2761,章清祥,2019-01-12 12:47:29,6,6,0,班级人数特别少意味着你干不了别的事，行这可以。每节课扫码点名，讲课随意发散，这都行，比较恶心的是研究性学习和展示，你不知道你会触到他哪个g点，马上把你贬的一文不值，发邮件也不回，我宁愿考试多占点分结果只占30%，也就是说你的成绩70%都在他手上攥着，我哭了，还没考试我觉得我就要挂了。
93867,2761,章清祥,2019-01-14 05:23:42,-19,2,21,我觉得老师挺好的啊。挺亲切的。\n\n虽然任务多了点，但是好好做也会有高分的啊，你以为的好好做了可不一定真的好…还没期末考试，但是期末考试就在自己了…平时不讲书的确不太…但是也不是很大的问题吧…我平时分很不错，我们小组内的任务分配也很好，给的分也挺好的。\n\n课都是要认真上，任务都要认真做的，而且“认真”做了也不代表你做的就很好了，反正我觉得老师分比实际应该有的偏低了
94019,2761,章清祥,2019-01-15 02:30:54,14,14,0,平时分两极分化严重……助教批作业：满分15，最低13；老师看展示：满分5，最低0……最重要的是让我们讲究逻辑但是自己没有逻辑性啊好烦！！！！！！！！
94046,2761,章清祥,2019-01-15 04:12:35,13,14,1,亲眼所见\n\n10分的研究性学习，他打了2分\n\n所有作业都交，所有课都来，最后挂了\n\n大家自己看吧
94260,2761,章清祥,2019-01-21 15:52:29,10,10,0,cnm
94382,2761,章清祥,2019-01-16 09:11:17,18,18,0,老师，我想对你说，我们都是心中有党的人，你应该反思反思，为什么你的班人那么少，为什么有人弃修，那不是别人缺勤，是受不了了。还有，抽空多读些书好吗，别太把上课这点小事放心上，让我觉得你只能在打分上展示自己的权力，我们也有☜? ? ? ? ? ?
94511,2761,章清祥,2019-01-17 04:03:40,11,11,0,只讲一点，这个老师分这么高，肯定有意自己刷分了，不然，二分以下
94676,2761,章清祥,2019-01-17 17:08:09,8,9,1,敲里抹
94752,2761,章清祥,2019-01-18 05:08:01,-14,2,16,老师很好呀，很用心在教学生，补充了很多课外的知识，不知道为什么这么多人在骂他。
94755,2761,章清祥,2019-01-18 05:16:54,0,1,1,没听过
94759,2761,章清祥,2019-01-18 05:19:34,12,16,4,大一一进校就遇到这么一个要求格式的老师对你未来四年的恶竞之路其实是有帮助的。老师对一些实事很有独到的看法，平时事情是比较多，特别是如果遇到了SB组员，什么都得自己干。一个组一个分这个评分机制真不太行。
94769,2761,章清祥,2019-01-18 05:47:15,-9,4,13,其实还可以，事情是多，要求严格，但老师事多严格应该构不成低分的原因，本来思修也没什么人听，讲出花都没用，上课感觉还是不错的，评评时事什么的。不过给分确实不太好…
94775,2761,章清祥,2019-01-18 05:56:59,8,8,0,为什么不能给0分？？？?
94784,2761,章清祥,2019-01-20 15:18:02,13,13,0,开始觉得老师讲的还不错 就没退课。结果最后绩杀，连微积分都拉不回来。。。
94788,2761,章清祥,2019-01-18 06:50:09,5,5,0,事多分低
94793,2761,章清祥,2019-01-18 07:07:22,9,9,0,事巨多，要求还非常苛刻，自己讲的不好还冤学生退课了，小组评分特别迷，最后成绩全掉在小组评分上了。给分太迷。千万别选。。。。
94819,2761,章清祥,2019-01-18 08:53:29,-4,2,6,怎么说呢，绩点还行的，就是平时事情很多，主要是要有一个好的小组长带着\n\n
94834,2761,章清祥,2019-01-18 09:50:31,11,16,5,倒了八辈子血霉被预置了他的课，微积分满绩都拉不回来绩点
94837,2761,章清祥,2019-01-18 09:53:17,9,9,0,他配不上他的评分
94841,2761,章清祥,2019-01-18 10:01:52,-6,0,6,还可以
94842,2761,章清祥,2019-01-18 10:05:16,-4,0,4,一般般
94866,2761,章清祥,2019-01-18 11:26:02,-1,3,4,嘤嘤嘤。。第一个学期事情有点多，第二个学期疯狂摸鱼。。最后3.3心满意足。
94876,2761,章清祥,2019-01-18 11:50:12,7,7,0,太乏味\n\n
94974,2761,章清祥,2019-01-18 14:05:24,13,14,1,预置了的就退吧
95000,2761,章清祥,2019-01-18 14:38:49,-17,3,20,平心而论，其实老师也没有评论里说的那么恐怖。上课的确不讲课本，并且有很多的展示，但是老师本身还是略有些可爱的233 也没有恶意辱骂同学的作业，给分也没有那么差（组里平均85）\n\n不过，事情的确很多，比我的室友多得多的多，小组总是在深夜赶ddl\n\n但是！！！起码我感受到的觉对没有评论里说的那么差！
95070,2761,章清祥,2019-01-18 16:08:45,-15,7,22,思路清晰 邏輯性強 剖析透徹\n\n事少人好給分高
95088,2761,章清祥,2019-01-18 18:05:53,-27,3,30,讲的确实是让人有收获的，虽然给分不一定有其他老师好，要求严格了点。但是还是觉得4.8也打得太低了。刷上去些
95399,2761,章清祥,2019-01-19 10:27:55,6,6,0,有的观点和见解还可以，只是作业真的很多，小组作业也很多，最后给分很不好，不是一个你认真做就能拿高分的老师，如果有别的选择不要选这个老师
95443,2761,章清祥,2019-01-19 11:49:09,6,6,0,是自己倒霉
95884,2761,章清祥,2019-01-20 07:28:19,5,5,0,为什么没有零分
96121,2761,章清祥,2019-01-20 13:06:27,1,2,1,自己看着办吧
96172,2761,章清祥,2019-01-20 13:55:52,11,12,1,好垃圾的老师，期末卷不批就按平时的小组成绩给分，一个组分数都差不多。狗屎，封建大男子主义者可以做思修老师吗？思想政治就不正确了，and同学发表性别歧视言论都不制止？？？这我就很不爽了，查老师没有0分，勉强给个1分吧。他不配，呵呵
97138,2761,章清祥,2019-01-21 17:46:53,10,10,0,摇号发绩点
97765,2761,章清祥,2019-01-22 15:39:07,20,20,0,还没掉到1分，这b是刷分了吧。
98517,2761,章清祥,2019-01-23 14:09:55,7,8,1,垃圾。不负责任。
98518,2761,章清祥,2019-01-23 14:11:08,5,5,0,真的无语
99006,2761,章清祥,2019-01-24 06:48:01,11,11,0,日常刷一分
99518,2761,章清祥,2019-01-25 01:54:41,-16,2,18,老师上课的时候喜欢分析时事，会讲一些关于法律的内容。他非常不重视课本，认为他的课堂主要培养学生的论文能力，所以会有很多作业和小组展示。作业很花时间，但是收获与付出成正比。其实那些展示老师给的要求都很明确，但凡用心准备的都能拿高分。不过确实到最后绩点大家都不高。适合愿意用心做作业又能接受绩点不高的人，想水还是换人吧。
99807,2761,章清祥,2019-01-25 07:49:26,6,6,0,个垃圾
100932,2761,章清祥,2019-01-27 06:57:23,13,13,0,也不管你事情多，上课无聊\n\n但是\n\n什么事情都做了，结果1.8？\n\n发3份邮件问过程分，份份不回？\n\n我只想说，你在浙大，真给浙大老师丢脸\n\n快点滚吧
103203,2761,章清祥,2019-02-26 23:58:48,10,10,0,真的拉低分，上课有些想法也让人震惊。能退赶紧退，身边就没有比我分低的\n\n
103207,2761,章清祥,2019-06-19 12:03:09,-2,1,3,...
104929,2761,章清祥,2019-03-31 10:22:28,14,14,0,我走进来\n\n哦？\n\n这里被黑粉控评了？\n\n再一看 zqx\n\n哦 应该的。
106431,2761,章清祥,2019-04-27 10:32:40,8,8,0,大一的时候他还是6+，看着这分下来，我觉得应该的
109135,2761,章清祥,2019-06-09 18:01:46,9,9,0,两年了回来看看这个分数，当时是六点多现在3.7，我只能说，该，真的该。这种水平的老师，还能待在浙大，是浙大的耻辱
109813,2761,章清祥,2019-06-19 11:33:10,9,9,0,小朋友们，不要上他的课，退掉，over
112733,2761,章清祥,2019-07-05 01:37:33,16,19,3,从大一上上完你的课后。我每年都刷他的评分，从6点多到3点多，我留下了欣慰的泪水。章清翔，我一辈子都不会忘记你，给我1.8，还不告诉我为什么杀我。沧海桑田海枯石烂，我以后每年会记得来查老师刷刷你，给你评评分，直至你被逐出评分系统。
114178,2761,章清祥,2019-07-09 03:11:55,12,13,1,就算没选上思修也不要选章亲翔的课，中肯意见!
115661,2761,章清祥,2019-08-16 10:56:43,8,8,0,快逃！
115691,2761,章清祥,2019-08-18 17:04:40,6,7,1,看到名字就想退了
116327,2761,章清祥,2019-09-08 10:32:52,0,3,3,没有体验
116529,2761,章清祥,2019-09-11 04:42:01,6,9,3,小朋友们！快逃！！！！快！！！！！！
117412,2761,章清祥,2019-09-24 04:36:10,5,7,2,辣鸡，真的辣鸡
118013,2761,章清祥,2019-10-19 00:09:54,-4,4,8,我觉得老师讲课虽然不是很好，但是现在人还是可以的，为人很大方，最近改进了很多呢，期末评分还不知道，老师说不会绩杀，希望如此呢
118027,2761,章清祥,2019-10-19 03:34:39,-10,4,14,我觉得挺好的呀，老师人很可爱，而且课也不错，思想很深刻。上课的时候我也能学到不少
118345,2761,章清祥,2019-10-30 12:24:44,7,10,3,为什么在考试周前安排去良渚呢？还同时布置三个ddl？人类迷惑行为
119373,2761,章清祥,2019-11-12 11:13:02,2,3,1,怎么还能有3.6？？？？？？？？？？？
120149,2761,章清祥,2019-11-18 00:28:23,-6,2,8,客观的讲，作业和事情确实很多，但是老师人还是不错的，作业交不上来也不会直接判你没交，会允许你迟一点。虽然作业很多但是不至于3.6分，个人感觉在7分左右吧
120265,2761,章清祥,2019-11-26 15:23:36,5,5,0,事多，课烂，骂人垃圾
120379,2761,章清祥,2019-12-01 11:22:52,4,4,0,真的别选，只要不符合他逻辑的东西就都是垃圾，无话可说了，我这门课怕是要完
120822,2761,章清祥,2020-01-17 17:04:02,2,8,6,垃圾绩杀 sb 狗东西 鸡巴玩意
120835,2761,章清祥,2020-01-17 17:23:17,-4,4,8,事情有点多，有点严格。但老师为人很不错，课上的也还行，不水，有干货。我觉得给分也还行啊，没那么恐怖。平时分最多一般般，不选政治而且考前准备其他科目没怎么看过思修(大概速成背了两三个小时)。最后4.2。很满意(要求比较低，大佬轻喷)
120863,2761,章清祥,2020-01-18 00:18:41,-3,3,6,事情是有点多，五六次小组讨论+ppt+论文，读书报告五千字……小组讨论课简直PPT赏析课，讲课一般般，观点有点奇葩，不过上课可以水，不点名，也很能听同学意见。期末考闭卷，不难，认真看看，最后4.5，也没那么绩杀。
120871,2761,章清祥,2020-01-18 01:01:35,-6,1,7,老师很好啊，没有传说中的绩杀，上课可以干自己的事，老师也会勾重点，期末考前背一背就行了。谢谢老师给了4.5
120889,2761,章清祥,2020-01-18 09:06:58,-11,2,13,谢谢老师给了4.8………
120982,2761,章清祥,2020-01-19 07:29:37,0,5,5,真的挺不错，老师布置的任务让我们学了很多，期末给了4.5，棒棒哒
121094,2761,章清祥,2020-01-19 14:41:42,7,11,4,课上什么都不讲 全靠学生的展示和讨论撑起课堂 作业很多 给分很迷 对法律和恋爱问题特别亢奋 建议以后展示话题尽量不要涉及法律和恋爱 会被怼死
121329,2761,章清祥,2019-12-19 11:20:03,3,5,2,作业贼鸡巴多
121433,2761,章清祥,2019-12-16 06:48:44,1,3,2,作业多，读书笔记5000字起步。其次，12月一个月3个任务，呵呵呵呵呵呵呵呵。一个展示能扣着一个细节疯狂骂。自我感觉非常良好，呵呵呵呵呵呵呵呵。
121491,2761,章清祥,2019-12-15 08:01:21,4,5,1,上课还好 事情是真的多 一次课外实践 3次小组讨论 两篇5000字的小组论文➕ 展示 一篇5000字的读书报告 我真的思修给他写吐了 真的不建议选
121599,2761,章清祥,2019-12-12 09:18:55,3,3,0,呵呵，逻辑鬼才，
121659,2761,章清祥,2019-12-10 04:26:13,2,2,0,呵呵呵
121801,2761,章清祥,2020-01-22 02:59:52,0,4,4,平时作业很严格，每次分都不高，也是一种锻炼吧。但期末得分还说得过去。
123464,2761,章清祥,2020-06-09 05:07:35,-13,0,13,今年还好吧，也没做什么突出的作业，我们小组甚至有崩盘的展示，但是也没有骂我们的内容，只是给了扣分在哪的原因，一般都只扣2分，虽然上课内容和书本不是很搭噶，最后考试背背书的标题还是可以的。最后给了4.5，出乎意料。
125225,2761,章清祥,2020-09-04 03:11:44,3,8,5,感觉这两个学期不至于过于绩杀，我是2019-2020学年秋冬学期线下的。平时授课基本都是我们展示，他很喜欢揪着一点不对的怼你，还不喜欢你反驳。讲法律，但是自己不讲理。如果不幸选上了他的课，请不要涉及法律等他稍有了解的范围。平时作业很多很多，同样的读书笔记，就他五千字起步，别的老师或许就两三千字封顶。如果能接受这个作业量（大一比较轻松，还可以的嘛），且选题的时候不要选有争议或者说他了解的法律等领域，还是可以的。绩点正常，这两个学期都不绩杀。
125880,2761,章清祥,2020-09-15 08:52:29,7,7,0,第一节课就布置5000字以上论文 两节课都不知道在讲什么 \n\n发现他分低 溜了溜了
126212,2761,章清祥,2020-09-19 16:13:44,3,3,0,别选他
126259,2761,章清祥,2020-09-21 05:16:20,4,4,0,真不怎么样
126430,2761,章清祥,2020-09-26 14:44:18,10,10,0,sb老师，户口本只有一页的，自拍就尼玛是全家福
126670,2761,章清祥,2020-10-13 01:09:43,5,5,0,讨论课很多
126671,2761,章清祥,2020-10-13 01:08:29,6,6,0,作业多，别选他（而且会骂学生辛苦做出来的作业）
126739,2761,章清祥,2020-10-17 08:43:59,3,3,0,作业多
126804,2761,章清祥,2020-10-21 00:21:13,34,34,0,总是把宝贵的课堂留给学生，还要让学生在课下时光时刻感受到思修的温暖与力量，真的谢谢他👎
126889,2761,章清祥,2020-10-27 01:09:18,15,15,0,要求全班人都按照他的思想来，不允许小组提出其他的观点，不是很理解这个大家都在认真准备的讨论课有什么意义？章清祥你自己讲不好吗？
126890,2761,章清祥,2020-10-27 01:23:03,10,11,1,为什么没有0分的选项？讨论课认真准备，提出自己的观点，却被老师当众否决，说不是正确的想法。讨论课不是思想的碰撞交流吗？如果有唯一正确的答案，还要讨论课干嘛？老师发张讲义，大家回去自行阅读不就好了吗？真的垃圾、可笑。后悔当初没有坚定退课的念头！听到舍友的老师有趣又尊重学生，对比之下，真的很不爽。
126892,2761,章清祥,2020-10-27 02:02:33,15,15,0,今天他又花了大半时间批评一个小组的pre，完全不接受学生的解释
126903,2761,章清祥,2020-10-27 06:53:00,12,12,0,我觉得他是个傻逼真的，我真是后悔能退课吗
126938,2761,章清祥,2020-10-28 23:58:28,10,11,1,滚出zju
126988,2761,章清祥,2020-11-03 01:07:43,5,6,1,真的很烦，别选他的课。
127000,2761,章清祥,2020-11-02 05:35:56,5,5,0,事情真的多
127342,2761,章清祥,2020-11-20 12:52:46,7,7,0,很难受，作业很多很多，两次小组讨论两次课堂讨论还要个人实践作业，真的作业很多很多而且展示给分也很狗血。本来我以为思修作业就是这么多，看了看室友才知道是只有这个老师的课作业会这么多。
127510,2761,章清祥,2020-11-24 00:04:33,9,9,0,呵呵呵呵呵呵呵呵呵呵，我以为思修老师应该自己首先思想没问题。骂学生，还固执己见，非觉得自己才是对的，当着全班的面会给学生难堪，无语了，可惜跑不掉了，思修看着看着就没了。
127512,2761,章清祥,2020-11-24 00:11:50,6,6,0,他教我们会读书 会考试 会做事，但我认为他无法以身作则教我们做人。
127890,2761,章清祥,2020-11-30 01:34:35,-2,4,6,老师个人观点有时候比较绝对。但是总体来说还是个比较温和的老师。作业确实有点点多，但是作业占比也大
128111,2761,章清祥,2020-12-08 00:11:31,9,9,0,我发现了，原来这老师是自己不想讲课，上节课展示完立即布置了新的展示作业。一个长学期快上完了一共听他讲过三节课呵呵呵呵
128219,2761,章清祥,2020-12-14 02:36:15,8,8,0,sb玩意别在这祸害zju学子了
128262,2761,章清祥,2020-12-15 13:26:25,10,10,0,老师愿意将宝贵的课堂时间留给学生展示，又愿意通过大量布置作业来考虑你的承压能力，同时不望在你展示的时候加以老师自己观念的评价，最后还能用一个令你难忘的成绩来敦促你记得回查老师来评价。如此优秀的老师，真是可惜chalaoshi没有给0分的选项，只能用1分来委屈老师您了，真是抱歉！
128793,2761,章清祥,2020-12-25 10:43:06,6,6,0,作业特别多，五千字读书报告，两次五千字小组研究性学习，三次小组讨论，是最坑的思修老师，而且有的小组做的作业有问题要重做。
128856,2761,章清祥,2020-12-26 05:25:48,11,11,0,作业奇多，多得离谱\n\n全是课堂展示，自己不讲话，于是期末了，我的书是空白的\n\n每次准备展示都在猜他的思路，一但思路不合就全盘抹杀你们的成果，当众批判辱骂你的作业\n\n对展示成果的评分全看ppt，ppt入他法眼，就当场加分\n\n结果就是根本没有自由的思考，只有在他的思路中摸索着被恶心\n\n我们小组氛围很好，都会主动干事，就是朋友聚会式的讨论\n\n但我们只敢中规中矩做，没有加分，也没有扣分，毕竟及格分总比因为踩雷而重做好吧\n\n美名其曰留一节课给我们问他问题，给他挑刺\n\n拜托，你拿捏着我的绩点，我敢说什么\n\n快期末了，我想活下来\n\n你赢了
128990,2761,章清祥,2020-12-28 03:59:18,21,21,0,快逃！！！！！\n\n作业超多！！！一学期课一半以上是同学的展示！难得他亲自讲课讲了和没讲差不多！而且对同学的成果不怎么尊重，和他想法不一样基本就低分了！
129000,2761,章清祥,2020-12-28 07:45:54,8,8,0,差不多得了 1分不谢
129006,2761,章清祥,2020-12-28 08:37:41,18,18,0,说真的我快被思修折磨致死了，忍不到期末再给他评分了。被他在课上怼哭过，被他四次讨论课两篇调研报告一篇个人报告的任务整绝望过，被坑货组员的不积极折磨过。明明自己无知无逻辑还天天垮起个逼脸吹毛求疵觉得学生千真万确得来的数据是虚假的，你不知道哪张PPT哪句话哪个字就触及他的G点。章清祥，谢谢你，成为了我迷茫大一生活中一记重锤。学弟学妹们如果被预置到他的课千万要记得退，宁可先不上思修也别去他的课堂，心态不好点的人，真的会崩溃的啊。我此前从未没在公开场合骂过人，但这一次我要说：章清祥goubi。
129194,2761,章清祥,2020-12-31 04:56:20,12,12,0,作业巨多，这学期总共上了三节课，其他全是小组展示。小组研究性报告两个，小组讨论三次，个人作业5000字。
129375,2761,章清祥,2021-01-05 00:23:06,10,10,0,随心而言，可配为师？格局太小，姿态太低，此言恶向，汝曾教我？
129380,2761,章清祥,2021-01-05 02:04:47,2,2,0,事多，快逃
129417,2761,章清祥,2021-01-05 06:56:07,8,8,0,事多，快逃！\n\n要学会即时损益，不然麻烦一个学期！
129990,2761,章清祥,2021-01-14 16:07:10,6,6,0,事多分低课烂，快逃
130751,2761,章清祥,2021-01-24 13:02:16,-8,0,8,老师讲的很好，对学生要求很严格
130774,2761,章清祥,2021-01-24 13:56:33,9,10,1,made，就是一个gouniangyangde东西
130863,2761,章清祥,2021-01-25 04:43:42,5,6,1,我不会给他高分
131325,2761,章清祥,2021-01-27 05:40:16,4,12,8,感觉和之前的评论相比，老师已经改进停多了吧....就是小组展示如果涉及法律有关的问题，他就会讲很多（可能和涉及自己专业相关的比较激动吧...）上课有几节课会自由交流，我们提问题然后和他探讨之类的，比起室友的连法律都没上过的思修老师还是要不少的。很幸运遇上了一个很好的小组，绩点上4也满足了w...
131335,2761,章清祥,2021-01-27 06:19:54,12,13,1,事情巨多，三个室友就一篇文章，我直接三次小组讨论，两次小组大作业，一次个人读书报告，讲课都不知道讲些什么，最后给的分又差，快跑!
131338,2761,章清祥,2021-01-27 06:30:51,13,14,1,如果希特勒，墨索里尼和zqx在一间房间里.... 算了算了， zqx🐶👃！！\n\n事情是真的多，快跑\n\n就算改进了什么的，就该推荐选这个老师？\n\n改进难道不是理所应当的？真的想要学生认可你，请从根本上审视一下上课方式和讲话方式。\n\n祝后生好运 ：）））））
131348,2761,章清祥,2021-01-27 07:08:30,8,9,1,老师的作业是真的很多，个人读书报告5000字，小组研究性学习2000-5000字，还要准备10分钟的演讲，老师也很注重PPT的排版等等，要求十分严格，而且老师有时候非常固执，不肯接受与自己观点相左的任何想法；而且开学前文件上说好的还有2次小组讨论莫名其妙的变成了三次，最后的考试也基本全靠自学，唯一的好处就是老师给看了一张历年卷，以及老师法律知识确实很渊博，事多，不过今年给分好了很多，但还是谨慎选择吧。
131350,2761,章清祥,2021-01-27 07:09:53,-22,1,23,期末绩点4.8只要作业认真完成按要求，考试简答题多写字就好了
131394,2761,章清祥,2021-01-27 10:25:57,4,7,3,重视在课堂上传达自己的观点\n\n作业比其他老师多好几倍\n\n绩点正常 \n\n骂学生什么的我作为20届没见到\n\n\n\n平时作业我们组做的都OK，不过我答思修类课程的能力一般。 卡线4.2\n\n建议：\n\n预置拿到可以不换 \n\n但预置不是他别选
131505,2761,章清祥,2021-01-27 23:21:15,0,3,3,老师挺好的，就是有时候是完美主义，以及有点坚持自己观点，我是2020-2021学期的，没有绩杀，我4.5。pre挺多的，但只要认真准备老师的pre，老师提出错误你们申请修改后重新展示、重新提交作业，老师也是能理解的。
131551,2761,章清祥,2021-01-28 03:43:47,4,6,2,给分正常，课不行，事多
132489,2761,章清祥,2021-02-02 02:50:19,-1,5,6,给分还行，人不行，上课事情特多
134792,2761,章清祥,2021-04-15 07:30:24,9,10,1,“你们联合学院性质上是民办学校”\n\n“就像浙江大学城市学院转成公办前没有区别”\n\n那您可真厉害，法务真不戳。
140522,2761,章清祥,2021-09-13 09:25:04,-18,3,21,我觉得挺好的，非常合我胃口。
142224,2761,章清祥,2021-11-09 01:42:52,12,14,2,快跑！
142231,2761,章清祥,2021-11-09 03:14:43,13,14,1,自己水平不行，还说学生自己辛辛苦苦写的内容是抄的，永远认为自己是对的，有什么话好说呢？快逃
142662,2761,章清祥,2021-11-15 03:10:12,15,17,2,本来以为这学期已经不用再做小组展示了。刚刚交完一篇论文，马上又给我们布置了一次小组作业。真谢谢你啊😄。选到了这人的课是真的晦气。纯÷生
143119,2761,章清祥,2021-11-19 07:43:02,5,7,2,哈哈哈😁
143597,2761,章清祥,2021-11-28 09:09:40,7,8,1,屁事巨多，上课巨水，把教书当做副业的人能教成啥样，赶紧清退吧
143783,2761,章清祥,2021-12-06 06:46:16,12,12,0,事情超级多，当成锻炼ppt制作和写稿的好机会，组员一定要能干事，不然组长🐶都不当，快跑，预至的也要跑，快跑
143947,2761,章清祥,2021-12-13 23:28:45,7,7,0,事情真的太多了
144391,2761,章清祥,2021-12-21 10:08:17,-9,7,16,老师有在变好。座位按组坐，大概也能知道哪些人没来。事多是真的，一学期五次pre。ppt做得好看很占优势。
144621,2761,章清祥,2021-12-23 00:41:35,8,9,1,作业太多
145651,2761,章清祥,2021-12-31 02:42:00,-9,3,12,人挺好，挺负责
146272,2761,章清祥,2022-01-06 05:58:41,-9,2,11,挺好的其实
147103,2761,章清祥,2022-01-08 17:11:34,10,12,2,事多分低，快逃，组长就是锅王
147107,2761,章清祥,2022-01-08 17:25:00,19,20,1,zqx什么玩意，组长写东西写到半夜就给这成绩，天天喜欢怼人，脑子里也不知道装的什么玩意
147109,2761,章清祥,2022-01-08 17:32:45,7,7,0,jb东西
147111,2761,章清祥,2022-01-08 17:50:14,9,9,0,事情踏马贼多 就一点不重视学生努力的成果 思修是这么上的吗？？
147114,2761,章清祥,2022-01-08 17:49:33,15,15,0,傻逼，想不明白为什么认认真真写作业还是绩点这么低，当时我预置的老师里面没有zqx然后就很无语被分到他的班，看来就是大家都不选剩下的。作业超级多，一个学期五次展示，三篇几千字的报告，别的老师没什么事情分数还很高，这傻逼就离谱，屁事多绩点还低，就是绩杀，千万不要选他的课，就算是大二再学思修也不要选他的课！
147116,2761,章清祥,2022-01-08 18:04:34,6,6,0,jb老师想想为什么别的老师评分都很高，屁事多打分低，学生认真完成作业也不放在眼里，沙币
147122,2761,章清祥,2022-01-08 23:50:34,5,5,0,垃圾一个
147134,2761,章清祥,2022-01-09 00:41:26,-21,4,25,上的挺好的
147172,2761,章清祥,2022-01-09 03:18:55,18,19,1,我cnm的zqx，作业给这么多，分给这么低。上课还很喜欢打断学生讲话，真是畜生一个。
147271,2761,章清祥,2022-01-09 10:52:27,-27,5,32,（886出品）作为组长加班长，庆幸有好组员，第一次小组作业主导分锅，后面的讨论，小组研究全程划水。上课不听讲，考试不复习，还有4.2。感谢章老师。
147273,2761,章清祥,2022-01-09 10:59:35,6,8,2,就去上了第一次课后面就没去了，给分3.9还行吧，不过真是苦了那些去上课，认真完成作业的同学了
147668,2761,章清祥,2022-01-10 11:51:30,13,14,1,如果你希望自己认认真真做事，努力不要白费，选到他的课赶紧退了，一定要快点退掉
150397,2761,章清祥,2022-01-24 08:17:58,10,11,1,为什么没有0分
152469,2761,章清祥,2022-04-12 10:26:27,11,12,1,我的大一上。。。👿
152773,2761,章清祥,2022-04-19 13:45:21,6,6,0,给分。。。呵呵。。。忙了一整个学期，最后3.3，不理解给分标准是什么，绩点都差在了平时分上。。。有的人翘一整个学期的课，绩点还比认真学的人高。。。无语，评分这么低是有原因的
154212,2761,章清祥,2022-05-26 05:34:34,-9,2,11,其实老师还可以
156841,2761,章清祥,2022-06-21 05:59:04,11,13,2,不要选，如果是预置能退尽量退掉，他没有水平，也没有态度（这个可能是我一面之词），对待学生很恶劣。我作为组员觉得我也算尽心尽力了，但我组长是真tm的划水，我最后3.6，不谢，我认了，我菜，而且我知道还有比我更惨的人。
160527,2761,章清祥,2022-09-26 02:07:17,7,7,0,烂。真的烂。
160881,2761,章清祥,2022-10-18 02:59:21,3,3,0,无语，事多得要死，室友就期末一篇论文我tm一学期有3篇，快点跑
161108,2761,章清祥,2022-10-27 07:00:14,4,4,0,怎么还有3分？
161119,2761,章清祥,2022-10-27 14:15:33,7,7,0,考试周布置五千字小组作业真的绝了
161120,2761,章清祥,2022-10-27 14:15:33,9,9,0,论考试周布置5000字作业这档事
161156,2761,章清祥,2022-10-30 02:45:20,2,2,0,垃圾，搞得我大一就忙死，作业紧的要死，选课要避开
161419,2761,章清祥,2022-11-07 01:23:32,6,6,0,事多评价迷，只要不符合他的观念就不ok啦 会说你们糊弄他没有端正态度。。。。。。。。。被一顿批
161421,2761,章清祥,2022-11-07 01:34:00,5,5,0,本来看评分很忐忑，上了第一节觉得老师还不错。然而今天早八真的是让我大开眼界。完全不听解释，小组作业0分说给就给，上课直接无下限批评。不要选，预置的也快退！！！
161422,2761,章清祥,2022-11-07 01:37:34,6,6,0,真的劝大家别选他的课，进ZJU遇到的排名第一傻逼的老师，上课小组讨论一骂骂一个班，做他的小组作业只能调查问卷，不然就给你低分骂你不好好做，写论文千万别看任何网上的资料，一点也别看，不然就说你是堆砌别人的观点！！
161432,2761,章清祥,2022-11-07 02:22:17,3,3,0,为什么没有0.....
161434,2761,章清祥,2022-11-07 02:35:03,5,5,0,骂学生态度不认真😅明明都有认真写，就他这里瞧不来那里瞧不来，以为你自己很牛逼是吧。呵呵😄事多分低的评价可能是高估他了，对待学生态度更恶劣。
161471,2761,章清祥,2022-11-07 10:48:29,2,2,0,作业太多啦
161505,2761,章清祥,2022-11-08 02:26:25,0,0,0,作业多了
161813,2761,章清祥,2022-11-14 01:11:17,5,5,0,一个字\n\n跑！
161887,2761,章清祥,2022-11-15 00:34:59,5,6,1,真的不要逼我骂人\n\n有人不退他的课我都会同情你的
161890,2761,章清祥,2022-11-23 03:41:56,5,5,0,。。。
161891,2761,章清祥,2022-11-15 00:48:58,-1,0,1,6   6    6
162123,2761,章清祥,2022-11-17 02:15:56,5,5,0,能退就退吧，别的也不想多说了
162423,2761,章清祥,2022-11-22 05:07:41,6,6,0,后悔没有弃修，现在觉得很无语，思修作业成了大头 服了，只求别绩杀，不然回来再骂一遍
162938,2761,章清祥,2022-12-06 18:29:55,7,7,0,不知道怎么骂，你们细品
163737,2761,章清祥,2022-12-16 04:31:06,10,11,1,怎么说呢，我是14级的，现在是22年，每次回想起本科生活还是忍不住想骂他，浙大7年最恶心的事就是遇到这么个人。整个学期都在给我们传递“你是个垃圾，坐在这读书是你的福气”这种观念。他的思修是我进入大学上的第二堂课，整个人都要自闭了，以为大学就是这种环境，他带给我的阴影至少花了两年才走出来。
163875,2761,章清祥,2022-12-16 10:38:09,6,6,0,预置了赶紧跑\n\n会骂学生认真做的作业\n\n真的无语
164001,2761,章清祥,2022-12-17 08:01:30,4,4,0,快跑，纯纯nt
164176,2761,章清祥,2022-12-19 01:12:37,7,7,0,÷生😅😅😅
164625,2761,章清祥,2022-12-22 09:35:44,9,9,0,大一上遇到的最烂的老师......
164644,2761,章清祥,2022-12-22 12:28:25,4,4,0,捏吗 傻逼真傻逼 快跑
165162,2761,章清祥,2022-12-29 12:44:17,5,5,0,依托答辩
166369,2761,章清祥,2023-01-12 05:52:45,2,2,0,。。。
166383,2761,章清祥,2023-01-12 06:28:05,3,6,3,虽然最后绩点还行，但zqx真的是我这个学期遇到的最差的老师，完全不懂得尊重学生，感觉自己很nb一样，会把情绪带到课堂上，发泄在学生身上
166413,2761,章清祥,2023-01-12 08:00:00,5,5,0,数不清的小组作业和连骂两节课的周二早八。感恩zqx让我的这一学期足够充实。。呵呵。。如果不退zqx的预置课那你的美好的心灵有趣的灵魂都要消失啦
166415,2761,章清祥,2023-01-12 08:01:22,1,3,2,个人任务多（讨论、展示、论文），老师哲学+法律出身，比较计较某些法律问题的细节，其他的都还好吧，无绩杀。
166453,2761,章清祥,2023-01-12 09:42:28,-1,2,3,老师确实要求比较严格，但是为什么最后给分还不错，也没有那么不好
166632,2761,章清祥,2023-01-13 05:44:42,6,6,0,认真完成个人读书报告，完全自创不是缝合论文，小组作业我也算是担当，期末开卷答的也不错，绩杀我直接给一分，作业多事多，认真完成换不来一个好结果
166633,2761,章清祥,2023-01-13 05:47:44,0,1,1,事多，给分一般
166672,2761,章清祥,2023-01-13 08:04:05,2,2,0,事多，骂的也惨555快逃
167047,2761,章清祥,2023-01-14 17:20:25,-1,2,3,事多，但分不少🤣就是课➕老师➕打分都比较玄幻😂
168242,2761,章清祥,2023-02-05 13:39:35,-1,3,4,给分还可以，没有想象中的那么差。老师比较严肃较真，讲课大部分不讲书本，事也确实比较多。不算是理想型的老师，但也不差。
168332,2761,章清祥,2023-02-12 07:39:17,6,6,0,从来没见过事情这么多的老师，这个学期有一半的论文竟然是在写思修的研究性学习论文。组长就是接锅侠。他也知道肯定没什么人愿意做他的组长，所以一开始就随机分组随机选组长。我就是个怨种。小组展示评价很迷。我们辛辛苦苦准备好久的展示结果被骂的要死，随便找的东西结果被说还不错。反正就是标准实在是太迷。给分不会很差，但是真的不会开心。
169450,2761,章清祥,2023-02-26 08:09:23,1,4,3,给分一般，可能是那么多年来改观了吧，一开始看他评分3点多吓懵了都，后面发现还可以吧，不是那么不能选。
172070,2761,章清祥,2023-04-18 16:25:34,0,0,0,house
172165,2761,章清祥,2023-04-21 03:49:42,9,9,0,浙大不可能有第二个zqx，希望下一届同学理智选择。具体怎么个烂法，看上面几条评论
172751,2761,章清祥,2023-05-06 05:42:42,1,2,1,真的很垃圾、、、、绩杀、事多、、完全不尊重学生
172836,2761,章清祥,2023-05-08 06:00:56,0,0,0,也中东西
172995,2761,章清祥,2023-05-11 03:16:22,2,2,0,两个法学基础通识班没啥人报，被迫取消，懂得都懂
173235,2761,章清祥,2023-05-16 10:48:56,0,3,3,给分蛮不错 据我所知我们组好像都上4.2了 有几个4.8的 但是但是！事情是真他妈多啊 两三次pre加上两三篇大论文 还有啥ppt要做的 思修能有这么多事真有你的zqx
173961,2761,章清祥,2023-06-05 08:44:44,8,8,0,每次选课前看査老师上4.几的老师的时候就会来看一眼zqx，这个时候就会原谅那些老师。去年上的他的课，很迷惑，认真做的被批没逻辑，随便做的被夸有重点，也不知道他在评论些什么。上课讲的东西没有什么可以吸收的地方，但是很喜欢吹自己。培养学生能力我能理解但是骂学生是垃圾无法苟同，在他课上唯一的收获是学会了论文的格式以及一群同仇敌忾应对老师的小组成员。
175304,2761,章清祥,2023-06-23 13:08:18,0,2,2,作业认真写了，感觉给分还行
179334,2761,章清祥,2023-09-11 17:15:58,4,8,4,22-23秋冬\n\n在课上认识了她，成为了无话不谈的好朋友，最后她拒绝了我，成为了我上大学第一个遗憾。\n\n事情的确很多，也许因为疫情的原因，期末开卷考，对政治选考生很友好，最后给分就也还好。\n\n好遗憾，好遗憾。
181765,2761,章清祥,2023-10-31 06:41:33,7,7,0,学生认真写作业，在你嘴里就是没有态度，认真写几千字文章，在你眼里就是抄袭，认真给你作报告，在你眼里就是没有逻辑，狗屁不通。摆出一副无所不知的样子不接受反驳意见，我不知道你是怎么当上的老师，何况是思政老师。我作报告你抬头了几次，人名例子国籍都记不清楚，说什么都是你知道，你看过，尊重他人就这么难吗。不懂交流，情商极低，吹毛求疵，不允许学生犯错，这就是你教书育人的态度？
181910,2761,章清祥,2023-11-04 14:15:54,1,1,0,傻逼老师
181948,2761,章清祥,2023-11-06 07:37:56,1,1,0,笑死，雷区居然是个人喜好
181963,2761,章清祥,2023-11-06 15:02:07,0,0,0,也中老师
182060,2761,章清祥,2023-11-09 07:20:44,1,1,0,真的不知道为什么有人给他打一分以上
182071,2761,章清祥,2023-11-09 12:35:18,4,4,0,宁可选不上也最好不要上
182124,2761,章清祥,2023-11-10 10:07:59,1,1,0,作业多....
182190,2761,章清祥,2023-11-12 05:42:07,4,4,0,依托答辩，作业巨多，自以为是
183886,2761,章清祥,2023-12-02 13:44:13,1,1,0,受不了
183947,2761,章清祥,2023-12-04 13:02:17,3,3,0,有些时候，老师要有自知之明。
184164,2761,章清祥,2023-12-11 14:34:53,5,5,0,laji
185164,2761,章清祥,2023-12-27 02:05:01,5,5,0,后来的同志如果预置到他的课千万要换，一学期思政三次小组作业+两次讨论+一篇书评，事情最多的存在。
185447,2761,章清祥,2023-12-29 11:33:25,3,3,0,laji
185451,2761,章清祥,2023-12-29 12:07:32,4,4,0,垃圾老师，自以为是，表面说一套，实际做一套，上课纯无语。。。。
185718,2761,章清祥,2024-01-04 01:15:47,3,3,0,事情巨多
185894,2761,章清祥,2024-01-05 14:16:03,6,6,0,《论为什么我不推荐任何人以任何理由选择这位老师》\n\n一学期，1篇读书报告和2篇小组论文字数要求5000+含金量（许多老师给的字数要求不仅低而且甚至是上限，这位牛，5000字甚至仅仅是下限，作为工信牲写这5000+论文，让我看线性代数，微积分和C语言程序设计的极霸题目都赏心悦目起来了，属实是小刀割辟谷，开了大眼了），小组作业PPT做好了以后还要被各种指责，对待学生的态度上属于小杯水平，要不是志愿者活动作业只要做了一次志愿者活动（不限活动时长）就能完成要求，就凭这个对学生的态度，我都不想给出2分。\n\n因此，我在这里不建议任何人以任何理由选择这位老师，除非你担心预置的这门课程退掉之后再次选择没能抢到更好的老师的课程，否则建议是快跑。（据说给分还行，那就自行斟酌吧。）\n\n本评论写于2024.1.5，评论内容仅代表个人观点，后来者如果看到了这条评论，请大家在观看评论的时候自行分辨，也希望看到这位老师以后对待学生的态度能有所好转。
186100,2761,章清祥,2024-01-08 10:46:47,3,3,0,一条狗
187647,2761,章清祥,2024-01-17 03:12:31,6,6,0,事多给分差
187676,2761,章清祥,2024-01-17 05:25:59,5,5,0,卡我绩(｡•ˇ‸ˇ•｡)
187689,2761,章清祥,2024-01-17 06:41:46,6,6,0,事多绩杀
187749,2761,章清祥,2024-01-17 09:54:58,0,2,2,给分4.5
187759,2761,章清祥,2024-01-17 10:06:30,1,1,0,呵呵不说了，看评论吧
187845,2761,章清祥,2024-01-17 14:48:04,5,5,0,每次上课都在，作业好好写了，考试卷子好好做了，但是绩杀
187962,2761,章清祥,2024-01-18 02:01:34,17,17,0,天杀的玩意，讲课和史一样，事还多还恶心，室友老师一学期一个读书报告思维导图，zqx三个5000字论文，志愿者活动别老师都没什么要求，这玩意要ppt还不少于多少页，辛辛苦苦一学期写了1.5w字+n次展示+n次课堂讨论，期末认认真真答了两个小时，答题纸写一大半，出分3.6还绩杀，真不知道这种玩意怎么在浙大待下去的
187987,2761,章清祥,2024-01-18 02:51:14,10,10,0,千万不要选！！！思修作业是所有老师里面最多的，两次五千字小组作业+个人五千字读书报告+3次小组讨论+志愿活动PPT。光是做作业的时候就已经在寝室里破口大骂。而且正常思修老师给的评分都是4＋，zqx呵呵一般不会超过四，钉钉私信也不回，上课数人数+数字签到。选他的课就是吃力不讨好，真的是让我知道了在什么情况下应该果断退课。选不上课都比上他的课好呢。快逃！！！
188268,2761,章清祥,2024-01-18 13:56:58,4,4,0,真的绩杀
188308,2761,章清祥,2024-01-18 15:17:16,1,1,0,看自己吧
190202,2761,章清祥,2024-02-25 10:24:15,9,9,0,课堂展示对同学作品批评严重，作业任务相当重，别的老师一学期总共一两千字的任务，章老师的学生一个学期要写10000字左右的文章，给分也不尽人意，供参考。
193767,2761,章清祥,2024-06-17 15:31:17,2,2,0,事多分少，绩杀，23-24学年秋冬
203969,2761,章清祥,2024-11-22 09:36:10,3,3,0,垃圾，不配为师，14年入学，已经10年了，其间查老师域名不知道换了多少次，每次想起都忍不住来控诉。不把学生当人，认为女生都会去当小三借私生子上位，怕不是绿帽子戴多了。18岁三观还在逐步建立的阶段被这种恶魔讽刺打压侮辱，不知道害了多少学生。
205740,2761,章清祥,2024-12-12 01:24:27,1,1,0,垃圾，无法用理性语言评说
208457,2761,章清祥,2024-12-28 06:08:07,1,1,0,虽然已经大二了，但是看到朵朵十大jsy老师多么多么好，还是忍不住回来再骂一遍
15022,2834,潘恩荣,2016-01-11 14:14:41,13,23,10,不好说…
23685,2834,潘恩荣,2018-03-06 01:45:07,25,33,8,这种老师也配上课不让用电脑？
25635,2834,潘恩荣,2016-05-30 06:40:12,8,14,6,讲这么差还不让用电脑
30424,2834,潘恩荣,2016-07-01 14:13:03,8,11,3,给分感人呵呵
30425,2834,潘恩荣,2016-07-01 14:19:02,2,4,2,感觉……没什么感觉。
30883,2834,潘恩荣,2016-07-02 21:39:46,-4,6,10,讲道理不会挂你，平时分一般80+，不缺考就行...（听说高永是给挂过的）但是，一个班近百个人，90+的一只手数的过来...毛概想拿高分就慎重考虑一下...
31908,2834,潘恩荣,2016-07-05 06:47:59,10,11,1,给分低
32750,2834,潘恩荣,2016-07-12 08:31:36,-11,1,12,有自己的思想，有自己的个性。比较适合理工学生去学的毛概
34854,2834,潘恩荣,2016-10-25 07:37:11,9,12,3,思想有问题
34965,2834,潘恩荣,2016-10-27 07:39:12,-5,6,11,上毛概课居然在讲怎么学好工科，怎么考工程师执照，怎么造好轴承轮胎。。
35356,2834,潘恩荣,2016-11-09 06:14:22,-9,5,14,理工科学生去听收获蛮多的
36448,2834,潘恩荣,2017-01-24 20:39:23,2,7,5,不讲课程内容，讲自己的经历与体会，闲的话可以一听~
40499,2834,潘恩荣,2017-01-04 01:27:50,9,11,2,呵呵呵
40713,2834,潘恩荣,2017-01-05 05:46:02,8,11,3,不想说什么hhh
46445,2834,潘恩荣,2017-01-21 14:46:40,8,11,3,垃圾啊
46481,2834,潘恩荣,2017-07-01 04:38:47,-5,13,18,作为毛概课的老师，潘老师真的做得很不错了。给分没有乱给，每一分都有迹可循，这点就很棒。上课讲得真的可以的，工科生表示听起来还挺有意思的。
46623,2834,潘恩荣,2018-05-10 10:08:51,-2,7,9,老师真的很棒，上课前说清楚规则，之后全靠自己的，考试前好好背书，老师真的会给很好的分数。
49478,2834,潘恩荣,2017-04-16 10:29:10,34,43,9,话不多说，垃圾一个
49505,2834,潘恩荣,2017-04-17 08:05:42,-12,2,14,老师人很好啊～超温柔而且讲课很耐心
51206,2834,潘恩荣,2017-05-24 05:23:39,18,25,7,好像自己学过工科就很值得炫耀一样，张口闭口一个“我是工科背景的人”，讲的烂还不让用电脑，老师你这是在谋财害命啊
55165,2834,潘恩荣,2017-07-01 02:29:42,11,13,2,为什么没有零分这个选项
55205,2834,潘恩荣,2017-07-01 03:39:49,-11,4,15,潘老师认真负责，给分透明
55665,2834,潘恩荣,2017-07-02 06:41:24,-11,4,15,老师很有趣呀，而且很温柔，特别像我的一个好朋友XD给分良心事情少！\n\n啊思政课没了……啊满足?
55678,2834,潘恩荣,2017-07-02 07:20:44,14,17,3,数学系的……表示毛概居然能比专业课的成绩低？？？最后一门思政课了不能给我个善始善终？ 诶一言难尽。而且毛概小组还要出去调研 讲真花了蛮多时间的。。。
56107,2834,潘恩荣,2017-07-03 05:31:59,9,12,3,负分滚粗
75143,2834,潘恩荣,2018-03-07 13:28:08,17,17,0,老师看起来很理性，但我目睹他不到一分钟给我们的最后报告论文打分，心都凉了
78267,2834,潘恩荣,2018-05-10 09:24:30,10,19,9,我不明白为什么在21世纪第二个十年，居然还有高校老师在课堂上用九十年代的现在已经毫无市场被无数次证伪的“河殇”的观点，用所谓的“海洋文明”这种及不准确的地理历史决定论断去论证西方文明的先进性。人类的存在就会创造历史，以一时的历史的兴盛与衰落去论断一个民族的文明的好坏极不准确，决不科学。\n\n我觉得老师这样灌输毒药，原因有三：第一，老师的知识水平确实需要更新换代了！第二，老师经常强调自己的工科背景，也难怪乎知识水平不够，毕竟体育老师也不一定上得好数学课嘛，可以理解！第三，我有点明白浙江大学为什么这些年来一直引进高水平人才了。
78358,2834,潘恩荣,2018-05-11 05:46:34,-2,4,6,很差。配对的组员也很差。炒鸡没有责任心的一个老师，一门思政课，上的毫无意义。差评
80636,2834,潘恩荣,2018-06-28 14:47:24,-2,2,4,我觉得不错。
81532,2834,潘恩荣,2019-09-06 09:09:48,-67,15,82,非常好的老师，很温和没说过一句重话，一点架子也没有。\n\n楼上那个喷子是16级混合班吴雨初，竺院学生就这种素质？你? 今晚必死
81668,2834,潘恩荣,2018-07-05 23:32:56,2,2,0,………………
81856,2834,潘恩荣,2018-07-06 10:15:25,6,6,0,不评价课程怎么样，分到的队友烂到爆炸，毛概组是我待过最差的小组没有之一
81883,2834,潘恩荣,2018-07-06 11:28:55,-1,2,3,老师我觉得没什么毛病给分完全公开透明，平时分主要看小组调研和课堂发言，期末把重点章节看了基本稳了
81919,2834,潘恩荣,2018-07-08 02:01:08,-29,8,37,傻逼玩意，一个学期下来每节都到课，除了最后一节因为太忙没有去，结果平时分只看那一次签到，那一次没去就少3分。然后总成绩卡在82.4，只要再加0.1分绩点就能高0.3，结果他说有旷课记录不给加。呵呵哒，怎么会有这种人，为什么没有-10分。
82329,2834,潘恩荣,2019-01-15 08:42:21,-10,4,14,抱歉一时激动，第二天冷静下来想改发现改不了了。麻烦把我的评价举报掉吧。\n\n\n\n我只是觉得老师的评分规则挺不合理的也显得不负责任，另外因为0.1分卡绩点不肯调分也很难让人有好感。就这样。
86573,2834,潘恩荣,2018-09-17 08:54:04,4,4,0,墨水不多 牛逼哄哄
86882,2834,潘恩荣,2018-09-19 06:57:53,3,4,1,老师地域黑。\n\n这个没得洗。
92966,2834,潘恩荣,2019-01-06 11:29:55,7,7,0,辣鸡老师，调研完写了调研报告5000字，最后倒数第二周才说不要调研报告只要案例分析，呵呵→_→。
93048,2834,潘恩荣,2019-01-07 06:17:33,5,5,0,调研报告辛辛苦苦写好了，结果最后两周了突然变卦，要求交案例报告，和调研内容没有关系。\n\n也不知道他怎么想的。
93991,2834,潘恩荣,2019-01-14 15:22:32,5,7,2,为什么没有零分啊啊啊\n\n最后一组展示就不听了吗？\n\n不听你还打低分？啊？!\n\n你倒是讲讲哪儿做的不好啊！\n\n然后第一、二组先展示就加分?\n\n为什么加分啊?顺序不是你定的吗?\n\n一开始讲了先讲就加分吗？\n\n哇，真的不服。。\n\n另外和其他老师横向比\n\n凭啥分低呢？唉。。。\n\n
94006,2834,潘恩荣,2019-01-16 02:10:39,7,9,2,吐槽某组上台演讲的那个同学真是废话连篇逻辑混乱令人反感啊 强忍着打人的欲望看PPT还是挺有内容的 不知道为什么是这样一个人上台演讲？？？？ 不仅我们不喜欢你 你大概也坑了你们整个组吧hhh
96553,2834,潘恩荣,2019-01-21 06:21:49,0,2,2,老师挺好的呀！不过我知道肯定有一部分人会在考前来看评论考虑要不要复习毛概ヽ(•̀ω•́ )ゝ那么我很负责的告诉你，一点都不复习应该不会挂科，但是得分可能会很低，刚及格那种。只要考前看看重点章节好好背一下，复习个一两个小时应该能拿到80分以上的。
102832,2834,潘恩荣,2019-02-24 02:17:38,-2,0,2,还可以
114664,2834,潘恩荣,2019-07-11 03:02:17,2,3,1,无聊 给分极烂
124348,2834,潘恩荣,2020-06-29 13:30:07,1,10,9,潘老师超级好♥，爱了爱了，虽然没满，但感觉体验很棒
124349,2834,潘恩荣,2020-06-29 13:31:08,2,5,3,刚出分，来评一下。今年疫情原因，前面各位评论说的缺点基本都没出现，但是也没什么出彩的地方，小组分配到87的平时分，总评没有被正态下去，还行了。不过，几千字的那个调研报告的打分，实在过于随意，这个作业是课程后期交上去的，才交上去没多久就给分了，而且很多分数都是类似于80和85这样的，感觉不是很认真，马院的其它有一些老师会给评语，指出不足，告诉我们扣分在哪里。总体来说，没有感到潘老师特别恶心，光就网课而言是个可以选的老师，但也没有什么特别优秀的理由来推荐他而不推荐其它老师。以上。
140637,2834,潘恩荣,2021-09-14 14:23:57,3,5,2,老师人很好，治学严谨，值得尊敬🙏
151252,2834,潘恩荣,2022-02-26 03:15:30,2,3,1,差，很差，非常差，自己根本不会上课还对学生要求高，可笑的垃圾老师
154866,2834,潘恩荣,2022-06-06 09:20:14,3,3,0,水平好拉…
155845,2834,潘恩荣,2022-06-16 08:50:43,-4,0,4,老师应该不会调分，不知道为什么评论要这样，小组展示的点评部分讲得我觉得还蛮言之有物的
157437,2834,潘恩荣,2022-06-23 08:21:02,-4,2,6,好老师！至少事情不多，讲课也还可以，给分挺好的！本来这学期毛概期末考感觉炸掉了，平时分结算的时候也扣了十来分，结果总评竟然意外的好！
165316,2834,潘恩荣,2022-12-31 13:16:34,2,4,2,其实是个很善良的老师
174434,2834,潘恩荣,2023-06-12 06:33:20,5,5,0,老师和助教都是一坨🗑️
176011,2834,潘恩荣,2023-06-27 12:04:47,5,5,0,给分超烂
176742,2834,潘恩荣,2023-06-30 03:29:06,2,3,1,好像会调分？
177271,2834,潘恩荣,2023-07-02 13:12:22,3,4,1,毛概课是几个老师轮流上的，没什么可说的。不过感觉潘老师的课不是很卷。
184249,2834,潘恩荣,2023-12-14 02:56:39,-7,1,8,傻屌玩意\n\n无比庸俗\n\n给我死
185784,2834,潘恩荣,2024-01-04 10:46:47,2,4,2,学弟学妹们，平时上课他说小组发言会加分，这个发言一定要发言！！！否则你最后的分数会非常难看，非常非常低！！他根本不是加分，而是直接把这个算这一部分一半的分数，如果你不发言这部分直接0分，明明每节课都做了但是因为没有上去读一遍，分数超低
185875,2834,潘恩荣,2024-01-05 06:54:30,2,3,1,感觉老师还好吧，期末平时分都是一项一项公开的，而且平时分的规则也是在学期初说了的（可能没有说细则，这一点上是有所欠缺的），也要求小组内部制定了平时分的细则，课也不是很卷，随堂作业的负担也不重，就是论述一下他课上给的问题。讲课算是无功无过吧。给的发言机会其实也不少了，每节课基本上都有好几个小组有机会发言。
187404,2834,潘恩荣,2024-01-16 02:57:47,7,7,0,上的习概 总结是事不算少但给分好！\n\n老师虽然会很严谨地测算平时分（算一整节课的那种），但还是会暗戳戳地调分😋人还是挺好的！\n\n平时分大头还是在课后小组讨论发言，鼓励想高绩点的多卷一下这个（我们组就因为这个和别的组分数差了很多🥲\n\n期末考试开卷而且挺捞的，带够材料就是抄就行\n\n看到分数真的很惊喜 谢谢老师🥰🥰🥳
188945,2834,潘恩荣,2024-01-20 17:23:40,2,2,0,课程特色的事情怨不得他
190387,2834,潘恩荣,2024-02-29 07:17:10,4,4,0,纯吹牛，上的AI伦理课事情贼多。又是辩论又是1w字论文，慎选！！！！！！！
195162,2834,潘恩荣,2024-06-27 03:52:05,4,4,0,习概：\n\n又是毫无意义的一门思政课，纯粹浪费时间\n\n授课内容不知所云，而且上课只有寥寥几个例子翻来覆去反复讲，即使没在认真听都能明显感觉到一个例子反反复复讲了几节课，感觉老师也完全没有东西可讲，只是为了水时间\n\n考核的话平时就两三次点名，平时分基本都是小组任务，一个好的小组很重要。最后会浪费一次课的时间来非常细致地算平时分，也会根据情况调分，不卡绩好评\n\n期末考试开卷考，随便狂抄两小时即可，分数相差不会很大
197719,2834,潘恩荣,2024-08-04 09:45:31,4,4,0,垃圾啊
972,3100,王东莉,2015-03-19 17:09:03,-16,12,28,上课轻松，给分很好。
1584,3100,王东莉,2015-03-22 16:35:36,10,24,14,上课超级严，两年前上思修上课完全不让做其他事。最后给分也低
2782,3100,王东莉,2015-05-07 07:27:11,-13,7,20,上课内容丰富，观点很新。给分非常好。
4278,3100,王东莉,2015-06-18 13:50:25,-3,9,12,很有修养，事少，人很好，上课还算有趣。
5706,3100,王东莉,2015-07-09 07:46:13,35,50,15,没兴趣，只是因为沟通与领导必修才选的…平时作业再认真考试再认真，也比不过上课与老师互动答题的记录，让觉得问题很幼稚，不愿意回答的只能呵呵ㄟ(▔，▔)ㄏ
6681,3100,王东莉,2015-07-18 11:13:36,-2,20,22,老师素质高，思修嘛讲什么也不听的，事情不多，给分至少我认为很好。
7587,3100,王东莉,2016-11-27 16:06:25,-6,5,11,非常好！就是有时会有很多事。
8037,3100,王东莉,2015-09-16 15:27:19,-18,7,25,很负责任，教授级别的，一点也不水，极力推荐
8119,3100,王东莉,2015-10-28 08:30:58,-11,5,16,很好的老师，水课一点都不水
8310,3100,王东莉,2015-09-18 07:04:09,3,11,8,人很和蔼\n\n
8622,3100,王东莉,2015-09-23 08:16:58,1,11,10,有趣哦，但课堂问题有点水。。。
8642,3100,王东莉,2015-09-23 12:17:24,-4,9,13,老师非常认真，教的素质非常高，比一般的思政老师要好得多。最关键的就是上课一定要积极举手回答问题哦。
8709,3100,王东莉,2015-09-24 08:40:53,-13,4,17,有感情，很吸引人
8869,3100,王东莉,2015-09-29 06:20:26,17,26,9,作业坑爹
8871,3100,王东莉,2015-09-29 06:36:58,39,59,20,作业太坑\n\n
9012,3100,王东莉,2015-10-09 08:37:42,64,142,78,思修，问的问题很幼稚，过时的心灵鸡汤，中国梦为主题的微电影，感觉整个人停留在几十年前，无趣古板，明明有那么多时事可以讨论非得接着搞初中政治课那套，奇怪分这么高
9214,3100,王东莉,2016-06-21 11:08:10,51,75,24,上课就是死命给学生灌心灵鸡汤，学不到一点有用的东西，差评！
9402,3100,王东莉,2015-10-26 06:56:27,53,74,21,其实我上课超级认真，就是不喜欢回答问题。看到好多回答完问题的就倒头睡下。超级不爽。不知道为什么把回答问题看那么重。我真的认真听了。
9464,3100,王东莉,2015-10-28 10:37:42,11,22,11,其实老师备课很用心，就是事多…
9558,3100,王东莉,2015-10-31 03:38:03,42,66,24,作业奇多奇烦。搞得好像我的专业是思修一样。
9604,3100,王东莉,2015-11-02 15:48:43,60,72,12,过分看重举手。提的问题又毫无讨论的价值。\n\n
9632,3100,王东莉,2015-11-03 11:02:16,1,5,4,能给人阳光
11172,3100,王东莉,2015-11-25 03:12:43,2,9,7,想听课的还是算了。
11430,3100,王东莉,2015-12-01 04:11:06,5,15,10,超讨厌这个老师。
11573,3100,王东莉,2015-12-06 10:23:52,21,34,13,总之就是要举手发言，如果最后评分不好真是觉得自己浪费时间，还不如刷微积分去。。。那些好评的人呵呵我都不想吐槽了
11690,3100,王东莉,2015-12-11 12:57:51,7,12,5,作业真坑啊
11794,3100,王东莉,2015-12-15 14:30:28,3,6,3,擦擦擦
12094,3100,王东莉,2015-12-21 17:59:14,5,9,4,作业多，其实挺好的老师，很有修养
12167,3100,王东莉,2015-12-22 06:40:33,10,20,10,回答提问就有加分，结果基本每次都提问那几个人，只能呵呵了
12511,3100,王东莉,2015-12-23 11:50:18,1,2,1,作业太多！
12561,3100,王东莉,2017-09-18 05:40:52,11,15,4,认真负责，然而作业超多，上课问题超无聊，却很看重举手次数
12568,3100,王东莉,2015-12-23 13:32:19,6,10,4,老师很和蔼，但是作业真的有点坑爹，微电影！还好完成得不错
13191,3100,王东莉,2015-12-25 05:48:06,2,4,2,挺无聊的
13726,3100,王东莉,2015-12-30 12:10:05,-2,3,5,给分还好\n\n
13875,3100,王东莉,2016-01-01 11:57:26,0,4,4,很敬业的好老师~
14080,3100,王东莉,2016-01-04 06:22:21,7,11,4,过分注重举手，作业多，助教还挑这挑那的
14137,3100,王东莉,2018-01-13 04:34:27,27,37,10,我觉得我坐在小学教室里
14381,3100,王东莉,2016-01-06 15:36:20,4,8,4,事儿逼 必点名
14907,3100,王东莉,2016-01-17 02:29:17,3,7,4,其实还好，就是上课要求发言有点坑……还有事也多...
15339,3100,王东莉,2016-01-14 02:46:45,2,5,3,呵呵呵
15989,3100,王东莉,2016-01-17 02:05:26,31,38,7,非常熟悉西方的一套理论，但是问来问去的问题呢，都too simple ，sometimes naive
16095,3100,王东莉,2016-01-20 16:00:45,0,6,6,给分好，老师还争取了少正态的人数⋯⋯嘛，上课记得多互动哦～
16532,3100,王东莉,2016-01-18 10:18:09,-1,9,10,真心挺好，虽然上课很水，但是老师上课很努力。那些抱怨要举手回答问题的，课堂不进行师生互动那你们来干什么，自习吗？你们以为自己在思修课上自习就能微积分满绩吗？
16895,3100,王东莉,2016-01-19 08:03:28,2,4,2,呵呵哒
17116,3100,王东莉,2016-01-19 15:22:11,-2,2,4,作为思政类老师已经很不错了
17495,3100,王东莉,2016-01-20 10:06:29,-1,3,4,我觉得这个老师很好，很有素养，特别想把思修课讲好，希望学生能听进去，只是我真的不喜欢思修这门课，但我还是很喜欢这个老师的(ง •̀_•́)ง
17510,3100,王东莉,2016-01-20 10:17:44,0,3,3,瞎jb评分
17556,3100,王东莉,2016-01-20 11:56:05,2,3,1,极点奇低\n\n
17601,3100,王东莉,2016-01-22 08:42:46,-3,2,5,还可以吧
17604,3100,王东莉,2016-01-20 13:28:23,10,14,4,额，每节课有一堆问题，重视举手，额，作业比较多，微电影，职业调查，，读书报告，样样不落，结果并不如人意
17652,3100,王东莉,2016-01-20 14:43:09,3,7,4,上课很无聊 灌输心灵鸡汤 过于看重上课发言 在思修老师中是作业最多的 给分很差
17684,3100,王东莉,2016-01-20 15:40:50,4,9,5,呵呵反正老子这辈子都不会选他的课当初本来预置不是他结果自己还选了好评的不要害人行吗给分还可以再低一点吗都不想爆粗了
17690,3100,王东莉,2016-01-20 15:48:44,2,4,2,给分坑
17696,3100,王东莉,2016-01-20 15:55:28,-3,2,5,其实我觉得老师真的很有修养，人也很友善，上课备课也很用心，而且是真心实意对学生好，为什么这么多人说她不好
17698,3100,王东莉,2016-01-20 15:57:44,5,7,2,老师很正统，老派。课堂要求严。但我觉得那些课堂发言的意义不大。
17711,3100,王东莉,2016-01-20 16:45:18,1,3,2,再见再见
17739,3100,王东莉,2016-01-20 23:14:28,-3,4,7,可以理解为是心灵鸡汤，不过老师上课时，在思想教育（可以理解为洗脑）、师生互动方面确实做得成功。事情会比较多比较烦，但最后看到一个高绩点还是会感到欣慰的。
17764,3100,王东莉,2016-01-21 00:35:29,5,6,1,给分不太好
17767,3100,王东莉,2016-01-21 00:42:02,2,3,1,太注重举手发言了。可是问题没探讨性。
17862,3100,王东莉,2016-01-21 03:01:18,3,4,1,上课太注重发言，问题都不怎么吸引人
17919,3100,王东莉,2016-01-21 04:00:40,3,4,1,作业好麻烦...给分就这样
18015,3100,王东莉,2016-01-21 06:03:54,3,4,1,无语了
18190,3100,王东莉,2016-01-21 09:00:00,-2,1,3,鸡汤高手，讲课很好就是，人很nice\n\n
18437,3100,王东莉,2016-01-21 15:40:26,-2,1,3,作业真的好多 据说前一年不是这样的 今年要求微电影还有2个论文(3000+2000) 给分额 差一分上4 我醉了
18473,3100,王东莉,2016-01-21 16:57:33,1,2,1,举手很重要。不要再灌鸡汤了！！！今日说法都比她好看
18585,3100,王东莉,2016-01-22 05:33:18,-2,2,4,讲课太多鸡汤，平时有各种麻烦的作业，期末给分不错
18896,3100,王东莉,2016-01-22 17:02:41,-8,4,12,我觉得老师真的很认真负责。。讲课也很生动啊。一开始上课没认真听到最后才好好听还很后悔呢。作业也不多。为什么那么多人说老师不好。老师给分也很好啊。替老师不公。。
18911,3100,王东莉,2016-01-22 18:26:43,1,2,1,没意思，上课完全没有意义，事多分还低。
18951,3100,王东莉,2016-01-23 00:24:36,9,14,5,给分巨坑，这么水的课绩点这么低！
19176,3100,王东莉,2016-01-23 11:43:27,-2,4,6,一般来这都是吐槽的。不过公正地说，老师很认真，作为思政教师已经很好了。
20049,3100,王东莉,2016-01-26 03:09:39,5,7,2,过分看重举手回答问题
20071,3100,王东莉,2016-01-26 04:48:09,14,21,7,老师让人很舒服，上的东西也没有让人不舒服，只是上课的方法，让人浑身难受
20631,3100,王东莉,2016-01-29 07:44:09,14,20,6,不愿举手回答问题的很可能被正态的
20947,3100,王东莉,2016-02-05 01:45:55,-3,3,6,看大家都在抱怨上课问题幼稚，这点确实，但是老师人真的不错，有修养。但那些说问题太幼稚懒得举手最后成绩不怎么样的，难道全是老师的问题吗？
20969,3100,王东莉,2016-02-06 01:52:30,2,4,2,坑太坑了
21299,3100,王东莉,2016-02-28 03:23:04,3,7,4,卧槽 事多的一笔 这课想得分全靠装逼 要不是组长啥的就别想得高分了
21361,3100,王东莉,2016-02-28 08:55:36,3,6,3,超级无聊，又事情多，而且给分不怎么好，按发言次数来的，超级讨厌
21995,3100,王东莉,2016-03-02 05:07:11,4,22,18,在这里骂的这学期思修是怎么上的？老师挺和蔼的，也挺用心的，上课并不严，作业一个微电影一个读书报告比某些通识都少，当然在思修里算微多。鸡汤嘛，各有各的看法，不要总把三观正当幼稚。给分当然要看你的表现了，比较公正。我认为是一位好老师，至少是一位合格的老师。
22012,3100,王东莉,2016-03-02 05:51:26,-3,1,4,分小组坐座位。事情太多。老师为人负责严谨
22428,3100,王东莉,2016-03-05 08:31:01,-4,2,6,给分很好
22986,3100,王东莉,2016-03-16 00:16:32,15,23,8,每节课都说：“有没有没发言过的同学？让我们把最后一个发言的机会留给从来没有发言过的同学～”然后叫一个每节课都发言的同学。直到学期的最后一节课都是这样，真是醉了。总是问那些幼稚的问题，比如我们在家庭和学校中应尽的责任义务有哪些...呵呵
23278,3100,王东莉,2016-03-23 12:14:18,3,5,2,学不到什么新东西 mdzz
23961,3100,王东莉,2016-04-22 17:43:17,-4,6,10,其实老师的人真的不错，说话的时候面带微笑，而且学识渊博，很负责任，也很关心同学。摸着你们的良心说，你觉得这个老师备课不认真吗？而且我有好好听课，好好做作业，最后4.5，老师给分不是乱来的好么
25220,3100,王东莉,2016-05-08 11:32:17,1,4,3,差评差评
25638,3100,王东莉,2016-05-30 09:24:42,1,3,2,折腾了我一学期 认真做作业 每节课必到 上课有发言 写论文还有期末都是尽心尽力 最后成绩呵呵 各种心灵鸡汤
25816,3100,王东莉,2016-06-09 05:53:53,2,4,2,差，绩点奇低
26150,3100,王东莉,2016-06-16 06:13:28,3,6,3,只想说为啥没有零分？\n\n
26470,3100,王东莉,2016-06-18 16:54:30,-8,4,12,不明白为什么会有这么多喷子 老师上课很和蔼 法律那一块还是讲了一些东西的，作业有些多但是认真完成分不会低啊，虽然没举过手，但是老师在最后还是让我们补救 课上没发言过 4.6 我不姓王?
28029,3100,王东莉,2016-06-28 08:00:38,-2,2,4,老师人挺好的啊，上课有点沉闷，但总体还是很好的
29113,3100,王东莉,2016-06-29 08:52:38,2,3,1,简直难受死了
34103,3100,王东莉,2016-09-27 04:54:05,3,9,6,这老师在名单里用红色标同学的名字，我就来打一个1分吧
34853,3100,王东莉,2017-02-28 12:22:52,-1,4,5,绝对好老师，我就这门课分数最高，85分
35062,3100,王东莉,2016-11-01 06:12:07,7,9,2,作业又多又烦，上课如同老太婆的裹脚布，又臭又长……
35063,3100,王东莉,2016-11-01 06:18:53,8,11,3,作业实在太多 要干这个干那个的\n\n早知道是这样还不如直接退课 \n\n过时的教学方式 有点在小学上课的感觉
35557,3100,王东莉,2016-11-10 07:27:09,3,5,2,无聊，幼稚，提的什么问题，根本不想听，还不让睡觉，一本正经瞎逼逼，看不惯
35635,3100,王东莉,2016-11-10 07:36:43,3,4,1,挺无聊的 感觉是初中政治和心理课的混合版 但是不适合大学生
36464,3100,王东莉,2016-11-14 03:39:22,2,3,1,事多，闹心，回答问题倒在其次。\n\n讲课内容无聊。\n\n
37228,3100,王东莉,2016-11-18 03:12:21,3,4,1,真的就是浪费时间浪费时间
37719,3100,王东莉,2017-01-19 14:05:16,26,34,8,客观来讲，老师亲切和蔼且总是面带微笑，虽水平有限但对待课程认真负责。看得出老师希望在她这门课上有所收获，但同学往往会因为事多或者得分不好而对她颇有微词。的确老师的课堂稍显幼稚，评分机制也比较死板，但这不能阻碍王老师成为一个亲切和蔼、认真负责、给分公道的称职的老师。
38230,3100,王东莉,2017-01-16 11:28:11,0,8,8,挺好的 举手很重要
38261,3100,王东莉,2016-11-28 11:17:31,0,4,4,水平低毋庸置疑，不需要我再多说什么。\n\n\n\n人品好？你觉得好你就说他好吧。\n\n\n\n心理课没上过。但他的思修课还是可以上的，只要上课抢着举手，然后随便讲点给小孩子讲的大道理就行了，，作业嘛，应该不能算很坑吧，认真的水水就过去了。\n\n思修课嘛，对老师的要求跟其他课不能一样的，。我觉得能像他这样就够了。\n\n你总会遇到各种幼稚的老师，只要他们不妨碍你，你别理他们就行。
38489,3100,王东莉,2017-01-16 10:41:17,-8,2,10,真的非常好，多举手，调分调得飞起\n\n
39471,3100,王东莉,2017-01-17 08:27:39,10,13,3,认真想把课教好，是个好老师。但是上课确实不有趣，作业认真完成还是有收获的。
39731,3100,王东莉,2016-12-27 07:48:52,1,4,3,虽然作业多\n\n但是老师很好很温和\n\n有时候还会开玩笑
40119,3100,王东莉,2017-01-17 11:50:29,1,2,1,老师做事是负责的，就是事比较多。给分也不好
40364,3100,王东莉,2017-01-03 05:30:56,3,3,0,老师太事儿墨迹作业巨多\n\n
40411,3100,王东莉,2017-01-03 07:38:30,2,6,4,太恶心了……思修课作业又多又恶心……还记录举手发言次数……逼你听课……课上的内容老套无聊……总之别选她的课……
40485,3100,王东莉,2017-01-03 15:41:57,0,2,2,挺好的。。。老师
40906,3100,王东莉,2018-08-25 06:36:12,8,9,1,死板，苛刻，多事
41078,3100,王东莉,2017-01-16 12:38:46,0,5,5,事情贼多，给分还低
43447,3100,王东莉,2017-01-16 09:43:01,-2,2,4,好老师～上课特别有趣！！
43455,3100,王东莉,2017-01-16 09:48:31,-3,3,6,记得多发言，然后期末保证不下4。
43463,3100,王东莉,2017-01-16 10:00:34,2,8,6,大绩杀！不举手就完蛋！！
43472,3100,王东莉,2017-01-16 10:14:24,2,3,1,挺不错的老师，虽然平时事情有点多，课堂还是能有所收获的，只要别太放纵，绩点还是可以的。\n\n
43488,3100,王东莉,2017-01-16 10:43:18,0,2,2,最好不要用高中上思政课的心态上思修课，这样或许能找到一点乐趣，也能以平和的心态得到一些有用的道理。
43493,3100,王东莉,2017-01-16 11:11:57,9,11,2,如果你上课不爱发言，千万别选。。本人就这样被正太了。。
43513,3100,王东莉,2017-01-16 11:53:35,-2,0,2,还不错\n\n
43561,3100,王东莉,2017-01-16 14:16:46,0,1,1,老师很好，认真做作业就行
43580,3100,王东莉,2017-01-16 14:46:41,0,2,2,我高中政治老师都比她有趣有深度
43672,3100,王东莉,2017-01-16 19:54:06,0,1,1,确实注重回答问题，但可控因素总比不可控的要好…老师讲法律以及案例分析还是很棒的，讨论讨论也很好，作业确实不少，但是一定要相信努力是有回报的！不要因为听说了可能给分不好就水水水啊。老师远没有评论中的那么可怕
44397,3100,王东莉,2017-01-17 17:35:09,0,0,0,估计会有些人吐槽，其实老师还好，关心学生，绩点什么的是靠自己争取的。
44701,3100,王东莉,2017-01-18 06:30:36,0,0,0,老师还好，作业有点多，注重平时成绩
44862,3100,王东莉,2017-01-18 11:52:10,0,0,0,认真负责的好老师
44893,3100,王东莉,2017-01-18 12:49:56,0,0,0,个人修养是真的很好，很温柔的老师，但是上课确实内容比较小儿科。。。一定要多发言，作业认真写，给分还是挺好的
45006,3100,王东莉,2017-01-18 21:44:11,4,6,2,真心觉得是个好老师，女儿嫁人还赶来给我们上课很感动，毕竟思修这种课实在是讲不出来啥，我觉得不怪老师的，老师真的尽力了非常认真负责！
45638,3100,王东莉,2017-05-04 23:59:31,-12,3,15,不要太相信查老师上的话。我就发了四次言期末有4．8会骗你。老师事情有点多想水的别来
47483,3100,王东莉,2017-01-27 17:02:35,0,1,1,其实还好吧，本来也没报多大希望。记得一定要回答问题！最后我得分还可以，希望不是因为运气好。
47508,3100,王东莉,2017-01-28 13:09:50,2,4,2,发言一次...嗯...绩点3.0...嗯....
47639,3100,王东莉,2017-02-09 11:02:49,-3,0,3,课件里的例子比较过时，老师人还是不错的。
47836,3100,王东莉,2017-02-26 04:14:39,5,9,4,说一句客观的话，老师人很好，这学期上课模式有改进，不再那么枯燥无聊。给分给得很好，主要看平时回答问题的次数(这个积极一点就好，老师主要是为了活跃气氛)然后两次实践活动认真完成，只要你用心老师总会看到的。不明白为啥大家说那么难听。老师也是通情达理的，付出与回报是成正比的。
49471,3100,王东莉,2017-04-15 11:49:28,-2,0,2,认真负责
53331,3100,王东莉,2017-06-26 11:28:15,-1,0,1,客观来说，事情多，但是付出多的分数确实高。不是那种9分的好老师，但是4点几给的太低了。
53549,3100,王东莉,2017-06-27 03:17:24,0,0,0,压分压分压分
58887,3100,王东莉,2017-09-18 08:58:53,0,1,1,很亲切\n\n
58895,3100,王东莉,2017-09-18 10:13:23,2,2,0,呵呵，微电影，新闻评论，举手发言，无fuck可说
58922,3100,王东莉,2017-09-18 12:50:25,2,2,0,超级不爽
59063,3100,王东莉,2017-09-19 09:10:55,2,2,0,作业多
59914,3100,王东莉,2017-09-28 06:55:24,3,5,2,目前作为萌新听了两节课，客观来讲，有以下的感慨：1.上课的确无趣，问题很无聊，我没有一点想参与课堂讨论的欲望。2.的确看重举手。3.的确会布置拍微电影的作业。4.不可否认，上课态度很认真。\n\n其他以后再说。
60361,3100,王东莉,2017-10-18 06:28:21,0,0,0,想死\n\n
60479,3100,王东莉,2017-10-22 10:13:28,3,3,0,三千字读书报告，秋学期第六周交，室友都没有读书报告
61824,3100,王东莉,2017-11-21 06:24:44,0,1,1,好听的
63347,3100,王东莉,2017-12-01 05:25:11,2,3,1,作业贼多，作业贼多，作业贼多，作业贼多，作业贼多，｡゜(｀Д´)゜｡
63598,3100,王东莉,2017-12-08 11:15:06,-1,2,3,事儿多。除去各种演讲与报告，四人一组拍微电影，时间比其他班十人一组还紧。教学内容真的是过时的鸡汤，学不到什么。
63657,3100,王东莉,2018-01-04 09:26:44,5,10,5,老师人很好啊，不能理解为什么恶评如潮。平心而论，某些同学不听课、不发言、作业也不认真做，到头来拿了个3.0结果过来喷老师，这是在搞笑吗？一分耕耘一分收获，不要再秀浙大学子的下限了。
63876,3100,王东莉,2018-01-22 08:11:45,-9,3,12,emmmmm\n\n怎么说呢，一个不顾自己名声，能每次点名的，事儿妈
64532,3100,王东莉,2017-12-25 03:18:23,-1,2,3,事情奇多，问一些很无聊的问题，一直鸡汤鸡汤鸡汤
64616,3100,王东莉,2017-12-25 13:53:48,1,4,3,无脑的问题真的很烦，上课有种幼儿园课堂的即视感。看在微电影蛮有收获的份上，给1分好了
65333,3100,王东莉,2018-01-03 05:48:52,-2,3,5,b事贼多，读书报告，翻转课堂，新闻评述，微电影，写法律报告，写感想，上课举手发言，期末还要闭卷考。如果你选，我敬你是条汉子。
65339,3100,王东莉,2018-01-03 06:19:19,3,5,2,虽然思修的内容有点嗯....但老师是很认真上课的，也很敬业啊，给10分啦。
65777,3100,王东莉,2018-01-22 08:40:28,1,5,4,哇，谢谢老师，平时干了很多有意义的事，给的分也很高
65813,3100,王东莉,2018-01-09 09:24:55,2,3,1,她呢，非常熟悉西方的那一套vaule，但是问来问去的问题呢，都too  young，sometimes naive!
65818,3100,王东莉,2018-01-22 09:19:53,6,10,4,4.5，没有当组长，一共发言4次，微电影一般，读书报告也没有展示。但是该做的作业也认真做了，考前一天思修稍微有复习，估计闭卷考考的还不错。主观题字数最好多一点，老师会看到你的用心的。
65905,3100,王东莉,2018-01-23 08:11:13,0,1,1,我其实觉得还好，老师还是认真在讲的，事多可能是想多锻炼下我们的能力。
65906,3100,王东莉,2018-01-10 06:11:18,0,1,1,老师还行，虽然幼稚
66602,3100,王东莉,2018-01-17 12:36:09,-1,1,2,听老师的课是什么体验?\n\n         任务奇多，微电影，读书报告，观后感，对大学生与法律的看法，上课没意思，还要考试。同学就一个小组任务还没期末考试，均绩还比我们高一截，总之就是想死。
66660,3100,王东莉,2018-01-22 08:26:25,7,8,1,绩杀吧，比我的线代还差劲。我自认为有认真完成老师的每项任务，看那种犯罪视频我也看了，微电影也拍了好久做得认真，读书报告其他班不写我们也写了，那么多任务就不能好好给分吗，思修不是没正态吗，为什么不可以看在我们都辛辛苦苦的份上多给点分呢？
67797,3100,王东莉,2018-01-22 07:32:35,4,5,1,嗯  说实话  老师每次上课前会认真观察每一个小组的到课情况并且记下来（应该是期末总评用）老师给分还是很好的  像我这种平时上课不发言（主要是感觉问题太弱智）最后期末都能得个3.9的绩点  算给分好的了 也可能是我平时完成作业太认真  哈哈   老师上课真的很认真  从她备课的情况就可以看出来   而且人还是很和蔼的  从QQ群交流就可以看出来 所以总结一下\n\n1.作业多。\n\n2.问题鸡汤。\n\n3.给分好。
67805,3100,王东莉,2018-01-22 07:38:04,0,0,0,嗯…上课之前看查老师很多说不好的。但是上课会发现人很和蔼，作为一门思修可能事情比较多，但是这样更有利于评定成绩。上课内容可能水了点，但老师是好老师。
67806,3100,王东莉,2018-01-22 07:39:09,0,2,2,小学花式鸡汤举手课，给分还贼差
67819,3100,王东莉,2018-01-22 07:51:14,0,2,2,作业有点多，课堂比较无聊，但老师还是在认真准备的，给分吗不好说，我感觉我的绩点稍微有点低了，别的同学基本都上4了，我3.9也勉强能接受吧，希望老师能提高一下均绩。
67823,3100,王东莉,2018-01-22 07:55:35,1,5,4,看完成绩特意过来说一下，我这种只发言过2次的人，最后绩点4.2，其实真的不是绩杀，发言确实重要，但是没有很大影响，回忆这一个学期，我觉得老师在法律基础那部分讲的还是很认真的，第一堂课的一些观点也很有启发，感觉老师真的是一个很认真负责的人。总之，这个评分真的不是很公正，至少应该有8+的评分……
67827,3100,王东莉,2018-01-22 07:59:10,1,7,6,如果小学的时候你碰到了一个好的语文老师，那是一种幸运，因为那正是语言学习的关键期；如果中学的时候你碰到了一个好的数学老师，那是一种幸运，因为那正是数理逻辑的培育期；如果大学时你遇到了一个好的思修老师，那是一种幸运。我从小学开始，幸运到了大学。
67829,3100,王东莉,2018-01-22 07:59:58,2,3,1,我觉得老师真的很认真，上课分小组，能认识这个小组的其他同学，挺好的
67831,3100,王东莉,2018-01-22 08:03:09,7,8,1,老师人很和蔼，总结下来这个学期主要就是写了一次三千字读书报告，一次微电影，社会公德单元的小组展示（水），一次小组新闻评述，一次法律单元的1000字观后感，举手其实一个学期满足一次就达到标准了，给分还是不错的
67834,3100,王东莉,2018-01-22 08:05:32,6,7,1,老师是很好的老师，温柔善解人意，课前展示内容和微电影作业都很有趣，而且老师在考试前还给了我们很多暖心小提示。思修这门课本来就讲不出什么高深莫测的东西来，只要每次作业认认真真做完，上课积极一些，期末的成绩不会差的~
67835,3100,王东莉,2018-01-22 08:05:50,6,8,2,老师人是很好的，就是课确实略显幼稚。也并没说完全不让干别的事（至少我没发现挨批的）绩点我反正上4了，别人怎么样不知道。总之5点几的分确实偏低，七八分肯定是有的
67840,3100,王东莉,2018-01-22 08:09:37,-1,0,1,我认为是还可以的，虽然事情确实有一些些多，但是只要认真，并且上课的时候相对积极一点，最后结果还是会不错的
67852,3100,王东莉,2018-01-22 08:17:45,-1,1,2,老师还是很负责的，以前看评论很多都说老师事情比较多，虽然比别的一些班可能确实多了一点，但也还是可以接受的，我觉得老师有很大可能会看我们的评论，因为感觉老师也一直在调整，不像原来评论说的那样看重上课发言，一学期只发一次言就够了，成绩也算理想吧。至于点名，我觉得是我们班太小了，划分好各组的位置，一眼望过去就知道谁没来了，这也没有办法，有哪个老师会在查人很方便的时候不查人呢？╮(╯▽╰)╭
67853,3100,王东莉,2018-01-22 08:19:00,-1,0,1,虽然老师提的问题确实比较幼稚 但是也是为了活跃课堂气氛 毕竟我们常常先入为主地看待这门学科 没有提问的话大家根本不会听课了 （反正我回答了一个问题好像也没被正太）看得出来老师很用心了
67859,3100,王东莉,2018-01-22 08:20:48,0,2,2,老师人很好，事情也的确是很多～我从来没有发过言最后也是4.2。尽好一个学生的本分就好，老师给分挺好的。
67867,3100,王东莉,2018-01-22 08:23:44,1,3,2,我想说件很神奇的事，我一次问题也没回答，最后绩点上四，发言并不是决定绩点高低的唯一因素，踏实一点，把该做的做好。
67868,3100,王东莉,2018-01-22 08:24:13,0,0,0,老师很认真
67869,3100,王东莉,2018-01-22 08:25:22,-2,0,2,挺好的，很负责
67872,3100,王东莉,2018-01-22 08:30:36,1,1,0,今天思修出成绩了，比我想象的高了许多。这么说吧，破事确实挺多：读书报告，观后感，微电影另加感想500字，网络学习2000字。看重举手，千万别听她说什么举手随意。
67874,3100,王东莉,2018-01-22 08:34:59,0,2,2,好老师，给分棒
67877,3100,王东莉,2018-01-22 08:38:36,0,4,4,上的课非常无聊，问的问题又很幼稚，最后给我个3.3，不枉我给她的反馈单都是及格，各门课中最受不了的就是她
67880,3100,王东莉,2018-01-22 08:42:06,0,1,1,认真听讲，总会有收获的，总体来讲还是很好的一个老师，很好说话，建议还有每节课抢一抢发言，考前多看看书，写平时作业拍微电影的时候认真一点，建议当组长。
67895,3100,王东莉,2018-01-22 09:10:16,0,2,2,给分挺好的！上课前半部分理想之类的确实有点无聊，后半段讲法律很棒！课后会很耐心回答我的问题。拍微电影还挺有趣的，感觉自己确实长进了！
67898,3100,王东莉,2018-01-22 09:16:19,0,1,1,当组长 做展示 多回答问题 绩点会高的
67909,3100,王东莉,2018-01-22 09:45:42,0,1,1,给分不错 上课很有诚意
67916,3100,王东莉,2018-01-22 09:56:53,1,3,2,虽然老师布置事情很多，但是她是一很有教养的人，说真的认真听，会觉得老师讲课很有魅力的，对人特别温柔。上课回答问题，不管好不好，老师都很有礼貌的说谢谢……课前会放钢琴曲，还说自己每天晚饭后散步一小时之类的，很有气质的老师啦
67926,3100,王东莉,2018-01-22 10:24:21,-1,0,1,要点名
67931,3100,王东莉,2018-01-22 10:33:30,0,2,2,唯一能给我安慰的课
67932,3100,王东莉,2018-01-22 10:33:58,1,3,2,思修均?3.7 我才3.3 ??\n\n答题答的很好 字写的很好\n\n就是上课发言少一点 \n\n无语了
67954,3100,王东莉,2018-01-22 11:27:18,2,4,2,老师其实很温柔啦，上课可能比较无聊，但是思修本来就挺无聊的。然后全课程举过一次手就好了，不用太多次。要拍微电影，但也挺好玩的。本来害怕被正太，但是认真复习，期末考认真考，最后4.2\n\n然后就是思修考试不用刷题!没用的，会BB就行了
67959,3100,王东莉,2018-01-22 11:39:04,0,1,1,按小组坐，要回答问题，剩下的都是所有思修课堂都要做的事情，给分也还不错，老师很有礼貌。
68419,3100,王东莉,2018-01-23 07:39:42,-2,1,3,巨无聊\n\n给分差\n\n记发言次数
68557,3100,王东莉,2018-01-23 10:58:13,7,11,4,老师其实很优雅也很有思想很有礼貌，讨论的问题的确很思修，\n\n是组长，没发过言，平常感觉自己也很水的。而且由于是下午七八节，上课真的不是一般的想睡啊！本来以为凉了，有4.5真的很惊喜~
68775,3100,王东莉,2018-01-24 01:21:48,4,4,0,给分挺好的
69430,3100,王东莉,2018-01-24 15:55:25,2,3,1,上课很无聊 给分一般\n\n但老师人还不错
71302,3100,王东莉,2018-01-28 09:13:13,2,3,1,非常好，很人性化，给分也好
72478,3100,王东莉,2018-01-30 08:02:27,0,0,0,是不是成绩杀手看你自己咯
73001,3100,王东莉,2018-01-31 14:22:19,0,1,1,还不错，给分合理
73221,3100,王东莉,2018-02-01 07:51:32,-3,1,4,好好好，满了
73361,3100,王东莉,2018-02-01 12:15:28,2,3,1,首先，老师会分组，按小组坐，上课看小组人头数点名，要逃课基本会被发现。然后讲讲上课吧，老师要求一学期至少发言一次就不会因为发言扣平时分，多发言可能会加分，上课提的问题也确实简单（我觉得简单不是挺好的吗，回答也方便，难道还想要一个难以理解的问题吗，为什么这都会被攻击…），也基本没人抢着发言，所以不用太担心。平时事其实挺少的，一个小组新闻评述5分钟，一篇读后感，一个一百字不到的观后感，最麻烦的是微电影，但其实写好剧本，有人会剪视频也就还好，没有乱七八糟的作业。老师长的一点都看不出来还有两年就要退休了，而且很温柔很有礼貌，上课一直是笑着的，经常为一些小事说谢谢。
74182,3100,王东莉,2018-02-06 06:19:21,7,7,0,开学第六周上交3000字以上指定范围图书读书报告一篇。各个小组都要准备新闻评述一次，其他小组打分。两个月时间拍摄一部健康向上的微电影，8分钟，其他小组打分。在爱课程网上注册，看指定视频并必须评论。临近期末根据两篇新闻写1000-1500字的感想。闭卷考。分配座位。登记上课举手发言次数
74205,3100,王东莉,2018-02-06 13:59:04,-1,0,1,很温暖
74280,3100,王东莉,2018-02-09 04:33:19,1,2,1,不举手，就等死吧
74711,3100,王东莉,2018-03-05 08:46:00,0,0,0,感觉没什么问题，但也没有什么亮点。和高中政治差别不大，经常讲鸡汤故事。但就思修这门课来说，还是称职的老师。
74728,3100,王东莉,2018-03-05 09:32:27,2,2,0,老师很负责啊 上课也很用心的准备了 作业略多但给的时间都还蛮宽裕的 说实话评分低了
74887,3100,王东莉,2018-03-06 09:03:16,0,0,0,挺好的，人蛮温柔，给分也不错
75306,3100,王东莉,2018-03-09 01:22:02,-1,0,1,就是好\n\n
79307,3100,王东莉,2018-05-30 15:33:18,1,1,0,幼儿园教师
79509,3100,王东莉,2018-06-07 10:58:36,-1,0,1,好好好
79730,3100,王东莉,2018-07-06 13:56:48,2,3,1,上课多举手！考前大概翻一下书，主观题写多一点，分数不会差的！
87634,3100,王东莉,2018-10-09 00:08:31,2,2,0,真的幼稚
87747,3100,王东莉,2018-10-11 08:25:16,1,1,0,不是组长，上课从来不敢发言，但结果还是不错的，4.2。大概是我们组的微电影得分比较高？老师很有修养很温柔的，只要用心，总会收获最难忘的。
88197,3100,王东莉,2018-10-24 01:11:32,1,2,1,真无聊。思想深度还不如发言的学生，一总结死气沉沉。完全没什么兴趣。手机电一大早就耗光了。还要重复同学分享时有点犹豫说出的地方。
88371,3100,王东莉,2018-10-30 00:17:37,4,4,0,老师的确是个好人，作业量其实也还好，只是……如果担任小学老师她也许会更适合……
88499,3100,王东莉,2018-10-31 10:53:14,0,0,0,
89404,3100,王东莉,2018-11-19 03:19:44,2,2,0,教幼儿园合适，当大学老师就算了吧
91207,3100,王东莉,2018-12-03 09:10:07,1,2,1,在座各位都能当大学老师
91827,3100,王东莉,2018-12-21 11:26:43,-12,4,16,“每次我都要五點四十起床才能趕上校車”，老用這句話跟學生比起得早，卻不知她自己多少歲了，需要的睡眠時數能和大學生比嗎？
94016,3100,王东莉,2019-01-15 01:51:21,3,3,0,为什么一定要举手发言呢？
94390,3100,王东莉,2019-01-16 09:40:17,6,7,1,这学期不用拍微电影了，总结一下上课的情况。相比较别的老师应该是比较乏味一点，但毕竟思修就是这样，讲的好不好都没人听。每节课都会点到，要记录发言次数。一篇3000+读书报告，一次小组课题，这两个和别的班应该都一样。上课和和气气的，对学生都挺好。综合来说就正常吧，我觉得6分有点低了
94541,3100,王东莉,2019-01-17 07:18:05,0,1,1,很无聊，没有意义，有固定座位，恶竞严重，举手不多分很低，上课提的问题也很无脑，总之浪费生命
94543,3100,王东莉,2019-01-17 07:23:18,1,2,1,。。。给1分，不想评论。。。
94552,3100,王东莉,2019-01-17 07:43:40,-1,2,3,我一个学期发言三四次，读书报告3000字，我写了近5000，考试前看书看到疯，大题目写了2张a4纸，最后才3.9？？？我不知道您的要求太多高，再见了，同学们能换就换吧，过来人的一句劝。
94557,3100,王东莉,2019-01-17 08:04:27,0,1,1,事情多，重视举手，但是不发言好像也没什么。。。
94563,3100,王东莉,2019-01-17 23:30:41,-12,2,14,王老师和两个助教很负责，改卷速度超快!虽然请了两次假，但靠发言还是补了回来..发言也挺照顾大家的。至于讲课内容嘛……思修这种课期望还是不要太高嘛-_-||。最后得了4.5，给王老师打call!
94564,3100,王东莉,2019-01-17 08:23:06,0,1,1,打call
94566,3100,王东莉,2019-01-17 08:26:38,1,2,1,绩杀啊，同学们，不要选
94570,3100,王东莉,2019-01-17 08:31:00,0,1,1,太看重平时回答问题 问的问题又很弱智
94572,3100,王东莉,2019-01-17 08:35:57,0,1,1,奇怪为什么看重回答问题，而且总是问有没有从来没有回答问题的人举手，但又只叫哪些经常回答问题的同学，无语。
94573,3100,王东莉,2019-01-17 08:38:07,4,4,0,老师人很和蔼，提问比较幼稚，，发言一次 读书报告3300+考前看书三小时 主观题没写特别多最后85感觉还好……卡绩就卡绩吧（又不是第一次）…………我觉得事情不是很多 如果积极发言好好写读书报告做调研最后好好复习绩点应该不会低
94576,3100,王东莉,2019-01-17 08:43:58,4,4,0,其实还好吧，老师显然上课还是比较用心的，人也不错。可能思修这个课本身比较无聊，然后老师水平确实比较有限，多数时候都觉得没什么意思。但是真的能感受到老师是想带给我们一些东西的。\n\n然后给分。。上课举手这个事情真是醉了。。课堂像个恶竞现场，每个彩虹屁的背后都是碎了一地的节操。\n\n7分给个精神可嘉分吧。
94579,3100,王东莉,2019-01-17 08:54:39,3,3,0,这学期不用拍微电影了，总结一下上课的情况。相比较别的老师应该是比较乏味一点，但毕竟思修就是这样，讲的好不好都没人听。每节课都会点到，要记录发言次数。一篇3000+读书报告，一次小组课题，这两个和别的班应该都一样。上课和和气气的，对学生都挺好。综合来说就正常吧。恶竞挺严重的，有个人每节课都发好几次言…给个7分吧
94580,3100,王东莉,2019-01-17 08:57:01,0,0,0,啊！老师很好啊
94582,3100,王东莉,2019-01-17 09:02:41,-6,0,6,老师的作业比较早交 一篇读书报告 一篇研究性调查 一次研究性报告小组展示 上课按组坐 所以每节课都会统计有谁没来 上课发言会加分 组长会加分  期末考试30% 最后4.8（我是组长）
94587,3100,王东莉,2019-01-17 09:28:12,1,1,0,认真负责，但是思修这门课就决定了水的本质。。。
94590,3100,王东莉,2019-01-17 09:40:35,0,0,0,就这样吧，比较看重上课发言，发言0次，所幸没有被强制正态吧。
94599,3100,王东莉,2019-01-17 10:08:39,0,0,0,希望最后一次课能划划重点啥的。老师人挺好的
94600,3100,王东莉,2019-01-17 10:10:56,0,0,0,比较看重举手，事儿还是比较多的，给分还可以吧。
94611,3100,王东莉,2019-01-17 11:22:34,4,4,0,老师总体来说还是负责任的，态度比较和蔼温柔。上课点小组到课率和迟到人数。上课的内容的确无聊，毕竟也有思修这门课的原因，很多人在睡觉，写其他作业，玩手机很常见。而且需要上课回答问题来刷平时成绩，前几节课竞争最为严重（基本各种抢）。期末考试没有发样题或系统复习，需要学生自己解决。总的来说，老师性格不错，但思修课的确水，很难学到知识，给分不算好不算坏，最好在回答问题或读书报告之一方面突出一点，期末论述题写的别太少，关键的课不要旷课。
94620,3100,王东莉,2019-01-17 12:10:49,-1,0,1,为什么给绩点给成这样？？任务那么多那么多 ? 不想说话
94621,3100,王东莉,2019-01-17 12:12:03,1,2,1,老师的课确实，看重课堂回答问题，问的问题有时候也挺尴尬，事情也挺多的(但是思修都是这么多事的)，我当初是前面志愿都掉了，然后选上了。当了小组长，课堂回答问题很多，然后考试裸考hh，成绩并不差。老师不会绩杀，给分还挺好，人并不难相处，很和蔼 ，老师分数但是并不差。
94633,3100,王东莉,2019-01-17 14:20:55,0,2,2,超级垃圾，瞎灌鸡汤，给分傻逼，千万别选她的课，误人子弟，不管是想好好学的还是想水的，都别选她的课！！
94673,3100,王东莉,2019-01-19 11:21:14,2,6,4,各位，发言也没什么用了。发言9次比不上当个什么组长收一次作业，我是服的。
94698,3100,王东莉,2019-01-18 02:28:29,0,2,2,给分超级低 绩杀绩杀绩杀 别选  上课超级无聊 跟给小学生讲课一样
94706,3100,王东莉,2019-01-18 02:35:28,1,1,0,老师人很温柔，但上课很无聊很无聊……问的问题也很幼稚……觉得自己回到了小学思修课堂。作业的话一篇3000字读书报告，一个研究性学习，还有志愿者活动。上课就发了一次言，读书报告刚好写到3000，期末裸考，最后3.9。怎么说呢，就还行吧。但你浙恶竞是真的严重…………综上，当个组长上课多举手发言好好做研究性学习好好写读书报告分不会低。
94751,3100,王东莉,2019-01-18 05:05:16,1,1,0,感觉小组作业挺重要
94787,3100,王东莉,2019-01-18 06:47:22,2,2,0,课比较无聊，人挺好的。
94795,3100,王东莉,2019-01-18 07:15:53,1,2,1,要脸还是要绩点，这由你自己决定。如果你能忍住那些幼稚的问题而不顾一切地举手发言，给老师留个印象，再当一个小组长，绩点就不是问题。我不是组长，我也没举手恶竞，但老师态度还好，给个7分。
94796,3100,王东莉,2019-01-18 07:25:52,1,1,0,虽然老师的课事儿比较多，而且上课提问确实略显幼稚。但这并不妨碍她是一个好老师，上课很用心，备课很认真。只要好好努力，老师是会看到的。
94870,3100,王东莉,2019-01-18 11:34:43,-1,0,1,心累！
94880,3100,王东莉,2019-01-18 11:59:36,1,1,0,绝了\n\n读书报告也被选上分享的了，志愿服务报告自认为也做的很好了参与了很多活动，期末考试感觉也还不错。最后绩点没上4。好了，现在终于理解了什么叫看举手次数了。我能感受到老师想要让我们真的能学到什么，但是每个人学习的方法都不一样吧，为什么一定要用举手这样的形式作为评判的标准呢。还有就是老师每次问还有同学没回答过吗的时候似乎永远看不到我。老师也要退休了，希望对以后的学生更更多元的去衡量他们，而不仅仅是举手次数了。
94892,3100,王东莉,2019-01-18 12:13:21,1,1,0,每节课都有点名，按小组点，跑不掉的hhh……我自己是小组长，并不是什么都不干的，组员划水，研究性报告我要一个人从三千编到一万，多拿点分应该没有问题吧……举手发言两次，期末考稍稍背了半天，绩点4.5。老师上课是很用心的就是可能思修的限制吧大家不会喜欢听。
95019,3100,王东莉,2019-01-18 15:08:05,3,3,0,真的不是维护老师，老师真的有很用心准备，思修这个课你希望能怎样呢？明明就是每个人主观上的认知，你为什么不思考为什么其他发言的同学说得底气足而在你眼中就是不屑？世界观确实很难拯救，但你也没必要践踏别人的叭。我绩点一般，不是既得利益者，平心而论，这个6分有点低了
95415,3100,王东莉,2019-01-19 10:52:32,2,2,0,其实也没有十分那么好 但是也绝不止6.3啊 所以想拉高一点...负责又很有涵养的好老师 毕竟思修嘛也不指望上的多好
95676,3100,王东莉,2019-01-20 00:41:35,1,3,2,小组长，举手了一次，期末考只在考前看了一会儿，但主观题写了很多，最后4.2，虽然再高一分就4.5了，但成绩比我想象中要好，老师很温柔，但是可能因为上课的问题太过于幼稚所以可能课程体验并不会很好，给老师10分拉一下均分，觉得老师应该可以到7分8分的程度，不止6分。
96195,3100,王东莉,2019-01-20 14:13:00,1,1,0,老师很温和也很有涵养，觉得相比部分老师已经相当优秀了，说课程没意思的，其实很多是课程内容本身的原因，老师是在用心准备的
96609,3100,王东莉,2019-01-21 07:39:13,4,4,0,为什么呢？为什么我的分那么那么地低呢？虽然我可能各方面并没有特别地突出，可还是完成了各个任务呀！那些评论里面说期末裸考的人，别相信他们，书还是要看的！！知识点还是要记住的！！！还有大题，天呐是我太天真了，大家都写的和作文一样！？不得不说，恶竞严重，估计要每个任务都炒鸡炒鸡有创意花心思完成才会拿到好看的分吧。
96824,3100,王东莉,2019-01-21 10:15:05,1,1,0,上课发言一次，读书报告被选上展示了，研究性学习和志愿报告一般。理科生所以最后闭卷考也不是很好。绩点3.9感觉还是挺公正的
96833,3100,王东莉,2019-01-21 10:21:47,1,1,0,多举手发言吧（叹气
97041,3100,王东莉,2019-01-21 15:13:02,3,3,0,事情很多，上课排排坐，必点名。最后把我卡绩了 你伤害了我 却一笑而过
97368,3100,王东莉,2019-01-22 08:25:07,3,5,2,老师挺不错的，绝对不止6.3分。讲法律基础的时候我很有收获，至少现在我已经充分了解并理解了我国的法治与法律体系( ﾟ∀ ﾟ)顺便表白思修D班一组（笑）(´-ω-`)
97672,3100,王东莉,2019-01-22 13:01:20,0,0,0,看重举手是真的，但是有些课还是挺有意思的~
97804,3100,王东莉,2019-01-22 17:35:09,0,0,0,老师挺好的，虽然提问太幼稚以至于都是水发言不太公平。。\n\n
98715,3100,王东莉,2019-01-24 00:13:15,-1,2,3,这个老师事情非常多而且给分极差，上课看重举手发言，像给小学生上课一样，十分无聊，选上她的课只能算你倒霉
98872,3100,王东莉,2019-01-24 04:24:25,0,0,0,老师很负责～
100405,3100,王东莉,2019-01-26 05:32:27,1,1,0,【思修】每节课必点名。课上干别的事老师也不会说，只是每次课前都会提醒同学们把手机调成静音。我们这届是一个社会调研（展示+报告）、一篇读书报告，本来还有志愿者活动展示但是因为课堂没时间展示了就只做了个ppt发给助教。最后考试闭卷。我觉得无功无过吧，你不能期待太多，但如果认真老师也不会少给你分的。平时作业认真一点，尽量多发言刷刷脸（不仅刷脸，最好还要让老师记住你的名字）（老师其实也很看重发言质量的，如果你的发言只是乱说一气下一次她点你发言的几率就会小一些）。其实我觉得思修教材编写得挺好的。
100605,3100,王东莉,2019-01-26 11:31:00,-1,1,2,老师很好，很和蔼，不明白为什么那么多人骂得那么难听，思修这东西，自己水得太过分就不要怪老师给分低了好吧…只要平时不缺课，作业认真写还是可以的(我迟到3次也有4.2)不过老师要求上课回答问题算很大比重的平时分，的确不太舒服…
102980,3100,王东莉,2019-02-25 07:42:33,1,1,0,老师人还是很不错的。
104140,3100,王东莉,2019-03-13 02:42:13,7,7,0,所有人都在试图举手发言，却没有人在听课，这样的情景我们称之为“表面听课”。
104413,3100,王东莉,2019-03-20 02:45:21,2,3,1,emm……老师人很好啦，很温柔啦。上课的话，可能是有点无聊吧。作业的话：调研报告*1+读书报告*1+志愿活动报告*1+期末考试*1。嗯，印象最深的就是老师说她坚持了八年（好像是八年）跑步，真的是佩服！还有，组员们都很可爱～所以我感觉还不错(◍ ´꒳` ◍)
106416,3100,王东莉,2019-04-27 07:19:33,1,1,0,大学生心理健康，老师很好，课堂上也能学到不少东西，如果你想水，你能水过，平时作业和开卷考试。但如果你想真心的学，也是会很有收获的。
106491,3100,王东莉,2019-04-28 01:45:26,-3,1,4,大学生心理健康，上课没有举手发言过，但还能上90，爱老师！
107319,3100,王东莉,2019-05-03 13:31:49,2,2,0,客观的说老师严厉，但是很和蔼，讲课很认真，选的视频挺不错的都，给分也还行
107361,3100,王东莉,2019-05-04 08:17:54,-6,0,6,老师是真的很热爱生活呀? ? ? \n\n感觉作业还是要好好做，考试好好考，\n\n没举手发过言，最后卡绩在91，感谢老师不正太之恩。
108396,3100,王东莉,2019-05-22 17:18:18,4,5,1,真的很好了。是好老师，更是好人。
120733,3100,王东莉,2020-01-16 03:36:26,1,1,0,卡绩91，但老师退休了，再也不上思修了，谢谢老师了
121934,3100,王东莉,2020-01-24 08:46:34,1,1,0,上课没发言过86很满足了\n\n八过老师退休了呢
122218,3100,王东莉,2020-02-20 05:12:57,2,2,0,学期发言5次，读书报告没有被评优，最后考试认真写了很多字，绩点很🉑了。老师人挺好的，上课看见同学在玩手机会提醒，但不会记名字扣平时分。以及，考试的时候千万要记住老师的名字怎么写，写错会扣分(狗头
122435,3100,王东莉,2020-02-27 11:47:39,0,0,0,太复杂了\n\n
125008,3100,王东莉,2020-08-09 03:13:23,1,1,0,还挺好的
5100,3142,叶文,2015-07-04 07:09:46,4,6,2,略萎靡
8456,3142,叶文,2015-09-21 10:52:05,-3,1,4,稍微有点无聊，但讲的话实在很有道理。
9063,3142,叶文,2015-10-12 03:20:57,-5,1,6,思修本来就水，课外研究性学习还可以\n\n
9076,3142,叶文,2015-10-12 07:41:27,12,19,7,不会有压迫感，让人感觉很真诚
14997,3142,叶文,2016-01-11 12:56:45,-1,4,5,听着挺舒服，说的话和观点也很有道理.
17566,3142,叶文,2016-01-20 12:06:14,7,12,5,绩杀 不到4
20323,3142,叶文,2016-01-27 04:11:18,4,5,1,唉。。。
22495,3142,叶文,2016-03-07 03:00:59,2,8,6,班里好像很多同学没上4 期末考考得好就行了 我平时没啥表现 还是上4了啊
87064,3142,叶文,2018-09-20 06:23:47,3,4,1,淼课233
98017,3142,叶文,2019-01-23 03:59:51,16,18,2,感谢老师卡绩之恩
98043,3142,叶文,2019-01-23 04:17:01,11,14,3,感谢老师卡绩之恩\n\n但是平心而论人还是不错的
98176,3142,叶文,2019-01-23 06:56:30,-2,0,2,水水水
98180,3142,叶文,2019-01-23 07:04:07,1,3,2,不怎么样
98321,3142,叶文,2019-01-23 10:13:55,7,7,0,感谢老师卡绩之恩
98422,3142,叶文,2019-01-23 12:31:18,4,7,3,上课无聊是真的，可是老师人好也是真的。每次上老师的课，都是想吐槽又不忍心吐槽的感觉。\n\n不过我更觉得这是思修这门课的问题，真的水。。。\n\n课程结束了，想起老师语重心长的分享和推心置腹的交流，还是有些不舍的，给了9分，祝老师一切都好。
98523,3142,叶文,2019-01-23 14:21:45,-1,3,4,事少老师好感觉读书报告写好了其他随意然后分就不错了。上课是真的没什么特别的，可能思修都这样，就聊聊天一样，我看了一个学期微积分（虽然微积分还是炸了）
99047,3142,叶文,2019-01-24 07:49:17,4,4,0,也付出了挺多，最后绩点不是很理想
102877,3142,叶文,2019-02-24 13:26:59,0,2,2,绩点4.2\n\n事情不是特别多（相比于其他老师）\n\n老师怎么说呢\n\n额。。。。。。。。。还好吧
103574,3142,叶文,2019-03-01 11:42:39,-1,1,2,很好的老师，很亲切。
103575,3142,叶文,2019-03-01 11:43:00,0,2,2,老师对向他询问思修论文的人很负责，帮助很大
116636,3142,叶文,2019-09-12 06:08:34,-2,0,2,老师很温和
118378,3142,叶文,2019-10-26 05:23:14,0,1,1,努力必有回报！
129554,3142,叶文,2021-01-07 06:50:04,0,2,2,非常感谢老师，真的是很温柔的人( ﾉωﾉ)
132013,3142,叶文,2021-01-30 02:53:05,6,6,0,也付出了挺多，最后绩点不是很理想
132021,3142,叶文,2021-01-30 03:09:49,0,2,2,老师人真的挺好的，上课也没有那种压迫感，很关注学生的看法。
132022,3142,叶文,2021-01-30 03:11:13,8,9,1,给分太差了吧？为什么才给3.6？明明付出也不少，但是给分也太差了吧？希望后续的同学选他的课慎重。真绩杀。
155081,3142,叶文,2022-06-08 05:53:31,0,4,4,老师人很好很温柔，是真的关心学生，想要同学过个有意义的大学，也给了很多人生观念上的指导。但是思政课都比较无聊吧，讲故事的时候我会认真听。\n\n我们小组作业很拉垮，但是读书报告和期末考试都有好好写好好准备，最后4.5。仅供参考。
166600,3142,叶文,2023-01-13 03:24:13,5,6,1,给分真的不太好
166783,3142,叶文,2023-01-13 14:48:02,-2,2,4,老师真的很真诚！虽然小组作业做到崩溃但是努力做了就会有回报，给分也挺好的。
166818,3142,叶文,2023-01-13 16:53:51,-3,1,4,很负责任的老师，上课内容虽然说比较枯燥但是我觉得这是所有思政类课程的通病吧，叶老师本人讲解还是很细致的，以及叶老师本人真的非常非常耐心，作业提交遗漏了也没有责怪。我觉得是给分很求是的老师，读书报告和小组研究学习认真做了卷了字数，期末开卷也尽量答了，最后绩点4.8，身边同学的绩点基本也符合个人付出。总体来说就是按要求完成任务就会得到相应成绩，最后再强调一句叶老师真的很好！
167135,3142,叶文,2023-01-15 04:14:21,-4,1,5,老师人真的很好，但个人本身不太喜欢政治，所以没咋听，读书报告卷了字数（要求3000及以上，我写了5000），小组研究性学习搞了论文，期末开卷尽我所能答了，字数不是很多（四道题2800左右，真的不多），最后4.2，不过是88分，就很淦，感觉老师给分还是很合理的，没有上面说的那么卡绩。朋友是同一节课，他超级卷，上课也回答问题，课后所有作业都很卷，最后4.8。
171818,3142,叶文,2023-04-06 12:14:23,2,2,0,老师给分真的很查 能run就run吧 不然会后悔
172414,3142,叶文,2023-04-26 11:11:07,2,2,0,感谢老师卡绩之恩！
4644,3181,施晨辉,2015-06-25 11:11:46,1,6,5,挺为学生着想的，讲课一般
7552,3181,施晨辉,2015-09-15 03:34:15,13,16,3,这门课没什么好说的，老师很不错
8496,3181,施晨辉,2015-09-22 01:35:04,5,5,0,老师人挺好的 也不会太多作业
9278,3181,施晨辉,2015-10-20 02:10:25,7,7,0,很轻松
9637,3181,施晨辉,2015-11-03 14:52:04,6,6,0,真的好老师
11289,3181,施晨辉,2015-11-26 09:10:24,3,3,0,老师平和、负责
13516,3181,施晨辉,2015-12-29 01:13:35,3,4,1,听他上课你会觉得他在课前聊天 找不到重点
17682,3181,施晨辉,2016-01-20 15:40:42,0,1,1,老师不错，很为学生着想
17774,3181,施晨辉,2016-01-21 01:05:52,0,2,2,老师人不错的，真的
18360,3181,施晨辉,2016-01-21 13:25:58,0,3,3,思修老师嘛！上课就是给大家讲讲而已，你还能要他给你讲什么呢？从这个角度看他还挺为学生着想的。\n\n
18744,3181,施晨辉,2016-01-22 12:37:22,5,6,1,老师真不错，很多话很有道理
48889,3181,施晨辉,2017-03-15 23:28:17,0,1,1,老师很好，很推荐
50266,3181,施晨辉,2017-05-02 05:25:30,3,4,1,老师很温柔，上课干活其实很多，课后作业也不多。下雨的时候，老师还会带紫金港的我们回学校...
50646,3181,施晨辉,2017-05-04 04:30:38,1,2,1,老师人超好，作业也不多，还会带紫荆港的同学回去\n\n
106539,3181,施晨辉,2019-04-28 04:58:06,2,2,0,超级棒耶，上的西溪的课，保证你可以晚上每次都能赶上74路会紫金港，一个职规书一个展示一个人物访谈就完事儿了。
107268,3181,施晨辉,2019-05-03 01:15:12,5,5,0,老师挺好的，但最后给分只能说一般了。
107276,3181,施晨辉,2019-05-03 02:17:41,0,1,1,还不错 事情比较少，还是能学到些干货的。给分还可以，不算差，但也不算最好
107347,3181,施晨辉,2019-05-04 05:46:52,3,3,0,没啥好说的，觉得给分和付出努力不成正比。在上课和对同学的关心照顾上算是很好的那种了
107394,3181,施晨辉,2019-05-05 00:17:39,2,2,0,给分真心一般，几个晚上搞出来的规划书和访谈。
33927,3195,沈晓华,2016-09-23 01:58:29,-3,0,3,老师非常。好⊙▽⊙
44803,3195,沈晓华,2017-01-18 09:20:43,-3,1,4,思修给分真的烂
75106,3195,沈晓华,2018-03-07 10:48:32,3,4,1,上了沈老师的遥感物理基础。这真不是通识课，说实话九成听不懂，老师给分很好，但是不建议选，一个学期下来没什么收获。
106839,3195,沈晓华,2019-04-30 04:10:14,-7,6,13,职规a事情少，给分棒！老师真的十分可爱十分好了！
108910,3195,沈晓华,2019-06-04 06:16:59,2,3,1,绩杀\n\n不明白为什么总有这种绩杀老师\n\n让学生不好过你很开心？\n\n我们再给你评低分你也很开心？\n\n
109351,3195,沈晓华,2019-06-13 07:57:10,4,6,2,职规A，老师人还行，上课不用听，分小组按组轮换坐，点名，事情不算多，给分看鹅颈，总体一般
117365,3195,沈晓华,2019-09-23 11:08:29,0,2,2,这老师很垃圾
127133,3195,沈晓华,2020-11-09 15:16:21,1,1,0,垃圾老师，官僚作风，看不下去/
133116,3195,沈晓华,2021-02-08 21:58:26,0,0,0,垃圾老师
181860,3195,沈晓华,2023-11-02 13:24:49,2,2,0,职规A，老师挺认真的，真的想学点东西可以报，但是想作为一节水课的话真的请远离，事情超级多……
183345,3195,沈晓华,2023-11-24 03:46:10,2,2,0,给分还行，事情算是比较多的，但是蛮有帮助的
184314,3195,沈晓华,2023-12-16 16:10:59,1,1,0,职规，老师课内容上的还是蛮有趣的，声音很温柔，事情稍微有点多（或许是职规通病？）但是真情实感认真完成作业给分还是不错的。
196799,3195,沈晓华,2024-07-05 08:02:47,2,2,0,一般吧，职规这门课不同的老师大同小异，逃不过的
204265,3195,沈晓华,2024-11-25 05:44:42,1,1,0,职规课事情特别多，各种没什么意义的个人和小组作业……这个老师期末展示也不框范围，（有意或无意）鼓励恶竞，还是同学打分。。基本不看内容只看形式，没有舞台剧基本期末就没了，ppt做得再认真也没用。。作为一门短学期且没什么意义的课，不知道这样折腾学生有什么意思。。老师甚至还真的认为这个课与专业课同等重要，无语。。
2140,3209,孙大雁,2017-06-07 15:39:28,140,159,19,思修课完全乱给分，讲课不知道在讲什么，讲不下去了就请同学发言，无语了
5072,3209,孙大雁,2015-07-03 08:24:46,175,203,28,无聊到极点
5203,3209,孙大雁,2015-07-05 23:47:15,68,76,8,无聊
7017,3209,孙大雁,2015-08-28 11:25:53,69,81,12,无聊
7026,3209,孙大雁,2015-09-13 09:04:38,114,134,20,无聊
7032,3209,孙大雁,2015-08-31 05:22:59,204,224,20,想给零分
7034,3209,孙大雁,2015-09-03 04:11:43,116,134,18,非法搜身
7043,3209,孙大雁,2015-09-01 04:16:31,91,106,15,日狗了
7044,3209,孙大雁,2015-09-01 04:18:26,68,81,13,好老师啊，你信吗？
7045,3209,孙大雁,2019-06-12 02:59:00,670,744,74,这种垃圾渣滓竟然是浙大的老师，浙大也真特么悲哀
7046,3209,孙大雁,2015-09-01 04:27:24,91,105,14,从未见过如此 老师
7047,3209,孙大雁,2015-09-01 04:22:29,55,62,7,无聊
7049,3209,孙大雁,2017-06-07 15:38:36,321,363,42,Sb二字足够说明问题\n\n
7050,3209,孙大雁,2015-09-01 04:26:20,42,51,9,呃
7051,3209,孙大雁,2015-09-01 04:26:36,79,94,15,我也是醉了..
7053,3209,孙大雁,2015-09-01 04:30:43,60,72,12,想哭
7054,3209,孙大雁,2015-09-01 04:31:36,75,84,9,更年期无限长…
7055,3209,孙大雁,2015-09-01 04:37:48,258,283,25,精致的利己主义者
7056,3209,孙大雁,2018-10-27 06:03:02,357,394,37,我只想说不打一分的都是托。
7058,3209,孙大雁,2019-08-19 13:08:17,483,551,68,呵呵，呵呵呵。中年妇女脾气多，就是一街头大妈的骂人模样。各位军训的童鞋可要好自为之哦…
7060,3209,孙大雁,2019-03-01 02:10:06,1647,1765,118,我告诉你们。。这老师多一分就害死十个人。。自己看着办。。顶我上前排！
7061,3209,孙大雁,2015-09-01 15:37:37,115,130,15,托好像来了，1。37到1。53了
7062,3209,孙大雁,2015-09-08 05:33:26,74,89,15,可以的
7063,3209,孙大雁,2015-09-01 10:28:18,48,56,8,日了狗了\n\n
7064,3209,孙大雁,2018-08-25 10:41:12,451,513,62,其实是一个普法的好老师：\n\n中华人民共和国宪法第三十七条 中华人民共和国公民的人身自由不受侵犯 禁止非法搜查公民的身体。
7066,3209,孙大雁,2017-06-07 15:39:23,130,146,16,我从未见过如此不在乎荣誉之徒/害羞
7067,3209,孙大雁,2015-09-01 22:32:38,205,226,21,浙大也有临时工？
7070,3209,孙大雁,2015-09-01 11:00:32,37,44,7,太凶
7072,3209,孙大雁,2017-06-07 15:39:13,174,198,24,如此不在意得失！不在意荣誉！不在意红旗的老师！除了大雁已经绝种
7076,3209,孙大雁,2015-09-01 11:06:13,42,48,6,折。。。腾。。。折。。。腾。。。折。。。腾。。。
7077,3209,孙大雁,2015-09-03 04:40:27,56,65,9,孱弱的暴政者
7078,3209,孙大雁,2015-09-01 11:14:19,91,103,12,乍一看很温柔，呆了两天才知道 真是日了狗
7079,3209,孙大雁,2015-09-03 04:16:12,40,45,5,什么玩意
7081,3209,孙大雁,2015-09-01 11:10:52,130,148,18,典型的两面派，从来不把学生当成一个人来看待，只为了个人私心，无耻，无耻啊，无耻。\n\n
7083,3209,孙大雁,2015-10-08 12:55:03,-25,24,49,很好的老师其实
7084,3209,孙大雁,2017-06-07 15:39:32,140,153,13,打一分以上的都是托，请相信我
7085,3209,孙大雁,2015-09-01 11:33:59,22,29,7,呵呵呵了
7086,3209,孙大雁,2015-09-01 12:15:45,-102,16,118,大家消气吧 别玩了
7087,3209,孙大雁,2015-09-01 12:20:03,-135,17,152,淡泊名利的好老师
7088,3209,孙大雁,2016-06-21 02:43:21,-179,29,208,爱你，孙，老，师。请踩不客气
7089,3209,孙大雁,2015-09-01 13:12:29,42,52,10,看以上评论即可。说明一切
7090,3209,孙大雁,2015-09-01 14:21:10,49,54,5,差，很差，各种差！反正一个字，差！
7092,3209,孙大雁,2015-09-03 05:40:48,-79,9,88,还好
7093,3209,孙大雁,2015-09-02 00:41:52,27,33,6,不说了，都是泪
7103,3209,孙大雁,2015-09-02 05:39:24,23,29,6,呵呵
7107,3209,孙大雁,2015-09-02 12:08:39,13,20,7,烂
7110,3209,孙大雁,2015-09-02 14:26:06,40,46,6,教心理的但自己的心理却不调整好
7112,3209,孙大雁,2015-09-03 04:14:34,23,28,5,费力不讨好   真是醉  还老叽叽歪歪
7113,3209,孙大雁,2015-09-03 04:16:28,37,42,5,从未见过如此厚颜无耻之人
7114,3209,孙大雁,2015-09-03 04:37:17,16,18,2,呵呵哒
7115,3209,孙大雁,2015-09-03 04:36:08,-29,3,32,呃
7122,3209,孙大雁,2019-03-28 05:33:37,468,516,48,军训期间为搜查同学是否带手机而下令搜身，在有同学提出反对后还一意孤行。作为一个大学的指导员，如此没有法律观念，我认为是丢了浙江大学的颜面。
7132,3209,孙大雁,2015-09-05 04:07:46,20,26,6,是一种酸爽的体验
7133,3209,孙大雁,2015-09-05 05:42:43,100,110,10,为人很假，色厉内荏，有一种想当然的自恋。啥事都喜欢插手，觉得自己经验丰富，然而很多时候是在胡整。
7135,3209,孙大雁,2015-09-05 10:17:10,14,20,6,呵呵
7137,3209,孙大雁,2015-09-05 11:25:17,17,21,4,心理变态
7140,3209,孙大雁,2015-09-05 15:33:00,28,38,10,就像吃了翔一样
7225,3209,孙大雁,2015-09-11 12:48:26,17,21,4,呵呵了
7288,3209,孙大雁,2015-09-17 03:28:50,-69,14,83,老师真的蛮好的，只是大家一时之气
7295,3209,孙大雁,2015-09-13 07:45:59,14,18,4, 无语
7310,3209,孙大雁,2015-09-13 10:28:26,14,18,4,呵呵哒
7311,3209,孙大雁,2015-09-13 10:30:21,11,17,6,。。。不解释
7431,3209,孙大雁,2015-09-14 10:57:19,18,22,4,辣鸡
7470,3209,孙大雁,2015-09-14 14:18:50,23,28,5,SBility
7648,3209,孙大雁,2015-09-15 07:33:57,-66,4,70,原来我要是评10分她就1.92了
7757,3209,孙大雁,2015-09-15 12:30:46,-18,8,26,大学时代很漂亮，然后就不知道怎么了
7841,3209,孙大雁,2015-09-15 14:51:48,-48,6,54,淡泊名利
7847,3209,孙大雁,2015-09-15 15:23:47,41,50,9,我只是想看看再给个1有多影响均绩
7924,3209,孙大雁,2015-09-16 06:57:27,-72,12,84,没必要吧各位学弟学妹
8020,3209,孙大雁,2015-09-16 13:43:55,-29,8,37,真的棒
8124,3209,孙大雁,2015-09-17 05:40:38,11,17,6,无语，真无语
8130,3209,孙大雁,2015-09-17 06:01:39,15,19,4,真心差
8219,3209,孙大雁,2015-09-17 14:45:44,14,22,8,几天不见均绩高了好多！大雁醒醒！
8243,3209,孙大雁,2015-09-17 23:54:35,15,19,4,可怜的学生。
8346,3209,孙大雁,2015-09-19 00:20:58,2,13,11,看在龙哥的面子上
8377,3209,孙大雁,2015-09-20 04:57:02,-55,8,63,没这么夸张，还可以吧毕竟是军训。平时挺好的\n\n
8575,3209,孙大雁,2015-09-22 14:02:46,-55,6,61,老师其实不错的，不喜勿喷
8643,3209,孙大雁,2015-09-23 13:07:58,41,49,8,日了大雁了
8724,3209,孙大雁,2015-09-24 12:47:32,0,6,6,无语。。。
8733,3209,孙大雁,2015-09-25 01:56:10,-32,10,42,OMG不就是军训吗至于你
8741,3209,孙大雁,2015-09-25 05:03:20,15,19,4,垃圾老师
8742,3209,孙大雁,2015-09-25 05:04:32,8,12,4,唉，一言难尽
8815,3209,孙大雁,2015-09-28 07:01:11,12,19,7,呵呵。没人性。
8835,3209,孙大雁,2015-09-28 23:15:02,10,14,4,太无聊恶心了
8937,3209,孙大雁,2015-10-03 11:48:41,1,4,3,呵呵哒
8983,3209,孙大雁,2015-10-08 03:34:03,6,12,6,给跪了
9030,3209,孙大雁,2015-10-10 12:44:43,62,74,12,这样的人竟然来浙大做老师！上课就在扯淡！！！根本不知道讲了什么！搞很多的形式！！！这让我们怎么考试！怎么不挂科！不明白浙大为什么聘请这样的人！
9293,3209,孙大雁,2015-10-20 09:04:05,-54,5,59,老师挺好哒
9334,3209,孙大雁,2015-10-22 03:58:43,-38,5,43,至今没感觉多差
9408,3209,孙大雁,2015-10-26 09:04:28,-48,7,55,超级好的老师
9481,3209,孙大雁,2015-11-26 04:11:06,6,10,4,呵呵。
9546,3209,孙大雁,2015-10-30 01:45:53,1,6,5,想死！！！！！！！！！
9635,3209,孙大雁,2015-11-03 14:28:16,2,6,4,呵呵呵
9636,3209,孙大雁,2015-11-03 14:45:04,9,13,4,城会玩
9661,3209,孙大雁,2015-11-04 02:26:17,3,7,4,呵呵哒
9781,3209,孙大雁,2015-11-09 02:46:44,3,8,5,想死的感觉
9848,3209,孙大雁,2015-11-11 05:19:04,1,7,6,呵呵呵呵\n\n
9852,3209,孙大雁,2015-11-11 06:32:52,0,6,6,没听过
9873,3209,孙大雁,2015-11-11 12:11:18,17,23,6,这是一种比闻脚臭更醉人的体验
9874,3209,孙大雁,2015-11-11 12:12:00,4,9,5,呵呵哒
9875,3209,孙大雁,2015-11-11 12:20:02,33,37,4,吃屎的感觉，她永远是便秘的表情
9885,3209,孙大雁,2015-11-12 01:21:26,-9,5,14,公道自在人心
10184,3209,孙大雁,2015-11-17 08:12:19,2,6,4,无聊，不近人情。
10409,3209,孙大雁,2015-11-18 12:45:33,3,7,4,三个字
10547,3209,孙大雁,2015-11-19 15:53:20,2,8,6,跟风sb
10600,3209,孙大雁,2015-11-20 13:31:29,4,9,5,渣渣
10642,3209,孙大雁,2015-11-21 09:09:17,7,11,4,简直傻逼
10685,3209,孙大雁,2015-11-22 11:09:52,0,5,5,老师。。。。。
10686,3209,孙大雁,2015-11-22 11:11:28,5,9,4,汗死了
10751,3209,孙大雁,2015-11-23 04:20:52,3,8,5,呵呵呵\n\n
10767,3209,孙大雁,2015-11-23 04:53:22,2,8,6,呵呵哒
10894,3209,孙大雁,2015-11-23 08:24:43,4,6,2,\n\n。。
11033,3209,孙大雁,2015-11-24 02:59:46,5,10,5,十分恶心
11256,3209,孙大雁,2015-11-26 03:00:44,6,9,3,。。。
11368,3209,孙大雁,2015-11-29 04:58:02,1,6,5,
11437,3209,孙大雁,2015-12-01 08:46:17,-2,4,6,无聊的一逼
11463,3209,孙大雁,2015-12-02 07:18:34,2,10,8,真是日了大雁了……
11498,3209,孙大雁,2015-12-02 15:27:38,0,3,3,呵呵呵
11657,3209,孙大雁,2015-12-09 11:55:58,1,4,3,呵呵呵
11680,3209,孙大雁,2015-12-18 00:36:10,3,6,3,......
11795,3209,孙大雁,2015-12-15 14:30:49,5,9,4,真没见过这么恶心的一个人 这活得精彩 不信你选选试试
11796,3209,孙大雁,2015-12-15 14:32:25,-1,3,4,天哪！红红火火恍恍惚惚！
11859,3209,孙大雁,2015-12-18 09:01:21,-1,3,4,蛤蛤蛤蛤
11861,3209,孙大雁,2015-12-18 09:03:36,-11,1,12,好好学习，天天向上。
11886,3209,孙大雁,2015-12-20 10:28:32,1,4,3,...
11944,3209,孙大雁,2015-12-21 11:24:20,-1,5,6,糟糕，要命
11959,3209,孙大雁,2015-12-21 11:41:00,-8,4,12,好好好
12005,3209,孙大雁,2015-12-21 13:18:17,-31,6,37,老师蛮好的嘛 （军训辅导员不是她）
12112,3209,孙大雁,2015-12-22 12:42:35,-1,1,2,呵呵哒
12135,3209,孙大雁,2015-12-22 03:12:42,16,23,7,上课之前说她的心理课一定会给我们带来很多收获，自恋到无可救药，结果说了一节课废话空话，心理知识一点都不专业
12191,3209,孙大雁,2015-12-22 09:04:56,0,2,2,。。。
12207,3209,孙大雁,2015-12-22 10:20:58,-2,1,3,哎哎哎\n\n
12229,3209,孙大雁,2015-12-22 12:01:52,0,2,2,1111
12278,3209,孙大雁,2015-12-22 21:51:37,-1,2,3,。。。
12299,3209,孙大雁,2015-12-23 01:54:04,-3,1,4,hhhhh
12313,3209,孙大雁,2015-12-23 02:44:15,-2,1,3,反正没上过她的课，忍不住
12342,3209,孙大雁,2015-12-23 04:13:12,2,5,3,悲哀，
12344,3209,孙大雁,2015-12-23 04:19:45,-1,1,2,。。。。。。
12436,3209,孙大雁,2015-12-23 09:19:25,-121,8,129,我是可爱的大雁宝宝，我给了大雁姐姐10分的高分，大家尽情的踩我吧。
12594,3209,孙大雁,2015-12-23 14:37:46,-14,3,17,美丽老师
12728,3209,孙大雁,2015-12-24 02:44:23,0,2,2,不多说了
12839,3209,孙大雁,2015-12-28 03:02:51,70,75,5,很想上她的课！大家给我推荐一下哪门课最傻逼，我去选啊！
12846,3209,孙大雁,2015-12-24 06:29:22,-4,4,8,很好哦
12887,3209,孙大雁,2015-12-24 07:26:28,-1,1,2,不想说啥\n\n
12905,3209,孙大雁,2015-12-24 08:05:24,1,2,1,。。。\n\n
12967,3209,孙大雁,2015-12-24 12:03:16,-1,1,2,呵呵哒
13033,3209,孙大雁,2015-12-24 14:35:55,-1,1,2,2。49\n\n
13133,3209,孙大雁,2015-12-25 02:37:54,6,8,2,终于摆脱她了T^T
13178,3209,孙大雁,2015-12-25 05:13:58,1,2,1,凑热闹
13238,3209,孙大雁,2015-12-27 12:14:49,-15,4,19,很棒的老师
13378,3209,孙大雁,2015-12-27 12:14:17,-8,2,10,好好好
13379,3209,孙大雁,2015-12-27 12:14:37,0,2,2,啊啊啊
13394,3209,孙大雁,2015-12-27 15:01:25,1,5,4,为了同学们，我给一分
13419,3209,孙大雁,2015-12-28 02:49:18,1,4,3,hhhhh
13421,3209,孙大雁,2015-12-28 03:05:41,0,3,3,差差差
13424,3209,孙大雁,2015-12-28 03:15:53,-1,2,3,选择死亡
13452,3209,孙大雁,2015-12-28 06:13:03,92,98,6,预置课是孙大雁的我哭着看完楼上评论，╭(°A°`)╮
13798,3209,孙大雁,2015-12-31 04:48:03,2,5,3,呵呵，呵呵
14004,3209,孙大雁,2016-01-03 14:11:13,1,5,4,上她的课。。简直害怕。。。
14009,3209,孙大雁,2016-01-03 15:22:16,-1,2,3,呵呵哒
14011,3209,孙大雁,2016-01-03 15:42:44,0,3,3,呵呵呵
14181,3209,孙大雁,2016-01-05 07:28:39,2,5,3,渣渣渣
14286,3209,孙大雁,2016-01-06 06:13:31,10,13,3,我浙学生是有理智的
14310,3209,孙大雁,2016-01-06 07:48:28,2,5,3,发起火来整个一泼妇
14328,3209,孙大雁,2016-01-06 10:19:09,3,8,5,好老师啊！怒给一分
14461,3209,孙大雁,2016-01-14 03:07:02,0,4,4,三个字
14498,3209,孙大雁,2016-01-07 09:07:36,5,13,8,SB老师
14714,3209,孙大雁,2016-01-08 12:04:00,7,11,4,傻逼老师，毁我青春。
14728,3209,孙大雁,2016-01-08 13:31:40,11,16,5,最垃圾的辅导员
14737,3209,孙大雁,2016-01-08 14:29:54,-28,8,36,老师人不错的，别乱黑
14749,3209,孙大雁,2016-01-08 15:30:02,6,11,5,孙碧池
14776,3209,孙大雁,2016-01-09 02:48:59,1,3,2,。。。
14805,3209,孙大雁,2016-01-09 11:00:48,-36,6,42,点名是负责任的表现 良心啊 给差评的都是自己不好好军训的
14865,3209,孙大雁,2016-01-10 11:23:46,-2,2,4,渣渣渣
15314,3209,孙大雁,2016-01-13 13:58:12,-7,2,9,不错啊
15494,3209,孙大雁,2016-01-15 00:00:56,1,3,2,你说呢
16289,3209,孙大雁,2016-01-17 17:23:59,-30,3,33,孙老师我爱你
17008,3209,孙大雁,2016-01-19 12:24:25,3,4,1,花样作死系列
17219,3209,孙大雁,2016-01-20 01:38:40,3,4,1,超级烂\n\n
17644,3209,孙大雁,2016-01-20 14:28:37,-1,2,3,呵呵，课不知道在上什么
17671,3209,孙大雁,2016-01-20 15:15:26,4,7,3,呵呵哒
17837,3209,孙大雁,2016-01-21 02:29:39,-30,8,38,你们怎么可以这么说呢，孙老师是个好老师。
17839,3209,孙大雁,2016-01-21 02:31:11,-17,4,21,其实老师还好吧...没有那么差
18139,3209,孙大雁,2016-01-21 08:07:43,-10,2,12,很好呀
18314,3209,孙大雁,2016-01-21 12:33:38,2,4,2,不好听
18517,3209,孙大雁,2016-01-22 01:35:59,12,15,3,日了大雁了
18577,3209,孙大雁,2016-01-22 05:16:23,-9,1,10,我可不是托\n\n
19092,3209,孙大雁,2016-01-23 08:51:31,-12,2,14,这个老师真的是特别高
19314,3209,孙大雁,2016-01-24 01:21:53,-1,2,3,不好呀\n\n
19442,3209,孙大雁,2016-01-24 08:33:05,-5,4,9,是个人
20145,3209,孙大雁,2016-01-26 08:35:27,10,16,6,人品有问题
20825,3209,孙大雁,2016-02-01 09:43:04,-32,5,37,看完楼上评论有点乱，军训不是她负责的。但聊的时候感觉人还蛮好的-_-
20832,3209,孙大雁,2016-02-01 12:20:52,-1,1,2,。。。
20881,3209,孙大雁,2016-02-03 01:13:34,0,1,1,
20919,3209,孙大雁,2016-02-04 03:29:18,12,17,5,傻逼一个 不配称老师
21146,3209,孙大雁,2016-02-21 13:21:03,9,14,5,碧池一个
21175,3209,孙大雁,2016-02-25 12:28:57,5,9,4,。。。。。。。。
21248,3209,孙大雁,2016-02-27 12:27:23,4,9,5,无语。
21330,3209,孙大雁,2016-02-28 04:52:48,-38,4,42,大家理性点，老师没这么差的，作为辅导员，人不错的
21337,3209,孙大雁,2016-02-28 05:27:20,3,7,4,我来帮忙清除祸害
21408,3209,孙大雁,2016-02-28 15:15:23,1,2,1,哦呵呵
21706,3209,孙大雁,2016-03-01 00:46:53,1,3,2,……没什么感觉
21746,3209,孙大雁,2016-03-01 03:00:54,6,8,2,哈哈哈
21889,3209,孙大雁,2016-07-01 10:02:03,13,17,4,。。。
22110,3209,孙大雁,2016-03-02 11:08:55,-1,5,6,差到极点
22114,3209,孙大雁,2016-03-02 11:26:16,-7,1,8,呵呵呵呵
22129,3209,孙大雁,2016-03-02 12:19:59,7,10,3,竟无言以对
22138,3209,孙大雁,2016-03-02 12:59:59,18,21,3,有幸我没上过她的课
22151,3209,孙大雁,2016-03-02 15:06:17,2,6,4,不说了
22233,3209,孙大雁,2016-03-03 04:45:15,-24,4,28,蛮好的呀
22330,3209,孙大雁,2016-03-03 15:51:31,0,4,4,大sb
22340,3209,孙大雁,2016-03-04 00:56:48,1,2,1,呵呵呵呵呵呵呵呵
22381,3209,孙大雁,2016-03-04 04:50:47,1,3,2,看着就烦
22592,3209,孙大雁,2016-03-08 08:52:20,0,1,1,。。。
22614,3209,孙大雁,2016-03-09 00:54:19,4,5,1,333
22739,3209,孙大雁,2016-03-10 10:34:54,-1,2,3,呵呵呵
22790,3209,孙大雁,2016-03-11 09:08:54,33,37,4,给1分，出一份绵薄之力
23519,3209,孙大雁,2016-04-04 02:54:06,2,3,1,我就看着不说话
23550,3209,孙大雁,2016-04-06 00:17:35,8,14,6,这个老师说实话不适合在浙大
23580,3209,孙大雁,2016-04-07 05:50:00,-2,4,6,就这个feel，倍儿爽
23711,3209,孙大雁,2016-04-13 07:46:31,19,22,3,脸上麻子太多，差评
23770,3209,孙大雁,2016-04-15 14:05:58,0,0,0,噢噢噢噢
23850,3209,孙大雁,2016-04-18 16:14:16,1,2,1,呵呵呵
23938,3209,孙大雁,2016-04-22 01:48:37,48,57,9,为了自己停车方便，让楼长阿姨把前面停自行车的地方空出来给她放小龟
23941,3209,孙大雁,2016-04-22 02:13:06,2,3,1,哦呵呵
24484,3209,孙大雁,2016-04-30 15:39:46,37,44,7,我只知道大一她当辅导员，要求我们每个人均绩一定要上3.8，没上的通通要谈话
24664,3209,孙大雁,2016-05-03 03:26:20,12,19,7,表示这个老师思修拉低了大一上整体的绩点。
24689,3209,孙大雁,2016-05-03 06:08:31,-1,0,1,。。。
24751,3209,孙大雁,2016-05-03 15:56:22,15,21,6,过河拆桥的傻逼
24756,3209,孙大雁,2016-06-11 14:49:02,4,8,4,两面三刀
24960,3209,孙大雁,2017-01-12 05:43:26,3,7,4,给分差
25260,3209,孙大雁,2016-05-09 05:10:22,9,12,3,这个老师出名的渣滓
25268,3209,孙大雁,2016-06-11 14:48:50,34,40,6,相处久了才发现 原来不是真心关心我们
25338,3209,孙大雁,2016-05-15 10:29:42,0,3,3,啪啪啪
25364,3209,孙大雁,2016-10-28 13:34:26,-29,4,33,做为辅导员还算尽心吧
25606,3209,孙大雁,2016-05-27 17:28:57,-10,1,11,+1分
25838,3209,孙大雁,2016-06-11 10:03:20,-12,3,15,感觉还可以吧
25918,3209,孙大雁,2016-06-28 08:23:34,5,9,4,傻逼老师
25932,3209,孙大雁,2016-06-14 12:17:16,2,7,5,一分以上都是拖？
25987,3209,孙大雁,2016-06-15 01:28:50,3,3,0,...
26174,3209,孙大雁,2016-06-16 07:07:44,-2,5,7,简直是人间享受啊！
26276,3209,孙大雁,2016-06-16 13:13:54,7,9,2,哗了狗
26382,3209,孙大雁,2016-06-17 09:01:56,1,2,1,hhh
26408,3209,孙大雁,2016-06-18 04:32:55,1,4,3,就是个垃圾
26451,3209,孙大雁,2017-09-15 02:53:02,8,30,22,我爱大雁啊
26585,3209,孙大雁,2016-06-20 07:55:35,-1,2,3,呵呵了
26590,3209,孙大雁,2016-06-20 08:27:13,0,3,3,。。。
26670,3209,孙大雁,2016-06-21 01:25:57,1,3,2,………
26694,3209,孙大雁,2016-06-21 02:31:16,-1,1,2,。。。
26700,3209,孙大雁,2016-09-20 02:02:33,0,4,4,辣鸡辣鸡
26731,3209,孙大雁,2016-06-21 03:38:55,2,4,2,垃圾啊
26747,3209,孙大雁,2016-06-21 04:42:52,1,3,2,很爽啊
27148,3209,孙大雁,2016-06-23 07:55:07,0,3,3,哈哈哈
27235,3209,孙大雁,2016-09-22 03:26:11,-35,6,41,孙老师人真的很好啊！你们不要绩点低了就乱说话
27309,3209,孙大雁,2016-09-26 07:55:17,9,12,3,无聊，只会装模作样
27754,3209,孙大雁,2016-06-27 11:13:32,1,4,3,...
27784,3209,孙大雁,2016-06-27 13:59:02,-7,3,10,好老师啊啊啊啊
28062,3209,孙大雁,2016-06-28 08:03:23,-14,6,20,j类没选上的同学们来学她的职业生涯规划吧，事少，起码能把j类混一个，就是上课比较无聊，做的活动很蠢，还有记得提前写职业生涯规划书，这老师期末了才想起留作业，想有点收获的可以换别的老师了
28523,3209,孙大雁,2016-06-28 09:51:36,-1,2,3,呵呵呵
28791,3209,孙大雁,2016-06-28 15:17:16,-1,2,3,垃圾老师
29926,3209,孙大雁,2016-06-30 14:00:02,-3,3,6,好好好。
30090,3209,孙大雁,2016-07-01 02:19:00,-6,3,9,挺好的啊
30212,3209,孙大雁,2016-07-01 05:41:10,-1,1,2,只是看看评论...
32340,3209,孙大雁,2016-09-11 13:54:29,-5,4,9,助人为乐
32342,3209,孙大雁,2016-07-06 07:38:54,2,2,0,不认识
32469,3209,孙大雁,2016-07-07 05:15:30,18,21,3,本来不信，现在信了，新生别选，别选，别选，用血总结的教训
32620,3209,孙大雁,2016-07-08 07:07:18,-3,3,6,挺好的，修学分
32728,3209,孙大雁,2016-07-11 22:49:29,-11,1,12,老师挺好的
32849,3209,孙大雁,2016-07-18 14:12:58,-1,2,3,呵呵\n\n
33107,3209,孙大雁,2016-11-22 01:10:46,0,3,3,呵呵呵
33163,3209,孙大雁,2016-09-14 11:41:40,-25,5,30,明明很好啊。老师温柔又漂亮。可以学到东西的。
33192,3209,孙大雁,2016-09-15 07:58:59,1,4,3,日日日
33206,3209,孙大雁,2016-09-15 16:04:02,2,3,1,呵呵呵。
33274,3209,孙大雁,2016-09-17 10:11:46,1,2,1,。。。
33275,3209,孙大雁,2016-09-17 10:29:00,2,3,1,我是路过的\n\n
33326,3209,孙大雁,2016-11-06 07:26:28,4,10,6,真是好老师。我给一分\n\n
33515,3209,孙大雁,2016-09-20 02:03:55,3,7,4,我去你姥姥的
33943,3209,孙大雁,2016-09-23 05:24:13,-2,1,3,。。。。。
33976,3209,孙大雁,2016-09-24 05:13:00,-1,2,3,辣鸡。。。。。
34707,3209,孙大雁,2016-10-19 02:10:55,4,6,2,sbsb
34779,3209,孙大雁,2016-10-21 16:13:44,-1,3,4,CNM
34868,3209,孙大雁,2016-10-25 15:10:19,0,1,1,不想评论
34991,3209,孙大雁,2016-10-28 08:01:07,0,3,3,想死的感觉
35181,3209,孙大雁,2016-11-04 01:57:18,-1,1,2,
35471,3209,孙大雁,2016-12-21 12:24:14,1,3,2,吱吱吱、
36206,3209,孙大雁,2016-11-11 05:36:24,-1,2,3,这老师呵呵
36408,3209,孙大雁,2016-11-13 06:05:07,0,9,9,hhhhhhh本来想给2分的但怎么都点不了只能给一分了 我只想说心理咨询别找她 我说怎么没人选她 一点都不好
36744,3209,孙大雁,2016-11-16 00:34:36,3,5,2,无聊啊
36849,3209,孙大雁,2016-11-16 08:45:57,-1,2,3,辣鸡，辣鸡，辣鸡
36922,3209,孙大雁,2016-11-16 14:06:28,1,3,2,呵呵呵
37398,3209,孙大雁,2016-11-18 16:14:40,49,55,6,做展示的时候，好刁难人，很看不起人，居高临下，以为自己很厉害是吗，你特么就是一副碧池样，太讨厌了，我特么好好的一个展示就被你特么毁了！是看到别的辅导员进来受刺激想展示自己在学生面前多有威严吗！！真的是一个老师吗，我天浙大怎么会有这种老师！大学没毕业吧还！真的很庆幸我的辅导员不是她！！
38149,3209,孙大雁,2017-06-14 09:19:59,-1,7,8,恶心的中年妇女
38520,3209,孙大雁,2016-12-07 13:41:36,-2,2,4,垃圾垃圾垃圾
39093,3209,孙大雁,2016-12-21 06:31:21,1,3,2,3个字
39122,3209,孙大雁,2016-12-21 09:00:43,6,13,7,满屏幕找0分没找到，没办法只能给个1分
39267,3209,孙大雁,2016-12-22 01:25:04,2,5,3,一条狗
39498,3209,孙大雁,2016-12-23 08:03:36,-1,8,9,你在上课时候的浪教很迷人～真心想x了你\n\n
39668,3209,孙大雁,2017-01-21 08:36:01,10,14,4,感觉有水军，都这么高了，二点多
39800,3209,孙大雁,2016-12-27 15:46:16,1,5,4,吃屎的体验
40175,3209,孙大雁,2016-12-29 16:15:24,-8,3,11,老师还是挺好的
40403,3209,孙大雁,2017-01-03 07:15:23,0,1,1,欲死不能
40443,3209,孙大雁,2017-01-03 10:34:35,0,4,4,我是来看评论的…\n\n
40562,3209,孙大雁,2017-01-04 05:37:40,2,3,1,辣鸡老师
40635,3209,孙大雁,2017-01-04 12:08:49,-1,1,2,无语了。
40636,3209,孙大雁,2017-01-04 12:10:45,0,5,5,听老师的课是一种会死人的体验……\n\n事情多……\n\n任务讲不清……\n\n这是核弹头……\n\n离得远一点好……
40638,3209,孙大雁,2017-01-04 12:11:07,-1,2,3,zz浙大怎么会有这样的zz老师
41155,3209,孙大雁,2017-01-09 14:09:37,-12,4,16,只想说老师思修课挺好的
41644,3209,孙大雁,2017-01-12 09:37:42,13,19,6,这么说吧…不幸是她团总支的…任何机会就给她熟悉那几个学生…把偏心不公正诠释到极致…还好再半年就可以摆脱了，真是命途多舛啊遇上这么个辅导员
42634,3209,孙大雁,2017-01-14 15:47:32,-6,4,10,不错哟
43426,3209,孙大雁,2017-01-16 08:54:14,1,5,4,0分 不解释
45988,3209,孙大雁,2017-01-20 10:47:34,-26,11,37,其实我觉得还挺好的啊，讲课也还不错给分挺好～最重要的是每次为借不到活动室伤透脑筋的时候都是大雁姐救命…总之雁姐人挺好的，很关心学生，在她的职规课上我也学到了很多。希望各位浙大学子评价还是【求是】一点，至少我看到的雁姐和现在热评里的那个恶劣的人，截然不同。
46054,3209,孙大雁,2017-02-26 01:15:26,-29,8,37,挺好的老师啊，给了我满绩，人很好很温柔的，事情也不是很多，好好完成就行
46315,3209,孙大雁,2017-08-30 11:22:34,-71,11,82,比心老师！真的很温柔很好 给分超级棒！反正她的职规是我上的最开心轻松的课！而且学到了很多 她请来的优秀学长学姐经验分享 资深HR真的都炒鸡棒！上课形式也很有趣！很有意义的一次课！值得一听！
47955,3209,孙大雁,2017-02-27 14:08:39,1,2,1,.....
48380,3209,孙大雁,2017-03-02 12:45:57,1,6,5,一颗老鼠屎丢到了浙大这锅汤里。
48623,3209,孙大雁,2017-03-08 13:25:35,-5,0,5,哈哈哈\n\n
49337,3209,孙大雁,2017-04-06 03:55:51,2,6,4,压榨学生劳动力
49357,3209,孙大雁,2017-04-07 10:00:22,-2,1,3,。。。。
49383,3209,孙大雁,2017-06-07 15:38:12,-1,2,3,呵呵哒
49399,3209,孙大雁,2017-04-10 07:30:46,0,2,2,醉醉醉
49745,3209,孙大雁,2017-04-25 09:41:43,0,3,3,损大演
50232,3209,孙大雁,2017-05-01 21:38:40,-1,3,4,辣鸡！
50690,3209,孙大雁,2017-05-04 10:06:11,10,13,3,真的垃圾，讲课没有意思，给分像屎，看心情，你惹到他就绝对没好脸色给你看，认认真真做的大作业真他妈不知道为什么这么低。
50792,3209,孙大雁,2017-05-05 11:59:04,-1,4,5,因为是沟领，还是挺值的！
51611,3209,孙大雁,2017-06-07 13:10:24,2,3,1,辣鸡，态度这么不好。。。
51974,3209,孙大雁,2017-06-14 03:33:45,-2,1,3,呵呵呵
52440,3209,孙大雁,2017-06-20 05:30:05,0,1,1,极差。
53100,3209,孙大雁,2017-06-25 15:06:09,1,1,0,难受…
57168,3209,孙大雁,2017-07-06 00:54:01,-1,2,3,去你大爷，大雁
57517,3209,孙大雁,2017-07-09 07:16:38,5,6,1,巨凶，反复无常。
57944,3209,孙大雁,2017-07-18 06:46:39,1,2,1,哎哎哎
58262,3209,孙大雁,2017-08-28 04:53:06,-1,0,1,哎呦卧槽
58318,3209,孙大雁,2017-08-29 02:08:06,-14,2,16,这个老师讲的好棒啊！
58336,3209,孙大雁,2017-08-29 03:46:29,1,2,1,qtmlgb
58370,3209,孙大雁,2017-08-30 03:45:40,-1,0,1,无语了……
58536,3209,孙大雁,2017-09-19 01:36:01,-3,1,4,没感觉
58643,3209,孙大雁,2017-09-12 01:25:27,0,2,2,无语无语
58701,3209,孙大雁,2017-09-15 06:47:41,3,5,2,活久见
58702,3209,孙大雁,2017-09-15 07:06:39,10,13,3,借场地收了表分配完去确认的时候说是学生助理乱填的，这样甩锅真是好笑啊，当大家都是傻的么
58724,3209,孙大雁,2017-09-16 02:35:36,-1,0,1,差差哈
58814,3209,孙大雁,2017-09-18 03:07:01,0,0,0,？？？
58820,3209,孙大雁,2017-09-18 03:44:15,1,4,3,给它一分是因为没有零分
58915,3209,孙大雁,2017-09-18 12:04:52,1,1,0,。。。。。
59402,3209,孙大雁,2017-09-21 06:48:38,-1,1,2,没听过 听说很差 \n\n
59431,3209,孙大雁,2017-09-21 09:47:44,11,15,4,这么说吧 两年里电气班的班费 一分也没拿到 每学期都说有五百 交了发票最后不了了之
59469,3209,孙大雁,2017-09-21 15:22:47,0,2,2,一言难尽
59475,3209,孙大雁,2017-09-21 23:58:44,-2,1,3,实在无聊，渣
59479,3209,孙大雁,2017-09-22 00:48:01,2,3,1,人很凶……
59549,3209,孙大雁,2017-09-22 12:50:13,17,22,5,中午被拉去开会 外卖来不及吃扔寝室 她一个人在上面放ppt 愣是撑到四点 ...然后我这天四点半吃的午饭
59563,3209,孙大雁,2017-09-23 00:23:23,2,4,2,来个一分尽自己绵薄之力\n\n
59815,3209,孙大雁,2017-09-27 07:23:19,-1,1,2,辣鸡。
59942,3209,孙大雁,2017-09-28 14:45:09,0,2,2,大雁奶奶
60015,3209,孙大雁,2017-10-03 13:31:56,-1,2,3,呵呵呵
60031,3209,孙大雁,2017-10-05 13:51:58,-1,1,2,
60037,3209,孙大雁,2017-10-07 02:26:24,1,5,4,慕名而来，1分略表敬意
60132,3209,孙大雁,2017-10-11 07:15:30,1,1,0,没感觉
60141,3209,孙大雁,2017-10-11 08:47:37,1,1,0,嘿嘿嘿\n\n
60421,3209,孙大雁,2017-10-19 12:07:31,2,5,3,垃圾老师
60422,3209,孙大雁,2017-10-19 12:07:44,2,2,0,哦天呐
60430,3209,孙大雁,2017-10-19 17:22:28,-1,0,1,呵呵呵
60536,3209,孙大雁,2017-10-23 11:53:28,-1,0,1,hhh
60783,3209,孙大雁,2017-10-30 05:04:49,-1,1,2,。。。
60874,3209,孙大雁,2017-11-01 01:49:04,1,2,1,啦啦啦德玛西亚
61233,3209,孙大雁,2017-11-13 00:27:41,2,5,3,慕名而来
61467,3209,孙大雁,2017-11-17 12:47:30,0,2,2,666
61477,3209,孙大雁,2017-11-17 14:05:49,1,1,0,…………
62088,3209,孙大雁,2017-11-22 11:06:20,0,4,4,慕名而来
62522,3209,孙大雁,2017-12-27 04:46:12,1,2,1,纯纱布
63607,3209,孙大雁,2017-12-08 14:04:01,3,4,1,辣鸡。
63651,3209,孙大雁,2017-12-11 13:50:49,-5,0,5,呵呵\n\n
63688,3209,孙大雁,2017-12-13 00:10:30,-20,8,28,大一，实话我觉得大雁老师挺好的，如果有什么事情也挺负责，会单独问你。不知道为什么评论这么渣，至少她没有得罪我，可能萌新经历的太少……
63797,3209,孙大雁,2017-12-15 03:25:14,-11,1,12,不错的老师
63809,3209,孙大雁,2018-01-16 09:13:28,-43,12,55,我不知道军训时候老师什么情况，但是她是一名很知性的心理咨询师，对同学们也很体贴和关心，心态非常健康、阳光，有精力的时候会给我们安排好多活动，是一名不错的辅导员
63890,3209,孙大雁,2017-12-18 15:41:42,-2,3,5,慕名而来给1分\n\n
63974,3209,孙大雁,2017-12-20 11:04:32,-1,1,2,123
63976,3209,孙大雁,2017-12-20 11:12:37,-1,0,1,。。。
64189,3209,孙大雁,2017-12-21 08:54:35,0,5,5,日常一分
64534,3209,孙大雁,2017-12-25 03:31:37,-17,3,20,给分很良心，很赞！！
64643,3209,孙大雁,2017-12-26 02:01:36,1,1,0,。。。
64657,3209,孙大雁,2017-12-26 05:53:25,-1,0,1,。。。。
64726,3209,孙大雁,2017-12-27 03:23:01,0,0,0,zsbd
65150,3209,孙大雁,2017-12-29 11:55:26,2,5,3,没有争议的sb
65302,3209,孙大雁,2018-01-03 00:32:00,-4,3,7,没上面说的那么差
65370,3209,孙大雁,2018-01-03 12:00:15,-1,3,4,慕名而来
65416,3209,孙大雁,2018-01-03 17:31:06,-1,1,2,没感觉
65469,3209,孙大雁,2018-01-04 07:43:28,1,5,4,慕名而来
65485,3209,孙大雁,2018-01-04 12:02:52,0,4,4,慕名而来
65562,3209,孙大雁,2018-01-06 04:41:59,1,5,4,慕名而来\n\n
65717,3209,孙大雁,2018-01-08 12:28:27,3,6,3,恶心?跟吃虫子一样
65721,3209,孙大雁,2018-01-08 13:00:18,11,15,4,就知道瞎bb，一点有意义的建议都没有，到期末了终于想起来关心我们成绩，一副为你着想的样子，说了一大通没卵用，恶心
65870,3209,孙大雁,2018-01-09 16:52:00,-1,3,4,啥都不晓得的大妈
65874,3209,孙大雁,2018-01-10 00:32:21,-2,3,5,慕名而来
66070,3209,孙大雁,2018-01-11 09:44:09,0,2,2,太垃圾
66400,3209,孙大雁,2018-01-16 04:17:40,0,2,2,慕名而来
66947,3209,孙大雁,2018-01-19 11:47:16,-2,0,2,zsbd
67832,3209,孙大雁,2018-01-22 08:05:01,1,1,0,hhh
69356,3209,孙大雁,2018-01-24 14:07:15,1,2,1,没上过，辅导员
70997,3209,孙大雁,2018-01-28 01:37:41,73,78,5,恭喜孙老师评分再降0.01！继续把持全校评分最低老师的宝座！恭喜！
73019,3209,孙大雁,2018-01-31 15:18:47,-1,2,3,垃圾透顶
73596,3209,孙大雁,2018-02-05 02:38:29,-1,5,6,长得丑差评给1分
73708,3209,孙大雁,2018-02-02 23:02:08,1,1,0,呵呵呵
73740,3209,孙大雁,2018-02-03 04:58:33,-1,0,1,呵呵呵
74273,3209,孙大雁,2018-02-08 15:45:00,2,2,0,垃圾啊
74417,3209,孙大雁,2018-02-20 09:50:02,2,3,1,红红火火恍恍惚惚
74479,3209,孙大雁,2018-02-27 14:26:50,0,5,5,慕名而来，1.06真的强。。。活久见
74633,3209,孙大雁,2018-03-05 02:04:42,0,3,3,垃圾老师
74849,3209,孙大雁,2018-03-06 06:03:18,1,9,8,听说骂她有赞 来试一下
74919,3209,孙大雁,2018-03-06 11:53:48,1,4,3,……日常1分
74967,3209,孙大雁,2018-03-07 01:32:40,-3,4,7,给个1分出一份绵薄之力?
75340,3209,孙大雁,2018-03-09 04:03:12,-2,4,6,路人给一分。
75385,3209,孙大雁,2018-03-10 02:17:22,-1,0,1,.......
75556,3209,孙大雁,2018-03-13 08:08:01,-4,4,8,看了评价也给个1分吧
75561,3209,孙大雁,2018-03-13 10:33:40,-3,6,9,恭喜孙老师去生孩子，给了两分纪念一下哦
75699,3209,孙大雁,2018-03-15 07:33:42,2,5,3,太垃圾
76263,3209,孙大雁,2019-01-03 10:45:39,-239,34,273,震惊了，楼上那么多网络暴徒，进浙大学习的人有了匿名评价功能就是这个德行？给分高、把你夸得像朵花就评价好？有些人，恐怕拿到浙大录取通知书的一刻就是自己的人生顶点了吧？大学不能只是温室和象牙塔，优胜劣汰的自然法则同样适用，进入社会的一刻，没人问你思修考了几分。还是成熟一点、平和一点，天地不仁以万物为刍狗，还是很公平的。否则，哪怕你混个满绩，毕业之后仍然只是个格局小、认为成绩就是一切的高分低能。一流的本科教育有哪些培养目标，你能在毕业前获得什么样的能力，有空麻烦搞搞清楚。
76394,3209,孙大雁,2018-04-07 09:02:13,19,20,1,我从未见过如此厚颜无耻之人……学弟学妹不要抱有侥幸心理，退一课海阔天空
76477,3209,孙大雁,2018-04-10 15:20:45,3,6,3,再打一次卡
76478,3209,孙大雁,2018-04-10 15:20:18,2,6,4,日常打卡
76687,3209,孙大雁,2018-04-18 08:33:52,0,4,4,打卡……
76718,3209,孙大雁,2018-04-19 05:05:35,-1,6,7,那就一分吧
76763,3209,孙大雁,2018-04-22 04:47:51,5,8,3,非常差
76804,3209,孙大雁,2018-04-23 15:45:20,-2,8,10,没那么差吧。。。\n\n
76805,3209,孙大雁,2018-04-23 15:51:20,7,25,18,老师挺好的，给10分。幸亏老师是心理老师，换一个人就跳楼了，别再说了，慕名而来真是过分
76806,3209,孙大雁,2018-04-23 15:51:53,-8,11,19,其实大雁老师挺好的，对我们党章学习小组的每个人都挺好，也希望大家别被带节奏吧
76946,3209,孙大雁,2018-04-26 10:00:29,1,2,1,综上所述
77096,3209,孙大雁,2018-05-02 03:52:34,-1,1,2,…？？？
77198,3209,孙大雁,2018-05-03 14:17:34,0,0,0,我的天
77325,3209,孙大雁,2018-05-04 16:10:26,0,5,5,日常打卡
77513,3209,孙大雁,2018-05-06 07:54:35,3,6,3,孙老师军训的时候到底干了什么？
77681,3209,孙大雁,2018-05-09 00:27:19,3,18,15,我只知道，前面的我浙学子素质比孙老师还差！
78261,3209,孙大雁,2018-05-10 08:41:38,-2,2,4,跟风一波\n\n
78391,3209,孙大雁,2018-05-11 09:07:28,1,3,2,我室友的职规血泪史?
78527,3209,孙大雁,2018-05-12 14:58:36,0,1,1,和蔼可亲sdy？
78681,3209,孙大雁,2018-05-14 11:53:04,1,1,0,。。。。。。
78742,3209,孙大雁,2018-05-15 03:05:43,-7,4,11,上过思修，还可以的\n\n
78862,3209,孙大雁,2018-05-16 01:57:03,-1,0,1,呵呵呵呵呵
79340,3209,孙大雁,2018-05-31 07:21:03,2,4,2,早死早超生\n\n
79563,3209,孙大雁,2018-06-09 09:43:28,-16,2,18,刀子嘴豆腐心，人还可以，个人觉得可以接受。。。
79714,3209,孙大雁,2018-06-13 03:19:36,0,1,1,2333
80498,3209,孙大雁,2018-06-27 07:02:52,2,4,2,遇到这号老师真的是长见识，啥也不会还横得不行。
81623,3209,孙大雁,2018-07-05 14:50:45,1,2,1,辣鸡的很
84807,3209,孙大雁,2018-07-14 02:22:51,-4,0,4,。。。。。。。。。。。。。。。
85116,3209,孙大雁,2018-07-15 12:53:18,-1,0,1,
85174,3209,孙大雁,2018-07-16 01:39:12,21,25,4,精致的利己主义者。做事不考虑顺序和对学生造成的影响，只管自己的工作和前途。\n\n她脸上笑嘻嘻，她做的所有事情，都是为了让自己工作汇报有的说。相信我，对你所有的好她都记得，你对她所有的冷漠她也都记得。
85766,3209,孙大雁,2018-08-04 15:20:50,-1,1,2,不咋地
85885,3209,孙大雁,2018-08-25 03:54:53,3,4,1,想给零分
85904,3209,孙大雁,2018-08-25 10:28:07,1,2,1,。。。。
85939,3209,孙大雁,2018-08-25 12:44:58,2,2,0,呵呵哒
86047,3209,孙大雁,2019-01-03 10:47:00,42,51,9,傻13迷彩鞋 我们新生花的钱都喂狗去了吗 就tm买了这么一堆破烂玩意 你们这些领导能穿着这垃圾鞋军训上三天我叫你们爷爷
86049,3209,孙大雁,2018-08-30 09:04:17,0,1,1,垃圾垃圾\n\n
86282,3209,孙大雁,2018-09-12 03:12:32,11,13,2,原来浙大不一定都是好老师、我才知道
86401,3209,孙大雁,2018-09-15 05:30:37,4,4,0,逼逼逼
86414,3209,孙大雁,2018-09-15 13:17:01,16,28,12,老师人很好，很关心学生，给老师差评的人一定是表现不好不够优秀，把责任推到老师上干什么？十分走起！（这条5毛，手动狗头保命，大雁还不快进来挨打！）
86733,3209,孙大雁,2018-09-18 07:24:52,0,2,2,唉不说了
86884,3209,孙大雁,2018-09-19 07:03:47,4,4,0,好像好多评论没了。。\n\n
87308,3209,孙大雁,2018-09-27 01:34:00,1,2,1,我了个去
87546,3209,孙大雁,2018-10-04 04:49:16,2,4,2,嘤嘤嘤
87547,3209,孙大雁,2018-10-04 06:39:24,3,5,2,人渣！
87807,3209,孙大雁,2018-10-14 11:53:40,-1,1,2,呵？呵？哒？
87874,3209,孙大雁,2018-10-16 13:54:20,0,1,1,。。。
87983,3209,孙大雁,2018-10-19 08:47:01,1,4,3,日狗了
88261,3209,孙大雁,2018-10-25 07:12:29,-2,1,3,不想说
88465,3209,孙大雁,2018-10-31 05:22:23,8,9,1,搜身过分了。浙大怎么会有这种老师？
88626,3209,孙大雁,2018-11-04 12:50:56,6,9,3,去盖个章另一个办公室辅导员指错路了这位就态度凶的要死，满脸不耐，怎么混进浙大的哦
89222,3209,孙大雁,2018-11-17 04:07:12,-1,0,1,啧啧啧
89255,3209,孙大雁,2018-11-17 14:08:09,1,1,0,更年期妇女综合症晚期患者
89928,3209,孙大雁,2018-11-21 09:55:05,-6,8,14,看来真的是很差的老师，虽然没接触过，打个1分好了
90340,3209,孙大雁,2018-11-23 08:12:01,1,3,2,幸好没进电院
90342,3209,孙大雁,2018-11-23 08:15:34,2,5,3,幸好逃过一劫没进电院
90707,3209,孙大雁,2018-11-25 10:52:09,-1,1,2,无语了
90918,3209,孙大雁,2018-11-27 11:53:23,-1,1,2,。。。
91351,3209,孙大雁,2018-12-06 07:12:14,0,1,1,不想再听第二次
91361,3209,孙大雁,2018-12-06 10:04:48,2,3,1,emmm
91466,3209,孙大雁,2018-12-11 03:46:12,-1,1,2,呵呵呵
91783,3209,孙大雁,2019-01-04 05:35:56,21,23,2,多少钱买进浙大的
91794,3209,孙大雁,2018-12-20 06:39:41,0,2,2,
91969,3209,孙大雁,2018-12-25 06:36:45,5,8,3,永远忘不了她指使我做事的那一副嘴脸?我特么是你的下人吗
92009,3209,孙大雁,2018-12-25 11:17:58,1,3,2,
92037,3209,孙大雁,2018-12-25 14:28:57,0,3,3,大家都这么评论我也来一手
92052,3209,孙大雁,2018-12-25 16:11:57,2,4,2,我只想知道她跟电院有什么关系……
92057,3209,孙大雁,2018-12-25 17:01:02,4,5,1,辣鸡，
92118,3209,孙大雁,2018-12-26 12:54:34,8,10,2,呵呵，隔楼那个辩护的，我就想问问。西方人说，魔鬼是上帝派来惩罚我们，让我们不要觉得自己得到的理所当然的人。所以按照你的逻辑，魔鬼是好货?某孙老师举止如此道貌岸然，自私自利，反倒是被你说成了，让我们知道社会残酷无情的，好人?这逻辑，没毛病!那，冒昧问一句，你没什么大错我扇你一巴掌，你是不是要谢谢我教你做人?         。还有，思修课成绩当然走出社会人家不会看这谁都知道，我们不是在意这个好名声，我们只是心痛好不容易辛辛苦苦提高上去的绩点，硬是无妄之灾的被拉低!
92327,3209,孙大雁,2018-12-28 00:33:35,-18,13,31,没有上过孙老师的课，但是，她是我的辅导员，不知道别的辅导员怎么样，只知道她很和蔼可亲，一个学期了，当她学生助理，一个办公室，从来没见她对那个学生有过暴躁脾气，任何一个有问题的学生都会和颜悦色，等到解决了才会送走，对我也是，经常关心我，关心学习，本人不是托，只是觉得，这个老师是心里老师，开导能力也好，不知道为什么大家会这样说她，只是，过去的就过去吧，不要再网络暴力了。
92401,3209,孙大雁,2018-12-28 09:08:10,3,4,1,sb足矣说明问题
92585,3209,孙大雁,2019-01-03 04:26:34,1,2,1,sbsb
92696,3209,孙大雁,2019-01-04 00:11:05,1,2,1,差差差
92760,3209,孙大雁,2019-01-04 08:11:16,9,12,3,我辅导员，开个心理辅导会收手机也是醉了
92801,3209,孙大雁,2019-01-04 13:24:59,-7,2,9,太厉害了 最好的老师
92865,3209,孙大雁,2019-01-05 08:22:23,2,2,0,………
92884,3209,孙大雁,2019-01-05 09:49:48,8,11,3,糟糕，是心肌梗塞的感觉
92897,3209,孙大雁,2019-01-05 11:39:51,-1,0,1,呵呵呵
92930,3209,孙大雁,2019-01-06 01:47:08,1,2,1,太差了
93024,3209,孙大雁,2019-01-07 03:18:05,-1,1,2,牛逼了
93151,3209,孙大雁,2019-02-07 13:04:31,-83,13,96,日常按个1
93623,3209,孙大雁,2019-01-11 03:30:22,0,2,2,。。。
94068,3209,孙大雁,2019-01-15 05:44:33,0,0,0,。。。
94207,3209,孙大雁,2019-01-15 16:02:30,1,1,0,为什么没有0
94401,3209,孙大雁,2019-01-16 10:19:46,0,1,1,……now
94402,3209,孙大雁,2019-01-16 10:22:09,12,14,2,加油，干到1.05\n\n
94631,3209,孙大雁,2019-01-17 12:55:21,-2,1,3,1分吧
94742,3209,孙大雁,2019-01-18 04:39:16,1,1,0,...
94891,3209,孙大雁,2019-01-18 12:11:49,-1,0,1,???
95314,3209,孙大雁,2019-01-19 07:57:45,2,3,1,。。。
95623,3209,孙大雁,2019-01-19 16:23:17,1,1,0,???
96501,3209,孙大雁,2019-01-21 05:20:16,-1,0,1,？？？
96684,3209,孙大雁,2019-01-21 09:06:03,-1,1,2,垃圾老师
97814,3209,孙大雁,2019-01-22 20:30:58,0,1,1,感觉极差
97818,3209,孙大雁,2019-01-22 22:37:25,2,3,1,跟大溜水一波
98593,3209,孙大雁,2019-01-23 15:27:00,-1,0,1,？？？
98632,3209,孙大雁,2019-06-12 02:59:09,21,22,1,孙大雁=SDY=沙雕炎\n\n真TM傻逼
100237,3209,孙大雁,2020-01-12 16:45:08,-171,15,186,孙老师很好哒!（不是托不是托!)\n\n军训本来就要苦一点哒!就要无条件遵循上级领导的命令!军令如山? \n\n五星好评!守住了优秀教师的底线!\n\n前排评论素质堪忧!身为浙大人＠(￣-￣)＠我对你们很失望
100482,3209,孙大雁,2019-01-26 08:41:57,-4,1,5,现在好多了\n\n
101181,3209,孙大雁,2019-01-28 01:24:46,3,6,3,就是日常过来按个1
101590,3209,孙大雁,2019-01-28 14:09:51,4,7,3,真的知道了浙大的老师不一定都是好老师……
101878,3209,孙大雁,2019-01-29 11:10:53,0,3,3,非常痛苦
102181,3209,孙大雁,2019-01-31 06:15:23,2,2,0,兄弟们冲啊
102459,3209,孙大雁,2019-02-02 15:43:48,-1,1,2,印象不是很好
102472,3209,孙大雁,2019-02-03 06:00:46,0,1,1,
102524,3209,孙大雁,2019-02-04 11:13:55,4,6,2,低级小学班主任手段
102567,3209,孙大雁,2019-02-09 04:12:55,1,4,3,评分好低啊，我祝她一臂之力
102571,3209,孙大雁,2019-02-09 09:40:00,-1,0,1,。。。
102909,3209,孙大雁,2019-02-25 02:23:21,5,7,2,一个死妈孤儿
102919,3209,孙大雁,2019-02-25 03:31:51,1,1,0,。。。
102942,3209,孙大雁,2019-02-25 05:33:35,0,4,4,我也想看看给一分影响均绩吗
102944,3209,孙大雁,2019-02-25 05:43:26,1,4,3,跟风1分
102963,3209,孙大雁,2019-02-25 06:20:08,-9,8,17,我想跪舔孙老师的脚和鞋子，孙老师是我的主子，真的享受被孙奶奶使唤的感受，想跪在她脚下
103047,3209,孙大雁,2019-02-25 15:18:13,9,11,2,我真是日了大雁
103112,3209,孙大雁,2019-02-26 04:06:43,-3,2,5,哈哈哈(ಡωಡ)hiahiahia
103132,3209,孙大雁,2019-02-26 06:11:23,-15,3,18,很好的老师，不是很懂大家为什么都不喜欢她\n\n
103198,3209,孙大雁,2019-02-26 15:54:30,-34,4,38,孙老师讲得还行啊，有些评论太不负责任了吧，感觉很多评论的可能都没见过孙老师吧，看了觉得不服，给个10分
103285,3209,孙大雁,2019-02-27 07:04:50,-1,0,1,！！！
103425,3209,孙大雁,2019-02-28 05:06:58,3,3,0,我擦嘞
103567,3209,孙大雁,2019-03-01 07:22:46,33,37,4,你们不要再骂她了，我赞都赞不完，手酸死了
103572,3209,孙大雁,2019-03-01 11:40:37,2,4,2,呵呵呵
103595,3209,孙大雁,2019-03-02 03:41:35,-1,3,4,呵呵呵了 两面派
103613,3209,孙大雁,2019-03-02 09:46:41,0,2,2,奇怪的体验
103617,3209,孙大雁,2019-03-02 10:12:45,3,4,1,我从未见过如此厚颜无耻之人(´இ皿இ｀)
103630,3209,孙大雁,2019-03-03 01:24:12,-6,3,9,还行吧.......\n\n
104101,3209,孙大雁,2019-03-12 03:25:22,1,4,3,恶心我
104264,3209,孙大雁,2019-03-15 08:58:09,2,5,3,最恶心的老师，不配
104341,3209,孙大雁,2019-03-18 06:56:12,-2,1,3,……？？？
104357,3209,孙大雁,2019-03-18 17:19:29,6,9,3,羡慕隔壁医试5+3，辅导员简直不要太好
104678,3209,孙大雁,2019-03-26 03:01:44,5,8,3,冲着名声来给1分！
105492,3209,孙大雁,2019-06-11 13:41:16,0,3,3,\n\n\n\n应该还行
106393,3209,孙大雁,2019-04-27 04:25:23,-5,1,6,别喷了
106856,3209,孙大雁,2019-04-30 05:18:15,-1,0,1,点点点
106994,3209,孙大雁,2019-04-30 15:00:41,7,10,3,只说职规不谈别的好吧，八人课真的超级棒。
107058,3209,孙大雁,2019-05-01 08:06:45,-6,0,6,
107426,3209,孙大雁,2019-05-05 06:31:33,3,6,3,其实根本不认识这个老师 看了评论大约懂了各位校友的认识了 能把分弄到无限接近于1的老师 是我孤陋寡闻了
107439,3209,孙大雁,2019-05-05 07:48:02,1,8,7,上课前看评分很慌张 职规课只有八个人 但上下来觉得职规课不管是内容还是给分都是很好的 有很多游戏作业也少\n\n
107500,3209,孙大雁,2019-05-06 02:47:38,4,5,1,这老师，不，不配做老师！
108364,3209,孙大雁,2019-05-22 04:15:39,-22,1,23,超棒哒，给分超好
108662,3209,孙大雁,2019-05-30 15:46:19,-3,5,8,sb 我也不知道她为什么sb 但别人都说她sb 那就sb吧\n\n
108756,3209,孙大雁,2019-06-01 12:03:51,1,1,0,ghh
108802,3209,孙大雁,2019-06-02 16:41:40,1,4,3,你改悔罢
109072,3209,孙大雁,2019-06-07 05:41:56,4,4,0,日了大雁
109133,3209,孙大雁,2019-06-09 15:22:39,2,3,1,一分我都觉得高
109154,3209,孙大雁,2019-06-10 10:13:48,0,1,1,\n\n \n\n
109243,3209,孙大雁,2019-06-12 08:27:11,-1,1,2,吃了屎
109328,3209,孙大雁,2019-06-13 06:38:21,-1,0,1,辣鸡啊
109370,3209,孙大雁,2019-06-13 11:35:20,0,0,0,。。。
109519,3209,孙大雁,2019-06-16 08:34:54,6,7,1,这样的都能当老师，那我选她不如选猪
109682,3209,孙大雁,2019-06-18 11:14:59,2,2,0,巨坑。。。
109733,3209,孙大雁,2019-06-19 02:31:46,-1,0,1,sb
109761,3209,孙大雁,2019-06-19 05:39:18,-21,10,31,我没上过他的课所以不评价 但说真的 他是我的辅导员 每次他和我说话都很温柔 让人觉得被重视 之前发生了点事 他也很认真帮我 还会关心我事情解决了没 其他我不知道 但我很喜欢他\n\n根本没上过他课 甚至不知道他是谁 就跟风给他乱打分的才是sb吧
109884,3209,孙大雁,2019-06-20 04:13:04,1,1,0,呵呵。
109895,3209,孙大雁,2019-06-20 05:14:46,0,3,3,md面个试就她板个脸，还故意刁难人
110038,3209,孙大雁,2019-06-21 13:40:46,1,1,0,耶大家好棒
110269,3209,孙大雁,2019-06-25 09:01:16,2,2,0,太狠了
110270,3209,孙大雁,2019-06-25 09:01:39,3,3,0,看评论，很开心
112062,3209,孙大雁,2019-07-03 10:58:42,1,3,2,
112087,3209,孙大雁,2019-07-03 12:54:16,-5,2,7,好老师哦
112342,3209,孙大雁,2019-07-04 02:20:06,7,8,1,日常来刷1
112850,3209,孙大雁,2019-07-05 06:06:15,3,4,1,不解释 1分
113797,3209,孙大雁,2019-07-07 15:01:29,5,11,6,呵呵哒，没接触过跟风打0的有点不求是
113841,3209,孙大雁,2019-07-07 17:39:16,37,43,6,我不认识这位老师。但隔两天就想来看看老师的评论，收获了很多快乐。十分！
114246,3209,孙大雁,2019-07-10 06:05:22,-1,2,3,哈哈哈哈哈哈
115283,3209,孙大雁,2019-07-17 15:52:49,-1,1,2,好好好
115532,3209,孙大雁,2019-08-01 14:51:15,11,14,3,打个一分，只想看看她的分数会不会收敛到1
115593,3209,孙大雁,2019-08-06 09:45:04,0,0,0,好!好!好!
115678,3209,孙大雁,2019-08-18 02:01:31,0,2,2,sbsb
115700,3209,孙大雁,2019-08-19 10:54:56,6,6,0,可怕啊
115759,3209,孙大雁,2019-08-19 12:50:47,1,3,2,真快乐
115762,3209,孙大雁,2019-08-19 12:52:19,-4,8,12,看着前面的评论，既喷血又快乐。佩服浙大学子喷人才华
115799,3209,孙大雁,2019-08-20 16:06:24,9,12,3,别的老师有效位数有三位，凭啥他只有一位
115821,3209,孙大雁,2019-08-20 12:39:07,1,2,1,……无话可说\n\n
115826,3209,孙大雁,2019-08-20 13:10:12,2,3,1,听个鬼哦
115855,3209,孙大雁,2019-08-21 07:14:48,-2,1,3,wtf
115879,3209,孙大雁,2019-08-23 02:32:44,-1,1,2,呵呵哒
115919,3209,孙大雁,2019-08-26 05:56:11,-9,5,14,看分太低，也打个一分玩玩
115922,3209,孙大雁,2019-08-26 09:22:57,-6,1,7,大雁大雁我爱你，就像老鼠爱大
116091,3209,孙大雁,2019-09-03 10:37:22,0,1,1,太舒服了哈哈哈哈哈哈哈哈哈哈蛤蛤蛤蛤蛤蛤
116150,3209,孙大雁,2019-09-10 00:51:39,-26,6,32,没上过他的课，但看评价都是骂她的我也跟风骂几句
116188,3209,孙大雁,2019-09-06 00:18:50,13,14,1,期待着收敛于1分的那一天
116275,3209,孙大雁,2019-09-07 06:40:57,-1,0,1,呵呵呵
116321,3209,孙大雁,2019-09-08 09:46:19,2,2,0,哈哈哈
116330,3209,孙大雁,2019-09-08 11:10:57,-1,1,2,......
116405,3209,孙大雁,2019-09-10 01:56:29,-1,1,2,咳咳咳
116428,3209,孙大雁,2019-09-10 12:18:36,4,4,0,666
116522,3209,孙大雁,2019-09-11 03:28:14,0,1,1,热腾腾
116590,3209,孙大雁,2019-09-12 02:39:12,1,3,2,我吐了一地
116681,3209,孙大雁,2019-09-13 03:35:46,7,9,2,谢邀\n\n人在纽约    月入百万\n\n哈佛硕士    刚下飞机\n\n========Dividing Line============
116772,3209,孙大雁,2019-09-15 12:46:17,0,0,0,
116792,3209,孙大雁,2019-09-16 02:04:24,1,1,0,
116860,3209,孙大雁,2019-09-17 01:15:30,2,2,0,那没事了
116864,3209,孙大雁,2019-09-17 01:48:52,-3,0,3,哈哈哈
116893,3209,孙大雁,2019-09-17 04:06:00,-1,2,3,没得说，奇葩
117033,3209,孙大雁,2019-09-18 12:00:22,1,1,0,呵呵呵
117066,3209,孙大雁,2019-09-19 02:09:36,0,2,2,真的菜
117117,3209,孙大雁,2019-09-19 09:39:17,-8,1,9,跟风一星。
117204,3209,孙大雁,2019-09-20 08:48:50,-1,1,2,三个字
117215,3209,孙大雁,2019-09-20 11:52:16,-2,0,2,三个字
117217,3209,孙大雁,2019-09-20 11:59:08,-4,3,7,给个1分跟跟风
117222,3209,孙大雁,2019-09-20 12:25:11,2,2,0,…………
117277,3209,孙大雁,2019-09-22 06:18:08,0,1,1,。。。
117286,3209,孙大雁,2019-09-22 10:37:34,13,14,1,期待着分数收敛于一分的那一天
117315,3209,孙大雁,2019-09-23 02:04:48,2,3,1,很差劲很差劲
117346,3209,孙大雁,2019-09-28 10:40:57,5,8,3,浙大之耻
117398,3209,孙大雁,2019-09-24 02:31:01,0,0,0,
117445,3209,孙大雁,2019-09-24 11:53:42,9,10,1,恭喜孙大雁老师评分低至1.04分啦
117534,3209,孙大雁,2019-09-25 13:01:32,16,18,2,冲冲冲，我们的征途是1.00
117606,3209,孙大雁,2019-09-26 14:55:02,3,3,0,emmm\n\n
117628,3209,孙大雁,2019-09-27 02:13:47,1,1,0,垃圾老师
117760,3209,孙大雁,2019-09-30 10:31:14,1,1,0,emm…
117762,3209,孙大雁,2019-09-30 11:01:14,5,7,2,成绩不够关系来凑 我可谢谢你
117875,3209,孙大雁,2019-10-07 09:54:49,-1,1,2,。。。
117879,3209,孙大雁,2019-10-07 13:29:11,1,2,1,对不齐
118004,3209,孙大雁,2019-10-18 05:58:28,-1,0,1,没听过
118036,3209,孙大雁,2019-10-19 04:39:14,2,2,0,我们
118231,3209,孙大雁,2019-10-23 09:59:23,0,1,1,来打分
118291,3209,孙大雁,2019-10-26 11:32:52,-2,1,3,慕名前来
118324,3209,孙大雁,2019-10-24 23:52:01,-1,2,3,好好好
118359,3209,孙大雁,2019-10-25 13:41:25,1,2,1,。。。
118382,3209,孙大雁,2019-10-26 06:30:20,-10,2,12,长的又好看，说话又好听，
118506,3209,孙大雁,2019-10-27 15:25:21,0,0,0,有意思嗷?
118554,3209,孙大雁,2019-10-28 12:18:17,-2,0,2,emmm
118737,3209,孙大雁,2019-10-31 10:49:52,0,0,0,无话可说
118794,3209,孙大雁,2019-11-06 03:03:08,1,2,1,无语了
118963,3209,孙大雁,2019-11-08 12:38:42,-4,0,4,还行吧
119026,3209,孙大雁,2019-11-09 15:41:51,-1,0,1,的种种
119583,3209,孙大雁,2019-11-14 02:29:34,-1,1,2,的滴滴滴滴滴滴滴滴滴
119698,3209,孙大雁,2019-11-15 02:05:50,1,1,0,上面那个洗地的水军给?? 爪巴gck
119843,3209,孙大雁,2019-11-16 04:34:18,-1,0,1,sbsb
119877,3209,孙大雁,2019-11-16 12:58:44,1,1,0,辣鸡额
120208,3209,孙大雁,2019-11-24 02:31:59,14,18,4,想日她
120228,3209,孙大雁,2019-11-24 10:24:38,2,3,1,没体验，谢谢
120257,3209,孙大雁,2020-01-12 16:45:00,2,3,1,sb实锤
120428,3209,孙大雁,2019-12-04 14:21:56,-1,0,1,哈哈哈
120446,3209,孙大雁,2019-12-08 06:37:44,-1,0,1,好爽啊啊啊啊啊
120475,3209,孙大雁,2020-01-12 16:44:55,2,3,1,对的人
120554,3209,孙大雁,2020-01-12 16:44:31,0,0,0,又来？
120809,3209,孙大雁,2020-01-17 10:50:36,-3,2,5,很负责的辅导员老师
120821,3209,孙大雁,2020-01-17 17:03:04,0,1,1,？？\n\n
121204,3209,孙大雁,2019-12-30 04:49:11,1,2,1,。。。
121326,3209,孙大雁,2019-12-20 02:07:24,0,1,1,。。。
121461,3209,孙大雁,2019-12-16 03:36:05,-1,0,1,慕名而来
121549,3209,孙大雁,2019-12-12 13:42:12,1,1,0,慕名而来
121611,3209,孙大雁,2019-12-12 08:26:14,-2,0,2,像在吃屎
122059,3209,孙大雁,2020-02-10 14:40:03,3,3,0,好老师好老师我是托我摊牌了
122083,3209,孙大雁,2020-02-12 03:31:21,-1,0,1,呵呵呵→_→无语😓
122171,3209,孙大雁,2020-02-18 14:34:37,0,1,1,慕名而来
122237,3209,孙大雁,2020-02-20 09:53:26,1,1,0,哈哈哈
122411,3209,孙大雁,2020-02-26 15:15:39,2,3,1,10次分期
122491,3209,孙大雁,2020-03-02 06:00:40,-1,0,1,无话可说
122588,3209,孙大雁,2020-03-05 06:35:25,-1,0,1,三个字
123253,3209,孙大雁,2020-05-26 06:53:15,10,16,6,从“给分厚道徐小洲 制度合理林建华 尊重学生孙大雁 亲切友善祝秀香 从不绩杀陈昆福 分多事少陈素珊 知识广博看沈燎 讲话生动吴朝晖 声音洪亮陶虹向”前来观光
123692,3209,孙大雁,2020-06-11 14:54:06,0,1,1,慕名而来
123732,3209,孙大雁,2020-06-13 03:54:56,3,4,1,慕名而来
123857,3209,孙大雁,2020-06-15 05:16:02,1,2,1,哈哈哈哈哈哈哈哈哈
124573,3209,孙大雁,2020-07-03 06:30:19,0,1,1,慕名而来
125015,3209,孙大雁,2020-08-11 07:15:17,-1,0,1,0.0
125081,3209,孙大雁,2020-08-28 14:40:24,-1,0,1,为啥没有零分\n\n
125100,3209,孙大雁,2020-08-31 11:21:52,1,2,1,
125398,3209,孙大雁,2020-09-08 06:16:28,3,5,2,是一个会因为学生申请会议室就对学生骂街的神奇辅导员
125506,3209,孙大雁,2020-09-10 16:27:32,1,1,0,呵呵呵呵呵
125578,3209,孙大雁,2020-09-11 17:45:00,1,2,1,垃圾！
125601,3209,孙大雁,2020-09-12 08:21:48,0,1,1,就是要低分\n\n
125738,3209,孙大雁,2020-09-14 00:53:46,2,2,0,作为辅导员，感觉不彳亍
125832,3209,孙大雁,2020-09-14 15:12:57,-1,1,2,垃圾虐
125930,3209,孙大雁,2020-09-16 00:59:16,3,5,2,吓得我赶紧把他的课给退了。。。
125939,3209,孙大雁,2020-09-16 02:07:22,5,6,1,有的人分低是因为学生保护，有的人分低是因为不保护学生
126120,3209,孙大雁,2020-09-18 00:41:52,4,5,1,奇人共赏
126210,3209,孙大雁,2020-09-19 16:00:25,0,1,1,哈哈哈哈，垃圾
126317,3209,孙大雁,2020-09-22 11:34:08,1,1,0,xsxs
126398,3209,孙大雁,2020-09-26 01:32:09,-1,1,2,恶心人
126802,3209,孙大雁,2020-10-20 15:14:25,2,3,1,慕名而来
126865,3209,孙大雁,2020-10-26 01:17:24,2,2,0,emm
126923,3209,孙大雁,2020-10-28 09:28:08,-2,0,2,。。😬\n\n
126925,3209,孙大雁,2020-10-28 10:03:24,0,1,1,烧饼玩意儿
126974,3209,孙大雁,2020-11-01 02:00:33,2,3,1,慕名而来
127163,3209,孙大雁,2020-11-11 11:42:52,1,2,1,吐口口水
127591,3209,孙大雁,2020-11-25 00:22:45,1,2,1,
127617,3209,孙大雁,2020-11-25 05:03:43,4,4,0,傻逼老师
127948,3209,孙大雁,2020-12-01 05:36:28,-1,0,1,退课了
128116,3209,孙大雁,2020-12-08 02:06:51,0,0,0,终于摆脱
128183,3209,孙大雁,2020-12-10 15:37:49,0,1,1,好家伙
128301,3209,孙大雁,2020-12-17 03:50:48,3,4,1,上课咋样我不知道，但是平时培训讲座什么的不是迟到就是无限拖堂
128309,3209,孙大雁,2020-12-17 10:47:23,2,2,0,无语了
128525,3209,孙大雁,2020-12-31 04:06:34,8,8,0,过几天就来评个一分，为评分收敛到一做出贡献
128526,3209,孙大雁,2021-01-25 13:26:45,0,3,3,人能做到这样也是没谁了
128527,3209,孙大雁,2020-12-23 14:26:23,-1,0,1,呵呵呵
128672,3209,孙大雁,2020-12-25 03:29:51,1,1,0,。。。
128696,3209,孙大雁,2020-12-25 04:42:31,1,2,1,y=1
128729,3209,孙大雁,2020-12-25 05:59:09,4,6,2,好老师强烈推荐
128744,3209,孙大雁,2020-12-25 06:34:09,16,18,2,大家要体谅老师，可能从小缺乏父母关怀
128747,3209,孙大雁,2020-12-25 06:41:23,1,1,0,666
128874,3209,孙大雁,2020-12-26 08:47:59,2,2,0,呸。。。。。
129048,3209,孙大雁,2020-12-29 07:01:24,-1,0,1,。。。
129366,3209,孙大雁,2021-01-04 15:24:45,-1,1,2,好像很垃圾
129387,3209,孙大雁,2021-01-05 02:34:48,-1,0,1,哈哈哈
129634,3209,孙大雁,2021-01-09 10:32:10,5,6,1,一日一评
129644,3209,孙大雁,2021-01-09 15:50:20,14,14,0,就是她让查老师中道崩殂，🐮
129662,3209,孙大雁,2021-01-10 08:53:21,0,0,0,。。。
129712,3209,孙大雁,2021-01-16 15:47:51,2,4,2,，，，，
129797,3209,孙大雁,2021-01-12 12:37:01,-5,0,5,不评价，差不多得了
130356,3209,孙大雁,2021-01-21 09:19:48,3,3,0,sbsb
130452,3209,孙大雁,2021-01-22 13:09:07,0,3,3,傻逼一个
130723,3209,孙大雁,2021-01-24 11:35:29,1,1,0,？？？
130992,3209,孙大雁,2021-01-25 13:24:10,2,3,1,一言难尽
131687,3209,孙大雁,2021-01-28 12:25:45,10,12,2,sb  屁事贼多  明明是自愿参加的活动还强行说是每个人必须参加  真就tmd煞笔
131784,3209,孙大雁,2021-01-29 02:41:55,1,3,2,辣鸡人
131792,3209,孙大雁,2021-01-29 03:38:55,0,2,2,直接退吧
132559,3209,孙大雁,2021-02-02 09:02:13,-39,21,60,老师真的很好，大家不要被其他评论洗脑了，上过她的课的同学都知道她给分相当好的，基本上4.8+。希望之后评论的同学能从实际出发，了解真相后再发表客观的评论，不要跟风～～～虽然是匿名评论，但也要展现出浙大人基本的素质哦(´-ω-`)
132697,3209,孙大雁,2021-02-03 10:56:54,-12,5,17,好老师强烈推荐给10分
133059,3209,孙大雁,2021-02-07 10:50:51,5,6,1,就是个辣鸡
133312,3209,孙大雁,2021-02-24 15:08:02,3,4,1,慕名而来
133340,3209,孙大雁,2021-02-26 03:22:00,-3,2,5,暂无，请看评论
133424,3209,孙大雁,2021-02-28 07:13:22,-12,3,15,我觉得还行
133705,3209,孙大雁,2021-03-04 04:15:59,-1,2,3,慕名而来
133715,3209,孙大雁,2021-03-04 06:54:17,-1,0,1,宁可真是个人才
133834,3209,孙大雁,2021-03-07 15:39:08,3,3,0,垃圾老师
134121,3209,孙大雁,2021-03-16 10:43:54,1,2,1,wdnmd
134320,3209,孙大雁,2021-03-23 15:23:06,-2,0,2,。。。
134591,3209,孙大雁,2021-04-03 10:46:53,1,3,2,1.03分
134723,3209,孙大雁,2021-04-12 07:00:14,0,1,1,职规一定要去咨询 sb一个
134900,3209,孙大雁,2021-04-21 14:50:45,-7,2,9,大家未免过于残暴
135236,3209,孙大雁,2021-05-06 11:39:40,2,2,0,无语子
135712,3209,孙大雁,2021-05-20 11:13:26,0,0,0,wdnmd
135898,3209,孙大雁,2021-06-02 02:57:09,1,2,1,无语。
136448,3209,孙大雁,2021-06-18 04:17:28,4,4,0,。。。。
136449,3209,孙大雁,2021-06-18 04:19:25,0,2,2,····
136491,3209,孙大雁,2021-06-19 03:18:19,1,2,1,？？？
136876,3209,孙大雁,2021-06-27 07:37:33,1,1,0,离谱？？
136909,3209,孙大雁,2021-06-28 06:08:38,2,4,2,建议埋了
137240,3209,孙大雁,2021-07-02 13:25:57,6,10,4,为了超过朝晖，为你投一票
138915,3209,孙大雁,2021-07-11 17:51:41,29,31,2,从“给分厚道徐小洲 制度合理林建华 尊重学生孙大雁 亲切友善祝秀香 从不绩杀陈昆福 分多事少陈素珊 知识广博看沈燎 讲话生动吴朝晖 声音洪亮陶虹向 十罪七策王章野”前来观光
139723,3209,孙大雁,2021-07-21 08:25:21,-5,1,6,我们的确是一个人的生活方式是什么时候回来呀，我们的生活方式是什么时候回来呀，我们的生活方式是什么时候回来呀，
139882,3209,孙大雁,2021-08-08 08:26:42,-15,5,20,单纯从她带过的社团和组织的领导来说，还是很认真负责的......
139925,3209,孙大雁,2021-08-20 11:46:04,3,5,2,啧啧啧
139956,3209,孙大雁,2021-08-22 14:05:17,-35,4,39,老师的课超好，选她选她选她
140017,3209,孙大雁,2021-08-23 11:44:56,10,13,3,真tm傻逼
140230,3209,孙大雁,2021-09-06 05:09:51,-23,3,26,上课挺好的呀
140405,3209,孙大雁,2021-09-10 16:00:18,7,10,3,很过分
140947,3209,孙大雁,2021-09-18 06:12:36,2,3,1,。。。
140965,3209,孙大雁,2021-09-18 12:09:57,1,2,1,Sb一个
141038,3209,孙大雁,2021-09-22 05:27:14,-55,6,61,浙大最好的老师，没有之一！
141757,3209,孙大雁,2021-10-24 13:35:20,3,4,1,？？？
142082,3209,孙大雁,2021-11-05 09:18:49,-13,6,19,讲课挺好的呀
142393,3209,孙大雁,2021-11-11 03:21:07,14,16,2,这位更是个寄吧😅
143173,3209,孙大雁,2021-11-20 12:34:52,1,4,3,为什么废话连篇
145165,3209,孙大雁,2021-12-28 03:19:49,2,6,4,垃圾吧
145599,3209,孙大雁,2021-12-30 12:14:38,-1,3,4,。。。
146527,3209,孙大雁,2022-01-07 00:37:11,3,6,3,好傻的
147324,3209,孙大雁,2022-01-09 14:14:27,-1,5,6,呵呵，我真的谢。。。
149610,3209,孙大雁,2022-01-16 07:55:31,3,7,4,军训给分不能这么低啊。。。现在想起来还生气
151257,3209,孙大雁,2022-02-26 10:50:20,0,3,3,sb老师
151395,3209,孙大雁,2022-03-02 06:26:55,2,4,2,真无语
152251,3209,孙大雁,2022-03-31 10:18:12,-39,7,46,孙老师真的很温柔
154489,3209,孙大雁,2022-06-02 01:55:02,5,9,4,艾斯比
158227,3209,孙大雁,2022-06-27 14:41:47,6,8,2,不把学生当人看，收敛到1我义不容辞
159572,3209,孙大雁,2022-08-16 03:30:14,8,10,2,给分巨高？ 超级好的一个老师？ 不点名？ 不拖堂？待人友好不故意刁难？和同学和睦相处？ 抱歉 这些全有 不要遇到孙老师 不然你这一科会g
159607,3209,孙大雁,2022-08-22 03:51:04,6,8,2,助力每一个1分的梦想
159649,3209,孙大雁,2022-08-22 13:59:14,0,1,1,sb，sb，sb
159653,3209,孙大雁,2022-08-22 14:15:09,-2,0,2,唉…………
159752,3209,孙大雁,2022-08-28 08:24:37,17,18,1,棺材土都埋到你眼眉上面了😅
160139,3209,孙大雁,2022-09-13 23:48:29,4,4,0,sbsbsb
160477,3209,孙大雁,2022-09-23 11:58:11,0,1,1,不是1.0我不是很认可
160835,3209,孙大雁,2022-10-16 10:27:04,2,2,0,呵呵
161086,3209,孙大雁,2022-10-26 08:13:59,6,8,2,虽然只和孙老师打过一次交道，她说一句话能把人噎死，不解释
163490,3209,孙大雁,2022-12-14 12:55:31,1,3,2,垃圾垃圾
164772,3209,孙大雁,2022-12-26 02:32:17,-1,1,2,阿西八
165105,3209,孙大雁,2022-12-29 07:00:55,8,9,1,孙大什么？便？
166593,3209,孙大雁,2023-01-13 02:57:45,4,4,0,孙答辩
167378,3209,孙大雁,2023-01-15 19:57:38,-9,0,9,https://m.doc88.com/p-48073125764855.html
168059,3209,孙大雁,2023-01-24 19:23:08,4,7,3,网络游戏《赛尔号》中，第一个拥有多于1个第五技能备选的精灵是谁？
168237,3209,孙大雁,2023-02-05 09:18:54,1,3,2,rnm
168256,3209,孙大雁,2023-02-06 18:53:38,-22,0,22,https://edu.sina.cn/gaokao/qsbk/2019-06-10/detail-ihvhiqay4633573.d.html?from=wap
168468,3209,孙大雁,2023-02-17 11:14:36,0,1,1,2778
169988,3209,孙大雁,2023-03-01 02:21:14,0,1,1,666
170075,3209,孙大雁,2023-03-01 09:18:13,4,7,3,傻逼一个，草你个死马，每亩玩意
170729,3209,孙大雁,2023-03-09 00:37:44,2,3,1,收敛于1
170746,3209,孙大雁,2023-03-09 03:37:50,2,3,1,收敛于1
170983,3209,孙大雁,2023-03-13 17:10:49,0,0,0,...
171228,3209,孙大雁,2023-03-19 13:15:34,3,3,0,。。。
171229,3209,孙大雁,2023-03-20 06:03:57,17,17,0,什么大便，不要选，千万不要选，狗东西。\n\n\n\n\n\n顺便点一句，在她那个什么心理中心组织工作。事多得要死
171231,3209,孙大雁,2023-03-23 16:31:32,28,31,3,握持兵权摧河山\n\n曹贼篡汉势昭然\n\n逆民心者须当诛\n\n马踏许都定危乱
171883,3209,孙大雁,2023-04-10 14:43:37,0,3,3,666
172494,3209,孙大雁,2023-04-28 02:22:13,1,2,1,你算什么东西
172839,3209,孙大雁,2023-05-08 06:33:31,2,3,1,就是答辩
172903,3209,孙大雁,2023-05-09 15:20:40,10,11,1,什么大便，不要选，千万不要选，狗东西。\n\n顺便点一句，在她那个什么心理中心组织工作。事多得要死
173326,3209,孙大雁,2023-05-19 06:31:45,8,9,1,孙答辩
174329,3209,孙大雁,2023-06-09 15:08:13,0,1,1,niu
178458,3209,孙大雁,2023-07-12 03:56:52,-49,8,57,这学期上的是孙老师的大学生朋辈心理辅导，虽然是另一位老师主要负责的。平时孙老师上课的时候讲的慢条斯理很舒服，小组里有问题需要解决回复也很温柔，也不点名，给分不错。没感觉到有哪里不好的，给个10分平衡一下。
179086,3209,孙大雁,2023-08-27 13:42:19,1,2,1,退了吧
179110,3209,孙大雁,2023-08-28 03:30:19,5,5,0,不知道
179114,3209,孙大雁,2023-08-28 05:21:18,5,6,1,为1.00贡献力量
179257,3209,孙大雁,2023-09-04 07:13:03,0,1,1,再低点
179376,3209,孙大雁,2023-09-13 18:11:07,13,15,2,毁我前程，错过强基补录的罪魁祸首
180167,3209,孙大雁,2023-09-20 12:28:10,1,1,0,就这样
180407,3209,孙大雁,2023-09-21 12:38:14,9,9,0,看到ly的评分一直掉，现在到1.06了，来看看大雁老师，1.03，只能说逆天
180582,3209,孙大雁,2023-09-23 04:44:45,-1,0,1,。。。
181042,3209,孙大雁,2023-10-06 13:26:53,2,3,1,喜欢毫无营养地长篇大论
181323,3209,孙大雁,2023-10-14 10:28:48,2,3,1,撒币撒币大撒币
181326,3209,孙大雁,2023-10-14 12:40:26,-79,2,81,我就要给10分，你们打我啊，嘻嘻嘻哈哈哈，哈哈哈嘻嘻嘻
190028,3209,孙大雁,2024-02-11 03:56:30,8,9,1,从“给分厚道徐小洲 制度合理林建华 尊重学生孙大雁 亲切友善祝秀香 从不绩杀陈昆福 分多事少陈素珊 知识广博看沈燎 讲话生动吴朝晖 声音洪亮陶虹向 十罪七策王章野”前来观光
190180,3209,孙大雁,2024-02-24 12:20:27,0,1,1,666
191977,3209,孙大雁,2024-05-06 13:58:58,11,11,0,建议把它嘴里耳朵里都灌满迎宾酒和雪\n\n然后扔进黑色高级车里雷普三回啊三回
197998,3209,孙大雁,2024-08-23 05:01:56,5,6,1,毁别人前程去吧，退退退
198010,3209,孙大雁,2024-08-23 13:30:25,2,2,0,真是lj
198075,3209,孙大雁,2024-08-28 13:05:41,11,12,1,MARIO分都比你高
201011,3209,孙大雁,2024-10-26 17:36:23,0,0,0,hhh
201652,3209,孙大雁,2024-11-05 06:33:58,0,2,2,懂得都懂
201694,3209,孙大雁,2024-11-05 12:23:10,8,9,1,为了防止影响评分，我先打了1分\n\n看评论区好像都是军训受sdy祸害的同学，如果来选朋辈心理的同学可能找不到想要的信息，所以我来讲讲朋辈心理方面\n\n这门课我觉得是好课，只要有基本的交流能力都能上得很开心，谁不喜欢和朋友敞开心扉聊天呢。课程内容其实主要是在小组内活动，老师参与的相对比较少，加上慕课还分担了理论课的内容，所以老师基本上就是个主持人组织一下活动，剩余都交给和小组成员互动。sdy和另一位老师大概分别上一半。单单讲课程内sdy没有其他评论里那么有害，毕竟只是个主持人。军训我就不知道了，但看其他人评分应该很暴雷\n\n最后就是希望选上朋辈心理的同学不要被sdy的评分劝退。如果实在被sdy恶心过，可以选其他老师的朋辈心理。这门课真的是很好的课🥺
202504,3209,孙大雁,2024-11-13 02:33:39,4,5,1,给分太差
202548,3209,孙大雁,2024-11-13 05:32:23,1,1,0,给分就是史中史，小组作业超努力最后还是史
203481,3209,孙大雁,2024-11-19 22:10:09,3,3,0,。。。
204416,3209,孙大雁,2024-11-25 17:29:57,0,1,1,屎屎屎
205295,3209,孙大雁,2024-12-04 04:04:56,-2,3,5,评分低可能都是因为军训？？？（我不清楚）\n\n但是就朋辈心理辅导这门课来说，老师很温柔，会下来和同学们交流。而且上课主要是小组内交流，感觉我们组的uu都好可爱(๑• . •๑)，上课体验很好，分数不清楚，不过另一个老师保证会好好给分（?）
205955,3209,孙大雁,2024-12-13 02:06:37,5,5,0,给分不好，慎选
208034,3209,孙大雁,2024-12-25 09:15:34,0,0,0,不太行
214091,3209,孙大雁,2025-02-03 07:06:15,0,0,0,真的不行
217306,3209,孙大雁,2025-04-08 06:25:46,0,0,0,收敛。
219698,3209,孙大雁,2025-06-04 09:18:11,0,0,0,啥也不是
9972,3422,李坚,2015-11-13 13:21:12,0,0,0,很有收获，人也很好
120223,3422,李坚,2019-11-24 07:47:00,0,0,0,已经退休了，真的很棒的史纲老师，有幸选到她的课，对我的影响十分深远。
7353,3426,甘均先,2020-02-11 07:11:10,317,366,49,好老师！！
7365,3426,甘均先,2015-09-14 03:51:29,7,23,16,就是听着有点困，其他都还好
7368,3426,甘均先,2015-09-28 11:09:09,5,12,7,浪浪浪
7572,3426,甘均先,2015-09-15 04:55:44,6,13,7,老师很可爱很温柔。史纲课困应该比较正常吧
7916,3426,甘均先,2015-09-16 06:10:51,0,3,3,浪浪浪
7974,3426,甘均先,2015-09-16 10:17:19,261,292,31,“希望老师能适当脱离课本”  甘先生表示要求太低
8348,3426,甘均先,2015-09-19 01:10:28,11,19,8,完全不用课本，上课还是很有意思的，不知道给分怎么样
8531,3426,甘均先,2015-09-22 07:02:52,4,7,3,上课很好，比较有趣
8858,3426,甘均先,2015-09-29 04:55:16,55,68,13,老师很好哒，上课基本不用课本，会提出一些启发性的问题让学生思考，而且有时候会逗我们笑~
8962,3426,甘均先,2015-10-06 12:53:14,5,9,4,很好的老师，上课启发思维
8963,3426,甘均先,2015-10-06 12:53:48,5,6,1,好好好！
9232,3426,甘均先,2015-10-18 10:22:01,85,96,11,带领中国走向胜利的老师
10118,3426,甘均先,2015-11-16 10:41:00,121,140,19,老师讲课非常棒，不用书但是会提出很多独到的见解和许多有价值的问题让我们思考，不点名但是会随机抽人回答问题，不讲书所以考试要靠自己咯，但课程本身非常有意义
11118,3426,甘均先,2018-08-25 04:46:52,236,254,18,书本是什么，甘老师表示不清楚
11426,3426,甘均先,2015-12-01 02:09:04,73,81,8,魔性的“什摸”
11649,3426,甘均先,2015-12-09 08:29:15,0,1,1,呃……不知道给分好不好
12012,3426,甘均先,2015-12-21 13:41:21,0,0,0,…………
12077,3426,甘均先,2015-12-21 15:58:45,5,5,0,呃呃呃，真的不要带书
12086,3426,甘均先,2015-12-21 16:19:05,6,8,2,讲的很好，适合旁听（ceng  ke）。不知道给分怎么样。附加一句，上课内容与理论考试没有任何关系
12098,3426,甘均先,2015-12-22 00:03:04,3,3,0,不错哦
12195,3426,甘均先,2015-12-22 09:14:11,31,38,7,能启发学生思维的好老师
12566,3426,甘均先,2016-01-06 13:27:49,1,3,2,感觉不错
12675,3426,甘均先,2015-12-24 01:01:33,15,27,12,有点小无聊，会点名回答问题，有历史小论文，喜欢发表自己见解的同学可能会感兴趣，纯粹去水的可能会尴尬
12813,3426,甘均先,2015-12-24 05:49:27,1,1,0,还没考试呢，要是得分还高的话就完美了
13615,3426,甘均先,2015-12-30 05:23:03,14,20,6,真正的人生导师，好老师
13617,3426,甘均先,2016-01-06 07:24:25,8,11,3,讲得真的真的真的很好，比课本好
13733,3426,甘均先,2015-12-30 12:47:37,3,3,0,上课一学期了，完全不带书，但是会变相点名
13803,3426,甘均先,2015-12-31 05:20:02,27,36,9,很有个性！上课都是研讨课，点人上去说，每节课都有2~5个问题讨论。作业是一篇论文，希望写与课上问题相关的，但基本没限制。
15157,3426,甘均先,2016-01-12 08:45:33,69,76,7,甘老师说，考试什么的，都是没意义的！
15794,3426,甘均先,2019-01-23 22:55:48,-18,8,26,很认真然而绩点好低 不知道说什么
15986,3426,甘均先,2016-01-17 02:00:12,4,5,1,棒棒哒
16457,3426,甘均先,2016-01-18 06:38:31,0,1,1,好
16656,3426,甘均先,2016-01-18 15:59:55,0,1,1,
16849,3426,甘均先,2016-01-19 05:24:01,2,2,0,中国好老师
18408,3426,甘均先,2016-01-22 12:56:48,3,3,0,老师上课不用书，一般用抽人来点名，喜欢创新的观点
18722,3426,甘均先,2016-01-22 12:01:20,0,1,1,挺有启发性的 我觉得老师很有魅力啦 就是疯狂的启发你
18723,3426,甘均先,2016-01-22 12:02:06,3,4,1,特别好的一个老师，平时上课会讨论问题，给分好
18730,3426,甘均先,2016-01-22 12:13:38,0,1,1,老师很好！引导学生creative thinking
18746,3426,甘均先,2016-01-22 12:48:58,1,1,0,业界良心，事少，被点到不在提心吊胆，事后说了一句4.5飘过\n\n
18748,3426,甘均先,2016-01-22 12:50:33,0,1,1,给分很好，讲究新点子，上课很有趣
18749,3426,甘均先,2016-01-22 12:51:03,1,2,1,老师上课很自由，不过你要是没有创新在他的课上就会被吐槽死。。。给分超棒，论文好好写就能上4
18750,3426,甘均先,2016-01-22 12:51:59,10,11,1,老师人好幽默三观正/萌萌哒/课上很多讨论，很有趣/作业少，给分厚道\n\n对对对，爱他
18751,3426,甘均先,2016-01-22 12:52:15,4,5,1,听甘老师的课，会纠正你被灌输的所谓的真正的知识。真的很好，上课氛围很好，老师很可爱，当然给分也不错。大力推荐
18752,3426,甘均先,2016-01-22 12:53:56,1,2,1,听说自己名字被圈了很害怕，想不到绩点还不错！
18753,3426,甘均先,2016-01-22 12:54:38,7,9,2,不会刻意点名，但每节课都会请很多人起来发言，叫到你不在就嘿嘿嘿了。很能锻炼人，好老师！而且给分超级超级好！
18754,3426,甘均先,2016-01-22 12:54:58,3,5,2,一学期下来很有收获，很精到的思维来分析历史，分分钟教高中历史老师重新做人。上课也会有启发性的问题。会点名，不过这么轻松的课翘课干嘛？
18765,3426,甘均先,2016-01-22 13:16:31,1,1,0,老师挺好的
18777,3426,甘均先,2016-01-22 13:39:16,10,11,1,讲得好给分高人长得又萌口音可爱简直不能更爱他！！！！
18779,3426,甘均先,2016-01-22 13:42:07,22,26,4,虽然我从来没听过课，但是深感是一个好老师，绩点把我给感动了，论文好好写，每节课都去，你一定会感动的
18780,3426,甘均先,2016-01-22 13:44:31,2,3,1,10分妥妥的～给分好不用说，课讲的也不错，会给同学们讨论课，小伙伴们有点嗨～
18782,3426,甘均先,2016-01-22 13:50:25,23,25,2,不带书哈哈哈(๑•ૅㅁ•๑)老师任性，点名大面积无区别扫射，点评同学real耿直，有时要求bilingual回答可逗。最后一课感动。不断地，勇敢地，向前奔跑。
18786,3426,甘均先,2016-01-22 14:00:42,1,2,1,良心好老师，给分高给分高给分高，上课思维活跃！！强推
18792,3426,甘均先,2016-01-22 14:14:56,0,2,2,给分超级好！很幽默，有时候会讲一下人生哲理。好老师(‘∀’●)♡
18802,3426,甘均先,2016-01-22 14:33:33,0,3,3,甘老师大大的好人，给分感人。
18830,3426,甘均先,2016-01-22 15:19:53,0,1,1,老师不错，引发人思考，给分不错
18868,3426,甘均先,2016-01-22 16:00:41,1,1,0,老师很可爱!!讲课有深度，会开讨论课。绩点妥妥的，我可以很明确的讲绩点和发不发言关系不大。主要是老师可爱，能学到东西
18870,3426,甘均先,2016-01-22 16:02:40,1,2,1,老师挺好的，虽然不会讲的热血沸腾，但每堂课都会有收获，甘老师特别希望大家发表自己的看法，有自己的思考、创新点。会有较多讨论课，即使听大家讲也很有意思。给分不错
18878,3426,甘均先,2016-01-22 16:21:09,0,0,0,不错哦
18950,3426,甘均先,2016-01-23 00:24:13,0,2,2,给分高，不解释\n\n
18988,3426,甘均先,2016-01-23 02:09:40,1,1,0,感觉会学到新的思维方法，以前的观念都崩了\n\n
19000,3426,甘均先,2016-01-23 03:04:25,0,3,3,绩点高
19004,3426,甘均先,2016-01-23 03:25:28,2,4,2,上了一学期课没用过书。讲真，甘老师的课适合对历史有一定知识储量的同学，上课会引导你思考，提出新见解。像我这种历史白痴⋯⋯上的有点尴尬。给分还不错。
19155,3426,甘均先,2016-01-23 11:19:13,2,2,0,老师上课注重引导我们思考历史，并且最后一节课还说了好多人生哲理，感觉真的很有用。而且，老师还很幽默哦~
19210,3426,甘均先,2016-01-23 13:58:34,2,2,0,上课点名回答有点恐怖，但是课上的很好很有深度和启发性
19280,3426,甘均先,2016-01-23 21:46:50,0,1,1,非常好的老师，我比较喜欢认真听他说，观点比较有感染力。虽然自己被他点到都说得很烂，但最后给分超好
19362,3426,甘均先,2016-01-24 02:59:21,0,1,1,好老师！知识渊博，上课氛围好，给分也好
19823,3426,甘均先,2016-01-25 10:34:00,0,0,0,不错的老师，不局限在中国式教育中。亲切，还挺好心的。好老师。
19862,3426,甘均先,2016-01-25 12:28:10,0,0,0,满分！！
20689,3426,甘均先,2016-01-30 01:06:31,1,1,0,nice
20762,3426,甘均先,2016-01-31 05:53:50,1,3,2,老师教的好，选他刚开始会觉得很坑爹，但后来觉得真的很好
21187,3426,甘均先,2019-01-23 22:55:28,-10,7,17,那么认真地上，分好低
21609,3426,甘均先,2016-02-29 10:28:08,0,0,0,书本？考试到了再决定要不要买吧，反正我不用。老师相当棒，有自己的想法，给分也不错！
21780,3426,甘均先,2016-07-05 10:08:06,1,1,0,讲道理，好老师，给分好
21812,3426,甘均先,2016-03-01 07:05:43,1,1,0,我觉得去水的同学可能会……
21923,3426,甘均先,2019-01-21 14:33:25,-1,8,9,风格我很不喜欢 不过萝卜青菜各有所爱吧 只是评分那么高确实让我惊讶
21989,3426,甘均先,2016-03-02 04:30:59,1,1,0,真的是很有启发性的史纲课，只有一篇论文和期末考试，不过上课可能会紧张点，老师的水平还是真心赞的。
22084,3426,甘均先,2016-03-02 09:46:53,1,1,0,给分好，完全脱离课本，事情少！强力推荐。
22320,3426,甘均先,2016-03-03 13:55:35,0,0,0,很能开发思维！讲得很好！很有特色！很能锻炼自己！关键是给分还很高！
22375,3426,甘均先,2016-03-04 03:37:27,2,2,0,老师人超好的 上课有很多自己的观点 还教我们用不同的角度去看历史事件 非常有批判性思维。而且上课方式敲可爱 比较注重讨论 给分也很好。
23899,3426,甘均先,2016-04-20 12:07:03,0,0,0,好老师。
24780,3426,甘均先,2017-05-14 06:44:26,4,4,0,被逼无奈
24980,3426,甘均先,2016-05-04 15:34:24,0,0,0,喜欢\n\n
25403,3426,甘均先,2016-05-17 09:06:04,41,49,8,在刚开始听他的课的时候是难以接受的，对讲课风格也很不习惯。然而如今学期已经过了一大半，我才逐渐明白，他花尽心思想告诉我们的东西是多么重要，重要到我们从来都只是听听而已而不放在心上。
25907,3426,甘均先,2016-06-14 07:25:40,16,17,1,好老师，虽然第一节课吓我们，但很可爱，唯一一节整个学期都坐前排的课，最后的寄语很感动，希望能选老师的通识课
25910,3426,甘均先,2016-06-14 07:47:26,93,99,6,甘先生值得满分！！\n\n真正地进行思维的探索和启发\n\n而不是 灌输一些稀疏平常的理论\n\n尊重学生的意见和观点 相当有个性\n\n非常的温柔 幽默 会提早下课\n\n讨论课比较频繁 但是问题有价值\n\n甚至课下也会让我想要去思考历史和人生以及社会现状 \n\n真正引起我大学思维转变的一位老师
25951,3426,甘均先,2016-07-02 00:33:00,4,5,1,感动?
26584,3426,甘均先,2016-06-20 07:44:46,1,1,0,超级好 一点事也没有
26818,3426,甘均先,2016-06-21 07:32:48,1,1,0,甘老师太棒了，特别有思想的一个老师！
27609,3426,甘均先,2016-06-27 04:52:21,0,0,0,
27866,3426,甘均先,2016-06-28 01:36:24,1,1,0,和老师聊天太有趣
28501,3426,甘均先,2016-06-28 09:35:37,1,1,0,最后的寄语
29111,3426,甘均先,2016-06-29 08:52:11,0,3,3,道理我都懂，美国统一加拿大是闹哪样啊
30378,3426,甘均先,2016-07-01 12:35:13,0,0,0,思想的碰撞，思维的启迪
30391,3426,甘均先,2016-07-01 13:05:30,1,1,0,老师给分高，上课事情少，课程主要是以讨论课为主，让大家抒发自己的意见，所以虽然不点名但是最好还是去……感谢老师！！！
30417,3426,甘均先,2017-01-07 02:59:25,4,5,1,个性好老师233333
30418,3426,甘均先,2016-07-01 13:55:07,4,5,1,刚刚看到给分实在是厚道 谢谢老师QAQ 上课总是提问题 期末一篇自定主题的论文 讲课观点很新颖也有道理 浓浓师生情
30420,3426,甘均先,2016-07-01 14:05:08,2,4,2,大学以来最高的绩点是甘先生给我的啊啊啊
30426,3426,甘均先,2016-07-01 14:21:12,1,1,0,除了喜欢点人回答问题，别的都挺好。认真写了论文，期末的时候也怎么好好考，最后给分不错。
30428,3426,甘均先,2016-07-01 14:26:08,1,1,0,老师挺不错的 上课不用课本讲的非常好 给分也可以 会启发学生思考的老师
30434,3426,甘均先,2016-07-01 14:51:35,2,3,1,老师超级好!上课有意思，但是想干自己的事也不会管你的哪怕在第一排；我们寝室三个人选了他的课，分别是5，4.8，4.5。
30439,3426,甘均先,2016-07-01 14:59:10,0,1,1,其实点名是点名起来回答问题啦，没被点到就ok，而且就一个小论文不会有什么小组作业，并且虽然我不知道考得怎么样，但是最后绩点巨良心！！！！真的超级良心！！！！
30467,3426,甘均先,2016-07-01 16:10:03,0,1,1,仙子啊仙子！！
30473,3426,甘均先,2016-07-01 16:27:13,0,0,0,。。。
30499,3426,甘均先,2016-07-01 18:42:46,1,1,0,老师的普通fà哈哈哈啊哈哈 人好 上课随机点人答问题 虽然思考题还蛮难想的但是你即使讲的真的很普通也没事 事情最少的史纲老师 考试我是觉得很悬乎论文也很水结果给分不错
30756,3426,甘均先,2016-07-02 11:42:31,0,0,0,事少给分高
31099,3426,甘均先,2016-07-03 08:16:33,0,0,0,启发式老师。。而且给分超好。。
31300,3426,甘均先,2016-07-03 15:14:02,0,0,0,给分善，事情少，真心好\n\n
31424,3426,甘均先,2016-07-04 01:54:59,1,1,0,甘老师的课是有真东西的。\n\n老师人很好，嗯。\n\n论文要有实在的论点，有想法分就不会低
32609,3426,甘均先,2016-07-08 04:48:04,0,0,0,好老师，为啥俩字不行\n\n
32762,3426,甘均先,2016-07-12 12:17:22,0,0,0,强推，每次坐在第一排，让老师记住你，寝室3个分别5.0，4.8，4.5.只要写一篇论文，事超少。平时都是讨论，即使没有什么历史学素养听听老师奇妙的见解也是很启发的。提倡创新，很难得。
32852,3426,甘均先,2017-08-31 15:43:38,-20,8,28,\n\n垃圾老师，毁我青春。讲课真心烂啊，想听都听不进去。千万千万不要选，不然后悔终生。顶我前排，让更少的人受害！
33297,3426,甘均先,2016-12-30 04:02:24,0,3,3,强烈建议选！\n\n给1分
33328,3426,甘均先,2017-02-28 00:30:28,49,58,9,很好很好
33824,3426,甘均先,2016-12-29 07:54:34,4,4,0,听完一学期各种所谓牛逼老师的课，我唯一想要签名的老师
33935,3426,甘均先,2016-12-28 01:05:19,-2,1,3,好！！
34089,3426,甘均先,2016-09-27 01:48:54,91,97,6,甘老师可是自带BGM的男人！
34689,3426,甘均先,2017-01-18 02:46:55,1,1,0,棒棒棒\n\n
34987,3426,甘均先,2017-03-22 11:47:45,1,5,4,呵呵呵
35091,3426,甘均先,2016-11-02 05:38:51,1,1,0,666
35546,3426,甘均先,2017-02-28 03:19:07,1,1,0,就跟卢兴江在我们心中的地位一样
38059,3426,甘均先,2017-02-28 13:07:26,2,6,4,大家别被低分骗了！
38060,3426,甘均先,2016-11-24 02:03:35,1,2,1,上课特别想睡觉，讲的东西还都是听不懂的东西
38061,3426,甘均先,2017-06-27 01:07:19,20,22,2,好老师！
38062,3426,甘均先,2016-11-24 02:04:28,1,1,0,很好的老师
38063,3426,甘均先,2016-11-28 13:38:55,12,13,1,真的是人生一大享受，能在大学听到甘老师的课。思想力满分，幽默感满分。甘老师坚持要我们把他的评分刷低，大家不要被评分迷惑喔。
38064,3426,甘均先,2018-01-27 13:23:25,-3,8,11,差的不行
38065,3426,甘均先,2016-11-30 14:51:02,2,4,2,很好很好很好
38066,3426,甘均先,2016-12-01 01:54:20,1,1,0,靠靠靠
38067,3426,甘均先,2017-01-24 03:39:02,3,4,1,。。。
38069,3426,甘均先,2017-01-19 00:16:52,1,2,1,老师真的很好很好很好很好我难以用语言形容的好！很幽默很有独到思考的老师！反正就是觉得和其他老师都不一样呢，绩点也不错哒 一开始很害怕被抽到回答问题是真的，但其实随便讲啦
38072,3426,甘均先,2017-01-18 16:34:24,45,53,8,老师人很好，不过个人感觉太强调对历史进程的预测了。我认为很多情况下人对目前情况的了解程度根本谈不上预测未来，让我们这些本来就不精通历史的学生来预测不是很靠谱。
38073,3426,甘均先,2016-12-01 02:38:36,2,4,2,没意思
38075,3426,甘均先,2019-08-04 00:55:25,500,531,31,老师最大的缺点就是，他竟然不允许我们说实话给他打高分！太可恶了，给他打一分
38076,3426,甘均先,2017-01-17 16:11:12,158,170,12,同学们，成绩出来了，快改成十分～
38085,3426,甘均先,2016-11-27 09:59:15,-2,3,5,不要选
38093,3426,甘均先,2017-01-20 00:33:44,20,23,3,嘿嘿嘿
38095,3426,甘均先,2016-11-24 05:36:38,320,341,21,差评，不能直面自己的优点，威胁我们来查老师刷低他的评分，这一点必须予以抵制。说到建议的话，有的时候英语回答会限制发挥，希望可以允许英语问题可以汉语回答。
38110,3426,甘均先,2017-08-31 15:44:58,5,9,4,讲课不太好
38125,3426,甘均先,2016-11-28 09:31:54,0,0,0,好老师哈哈哈哈哈哈哈哈哈
38126,3426,甘均先,2016-12-19 13:07:07,0,2,2,111
38127,3426,甘均先,2017-03-22 12:12:47,69,73,4,先生之风 山高水长
38128,3426,甘均先,2016-11-25 01:56:40,3,4,1,老师让我们把分给他往低打，不然就惩罚我们！我偏不！
38129,3426,甘均先,2016-11-25 01:56:48,1,5,4,不咋样
38130,3426,甘均先,2016-11-25 01:56:56,1,1,0,赞赞赞
38131,3426,甘均先,2017-03-02 03:13:45,1,4,3,hhhh评分改回来
38132,3426,甘均先,2017-08-09 09:00:12,3,4,1,想睡觉
38133,3426,甘均先,2017-01-18 06:18:19,1,2,1,是时候把分数打回去了
38134,3426,甘均先,2017-04-06 10:35:56,13,17,4,好老师\n\n
38135,3426,甘均先,2016-11-25 01:57:40,-1,0,1,很棒的
38136,3426,甘均先,2016-11-25 01:57:50,-2,0,2,………………
38137,3426,甘均先,2016-11-25 01:57:51,0,2,2,用英语回答问题- -
38138,3426,甘均先,2016-11-25 01:58:03,0,1,1,老是要点名提问题，还要英语回答，千万不要选
38139,3426,甘均先,2016-11-25 02:00:50,186,203,17,竟然让我们刷低分数，其实甘老师是9.5+的
38140,3426,甘均先,2016-11-25 01:58:31,-1,2,3,上课老是跑偏 没意思！
38141,3426,甘均先,2017-01-18 01:29:15,4,6,2,垃圾老师，平时上课不按书，就知道讨论那些奇怪的问题，作业也没有，论文可以随便写，考试还那么难，给分还这么好，我为什么没选上甘老师的课？？我真是日了4.5的室友了。
38142,3426,甘均先,2017-01-20 10:59:02,45,50,5,改回评分
38143,3426,甘均先,2016-11-25 02:01:03,10,12,2,炒鸡棒的老师，搞不懂为什么叫我们给他差评
38144,3426,甘均先,2017-09-09 10:01:37,5,7,2,很痛苦。。。
38145,3426,甘均先,2017-01-18 01:27:46,0,4,4,最好的史纲老师，上课有趣，能学到历史的思维，平时没有作业，最后还有休息和电影课，给分超级好！终于可以说真话了
38146,3426,甘均先,2017-03-07 10:38:42,1,3,2,很好。
38147,3426,甘均先,2016-11-25 02:10:28,5,5,0,提一些莫名其妙的要求?用成绩威胁
38150,3426,甘均先,2016-11-25 02:43:35,1,3,2,差评 给10分
38152,3426,甘均先,2016-11-25 02:55:34,11,16,5,被逼得来查老师刷低他的评分。。说到建议的话，希望老师能够尽量回避英语作答这个环节。正如老师所说，很多时候英文体现不出思想的深度，希望教学方式能够有所改进。
38154,3426,甘均先,2017-02-09 05:32:15,44,45,1,绝对的没有任何异议的思想引路人，超赞！！！！
38155,3426,甘均先,2016-12-20 13:35:13,2,2,0,有意思
38156,3426,甘均先,2016-12-02 01:51:05,8,10,2,居然总成绩威胁我们，必须给好评，那就一分吧。
38157,3426,甘均先,2017-09-03 22:30:09,2,8,6,老师讲课枯燥无味，听着想睡觉\n\n
38158,3426,甘均先,2017-02-28 02:59:52,108,120,12,我表示真的尽力了，打一分平均分还七点多。。。。
38161,3426,甘均先,2018-09-18 05:05:46,1305,1505,200,史纲老师：我在查老师上看我的分数太高了，这很不利于我的身心健康，我希望我的同学们赶紧给我把分打得低一点，最好4、5分，评论里都骂我，对别的老师的不满也都骂我这里，给我打低分。如果期末考试前我看我的分数还是太高，我就要用成绩让你们给我打低分。我不是开玩笑，我是深思熟虑后很严肃的说的。
38174,3426,甘均先,2016-11-25 08:22:27,0,2,2,上课总是喜欢问问题，还会提一些奇怪的要求，课也总是不上完
38181,3426,甘均先,2016-11-25 10:49:27,0,0,0,很有趣
38201,3426,甘均先,2016-11-26 08:37:59,0,1,1,上课讲一些根本就是没有理论根据的东西?
38203,3426,甘均先,2017-03-01 10:00:49,5,6,1,超级好的老师！给分是应老师要求故意刷的嘻嘻。不要错过这个男神级人物！给分超级赞！
38222,3426,甘均先,2016-11-27 12:32:07,0,0,0,感觉说出来的话高深莫测，经常会听不懂
38225,3426,甘均先,2016-11-27 13:19:42,-1,0,1,老师逼我们打低分～
38253,3426,甘均先,2016-12-05 10:34:33,-1,1,2,mdzz\n\n
38256,3426,甘均先,2017-03-09 07:24:03,0,2,2,很好的老师
38257,3426,甘均先,2017-03-02 07:09:12,2,5,3,喜欢他！！！
38271,3426,甘均先,2016-11-29 01:01:05,0,0,0,老师，求多给思考时间，两分钟思考真心不够，想创新也没思路。
38281,3426,甘均先,2016-11-29 06:31:49,3,3,0,被逼无奈打低分，好痛苦
38291,3426,甘均先,2016-11-29 09:24:00,0,0,0,随时等待被点杀
38306,3426,甘均先,2017-01-17 16:29:52,2,2,0,人生导师，给分很好，有很大启发。
38349,3426,甘均先,2016-11-30 13:21:02,0,0,0,有点迷\n\n
38352,3426,甘均先,2016-11-30 14:49:30,1,2,1,我就笑笑不说话
38356,3426,甘均先,2016-11-30 23:21:21,4,7,3,一开始老师的课很有趣，但是历史对我来说还是太难了，老师提问太频繁了。而且没想到，老师居然还会用分数威胁我们在查老师上的评分。天啊，这种老师果断0分啊！
38357,3426,甘均先,2016-12-01 00:47:41,0,1,1,差差差...
38360,3426,甘均先,2017-01-19 04:06:05,3,6,3,就要给你十分，哼
38361,3426,甘均先,2016-12-01 01:55:20,1,1,0,这可咋整啊...给个偏低的分吧
38362,3426,甘均先,2016-12-01 01:58:46,0,1,1,你们不给我打低分我就给你们打低分。
38363,3426,甘均先,2016-12-15 10:43:01,1,1,0,超棒的老师
38370,3426,甘均先,2017-01-12 09:49:37,21,27,6,考试很简单 选择题一个都没对
38371,3426,甘均先,2016-12-01 04:47:49,0,1,1,竟然用分数威胁我们，向甘老师低头。。一分
38393,3426,甘均先,2016-12-20 02:53:11,0,1,1,PPT太直白\n\n
38397,3426,甘均先,2016-12-02 03:00:49,0,1,1,老师让人恶意刷低分数。。我是拒绝的，有本事给我考试不及格！好老师就是要打高分！
38418,3426,甘均先,2016-12-04 03:04:58,0,1,1,经常提问，点名回答问题，但很有思想很认真，普通话不标准噢
38420,3426,甘均先,2016-12-04 08:02:49,9,10,1,老师太帅了，上课大家都看脸不听课了
38753,3426,甘均先,2016-12-17 15:11:01,0,0,0,真是不错
38844,3426,甘均先,2017-02-16 05:19:54,0,0,0,超级棒的好老师！
38941,3426,甘均先,2016-12-20 02:59:35,0,1,1,我打1分，真的是被迫的呜呜...是好老师，会提出很多有意思的问题，启发你思考，不太适合水
38961,3426,甘均先,2017-01-10 10:52:49,2,2,0,老师不许打高分，我能怎么办，我也很绝望啊！ 果断1分
39009,3426,甘均先,2017-01-17 16:06:55,4,4,0,同学们，成绩出来了……快改成十分
39036,3426,甘均先,2016-12-21 00:18:04,0,1,1,男神男神男神。养颜又博学
39136,3426,甘均先,2016-12-21 09:53:01,0,0,0,刷低分...
39143,3426,甘均先,2016-12-21 10:21:41,0,0,0,很棒哟
39150,3426,甘均先,2016-12-21 11:23:24,1,1,0,甘老师这么好，你们怎么可以打低分呢？太不可爱，怎么可以为了分数违背内心呢？成绩什么的，你们自己加油～
39184,3426,甘均先,2016-12-21 13:42:56,0,0,0,我已经上过了，不怕，必须10分，简直重塑了我的历史观
39226,3426,甘均先,2017-01-18 03:08:33,3,3,0,很好的
39301,3426,甘均先,2017-02-28 07:33:13,4,5,1,很受启发
39386,3426,甘均先,2016-12-22 10:52:48,0,0,0,太棒了，简直最好老师，打死也不打低分
39429,3426,甘均先,2016-12-22 15:23:10,0,0,0,超棒的，像我这种懒得评分的都来夸他了！！\n\n
39557,3426,甘均先,2016-12-24 14:35:34,0,0,0,不错哦
39575,3426,甘均先,2016-12-25 10:50:40,-2,2,4,果断一分，这是老师逼我们这么做的，但真心是个好老师，大家别被这个评分迷惑了，他真实评分应该是9.5+
39579,3426,甘均先,2016-12-25 15:13:29,0,0,0,应老师要求……一分
39593,3426,甘均先,2016-12-26 02:32:13,0,0,0,虽然老师用绩点为着我们，但是我不能昧着自己良心打分，所以我打了，10分
39635,3426,甘均先,2017-01-18 05:18:56,4,4,0,爱男神 超级有思想 谦虚 平时基本没事 给分也拉高了我绩点～
39674,3426,甘均先,2017-01-18 00:26:59,7,7,0,甘老师是真的把史纲这样的课程，上出了自己的风格，能给学生带来享受的老师
39680,3426,甘均先,2016-12-27 03:05:40,0,0,0,迫不得已
39681,3426,甘均先,2016-12-27 03:05:57,0,1,1,不多说了，为了大家的分数
39682,3426,甘均先,2016-12-27 03:08:58,3,3,0,帮同学助攻。都一分了还有6
39712,3426,甘均先,2016-12-27 05:58:33,4,4,0,没上过甘老师的课，但是听学弟学妹们说不给老师打到5以下，期末就要挂，那我就来帮忙给老师打个1分好了
39714,3426,甘均先,2016-12-27 06:01:16,13,14,1,没上过甘老师的课，但是据说很好\n\n听学弟学妹说如果不把他的分刷到5以下就用绩点告诉他们\n\n那我就帮个忙好了
39746,3426,甘均先,2017-06-16 05:23:17,0,2,2,太好的老师了，很有启发性。
39750,3426,甘均先,2016-12-27 08:52:48,0,0,0,好好好
39753,3426,甘均先,2016-12-27 09:53:28,0,0,0,好老师！我喜欢！
39767,3426,甘均先,2016-12-27 11:40:52,0,0,0,123
39813,3426,甘均先,2016-12-28 01:16:57,0,0,0,一分路过，，，，，，，，
40032,3426,甘均先,2016-12-29 01:50:49,207,224,17,我从未见过如此厚颜无耻之老师！！！不能直视自己的优点，竟然强行要我们把分数从9.8打到五分以下！！！不惜以绩点相要挟，我能怎么办(⊙o⊙)！我也很绝望啊！老师的表现绝非你现在看到的分数那样，观点有启发性，也没什么破事儿，上课都是思考，唯一的不足就是有时候会让你用英语回答问题，然后很尴尬
40061,3426,甘均先,2016-12-29 04:38:45,0,0,0,响应号召
40090,3426,甘均先,2016-12-29 06:34:09,0,0,0,赞赞赞\n\n\n\n
40200,3426,甘均先,2016-12-30 02:25:40,0,1,1,别被评分迷惑了
40209,3426,甘均先,2016-12-30 04:08:05,0,0,0,老师太棒了，满满正能量，但老师要求我们打低一点，只好给低分
40214,3426,甘均先,2016-12-30 05:34:23,1,1,0,给予了我极好的大学第一印象
40305,3426,甘均先,2017-01-02 05:14:51,3,3,0,不点名的，但是一节课叫半个教室的人回答问题，跟点名没多大差。不过老师绝对是好老师，这个没话讲
40506,3426,甘均先,2017-01-04 02:11:16,2,2,0,打一分?
40569,3426,甘均先,2017-01-04 06:09:10,2,2,0,强烈推荐！
40639,3426,甘均先,2017-02-26 13:52:10,7,7,0,好老师，别的不多说了。
40876,3426,甘均先,2017-01-18 04:09:15,2,2,0,应老师要求打1分，真的是超级好的老师啊，上课完全可以扔掉辣鸡书本，先生更关注学生的思想，平时也不点名，期末论文好好写就行
40930,3426,甘均先,2017-01-06 13:05:49,1,1,0,火钳留名 就是这么霸气
40957,3426,甘均先,2017-01-06 16:54:31,0,0,0,…………
41033,3426,甘均先,2017-01-08 13:31:38,3,3,0,选课系统居然给已经修过了史纲的我预置了他的史纲课！！
41239,3426,甘均先,2017-01-10 07:20:34,1,1,0,。。。
41317,3426,甘均先,2017-01-17 22:58:06,4,4,0,快改十分!!!
41379,3426,甘均先,2017-01-11 07:07:50,10,13,3,哭着给老师打了一分ಥ_ಥ       个中滋味，只有上过甘先生课的人才懂
41483,3426,甘均先,2018-01-31 05:51:09,-20,5,25,老师真不咋地
41496,3426,甘均先,2017-01-12 04:34:44,0,0,0,我是来助攻的。
41861,3426,甘均先,2017-03-21 11:37:22,2,2,0,哈哈哈打十分
41878,3426,甘均先,2017-01-13 06:51:42,0,0,0,初次性体验
42224,3426,甘均先,2017-01-17 07:33:20,1,1,0,凑个热闹来打一分
42932,3426,甘均先,2017-01-15 12:26:45,1,1,0,老师说要打低分
43506,3426,甘均先,2017-01-16 11:34:39,3,3,0,老师……我我我尽力了……1分
44410,3426,甘均先,2017-01-17 22:51:16,1,1,0,可以给你很多启发的好老师
44415,3426,甘均先,2017-01-17 23:08:56,1,1,0,很睿智有思想有深度的男神，口音萌萌哒，给分超棒，爱您！！！
44447,3426,甘均先,2017-01-18 00:12:20,4,4,0,老师很好很好很好很好啊，上课很有思想，根本听不够，不要被6点积分骗了，绝对的好老师
44480,3426,甘均先,2017-01-18 01:04:14,3,3,0,话虽如此 我还是给你打高分
44481,3426,甘均先,2017-01-18 01:06:21,10,10,0,出完绩点再评就可以讲真话了?老师很好，我给十分
44537,3426,甘均先,2017-01-18 02:39:48,6,7,1,应老师要求说一句:垃圾老师，毁我青春。不过讲道理在他的课上能学到的东西远比书本里的精髓。特别是对我们以后判断国际形式有一定的帮助，像我这种以后准备去为国捐躯的垃圾一定会谨听教诲。
44545,3426,甘均先,2017-01-18 02:45:44,3,3,0,迫于压力，我还是给十分。上课很提倡创新性思维，我觉得大学生应该有这样的思维，甘老师给我们很大的思考空间。活生生拉高了我的均绩，看到查老师的评论，十分魔性π_π
44589,3426,甘均先,2017-01-18 03:41:54,0,0,0,老师不会按照课本讲，会有许多问题会抽人回答，不怎么点名，作业什么一定要好好写，占分多，老师人很好。至于打分低是因为老师说的不给打低分他就给我们打低分
44655,3426,甘均先,2017-01-18 05:34:54,1,1,0,期末成绩已出 威胁解除 这波，我给甘老师满分（手动捂脸）
45372,3426,甘均先,2017-01-19 13:16:30,2,2,0,很棒的老师！
45935,3426,甘均先,2017-01-20 09:28:51,1,2,1,成绩出来了 送甘老师回9＋
47754,3426,甘均先,2017-02-23 09:19:18,0,0,0,好老师，保护性1分
47952,3426,甘均先,2017-02-27 12:42:19,0,0,0,男神不解释!引领史纲这种课走向新世界的第一人，对人生态度/方向/思想的启发很大，非常感谢您!
48118,3426,甘均先,2017-02-28 14:23:55,0,0,0,甘老师不需要课本，诙谐幽默有口才，期末考试贼坑，最后绩点3.3，绩点很低，但是老师真的很好，带我们思考了很多。感谢！
48321,3426,甘均先,2017-03-02 06:35:44,4,5,1,除了均绩，别相信你在甘老师这里看到的数据，不是可能，你就是看了假的查老师～
48630,3426,甘均先,2017-03-08 16:12:46,1,1,0,甘老师超可爱！\n\n上课内容也很有启发性。\n\n
48657,3426,甘均先,2017-03-09 03:35:41,0,1,1,评分随手打的，别当一回事，看评论，绝对男神
48902,3426,甘均先,2017-03-16 02:56:54,0,0,0,"故意让我们打低分，但上课内容真心不错。成绩看你写的论文和期末考试。O__O""…我才3.6"
48934,3426,甘均先,2017-03-17 02:04:04,1,1,0,老师要给他评分低一点，
48960,3426,甘均先,2017-03-19 09:27:14,0,0,0,很好的老师
49273,3426,甘均先,2017-04-01 02:57:09,0,0,0,很喜欢啊老师非常有思想见解，可是为什么一定要让大家打低分呢
49894,3426,甘均先,2017-04-27 04:06:03,10,20,10,不点名但是会叫很多人回答问题 感觉并没有评论里说的那么好也可能是我自己的问题 但总觉得老师并不很尊重学生 老师自己的水平和提出的问题与学生高中历史水平不相匹配 刻意强调预测、判断 导致很多问题同学由于史料知识缺失无法得出很好的结论 课堂氛围一般 交流互动一般 收获一般 学期中来评论的 成绩无关 当然如果对历史非常感兴趣并且了解很多的人或许会有很多共鸣吧
51263,3426,甘均先,2017-05-26 04:23:39,0,0,0,老师真的是人生导师。但希望翘课混学分的还是不要来选老师的课了。不然不公平。老师是最好的老师，也值得认真努力的学生。
51324,3426,甘均先,2017-05-31 09:55:23,0,0,0,大学期间最好的非专业课老师。
51364,3426,甘均先,2017-06-02 02:05:31,0,0,0,改回评分。\n\n绝对是一个好老师！
51722,3426,甘均先,2017-06-08 14:57:21,0,0,0,明明是10分的老师  硬让我们把分打低hhh\n\n要想学真东西，来听甘老师的课吧
51724,3426,甘均先,2017-06-08 15:21:52,0,0,0,你懂的
51928,3426,甘均先,2017-06-13 15:28:12,0,0,0,非常好
51991,3426,甘均先,2017-06-14 04:38:37,0,0,0,老师说要打5分以下，但是我已经修完这门课了，哈哈哈哈哈。特别好的老师，反正是我男神。
52319,3426,甘均先,2017-06-18 09:35:06,0,0,0,哈哈哈
52320,3426,甘均先,2017-06-18 09:39:55,0,0,0,挺好的\n\n
52654,3426,甘均先,2017-06-22 03:27:18,5,8,3,大一新生不适合听甘均先的课hhh
52772,3426,甘均先,2017-06-22 16:43:17,7,8,1,1分，原因请看前排
53222,3426,甘均先,2018-02-03 01:48:42,-19,11,30,垃圾老师 毁我青春！
53414,3426,甘均先,2017-06-26 14:22:34,0,0,0,路过的
53563,3426,甘均先,2017-06-27 04:40:52,2,3,1,别说了，很糟糕（手动滑稽）
54559,3426,甘均先,2017-06-29 15:20:56,2,2,0,好好好好老师
54848,3426,甘均先,2017-06-30 10:09:16,0,0,0,为了拉低甘老师的分数
55349,3426,甘均先,2017-07-01 10:30:45,0,0,0,不太可爱
55543,3426,甘均先,2017-07-02 01:10:33,0,0,0,老师给分真的很好，而且很有用的上课内容
55544,3426,甘均先,2017-07-02 01:12:31,3,3,0,超级棒，老师超级有思想！选他的课没错！绩点超级赞！
55549,3426,甘均先,2017-07-02 01:28:09,2,2,0,老师真的是一个很有思想的人，实在让人佩服，非常注重学生的创新想法，然后给分很棒，赞一个。
55550,3426,甘均先,2017-07-02 01:29:12,2,2,0,老师给分上课真的好虽然让我们给他低评分但我还是给了10分因为我上完他的课了
55558,3426,甘均先,2017-07-02 01:51:21,0,1,1,老师真的很有自己的想法
55561,3426,甘均先,2019-01-23 22:55:37,-11,12,23,每节课都好好上了，论文也很用心，结果给的分是我所有课里最低的。。。开始怀疑人生。。。。。。
55562,3426,甘均先,2017-07-02 02:13:09,0,1,1,老师人真的超级棒，上课内容很有自己的思想，听课会有很多的收获，上课能真正引导学生去思考，但是老师不想要评高分，没办法hhh。
55580,3426,甘均先,2017-07-02 03:12:41,2,3,1,老师上课会抽同学回答问题，常见的就是“如果怎么怎么了，历史会怎么样”一类的问题，侧重发散型和创新型。但是如果没有什么历史基础，估计就像某个理科生一样光顾着装逼了。\n\n考试占30%，论文70%。而且老师说如果论文注重创新的话可以考虑少看考试成绩。\n\n考试不用准备，准备了也没用。\n\n论文务必认真写，不是说态度认真就行了，而是要在选题，结构，逻辑方面都尽心，不然平庸之作难得高分。\n\n上了所有的课，请假1次，被抽到回答问题两次，一次没回答，一次回答了。\n\n论文自觉写得不错，考试自觉很一般。最后92。
55582,3426,甘均先,2017-07-02 03:13:37,2,3,1,不知道有打低分的规定，所以打了10分ww 甘老师课上的任务很少，就期末一篇论文。老师非常注重历史背后的思考，虽然作为理工科学生真的一脸懵逼。说期末考试不重要是真的！！！只要认真写论文表达出自己的思考成绩就不会低的(考试选择题都是蒙的还能有这个分数大感谢！！)
55584,3426,甘均先,2017-07-02 03:19:15,1,1,0,赞！很好！棒！
55601,3426,甘均先,2017-07-02 04:28:44,0,2,2,不点名但是会找同学问问题，不按书的套路走但是很能激发学生兴趣和思考问题的欲望。有想法的好老师
55652,3426,甘均先,2017-07-02 06:06:21,1,2,1,甘先生真的是很好的老师，很启发同学思考，事情不多，就一篇论文，虽然上课在他点名的时候瑟瑟发抖，但是后来想想问题都很有意思，最后一堂课带我们思考人生，课上完了真的快哭出来，好舍不得，而且写完他的论文真的有一种思考过学到东西的感觉，11分的老师，多给1分不怕他骄傲
55667,3426,甘均先,2017-07-02 06:43:06,2,3,1,这是一位非常审美的老师。非常。
55676,3426,甘均先,2017-07-02 07:11:35,3,4,1,除了每节课特别喜欢叫人回答问题之外，我想说，甘先生真的非常非常非常赞，无论是讲课内容还是绩点，都不会让你失望的。
55681,3426,甘均先,2017-07-02 07:23:56,3,4,1,无水十分。老师自我要求很高，追求上课内容和形式的创新，每一届的课堂都希望有自我突破；上课内容与书本基本无关，是分专题（话题）的思考和探究，问题很有深度和思考价值，经常一想就停不下来了，所以很难水；会点名提问，但答不上来也没事。只有一篇论文，给分多半看文章质量（很友善）。可能三观比较相近，总之觉得老师很有水准。甘先生是我在浙大见到最激萌最体谅学生最有人情味儿课最值得上的老师之一，强烈安利。
55727,3426,甘均先,2019-01-23 22:57:01,-64,25,89,听说他的?点非常高 问了几个人确实都上了4 然而我只有3.3 也没有翘过课...可能我论文不太对他口味吧 他的上课风格就是那种2分史实 8分yy...讲道理不是很喜欢这种整天扯什么近代史的关键在于竞争这种观点...他说的好像很新颖...其实也是老生常谈吧 历史课嘛我觉得还是要注重史实一点...查老师上说的好像课很有趣一样...其实真的上课的时候也没有什么人认真听...可能论文也要写的像他上课那样玄学才可以吧 还有上课随机点名这种真的不喜欢...写作业都不能安心写 真的想了解历史的话 还是赵晖大法吧
55741,3426,甘均先,2017-07-02 09:59:56,-1,1,2,学分给力好老师
55768,3426,甘均先,2017-07-02 10:47:30,0,2,2,非常能打开人的思路，用不同的眼光看历史
55960,3426,甘均先,2017-07-02 18:44:49,-2,1,3,很负责的老师。
56057,3426,甘均先,2017-07-03 03:48:43,-3,0,3,我是来帮老师打低分的。。。
56078,3426,甘均先,2017-07-03 04:25:58,-3,0,3,不听他的，必须给10
56114,3426,甘均先,2017-07-03 05:58:54,0,3,3,遇见甘老师是你的幸运
56281,3426,甘均先,2017-07-03 11:33:16,-1,1,2,十分特别的老师
56293,3426,甘均先,2017-07-03 12:13:00,-1,1,2,超级好
56478,3426,甘均先,2017-07-04 01:23:07,0,1,1,老师会激发我们的创新性思维，上课比较有趣，也比较水，平时一点任务都没有，只有上课回答问题，给分很好！
56616,3426,甘均先,2017-07-04 05:52:17,-1,1,2,很好的老师 有自己的想法 课堂气氛很活跃
57440,3426,甘均先,2017-09-05 09:52:39,8,22,14,\n\n一个学期的史纲学习体验是：恐惧！不安！心累！折磨！失望！沮丧！愤怒！
58140,3426,甘均先,2017-08-06 09:24:45,1,3,2,史纲课在他眼中要变成“艺术品”，非常有见地、有思想、正能量的老师，感觉自己上了国内最好的史纲课。
58267,3426,甘均先,2017-08-28 06:41:44,0,1,1,超级好，讲历史给我们很多思辨的启示。
58555,3426,甘均先,2017-09-03 00:08:10,1,1,0,他给我满绩 我给他满分
58630,3426,甘均先,2017-09-11 07:48:29,11,11,0,先生之风，山高水长。\n\n学生大一有幸跟随老师学习，今年已是研一，依然有许多东西在改变着我。
58694,3426,甘均先,2017-09-15 03:58:11,1,2,1,...
59091,3426,甘均先,2017-09-19 11:45:27,0,0,0,请进入查老师页面，点击热门老师\n\n我只认识里面的甘先生和竺可桢老校长，是我孤陋寡闻吧
59157,3426,甘均先,2017-09-20 03:52:58,0,0,0,再添一发
59220,3426,甘均先,2017-09-20 08:45:34,1,1,0,我就打十分，反正我已经结课了，哈哈哈。超级棒的老师。
59297,3426,甘均先,2017-09-20 14:33:30,1,1,0,可以水，但点名一定要到
59382,3426,甘均先,2017-09-21 05:46:49,0,0,0,害怕。。。
59400,3426,甘均先,2017-09-21 06:46:29,0,0,0,能够突破课本就值得我打10分，何况我还要趁他压分之前这么做
59426,3426,甘均先,2017-09-21 09:09:44,0,0,0,很棒的\n\n
59473,3426,甘均先,2017-09-21 23:49:18,1,1,0,我觉得很开启思考
59574,3426,甘均先,2017-09-23 09:19:01,0,0,0,精神的洗礼
59753,3426,甘均先,2017-09-26 16:43:06,0,0,0,最好的老师
60341,3426,甘均先,2017-10-18 01:51:41,0,0,0,好的吧
60665,3426,甘均先,2017-11-03 14:33:16,2,2,0,很不错啊
60853,3426,甘均先,2017-10-31 10:16:53,0,0,0,人生导师
61227,3426,甘均先,2017-11-12 15:33:50,0,0,0,给分好
62308,3426,甘均先,2017-11-24 06:15:05,0,0,0,好好好有水平
63980,3426,甘均先,2017-12-20 11:49:24,1,1,0,甘老师，你太好了！！！上课超级棒！！帮你把分打下去！！
64026,3426,甘均先,2017-12-20 14:30:23,0,0,0,只为拉低评分
64027,3426,甘均先,2017-12-20 14:31:10,0,0,0,棒棒哒，可是。。老师不能直视寄几的优点
64098,3426,甘均先,2017-12-21 11:24:32,0,0,0,…这个老师………\n\n
64268,3426,甘均先,2017-12-22 06:31:50,0,0,0,太好啦！给1分
64370,3426,甘均先,2017-12-23 04:23:25,0,0,0,很棒棒
64422,3426,甘均先,2017-12-23 12:22:03,0,0,0,好老师啊
64487,3426,甘均先,2017-12-24 13:23:15,0,0,0,男神！\n\n
64670,3426,甘均先,2017-12-26 07:12:26,1,1,0,改回来
64759,3426,甘均先,2017-12-27 05:14:50,2,2,0,最后两节课了有点舍不得……讲得真的非常好从不用课本，简直指路人233可惜平时我史纲后面是大英，经常为了赶作业不怎么听课，好后悔?
65471,3426,甘均先,2018-01-04 07:57:44,2,2,0,真正的好老师，每节课都很有感触，这么多节通识课里我唯一没水的就是甘老师的课。
66076,3426,甘均先,2018-01-11 11:19:40,0,1,1,老师竟然想让我们打低分？？！！！
66095,3426,甘均先,2018-01-11 13:58:33,0,0,0,特别特别棒的老师！很有思想，上课内容非常有特色，人也很好！不点名，事少，两次论文认真写就好了！就是每次都让我们帮他刷低分……好好好，等一出分我就改回来～(￣▽￣～)~
66702,3426,甘均先,2018-01-18 11:36:09,2,2,0,同学们，快打回10分
67047,3426,甘均先,2018-01-20 07:01:27,2,2,0,有思想，有深度，古为今用，本来打算将这学期的史纲都水过去，但听了第一节课就迷恋上这个老师了，两篇论文都极其用心地用了一到两周去写，太喜欢甘老师了！！！
67358,3426,甘均先,2018-01-21 02:23:24,0,0,0,厉害了，我的哥
67818,3426,甘均先,2018-01-22 07:48:20,2,2,0,我不管，我要打10分
68747,3426,甘均先,2018-01-23 17:40:57,0,0,0,超赞的。很有思想啊！
69141,3426,甘均先,2018-01-24 08:55:13,1,2,1,史纲\n\n1、老师上课不讲课本，但会有历史问题的讨论，非常具有启发性。不点名，但会点人回答问题，但不会登记名字。\n\n2、期中期末各一篇论文，没有其他作业。\n\n3、喜欢老师上课，很有趣。
69779,3426,甘均先,2018-01-25 11:22:39,1,1,0,好老师，讲的好，给分也好。
69797,3426,甘均先,2018-01-25 11:54:29,9,9,0,不懂下面评价垃圾的是什么意思\n\n我觉得甘老师真的是很有思想的人，他给我们上的课都是很体系化的，也不断地在激发我们思考问题。\n\n他论文的要求是创新性和理论性。\n\n至于给分，我觉得还不错的。只要你写的有自己思考的深度和新见解。
69813,3426,甘均先,2018-01-25 12:33:04,1,1,0,棒棒棒！！！！
69844,3426,甘均先,2018-01-25 13:41:05,9,10,1,想听故事不要选，想接受点思想理论的建议听一听，甘老师的课认真听听很有道理的，但是边玩手机边听或者睡觉或者背英语写作业的话是学不到什么的。课可以水的，不会点名，但是有时会提问问题，建议不要翘，反正你干别的他也不管。最好记一下甘老师讲的东西，认真听三四次课对写论文有好处的。论文最好不要老生常谈，认真写写绩点还算过得去。没有其他作业，两篇论文。中间有次电影课有次请了台湾的一个学者来讲一讲。
69852,3426,甘均先,2018-01-25 14:01:24,2,2,0,我见过最有思想的老师，毕竟“毁灭性思考”。
69861,3426,甘均先,2018-01-25 14:20:35,0,1,1,很舒服，绩点很不错
69862,3426,甘均先,2018-01-25 14:21:36,0,0,0,虽然点名回答问题还是有点可怕的，但是我一次都没有被点到过哈哈哈哈哈哈哈哈
70426,3426,甘均先,2019-01-23 22:59:21,-58,4,62,大绩杀!均绩2.4，无话可说!
70505,3426,甘均先,2018-01-26 23:16:18,0,1,1,老师思想很有深度，上课跟着老师的思路走，能学到很多东西。事情很少，给分较好？
70678,3426,甘均先,2018-01-27 11:07:05,1,1,0,很棒很棒，教我们的方法还是挺有意思的，就是有次讨论课用英语回答，英语学渣表示。。。。死亡
70748,3426,甘均先,2018-01-27 13:02:29,1,1,0,老师很有思想，认真听绝对受益匪浅。带来和从前完全不同的历史课体验。
70980,3426,甘均先,2019-01-21 01:14:08,5,10,5,作为一个比较倾向历史考证的人，开始听甘均先老师讲他那些预测、理论时，觉得非常扯淡，一度认为自己这学期都不可能好好听课了。。。。。。但静下心来听了几节课之后，愈发老师用一些比较另类的理论来总结历史规律（而且这些理论往往对现实有比较大的借鉴意义，还是挺有意思的。）现在想想有时候换个角度看问题，还是会走许多不一样的发现。\n\n不过客观的说这样的课确实有可能略枯燥，而且尽管思维很重要，部分同学的历史基础也许无法支撑他们总结一个合理的理论。（总不能不顾考证瞎编吧？）。所以如果想听更有趣的课还是找赵晖大神吧，如果你不介意作业爆肝的话（手动滑稽）
70983,3426,甘均先,2018-01-28 01:27:53,5,7,2,本来看到自己的绩点也觉得老师是个绩杀……不过后来发了个邮件问了得知是自己期末爆炸了……前面几位如果有什么疑惑是可以去问老师的，老师回复还是很热情的啦
71785,3426,甘均先,2018-01-29 03:05:35,-2,2,4,垃圾少年，毁我老师。
72158,3426,甘均先,2018-01-29 13:18:06,4,5,1,高中里有些观点不敢说，在甘老师的课上可以畅所欲言，还是很开心的。
72779,3426,甘均先,2018-01-31 05:27:31,7,7,0,首先 老师很可爱 不点名 有一次老师尝试着抽查 结果叫了好多名字都没点到没来的 就不了了之 哈哈哈哈哈哈 他说没成就感 有个同学没来被点到 后来他同学极限操作和他讲了第二节课来的 和老师说了就一笔勾销 多好的老师\n\n其次 我论文真的不会写 乱七八糟写一通最后绩点也上四了 \n\n最后 老师品味不错 五分钟休息时间会给我们听歌  都是不错的歌和轻音乐
73617,3426,甘均先,2018-02-02 06:32:31,0,0,0,满足老师的要求给1分。然而我觉得史纲课上的我对历史有了不一样的认识老师人其实也十分好的。两次论文好好写绩点不会低的。考试，稍微准备一下就行。
73896,3426,甘均先,2018-02-03 11:19:45,0,1,1,特别特别棒的老师！很有思想，上课内容非常有特色，人也很好！不点名，事少，两次论文认真写就好了！就是每次都让我们帮他刷低分……现在出分了，回来改分～(￣▽￣～)~
74051,3426,甘均先,2018-02-04 13:55:10,0,0,0,谢谢老师
74337,3426,甘均先,2018-02-11 15:06:31,2,2,0,论文认真写了，大概是期末崩盘了…\n\n老师的思维很创新很有深度，温柔有风度
75153,3426,甘均先,2018-03-07 14:45:17,2,3,1,在老师的威逼下，还是决定面对自己的内心，十分，满分！我心甘情愿收到老师的低分！
75154,3426,甘均先,2018-03-07 14:45:32,1,1,0,这是一种怎样的体验？爽！很爽！爽死了！
75161,3426,甘均先,2018-03-07 15:33:48,8,8,0,盗墓笔记和盗梦空间。。。
75579,3426,甘均先,2018-03-13 13:10:11,0,1,1,……………
75625,3426,甘均先,2018-03-14 07:18:22,3,3,0,老师的思维比较理想，克制，观点温和不极端～
75873,3426,甘均先,2018-03-20 11:12:10,2,2,0,趁机写实验报告
75887,3426,甘均先,2018-03-21 02:45:45,12,14,2,相比于史纲，更趋于人生观。
76144,3426,甘均先,2018-03-28 02:19:49,10,11,1,老师的人格魅力到了什么程度呢？就是听着听着你就默默的放下了手机，认真听老师的分析。折服！
76165,3426,甘均先,2019-01-21 15:00:02,-30,24,54,感觉自己听的不是史纲课，是个人创新观点秀。\n\n一直以为历史是严谨的，允许多观点的。然而这个老师让我觉得历史就是个玩笑，可以随意断章取义来支持自己所谓的创新观点。知道了事情的发展态势，再去批判前人，有什么意思？？？这样根据历史得出的所谓结论，说应该怎么怎么样，就显得格外苍白。\n\n史纲课真的听不下去了，跑来查老师写个吐槽。想认真地了解历史，感受历史的魅力的，真的别选他的课。从小到大，第一次讨厌历史，感谢他的课
76184,3426,甘均先,2018-03-28 11:49:16,2,2,0,历史本来就是先果后因啊
76191,3426,甘均先,2018-03-28 17:17:55,6,6,0,老师是让你感受思维的魅力，不是让你感受历史的魅力。
76232,3426,甘均先,2018-03-29 12:15:59,3,4,1,这么说吧，不选不一定后悔，选上一定不反悔！
78875,3426,甘均先,2018-05-16 03:53:24,-10,9,19,4次讨论课我只想问你到底能不能好好上课？一直在那边提自己的几个观点，对于历史能严谨一点吗？
79104,3426,甘均先,2018-05-23 03:41:34,2,2,0,这老师太可爱了，可爱的口音，搞笑的例子，一开始很慌，因为经常叫人回答问题，到后来思维越来越快，也开始发散，跟着老师的节奏，史纲课还是很有趣的。
79393,3426,甘均先,2018-06-03 08:00:17,0,0,0,喜欢老师!!!!!!!!!
79684,3426,甘均先,2018-06-12 16:28:25,0,0,0,老师很有趣的！
79768,3426,甘均先,2018-06-13 11:36:17,0,1,1,为了不拉低风评给了9\n\n老师挺好的 很有自己的思考 也能启发人 讨论课的评论看起来尖锐其实人并不直男癌\n\n但是今天上来不是讲这个的\n\n写小说有前途吗？你写的东西有人看吗？现在还有人看小说吗？\n\n甘老师今天的死亡三问直击心灵 小说爱好者丢大家脸了好嘛\n\n手动狗头
80101,3426,甘均先,2018-06-20 03:27:06,0,1,1,太可爱了!
80231,3426,甘均先,2018-06-22 07:40:53,0,1,1,。。。。
80315,3426,甘均先,2018-06-25 04:23:31,0,0,0,一起刷分啊
80522,3426,甘均先,2018-06-27 11:20:50,2,3,1,虽然整个学期被怼得很难受，但是不得不说，解构恨意很容易做到，但是结构恐惧太难了！
80616,3426,甘均先,2018-06-28 10:02:05,0,0,0,不错哦
80617,3426,甘均先,2018-06-28 10:02:50,0,0,0,超级棒
80854,3426,甘均先,2018-07-02 04:57:44,1,1,0,论文字数好多哦，2000+5000，不过选题还是蛮自由的。
80919,3426,甘均先,2018-07-02 16:16:53,0,0,0,可以说是大一启发最大的一门课了
81456,3426,甘均先,2018-07-05 06:28:29,2,3,1,个人认为甘老师讲得还是很有趣的，不过主要讲的是个人观点思考方式，就没什么史料啦，但对于我这种历史课瞌睡的人来说是福音。
83868,3426,甘均先,2018-07-11 11:29:53,2,2,0,意想不到的分数让我感动\n\n
83875,3426,甘均先,2018-07-11 13:56:21,0,0,0,甘老师人真的挺好的。没有翘过课，没有发过言，论文激情头秃，考试极限抄书……绩点还行吧´_>`
83881,3426,甘均先,2018-07-11 12:18:10,0,1,1,喜欢甘老师
83883,3426,甘均先,2018-07-11 12:20:02,0,0,0,给分真的很好
83885,3426,甘均先,2018-07-11 12:26:57,0,0,0,很有趣 很有料 给分好
83888,3426,甘均先,2018-07-11 12:31:10,1,1,0,老师上课很少按教材来，拓展的内容不少，讲了很多老师自己对历史的看法，与普通的历史课很不一样。具体合不合适可能要看自己喜欢什么形式的，至少我就不是很适应，有些时候也不是特别认同老师的观点。不过老师总体来说还是很不错的。
83890,3426,甘均先,2019-01-23 22:55:19,-2,17,19,一节课没翘，翘课的4.2+  3.3正太，无话可说
83891,3426,甘均先,2018-07-11 12:39:28,0,1,1,甘老师给分是真的好，我永远吹捧他！！！我也很喜欢老师有自己想法的课！！！只是可惜甘老师说不能打满分
83892,3426,甘均先,2018-07-11 12:43:20,0,0,0,老师非常可爱！会拓宽我们的思路，很有启发意义。期末开卷考完全懵逼瞎写...但是论文好好写了成绩没问题的
83894,3426,甘均先,2019-01-23 22:55:59,-2,7,9,每节课都去 从来没有被抽到发言过 两篇论文写得很认真 最后考试也还行吧 绩点不高 有点失望了
83897,3426,甘均先,2018-07-11 13:03:36,1,1,0,史纲么，大家都懂的，是那种不管老师好不好都死活听不下去课……?不过对于甘老师，我的看法是，一开始上课感觉他的上课思想有点难以接受，然而后来看他的评分方式和上课方式才觉得他是一个很公正很负责很诚恳的老师，教的东西也是用了心的，也很注重思考和学习。最后再感谢一波甘老师给的绩点～写论文的重点就是有自己的思考。课程结束的时候有点不舍…
83900,3426,甘均先,2018-07-12 05:08:44,0,0,0,听课真的有收获。不必多说
83930,3426,甘均先,2018-07-11 14:13:17,1,2,1,完全不讲书本 给我们上人生哲学 虽然小菜鸡觉得点名压力很大 但是老师人很不错 瞎写的论文瞎抄的期末考试也有4.2
83936,3426,甘均先,2019-01-23 22:57:26,-23,4,27,无语了简直 认真搜资料想了好久一节课没翘 被正态
83948,3426,甘均先,2018-07-11 15:12:59,0,0,0,事少给分好，我都以为自己要跪了，结果还不错。。。真的不会写论文和主观题。。。可能老师真的看你论文有没有认真写吧，感谢老师，没有给我的绩点雪上加霜！上课内容不是讲历史内容，而是思考和总结，讨论课会抽人回答，自己思考，不讨论，个人表示一学期都没抽到过一次
83968,3426,甘均先,2018-07-11 15:29:31,0,0,0,表白男神！！！
84006,3426,甘均先,2018-07-11 17:01:03,2,2,0,一学期被点名上台讨论3次……论文尽力了 拿了4.5……谢谢老师吧?
84050,3426,甘均先,2018-07-12 02:42:54,0,1,1,好老师，对这门课有着自己的理解，完全不照本宣科，也很看重学生对历史问题的思考，会把我们看作平辈来交流问题.....呜呜呜总之我永远爱甘老师，虽然我水过了这么多节课，您是我男神
84060,3426,甘均先,2018-07-12 03:07:03,0,1,1,老师很nice，讨论课会点人回答问题，但是真的会学到东西。很有思想的一个老师，论文想好主题好好写，分数会好的。另外这学期的课我好像没听到老师叫打低分，所以十分献上以表敬意及谢意
84271,3426,甘均先,2018-07-12 11:55:27,0,1,1,老师非常好
84621,3426,甘均先,2018-07-13 10:44:42,0,1,1,男神老师，上课给人非常多的启迪
84889,3426,甘均先,2018-07-14 07:59:23,0,1,1,啊啊啊啊啊老师好帅的！！
86094,3426,甘均先,2018-09-06 05:07:48,0,1,1,good
86419,3426,甘均先,2018-09-15 17:46:49,0,1,1,成绩出来了，评分稳了，老师真的炒鸡棒，就算卡了我的绩也要为老师打call。
86434,3426,甘均先,2018-09-16 05:41:22,0,1,1,不错不错
86640,3426,甘均先,2018-09-17 15:52:33,0,1,1,棒棒棒
86711,3426,甘均先,2018-09-26 00:50:16,0,1,1,第一次感受到历史不只是历史
86721,3426,甘均先,2018-09-18 06:23:15,1,2,1,一个字，爽～\n\n老师真的骚
86722,3426,甘均先,2018-09-18 06:23:27,1,2,1,在线学英语
86843,3426,甘均先,2018-09-19 04:44:16,0,1,1,还不错
86987,3426,甘均先,2018-09-20 01:31:57,0,1,1,太棒啦
87003,3426,甘均先,2018-09-29 04:13:44,1,3,2,只恨 才上了他一学期的课.
87082,3426,甘均先,2018-09-20 07:35:55,0,1,1,哈哈，回来特意打的十分，上得很有意思。\n\n
87099,3426,甘均先,2018-09-20 09:15:45,0,1,1,好老师！
87243,3426,甘均先,2018-09-26 05:19:57,1,2,1,真的很幽默很可爱的老师！
87488,3426,甘均先,2018-09-29 13:50:22,0,1,1,没话说
87521,3426,甘均先,2018-09-30 23:02:15,3,5,2,老师鼓励我们在课上答问和讨论时用英语表达自己的观点，一开始觉得特酸爽，到后面真的觉得他的想法已经走在了大多数老师的前面。
87524,3426,甘均先,2018-10-01 08:20:47,1,3,2,境界的提升，人格的培养
87687,3426,甘均先,2018-10-30 09:04:12,89,93,4,老师的听歌品味相当高！上他的课可以享受到一大批高质量纯音～
88148,3426,甘均先,2018-10-23 05:21:08,5,7,2,甘老师讲课特别特别好   非常有意思而且会引发很多思考  听别的同学说史纲课很无聊 我就庆幸自己遇到甘老师  史纲一点也不无聊特别有意思
88199,3426,甘均先,2018-10-24 01:52:36,0,2,2,舒服啊
88215,3426,甘均先,2018-10-24 05:42:04,0,1,1,头脑风暴
88245,3426,甘均先,2018-10-25 01:23:49,0,2,2,就是英语……
88501,3426,甘均先,2018-10-31 11:11:00,0,2,2,老师人很好，给分也很好(^_^)
88778,3426,甘均先,2018-11-07 14:39:55,0,2,2,思想上真的有启发，简直不像思政课，大一就遇到老师感觉很棒
89138,3426,甘均先,2018-11-16 04:23:04,0,2,2,与众不同
89706,3426,甘均先,2018-11-20 10:36:16,0,2,2,男神~~
89806,3426,甘均先,2018-11-21 01:46:21,0,2,2,特别好的老师 很可爱 内容很丰富 就是和课本没什么关系 经常让我们欣赏音乐 品味很高的一个老师
89862,3426,甘均先,2018-11-21 05:21:49,0,1,1,这么可爱的老师只能是我的
89863,3426,甘均先,2018-12-05 04:06:42,0,1,1,好好好
89864,3426,甘均先,2018-11-22 15:06:36,0,1,1,有理想 有力量 dei
90116,3426,甘均先,2018-11-22 12:55:00,0,0,0,骚的一批
90361,3426,甘均先,2018-11-23 09:09:53,-1,1,2,大爱甘老师！史纲课上的超级有趣而且有很多启发，讨论课的氛围很棒，真的是希望同学多思考的好老师！
91021,3426,甘均先,2018-11-29 03:39:15,0,1,1,蜜汁“怎么肥似”\n\n话说老师联系方式是什么\n\n要交作业老是找不到他??
91107,3426,甘均先,2018-11-30 04:00:01,0,1,1,思想深邃，独特而深沉
91303,3426,甘均先,2018-12-05 09:20:59,0,1,1,我已经上完啦要来如实评价。\n\n甘老师平易近人，关心学生，思想有深度。\n\n上课甘老师课特别开心ヽ(○^㉨^)ﾉ♪
91476,3426,甘均先,2018-12-11 07:23:20,15,16,1,真的牛逼\n\n真的牛逼\n\n今天，12月11号这节课真的是让我看到了一个高校历史老师该有的眼界，才华和创造力。
91511,3426,甘均先,2018-12-12 06:41:32,0,1,1,很有思想，也让我看到了历史的意义
91515,3426,甘均先,2018-12-12 07:38:00,0,1,1,真的太棒了！！！老师讲课超级有感染力！！！
91652,3426,甘均先,2018-12-17 09:26:27,0,1,1,老师太可爱了
91701,3426,甘均先,2018-12-18 04:57:34,1,2,1,我就是要打10分
91703,3426,甘均先,2018-12-18 05:21:23,1,1,0,贼好玩，跟一般的老师很不一样
91714,3426,甘均先,2018-12-18 11:35:01,7,8,1,10分的老师，但是按老师要求我还是打了1分? ? ?
91830,3426,甘均先,2018-12-21 15:47:12,8,8,0,想听四年的甘老师的近代史纲，想上四年史纲！！！！\n\n太幸运了，大一一上来遇到这种老师！\n\n每上一节课都感觉到自己升华了！\n\n思想真的很深邃开阔\n\n每节课都收获满满
91863,3426,甘均先,2018-12-23 13:25:35,2,4,2,帮老师刷低一些分。。。。。
91933,3426,甘均先,2018-12-25 04:17:29,46,47,1,我就是要打10分！！老师不搞花里胡俏的分组啊展示啊之类的，坚决反对恶竞，讲课超级棒而且超级有趣，上课放的音乐特别好听！！长得还帅还有气质！！吹爆好吗！！
91951,3426,甘均先,2018-12-25 05:40:49,0,2,2,真的很棒，讲的历史之外但历史基本功很好
92136,3426,甘均先,2018-12-26 14:58:33,1,1,0,为了满足老师的要求强行打低分，超级喜欢甘先生的课啊啊啊啊
92200,3426,甘均先,2018-12-27 04:16:44,10,10,0,听老师的课都把我听哭了，真的好老师！\n\n戳你心灵的观点
92212,3426,甘均先,2018-12-28 10:33:41,0,1,1,有意思
92267,3426,甘均先,2018-12-27 10:36:10,6,6,0,史纲 甘均先，马原 吴旭平
92481,3426,甘均先,2018-12-30 06:22:41,0,1,1,很有启发性
92531,3426,甘均先,2019-01-02 05:12:10,1,2,1,老师真的很可爱，上课内容很丰富且深刻，算是换个角度学历史吧。而且很有品味呐，执着于带我们欣赏音乐，真的很棒！
92539,3426,甘均先,2019-01-02 08:28:01,4,5,1,必须10分，必须的！\n\n神仙老师，讲课很有条理和水平\n\n能看出思想境界高，有着有趣而会思考的灵魂\n\n不管成绩最后怎样都要夸爆他！听了一个学期根本舍不得结课…
92590,3426,甘均先,2019-01-03 05:05:01,0,1,1,老师讲的真的很好，我还想在听一边
92611,3426,甘均先,2019-01-03 06:17:08,2,3,1,不管成绩如何，都先来夸一波
92724,3426,甘均先,2019-01-04 03:49:26,0,1,1,思想深邃，思维创新，语言幽默，风格犀利
92748,3426,甘均先,2019-01-04 06:39:42,0,1,1,甘老师牛逼!
92841,3426,甘均先,2019-01-22 11:10:55,-9,5,14,哈哈哈哈? ? ?
92851,3426,甘均先,2019-01-05 07:34:27,5,6,1,就 真的思想飞跃 打开 老师倒是没让我们这一届给他低分 每节课都会放很好听很好听的音乐来描述历史 自己有自己的一套思维真的受益匪浅 一点儿也没有水课的态度 教得太好了 想水可以水 不想水也真的可以学到东西 我太喜欢这个老师了 我真的难以表达 太喜欢了 真的博学多才 也特别幽默 真的热爱历史 我给10分嫌少 我能打200次10分
92854,3426,甘均先,2019-01-05 07:58:59,1,2,1,棒棒哒
93061,3426,甘均先,2019-01-07 07:28:00,19,20,1,最后一节正课，讲的有点大有点远，其实都是想不明白又和史纲无关的事，但老师还是要给我们认真讲，下课时全体鼓掌。\n\n很庆幸当时自己签条子上了甘老师的课，虽然讨论课常常让人觉得各种无解和绝望，但老师内心是个超级正超级向上的人。
93199,3426,甘均先,2019-01-08 05:53:21,7,8,1,灵魂得到升华
93239,3426,甘均先,2019-01-08 08:42:07,4,5,1,非常nice，真的，选这门课的史纲血赚
93339,3426,甘均先,2019-01-09 05:15:11,4,5,1,老师的课每次下课都会全班鼓掌，作为一个上课经常无意识水课的人，也偶尔能够感受到他的思想是真的很深刻!超好的课!
93348,3426,甘均先,2019-01-09 05:54:56,1,2,1,老师很好，但是就是想深藏功与名，希望打低分
93351,3426,甘均先,2019-01-09 06:06:12,3,5,2,我舍不得结课。甘老师讲的好得能让你打开其他科作业又合上听讲。能遇到这样的老师，真的很幸运。
93353,3426,甘均先,2019-01-09 06:25:50,0,1,1,真不错
93441,3426,甘均先,2019-01-09 15:02:58,33,34,1,老师这次没有强制我们打低分，那我就放肆打满分啦！\n\n甘老师的史纲课真的完全不水，可以获得很多基于历史却又超脱历史的思想方法和逻辑体系，他的启示都很贴近实际，而且发人深思，让我真正明白了“以史为鉴”的意义。\n\n甘老师的讨论课话题也都很深刻新颖，每次大家都发言很热烈，这在一个不强制记发言次数的思政课上真的很难得。（虽然老师提过倡导英文发言，但两次下来大家都回归中文了，其实没有强制）\n\n而且甘老师对大家的思想都很包容！还会引导启发！收获很多。\n\n最后，歌单真的很好听。
93540,3426,甘均先,2019-01-10 08:25:24,13,14,1,甘均先老师真的是一位非常有个性的老师，有自己的独特的思想，把史纲教的没有一点老旧古板的气息，上课充满活力和热情，上课将哲学，艺术，历史，科学融为一体，教会我们怎么从历史中跳脱出来，用自己自己理性的眼光去思考问题，去挖掘历史中蕴含的深刻哲理，他上课的一些论断真的很有用，都是能让我们终身受益的一些道理，很棒的老师，给10分我都嫌少
93550,3426,甘均先,2019-01-10 10:01:12,1,3,2,音乐很好听
93622,3426,甘均先,2019-01-11 03:28:36,-2,2,4,。。。
93645,3426,甘均先,2019-01-11 05:07:24,0,3,3,阿甘真的超级可爱!!!
93648,3426,甘均先,2019-01-11 05:35:05,3,5,2,老师真的好棒！ 大一上学期最最最最喜欢的老师了 学到了很多超出史纲以外的东西 虽然很多人已经说过了 但还是那句话“先生之风，山高水长。” 以后要日常循环老师的歌单～
93687,3426,甘均先,2019-01-25 03:46:34,14,17,3,谢谢老师给了我4.2
93718,3426,甘均先,2019-01-12 08:32:10,0,1,1,妙啊！
93748,3426,甘均先,2019-01-12 14:45:36,0,1,1,哈哈哈
94119,3426,甘均先,2019-01-15 08:17:02,20,21,1,如果教我史纲课的是其它老师，我对近代史的理解估计还停留在腐朽，落后之类的简单意象。上了老师的课以后，我才知道很多历史事件的发生都是有前因后果的，很多的错误都是可以避免的。这种批判的策略思考一生受用。
94135,3426,甘均先,2019-01-15 09:06:36,0,3,3,必须满啊，虽然还没考，先生之风，山高水长，真的是极其富有创造力和激情的老师\n\n
94159,3426,甘均先,2019-01-15 10:57:43,0,2,2,好 大家风范
94405,3426,甘均先,2019-01-16 10:29:40,3,5,2,甘甘也太可爱了叭~能预置上老师的课真的十分庆幸哇！虽然是历史渣渣，但是听老师的课还是会很认真地去听的呢!因为 讲得真的太好了叭~
94407,3426,甘均先,2019-01-16 10:32:48,0,2,2,帮忙刷
94438,3426,甘均先,2019-01-16 12:43:27,29,31,2,看到前面的评论“先生之风，山高水长”真的很感动了，甘老师真的当得起这样的评价！
94475,3426,甘均先,2019-01-16 16:51:50,1,3,2,非常好
94483,3426,甘均先,2019-01-17 00:56:30,2,4,2,我不管！我就要给老师打十分！太棒了吧！事情很少！还很和蔼可爱！一点都不凶。有非常不一样的历史视野，会刷新对历史的见解。期末很拼命的想给每个人打高分数，可惜无奈有正态。只要好好听课认真准备论文，你的绩点不会低的！
94606,3426,甘均先,2019-01-17 10:59:08,0,2,2,真的是好老师。
94613,3426,甘均先,2019-01-17 11:32:59,0,2,2,给分好
94912,3426,甘均先,2019-01-30 06:18:54,-20,9,29,staring  at  the sun!
94941,3426,甘均先,2019-01-18 13:22:34,0,1,1,各位同学，快刷低评分，快考试了！
95956,3426,甘均先,2019-01-20 09:27:15,1,2,1,老师太强，我太菜了。。。。。
96248,3426,甘均先,2019-01-20 15:02:03,0,2,2,被才华折服
96316,3426,甘均先,2019-01-20 23:39:16,2,3,1,认真写论文，认真考试，绩点不会差的。老师的课很有思考，但是有些观点不敢苟同。对于历史，每个人都有不同的看法，老师只是提供一种他的思考方式，引导出大家的独立思考。很有意义。
96390,3426,甘均先,2019-01-21 02:12:17,0,1,1,我现在在期末考场。。。
96686,3426,甘均先,2019-01-21 09:07:10,1,1,0,哈哈哈哈哈哈 歌很好听！
97985,3426,甘均先,2019-01-23 03:21:55,4,5,1,真的实名吹爆 让我明白近代史也能讲的这么生动 先生自己很多思想真的很有启发性 这学期说“教务处给我开太多课了我下学期不上了” 结果真的就没有先生的史纲课 我强烈安利 下次再开课的时候不要错过
98207,3426,甘均先,2019-01-23 07:41:58,3,5,2,男神呜呜呜
98344,3426,甘均先,2019-01-23 10:47:07,2,4,2,老师真的非常棒
98633,3426,甘均先,2019-01-24 15:54:42,6,6,0,真的可以收获到很多东西，特别是在创新意识方面有所突破 还有甘老师是我上大学以来第一个给我们讲写论文技巧的老师(也可能是由于我们班整体论文水平不让他满意的原因吧～)此外还收获了很多人生哲理，学会用新的视角去看待历史进程和人生轨迹，总而言之，我认为上课所受到的思维上的启发比知识本身更为重要～
99343,3426,甘均先,2019-01-24 15:08:49,1,2,1,超棒！给分超好！
99345,3426,甘均先,2019-01-24 15:10:00,7,8,1,老师人挺好的，思想很深刻，两篇论文一次开卷考，整体任务不重。给分我觉得挺良心的。
99347,3426,甘均先,2019-01-24 15:11:24,7,8,1,阿甘给分真的超好!期末考试我个人感觉真的是自己瞎写但是可能因为论文比较被阿甘认可，他就给了一个我很满意的分数!!感觉在阿甘这里还是论文更重要!
99351,3426,甘均先,2019-01-24 15:17:18,7,8,1,老师给分真的是好爆了好吗我一个没选历史的在那边写了一坨自己都懵逼的答案...分数还这么高太幸福了吧？？\n\n然后老师非常有思想，他的一些结论真的很精辟，对做人意义也很大，真的很有深度，这种思考真的让人很享受\n\n课堂十分轻松，老师十分幽默，教学方式独特，还想再学一遍！
99353,3426,甘均先,2019-01-24 15:17:50,4,5,1,第一次知道历史课可以这样上。书几乎没有翻过，上课以专题讨论为主。个人很喜欢这个风格。总之，如果电波合上了绝对比正常史纲有意思得多，没有合上就不知道了。能上到老师的课很幸运。
99354,3426,甘均先,2019-01-24 15:22:44,4,5,1,老师我爱你啊啊啊啊爱死你了啊啊啊啊
99356,3426,甘均先,2019-01-24 15:28:08,9,9,0,老师真的太好了太好了太好了我爱您！！！！
99359,3426,甘均先,2019-01-24 15:28:51,8,9,1,甘老师太好了，唯一一门4.8的，上课讲的很深，歌很好听，还有经常让我们自由讨论，要上史纲的一点要选甘均先啊！
99361,3426,甘均先,2019-01-24 15:30:48,9,10,1,这样的老师真的太好了！很努力写了论文，要求内容不要求格式，什么都说得清清楚楚！也不走正态分布。凭良心说，我的努力不及他给的分。真的很喜欢上课的氛围，讨论课就是讨论，不记站起来同学的名字，没有那么功利性！你要做的就是形成自己的思想然后在论文里展示出来，感觉老师蛮喜欢交流的！真的好！不虚此行！
99371,3426,甘均先,2019-01-24 15:38:40,108,119,11,我把甘老师的所有评价都翻遍了，500多条评价里几乎很少有负面评价。然而在出分之后我却在最新评论里看到了许多骂声。难道一个好老师会突然在这个学期的讲课质量变差么？这显然不合理，说明那些骂声与差评怕是因为自己的核心利益--绩点受到了伤害，才突然群起而攻之，我的分析应该不是很失偏颇吧。举一个例子，我是一个文科生，选了一个理科通识课生命科学导论，我从不水课，考前认认真真背了好久，然而最终绩点3.3，我当然很失望，但我并没有因此去查老师骂史锋老师，因为他确实如在查老师上的评价所说，讲的很好，开阔眼界，我为什么要因为自己因为是文科生的缺陷而给老师打低分呢？3.3是我罪有应得，我明知我是文科生却没有比理科生在这门课程上付出两倍甚至更多的努力。同样我在这里赞美甘老师并不是因为他给了我4.8，这是我应得的结果，我有文科生的资本，每次上课积极发言，课下还与老师继续讨论，论文查了很多资料，期末也认真复习了，所以4.8是我应得的。我赞美甘老师是因为他确实突破常规，给我们新的思维。有些人说他只讲观点不讲历史，那如果想要了解历史，为什么不自己认认真真的看教材？讲课如果只是按照教材讲，那还要老师干什么？所以甘老师的价值就在于他打破常规的思路与眼光，让我们重新认识历史。好了我说完了，最终我希望大家作为浙大学子还是有点情怀吧，如果总是只根据自己得到的绩点来评价老师，是不是有点辜负了整天萦绕在我们耳边的那句话：“海纳江河，启真厚德。开物前民，树我邦国”。
99382,3426,甘均先,2019-01-24 15:48:59,7,7,0,什么都不想说，老师我爱您，与分数无关，真是爱上了您……祝好！如此儒雅深沉，风度翩翩，睿智幽默的老师哪里找……此生难遇，真的好喜欢啊！
99383,3426,甘均先,2019-01-24 15:49:37,4,6,2,首先，先允许我哭一会。我哭，是因为我选上了我认为最好最祥和仁慈的甘老师的课。老师上课不会拘泥于书本，有自己的思想，会组织很多讨论课，平时课后没有作业(看着我室友又是话剧又是家书写作什么的心里爽死了)，课间老师还会放音乐给大家听，考前还把音乐名字都发给大家看让大家去听音乐放松。期末开卷考，我感觉答的不好结果4.8！！！不说了，大爱甘老师。
99385,3426,甘均先,2019-01-24 15:52:46,5,5,0,引路人
99386,3426,甘均先,2019-01-24 15:53:21,14,14,0,甘甘真的太好了叭，作为一名理科生，历史是我曾经最头疼的一门学科，但是上了甘甘的课，我发现我找到了学习历史的乐趣所在，曾经死板的学习让我失去了学习历史的兴趣，但是甘甘帮我找回来了!!尽管我的论文没有让老师足够满意，但是也是认真地花了数个夜晚去写的，写的时候也没想太多，只是想要好好写，认真对待，最后的考试也是考前积极备考，考试中尽力地去翻阅资料，最终的结果虽然并不是特别的惊艳，但是作为一名历史渣到爆炸的理科孩子，我已经很知足了，谢谢老师!您的课真的上得很好，会积极地向小伙伴们安利您的? ? ?
99387,3426,甘均先,2019-01-24 15:53:54,5,5,0,很注重启发学生的历史思维
99394,3426,甘均先,2019-01-24 16:10:47,5,6,1,老师讲课真的炒鸡无敌棒！讲课内容非常有趣！课间还会给我们听很多有意思的歌！最重要的是！每次都提前十五分钟以上下课！最后给分也超级好！实名推荐！
99396,3426,甘均先,2019-01-24 16:16:52,0,3,3,。刚刚说
99404,3426,甘均先,2019-01-24 17:08:18,4,6,2,和npy一起听的甘先生的课，每次都是前三排。\n\n最后一堂课被甘先生调侃了 ^皿^
99405,3426,甘均先,2019-01-24 17:12:17,11,12,1,老师超棒吖，很喜欢老师把史实和自己犀利的观点结合起来，听了老师的课思维开拓了很多，还记得老师说的一句话，并不只是为了让你们去分析史实，而是教给你们今后生活中遇到困难时从哪些方面思考克服困难。\n\n虽是史纲，但更像是思维碰撞的课堂，带给我的帮助是很大的。\n\n
99408,3426,甘均先,2019-01-24 17:46:39,3,4,1,甘老师讲得太棒了！他是一位思想深刻、有创造力的老师！他的课给我带来一种思维的升华！而且给分超级好，谢谢甘老师！
99412,3426,甘均先,2019-01-24 18:13:44,7,8,1,这就是思想啊，愿先生之风，山高水长。不去思考历史历史也就是时间轴上尘封的一部分，能像这样思考历史才是找到历史的财富啊!从历史中找到超越历史的东西，回顾过去也不就是为了向前看吗?总之甘先生的课实在是太棒了，自己思考一下，把这样容易空洞空泛的道理和思想内容讲得如此生动和有条理是有多不容易?认真听讲总觉得自己得到了共鸣和升华。
99414,3426,甘均先,2019-01-25 04:52:12,7,7,0,事情少，给分好，上课氛围很宽松
99416,3426,甘均先,2019-01-24 19:41:22,2,2,0,讲课超棒(虽然一直没好好听)而且给分超温柔，爱了爱了
99427,3426,甘均先,2019-01-24 22:45:31,2,2,0,太棒了
99433,3426,甘均先,2019-01-24 23:03:49,2,12,10,在查老师上，你只会看到拿着高分的人，嘴上说着给分不重要，然后大赞老师，心里还是觉得因为给分高而开心，而那些被给低分的人，从来都是随便给个理由骂老师，或者直接以绩杀否定老师。大家都挺功利的，没必要互怼，但往往正义的言论总被踩的很低。
99435,3426,甘均先,2019-01-24 23:08:26,0,3,3,和其他史纲老师不同，很有思想。我是理科生，上课也基本水过，论文也是匆忙赶完，绩点虽然不是很高，但已经很满意了。老师人是真的好，看到因为绩点被别人差评，真的很气愤!!
99438,3426,甘均先,2019-01-24 23:14:28,3,4,1,真正的大学导师，鼓励我们思考，重视论文里的思想而不是字数，最后给分相当好，点赞！
99439,3426,甘均先,2019-01-24 23:18:17,2,3,1,听甘先生的课真的很享受，作业不多，一学期就一篇随笔一篇论文，论文要求高，真正希望启发我们思考，最后一节课跟我们讲论文该怎么写，受益匪浅。并且，给分超好。强烈推荐！
99455,3426,甘均先,2019-01-25 00:04:46,3,3,0,考完了大家改回10分吧！这次我多选题全单选了，老师还是给了我4.5。大爱！
99457,3426,甘均先,2019-01-25 00:07:43,0,1,1,最后还是史纲老师对我好，我吹爆
99468,3426,甘均先,2019-01-25 00:28:37,1,2,1,事少给分好，注重思辨能力和创新思维的培养，好老师，10不多说
99473,3426,甘均先,2019-01-25 00:34:54,2,2,0,出成绩了，赶紧打回十分? \n\n
99478,3426,甘均先,2019-01-25 00:37:11,7,7,0,感觉在听百家讲坛
99480,3426,甘均先,2019-01-25 00:39:17,13,13,0,事少这个是真的，期中2000随笔，期末5000论文，特地嘱咐不要写太多，重要的是思考，避免了恶竞。然后我室友的史纲课还有分组展示什么的，甘先生的课完全没有这些烂事，没有分组，没有建群，吹爆。期末最后一节课，反复强调，一定要多写一点，我选择题炸了，但是每道简答题都写满，论文两篇也努力提出自己的观点，查了很多史料，最后4.8。
99482,3426,甘均先,2019-01-25 00:41:47,4,4,0,挺有收获的，他的课不能说全部，但大部分都会给你耳目一新的感觉。
99488,3426,甘均先,2019-01-25 00:46:49,9,9,0,考试之前就给老师评过分，考完了一样的分还是10分。我只想说楼下的说正态什么的可能是少数吧，甘老师给分不错的，史纲课如果不喜欢发言的同学完全没有影响（我就是），反而能从他这里收获很多思想上的东西，如果喜欢发言的同学也可以碰撞出火花，也没有那种不必要的组成小组。除此之外，书本老师第一节课就说自学，上课讲的确实史实和思想三七开吧，但是看过书之后觉得没什么特别重要需要讲的内容，自己看完全可以。甘老师真的给了我不是应试教育的感觉，真正做到以史为鉴。
99490,3426,甘均先,2019-01-25 01:02:39,3,3,0,男神 给分好 课超有水平 没得说
99516,3426,甘均先,2019-01-25 01:53:38,3,3,0,超级棒 给分也好 神仙老师 哲学思维 解构历史对当下的意义 收获颇丰
99526,3426,甘均先,2019-01-25 02:05:15,4,4,0,上第一节课的时候，觉得和以前的历史课很不一样，不再是有趣的故事大会，觉得不喜欢。\n\n但后来，每节课坐在第一排，认真听，越来越发现史纲课的有趣之处，上到最后一节课反而很舍不得老师与史纲。\n\n反正很开心?！
99527,3426,甘均先,2019-01-25 02:11:08,12,12,0,先生之风，山高水长。
99532,3426,甘均先,2019-01-25 02:18:50,1,1,0,哈哈哈
99556,3426,甘均先,2019-01-25 02:50:01,4,4,0,老师的课是一种享受，不该水水过
99559,3426,甘均先,2019-01-25 02:57:52,4,4,0,给分也太好了吧!\n\n\n\n我大一唯一一门将近满绩的学科
99670,3426,甘均先,2019-01-25 04:48:25,5,5,0,老师很优秀，上他的课真是一种享受能有很多启发的东西，人好事少给分高，甘老师我男神！
99680,3426,甘均先,2019-01-25 04:55:24,7,7,0,给分好，事少，吹爆
99716,3426,甘均先,2019-01-25 05:37:14,5,6,1,出来分了  \n\n没有人能阻挡我给甘老师高分? \n\n姐妹们，是他拯救了我的均绩
99791,3426,甘均先,2019-01-25 07:32:36,2,2,0,，，，
99885,3426,甘均先,2019-01-25 09:06:04,3,3,0,好老师！
99893,3426,甘均先,2019-01-25 09:13:03,4,5,1,给分好好 被大英数学思修伤透了的我感动哭了(˘̩̩ε˘̩ƪ)
99894,3426,甘均先,2019-01-25 09:14:49,2,3,1,好到说不出话，大噶都夸过了，真的，完全棒呆！10分！10分！
99960,3426,甘均先,2019-01-25 10:49:35,4,5,1,真的好好啊 分也给的好！
99974,3426,甘均先,2019-01-25 11:25:47,5,7,2,史纲居然有歌单。。。\n\n上课很有深度，虽然我一直在水
100029,3426,甘均先,2019-01-25 12:58:45,3,5,2,甘老师真的男神！事少，上课有趣，是真正能学到东西的史纲课！吹爆！！！
100082,3426,甘均先,2019-01-25 14:10:09,5,7,2,甘老师既幽默又帅气，关键给分好，超级喜欢老师！
100536,3426,甘均先,2019-01-26 09:14:06,5,6,1,好老师不多说
100570,3426,甘均先,2019-01-26 10:22:09,11,12,1,老师的思想很深邃，很有见解，格局很大，感觉已经超出了历史的范围了，事不多，不会为难学生，就是写两篇论文，认真的写，有自己的看法，分数就会不错的
100645,3426,甘均先,2019-01-26 13:12:00,20,21,1,实在是太强了，我感觉上了浙大遇到这个老师真的值。不用去管什么绩点啊分数啊，扔下这些来听甘老师的课吧，哪怕是来旁听也好啊。可惜老师只开了史纲。
101928,3426,甘均先,2019-01-29 20:06:45,10,14,4,这老师 给分太好了 作为隔壁班的同学 我很讨厌他
101929,3426,甘均先,2019-01-29 20:06:49,1,2,1,太棒了啊啊啊
102192,3426,甘均先,2019-01-31 08:48:03,3,4,1,甘老师是个很特别的老师
102585,3426,甘均先,2019-02-11 06:06:36,10,10,0,多年以后如果我想起初入大学园的这一年，坐在甘先生的课堂上的这一幕将一定会浮现。
102638,3426,甘均先,2019-02-16 11:20:11,24,25,1,怎么说呢，我大概是这个社科班里为数不多的工科生吧，我是补选进来的（当时甘老师特地为了我亲自去给教务秘书打招呼），很意外的是一个学期没有交集，期末交论文的时候他却清晰地记起了我的名字，那种感觉，就像生命中真的会有什么重要的人会在什么时候来呼唤你，他的课程很有特点，每一节课都提出了对这个历史框架对这个世界的新的看法，可以说对我们思维的发展很有启发了，真正的大师不会去讲历史，他讲的是如何去在历史的宏观背景下把握自己的命运。于是我写下了这篇人生意义上第一次由自己完全原创长达7000字的论文，将老师给我的启发，我对自动化控制系统的理解以及历史的潮流融合在了一起，这大概是我最大的收获吧，4.8，也算是我这个学期第二高的绩点了（谢谢甘先生）
102687,3426,甘均先,2019-02-20 09:59:45,9,9,0,其实没啥好说的，能预置这位老师，实在三生有幸。如果你想水一个高绩点，可以的，其中期末两篇论文稍微用点心，给了4.8；，但我建议你，真的可以听听他的课，能学到的东西，不仅仅是用只言片语可以表达的。记得当初行策课老师有个问卷：你认为应该如何改进思政类课程？我的回答是：像甘钧先老师那样上课（是的，是钧不是均hhh）
102734,3426,甘均先,2019-02-22 05:19:58,1,1,0,超棒！
102737,3426,甘均先,2019-02-22 05:29:50,1,1,0,享受啊
102800,3426,甘均先,2019-02-23 08:02:26,1,1,0,老师真的非常棒！！！！！！
102819,3426,甘均先,2019-02-23 13:19:24,0,0,0,，，，
102837,3426,甘均先,2019-02-24 03:06:26,1,1,0,真真正正的好老师！\n\n课上不拘泥于课本，能很有逻辑很有体系地讲出自己的观点和见解！而且非常生动有趣。\n\n甘老师的课是我从小到大听过的最棒的历史课！
102878,3426,甘均先,2019-02-24 13:33:21,1,1,0,舒服 老师爱你
102946,3426,甘均先,2019-02-25 05:50:25,1,1,0,论文有好好想点子好好写，期末考摸了。给分很好，不用担心期末的问题，可以放心听老师脱离课本。
103024,3426,甘均先,2019-02-25 12:06:46,1,1,0,上课很自由 话题很能引发学生思考 虽然不讲书上的哈哈哈 关键是评分也很高^_^
103072,3426,甘均先,2019-02-26 01:27:18,1,1,0,能学到不一样的观点
103089,3426,甘均先,2019-02-26 02:41:25,0,0,0,………………
103199,3426,甘均先,2019-02-26 16:10:01,4,4,0,先生之风，山高水长
103251,3426,甘均先,2019-02-27 03:32:55,0,1,1,来了 给您刷分了
103252,3426,甘均先,2019-02-27 03:39:56,1,1,0,?
103319,3426,甘均先,2019-02-27 09:43:31,1,1,0,Amazing！
103374,3426,甘均先,2019-02-27 15:13:37,0,0,0,甘老师真的不上课了吗？好伤心\n\n
103395,3426,甘均先,2019-02-28 02:02:05,2,2,0,非常有趣的老师，听老师的史纲课能学到很多干货，虽然不讲课本的东西，但是会有新颖的史学思考引导，对论文的要求相对会高，角度要足够新颖，甚至可以非历史理论，讨论课比较多，老师酷爱音乐，给分也很好，超爱！\n\n给我影响比较大的一个老师！
103418,3426,甘均先,2019-02-28 04:04:49,5,5,0,甘老师的史纲哲学课太棒了，给分也超好，我一个历史学考是b的人怕死怕活等出成绩结果出来4.5太爱老师了
103500,3426,甘均先,2019-02-28 14:45:23,0,0,0,老师不上课了吗！wuwuwu
103541,3426,甘均先,2019-03-01 02:57:28,2,2,0,啦啦啦
103623,3426,甘均先,2019-03-02 13:08:09,9,9,0,甘老师真的是很棒的史纲老师，他看待历史的角度非常新颖、有深度、有见解，作为一个文科生，见过的历史研究角度也不算少了，但是甘老师给我们讲解的观点、思考，是从来没有接触过的，真的有一种如沐春风的感觉！唯一有点尴尬的就是讨论课会要求双语。。。还有可能随机点人回答问题555（我就被点过好几次）平时事情很少，期中期末各一篇论文，主要看期末论文，想拿高分一定要尽量有自己的见解与思考。考试开卷，不难的。最后收获大一上最高绩点，感谢老师！！
103719,3426,甘均先,2019-03-04 14:12:03,2,2,0,好呀！
103781,3426,甘均先,2019-03-05 12:20:14,3,3,0,棒棒棒！真正的大学老师！
103810,3426,甘均先,2019-09-25 11:03:19,2,2,0,哈哈哈\n\n
104035,3426,甘均先,2019-03-11 01:28:33,0,0,0,好啊\n\n
104289,3426,甘均先,2019-03-16 14:43:53,9,9,0,1.老师的课非常有意思！可以把无聊的史料讲成生动的人物传记，甚至揭秘教科书里面没有的历史人物间的小故事。有时候作业繁重，一边写一边听别有一番风味。\n\n2.其他老师都有什么小组展示，但是我们甘老师就没有这种没太大意义的事情，反倒是专门抽了一个下午的课给我们放电影\n\n3.甘老师的作业也不多，就期中一个小论文（2000字）以及期末一个大论文（5000字）\n\n4.最最最最重要的是，恶竞在甘老师面前几乎没作用。甘老师给学生打分不看期末考成绩，“期末考只要你们写了就行，最后评分呢我就看你们两次论文写得怎么样，以及我看你们的脸熟不熟悉，脸熟就说明你们上课都在认真听嘛”，我平时上课都有在不时地做点笔记，顺带记录一些甘老师很有意思的话，经常和甘老师四目相对，然后写论文的时候也都比较用心地结合平时笔记去写，模仿老师上课PPT展示的逻辑，两篇论文都只比字数下限多了那么一点，但是最后老师的给分真的很好，喜出望外的感觉！\n\n\n\n
104330,3426,甘均先,2019-03-18 04:18:05,0,0,0,干货课
104506,3426,甘均先,2019-03-22 02:17:25,3,3,0,时隔一学期，每忆起仍不能忘却\n\n先生之风，山高水长\n\n（就是自带的bgm有点逗）
104544,3426,甘均先,2019-03-23 07:10:23,8,8,0,我实在没法昧着自己的良心给您打低分
104652,3426,甘均先,2019-03-26 01:43:36,0,0,0,老师给分超好，上课也很棒
104673,3426,甘均先,2019-03-26 02:42:33,0,0,0,很优秀
105098,3426,甘均先,2019-04-03 14:17:16,5,5,0,每个学期都应该上一节甘老师的史纲课。
105293,3426,甘均先,2019-04-09 08:39:09,4,6,2,虽然这是我绩点最高的一门，但是即使他给我3.3，我也还是给他打10分。
105396,3426,甘均先,2019-04-11 13:00:05,2,2,0,先生之风，山高水长。\n\n我的思辨能力训练离不开甘老师的点拨。如果以后我可以有点成就的话，也离不开甘老师的教诲。\n\n甘老师完全可以说是改变我人生轨迹的一位老师。至少过了半个学期，我还是相信着甘老师的。
105509,3426,甘均先,2019-04-16 01:48:43,1,1,0,太喜欢了!吹爆!
105822,3426,甘均先,2019-04-21 09:46:19,3,3,0,是一门非常有收获的课，非常幸运预置甘老师的课
105834,3426,甘均先,2019-04-21 15:26:46,5,5,0,甘老师有思想，有水平，有胆量
106349,3426,甘均先,2019-04-29 02:35:11,7,7,0,甘先生是我一生难忘的老师
106668,3426,甘均先,2019-04-29 01:40:36,0,0,0,很好的老师，真的超级好。事少，给分高！
106855,3426,甘均先,2019-04-30 05:18:09,3,3,0,他懂得尊重学生
107466,3426,甘均先,2019-05-05 11:06:39,7,9,2,甘老师真的是个低调但真的牛逼的人，上课上心，任务少，可以水，但是上到不想水。即便不怎么了解历史，但他的提问没有什么专业的东西，历史不好很能不错的表达自己的观点。老师的思想是真的好，给满分。
107860,3426,甘均先,2019-05-10 11:50:55,3,3,0,好像再去蹭一蹭甘先生的史纲看\n\n课呀~真的很有深度
108176,3426,甘均先,2019-05-16 05:02:09,1,1,0,感天动地好老师
108496,3426,甘均先,2019-05-27 03:36:31,1,1,0,事少分多?
108609,3426,甘均先,2019-06-01 12:32:40,0,0,0,男神！！
108610,3426,甘均先,2019-05-29 15:18:33,0,0,0,敲棒der
108678,3426,甘均先,2019-05-31 04:58:31,1,1,0,太棒了1551事情不多，上课超级有意思，认真做给分很好
108753,3426,甘均先,2019-06-01 11:32:42,4,4,0,先生之风，山高水长
108792,3426,甘均先,2019-06-02 13:43:17,3,3,0,老师上课真心有趣，不想打低分
109215,3426,甘均先,2019-06-12 03:32:04,0,0,0,极好!
109375,3426,甘均先,2019-06-13 12:25:39,0,0,0,真的真的超级棒！
109679,3426,甘均先,2019-06-18 10:18:22,7,7,0,大一一年最有启发性的课，最舍不得的课，最后一节听了两遍录了音，大二还会再去甘老师的课上听讲的。选上了课的同学一定要用心听，会有巨大的启发去。
110716,3426,甘均先,2019-07-06 01:10:14,1,1,0,好老师！！
112227,3426,甘均先,2019-07-03 23:37:41,0,0,0,超级好！！！！
112378,3426,甘均先,2019-07-04 03:20:03,4,4,0,18我大一刚开学的时候不到8分，现在我大一结束就变成9.37了，大家自己体会这是什么神仙老师吧?
112813,3426,甘均先,2019-07-05 03:53:37,-1,1,2,。。。
113365,3426,甘均先,2019-07-06 10:05:20,5,5,0,老师怎么不要求同学们在查老师这里打低分了？要不是这个还抢不到老师的课呢。甘老师牛逼！
115276,3426,甘均先,2019-07-17 10:09:29,2,2,0,讲课巨好，给分巨好，神仙老师
115963,3426,甘均先,2019-08-27 08:38:14,0,0,0,好好好
116479,3426,甘均先,2019-09-11 01:48:22,0,1,1,优秀。到位
116481,3426,甘均先,2019-09-11 01:51:33,1,1,0,老师要求打低分我也没办法
116485,3426,甘均先,2019-09-25 04:27:34,28,29,1,甘老师病了讲不动了好心疼
116508,3426,甘均先,2019-09-11 02:48:19,6,6,0,老师注意身体，好好休息，上课换风格，少了一点激情，但是仍然全是思考与启发。
116770,3426,甘均先,2019-09-15 12:28:09,6,6,0,先生之风，山高水长
116897,3426,甘均先,2019-09-17 05:41:50,0,0,0,问就是好，很有思想建树的老师，上他的课每每被他掷地有声的思想所震慑，给分也是在正态框架尽量给我们最好的，上他的课绝对血赚！
116987,3426,甘均先,2019-09-18 04:11:39,3,3,0,两年前6分多，当初才能捡到漏。现在9.4学弟学妹们想抢老师的课不容易啊
117478,3426,甘均先,2019-09-25 11:03:38,0,0,0,tql
117487,3426,甘均先,2019-09-25 03:06:42,1,1,0,先生之风 山高水长
117833,3426,甘均先,2019-10-04 06:19:52,4,4,0,不能说实话真让人不爽。
117970,3426,甘均先,2019-10-17 07:05:37,6,6,0,太喜欢这个老师的课了。老师讲的东西非常深奥，分析的非常透彻，课间放的音乐太对我的胃口了。课堂讨论的时候会点名，但说不上来也没关系，鼓励大家用英文发言，善解人意，大家都快去选他的课呀，保准你不会后悔！
118440,3426,甘均先,2019-10-27 05:20:42,1,1,0,tql
119315,3426,甘均先,2019-11-12 04:58:01,4,5,1,先生之风 山高水长
119340,3426,甘均先,2019-11-12 06:57:15,3,3,0,特别喜欢甘老师在课间放的音乐
120876,3426,甘均先,2020-01-18 02:41:19,2,3,1,甘老师讲建国后批评与自我批评的那一课听哭了，讲得太好
120934,3426,甘均先,2020-01-19 00:02:01,2,4,2,超级喜欢甘甘。平时没有作业，只有两篇论文，但是要求有创新性，理论化。从我的绩点看，我的论文居然被认可了。啊啊啊啊，真的对理科生的我莫大鼓励。我以为文科我学不来呢。上的课都很有深度，不是单讲历史，一环套一环，贼厉害。希望甘甘身体健康，不要生病了。
121019,3426,甘均先,2020-01-19 08:49:07,4,5,1,甘老师：我其实很想让他们把我从查老师里去掉的，结果去不掉。要么你们去查老师里都用英文评论，这样他们看到英文可能不会来选我的课。或者你们就去跟他们说一下，我的史纲课跟不是听故事的，是要思考问题的，是上的不太舒服的，让他们准备好了再来选。
121265,3426,甘均先,2019-12-25 03:12:19,2,3,1,甘老师真的是水平很高的老师，课堂让人感受到学术与思维的交融。能够通过简单明了而轻松愉快的例子让学生理解自己的思想，并促使学生进一步思考。直面问题，对于浙大甚至是国家受争议的问题并不避讳，让人感受到真切的求是精神，给10分！
121266,3426,甘均先,2019-12-25 03:00:53,2,2,0,老师真的太棒了！！！听他的课能有很多启发
121342,3426,甘均先,2019-12-19 02:41:44,4,4,0,We’d better comment in English.
121438,3426,甘均先,2019-12-16 06:31:33,0,0,0,哈哈哈
121508,3426,甘均先,2019-12-13 17:18:26,0,0,0,斯国一
121581,3426,甘均先,2019-12-12 10:33:51,0,0,0,很有趣啊，人生最独特的历史课。\n\n
121920,3426,甘均先,2020-01-24 01:08:52,1,4,3,I advice the students whose English is poor not choose this  teacher
121924,3426,甘均先,2020-01-24 03:13:42,1,3,2,第一节课听老师对人生的看法的时候，就感觉到老师是一个有思想深度的人，后来也渐渐验证了。嘻嘻还有甘老师每节课放的歌我都会默默加到歌单里，听歌品味超棒的老师！
121932,3426,甘均先,2020-01-24 08:41:59,0,1,1,老师很有思想，平时事少只有期末一篇感想一篇论文
122455,3426,甘均先,2020-02-28 10:42:40,0,0,0,He is a good teacher.
122548,3426,甘均先,2020-03-03 16:10:31,0,0,0,深刻且智慧
122599,3426,甘均先,2020-03-06 09:04:45,2,2,0,甘老师教会我们的是批判性思维，而绝非简单的史实
122678,3426,甘均先,2020-03-17 08:03:37,1,1,0,上课真的好，给分也是真的好……\n\n好好写期末论文真的 他会给超级高的分
123015,3426,甘均先,2020-04-30 13:25:04,1,1,0,很认真负责
123435,3426,甘均先,2020-06-09 02:15:22,0,1,1,网上教学从不点名，一篇随笔一篇论文，老师讲的很好
123771,3426,甘均先,2020-06-14 04:14:27,1,2,1,甘老师喜欢中英文结合讲课，思想有深度，不怎么按照教材来。能学到很多东西，态度极好。10分没毛病
123772,3426,甘均先,2020-06-14 04:32:46,1,1,0,反正我已经上过他的史纲H了，不怕他的差评威胁，所以可以放心地夸甘老师了～人超好超帅，对学生很好，作业不多，上课看了几部电影，英文发言其实也不难。上他的课，重在思考，那些说甘老师的课难的，应该反思的是自己。反正在我眼里，甘老师永远赛高！为他打call！！
124046,3426,甘均先,2020-06-22 08:52:29,0,0,0,好老师！
124438,3426,甘均先,2020-07-01 08:54:06,0,0,0,甘老师的史纲课真的太棒了!给分好，事情少，上课内容有深度，可以启发看待历史的不同角度，真的让思政课有所收获！
124441,3426,甘均先,2020-07-01 09:48:34,1,1,0,网课期间上了史纲，讲课很好，是有思想深度的老师，听课收获很大。期中一篇感想期末一篇论文，事情真的少。上课发言不一定要英文的。给分我觉得中规中矩，但是我历史真挺菜的，还挺符合我，所以满意啦！
124471,3426,甘均先,2020-07-01 17:19:35,0,1,1,高分挺高的，低分也很低，没信心还是别选了
124527,3426,甘均先,2020-07-02 10:41:41,0,0,0,除体育外的第一个满绩！我爱甘老师！！😭
124599,3426,甘均先,2020-07-03 11:53:00,0,0,0,很好的老师
124664,3426,甘均先,2020-07-05 10:04:53,3,4,1,甘先生的课，非常看重同学的思想，也很锻炼同学的思想。论文好好写，有自己的想法很可能满绩。
125764,3426,甘均先,2020-09-14 05:22:52,-2,3,5,我讲课是跟考试无关的？？？？
125852,3426,甘均先,2020-09-15 02:32:06,4,4,0,亲亲亲亲
125976,3426,甘均先,2020-09-16 07:03:25,2,3,1,有一说一，只要论文不抄，绩点不会低的。论文分数低只有两种可能：百度复制粘贴太多或者全篇废话，老师绝对是看得出来你的文章有没有水分的，一些同学不要觉得自己很认真的写了很多废话老师就应该给你很多的辛苦分哦～
126658,3426,甘均先,2020-10-12 07:26:54,16,16,0,老师：“你是不是一个意志强大的人？”\n\n我：“no”\n\n老师：“那你为什么意志软弱？”\n\nWHAT？？？
126682,3426,甘均先,2020-10-13 11:42:17,1,2,1,真的好
126924,3426,甘均先,2020-10-28 09:49:10,1,1,0,最好的历史老师
127060,3426,甘均先,2020-11-04 13:44:57,1,1,0,思想与宇宙
127070,3426,甘均先,2020-11-05 05:19:28,2,2,0,太好了，“别的班比我们班上的快，那我们来看场电影吧”
127203,3426,甘均先,2020-11-13 01:18:10,0,0,0,绝对好老师，启发学生思维，锻炼学生英语水平，好老师！
127754,3426,甘均先,2020-11-26 10:29:28,1,1,0,启蒙了我大学的学习兴趣的老师。超级超级棒!
128708,3426,甘均先,2020-12-25 05:08:38,0,1,1,宝贵的网课体验
128883,3426,甘均先,2020-12-26 10:45:10,0,1,1,第一次听甘先生的课感觉不像史纲，像哲学，不太适应。越听越有味道，甘先生是真的很好一个人，上课讲的东西也有很多干货，有一次还带病坚持上课。
129523,3426,甘均先,2021-01-06 15:09:48,2,2,0,先生学识思考的冰山一角，足以让我这个普通人感到震撼
129524,3426,甘均先,2021-01-06 15:23:59,0,0,0,启蒙学生思想的好老师！
129572,3426,甘均先,2021-01-07 14:08:57,2,2,0,史纲事少分高\n\n讲的大多都是老师自己的思考，不拘泥于课程内容\n\n好老师
129598,3426,甘均先,2021-01-08 08:18:51,1,1,0,甘老师很有自己的想法，好老师不用多说
129985,3426,甘均先,2021-01-14 15:22:31,1,1,0,男神，后悔之前没好好听课
130147,3426,甘均先,2021-01-22 13:21:09,0,0,0,威胁无用，十分有理
130490,3426,甘均先,2021-01-23 03:05:23,0,0,0,给个满分祈祷，等下考试现场翻新书希望人没事，希望绩点不会太拉
130620,3426,甘均先,2021-01-24 03:38:51,1,2,1,花15块钱冲爱奇艺下纪录片给我们看可还行
130807,3426,甘均先,2021-01-24 16:09:05,0,0,0,超棒的老师，人生课堂。很会启发学生思考，给分也超级棒的，写完他布置的论文有一股很强的成就感
130900,3426,甘均先,2021-01-25 07:41:35,4,4,0,课上讲的不都是书上的知识，不拘泥于课本，虽然上课像在上哲学，但很有思想价值；作业也不多期末交两篇论文（虽然赶的很匆忙，但最后绩点还是能看的）真的是好老师的哇
130902,3426,甘均先,2021-01-25 07:45:39,1,1,0,老师给分非常给力！平常不怎么讲书本，都是一些比较有深度、哲理性的内容，可以认真听（也可以水水过），平时上课会点人回答问题，基本上能说几句就行，作业只有期中期末两篇论文（不要求卷3000-6000）期末一起交，最后给的成绩应该都会帮你捞上去。一句话：老师人超好
130905,3426,甘均先,2021-01-25 07:57:05,1,1,0,老师超级棒，极力推荐，中国近现代史纲要，平时没有作业，就期中期末两篇2000-6000字的论文，给分也超级好
130911,3426,甘均先,2021-01-25 08:21:09,1,1,0,没什么好说的，能上他的课就是一种幸运。
130914,3426,甘均先,2021-01-25 08:33:28,1,1,0,感觉自己论文也很认真的写了，最后82分，3.6绩点可能是思考的还不够吧……不过甘老师很好的，很喜欢上他的课
130941,3426,甘均先,2021-01-25 10:09:20,0,0,0,我爱甘均先 上课很开眼界 事少分高 甘均先yyds！！！
130964,3426,甘均先,2021-01-25 12:05:03,0,0,0,没什么好说的，甘老师y y d s
131018,3426,甘均先,2021-01-25 14:43:19,0,0,0,卧槽，浙大还有这么好的老师，感动了
131019,3426,甘均先,2021-01-25 14:43:46,4,4,0,机器人工程的朋友们小心一点，如果一个班上有40个机器人工程的，他会认为全班都是机器人工程的
131144,3426,甘均先,2021-01-26 07:20:22,0,0,0,666
131239,3426,甘均先,2021-01-26 18:37:25,6,6,0,史纲遇上这样的老师真的挺幸运的，把史纲上到这种水平，老师的水平真的好可怕……\n\n老师的史纲会讲很多他不会说你绝对想不到的新方向。上他的史纲课真的很值，上课认真听一秒赚一秒。
131346,3426,甘均先,2021-01-27 07:07:26,0,0,0,很好的老师，上课有干货
131433,3426,甘均先,2021-01-27 13:18:36,0,1,1,甘均先yyds，大爱甘老师[em]e245[/em]\n\n史纲上课特别有意思，不讲书本，讲哲学，还时不时网上付费下电影给我们看[em]e113[/em][em]e113[/em]\n\n最好史纲老师，查老师满分给爷打上[em]e113[/em]
131521,3426,甘均先,2021-01-28 01:48:21,0,3,3,老师上课很有自己的风格，从独特的角度讲历史，听他的课是真的感觉受益匪浅，而且作业也不多（期末两篇论文），给分超好！！超喜欢他！！
132014,3426,甘均先,2021-01-30 02:53:14,2,4,2,甘老师是第一位值得我用先生称呼的老师。他讲的不是历史，不是政治，是哲学。他的思想不是大海，不是天空，是宇宙。（虽然一个学期下来工科生始终听不太懂，就是觉得他很牛逼）事超少，一学期只有两篇论文，先生看重思想的深度，给分超级超级好。先生为人谦逊，不愿学生给他实事求是的好评，但我还是得向他表示衷心的崇敬与感谢。
132045,3426,甘均先,2021-01-30 04:07:58,0,1,1,难得一见的好老师
132654,3426,甘均先,2021-02-03 06:57:42,0,3,3,吹爆，满分都不够的好老师，他的史纲课不拘泥于课本，听他的课对思维、人生都有很大启发，事情也不多，平时只有两篇论文，甘老师不推崇内卷，看中思维深度。给分也很好，能选上他的课真的是一种幸运。
133293,3426,甘均先,2021-02-23 13:16:47,4,5,1,甘均先yyds！上课和课本无关，全是关于历史的经验教训总结和哲思，最后会上升到方法论。希望同学课堂讨论和写论文能有自己的思考。喜欢屠杀式点人回答问题，“我们再找五个同学”结果点了十几个。
133391,3426,甘均先,2021-02-26 15:12:46,2,3,1,平时喜欢称他为甘神，如今觉得称甘先生更为恰当。他敢言敢讲，往往能带来引人深思的论题，令人惊诧的论点，先生之风，山高水长。
133649,3426,甘均先,2021-03-03 08:25:58,1,2,1,很棒的老师 ，上课收获很多，不仅仅是历史
133689,3426,甘均先,2021-03-04 00:44:31,2,4,2,上了第一节课就感觉到了甘老师思考的深度，从另一个角度来看待历史
133903,3426,甘均先,2021-03-09 09:14:49,-1,1,2,好好好
134098,3426,甘均先,2021-03-16 02:11:01,0,1,1,讲课幽默，深刻，人好好。
134609,3426,甘均先,2021-04-05 06:58:33,0,0,0,test
134642,3426,甘均先,2021-04-07 07:40:36,1,3,2,这老师实在是太好了
134771,3426,甘均先,2021-04-14 11:44:45,5,6,1,好老师，史纲不恶竞，很有思想和激情的一位年轻老师
136322,3426,甘均先,2021-06-16 08:01:51,2,3,1,很棒！让我真正敬佩的老师不多...
136349,3426,甘均先,2021-06-16 23:10:35,19,20,1,感觉甘老师承受了很多压力，有些遗憾没能体验到口耳相传的最后一课，不过甘老师给予我们的思维方式和价值观的启迪还是巨大的。非常荣幸能够预置到甘老师的课
136666,3426,甘均先,2021-06-22 14:39:24,17,18,1,孙大雁太多，甘均先太少
136706,3426,甘均先,2021-06-23 07:44:16,6,9,3,有思考，有深度，讨厌恶性竞争（会规定论文最高字数，不鼓励超过字数，注重论文深度而不是长度），鼓励多思考，鼓励同学们挑战自己用英文发言（但是不愿意用英文用中文也不是不行嘿嘿嘿），非常好的老师
136728,3426,甘均先,2021-06-23 13:03:09,4,5,1,好想回到学期初，听老师把那些不同视角的历史和启迪性的讨论再讲一遍\n\n这些讨论看起来可能有点泛，但是是真正能够启发人发现问题和解决问题的东西。\n\n也希望老师对于教育的热情不要被我们的（或许）冷漠的回应磨灭吧
136973,3426,甘均先,2021-06-29 04:07:27,3,4,1,很有深度的一门课，很照顾学生的老师。需要写两篇论文，准备上课发言，感觉是有意义的事情
137107,3426,甘均先,2021-07-01 08:27:25,6,7,1,结束了，可能是大学四年质量最高的思政课
138451,3426,甘均先,2021-07-09 09:13:17,-17,8,25,给分好低好低。慎选。
138478,3426,甘均先,2021-07-09 11:34:59,0,1,1,这学期期末不调分，看分数估计70分平时分给满了吧。。老师其实已经尽力了
138613,3426,甘均先,2021-07-10 03:19:37,0,2,2,唯一一门满绩的课
138891,3426,甘均先,2021-07-11 14:41:43,4,5,1,真正的史纲课，最好的史纲老师！！
140438,3426,甘均先,2021-09-11 11:53:51,2,3,1,一年后来评价，思政课里难得的清流，喜欢上课的思考题，和对历史和人生的分析，我上课总是起来回答问题，让我进一步在历史深耕的老师
140852,3426,甘均先,2021-09-17 01:52:42,0,1,1,非常优秀
141254,3426,甘均先,2021-09-27 13:31:59,3,5,2,从没见过思想这么有深度的思政老师，给分不错，还不鼓励恶竞，强推啊
141828,3426,甘均先,2021-10-27 06:24:13,2,3,1,好耶耶耶耶耶
143367,3426,甘均先,2021-11-24 07:36:34,1,3,2,甘老师yyds，思想真的很有深度，会引导学生思考很多现实性问题。从他的课上不仅可以学到人生道理，还可以拓宽自己思考的维度。超级棒！而且有时候的一些小笑话也很有趣，还会提前下课。（我还没上完课，但是真的为老师的魅力所折服了）
144025,3426,甘均先,2021-12-16 06:40:53,13,14,1,老师思想很有深度 是真正的史纲课了属于是【但不妨碍我史纲课听不下去……】\n\n花式点名：点人起来回答问题→直接大面积点名→钉钉群发一张图看谁未读 还会鞭尸
144346,3426,甘均先,2021-12-21 06:39:26,0,1,1,有亿点点强
144673,3426,甘均先,2021-12-23 05:25:08,0,1,1,很好的老师
144902,3426,甘均先,2021-12-26 01:23:23,5,6,1,甘老师学的是国际关系，教的是史纲，，讲的是哲学。强推
144976,3426,甘均先,2021-12-26 07:15:05,1,1,0,///
145318,3426,甘均先,2021-12-29 04:04:11,9,10,1,突然想起一句话“秀口一吐，就是半个盛唐”，甘先生学识实在是太渊博了，事情少，给分好，听课还有意思，会给你一个不一样的世界
145334,3426,甘均先,2021-12-29 05:31:24,0,0,0,哈哈哈
145466,3426,甘均先,2021-12-30 01:18:11,2,3,1,老师讲课很深入，非常具有启发意义
145586,3426,甘均先,2021-12-30 11:08:03,4,5,1,甘先生的课是一众思政课里灼灼闪光的那一份，虽然课程是近现代史，但是他却上的是哲学。我可以说甘先生的课对我的人生是有所影响的。我深深地感到自己的幸运，在刚入学的大一能上到这门课。
145608,3426,甘均先,2021-12-30 14:16:50,0,0,0,还好还好
145925,3426,甘均先,2022-01-13 11:46:28,-25,6,31,史纲考完了，听说甘均先会捞人\n\n保佑保佑\n\n写了3000读书报告和5000论文，平时从未认真听\n\n---\n\n回来了，4.2是不是没到平均分呜呜
146026,3426,甘均先,2022-01-05 05:52:40,0,2,2,老师太巨了
146090,3426,甘均先,2022-01-05 12:44:28,16,16,0,“你来了吗？”
147656,3426,甘均先,2022-01-10 11:06:05,1,2,1,水平高
148104,3426,甘均先,2022-01-11 13:39:05,0,3,3,教学内容很有意义，但我大部分时候没有认真听。。有点愧疚
148742,3426,甘均先,2022-01-13 11:24:19,-6,3,9,喜提4.8
148743,3426,甘均先,2022-01-13 11:28:52,0,3,3,老师教学深入，给分好
148744,3426,甘均先,2022-01-13 11:29:41,6,9,3,老师水平很高，平时事少，给分也很好(*ﾟ∀ﾟ*)
148745,3426,甘均先,2022-01-13 11:30:21,5,7,2,均先giegie好帅！大家快冲！
148756,3426,甘均先,2022-01-13 12:21:50,5,6,1,甘钧先我爱你！
148774,3426,甘均先,2022-01-13 13:02:17,0,1,1,甘先生好
148781,3426,甘均先,2022-01-13 13:22:16,5,6,1,很有思想的一位老师，虽然一半上课在赶作业挺对不起老师，但是不得不说老师真的很好。\n\n这学期作业是一个5K论文+3K读书报告。老师不追求卷，而是想看新观点。我写了很多自己的想法交上去，最后4.8。\n\n谢谢老师！选上甘老师不亏！
148823,3426,甘均先,2022-01-13 15:21:55,3,4,1,想法维度很高，境界太高，难以企及先生之风度！
148931,3426,甘均先,2022-01-14 03:37:40,7,8,1,真的讲的很好，你不听会后悔的，我就是。
149405,3426,甘均先,2022-01-15 08:49:51,3,6,3,如果被抓到偷懒不听课的话，会得到一个痛不欲生的分数。比想象的低得多多，哭哭哭，劝还是别冒险了。
150820,3426,甘均先,2022-02-19 04:39:46,5,6,1,好课，没什么政治色彩，看的到老师对历史、人生意义的深刻思考。
150960,3426,甘均先,2022-05-16 08:10:50,3,7,4,我猜绿冲锋衣老哥大概是刚穿越过来，还不太适应我们这个年代的用词习惯
150984,3426,甘均先,2022-02-21 14:53:23,1,2,1,好老师，上课不讲课本，会给你讲一些其他的东西，有点像哲学，对人生很有帮助，这门课考试也很简单，开卷，所以听听别的东西也不错
151147,3426,甘均先,2022-02-23 12:05:49,13,15,2,“最好的史纲老师，真正的史纲课。”\n\n这节课的期末考试是开卷，根据时间线就可以找到答案，还是挺简单的。\n\n上甘老师的课让你的史纲课不再是一门水课，而能学到很多关于历史和人生的思考。\n\n强推啊！
151379,3426,甘均先,2022-03-02 01:54:45,7,10,3,为什么这学期开始事这么多，一反往常啊
152341,3426,甘均先,2022-06-21 12:52:46,28,29,1,不管得分如何，甘老师带给我们的思考是最重要的，甘老师的体验报告也确实启发了我，我曾经也算想象力丰富的人，我时常想象压抑到足以吞噬一切的乌云带来惊世骇俗的电闪雷鸣、随后一场旷日持久的雨完全将我的家乡淹没成一片汪洋；想象血红色的天空，灰蒙蒙的雾霾，夕阳留下仗剑走天涯的侠士的剪影。我看见过鳄鱼失去翅膀的痛苦，看见过机器人偷偷流下的眼泪，看见过沙漠里被烈日炙烤到融化的时间，看见无数追梦的孩子爬向满天星辰。每当我想到什么东西，我的大脑总会生成一个真实图像，让我觉得我仿佛真正见过一样。然而，这种感觉到了大学之后就再也没有出现过，直到上了甘老师的史纲我才又找回了那种感觉，真的很感谢甘老师！这不是史纲课，是哲学课！
152751,3426,甘均先,2022-04-19 08:31:46,1,2,1,🉑深思，
152752,3426,甘均先,2022-04-19 08:31:46,0,1,1,🉑深思，
152753,3426,甘均先,2022-04-19 08:31:46,0,1,1,🉑深思，
153152,3426,甘均先,2022-04-26 07:25:07,6,7,1,先生的观点让人听了很舒服 容易接受
153232,3426,甘均先,2022-04-27 02:21:07,0,6,6,个人不是很喜欢 仁者见仁吧
153270,3426,甘均先,2022-04-27 09:20:18,3,5,2,被连续点了五次名回答问题，就讨厌他啦。哈哈哈哈哈哈(ಡωಡ)hiahiahia
153329,3426,甘均先,2022-04-28 05:58:45,-6,4,10,评分那么高认真的吗？上课很有压迫感
153336,3426,甘均先,2022-04-28 07:46:13,14,15,1,回复上一位同学，老师就是鼓励大家思考啊，像叫人回答问题这样，而且答得不太好也完全没有关系，他会总结你的回答。个人感觉认真参与就不会有压迫感吧，而且老师在第一节课就强调了他的史纲课是要大家参与、思考的，不是来听故事的水课，如果觉得不能接受其实当时就可以退课啊~
153660,3426,甘均先,2022-06-26 17:19:46,20,21,1,考完了很久，成绩也出来了，还算不错的，4.2。出成绩前，老师在群里发了一篇文章（给分说明），当时深受震撼。于是在前两天做梦，梦见老师呕心沥血地批改我们的作业。真的喜欢甘老师，我的甘先生。遇见您用尽了我的运气，感谢一路灵魂相伴。
153878,3426,甘均先,2022-05-15 05:00:04,6,8,2,面对屠杀时，如何面带微笑😊\n\n我好担心期末绩点呀😭
154183,3426,甘均先,2022-05-25 09:21:52,2,2,0,一开始可能不是很喜欢 但后来适应了觉得很好
154295,3426,甘均先,2022-05-29 11:48:18,4,4,0,很有个性的史纲课
154369,3426,甘均先,2022-05-31 07:52:38,18,18,0,感谢一路灵魂相伴～\n\n明明是甘老师用灵魂一路陪伴我们啊
154456,3426,甘均先,2022-06-01 15:50:49,21,21,0,感谢一路灵魂相伴！
154461,3426,甘均先,2022-06-01 17:13:08,19,19,0,“今天天太热了，我不想讲课，看电影吧”\n\n“这种课程论文基本都是垃圾，但是我还要看”\n\n老师的思想太深刻了，真的是给你灵魂上的洗礼，每次上完课都会思考很久，真的会让你的境界提升。而且老师对于应试教育的思考也很贴近学生。太喜欢老师了！
154641,3426,甘均先,2022-06-02 16:05:10,30,31,1,看到“感谢一路灵魂陪伴”这一行字出现在屏幕上时眼泪掉下来了，或许不是为这句话哭的，而是配合着老师站在讲台上摆摆手说下课的样子，知道这一学期就这么结束了，作为一个理科生再也不没机会坐在台下听老师讲那些我从未听过的“超越受限的意识”的美妙想法了。曾经因为害怕被提问而不情不愿地走进教室，这一次走出来却不能再走进去了，至少不再是有甘老师站在台上播放音乐等待上课的教室了。好像之前没有哪门课结课会让我难过至此，甚至现在打字的时候眼泪又流下来了。大概因为老师的课堂真的不是直白的知识传递，他试图用他深邃的灵魂照亮我们的。希望老师好好休息，平安顺利。
154681,3426,甘均先,2022-06-03 09:59:03,18,18,0,优点是史纲课不像史纲课，缺点是史纲课不像史纲课。\n\n如果你有充足的精力和灵动的思维，那绝对不会感到无聊和拘束；如果你只是想上一节中规中矩的思政类历史课，你会怀疑自己是不是走错了教室。
155008,3426,甘均先,2022-06-07 11:06:23,12,12,0,史纲与哲学的完美结合！\n\n感觉会受用一生！\n\n希望老师身体健康 感谢一路灵魂相伴\n\n是最喜欢的思政课了
155048,3426,甘均先,2022-06-08 02:05:35,13,13,0,爱了爱了。\n\n这才是老师该有的模样。超脱于课程：哲学，宇宙，意识，无所不有。
156898,3426,甘均先,2022-06-21 09:52:08,16,19,3,老师: “三个班仅一位同学满绩，你们所最在乎的，可能是我最不在乎的”
156957,3426,甘均先,2022-06-21 12:17:15,15,15,0,很有思想，希望大家都能认真对待老师的作业捏。期末说着狠话但是给分还是很好，大大地感动了
156959,3426,甘均先,2022-06-21 12:23:05,15,15,0,他是超凡脱俗的，虽然听甘老师的史纲会有点吃力，有点难懂，但是宇宙想象带来的思想超脱并不亚于历史给予我们的教训，他是有思想的，因此他的课也是。
156961,3426,甘均先,2022-06-21 12:25:52,6,6,0,太棒啦
157438,3426,甘均先,2022-06-23 08:25:53,3,3,0,因人而异吧，虽然老师思想很深刻，但就，有点跟不上QAQ\n\n给分不咋地
157567,3426,甘均先,2022-06-23 17:58:04,2,3,1,希望老师健康！感谢灵魂一路相伴，但给分确实呜呜呜
157867,3426,甘均先,2022-06-25 08:16:47,3,4,1,给分很好，人超好，上课传达的是思想不是简单的八股文，有深度的老师，希望以后还能上老师的课
159777,3426,甘均先,2022-08-29 09:22:51,3,3,0,一流一流，讲课很有思想，显然了解存在主义哲学，有自己独立思想。
160771,3426,甘均先,2022-10-11 00:33:43,6,6,0,提问及其有深度，我之前退了预支课，只有这个老师愿意接收我，而且真的超级温柔超级严谨，对待学术真的有自己的想法，喜欢历史，想学东西找他
160796,3426,甘均先,2022-10-12 07:57:19,2,2,0,吹爆！！！
160888,3426,甘均先,2022-10-18 08:41:52,4,4,0,有点想甘老师\n\n在我大一进来的时候\n\n满足了我一切对讲人文方面的老师的想象\n\n大三yq好无聊\n\n好希望能再有这种思考的课
161084,3426,甘均先,2022-10-26 06:29:21,-5,2,7,有小组讨论还有3篇3000字的论文这个量emo了
161573,3426,甘均先,2022-11-09 07:02:42,4,4,0,太喜欢老师了！！上课讲的超级好听（各种故事！！）超级可爱，开的玩笑真的很有趣。课堂氛围超好！
162793,3426,甘均先,2022-12-06 05:41:20,2,2,0,为什么满分只有10分qwq 想打100分 他是真的对学生很好！
163339,3426,甘均先,2022-12-14 05:12:35,3,3,0,“先来听点音乐，缓解下压抑的情绪”
163413,3426,甘均先,2022-12-14 08:39:38,2,2,0,内容丰富贯中西，思维深度越古今，认真负责，绝对是好老师！
163720,3426,甘均先,2022-12-16 04:13:37,3,3,0,gjx国士无双，太帅了，太好玩了，说话太有意思和启发了
163912,3426,甘均先,2022-12-16 14:01:54,4,5,1,听完甘老师的课一年多了，不管碰到谁都强烈推荐甘老师的史纲课。我本身就很喜欢历史，但老师的思想深度真的让我对历史又有了新的理解和感悟。
164711,3426,甘均先,2022-12-24 04:29:43,3,3,0,上过他的一次党史课，被深深打动了
165249,3426,甘均先,2022-12-30 13:54:55,6,7,1,第一个长评献给甘老师\n\n上大学以来遇到的第一个学识如此渊博又能打动我的老师\n\n老师的思想真的很深刻，可惜后来改线上效果没有线下好\n\n小学的时候我还会有很多想象，但是初中高中忙于学业就几乎不会对宇宙或者时空想象了，很感谢老师给我想象的机会\n\n“生命哪怕只有一秒也是美丽的”这句话课上一听到就想掉眼泪\n\n那节课上完后哭着写的体验报告，一遍遍回想我的过去，我的消极情绪\n\n他的课上总是会有超乎我想象的深刻观点\n\n后来网课没能多听一点老师讲课真的很遗憾\n\n希望以后还能上老师的课
165541,3426,甘均先,2023-01-08 07:23:30,1,2,1,是很好的老师
166199,3426,甘均先,2023-01-11 11:42:57,4,6,2,呜呜呜呜，谢谢老师，你给的史纲绩点在寒冷的冬天安慰了我。你上课也真的很好，呜呜呜太好了🥹
166211,3426,甘均先,2023-01-11 12:16:46,7,8,1,我觉得甘老师真的是一个格局很高的人，有情怀的人，上甘老师的课我觉得很幸运，选老师的课最后的报告一定要认真写，我很认真地写最后4.8 很开心，都来选老师的课，真的很好
166217,3426,甘均先,2023-01-11 12:40:24,4,5,1,更像是哲学课
166227,3426,甘均先,2023-01-11 12:59:28,1,1,0,好老师，上课会带我们思考与感悟，点名基本是点钉钉消息未读的人。上课可以在下面做自己的事，他看到之后会开玩笑，但还是让你做自己的事。作业要求很随意（褒义），作业只要体现我们的核心想法就可以了。
166243,3426,甘均先,2023-01-11 13:52:45,1,2,1,与其说是史纲课 不如说一门哲学课 \n\n虽然上课时我水的比较多（）但是甘老师真的是一个很有思想的老师
166254,3426,甘均先,2023-01-11 14:57:40,4,6,2,大一史纲课如果你不想干巴巴地学史纲，而且想从成绩中获得对自己的一部分认可，那一定要选甘先生的史纲课。甘先生有一次课三节讲中国共产党的历史转折真的封神，没有讲稿ppt纯粹手写板书输出。甘先生的课程作业，三次想象报告，课上给我们看了两三次电影（一部分是线上开课原因），可以用影评代替想象报告，真的很自由很有天马行空的空间，什么，你说课程上不完？不存在的，“考试都是开卷，给你把书讲完有什么用？”甘老师的课讲多讲少都不影响每次课的独立性和完整性，跟书中脉络有联系，但却绝不被其约束，他的观点我可能不全赞成，但都很有深度，他的口音和他讲授的方式一样，很接地气，深入但浅出。这样有趣的历史，认真学习受益匪浅，爱了爱了！！谢谢甘老师一学期的教诲，浓浓师生情！
166257,3426,甘均先,2023-01-11 14:45:51,3,3,0,老师人真的超级好！虽然因为功利的想法，苯人上课经常写其他作业，但是偶尔抬头听课的时候还是能收获很多。从老师那里学习到的不仅仅是知识，更多的是生活和做事的态度，我觉得这比干听近现代历史更能让人受益。作业只有学期结束前交的有关于死亡的想象报告，6000-9000字。虽然写得不好，有些幼稚，但我觉得对以后的我来说这也是一份有真情实感的珍贵回忆。期末考开卷。现在有些舍不得，因为感觉史纲课结束之后，在浙大上的思政课就只能是思政课了。最后，感谢甘老师！
166289,3426,甘均先,2023-01-11 16:50:08,4,5,1,甘老师更像是近代的先生，这是我来浙大一来最好的老师
166299,3426,甘均先,2023-01-11 23:42:44,1,1,0,真的，爱死甘老师。思想很有深度，特别值得10分呜呜
166366,3426,甘均先,2023-01-12 05:49:23,-26,4,30,10分！10分！一个每节课都管都不管直接写vjf线代作业的我拿了4.8！！救我一条狗命啊啊开心炸了哇吼
166499,3426,甘均先,2023-01-12 11:53:34,4,6,2,甘老师讲课不拘泥于书本，擅长用自己的一套哲学体系带领我们进入近现代史的海洋，温文尔雅，有大师的风范。\n\n强烈推荐甘老师！！（后悔没有好好听课了）\n\n不过！！期末考前还是要稍微看看书本的，毕竟甘老师讲课的内容和考试内容十分甚至有九分的无关……
166763,3426,甘均先,2023-01-13 13:14:23,1,5,4,老师讲得很好，史纲真的是裸考都能过，在他的课上听与考试无关的内容还挺有趣的。就是可惜没上4.5。
167516,3426,甘均先,2023-01-17 02:39:46,1,3,2,大师风范
167813,3426,甘均先,2023-01-19 07:58:29,-13,16,29,有一些事情。。。\n\n只想说shame on you\n\nzju师德师风问题较为突出不是吹的
168004,3426,甘均先,2023-01-22 03:52:37,-15,9,24,有一些事情不能上台面的\n\n真的肮脏
168495,3426,甘均先,2023-02-18 14:13:44,2,4,2,老师给分很好，平时上课也很有意思。
168538,3426,甘均先,2023-02-19 08:47:03,1,3,2,老师给分很好，平时上课也很有意思。
169384,3426,甘均先,2023-02-26 01:34:50,-7,2,9,老师是有水平的老师，上课容易昏昏欲睡但是给分很好，我唯一一个4.8哈哈哈
169910,3426,甘均先,2023-02-28 10:27:23,3,3,0,很好！！！
170103,3426,甘均先,2023-03-01 11:10:27,9,9,0,很可爱的老师，内容有深度，给分不错，大家快选
170139,3426,甘均先,2023-03-01 13:47:24,9,9,0,在浙大不听甘老师讲史纲，注定会留下遗憾。真想再听一次啊😘实打实的正能量好老师！讲的不是史纲，胜过史纲，每分每秒都有新的收获😀
171761,3426,甘均先,2023-04-04 09:32:51,6,6,0,甘老师什么时候出书 我要买爆😍
171763,3426,甘均先,2023-04-05 04:04:12,10,17,7,If you're interested in history，DO NOT expect to learn anything useful in his class. He just likes to express his weird opinions which are not even wrong.
172291,3426,甘均先,2023-04-24 10:07:04,2,4,2,甘老师快快出书
172348,3426,甘均先,2023-04-25 08:47:47,3,4,1,甘老师赛高！
173260,3426,甘均先,2023-05-17 06:55:41,9,12,3,很有深度的老师，或许只有上过他的课才能明白为什么他史纲课很少讲课本知识
173266,3426,甘均先,2023-05-17 07:42:29,-5,14,19,感觉老师上课经常脱离历史，会问你很多没什么意义的思考题，欣赏不来这种所谓的“哲理”
173779,3426,甘均先,2023-06-08 01:08:30,-26,1,27,哦，射手座，就是这个性格。哈哈哈
173782,3426,甘均先,2023-06-02 16:34:39,-5,1,6,查老师真会玩，一直以为我的史纲老师是N/A宝藏
174078,3426,甘均先,2023-06-06 06:13:41,-30,15,45,民科+魔怔人+疯子
174110,3426,甘均先,2023-06-06 09:31:38,12,12,0,非常有思想的老师
174147,3426,甘均先,2023-06-06 15:44:33,4,5,1,今天那个人是挺抽象的
174531,3426,甘均先,2023-06-13 17:03:29,-24,10,34,理工科慎选，不知道为什么对工科生有这么大的恶意。。。
175191,3426,甘均先,2023-06-22 08:43:28,11,12,1,有思想的老师\n\n想听史实介绍的不建议选\n\n想从历史中获得思考和经验的可以选\n\n老师对一些自然现象有自己的看法，不一定出自于正统的自然科学观念，但我个人觉得新的角度和巨大的想象力确实有助于我们冲破桎梏进行创新。
176295,3426,甘均先,2023-06-28 09:27:02,16,17,1,舍不得甘先生\n\n这是我上浙大来最喜欢、最期待、最能帮助自己思考的课了\n\n感谢甘先生
176581,3426,甘均先,2023-06-29 09:56:57,1,2,1,宇宙想象我觉得很有意义，要允许不现实的存在~
176583,3426,甘均先,2023-06-29 10:02:49,9,9,0,非常非常好的老师，真的能学到知识，鼓励我们思考，学的也非常轻松，从来没有作业。大作业不水论文而是写诗，如果有思考可以完成的很好且很快。期末给分非常好。总之甘老师是我的神。
176585,3426,甘均先,2023-06-29 10:10:38,3,3,0,就是很喜欢啦～
177833,3426,甘均先,2023-07-05 03:19:08,1,4,3,思而不学则殆
177841,3426,甘均先,2023-07-05 03:59:38,0,10,10,学习的前提是知道自己在学的是什么东西\n\n讨论的前提是双方讨论的是同一个东西\n\n教学的前提是明确自己在讲的是什么东西
177933,3426,甘均先,2023-07-05 14:33:56,0,4,4,其实也就那样，不过事情比较少
179201,3426,甘均先,2023-08-30 03:47:25,0,1,1,保护保护
180198,3426,甘均先,2023-09-20 13:52:20,7,8,1,他应该去教哲学，教什么近代史\n\n上课就是一路讲到很远很远的地方
180413,3426,甘均先,2023-09-21 13:12:45,5,7,2,甘老师上课有很多哲学性思考，想调动学生的思维，几乎与课本无关，适合喜欢哲学的学生🧐
180471,3426,甘均先,2023-09-22 01:19:03,-7,3,10,打低分压一下
181394,3426,甘均先,2023-10-16 14:06:10,2,4,2,老师上课有哲学思考，是培养人才的课堂
181487,3426,甘均先,2023-10-19 04:42:25,1,3,2,真正的老师
184438,3426,甘均先,2023-12-19 15:22:20,1,2,1,真正的思考者\n\n真正的老师
185400,3426,甘均先,2023-12-29 01:18:12,1,2,1,老师很有思想，事也不多，人好
187975,3426,甘均先,2024-01-18 02:35:49,-1,0,1,事儿是真的不多
189450,3426,甘均先,2024-01-24 09:38:54,-1,0,1,特别好的老师！有思想，给分高，人好！
189452,3426,甘均先,2024-01-24 09:42:24,0,1,1,真神！无须多言
189484,3426,甘均先,2024-01-24 23:48:32,1,1,0,非常有见地且温柔的老师，上课并不局限于史实，能极大的开拓思维。老师虽然会威胁要给低分，但是他的行为完全是把高绩点塞进学生口袋并且把扣子合上。但是建议期末考前还是要把书整理一遍，毕竟篡改历史太离谱老师也捞不了。
189527,3426,甘均先,2024-01-25 07:52:32,0,1,1,神，真正的好老师，有思想
190435,3426,甘均先,2024-03-04 03:28:32,2,3,1,讲的很好，给分也好，上课很有条理也很有趣。不过他的一些观点（比如对于游戏和部分近代史的看法）让我不敢苟同。不过会包容不一样的看法
190627,3426,甘均先,2024-03-12 07:46:35,1,2,1,老师很棒，真的很有哲思，呜呜呜呜男神
194208,3426,甘均先,2024-06-22 13:16:27,0,8,8,这全是好评我是不理解的，我觉得不好
195189,3426,甘均先,2024-06-27 05:56:37,0,2,2,有时候会点名，总评比较捞
195851,3426,甘均先,2024-07-01 09:47:04,5,9,4,千万千万别选，学弟学妹们。每堂课必点名，每堂课必回答问题，那些问题根本没法回答，很难。不能安心做作业，不能安心打瞌睡，不能安心玩游戏。哈哈哈，哈哈哈
196140,3426,甘均先,2024-07-02 00:23:19,0,6,6,甘先生我是你的狗！！！！！没有你我怎么活啊啊啊啊啊啊！！！
196274,3426,甘均先,2024-07-02 17:42:33,-1,1,2,喜欢偏哲学一点的同学可以大胆冲，老师基本不讲历史，上课都是探讨一些哲学问题，很多问题都好难回答\n\n给分爆好\n\n记得思考一下如何让动物觉醒（笑
196596,3426,甘均先,2024-07-04 07:50:49,0,3,3,虽然上课经常点名来请同学互动，而且喜欢探讨一些奇奇怪怪的问题，但是给分很不错。推荐想拿高绩点或者喜欢深入思考历史问题的同学选他的课
197494,3426,甘均先,2024-07-17 08:41:23,-2,4,6,思想家，大家风度\n\n论文认真写，期末裸考，最终5.0
214930,3426,甘均先,2025-02-19 06:55:25,-1,3,4,好好好好好
215440,3426,甘均先,2025-02-26 06:22:28,0,3,3,慕名而来
215467,3426,甘均先,2025-02-26 10:56:40,-1,8,9,迄今为止，这颗星球上最有思想的人。大赞
215631,3426,甘均先,2025-03-03 05:41:55,10,14,4,作为一个唯科学主义者，感觉讲得有点太玄学了，有点接受不了
215633,3426,甘均先,2025-03-03 05:51:21,5,6,1,去讲哲学吧
216061,3426,甘均先,2025-03-10 06:35:27,6,8,2,我觉得大家发言的时候，先过一下脑子
216074,3426,甘均先,2025-03-10 10:20:08,7,7,0,不想说话
216106,3426,甘均先,2025-03-10 10:04:40,8,17,9,老师人真的很好。反正思政课也基本学不到什么东西，老师在讲历史的时候代入一点哲学的想法又怎么了？又不是隔壁硬课大雾上扯皮的老师。\n\n我就是工科生，工科生就把自己限定死了是吧，只能接受唯物的，现实的，物质的，绝对的东西了是吧，就不能有一点想象力了吗\n\n我接受老师，和老师有思维上的共鸣与碰撞感到很满足。但是如果不接受老师的风格，低头玩手机就行了，反正只是思政课而已。
216569,3426,甘均先,2025-03-18 14:31:11,3,11,8,rzsb一个，马院的唯心主义者罢了，果然是把贵院指鹿为马发挥到极致
217197,3426,甘均先,2025-04-03 18:03:14,-8,5,13,大四学生回来评一下大一的史纲课，甘先生查老师有两个名字，一个平均绩点4.34一个4.33，我想真没得黑吧
217577,3426,甘均先,2025-04-14 00:08:39,12,12,0,你说的对，但《无限奇点》是由gjx自主研发的一款全新超维意识冒险游戏。游戏发生在一个被称作「无限潜在→有限存在→无限存在」的抽象宇宙，在这里，被无限选中的生命将被授予「无限之眼」，导引意识之力。你将扮演一位名为「觉醒者」的神秘角色，在自由的思考中邂逅性格各异、逻辑独特的同伴们，和他们一起击败唯科学主义的强敌，找回失散的无限意识——同时，逐步发掘「无限」的真相。
220887,3426,甘均先,2025-06-20 09:18:11,10,10,0,“给你60分还是重修？”
220888,3426,甘均先,2025-06-20 09:17:42,7,8,1,如果你能接受“无限是生命”，并且觉得史纲这门国家级别的思政课讲非唯物主义论是合理的话，请你来选吧。\n\n哦对，读书报告一定不要说他的思想不对，小心直接给你挂科。
221437,3426,甘均先,2025-06-23 12:39:26,2,2,0,评判老师好不好主要还是看你追求什么，对于思政课来说，事情少给分好就是好老师了
22373,3735,尤云弟,2016-03-04 03:16:53,90,105,15,哇今天发现尤老师终于自立门户了啊(￣▽￣)ノ开心~~四大家族虽然没有完全记得但是这方面的扩充让史纲课变得妙趣横生。尤老师的课干货特别多，绝对好评！
22580,3735,尤云弟,2016-03-08 06:54:39,40,53,13,感觉老师挺萌的，事也少，讲课也蛮有趣的。
22700,3735,尤云弟,2016-03-10 03:41:13,13,19,6,风趣幽默
22707,3735,尤云弟,2016-03-10 05:36:37,27,34,7,超可爱\n\n
22716,3735,尤云弟,2016-07-01 05:39:56,78,88,10,好老师，给分也棒棒哒
22725,3735,尤云弟,2016-03-20 23:07:30,33,40,7,老师人好，上课有趣可爱，干货故事多，复旦毕业耶鲁读书，会讲很多国外档案故事，老师加油，
22847,3735,尤云弟,2016-03-13 11:13:34,11,15,4,老师很萌的\n\n
22997,3735,尤云弟,2016-03-16 03:11:34,8,12,4,满满的爆点，很有趣
23303,3735,尤云弟,2016-03-24 02:24:03,5,11,6,很棒的老师
23312,3735,尤云弟,2016-03-24 05:25:36,160,200,40,我有一个浙大校友……\n\n
23316,3735,尤云弟,2016-03-24 07:14:58,6,12,6,老师棒棒哒\n\n
23365,3735,尤云弟,2016-03-27 09:33:53,5,12,7,老师好可爱呀
23470,3735,尤云弟,2017-07-04 12:22:56,283,337,54,一起来刷个十分，尤老师上课非常有趣，讲完书上的知识点，放一些好玩视频增长历史知识，会利用国外查的档案资料给我们讲历史趣闻，复旦博士，耶鲁留学，很钦佩老师的学习经历和研究领域，棒棒哒，最重要，尤女神对学生有责任心，非常和蔼，打分也不错哈哈，事情多但是一分付出一分收获，认真完成活动课和论文，有回报的?绝对优秀的大学老师！
23481,3735,尤云弟,2016-03-31 04:04:48,9,16,7,老师特别棒 特别可爱 上课老是会给我们讲别的故事 所以课堂很有趣 宋氏家族啊澎湃App啊走出帝制啊还有更多有名的民国人士 特别好玩 她夸绍兴人有文化时我内心是心虚的 嗯 她还特地去了绍兴为了给我们讲鲁迅
23581,3735,尤云弟,2017-09-05 05:29:43,6,12,6,特别八卦\n\n
23588,3735,尤云弟,2016-04-08 02:10:41,7,10,3,超级超级棒
23807,3735,尤云弟,2017-03-01 14:19:14,129,143,14,尤老师脾气好，上课好可爱，有时候太搞笑啦，把史纲课讲得有意思，干货故事多，复旦毕业，耶鲁读书，去过很多地方，会讲很多国外档案故事，老师加油，听说打分也很棒！
24416,3735,尤云弟,2016-04-30 13:30:30,23,30,7,手把手教你秀恩爱： ）
24966,3735,尤云弟,2016-05-04 13:44:13,4,7,3,生动活泼有趣的好老师，云弟老师真是么么哒呀!绩点给的还高，演出也挺有趣的。
25354,3735,尤云弟,2016-05-16 00:12:43,17,29,12,不懂说事少的什么心态…连续三周要准备三次小组展示…跪了
25850,3735,尤云弟,2016-07-01 03:23:34,5,7,2,给分蛮好 老师人也很有趣...
26153,3735,尤云弟,2016-06-16 06:15:16,4,6,2,布置论文比其他老师少
26656,3735,尤云弟,2016-06-20 15:57:36,3,6,3,事情少。。
26693,3735,尤云弟,2016-06-21 02:26:43,0,8,8,老师可爱，事少分高，不过声控不要选。。。
26832,3735,尤云弟,2016-06-21 08:35:44,6,10,4,老师人很亲切很年轻很努力，但感觉经验还是不足，讲课功底还差一些。有很多展示，但论文布置不多。
27341,3735,尤云弟,2016-06-25 02:59:47,2,5,3,挺喜欢。除了三节讨论课有点忙。平时上课开心的时候听一听，烦的时候水一水也没关系
27863,3735,尤云弟,2016-07-01 05:40:05,5,8,3,师生情，给分棒棒哒！上课萌萌哒！
27865,3735,尤云弟,2016-06-28 01:22:01,7,11,4,可以可以
28031,3735,尤云弟,2016-06-28 08:00:40,3,6,3,老师教学方式很有意思
28543,3735,尤云弟,2016-06-28 10:00:54,101,107,6,对老师上课的“然后ni”印象很深hhh不过老师人挺好的呀
28678,3735,尤云弟,2017-01-17 22:24:25,10,13,3,老师想把史纲上好，而不是水过，讲了许多民国轶事奇人，默默百度。
28807,3735,尤云弟,2016-06-28 15:52:30,6,8,2,非常好的老师 讲得很生动 事情少脾气也很好 而且还有一个浙大校友
30136,3735,尤云弟,2016-07-01 03:25:03,7,8,1,给分很好！！人也很棒！不会点名的！很喜欢爱老师
30141,3735,尤云弟,2016-07-01 03:37:37,1,5,4,云弟超可爱 有一个浙大校友 事情不多而且会帮你减少 好老师 讲课也蛮有趣
30150,3735,尤云弟,2016-07-01 03:56:13,3,6,3,老师人很好啊，给分也好，完全可爱*^o^*
30152,3735,尤云弟,2016-07-01 04:03:31,3,7,4,第一节课从头虐到尾，不过是个好老师给分也很好，虽然三节展示课有点累，但老师很好。“我的男朋友---我有一个浙大校友”
30153,3735,尤云弟,2016-07-01 04:04:37,23,29,6,老师超级萌 努力的把史纲课讲的很有趣 \n\n会分享很多背后故事 特列特别有意思\n\n而且超厉害啊 复旦耶鲁毕业生 \n\n\n\n给分也超棒 要感动哭了 \n\n只有一篇1000到2000字的小论文\n\n和三节活动课 \n\n只要态度认真一点 得分都很好的 推荐啊\n\n哦哦哦 不点名不点名
30193,3735,尤云弟,2016-07-01 05:00:58,2,6,4,给分好好啊 我这种论文水水过上课不发言的都有4.5 而且老师还挺趣的233
30196,3735,尤云弟,2016-07-01 05:03:40,4,9,5,付出总有回报。虽然有三次展示课加读书报告加读书感想，虽然事情堪称史纲之最，但只要给分好，又有什么关系ni\n\n
30215,3735,尤云弟,2016-07-01 05:41:59,4,6,2,老师给分好！虽然有三次连续的展示课但感受到付出还是有回报的，上课挺不错的。\n\n
30236,3735,尤云弟,2016-07-01 06:25:29,13,17,4,老师人特别特别好，年轻有活力，上课很有趣。对于讨论课，她的原话是，同学们不用花太多的精力和时间，尽力就好。多么为学生着想的好老师啊。最后，给分好。
30241,3735,尤云弟,2016-07-01 06:31:26,4,6,2,老师不错，讲课有趣，感觉考试考的很渣最后分数却很高，不可多得的好老师～
30433,3735,尤云弟,2016-07-01 14:48:26,4,7,3,老师很好很好，绩点么，身边4.2好像就算低了吧，老师很萌，还会讲很多她自己收集的资料和自己研究的内容。事情也不多，只是我们这个学期三节展示课有点忙。
30604,3735,尤云弟,2016-07-02 04:45:23,7,9,2,有干货，老师人也很好，上课讲着讲着会把自己说笑的，浙大校友这个梗也是非常6，最后分数也充分体现了老师之前说的“让我们过个好暑假”，总的来说，强烈推荐！
30635,3735,尤云弟,2016-07-02 06:00:31,0,5,5,事情比较多，但是范围很广，通过三次展示学到了很多，给分好，爱调戏坐第一排的男生
30935,3735,尤云弟,2016-07-03 03:29:01,0,3,3,我说我分很低，没办法，总有倒霉的
31581,3735,尤云弟,2016-07-04 07:11:43,20,24,4,尤老师特别棒！很开心修了她的史纲课。尤老师的史纲绝不是洗脑课，而是客观的告诉我们为什么历史是这样走下去的。\n\n尤老师还一直教导我们要多读书多锻炼，一定谨记教导。感谢尤老师！\n\n最后，祝福尤老师和她的浙大校友~
31615,3735,尤云弟,2016-07-04 09:16:45,1,5,4,上课不经意就会说起自己的男朋友。讲真给分是真好。
32749,3735,尤云弟,2016-07-12 07:59:17,9,12,3,事少分高不怎么点名，史纲除了云第还选谁！？
32822,3735,尤云弟,2016-07-16 07:07:25,5,8,3,挺好的老师，在课堂上会讲一些干货。有时候吃学霸餐会碰到，还会聊一些有意思的事。最主要的是还关心学生的人生大事。真心好老师。给分也不错。
33590,3735,尤云弟,2016-09-20 07:35:40,5,5,0,好多小故事，真的很了解历史，敲棒的！
33853,3735,尤云弟,2016-09-22 06:06:27,1,3,2,幽默哦
34582,3735,尤云弟,2016-10-14 07:15:17,5,5,0,还不错
35358,3735,尤云弟,2016-11-09 06:29:33,6,8,2,尤老师中国近现代史专业毕业，了解很多历史故事，不为人知的秘密...上课幽默，风趣，真心不错，棒棒哒，期末给分好，感动..
35359,3735,尤云弟,2017-01-14 05:01:46,6,8,2,好，很好，棒，这种词已经不够形容她了
35360,3735,尤云弟,2016-11-09 06:39:32,7,9,2,挺好哒，订婚还发糖
35629,3735,尤云弟,2016-11-10 07:36:04,2,4,2,我家那个对象。。。
35865,3735,尤云弟,2016-11-10 08:35:12,3,5,2,好可爱啊！老师超级萌，上课讲很多段子哈哈哈哈很轻松
39276,3735,尤云弟,2017-01-14 12:29:55,-1,3,4,好老师！尽量会把史纲这种课讲得生动有趣，非常吸引人！\n\n事是真的少，因为除了个人论文好好写外，小组展示这种麻烦的事情水水过就好，不是特别影响成绩
39779,3735,尤云弟,2016-12-27 12:31:27,1,4,3,好老师好老师
40179,3735,尤云弟,2016-12-29 19:56:59,2,6,4,尤老师很有才华 有问必答。复旦博士耶鲁读书 会很多民国故事 对学生也很好。用了立方书app方便学习，问卷调查也做了，希望老师教学改革成功。
40370,3735,尤云弟,2017-01-03 05:53:20,17,19,2,她和她的浙大校友终于在我们的见证下修成正果了\n\n
40740,3735,尤云弟,2017-01-05 07:48:44,19,31,12,挂名换个老师来上课，老师上课死垃圾，很不尊重学生
40838,3735,尤云弟,2017-01-14 03:14:30,3,4,1,非常棒，老师给分超好，大爱尤老师！
41064,3735,尤云弟,2017-01-26 02:26:52,28,39,11,棒棒哒！
41095,3735,尤云弟,2017-01-14 03:53:05,2,4,2,老师很有学问  特别善良  通情达理 上课只要求去听  做微积分都行  最后展示课小组好好配合  准备好一点  特别有趣  考试只要认真写的满一点就好  老师说会让你过好年  然后就4.5了  好棒好棒！\n\n
41240,3735,尤云弟,2017-01-21 13:42:26,75,94,19,我选了假课........
41258,3735,尤云弟,2017-01-10 09:08:34,31,36,5,我选到了假课
41262,3735,尤云弟,2017-01-10 09:26:02,20,25,5,我选到了假课
41270,3735,尤云弟,2017-01-16 13:55:41,11,13,2,老师很棒的。上老师的课可以学到很多民国的知识。一开始老师就布置任务，尽快早做，要不然后面爽死。。。。(●—●)
41335,3735,尤云弟,2017-01-10 15:31:46,-9,2,11,老师很可爱啦，虽然上课内容与考试无关，虽然因为身体不好和结婚～(￣▽￣～)~有几次没来上课嗯给个平均分
41597,3735,尤云弟,2017-01-14 03:25:37,1,4,3,被正态
42220,3735,尤云弟,2017-01-14 02:34:43,2,4,2,给分好，事情少
42228,3735,尤云弟,2017-01-14 02:45:05,8,11,3,老师好，给分高，期末试卷多写字。。。祝老师新婚快乐哈
42232,3735,尤云弟,2017-01-21 05:33:42,3,7,4,稳，一分耕耘一分收获，我不是组长，小组分也不高，好好学4.5还不是美滋滋\n\n
42233,3735,尤云弟,2017-01-14 02:54:08,3,5,2,老师真的是完美，小组讨论课、展示课，虽然有点累，但最后给了4.5绩点，真的是好老师
42235,3735,尤云弟,2017-01-14 04:29:28,0,2,2,棒棒\n\n
42236,3735,尤云弟,2017-01-14 02:54:54,4,6,2,老师上课超级有趣，会讲很多书上没有的东西，绝对给10分
42238,3735,尤云弟,2017-01-14 02:56:15,0,4,4,上课有趣 给分超棒哦！
42239,3735,尤云弟,2017-01-14 02:56:52,4,5,1,老师上课讲故事，超级好超级好超级好的老师一枚，给分也超棒，今年结婚啦哈哈哈哈哈新婚快乐呀，爱你么么哒
42241,3735,尤云弟,2017-01-20 06:31:18,-2,22,24,我觉得我们不应该用是否绩杀来形容一个老师，只是严格与否已经你自己是否努力罢了。我上的是王雪楠老师的课，虽然她没有经验，上课时间把握的不是很好，但她讲的确实还不错，除了连着三节课讲下来会让人觉得很无聊以外，只要是上课听讲了，就会觉得还是有收获的，史纲考的本来就难，考试绩点低也很正常。因为王雪楠老师是第一次教我们，再给平时分方面也没有经验，所以第一次期末考试我们的绩点普遍比其他班低，但她还是会很可爱地说去申请帮我们加平时分，不管能不能成功，我都觉得她挺好的。真的!不要太在乎绩不绩杀，最后的结果主要看你自己的努力而不在于老师，而且，凭心而论，她讲得还挺有趣的，人也很可爱。
42244,3735,尤云弟,2017-01-20 09:54:01,-1,14,15,靠新老师学生的低绩点拉高自己学生的绩点
42254,3735,尤云弟,2017-01-14 03:14:41,1,2,1,好好好好好，虽然事情不少但是给分真的跪了 不要太好啊！！谢谢老师！
42255,3735,尤云弟,2017-01-14 03:15:07,4,4,0,很好啊\n\n
42256,3735,尤云弟,2017-01-14 03:15:25,2,3,1,给分超好
42258,3735,尤云弟,2017-01-14 03:15:46,2,4,2,绩点巅峰
42259,3735,尤云弟,2017-01-14 03:15:55,4,6,2,老师上课很有趣 会讲很多书上没有的东西 因为老师研究挺深入的所以学到不少关于蒋介石的东西 平时讨论课展示课什么的还是有点事情的 最后给分不错4.2挺满足啦 老师今年结婚还发了喜糖～ 同学们一定要选上真课包你不后悔
42260,3735,尤云弟,2017-01-19 07:46:14,3,7,4,好老师，事情真的不多，好好做的话一定会有成果的。给分也很好。
42261,3735,尤云弟,2017-01-14 03:16:25,-1,1,2,老师人太好了！
42262,3735,尤云弟,2017-01-14 03:16:37,5,7,2,史纲是我所有科目最好最高的了，大爱老师！老师还借我课本和浙江精神！！！
42263,3735,尤云弟,2017-01-14 03:16:48,1,3,2,挺好的呀
42264,3735,尤云弟,2017-01-14 14:08:47,1,5,4,老师讲的很好，很多干货，只要平时认真给分就真的很好，老师很棒！然后ni新婚快乐！
42265,3735,尤云弟,2017-07-03 07:58:55,40,46,6,尤老师好啊
42266,3735,尤云弟,2017-01-14 03:17:00,0,3,3,炒鸡好\n\n
42268,3735,尤云弟,2017-01-14 03:18:41,3,4,1,巨好，上课很好，给分很好
42270,3735,尤云弟,2017-01-14 03:19:57,2,3,1,老师真的超级棒啊，安排的活动都很有趣，给分超级棒，超级棒，超级棒！！！上课也很有趣，有好多资料可以看，大爱老师(๑•̀ㅂ•́)و✧
42273,3735,尤云弟,2017-01-14 03:20:11,3,4,1,好好的
42274,3735,尤云弟,2017-01-17 12:53:15,0,3,3,老师人很好啦，可惜深藏不露，莫名绩杀ㄟ(▔ ，▔)ㄏ
42275,3735,尤云弟,2017-01-14 03:20:50,2,4,2,非常棒的老师，上课很生动，给分也很好 虽然自己被小小的正态了一下
42277,3735,尤云弟,2017-01-14 03:22:14,2,3,1,超好的
42278,3735,尤云弟,2017-01-14 03:22:51,5,6,1,尤老师的主要研究方向是蒋介石和国民党，讲课很好很有趣，从来不点名，上课会放很多的别的地方找不到的视频，一个能勾起学生兴趣的好老师。一直以为考试会挂科，但是最后拿了4.5的绩点，真的感谢老师。
42279,3735,尤云弟,2017-01-14 03:22:54,8,11,3,事少人好。但是要摊上一个不好的小组，那可能会跪得很难看的。
42281,3735,尤云弟,2017-01-14 03:23:27,3,4,1,老师很可爱，对待大家十分宽容，关心同学，给分更是……大家都懂～讲课也较为有趣。赞一个!
42284,3735,尤云弟,2017-01-14 03:34:07,0,2,2,我的绩点...
42286,3735,尤云弟,2017-01-14 03:33:44,1,2,1,...\n\n
42299,3735,尤云弟,2017-01-14 03:48:11,4,5,1,很棒哒史纲老师，虽然学校安排的期末考试很坑，但是还是拿了4.5，班里上4的小伙伴很多。平时好好表现，论文小组作业认真做的话，高分不是问题。
42301,3735,尤云弟,2017-01-14 03:50:26,2,4,2,老师太棒了。讲课很好。给分更棒。4。5。爱老师
42305,3735,尤云弟,2017-01-14 03:52:37,12,13,1,尤老师超级棒！\n\n不过有其他老师挂名，选课注意甄别！
42307,3735,尤云弟,2017-01-14 03:59:55,3,5,2,很好的老师哦\n\n给分很好\n\n上课也很有意思\n\n爱她
42314,3735,尤云弟,2017-01-14 04:17:24,4,4,0,尤老师上课真的很有趣，不由自主开始听课，虽然最后两节课没有好好听课......史纲复习来不及，但是老师给分很感人！
42317,3735,尤云弟,2017-01-14 04:19:52,4,4,0,可水可听   绩点超高\n\n
42330,3735,尤云弟,2017-01-14 04:35:36,5,5,0,老师给分好啊\n\n
42348,3735,尤云弟,2017-01-14 08:16:36,1,7,6,唉，小组长，展示课忙的不行，回答问题很多提问也很多，然而最后3.3不说话
42381,3735,尤云弟,2017-01-14 05:57:42,1,3,2,老师超级可爱，很温和亲近，事情不算多，给分绝对好
42402,3735,尤云弟,2017-01-14 06:35:21,-1,3,4,可以水，而且给分特别好（老师说：“都放水，我不会比别人放的少”）
42404,3735,尤云弟,2017-01-17 09:48:10,53,68,15,我不知道尤老师，但是我知道王雪楠\n\n客观讲，她上课还是可以的，讲的是不红不专的历史\n\n但是 事多 做展示时会怼人 最重要的 绩杀\n\n问到现在，最高绩点是3.3\n\n就这样 希望只是因为她初来乍到缺少经验\n\n不过还是给大家排雷：）\n\n希望大家不要上假课
42410,3735,尤云弟,2017-01-14 06:55:34,3,3,0,好的不需要解释
42527,3735,尤云弟,2017-01-14 11:17:07,2,2,0,老师非常好啊，比起室友的史纲老师好上一百倍哟，平时上课不会点名，也不会要求你一定要听课，但讲的非常好，有很多独家史料啊
42600,3735,尤云弟,2017-01-14 13:54:30,5,6,1,绝对是好老师！！！真的太好了
42726,3735,尤云弟,2017-01-15 03:55:36,8,9,1,考完微积分来评价一发  老师人特别可爱*ฅ´ω`ฅ*讲课也超级有趣而且每次都会提前下课让大家都可以去食堂吃饭不要吃学霸餐qwq最后的给分也超棒的真是如果没有史纲我的绩点大概会难看到死(¯―¯٥)…总之考完微积分了真的很想给老师说  谢谢老师给我这么高的绩点qwq！
42776,3735,尤云弟,2017-01-15 05:16:11,2,4,2,干货很多，课堂很有意思，老师风趣幽默，分给的很高，平时的事情也比较少。
42784,3735,尤云弟,2017-01-15 05:26:51,1,3,2,给分棒
43909,3735,尤云弟,2017-01-23 02:37:14,23,29,6,听说很好
43924,3735,尤云弟,2017-01-17 06:31:08,28,29,1,只想说羡慕那些有老师的学生 挂名她的课的这个代课老师绩杀到13里了
44108,3735,尤云弟,2017-01-17 09:31:24,66,79,13,我的老师名义上是她但是却是王雪楠……真的被坑惨了。王雪楠班均绩2.8其他的班3.8你们想想这能拉多少绩点？不说了，反正王雪楠大绩杀大绩杀大绩杀，课代表和她沟通好久都不改期末分数比例，也是醉了，因为她我的均绩又掉了好多???
44131,3735,尤云弟,2017-01-21 14:20:01,42,51,9,那些说王雪楠申请加成绩的，脸疼不疼？什么叫看自己努力？绩杀老师努力有用吗？省就算省状元一样3.0
44197,3735,尤云弟,2017-01-17 11:53:24,23,34,11,算是我倒了血霉，当初以为选上了尤老师的史纲，没想到是一个新来的年轻老师王雪楠挂在尤老师的名下来上课。新老师，上课逻辑不清楚就算了，上课全讲书本以外的内容就算了，讲的完全不是正统史观也就算了。可是您给全班的均绩是2.7是什么意思，就算是其他号称绩杀的老师的均绩也没您这么低啊。学校要求正态分布，是为了控制高分人数，可您倒好，80分以上的全班凤毛麟角，一个都找不到的。我可真是谢谢您了，让我看到了年轻老师有多胡来。您到一个新地方不尊重当地的习俗你怎么混的下去？
44199,3735,尤云弟,2017-01-22 14:23:05,6,10,4,已转移
44224,3735,尤云弟,2017-01-17 12:11:46,0,12,12,大家不要骂王雪楠老师了，老师也是在很用心的上课，包括考试结束后一直在捞那些及格不了的同学，想让他们都能及格，包括一个作业都没交的同学，最后的分数我感觉是老师不懂怎么给我高分而不是不愿意给我们高分，老师是真的很想让我们分数高点的，只不过是今年第一年来浙大，还不懂怎么把分数调高，占比那个也不知道可以改，大家不要抱怨老师了，老师现在还在努力给我们改分，绝对不是一些同学说的故意绩杀，请大家体谅一下老师吧，谢谢 （来自一个虽然是课代表依然只有3绩点的苦逼同学）但王老师真的人很好的，没有评论说的那么可怕
44241,3735,尤云弟,2017-01-18 00:26:55,3,4,1,老师非常好！给分好，讲课有意思，学到了很多！史纲课的知识竟然用在了思修考试。看得出来老师是一个非常认真做学问的人，考试加油！
44292,3735,尤云弟,2017-01-17 14:21:48,15,16,1,小心挂名的王雪楠，绩点被史纲拉了0.4能忍？
44306,3735,尤云弟,2017-01-17 14:46:31,5,19,14,我也很难过我一个文科生，成绩这样，但是希望大家不要太怼我们的王雪楠老师，其实她也挺好的，讲课不错，然后帮我们出主意，很尽心的老师，至少真的关注我们，最后成绩是这样相信她也没想到。。我只是说出我想说的。我觉得老师挺不容易的。我想，如果我有一天走上工作岗位，也会有一些不小心，不懂的，我希望会有人体谅我。老师也付出了很多。
44404,3735,尤云弟,2017-01-17 22:20:46,2,2,0,被正太了(｀⌒´メ)\n\n
44424,3735,尤云弟,2017-01-28 02:22:18,34,44,10,尤老师的均绩是3.9，现在变成3.6全是坑爹绩杀王雪楠搞的，班上均绩2.7左右，毁大一的坑爹绩杀，学弟学妹注意了。
44440,3735,尤云弟,2017-01-17 23:57:18,32,39,7,假老师真的害人，千万注意这个老师的课有可能是王雪楠上的，那样的话最后绩点有3分算不错的，听说均绩2.4，无话可说。这种水课到头来绝大多数人还不是要一个绩点，那么多破事辛辛苦苦干了给我搞这出？学历史学傻了？
44469,3735,尤云弟,2017-01-18 00:51:22,3,5,2,老师不点名，讲课其实有趣，只是自己弱鸡不想听，确实是一位好老师！
44498,3735,尤云弟,2017-01-18 01:39:22,4,7,3,老师人很好，很可爱，也很有知识素养，知识水平很高。她说会让我们过个好年的，她不点名的理由很赞。虽然我绩点没有上四，但，毕竟有很多上四的，所以，还是推荐老师。给老师点赞。
44728,3735,尤云弟,2017-01-18 07:10:36,0,3,3,棒棒哒
44887,3735,尤云弟,2017-02-24 02:48:03,9,13,4,没有上过尤老师的课，嗯，我上了假课。。。请各位同学一定要注意甄别，保护好自己来之不易的绩点！！
44990,3735,尤云弟,2017-01-18 17:49:43,2,4,2,老师好棒好棒的！而且绩点感人啊啊啊！感觉要成为我这个学期最高绩点了
45042,3735,尤云弟,2017-01-19 01:23:57,3,5,2,老师好啊\n\n
45631,3735,尤云弟,2017-01-20 01:29:10,0,4,4,真诚满满的老师～点名会提前通知 上课很认真 近代史讲得很好玩  如果说有缺点 就是讨论课太累 最后给分超好
45843,3735,尤云弟,2017-01-20 07:17:24,4,6,2,这么认真的做平时作业。最后还是被正态到3.3，:-(
45923,3735,尤云弟,2017-01-20 09:09:35,29,34,5,我就说一句，选尤老师的课，在还能退选的时候一定要去上一节，如果是那个叫王雪楠的冒牌货赶紧退，退，退，别xjb犹豫，迟个几年再学这门课，也比毁一学期的成绩好
46028,3735,尤云弟,2017-01-20 12:24:08,-11,13,24,说实话，王雪楠老师虽然给分不高，但是本身有水平，对近代史有研究和自己的见解；上课不用带课本，认真听会有不同的思考，改变对一些历史人物或事件的固有印象。看得出老师对小组展示的要求还是挺高的，会不时打断，提问或补充一些内容。文学素养高于一般老师，反正比我一位爱读错音的人文通识课老师好太多。平均分是73.8，所以绩点没有2.4这么低（当然也已经低出了一个境界...）但至少在我看来，如果实事求是，大部分同学平时分本就达不了多高分，多选题别的老师的学生也不见得能做多好。这次均绩低说到底就是老师初来乍到，业务不熟，分数比例设置没有其他老师的“合理”，虽已尽量给分、捞人，但也回天乏术。事实上，按照同学实际水平，能拿高分的凤毛麟角很正常，一堆4.几的才水吧。不明白为什么有些水了一学期课的同学会认为自己有资格拿高绩点，难道你其它科目水水就不会挂科吗?何必文理区别对待。说上课讲课外的想想有些老师的思修，一学期讲了多少课本内容?只不过给分高罢了。PS：大概王老师下学期会三七开，考试只看多选了，这样绩点应该低不了。还是推荐对近代史感兴趣的来听王老师的课，虽然我没上过其他老师的史纲课（废话ԅ(¯ㅂ¯ԅ)）。当然史纲也是本人绩点最低的一门，我们都是小白鼠，但没必要因为得分低而一味否定老师吧，自己努力了至少不会低到无颜见江东父老。
46185,3735,尤云弟,2017-01-21 01:13:51,12,19,7,首先老师挂名这种说法就是闻所未闻见所未见的，没有资格开课就是没有资格开课啊，的确王雪楠讲课是有自己的逻辑和风格，但这并不意味着她可以绩杀啊，回复一个长评论说凭什么有些同学水了一学期却认为自己可以拿4.+，可是别的班的同学不是在水嘛？大家一起水，老师给分截然不同，结果是大家一起看绩点，这对雪楠班里的同学来说就公平吗？业务不熟不是借口，是自己不按套路出牌，难道不可以按照挂名的教学班的方法算吗。不过大水课的绩点大家也没必要太在意，也至少尊重一下为人师表吧。还是给雪楠7分。
46342,3735,尤云弟,2017-01-21 09:27:07,5,7,2,老师很亲切呐，很舒服的感觉。
46681,3735,尤云弟,2017-01-22 06:54:23,1,3,2,坑逼王学楠，小心挂名的老师，真的坑
47023,3735,尤云弟,2017-01-23 09:48:40,1,3,2,尤老师上课棒棒哒，会很多历史档案小故事，还会给我们看她的研究成果。是耶鲁读书复旦毕业的，很佩服她把这么枯燥的史纲课讲的这么有趣。期末给分也很棒，有付出就有回报，绩点提升靠史纲。谢谢老师，老师加油
47200,3735,尤云弟,2017-01-24 12:06:50,4,6,2,棒！讲课有意思，给分也超好。祝老师新婚快乐，早生贵子！
47305,3735,尤云弟,2017-01-25 07:17:33,-9,8,17,其实说句实话，在这里夸尤老师的大部分因为绩点很高，给分很好。期末我没觉得多难，尽管答得一般但是我觉得史纲课真的学不到什么，对我的思维没有有效的启发。看到评论我觉得有一点过誉老师了。最后一节课大家都希望老师点个名可老师没点，我觉得这是对认真（至少是对每次到这堂课的同学的侮辱）。如果想水推荐你，如果想拓展知识面请慎重。不过老师很体贴这一点不用质疑
47916,3735,尤云弟,2017-02-27 09:21:39,1,4,3,给分莫名其妙
48534,3735,尤云弟,2017-03-07 02:03:39,3,3,0,大家可以拿出手机百度下...\n\n
48664,3735,尤云弟,2017-03-09 05:22:55,1,2,1,………王雪楠………
51917,3735,尤云弟,2017-06-13 13:28:24,-2,4,6,老師很好，介紹了不少民國的故事。但我感覺老師是果粉啊，非常隱晦地黑昆侖又好像想表揚四大家族似的。講抗戰的時候還能忍；講解放戰爭的時候我有一種衝上去幫她講的衝動，她自己也講的沒勁，一些介紹TG的地方竟然被她跳過了。可能和她的研究方向有關？當然我相信大多數人沒有我這麼高的政治敏感，那麼她的課還是很好的。不過不要選錯老師啊，我一開始選的不是她本人，後面自己琢磨出來的。
52596,3735,尤云弟,2017-06-21 09:48:50,5,6,1,超棒  给分好  性格好
52723,3735,尤云弟,2017-06-22 09:56:00,6,6,0,10分不解释
55721,3735,尤云弟,2017-07-02 09:19:34,2,4,2,老师人很好，可爱！上课会扯八卦，一点都不无聊233论文对我来说有点点难，但是给分真的非常好啊！
55724,3735,尤云弟,2017-07-02 09:27:00,5,6,1,表白老师！
55726,3735,尤云弟,2017-07-02 09:28:32,3,4,1,老师非常好啊，给分好好。期末考试大题写的挺少，选择题还选了很多一个选项竟然上4了……像我这样只能靠思政课拉高绩点的人真的特别感谢老师。\n\n上课的话很有意思，会讲很多高中历史听不到的观点。还有大佬们的小八卦。平时作业小组作业略多，分担给每个人的任务很轻松。个人论文的话会给十几个命题，所以选自己想写的很容易写。论文上限2000!!!!!这么好的事去哪找?\n\n不过要注意甄别尤老师和王雪楠……有挂名上课的，祝大家幸运地选上!
55747,3735,尤云弟,2017-07-02 10:12:47,6,7,1,老师人很好 很亲切 给分4.2我已经很满意了
55748,3735,尤云弟,2017-07-02 10:13:38,5,6,1,实力赞美老师！！！！老师就是人民的大舅星！！！！打100分都嫌少！！！！
55751,3735,尤云弟,2017-07-02 10:26:58,2,4,2,上课有趣 绩点高
55754,3735,尤云弟,2017-07-02 10:29:09,-17,3,20,虽然给了我94 有点小沮丧 但是真的已经很满意了 ！ 大赞！
55775,3735,尤云弟,2017-07-02 11:14:23,-2,2,4,尤老师给绩点真的大方
55801,3735,尤云弟,2017-07-02 11:45:54,2,2,0,老师挺好的。也希望老师多多注意身体，不要太累啦！
55804,3735,尤云弟,2017-07-02 11:49:50,4,5,1,绩点大舅星
55805,3735,尤云弟,2017-07-02 11:50:38,3,3,0,还有比尤爸爸更好的老师吗？
55818,3735,尤云弟,2017-07-02 12:16:14,2,3,1,老师特别棒！！！！！！！！！！！！！！！！！！！！！！！！！！！！！！！！！！！！！！！！！！！！！！！！！！！！！！！！！！！！！！！！！！！！！！！给分特别棒
55821,3735,尤云弟,2017-07-02 12:21:26,-1,1,2,很好的老师
55824,3735,尤云弟,2017-07-02 12:27:36,0,2,2,老师人很好，学术水平也很高，好老师!
55831,3735,尤云弟,2017-07-02 12:33:49,0,1,1,老师上课很不错，不是很专。普遍反应给分很好但我自己觉得平时做的都挺认真的小组打分也不错但绩点比想象的低了点...可能还是自己有哪里没做好吧
55836,3735,尤云弟,2017-07-02 12:40:26,0,1,1,非常好，上课很生动有自己的看法事情不是很多，关键给分超好！！
55840,3735,尤云弟,2017-07-02 12:43:03,1,3,2,很好的尤老师呀很喜欢用表情包的尤老师呀
55841,3735,尤云弟,2017-07-02 12:43:21,3,3,0,尤爸爸不解释
55844,3735,尤云弟,2017-07-02 12:47:47,1,3,2,被正太了，呵呵。
55852,3735,尤云弟,2017-07-02 13:10:31,2,3,1,老师的课很有趣，喜欢历史，喜欢萌萌的老师
55853,3735,尤云弟,2017-07-02 13:11:43,3,5,2,满绩啦，不过老师活动还是挺多的，有点累，论文靠恶竞，写了7000+字，考前看了一天史纲书和浙江精神，考试全翻到了，选择题还是自己做，没有全蒙ABCD。
55855,3735,尤云弟,2017-07-02 13:13:01,1,3,2,超棒！
55856,3735,尤云弟,2017-07-02 13:13:53,2,2,0,太棒啦
55858,3735,尤云弟,2017-07-02 13:25:42,2,2,0,选尤老师的课 没毛病！！！
55873,3735,尤云弟,2017-07-02 13:59:52,1,3,2,优秀，棒棒棒棒！
55875,3735,尤云弟,2017-07-02 14:03:02,3,4,1,哇超级棒的老师，给分也很棒的，超级温柔超级好。
55889,3735,尤云弟,2017-07-02 14:42:24,0,2,2,尤老师真的很好，作为一个工科生，也认真听了关于国民党和委员长的我以前从来不感兴趣的故事。
55902,3735,尤云弟,2017-07-02 15:09:15,4,4,0,反对楼上说论文靠恶竞的 论文认真写了2500左右 选择题全选了abcd因为时间不够 平时小组活动积极 最后4.8 可能差别在选择题 反正论文别真写个7000+啊老师也很累的
55949,3735,尤云弟,2017-07-02 17:43:01,3,4,1,真·尤老师的课不用多说！上课好，绩点高
55985,3735,尤云弟,2017-07-03 01:19:11,4,4,0,认真负责的好老师
55987,3735,尤云弟,2017-07-03 01:23:19,4,5,1,老师超级好哒，课也超级有趣
55988,3735,尤云弟,2017-07-03 01:24:53,6,6,0,4.8！！赞！
55992,3735,尤云弟,2017-07-03 01:28:12,1,3,2,讲课和给分都很亲民
56013,3735,尤云弟,2017-07-03 02:16:19,2,3,1,棒棒棒
56093,3735,尤云弟,2017-07-03 04:57:46,4,5,1,尤老师必须满分啊！\n\n尤老师的事情不多，最多也就史纲老师的平均水平，但是她课上得好啊，还会给我们看一些课外的视频，讲一讲自己在美国求学的经历等等。最重要的人尤爸爸人好啊，给分也好啊！强烈推荐啊！我一个理科生跑到人文预置的尤爸爸班，几乎全是文科妹子啊，文综不知道比我高到哪里去啊！我怕死了啊！最后尤爸爸还是给了我4.5，可能是因为平时努力参与展示，虽然考试很糟，但还是谢谢尤爸爸！\n\n顺便一提，下学期尤爸爸的班是周三上午和周五上午，不要选错哦
56136,3735,尤云弟,2017-07-04 07:11:31,5,6,1,讲课特别有趣，人也很好的一个老师
56183,3735,尤云弟,2017-07-03 07:56:18,1,3,2,给分真的感人
56292,3735,尤云弟,2017-07-03 12:08:33,6,6,0,女神，尤老师
56635,3735,尤云弟,2017-07-04 06:19:05,1,4,3,\n\n尤老师超级棒！
56650,3735,尤云弟,2017-07-04 07:08:38,2,3,1,老师的课非常有趣，老师本身也非常可爱，重点是事少，给分高，期末考前还特别安慰我们不会挂的，平时分给的很好，期末也是师生情满满，放的视频都非常有趣。干货多，有学识的老师，历史人物信手拈来。对待学生宽容。
56652,3735,尤云弟,2017-07-04 07:11:01,3,4,1,非常好哦！十分
56659,3735,尤云弟,2017-07-04 07:42:22,3,3,0,史纲课\n\n
56666,3735,尤云弟,2017-07-04 08:12:53,3,4,1,很开心
56674,3735,尤云弟,2017-07-04 08:33:09,2,3,1,给分好呐
56862,3735,尤云弟,2017-07-05 01:31:56,4,6,2,果断选！很有师生情！\n\n
58167,3735,尤云弟,2017-08-13 23:05:03,-1,2,3,尤老师棒棒哒，会很多档案故事，研究金融史移民史，很有趣，上课不错！对学生负责，推荐给学弟学妹！
58264,3735,尤云弟,2017-08-28 05:23:44,2,2,0,哈哈哈
59145,3735,尤云弟,2017-09-28 07:54:18,3,4,1,很轻松，讲得风趣\n\n
59256,3735,尤云弟,2017-09-20 11:21:26,0,2,2,尤老师超级棒！今天刚听了一节，就开始对以后的课充满向往！
59283,3735,尤云弟,2017-09-20 12:29:34,1,2,1,上课非常有意思
59800,3735,尤云弟,2017-09-27 05:21:10,4,4,0,老师生病了 怎么了？心痛
60008,3735,尤云弟,2017-10-02 14:23:14,2,3,1,挺好的吧
60336,3735,尤云弟,2017-10-17 23:54:09,-31,7,38,上课作业巨多，顶我上去让大家看见
60602,3735,尤云弟,2017-10-25 04:53:18,0,2,2,好棒的
60615,3735,尤云弟,2017-10-25 09:15:01,4,6,2,楼上说上课作业多的那一个，什么心态？纲要每门课都有固定作业的，尤老师相比其它已经少很多了好吗？
60706,3735,尤云弟,2017-10-27 09:28:42,7,7,0,喜欢，老师很幽默，课上的很好，作业压力也不大，敲喜欢 (๑ºั╰╯ºั๑)
61380,3735,尤云弟,2017-11-15 20:02:10,-13,4,17,不点名什么的确实蛮好的，感觉作业说着不多，但是还是很多啊立方书什么乱七八糟的，可能真的是身体不好，但是讲了一会就说讲不动了，上课上着蹦出来民国八卦，我其实不是很喜欢这种上课方式。总之当时抱着极大的热情选了她，但现实跟我所期望的有一点不一样。
62029,3735,尤云弟,2017-11-22 08:04:13,5,5,0,真的好老师，虽然由于身体原因可始终上不全，但讲课非常认真，而且作业超少！！
64012,3735,尤云弟,2017-12-20 13:48:38,1,2,1,可以，强推
64429,3735,尤云弟,2017-12-23 12:55:38,5,6,1,棒棒哒\n\n
65107,3735,尤云弟,2018-01-12 01:50:39,18,19,1,尤老师怀孕了！！！真心祝愿老师阖家欢乐٩(๑^o^๑)۶
65511,3735,尤云弟,2018-01-05 02:06:45,9,10,1,老师特别好。身为组长连续四周准备三次展示的确有点累，但是很开心。老师特别温柔，特别在乎师生情。老师真的老好了٩(•̤̀ᵕ•̤́๑)ᵒᵏ。
65522,3735,尤云弟,2018-01-05 03:59:50,10,11,1,能预置尤老师的史纲课真的太棒了！老师上课干货不少，而且经常会放一些珍贵的视频图片。不过老师要注意保重身体啊！
67492,3735,尤云弟,2018-01-21 10:42:52,5,6,1,超级棒！
67901,3735,尤云弟,2018-01-22 09:20:56,10,11,1,果断10分 老师注意身体 养个宝宝不容易哇
69315,3735,尤云弟,2018-01-24 12:45:32,-4,7,11,正态都是整组整组给的，你就是再努力，不在一个好一点的小组里？对不起，3.3
72161,3735,尤云弟,2018-01-29 13:35:16,7,8,1,老师真的是特别特别好的那种，选到老师的课简直是我大一上最幸运的事，事并不多，给分超级好。老师的身体不太好，听说下个学期不开课了，希望以后还能选到老师的同学一定要好好珍惜老师呀～(^з^)-♡
72162,3735,尤云弟,2018-01-29 13:40:01,9,9,0,太棒了
72165,3735,尤云弟,2018-01-29 13:45:04,-3,2,5,被正态了。。。
72169,3735,尤云弟,2018-01-29 13:46:41,10,10,0,老师超萌，给分超好，会给我们讲有趣的民国轶事，感谢老师的满绩！
72170,3735,尤云弟,2018-01-29 13:46:55,7,9,2,老师真的好哭了！\n\n水了一学期\n\n小组也很水，考试前连书都没看\n\n然后就轻松4.2了！\n\n谢老师！！！
72172,3735,尤云弟,2018-01-29 13:48:34,12,12,0,老师很好，在四大家族方面很有研究，为人也很真诚！
72183,3735,尤云弟,2018-01-29 14:00:28,5,7,2,很好很好。
72185,3735,尤云弟,2018-01-29 14:04:47,22,23,1,尤老师是我目前遇到的最令我感动的老师。本来老师的身体就有点不好，还能坚持来给我们上课，上课却一点也不沉闷。今天成绩刚出，本来老是跟我们说争取在30号出成绩，现在提前了1天，感动。所以说选到尤老师（不是王雪楠）的课的同学，不要因为尤老师给分好就来水水过，听听尤老师的课，很有趣，也能增长你的见识，最重要的是，这样才是对尤老师最好的回报，谢谢尤老师o(^o^)o
72203,3735,尤云弟,2018-01-29 14:29:03,3,6,3,很亲民的老师！\n\n
72207,3735,尤云弟,2018-01-29 14:33:24,-36,5,41,经常请假，学不到东西，给分有好有烂，我就是被正太分布了，狗比老师
72210,3735,尤云弟,2018-01-29 14:36:57,13,15,2,水了一学期4.5……除了期末考写断手之外，全靠师生情了……
72346,3735,尤云弟,2018-01-30 02:37:44,10,13,3,绩点给了4.8，除了期末考真的写到手残，另外的作业内容其实比别的史纲老师要少些，上课也非常可爱
72547,3735,尤云弟,2018-01-30 10:45:50,13,15,2,给分真的挺高的感天动地hhh上课很有趣，经常在群里和我们怼表情包，除了连续三节展示课有点累，没什么事，论文还规定字数上限超过扣分(￣▽￣)\n\n关键是！没有互评！没有恶竞！付出努力会有回报，真的很棒♪( ´▽｀)\n\n希望老师身体健康早日康复
73802,3735,尤云弟,2018-02-03 06:18:38,6,10,4,不知道那些没打10分的是怎么想的
73947,3735,尤云弟,2018-02-03 17:40:07,7,7,0,我爱老师！
74003,3735,尤云弟,2018-02-04 04:50:46,2,5,3,老师挺好的，每次都让我停下写作业好好听课。
74607,3735,尤云弟,2018-03-04 14:39:00,8,9,1,老师超赞
74910,3735,尤云弟,2018-03-06 10:56:21,6,7,1,好老师，
77238,3735,尤云弟,2018-05-04 05:33:19,9,11,2,尤老师复旦博士，耶鲁留学，很钦佩她的学习经历和研究领域，很有意思的。经常给我们看最新研究成果和档案资料视频等。尤老师打分也不错哈哈，事情多但是一分付出一分收获?绝对优秀的大学老师！
78868,3735,尤云弟,2018-05-16 03:18:59,8,9,1,课讲得好，给分也很不错
83184,3735,尤云弟,2018-07-10 01:33:59,4,8,4,尤老师很好，对学生负责体贴，上课幽默，知识丰富，有各种有趣的资料，还给我们讲各种新知识，上课任务都很公正，比其他老师少，打分不错！棒棒哒！听说生宝宝了，不知道啥时候再开课。满分！
86509,3735,尤云弟,2018-09-17 02:58:44,3,4,1,尤老师讲课超有趣滴
86539,3735,尤云弟,2018-09-17 05:46:50,6,6,0,特别棒，有趣，老师人很好
86645,3735,尤云弟,2018-09-17 23:47:01,-1,2,3,水水的，很可亲
86692,3735,尤云弟,2018-09-18 04:06:16,6,9,3,上完第一节，反手就是个十分，不解释。
86706,3735,尤云弟,2018-09-18 05:36:35,3,4,1,老师超级好
86846,3735,尤云弟,2018-09-19 04:54:20,2,4,2,老师上课很有趣，不时分享历史故事，很棒的老师
87069,3735,尤云弟,2018-09-20 06:38:13,7,8,1,“点名就像用身体留住男人的女人”
87295,3735,尤云弟,2018-09-26 22:34:56,4,4,0,老师很棒，在讲上课内容的同时，串讲了很多不为人知的故事，很喜欢尤老师的史纲课。特别喜欢尤老师平易近人，脾气好，又可爱幽默
87694,3735,尤云弟,2018-10-10 06:29:43,1,3,2,接地气
88091,3735,尤云弟,2018-10-22 05:39:14,4,6,2,老师太可爱啦！！！！表白老师！！！
88244,3735,尤云弟,2018-10-25 00:48:12,4,4,0,不想睡
91683,3735,尤云弟,2018-12-18 01:51:47,2,3,1,尤老师超好！！！|ω・）
91984,3735,尤云弟,2018-12-25 07:29:14,0,2,2,很棒啊，我本来不打算听的都被吸引了
92730,3735,尤云弟,2019-01-04 04:20:34,3,5,2,尤老师很棒！上课有趣，能讲历史故事，又能上出思政味道。通俗易懂，也很有想法。复旦毕业留学耶鲁，有很多知识。很体谅学生，平时任务完成，很重要，但是没有恶竞噢哈哈哈哈
93177,3735,尤云弟,2019-01-08 03:38:02,8,10,2,超级好的老师！我很幸运的没有选到假课，一个学期的史纲课，除了一次因为生病让其他老师代课，都是尤老师上的，真的特别有意思。讲课很生动而且会很尊重史实，很客观。超级爱，她让写论文会设置上限阻止恶竞！！！而且会让我们以身体为重！！！三次活动课看起来繁杂但是做好了很有意义，而且展示课展示时间很灵活。还没考试不知道绩点，不过老师的意思大概也不会太为难大家的?
93727,3735,尤云弟,2019-01-12 12:22:09,1,3,2,666
96098,3735,尤云弟,2019-01-20 12:48:11,-2,0,2,好好好
96140,3735,尤云弟,2019-01-20 13:23:22,2,3,1,提前打满，考试祈福
96747,3735,尤云弟,2019-01-21 09:53:46,5,5,0,尤老师的课很有意思的，听下去没有历史的那种枯燥。会举一些历史人物(尤其是蒋介石)的八卦，听一个个小故事，从中学到一些内容，恐怕是一生受益的。最让人难忘的一点是尤老师在这学期去做了一次手术，修养期间仍然不断关注我们的活动课情况。优秀又负责任的老师。
97246,3735,尤云弟,2019-01-22 07:20:49,-7,6,13,老师挺好 但给分不好
97248,3735,尤云弟,2019-01-22 07:22:51,5,6,1,老师超级好，上课很有趣，给分也超好的。根本不像我的思修老师。唉已经不想吐槽了。
97273,3735,尤云弟,2019-01-22 07:39:25,1,3,2,给老师10分 课程5分 出期末卷的评不了 已经死了 呵呵
97297,3735,尤云弟,2019-01-22 07:55:49,2,4,2,老师很好很温柔。一学期主要是要做好三次活动课和一个论文一篇读后感。可能组长会比较累一点，组员大部分还是挺轻松。给分还行吧，毕竟是有正态的通识课，老师也很难打分的，大家也就不要吐槽啦，要骂就去吴朝晖林建华SB那儿吧?
97325,3735,尤云弟,2019-01-22 08:09:24,-1,0,1,美好\n\n感动
97329,3735,尤云弟,2019-01-22 08:10:36,7,7,0,听尤老师上课让人感觉很轻松。一共有三次展示课，我作为小组长还是比较累的。但是老师留的小论文和读书报告作业相较其他班来说轻松很多了。别的班论文都要五，六千字以上，尤老师是两千字以下！！！从根源上杜绝恶竞！！！老师很体谅学生，告诉我们一切以身体为重。期末给分也不错，想尽办法提高我们的绩点。
97382,3735,尤云弟,2019-01-22 08:28:31,3,3,0,老师太好看了！！
97386,3735,尤云弟,2019-01-22 08:29:57,5,6,1,实在友好，有很多老师从美国获取的一手史料，给分超棒，我一个历史超差的工科生也能考4.5
97391,3735,尤云弟,2019-01-22 08:32:55,0,2,2,老师讲的课真的好! 人也特别好! 给分也很棒! 爱死老师了!
97396,3735,尤云弟,2019-01-22 08:37:14,1,2,1,超级棒的老师！！！上课有趣收获大给分也好，强推！！！
97398,3735,尤云弟,2019-01-22 10:06:08,9,9,0,百分百好老师，知道大家对这门课的态度，所以对大家要求不高。当了组长，92分压线4.8还是挺满意的，期末考前补天复习了一个小时，答卷全部写满?性价比很高啊！而且老师特别可爱，会发表情包；出院以后马上回来上课了，敬业！讲课有趣，虽然期中考后学业压力真的太重我就没好好听了dbq我喜欢抑制恶竞的好老师！
97400,3735,尤云弟,2019-01-22 08:38:11,2,3,1,老师真的太可爱了，期末看我们惨不惹睹的卷子绞尽脑汁想着怎么把我们从启真湖底捞出来。上课绝对不会想睡觉，听听民国时期的小故事。期末到了，我就记住了小故事?
97405,3735,尤云弟,2019-01-22 08:40:12,1,1,0,老师人真的是超级好，上课偶尔穿插的历史趣味小知识很吸引人，最重要的是事情少啊，给分还超级好，从内心感谢老师啊??！
97415,3735,尤云弟,2019-01-22 08:45:15,3,3,0,太棒了，上课十分有意思，还木有期中考试，平时事也超少，问问题会耐心和你讨论清楚，还会有很多棒棒的史实，强推\n\n(PS:绩点也是超赞呢，相当抚慰被数学伤害的小心脏)
97422,3735,尤云弟,2019-01-22 08:49:01,-1,1,2,老师真的超级超级好 事情算是比较少了吧给分也超级好 写论文和读书感想都有字数限制 拒绝鹅颈 还会在群里发表情包 今年老师做了一场手术 修养了一个月就来上课 看卷子也是非常快 一天就出分了 不过被卡绩了还是有点点难受 但是老师真的很好了
97425,3735,尤云弟,2019-01-22 08:50:58,2,2,0,呜呜呜！我爱云弟姐姐！\n\n其实感觉自己的小论文和读书报告也没有特别认真写 期末成绩超出想象！\n\n爱她！！！
97429,3735,尤云弟,2019-01-22 08:52:41,3,4,1,真心的好老师，上课有趣，讲得好，经常放一些特别有趣的视频。关键是给分超好，我期末字写得特别丑，她还给了我91分。
97434,3735,尤云弟,2019-01-22 08:57:05,0,1,1,没说。绝对好老师???
97447,3735,尤云弟,2019-01-22 09:04:00,8,9,1,尤老师真的是太好了，天使姐姐啊呜呜呜。这个学期老师恰好老师生孩子手术了，身体不好，不得不请别人帮忙代了两节课，但是出院后就马上来给我们上课了，超感动的！平时上课也很有趣的，事情不多，两篇论文，不许鹅颈，分组展示用心点花时间也不多。尤其是期末给分超棒的！！！拯救了我被大英拖垮的均绩！！吹爆尤老师！！！让我又有了不退院的希望！
97454,3735,尤云弟,2019-01-22 09:07:28,0,5,5,唉，我本以为上尤老师的课绩点会很高的。唉！勉强过三.
97459,3735,尤云弟,2019-01-22 09:11:01,1,3,2,老师真的特别认真
97460,3735,尤云弟,2019-01-22 09:11:00,4,4,0,老师真的特别认真
97467,3735,尤云弟,2019-01-22 09:11:50,2,3,1,给分好  人也很温柔
97476,3735,尤云弟,2019-01-22 09:16:01,0,2,2,老师超好 给分也好 老师我爱你
97477,3735,尤云弟,2019-01-22 09:16:52,0,2,2,下辈子娶你！太好了！
97480,3735,尤云弟,2019-01-22 09:17:38,3,4,1,我永远喜欢尤老师!
97490,3735,尤云弟,2019-01-22 09:20:35,1,3,2,好老师，10分我觉得少了
97491,3735,尤云弟,2019-01-22 09:22:26,2,3,1,超级棒的历史老师，历史观很正很乐观。渊博温柔，课堂非常精彩。听老师的课能开拓视野，学到很多知识增长见识。真的感谢老师让我一个理科生重燃对历史的爱～老师给分也很好，反对恶竞，论文都有字数限制，希望我们能写出有价值又简练的论文。结束的时候非常舍不得老师，强烈安利了
97494,3735,尤云弟,2019-01-22 09:23:41,2,2,0,尤老师上课讲得很细致\n\n活动课比别的老师多一点\n\n论文和读书感想字数要求都不高\n\n期末还熬夜把我们的分数捞起来 \n\n感谢尤老师T^T
97501,3735,尤云弟,2019-01-22 09:52:54,1,3,2,吹爆尤老师！！！\n\n贼萌贼可爱，三次展示课虽然有点忙，但是给分特别好！！\n\n期末考试真的不要愁，我是之前完全没翻过书，考试前一天翻了一半不到，考试的时候不管对错抄的满满的，比预想地好多啦！
97503,3735,尤云弟,2019-01-22 09:32:58,4,4,0,老师讲课特别好特别生动会讲一些故事什么的。。。论文规定字数上限期末熬夜给我们捞分。。。真的是好老师！！！
97510,3735,尤云弟,2019-01-22 09:37:08,3,4,1,绝对的好老师 感谢预选到你的课!
97515,3735,尤云弟,2019-01-22 09:44:08,1,3,2,老师上课非常生动有趣，分享了许多百度不到的资料，打分也很高 ：）
97521,3735,尤云弟,2019-01-22 09:51:13,4,4,0,尤老师本身学识非常渊博，讲课备课也十分认真，但同时，也非常能理解我们大多数学生对这门课的认识…给分超好，人也nice！
97522,3735,尤云弟,2019-01-22 09:51:40,2,3,1,超赞的老师o(^o^)o说话很可爱
97549,3735,尤云弟,2019-01-22 10:31:10,6,7,1,尤老师真的是很棒的老师和历史学者！对待史料的态度超认真，讲课很有趣，不是很红专的那种。三次展示课挺有趣的，进行的比较早，也没觉得事情很多，给分是真的很好！
97562,3735,尤云弟,2019-01-22 10:48:47,3,4,1,有节课老师讲到宋指纹我想半天不知道zhiwen怎么写，后来听到救蒋介石才知道是宋子文（zi文）
97566,3735,尤云弟,2019-01-22 10:55:33,3,5,2,为尤老师疯狂打电话啊！！！老师真的太好了！讲课很有趣，真的能学到很多东西！真的是我从初中以来听过的最有趣的历史课！老师给分也超级赞的，特别感谢老师给了我的最高绩点?帮我这个cj提了好多均绩，超级感谢您?！！现在是9.95，冲鸭刷到满分！！
97572,3735,尤云弟,2019-01-22 11:07:27,4,5,1,老师很棒，对同学的态度很好，大赞！
97627,3735,尤云弟,2019-01-22 12:20:29,5,7,2,上课讲得贼好笑
97650,3735,尤云弟,2019-01-22 12:42:16,6,7,1,老师讲课很有深度 也很有意思 是非常推荐的老师 也建议同学提高自身知识水平 期末还是有些人绩点只有3.5的。。毕竟是正态课
97728,3735,尤云弟,2019-01-22 14:16:33,11,11,0,老师上课真的很努力，很有趣，很有心，也很轻松。同学们普遍对史纲不太重视，都在写微积分什么的，老师也不怪我们，很多时候还会留出最后20分钟给我们自习，甚至还会提早一点点下课，防止骑车的同学堵在车库那里。课程内容很多样，只要认真学，就很锻炼人的学习能力和合作能力。而且，真的不恶竞！别的老师规定论文最低字数，而且不写个两倍啥的还会酌情扣分［你懂的］，尤老师规定最高字数，和别的老师最低字数一样>_<就是希望老师千万爱惜身体，千万别再生病了。
97949,3735,尤云弟,2019-01-23 02:35:30,4,7,3,让我回答听老师课是什么体验，可是已经好久没听课了，对老师印象不是特别深啦，但是肯定是个好老师，萌萌哒，挺搞笑的。给分也很好，自己4.2，但是身边很多上4.5的，希望老师一生都健康快乐呀
98320,3735,尤云弟,2019-01-23 10:12:41,5,6,1,很棒！尤老师很亲切善良给分好，上课风趣，而且她有很多有趣的个人经历和阅历，有干货也有快落！
98676,3735,尤云弟,2019-01-23 18:12:20,1,3,2,非常有趣。
102194,3735,尤云弟,2019-01-31 09:21:13,5,6,1,太舒服了，给分也超好，认真完成三次展示，老师不会亏待你的
102257,3735,尤云弟,2019-01-31 15:29:07,2,5,3,老师上课有趣耶，各种民国的事件很懂，还经常讲蒋的故事。给分也不错
103040,3735,尤云弟,2019-02-25 14:38:54,6,6,0,老师超可爱，人也好，期末考考砸了全靠老师救的我
103551,3735,尤云弟,2019-03-01 03:29:16,3,5,2,爱上老师了^_^
103722,3735,尤云弟,2019-03-04 15:07:49,4,5,1,观感极佳
104700,3735,尤云弟,2019-03-26 06:38:06,7,7,0,上课特别有意思，没来是一种损失。
107171,3735,尤云弟,2019-05-02 04:49:11,-7,3,10,老师很好。很有趣又知识点很多。但是现在的史纲课也太花里胡哨了吧。为什么有那么多的活动课和小组展示?给我们想好好背史纲的同学留点活路吧
108540,3735,尤云弟,2019-06-27 16:20:15,5,6,1,爱老师！！
108844,3735,尤云弟,2019-06-03 06:50:25,6,7,1,尤老师有一份历史学者的豁达和从容。思政课都会有些条条框框，但是史纲课依然有趣，尤老师我挺你！
109544,3735,尤云弟,2019-11-11 10:10:44,4,6,2,一学期结束了，尤老师的上课内容很丰富，档案很多，有时候边讲故事边自己笑。很多不为人知的故事，脾气也很好，尊重学生爱学生，尤老师带宝宝很累但是总是半夜回复邮件，佩服她！
109936,3735,尤云弟,2019-06-20 10:20:46,9,11,2,你要把尤老师上的当做思政课的话可以给10分 ，当做历史课的话只能给8分。\n\n上完这门课希望你也能开始“怎么回事妮……”
109964,3735,尤云弟,2019-06-20 14:29:03,7,8,1,绝世好老师
110699,3735,尤云弟,2019-06-28 04:51:42,2,4,2,疯狂给尤老师打call，虽然一学期我只去过三节课
111740,3735,尤云弟,2019-07-02 17:19:25,8,8,0,非常非常好的老师！
111745,3735,尤云弟,2019-07-02 17:35:22,4,7,3,半夜出成绩了\n\n过来评个分\n\n老师真是太好了！！\n\n有的时候大半夜还在群里回消息\n\n捞我们捞到一点多\n\n老师真的超可爱
111749,3735,尤云弟,2019-07-02 18:10:59,5,8,3,被卡绩了呜呜呜。不过绩点也有4.5已经很满足了。老师真的很好，半夜捞我们。
111753,3735,尤云弟,2019-07-02 18:18:05,6,7,1,尤老师太好了！事少给分高课也讲得好
111777,3735,尤云弟,2019-07-02 22:41:21,-11,5,16,认真做作业，认真小组展示，认真期末考，最后3.3，我服。
111802,3735,尤云弟,2019-07-02 23:36:51,3,4,1,谢谢老师，十分不是没有理由的.上课挺有意思的，虽然听不听都没关系，超级喜欢老师
111810,3735,尤云弟,2019-07-02 23:50:19,5,7,2,尤老师巨可爱！！！捞人高手！！！
111865,3735,尤云弟,2019-07-03 01:33:10,-6,4,10,被正态了，没什么好说的
111868,3735,尤云弟,2019-07-03 01:38:03,3,5,2,感谢尤老师救我!!!
111909,3735,尤云弟,2019-07-03 02:31:45,2,5,3,老师人很有趣！！！在尽力把史纲这个没啥意思的课上的有意思\n\n会提前告诉下节课要点名\n\n给分也好！！！我展示课和讨论课小组评分都中不溜秋期末考稀里糊涂抄书最后4.5了 爱老师！！
111910,3735,尤云弟,2019-07-03 02:32:50,4,4,0,我爱老师!啊啊啊啊啊啊女神!
112032,3735,尤云弟,2019-07-03 08:36:35,7,8,1,历史学者。虽然年轻但是有学者风范。
112137,3735,尤云弟,2019-07-03 17:23:39,5,6,1,老师是个很温柔的人，上课尽量会上得有趣，对学生也都很好。最后感谢老师捞我呜呜呜
112418,3735,尤云弟,2019-07-04 05:17:25,6,7,1,尤老师很喜欢讲一些四大家族，蒋家王朝，感觉听她的课会很有意思，而且老师给分超好，大赞
113102,3735,尤云弟,2019-07-05 23:26:31,7,7,0,云弟总冠军！
113144,3735,尤云弟,2019-07-06 00:18:40,3,4,1,老师把史纲课上成了故事课，一个理科生也听的津津有味
113370,3735,尤云弟,2019-07-06 10:55:20,5,6,1,作为前排学生感觉是一种享受 虽然最后卡绩了orz
114815,3735,尤云弟,2019-07-12 00:25:14,0,3,3,我不明白我为什么分这么低…比论文直接拿别人的同学都低…就酱哇…心累了…
115599,3735,尤云弟,2019-08-07 08:58:48,3,4,1,尤老师很年轻，上课很有趣，档案资料很多，说话很有艺术感。会给我们讲教学内容还要做人道理，很佩服她求学经历，为自己的人生理想，一直探索追求。感觉老师做事做人品格坚韧不拔吃苦耐劳那种，值得学习，
116251,3735,尤云弟,2019-09-06 15:21:18,-13,5,18,不明白咋这么高
116487,3735,尤云弟,2019-09-11 02:08:57,4,4,0,真滴好(✪▽✪)
116581,3735,尤云弟,2019-09-12 01:25:09,1,3,2,好得不谈了
116857,3735,尤云弟,2019-09-17 00:48:01,2,2,0,在快乐中获得知识，脾气很好
117097,3735,尤云弟,2019-09-19 06:53:49,6,6,0,超级开心，唯一一节讲历史但是我不困的课。能想象一个听计算机史，化学史都困的人，正经听历史课活力满满吗？？！
117685,3735,尤云弟,2019-09-29 02:13:26,-1,2,3,牛逼。
118402,3735,尤云弟,2019-11-07 03:40:45,2,4,2,超棒，是个好老师，上课有趣，人也很好，很有知识
119087,3735,尤云弟,2019-11-10 07:43:34,1,3,2,尤老师的上课内容档案很多，会讲讲故事脾气很好。尊重学生爱护学生，尤老师带宝宝很累，工作很拼，总是半夜回复邮件，回复qq，佩服尤老师！加油！
120817,3735,尤云弟,2020-01-17 13:17:54,-2,0,2,好老师，绝对的好老师
121047,3735,尤云弟,2020-01-19 10:21:20,1,1,0,老师讲课很有意思！
121817,3735,尤云弟,2020-01-22 06:11:44,2,3,1,挺好的\n\n挺有人文关怀的\n\n讲课不错\n\n给分也好，老师会尽力捞人，但学校要求正态分布老师也没办法，只能说尽力了。还是自己努力吧，比别人做得好一点，分数不会低。\n\n能选到挺幸运的，别总是上课水手机，往前排坐一坐。
122400,3735,尤云弟,2020-02-26 06:50:31,0,1,1,做了尤老师的课代表，但是任务不重。老师讲课十分有趣。有满满的干货，老师还会分享许多她学习研究过程中经历和资料，还能看到各种绝密有趣视频。给分也不错呢。大爱老师！
122436,3735,尤云弟,2020-02-27 12:00:39,3,3,0,给尤老师打call
122442,3735,尤云弟,2020-02-27 13:30:58,4,5,1,老师讲话好可爱，学富五车嘴却有点笨，上了一堂课就喜欢上这位老师啦，感觉她是那种非常接地气地追求理想并且非常成功的人。
122511,3735,尤云弟,2020-03-02 14:33:39,2,6,4,非常优秀的老师。第一节课自我介绍就被老师不想卖萌却处处卖萌、对学术严谨认真的态度给吸引了(我是补选进去的学生，尤老师签条子很好说话的)。上课内容丰富，绝对不是照本宣科，而是真正结合了自己的研究方向，为我们普及一些历史。还会推荐很多书籍。总之赶紧选尤老师吧~
123178,3735,尤云弟,2020-05-16 12:20:27,3,5,2,不知道她为什么要把所有回放都删了~
123326,3735,尤云弟,2020-06-03 08:13:45,1,3,2,我真服了 为什么喜欢删一些资料文件 连自己的序号都没地方看了
124073,3735,尤云弟,2020-06-23 08:19:00,6,6,0,今天考史纲，过来打个10分，对不起老师，这学期的课我全水过去了，没能认真享受你的课
124087,3735,尤云弟,2020-06-23 12:58:34,8,8,0,尤老师上课有好多材料，上课好有趣，人很温柔！！！
124323,3735,尤云弟,2020-06-29 07:55:04,7,10,3,不知道评分标准是什么样的 明明很水的人拿了很高的分 自己卡绩了觉得很不爽 只能说没有评论这么好吧
124326,3735,尤云弟,2020-06-29 08:03:20,3,5,2,老师太好了
124329,3735,尤云弟,2020-06-29 08:58:00,10,10,0,我不知道其他同学怎么样，但我得到的分数和我努力的程度是一致的，非常满意！而且从我的小组看，分数分配的时候大家打分基本上是和你的认真程度成正比的，有所努力，有所学得，有所成果，是我心中最满意的课程模式\n\n还有，吹爆尤云弟老师，历史出身，上课会分享很多有趣的历史知识（尤其是民国时期的历史人物），认真听课真的收获好多，不会感到红专。还有老师超级可爱，上网课会委委屈屈地问哎呀你们怎么都没个反应，就她一个在讲很孤单，口头禅是说话尾巴会带个nie，从发音可以看出是个纯正的平翘不分的浙江人。\n\n上课事情感觉也不多，怎么说呢，因为上课不是有些老师非常红专的那种嘛，大家在展示的时候也会尝试一些有趣的题材，选择余地比较大（不存在红专题材就易得高分），讲的好老师也是很支持的，所以做起来没有被强迫的余地，做的心情愉悦了，就感觉工作没有多少
124342,3735,尤云弟,2020-07-01 07:06:02,2,5,3,老师很好，讲课也有趣，就是小组互评无规则无标准，很无语的规则，并不是会按照付出评分。祝大家都遇到好的组员和组长。
124359,3735,尤云弟,2020-06-29 15:23:16,5,6,1,关于小组作业的分数分配方式真的很好，最后你的成绩和你在组内的贡献度成正比，减少了部分人划水的可能，有多少付出就有多少回报。最终出的成绩也符合自己的预期，尤老师论文设了上限，杜绝鹅颈真的赞。最后还有一点非常感人，钉钉私聊她都回复的挺及时的，而且有时候还会跟你聊起来hhhhhh对比有些老师已读不回……为尤老师打call！！选她！！
124366,3735,尤云弟,2020-06-29 17:38:50,0,3,3,千言万语一句牛逼
124418,3735,尤云弟,2020-06-30 14:59:37,0,3,3,超好的老师
124507,3735,尤云弟,2020-07-02 07:23:17,3,7,4,尤老师上课内容丰富，档案资料多，很有趣，还有一些不为人知的故事。她讲究说开心读书，快乐学习，学会历史思维作人生决定！很喜欢老师的课，上课也有水平，听说获过省里大奖。老师打分也很好，任务不多，不希望我们鹅颈，一篇个人小论文是有字数的上限要求。付出回报成正比，组内互评有规则。很喜欢尤老师，选她的课没错的！棒棒哒！也祝福尤老师天天开心！
126067,3735,尤云弟,2020-09-17 04:32:52,1,3,2,开学第一次课，可爱爆了！真是好老师！
126820,3735,尤云弟,2020-10-21 11:54:31,-17,9,26,事情是真的多，对于理工科的人来说难道老师心里没点数这是个水课吗？课上的很好，平时分让同学给，很公平，但事是真的多啊，是需要你压缩别的课的时间来搞
127253,3735,尤云弟,2020-11-17 08:48:29,4,5,1,这能不给十分？
128818,3735,尤云弟,2020-12-25 14:54:40,1,3,2,尤老师的课太好了！非常有意思！
129189,3735,尤云弟,2021-01-06 02:08:10,4,5,1,幽默风趣有智慧，上课有各种档案资料，不枯燥高大上，爱了爱了，能感受她对史纲的热爱，对教学科研热爱，而且上课轻松有趣，不会动不动叫你回答问题，也不会鹅颈，让你享受上课学习，十分，十分!
129291,3735,尤云弟,2021-01-03 15:26:39,2,4,2,尤老师简直太棒了，博学又有趣，不会干念课本，全都是讲有意思的历史故事，还会结合很多自己游学搜集的史料，更会教导我们不要恶竞，身体为重，太爱她了
130003,3735,尤云弟,2021-01-27 10:02:19,4,9,5,上课极其有趣，档案资料很多，幽默风趣，能感觉到老师在用心熏陶我们要好好学习，报效国家。思政课能上成这样，绝了，不愧是获过教学奖的老师！任务是小组和一篇论文和网上讨论题。跟着老师的节奏，一步步完成就好了，不会鹅颈。绩点4.5.我超级满足了！推荐推荐yydyyds
130606,3735,尤云弟,2021-01-24 02:24:11,1,3,2,好老师，真正的从历史角度讲历史，不恶竞。
130616,3735,尤云弟,2021-01-24 03:18:11,-1,1,2,老师超级好，上课不会觉得枯燥，很喜欢分享小故事
130621,3735,尤云弟,2021-01-24 03:47:02,2,3,1,尤老师超级好，刚出分来评价一下。上课有意思，写论文有字数限制，不鼓励恶竞。点名的时间她也会提前告诉大家的。
130626,3735,尤云弟,2021-01-24 04:31:35,-1,2,3,能感受到老师在疯狂捞我，老师学历很高复旦毕业去美国留学。做学问很认真，讲课也很有意思，会讲一些有趣的历史，放一些视频，给分很好。最让人印象深刻的是老师的温州口音，给10分毫不为过
130633,3735,尤云弟,2021-01-24 04:54:54,21,24,3,yyds大概就是尤云弟神的意思吧？
130643,3735,尤云弟,2021-01-24 05:21:01,2,4,2,宝藏 宝藏 宝藏！\n\n还是老乡！\n\n绝对的真正的\n\n绝无仅有的\n\n宝藏老师！
130683,3735,尤云弟,2021-01-24 07:35:17,0,2,2,尤老师真的真的非常好：\n\n1.讲课有知识性有趣味性。\n\n2.作业布置非常合理。\n\n3.老师性格好，将心比心的典范。\n\n4.老师人格魅力很强，能够很自然地勉励人多多读书的感觉。
130707,3735,尤云弟,2021-01-24 10:20:14,-1,0,1,老师真的超级好，两次点名，讲得也超棒，不鼓励恶竞，给分好。yyd  yyds!!!
130817,3735,尤云弟,2021-01-24 17:28:55,-1,1,2,yyds
130918,3735,尤云弟,2021-01-25 08:43:39,0,2,2,吹爆老师！
130919,3735,尤云弟,2021-01-25 08:44:22,5,8,3,老师是好老师，为啥我所有的东西都认真做了，绩点只有3.3。。。唉可能是我太菜了吧
130994,3735,尤云弟,2021-01-25 13:28:15,5,6,1,yydsyyds（尤云弟是永远滴神）\n\n老师的课堂超级有趣，民国时候四大家族的八卦故事信手拈来，幽默风趣，干货很多，课上可听可水，还会留时间给大家做其它科的作业。考前就叫大家别刷题，说自己一定会尽力捞的，最后做到了，认识的同学分都很好，本人4.8芜湖，虽然有点遗憾上课摸鱼太多错过了很多干货。（特别表扬：老师的作业从来都是限制字数上限，且反对恶竞，用点心没问题的）
131371,3735,尤云弟,2021-01-27 08:45:43,3,3,0,老师超好
132470,3735,尤云弟,2021-02-01 22:35:32,-2,8,10,老师上课比较轻松，就是缺乏深度
132835,3735,尤云弟,2021-02-04 04:48:20,0,2,2,不允许有人不认识我们仙女尤老师，太好啦啦啦啦啦啦啦啦啦啦啦啦啦
132931,3735,尤云弟,2021-02-05 06:08:20,3,4,1,尤老师，上课很有思想的，也很有趣，收获大，她主要通过档案史料不为人知的，给我们展示历史，经常让我们好好思考，历史的前后左右，这是为什么捏？老师是个对国家有情怀的人。任务是小组作业，一篇个人论文和网上讨论题。绝对不鹅颈，作业限制最高字数。yydyyds！推荐！！据别的同学说，她教学获过省奖的！
133031,3735,尤云弟,2021-02-06 16:26:33,0,2,2,人美心善给分高
133362,3735,尤云弟,2021-02-26 10:09:20,1,2,1,老师真的教的非常好，上课也很有趣，给分很好
133509,3735,尤云弟,2021-03-01 11:05:56,-4,3,7,来人，我来吹爆（真实原因是拿了4.8咳咳咳）\n\n老师上课很有意思，但是讲的内容其实基本上是书本的延申，段子很多，可能就跟有个评论说的一样，深度不够，但是广度还是够的。\n\n个人很欣赏老师的考核方式，加入小组课本剧的创新玩法，而且基本上不搞什么阶级评分什么的，史纲还是课后作业比较好玩的，除了……头秃的小论文。\n\n老师对课堂表现，听课认真程度比较关注的，点到为止，我觉得以我的能力应该拿不到那么高的分。\n\n就这样吧，比起其他老师，我更推荐这个老师，毕竟她的课有意思，比你其他老师水课有价值，对吧？
133559,3735,尤云弟,2021-03-02 06:17:14,1,2,1,老师讲得太好啦！\n\n基本不点名\n\n给分超级好！！
134662,3735,尤云弟,2021-04-08 02:15:11,-3,1,4,给分很好 会具体通知点名的时间 讲课很有意思！
134696,3735,尤云弟,2021-04-10 03:02:52,7,10,3,尤老师上课主要通过档案史料形象生动，给我们展示近代史，经常让我们好好思考，历史的前后左右，经常问我们，这是为什么捏？（她的特殊温州语气词）有趣又有思考深度！这学期还有思维导图训练思辨能力，很新潮，有收获，很超前！任务是小组活动，一篇个人论文和讨论题。绝不鹅颈噢，快乐学习，三观超正的！作业限制最高字数。yydyyds！看前面同学评论，我查到她教学获省奖的新闻了！
136919,3735,尤云弟,2021-06-28 07:54:02,1,2,1,yyd yyds！大家快选！！！
137444,3735,尤云弟,2021-07-04 07:54:52,2,5,3,老师太好了，给分也超级好
137453,3735,尤云弟,2021-07-04 08:30:32,4,6,2,尤老师真的真的太好了，事情少，史纲课好好听课的次数一半不到，看到成绩使我十分惭愧，德不配位。老师很可爱，讲课会穿插很多书本外的知识，点名会在群里提前说，但她的课真的值得好好听听，她的分数也会远超你的努力。yyd yyds！
137561,3735,尤云弟,2021-07-05 05:59:53,-2,3,5,虽然被卡绩了\n\n但yydyyds
137758,3735,尤云弟,2021-07-06 04:03:39,1,3,2,老师yyds！！！给分太tm好了
137763,3735,尤云弟,2021-07-06 04:30:47,-2,5,7,老师讲课很可爱，给分我也不知道怎么回事hhh，喜提3.3hhhh\n\n听说老师给分很好那我应该是本来快要不及格了吧hhhh\n\n谢谢老师啊hhhh
137770,3735,尤云弟,2021-07-06 05:16:25,0,3,3,尤老师爱了爱了 上课干货满满 脾气很好 很温柔 讲究在快乐中学习哈哈哈！一个理科生学到了不少党史知识，而且给分公正，我们任务是一个讨论题一个活动课一个参观感想一个小论文，平时要做学在浙大上课笔记和看mooc视频，看起来多，但是从不鹅颈哈哈哈，打分也不错👍
137835,3735,尤云弟,2021-07-06 09:15:32,2,5,3,尤老师真的很好！虽然我最后绩点不是很高，但应该是我卷面成绩不高的问题。对于一个思政课老师，做到这样真的很不容易。她极力反对内卷，论文严格上限，发言不要求（所以我们班平时没人发言xsl）选她不会后悔！
139444,3735,尤云弟,2021-07-15 15:55:58,2,4,2,尤老师真的超级超级棒！
139716,3735,尤云弟,2021-07-21 03:07:39,-1,3,4,尤云弟老师yyds!
140412,3735,尤云弟,2021-09-11 01:48:39,8,10,2,尤老师真的真的非常好：1.讲课有知识性有趣味性，内容深刻！！。2.作业布置非常合理。收获满满。3.老师性格好又温柔，师生之间又高风亮节。4.老师人格魅力很强，能够很自然地勉励人多多读书的感觉。
140596,3735,尤云弟,2021-09-14 05:47:34,0,2,2,太可爱了老师！！
140652,3735,尤云弟,2021-09-15 01:30:36,5,6,1,尤老师不爱点名，点名也是没办法。\n\n史纲课很有趣，课堂氛围很活泼。\n\n作业基本等于没有。
140654,3735,尤云弟,2021-09-15 01:49:05,0,1,1,yyds
140818,3735,尤云弟,2021-09-16 10:21:44,3,5,2,尤老师yyds，超级爱笑，只想让学生快乐！那还有这么好的老师
141013,3735,尤云弟,2021-09-21 12:19:29,1,4,3,给分并没有特别好吧
141415,3735,尤云弟,2021-10-08 00:16:19,-1,1,2,选这个老师结果别的老师上，无语
141576,3735,尤云弟,2021-10-15 05:10:33,3,4,1,尤老师真的真的非常好：1.讲课有知识性有趣味性，内容深刻！。2.作业布置非常合理。收获满满。3.老师性格好又温柔，师生之间又高风亮节。4.老师人格魅力很强，能够很自然地勉励人多多读书的感觉。
141791,3735,尤云弟,2021-10-26 03:26:23,1,4,3,yyds
142740,3735,尤云弟,2021-11-15 16:25:49,1,2,1,上的中特，不能带笔记去考，但考的都是书上直接有的。每节课会随机点一两个人回答问题，讲的不只是书上的内容，会联系生活实际讲小故事。作业只有心得体会，无字数要求。还有合上一门课的另外一个老师要求小组展示，整体作业量不大。总体给分较好，可选~
143017,3735,尤云弟,2021-11-18 08:22:42,3,4,1,满绩5.0
143923,3735,尤云弟,2021-12-13 06:06:52,4,7,3,考前让大家别刷题，还说会尽力捞大家让大家放心，好老师啊！ 还会留时间给大家做其它课的作业。（特别表扬：老师的作业从来都是限制字数上限，且反对恶竞）
143925,3735,尤云弟,2021-12-13 06:27:31,2,4,2,尤老师真的真的非常好：1.讲课有知识性有趣味性，沉迷档案史料不可自拔，内容深刻！。2.作业布置非常合理。收获满满。3.老师性格好又温柔，师生之间又高风亮节。4.老师人格魅力很强，能够很自然地勉励人多多读书的感觉。思政味道重！
144314,3735,尤云弟,2021-12-21 05:37:58,6,7,1,很温柔很可爱，而且遏制内卷
144727,3735,尤云弟,2021-12-23 10:51:33,8,8,0,尤云弟yyds！！！大爱尤老师！！！温柔有趣！！！把“呢”说成“捏”也太可爱了！！！
145572,3735,尤云弟,2021-12-30 09:43:01,6,7,1,尤老师上课主要通过大量档案史料形象生动，给我们展示近现代史！经常用别的班级老师没有的美国和台湾地区的史料激发我们好好思考，史纲的重要性和历史的前后左右，有趣又有思考深度！！还有小组活动课一篇个人论文和讨论题，比较遏制鹅颈的、讲究快乐学习。我那学期有思维导图训练思辨能力，很新潮，很超前！yyds！看前面同学评论，选课时候我也去查了，发现她教学比赛获了很多奖，有个浙江省特等奖的新闻！结果发现，她很谦逊很低调，都没提起，会跟我们说查档案的时候曾经抄断手！穷留学生吃赛百味一个星期拉肚子！听起来好惨，也是佩服她。
145576,3735,尤云弟,2021-12-30 09:57:17,5,5,0,尤老师上课干货满满，遏制鹅颈。那个uu说查档案的时候曾经抄断手！穷留学生吃赛百味一个星期拉肚子！我也记得，听起来好惨，感觉又很厉害，奋斗的痕迹……
145637,3735,尤云弟,2021-12-31 01:15:21,2,3,1,尤老师太好了！预置她的课真是走了大运！这样的老师不给10分实在说不过去嘻嘻嘻
145640,3735,尤云弟,2021-12-31 01:40:33,3,6,3,上课档案资料详实，很不一样的讲课方式，真真正正地想让我们从近代史中有所学。不愧是优秀历史学者。新年还发红包给我们，近现代史yydyyds！
146123,3735,尤云弟,2022-01-05 13:56:55,2,2,0,老师人很好QAQ
146362,3735,尤云弟,2022-01-06 10:20:04,4,5,1,老师上课会分享许多书中没有的史料和八卦。老师对华侨相关的历史有仔细详细的研究，据此对抗战史和民国史的补充让我们学习的历史更加丰满。老师也非常的可爱！据我所知，她是事实上的反卷斗士！
146363,3735,尤云弟,2022-01-06 10:22:27,3,3,0,老师真的太好了
146370,3735,尤云弟,2022-01-06 10:50:42,1,3,2,非常温柔可爱的老师，还会给我们发红包。第一门满绩就在这里收获的。尤老师yyds
146372,3735,尤云弟,2022-01-06 10:59:59,0,2,2,老师超好的，给分很好
146402,3735,尤云弟,2022-01-06 13:16:12,3,3,0,能上尤老师的课，三生有幸！
146403,3735,尤云弟,2022-01-06 13:19:55,-1,1,2,话不过说直接上10好吧，上尤老师的课简直就是上辈子修了八辈子福气。而且还是预置来的，运气太好了能碰到尤老师。
146421,3735,尤云弟,2022-01-06 14:34:14,4,5,1,老师上课很精彩，史料小故事都很好，不同于其他老师的枯燥课堂。但是由于学校规定老师真的没有很多能捞的余地，大家都要加油！（后半段针对纲要所有老师来说的）
146422,3735,尤云弟,2022-01-06 14:36:11,1,2,1,尤云弟yyds\n\n老师本人很励志平时也特好一人
146435,3735,尤云弟,2022-01-06 14:52:03,3,3,0,老师人很好
146454,3735,尤云弟,2022-01-06 15:04:01,1,1,0,老师太棒了啊，史纲是尤老师就放鞭炮庆祝吧。
146491,3735,尤云弟,2022-01-06 16:39:53,0,1,1,撞大运了！！！
146530,3735,尤云弟,2022-01-07 01:00:40,6,8,2,YYDS！尤云弟神！
146552,3735,尤云弟,2022-01-07 02:11:35,6,8,2,完美的老师！
146706,3735,尤云弟,2022-01-07 08:40:13,1,4,3,yyds!\n\n考不好是我的问题 尤老师真的很棒！我学到了更为丰满的历史
146745,3735,尤云弟,2022-01-07 10:03:55,5,7,2,老师人好，反内卷，上课也很有意思
146758,3735,尤云弟,2022-01-07 11:14:15,8,10,2,尤云弟老师讲课很幽默，还会讲很多的小故事，善解人意，对民国方面超级了解。十分都嫌少!
146988,3735,尤云弟,2022-01-08 10:03:22,4,8,4,可惜史纲只能学一次
148420,3735,尤云弟,2022-01-12 12:03:20,5,6,1,好的呢
150610,3735,尤云弟,2022-02-14 07:22:57,15,17,2,确实是这样。尤老师上课主要通过档案史料讲近现代史！思政味道也重，语重心长跟我们讲历史背后的家国情怀！她有很多境外的史料，跟其他老师不一样。有趣又有意思，讲问题的角度很有深度。作业是小组展示课、一篇个人论文和讨论题和浙江省档案馆感想。感觉她不喜欢鹅颈、要开心学习，真的学到知识才是重点。发现她教学比赛确实获了很多奖，她从来没说，很谦虚的一个人，只会说查档案、抄断手，留学耶鲁时候很穷很苦，一天拍几千张照片，感受到了她对学术的热爱和执着。还有对学生非常和蔼可亲，说话很可爱！
151167,3735,尤云弟,2022-02-24 01:48:38,7,8,1,好极了
152025,3735,尤云弟,2022-03-23 10:04:46,7,8,1,尤老师是我在浙大遇到的最好的老师
152052,3735,尤云弟,2022-03-24 07:09:20,14,14,0,听说老师教学比赛又获奖了，我们班配合录课的，感觉很荣幸哈哈哈哈yyd yyds!
152679,3735,尤云弟,2022-04-18 07:39:06,9,9,0,尤老师很棒，她的课可以学到很多
153709,3735,尤云弟,2022-05-09 03:58:39,-3,0,3,。。。
153874,3735,尤云弟,2022-05-15 07:03:25,9,11,2,尤老师教学获大奖啦 YYD YYDS！确实上课有趣，超好玩的！
153933,3735,尤云弟,2022-05-17 06:21:19,11,13,2,老师超级好，上课很幽默。会把作业分阶段布置，每次完成一部分就好，到了期末沉浸在各种锅里面的时候史纲没有任务真的感觉挺快乐。看到尤老师教学又获奖了，永远滴神！yyd，yyds!爱了爱了！
155628,3735,尤云弟,2022-06-15 00:27:52,12,14,2,大早上还没出分就来评一个10分！呜呜呜很喜欢尤老师！特别有趣特别可爱的一位老师，许多许多自己之前从不曾有机会了解的历史知识，尤老师都会在课上讲！尤云弟老师的纲要课绝对不无聊！选她没错！
155992,3735,尤云弟,2022-06-17 04:28:36,11,12,1,期末卷面50捞到了3.9，最后还鼓励我好好学习。
155994,3735,尤云弟,2022-06-17 04:30:11,5,8,3,老师超级棒！
156007,3735,尤云弟,2022-06-17 05:45:33,15,16,1,尤老师😭😭😭她真的我哭死\n\n为什么史纲这门课只能选一次啊！\n\n尤老师真的yyds！！！！！\n\n不要犹豫都选她！！！！
156008,3735,尤云弟,2022-06-17 05:45:33,7,8,1,尤老师😭😭😭她真的我哭死\n\n为什么史纲这门课只能选一次啊！\n\n尤老师真的yyds！！！！！\n\n不要犹豫都选她！！！！
156054,3735,尤云弟,2022-06-17 08:58:30,7,9,2,必须给10分！！老师实在是太好啦！！！！
157763,3735,尤云弟,2022-06-24 17:24:54,2,4,2,给分也太求是了
159378,3735,尤云弟,2022-07-15 07:45:26,2,6,4,很可爱的老师！满绩了！
159616,3735,尤云弟,2022-08-22 07:49:33,11,13,2,给学弟学妹看。。尤老师上课很有意思，眼睛会看着学生，信手拈来讲历史故事背后的大道理，总是说要用大历史观去看待人生，要走对的路，让自己快乐！感谢尤女神，她拿自己的档案馆的体会，台湾访学坐出租车怼人，耶鲁留学很多细节，让我在大一的时候知道自己想要过什么样的生活。她有智慧，有思想，很严谨，最重要是看得出来她发自内心爱给我们上课！爱学生！
160030,3735,尤云弟,2022-09-12 04:10:23,4,4,0,感动了，超可爱的口音！
160041,3735,尤云弟,2022-09-12 07:27:28,0,2,2,喜欢上
160045,3735,尤云弟,2022-09-12 08:04:29,2,2,0,老师让我感到历史学习可以是鲜活快乐的，用故事串联阔大的历史
160561,3735,尤云弟,2022-09-27 03:19:37,6,7,1,没作业，开卷考，好多视频，好多故事，然后尼，然后尼，10啦
160832,3735,尤云弟,2022-10-16 06:56:01,2,3,1,然后妮，上课水吧，不过听了也有趣的
160984,3735,尤云弟,2022-10-23 02:42:25,3,4,1,yyds
160985,3735,尤云弟,2022-10-23 02:43:16,5,5,0,尤老师yyds！
160986,3735,尤云弟,2022-10-23 02:44:52,3,4,1,尤老师yyds！！！会跟你讲好多小故（ba）事（gua）！上课超级有意思！！！还会放好多视频呜呜呜！选上尤老师的课真的是我一个历史菜鸡的一生之幸呜呜呜
161031,3735,尤云弟,2022-10-24 09:53:31,3,4,1,“这个问题很重要啊”“然后ni”尤老师超可爱的
161408,3735,尤云弟,2022-11-06 13:44:51,-1,2,3,好老师！
161823,3735,尤云弟,2022-11-14 05:27:18,1,3,2,🐮🐮🐮
162199,3735,尤云弟,2022-11-17 14:25:05,3,4,1,yyds
162431,3735,尤云弟,2022-11-22 07:43:53,8,9,1,然后捏，就有一个个小故事哩
164265,3735,尤云弟,2022-12-20 05:20:57,4,5,1,👍👍👍
164266,3735,尤云弟,2022-12-20 05:20:57,6,6,0,👍👍👍
164781,3735,尤云弟,2022-12-26 05:23:09,4,5,1,尤老师神助攻手！
164852,3735,尤云弟,2022-12-27 02:55:34,4,7,3,好的历史老师就像她这样 能选到她的课是天大的好运气 结课了还会给学生发红包
164937,3735,尤云弟,2022-12-28 06:05:35,12,12,0,YYD，YYDS！尤老师真是神仙好老师，上课讲得好！又有趣又有内容！动不动抛出“为什么捏”，吊足胃口，再来一个不为人知的故事，太可爱了！她还说本来第八周都要认一下脸。可惜分别太匆忙了。最后结课了还发个大红包！
164964,3735,尤云弟,2022-12-28 06:37:10,1,3,2,尤云弟！！！！博学可爱！关心学生！历史原来可以这么有趣！！！
165559,3735,尤云弟,2023-01-08 09:45:14,6,7,1,尤老师真的好暖心！一直叫我们不要恶性竞争，经常让我们以身体健康为先！给分也是不用多说的好！为什么没有100分！尤云弟我的神！！！
165584,3735,尤云弟,2023-01-08 13:13:11,8,8,0,太好了
165634,3735,尤云弟,2023-01-09 05:37:43,4,5,1,史纲，给分不错
165722,3735,尤云弟,2023-01-09 12:02:23,9,9,0,尤老师上课挺有趣，给分也不错
165867,3735,尤云弟,2023-01-10 07:41:02,6,8,2,真的很喜欢尤老师。超级可爱超级幽默！而且能从老师身上感受到一个学者的风骨，平易近人没有傲气，有悲悯心，拜托我真的很喜欢温柔的善良的没有偏见的人啊。很幸运能上尤老师的课，之前还因为一些说会换老师的评论吓到了。都来上尤老师的课哇！！！
166193,3735,尤云弟,2023-01-11 11:35:07,9,10,1,上完课一年来评 就近代史纲来说\n\nyyd是最好的史纲老师 zh是最好的历史老师 gjx是最好的老师
166354,3735,尤云弟,2023-01-12 05:12:24,2,4,2,课精彩 给分好 爱死yyd
166409,3735,尤云弟,2023-01-12 07:33:18,8,10,2,yyd真的是一位宝藏老师，上课非常精彩、引人入胜。上课前还想在课上写点作业、干点别的，结果上完课后发现自己原来想干的事情都没做，噢，原来是我沉浸在yyd的史纲课里了【笑哭】。因此，我的建议是不到万不得已，不要水课，你真的从课上能收获很多。老师非常关心学生，消息也及时回，助教也很不错，结课了还发红包欸。最后出分也超级好，yyd助我拿到了进入zju的第一个满绩【好耶!】，想史纲满绩嘛，就来这里趴。
166722,3735,尤云弟,2023-01-13 10:09:13,7,7,0,老师讲课很激情
167229,3735,尤云弟,2023-01-15 06:46:12,2,6,4,超级喜欢尤老师！！！！！上课轻松有趣！！事情少给分高！！最重要的是，可以感受到尤老师是真心热爱讲台和学生，不只是关心学生们的学业，而是对学生的发展、学习、生活都有着巨大的体谅和关切！！
167841,3735,尤云弟,2023-01-19 11:54:33,5,8,3,满分满分满分！！尤老师真的太太太好了。上课幽默有趣，我一个历史不太好的都听得津津有味。平时作业很少，也基本都不点名。非常关心学生，超级和善啊啊啊啊啊啊！！给分也巨好呜呜呜呜呜
169553,3735,尤云弟,2023-02-27 01:54:10,7,8,1,好！！绩点好！人好！课好！
170013,3735,尤云弟,2023-03-01 03:38:38,10,14,4,开学第一周来上课就被尤老师震撼住了，不愧是满分老师，上课好有趣，幽默风趣还有各种历史知识，串起来告诉我学习史纲太重要了，整整三节课我居然没玩手机，爱了爱了，yyd!yyds!
172307,3735,尤云弟,2023-04-24 23:46:40,4,5,1,太好了
173659,3735,尤云弟,2023-05-31 07:26:14,5,5,0,真的真的超级棒
173721,3735,尤云弟,2023-06-02 01:50:22,2,4,2,超级无敌好啊啊啊啊啊啊啊啊！yyds！！
175218,3735,尤云弟,2023-06-22 12:50:30,6,6,0,选了不亏的，快选快选(ಡωಡ)hiahiahia
175619,3735,尤云弟,2023-06-26 02:35:13,-6,3,9,6。。。
175623,3735,尤云弟,2023-06-26 02:49:22,9,9,0,爹！！！
175624,3735,尤云弟,2023-06-26 02:50:51,3,5,2,啊啊啊啊啊啊满了啊啊啊啊啊谢谢老师 真的给分超好
175644,3735,尤云弟,2023-06-26 04:12:10,3,4,1,人好课好分好 事少
175653,3735,尤云弟,2023-06-26 05:05:16,4,6,2,真的很幸运能选上尤老师的史纲！！！讲课特别好人也特别好事情也不多！！！最后绩点也很不错！！！大爱尤老师！！！
175682,3735,尤云弟,2023-06-26 07:38:28,3,4,1,尤老师温柔细心认真负责，幽默又会讲故事，最后史纲我拿到自己文科的最高分，不过小组展示要看小组的情况，点名基本会提前说，没有几次，但老师的课还是很有意思的，bd
175733,3735,尤云弟,2023-06-26 10:38:00,5,7,2,老师真的超级超级好！上课很有意思，作业也还好，不是很多，是一个很有教学热情的老师，也很有幸拿到了大学第一个满绩，爱死她了！！！
176028,3735,尤云弟,2023-06-27 12:50:55,11,11,0,讲课真的很有意思，然后评分标准说的也很清楚，最后给分很好，满了！
176180,3735,尤云弟,2023-06-28 03:58:51,-35,5,40,我草 94 差一分满了 真牛逼啊 毕竟我只去上过三次课
178374,3735,尤云弟,2023-07-11 05:18:01,-21,4,25,讲课水平一般 小事情不少 给分也并没有被吹得那么好
179041,3735,尤云弟,2023-08-24 08:55:37,12,15,3,人善事少课好， yyd yyds!选她！
179238,3735,尤云弟,2023-09-01 05:05:49,-8,6,14,很难评
182064,3735,尤云弟,2023-11-09 09:42:00,3,5,2,太温柔博学的老师！让我看看是谁不给十分！
182790,3735,尤云弟,2023-11-20 08:45:36,4,5,1,好好好
182892,3735,尤云弟,2023-11-21 03:49:04,2,5,3,把历史讲的很生动，10分~
184410,3735,尤云弟,2023-12-19 05:15:48,4,4,0,太棒了
184626,3735,尤云弟,2023-12-22 03:56:58,6,8,2,史纲课第一段子手
185188,3735,尤云弟,2023-12-27 03:44:31,7,8,1,史纲课两大段子手，一个dzw，一个yyd！
187047,3735,尤云弟,2024-01-14 09:03:10,10,12,2,老师值得十分！\n\n上课有趣➕反对鹅颈第一人➕期末还在群里发红包祝大家都取得好成绩➕说话温温柔柔➕每次点名都提前通知➕找我们帮忙录课（其实是正常史纲课上课时间）还送我们小礼物\n\n预置上尤老师的课就偷着乐吧🥰
187723,3735,尤云弟,2024-01-17 08:18:04,4,4,0,人好，不点名，事少
187859,3735,尤云弟,2024-01-17 15:11:57,8,10,2,特别可爱的一位老师！人特别随和特别温柔www，我是补选上的尤老师的课，老师还很耐心地帮我解决了补选的问题。甚至同时期在上别的历史课写的论文发给老师老师也会很耐心地看并且线下找到你给你提反馈意见，真的是一位特别认真负责的老师。在期末考试前会反复提醒我们注意事项，认真帮我们复习，尤老师wwww真的特别好！最喜欢老师的“然后ni”哈哈哈哈特别可爱！
187978,3735,尤云弟,2024-01-18 02:40:16,7,9,2,老师超级好啊......期末考一道大题全写错最后还是被老师海底捞了！！！平时上课会按照小组名单点人头，上课也超级有意思，经常给我们分享一些自己的趣事或者历史名人的趣事，满分满分！！！
187996,3735,尤云弟,2024-01-18 03:01:03,6,7,1,一定会收敛于10的orz
188320,3735,尤云弟,2024-01-18 15:32:54,1,3,2,一学期点两次名还会提前告诉，温柔幽默，不用复习给分好，冲！不要犹豫！
188848,3735,尤云弟,2024-01-20 08:20:19,8,9,1,讲课很有趣，很少留课后作业，主要一篇读书报告一次小组活动，最后期末开卷考前翻一遍书就行，最后捞满了。
190305,3735,尤云弟,2024-02-27 14:46:20,10,10,0,这个老师讲课巨逗，明明声音很催眠但是内容不犯困那种。还有她敢调查非法移民诶！好酷！
190493,3735,尤云弟,2024-03-06 03:26:14,10,10,0,近现代史纲，老师很温柔，上课会补充很多个人经历和民国小故事，听课体验很不错。但我实在无法理解在认真完成所有作业和考试，小组展示组也分到了很不错分数的情况下是怎么拿到这么低的分数的，只能说自认倒霉吧
191644,3735,尤云弟,2024-04-26 12:32:41,8,9,1,尤老师讲抗日战争讲得哽咽眼睛泛泪花，讲得非常好，很多外国档案和资料，我听得很感动又激动，勿忘国耻！
191724,3735,尤云弟,2024-04-29 04:21:37,5,8,3,事太多
192487,3735,尤云弟,2024-05-22 08:55:57,16,17,1,作为课代表单纯来留个言，尤老师这学期的史纲课除了很多档案小故事，居然非常时髦有趣，让我们在活动课使用Ai语言大模型，鼓励我们使用体验她研究的知识图谱，还每人发了一个小礼物，现在这样用心给学生花心思的老师太难得啊！！尤女神加油！！
192509,3735,尤云弟,2024-05-22 08:55:52,9,10,1,老师把知识图谱做成一本书的样子，历史是最好的教科书，真的好用心啊！
192510,3735,尤云弟,2024-05-22 09:05:47,-10,6,16,基本什么也学不到，事情还特别多
195069,3735,尤云弟,2024-06-26 15:51:55,5,5,0,出分前来给老师打个十分 希望老师一定要捞捞我啊
195841,3735,尤云弟,2024-06-30 08:53:06,6,8,2,无敌的老师
195863,3735,尤云弟,2024-06-30 11:19:04,9,10,1,不管是给分还是什么都是真的好到无话可说了
195886,3735,尤云弟,2024-06-30 14:05:29,3,6,3,预置了尤老师的史纲课你就乐着吧，老师真的特别特别好
195968,3735,尤云弟,2024-07-01 03:01:14,-2,5,7,给分没想象中的好，慎选
196847,3735,尤云弟,2024-07-05 13:03:37,1,2,1,党史出分很快，但个人觉得给分有点莫名奇妙，认真写了书评+高中选考政治历史，总评实在一般。。。
196961,3735,尤云弟,2024-07-06 06:31:26,2,4,2,10分不解释
197278,3735,尤云弟,2024-07-10 08:00:11,6,8,2,尤老师上课特别有趣，是能够让我在做别的事情都能被吸引过去的有趣。史纲这门课讲得很多，每节课知识安排得其实也很满，但是尤老师的课真的给我补充了非常多的历史知识！虽然其实没怎么听课（），但是老师上课讲得真的很不错。老师会点名，是两次提醒过的，还有随机点名，请假之后好像也可以去销假，在到课方面管理得挺松的。事情不算特别多吧，基本史纲每个老师都是这个任务量，一篇读书报告，一次线下参观观后感（自行报名可以不去），一次小组展示和期末考。本人高中选历史的，基本上在这门课没有花时间，也没有当小组长课代表之类的，最后4.8。选上yyd还是很幸运的！
198672,3735,尤云弟,2024-09-10 14:35:56,6,6,0,真的很生动有趣
198755,3735,尤云弟,2024-09-11 10:46:36,12,13,1,真的巨体贴学生，头一次见到有老师会说“学生如果旷我的课是因为我教的不够吸引人”这种话，真的感动😹，而且上课也很有意思，会讲小故事同时穿插一些唯物史观，“……妮”的口音也真的可爱妮
200281,3735,尤云弟,2024-10-19 07:47:47,3,4,1,重新来评价了！之前问了老师一个问题（作业相关）但是老师当时比较忙就没有给出很详细的答复。一开始很失望，但是后来和老师沟通后，老师也是非常耐心非常专业地给出了很好很棒的答复🥺🥰❤️，还是像老师上课讲的那样，要对历史充满温情和敬意！最后还是超级谢谢老师😋！
201547,3735,尤云弟,2024-11-04 07:38:26,10,11,1,教授抗日战争史，老师红了眼眶，这或许就是大学生上历史课的意义吧
202380,3735,尤云弟,2024-11-12 07:35:59,2,3,1,没得喷，妮～
203907,3735,尤云弟,2024-11-22 02:06:45,8,8,0,好老师 满分
204107,3735,尤云弟,2024-11-24 09:00:49,8,9,1,有情怀，有风骨，有学识，有经验。
204523,3735,尤云弟,2024-11-26 11:53:02,10,10,0,党史上到一半忍不住了\n\n老师好可爱☺️\n\nni～
205279,3735,尤云弟,2024-12-03 22:14:24,5,6,1,不得不说，两周活动课太精彩了，我们在提升历史素养的同时，学会了如何让AI赋能思政课。在用AI思辨史纲课题目时候，我们达到了尤老师最后一场说的道的高度啦！史纲课收获满满，为尤老师的精心安排和组员认真付出点赞！
205854,3735,尤云弟,2024-12-12 09:47:18,4,4,0,好！！
208268,3735,尤云弟,2024-12-26 12:20:15,5,7,2,第一次听到老师说“没有把你们留在我的课堂是我的问题，所以我不会点名”。但是老师的史纲讲得真的太好了，讲到一些屈辱不平甚至会眼泛泪光，我还想再上一学期尤老师的课！！
208858,3735,尤云弟,2025-01-02 14:53:26,8,9,1,“我不会和其他老师一样点名，因为我一直认为没有把学生留在课堂里，是老师的问题。”老师讲的很生动，虽然我确实听的课不多，但是能感受到尤老师对于浙大的热爱，我也很爱yyd老师！
211387,3735,尤云弟,2025-01-11 10:03:14,3,4,1,老师人很好，但我被卡绩88了。但不影响老师人很好
211603,3735,尤云弟,2025-01-12 03:54:45,6,6,0,尤老师是非常好的历史老师，上课很有热情，有很丰富的文献和视频史料，也时时刻刻向同学们传递着正确的历史观。当我们回顾历史的时候，一定要带着温情的眼光去看待当时的人和事，这句话让我受益匪浅，感谢尤老师！
211609,3735,尤云弟,2025-01-12 04:11:16,2,4,2,老师的史纲课真的很有意思！和高中讲的视角很多都不一样！但我有时候是会摸鱼hhh不是组长课代表，作业按时提交，考试前一天复习了一下，最后4.8！
211621,3735,尤云弟,2025-01-12 04:48:39,1,2,1,尤老师好老师！有情怀有风骨！事少分好！！！YYDS无需多言！
212387,3735,尤云弟,2025-01-14 02:48:05,-2,3,5,老师人挺好的，讲课也很用心，给分也好，身边都是5.0 4.8，出分后群里都是谢谢老师。就是我小组作业、平时作业都认真做，最后出分4.5，比经常不到课的同学还低，心里有点落差。不过老师还是很好的，对教学很有热情！
213726,3735,尤云弟,2025-01-19 09:31:29,7,7,0,老师人挺好，就是莫名其妙被绩杀了
213759,3735,尤云弟,2025-01-19 13:29:02,-1,3,4,老师人很好，对学生也很宽松。网站上的均绩都是4.3，为啥最新评论都是4.8，而且89就算卡绩点了。有点不理解，因为自己没有拿高分，小小失落
216303,3735,尤云弟,2025-03-13 03:56:14,1,1,0,有意思
217783,3735,尤云弟,2025-04-16 11:02:40,0,0,0,老师很好，但被88卡绩
220675,3735,尤云弟,2025-06-19 07:48:20,2,2,0,老师很好，但我太菜
220676,3735,尤云弟,2025-06-19 07:24:27,2,2,0,无语死了。平时任务全都完成了。3.9我请问呢？
221155,3735,尤云弟,2025-06-21 14:02:51,3,3,0,老师人真的很好，但是最后只有3.9有点无语
221528,3735,尤云弟,2025-06-24 08:24:47,2,2,0,期末太难，不怪老师，爱你yyds
44991,3743,王雪楠,2017-01-18 18:00:01,60,95,35,给这个分完全是因为没有负分\n\n
45122,3743,王雪楠,2017-03-05 06:34:54,-39,11,50,。。。。。。。。。。。。。。。。。
45451,3743,王雪楠,2017-01-19 14:40:34,36,63,27,纪杀，绝对绩杀\n\n按着她的要求平时报告认真做买了两本书全看了考前还抄了书结果3.0的绩点，一问全班都很低......虽然上课不错
45555,3743,王雪楠,2018-08-25 02:37:03,231,321,90,老师上课真的超级有趣！！！！叫我们抄教辅材料抄100页考试就不会挂啦~~绩点就能1.5啦~~~超开心的哦(围笑)大家，退了吧这么好的课大家上不起的(围笑)所以给她一个大大的1分完全是因为她在我心目中是第1的
45616,3743,王雪楠,2017-01-20 00:57:52,5,11,6,哪节课的
45622,3743,王雪楠,2017-01-20 01:09:41,608,762,154,老师很好啊！给分真的棒！平均2.7！
45637,3743,王雪楠,2017-03-10 10:47:33,40,69,29,给一分倒不是因为没零分，一分给在上课还是像说书一样，如果但是听听图个乐倒也可以。但是，两次小组展示+2000字诸多要求的论文，这么多事情，最后还是这么个分数，就我一个人这分我还可以说是我比较差，不努力，但是现在全班均绩这个样子，什么鬼啊。抄所谓教辅有什么用啊。虽然知道史纲可能会比较差，但是没想到这么差啊。辛辛苦苦一学期，连有机都考出自己满意的成绩，结果史纲一出，一夜回到解放前，均绩唰唰往下掉。心疼，还能说什么呢，我2.4怪我咯。
45643,3743,王雪楠,2018-01-29 07:27:03,24,57,33,真的是辣鸡，感觉上了假史纲，辣鸡老师毁我青春！
45678,3743,王雪楠,2017-03-02 02:30:08,77,115,38,不要学分了也要退课
45708,3743,王雪楠,2017-03-08 05:27:51,33,57,24,同学平时史纲一点事情也没有 最后两千字论文就完事了 4.5 我 … 2.7 别的不说了 慎选
45730,3743,王雪楠,2017-01-20 03:50:26,30,50,20,初来乍到，吓我一跳。
45901,3743,王雪楠,2017-09-22 01:48:17,57,88,31,真的不想说什么 估计全校史纲的绩点都是我们几个班拉低的吧 4:6的成绩构成也只有我们了吧 听说最后的成绩还是调高了的 不知道老师你原来打算给多少呢?
45924,3743,王雪楠,2018-01-28 06:38:39,96,157,61,虽然老师上课认真，但是给分惨不忍睹啊！\n\n平时上课每节都到，还做了展示，交了读书报告（近乎论文），期末卷子填满了，然而，这绩点，让我直接崩了。
45944,3743,王雪楠,2017-01-20 09:36:04,76,111,35,我还能说什么呢 比别班多做一个展示论文也难度更大老师上课不按课本讲是好事但是也没有上完啊 认真上课的同学也可能只有3.3  别班不认真的同学也有4.5 希望老师以后能在给分上再多多考虑：）让通识课拉均绩不妥吧：）
45958,3743,王雪楠,2017-01-30 17:33:43,-42,7,49,新老师，绝对的好老师
45964,3743,王雪楠,2017-02-28 13:21:32,29,50,21,给1分是因为没有0分 不知道这个学期还有没有人选她的课 毁我绩点毁我人生
46069,3743,王雪楠,2017-11-22 05:53:51,94,137,43,亲测2.4，她上课就有种感觉，她最牛逼，天底下她知道的东西最多，你们台下这帮渣渣都给我乖乖听好了。然而听好了也没用。我真不懂她在我们一群新生面前装x有什么优越感，这样的态度放在教书，做学问上都做不出成果来吧
46265,3743,王雪楠,2018-03-08 02:27:40,282,413,131,上课一副我最牛b，傲慢狂妄，喜欢怼学生。自以为是，还瞧不起浙大其他史纲老师！！辛苦一学期绩点2.5！说好给我们改分数，结果关机！连句道歉也没有。 这是严重教学事故！不用负责吗？读书读傻了？ 楼下的居然认为分数低是公正？？请问我们辛辛苦苦一学期认真付出，又讨论又论文，没有回报，成绩那么低，算公正？没法选好专业，改变人生命运！她没涵养，不尊重学生，不配开课当老师！
46273,3743,王雪楠,2017-03-04 11:51:22,24,43,19,给分很差
46276,3743,王雪楠,2017-01-21 06:14:03,41,71,30,均绩2.8最高3.3你明白的，其他老师的均绩3.8都比她最高的高，还搞特殊跟其他老师平时期末比不一样，明知道史纲考研难度还这样。她就是挂尤云弟名的老师，选上了赶紧退
46278,3743,王雪楠,2017-03-02 01:48:10,18,36,18,给分想哭
46281,3743,王雪楠,2019-01-10 02:52:08,216,308,92,我敬你是条汉子 希望以后还能在学校见到你
46284,3743,王雪楠,2017-01-21 06:37:19,14,21,7,膜大绩杀\n\n
46303,3743,王雪楠,2017-01-21 07:25:00,14,26,12,7分主要给王雪楠老师的课，但分数、绩点就无需赘言了。1.20尤云弟老师那儿的一个长评我写的。的确，同样水课，我们三个班绩点远低于其他班，这真的很不公平，尤其是对dl们，史纲狂拉均绩。希望老师以后能早点入乡随俗吧。
46307,3743,王雪楠,2017-01-21 07:53:11,9,17,8,继杀QAQQ
46325,3743,王雪楠,2017-01-21 08:33:29,9,14,5,看评论看评分
46524,3743,王雪楠,2017-02-28 05:17:22,9,17,8,给分确实太低
46526,3743,王雪楠,2017-01-22 01:50:12,10,18,8,没话讲了，给分真差
46530,3743,王雪楠,2017-03-07 04:22:23,32,47,15,毁我人生
46533,3743,王雪楠,2017-01-22 02:01:13,15,29,14,同样都不会做试卷的情况下，整个班的成绩就是比其他班差一大截，出成绩你会绝望的
46536,3743,王雪楠,2017-02-27 09:01:28,13,22,9,嘿嘿嘿
46542,3743,王雪楠,2017-01-22 02:22:00,17,25,8,呵呵呵呵，说好改分？？？结果呢？
46544,3743,王雪楠,2017-04-15 03:31:06,37,63,26,这腊鸡老师怎么还在祸害其他人啊，学校也不管管，怎么给她过的教师面试，得仔细查查。教的乱七八糟，学的全是鸡毛蒜皮、各种不靠谱的历史人物的八卦，书上的内容什么也没讲，完了师德还这么差劲?。
46550,3743,王雪楠,2017-03-02 07:05:12,18,29,11,呵呵 微妙 她觉得自己很厉害吧…说话流氓匪气
46569,3743,王雪楠,2017-06-21 03:26:55,158,208,50,她影响了我的整个大一，拉了0.2均绩，打乱了我对大一的所有规划，不是她或许已经进工高了。不说了，要落泪了。
46679,3743,王雪楠,2017-01-30 17:33:09,-33,11,44,辛苦了。虽然给分不好，但课真心挺不错的。
46716,3743,王雪楠,2017-05-12 07:40:21,180,235,55,老师应该能看到查老师平论，如果能，请在查老师上正面回应为什么没有给改成绩，明明是承诺了的！想必你也不想总在低分榜挂名……顶我上去……
46757,3743,王雪楠,2017-01-22 09:25:04,10,15,5,大绩杀
46760,3743,王雪楠,2017-01-22 09:26:45,10,15,5,给分就是坑
46780,3743,王雪楠,2017-01-22 10:02:28,65,98,33,算是我倒了血霉，当初以为选上了尤老师的史纲，没想到是一个新来的年轻老师王雪楠挂在尤老师的名下来上课。新老师，上课逻辑不清楚就算了，上课全讲书本以外的内容就算了，讲的完全不是正统史观也就算了。可是您给全班的均绩是2.7是什么意思，就算是其他号称绩杀的老师的均绩也没您这么低啊。学校要求正态分布，是为了控制高分人数，可您倒好，80分以上的全班凤毛麟角，一个都找不到的。我可真是谢谢您了，让我看到了年轻老师有多胡来。您到一个新地方不尊重当地的习俗你怎么混的下去？
46788,3743,王雪楠,2017-01-22 10:17:47,33,47,14,人不仅要自己努力，也要考虑历史的进程。
46794,3743,王雪楠,2017-01-22 10:22:48,10,18,8,大绩杀←
46820,3743,王雪楠,2017-02-08 13:43:12,23,44,21,太烂了，讲课差，论文要求破多，还是大绩杀!说好3天内要改分，这都多少天了，还是不改，什么狗屁老师，说话当放屁样!
46825,3743,王雪楠,2018-01-25 10:02:30,70,111,41,这么个人渣老师，大一碰到倒了八辈子血霉
46827,3743,王雪楠,2017-01-22 11:32:21,10,17,7,大绩杀
46833,3743,王雪楠,2017-01-22 12:01:01,34,54,20,绩点杀手，大学第一门低于3绩点的课，组里平均绩点大概2.7左右吧！而我室友上了另外一个老师的课（平时什么事都没有）也没有复习就拿到了4.5的绩点！这是多么不公平，凭什么一样的试卷，我们全班得到这么垃圾的分数！平时要好几次展示，事情超级多，绩点杀手啊。。。我想说，还好专业已经确定了，否则直接因为这门课，我还不如选择退学。对，还不如退学重新开始！一个可以毁我人生的老是，牛逼！
46835,3743,王雪楠,2017-01-24 15:21:17,18,35,17,回来刷个差评
46979,3743,王雪楠,2017-01-23 07:04:36,152,213,61,为人师表缺了几样东西：一、信守承诺，说好给我们改分数，又说三天以后可以重新查，结果呢，什么交代都不给，还不是没有改回来。二、谦逊，讲课的时候总感觉天下我最厉害，总喜欢怼我们。三、责任，事情没解决，就想着逃避，关机是怎么回事？！好歹出来给个交代啊。四、naive，不懂当地习俗，我就觉得无语，别人班均?3.8，我们均?2.4，这是什么鬼。一句不懂规则就完事了？！我tm打了人，说句不小心的就没事了？！连句公正的道歉也没有。\n\n不过，还是感谢你给我们上课。虽然照样什么都没学到呢。呵呵呵呵呵呵。
47043,3743,王雪楠,2017-01-23 10:40:42,14,19,5,大绩杀！！！好歹给点笔墨分！！！怀疑有个假老师！！！
47102,3743,王雪楠,2018-09-20 01:48:13,23,55,32,上课一副我最厉害最牛b的样子，喜欢怼学生。说话有点流氓匪气！那改卷呢！ 辛苦一学期绩点2.5，啥意思！！说好给我们改分数，又说三天以后可以重新查，结果呢，什么交代都不给，关机是怎么回事？！好歹出来给个交代啊。连句道歉也没有。 刚来新地方 ，不去问问其他老师，不遵守规则，一句第一次改卷打分就没事了？读书读傻了？恐怖大绩杀
47241,3743,王雪楠,2017-01-25 00:09:28,19,39,20,既然你答应了要改分，说三天之后重新查成绩，那现在这种情况怎么解释，你准备怎么给个交代，被一门史纲课拉那么多鸡点，我除了一句mmp无fuck说
47242,3743,王雪楠,2017-01-25 00:15:27,10,15,5,上课不好给分差
47257,3743,王雪楠,2017-03-02 07:45:46,18,33,15,诸位在校，此课慎选！
47291,3743,王雪楠,2017-01-25 05:49:49,-24,7,31,可以啊 好老师 真是好老师\n\n
47293,3743,王雪楠,2017-01-25 06:05:56,10,17,7,hh活着不好吗
47417,3743,王雪楠,2017-01-26 05:54:46,10,15,5,差到极致
47462,3743,王雪楠,2017-01-27 04:02:06,10,15,5,绩杀，不讲信用，说好的改分呢？\n\n
47541,3743,王雪楠,2017-01-30 08:39:26,-16,7,23,绩杀，但是是第一年
47555,3743,王雪楠,2017-01-30 17:37:00,22,39,17,垃圾老师，叫我们手抄什么书，然后自己去复印，班级里发的群魔乱舞，最后没卵用，还说是我们的责任，成绩也乱给，其他老师三七分配，她倒好，七三分配，呵呵了，均绩掉了0.2，没谁了，千万别选她
47608,3743,王雪楠,2017-03-19 11:28:07,-1,11,12,真好！好老师！
47613,3743,王雪楠,2017-02-08 06:08:40,16,23,7,给分低就算了，骗人是个什么道理？\n\n说好了改分，最后毫无动静\n\n无话可说，只能送上四个字\n\n无耻之尤
47640,3743,王雪楠,2017-06-24 15:15:49,-133,21,154,我就是那个“幸灾乐祸的异类”，挂名的事我聊不动，这一点我的说法确实有问题。但是，讲课细致和讲不完矛盾吗，是不是推荐了书和视频？关于收获，我就列几点：第一次写论文，知道用数据库，知道怎么选文献。我没说我很认真，平时上课没认真听（讲的有趣就听，枯燥的就打瞌睡），展示小组也是被怼，考试前书还是新书，选择题估计零蛋，论述题撑死八十，不过论文真的从布置开始就查资料准备。我没办法证明认真学就有好绩点，所以没说绩点。既然你问我绩点，那我告诉你，3.9（83）。真是不好意思了，你要说我幸灾乐祸我也只能认。欢迎来怼，我只是看不下去一边倒。
47748,3743,王雪楠,2017-02-23 06:45:11,7,14,7,傻逼老师不解释，给的什么分，很不尊重学生，老是打断学生的ppt演讲，都不明白浙大怎么会有这种老师
47770,3743,王雪楠,2017-02-24 07:21:09,6,9,3,绩杀杀！！！
47790,3743,王雪楠,2017-02-25 00:26:53,6,9,3,上课可以水，反正绩杀。
47827,3743,王雪楠,2017-02-26 01:36:34,6,10,4,特别坑
47828,3743,王雪楠,2017-02-26 01:37:43,7,10,3,呵呵呵呵，不多说
47838,3743,王雪楠,2017-02-26 06:35:06,7,10,3,大绩杀
47859,3743,王雪楠,2017-02-26 12:51:38,7,10,3,怎么没负分？
47889,3743,王雪楠,2017-02-27 03:29:43,-1,4,5,送个助攻
47894,3743,王雪楠,2017-02-27 04:51:19,10,15,5,老师上课很认真 但事多给分惨不忍睹 固执己见 课代表多次提出算分制度不合理都被驳回
47902,3743,王雪楠,2017-03-03 05:18:21,10,17,7,给一分是因为没有零分！每节课自己讲到哪了都不知道，整天嘲笑学生，觉得自己最牛，公车上书是假的这事每周说一遍，最后把全班的分登错了绩点哗了狗
47908,3743,王雪楠,2017-02-27 08:33:56,6,8,2,真心不想再说了
47921,3743,王雪楠,2017-02-27 10:00:42,2,8,6,讲课我服你，给分我是真真的没话说，我只呵呵
48038,3743,王雪楠,2017-03-01 14:58:37,10,16,6,退课，退课
48051,3743,王雪楠,2017-02-28 06:37:53,14,21,7,以看不起学生中学历史知识看不起浙大其他史纲老师的语气上没有历史知识根本听不懂她体系的课 考前教学生作弊浪费学生时间 论文题目不讲清楚全班离题后说大家吃大锅饭 课堂展示在没有事先说好的情况下只能按照她的思路展示一半 最后给分平均2.7最高3.3 欢迎选课
48071,3743,王雪楠,2017-02-28 09:50:54,8,11,3,绩杀，评分方式差别过大。有趣但不是非常理解她的讲课内容和任务布置与史纲这门课程的联系，可能换成其它与历史有关的兴趣类课程会更合适
48141,3743,王雪楠,2017-03-01 01:22:54,2,7,5,好好好，我不多说了
48160,3743,王雪楠,2017-03-01 04:37:12,6,9,3,hhh
48162,3743,王雪楠,2017-03-01 04:39:28,14,19,5,选尤老师课的宝贝们注意甄别哦，别上了假老师
48164,3743,王雪楠,2017-03-01 04:46:46,7,9,2,辣鸡很垃圾
48169,3743,王雪楠,2017-03-01 05:18:28,5,8,3,祝大家取得好成绩
48170,3743,王雪楠,2017-03-01 05:24:48,6,10,4,还我成绩 认真做展示和论文=3.0
48171,3743,王雪楠,2017-03-01 05:24:56,10,17,7,没零分的选项我也是很无奈
48172,3743,王雪楠,2017-03-01 05:25:20,15,22,7,放在其他老师班里妥妥4.5+的 结果3.0 大概这就是恩赐吧微笑:）说好的改分等了一个寒假什么都没有？？？还让我们不要骂她？？？谁给你的勇气？？？梁静茹吗？
48178,3743,王雪楠,2017-03-01 05:58:35,13,18,5,平时认真做了她的所有要求 反正到期末的时候 你的绩点就可以直接炸了 没关系 你拿了2.4 别人拿4.8
48181,3743,王雪楠,2017-03-01 06:01:21,4,7,3,呵 呵 呵
48183,3743,王雪楠,2017-03-12 08:45:31,10,15,5,呵呵呵
48184,3743,王雪楠,2017-03-01 06:13:16,4,9,5,无f*ck说
48203,3743,王雪楠,2017-03-01 07:47:37,-22,4,26,课上的很好
48228,3743,王雪楠,2017-03-01 10:40:00,-1,4,5,…………
48282,3743,王雪楠,2017-03-21 11:53:01,2,15,13,我爱你\n\n
48284,3743,王雪楠,2017-03-02 02:05:49,12,17,5,自己说自己都没有教师证，凭什么上课还这样给分呢
48308,3743,王雪楠,2017-03-02 05:20:43,8,11,3,史纲可能是我四绩点年最低的一门课了，改成绩改到姥姥家了
48310,3743,王雪楠,2017-03-02 05:39:12,9,16,7,为何要挂名上课啊，欺骗学生的感情……
48313,3743,王雪楠,2017-03-02 05:59:47,-50,8,58,给分很好啊，平时水水过，期末3.9，哈哈哈哈哈，很好的老师0.0
48343,3743,王雪楠,2017-03-02 07:57:45,2,6,4,傻逼一个
48370,3743,王雪楠,2017-03-02 10:59:54,8,18,10,今天第一次听老师的课，感觉是一个非常霸气的老师，讲课还算有趣，但估计这学期给分仍然不会好，可能人的脾气就是这样的吧，说期末成绩占40%，是卷面成绩乘0.4，言下之意是不会调分，如果试卷难了，岂不完蛋?我退掉预置的课选了尤云弟竟然选到假老师??!!我还是在考虑退掉，等大二再学了，保险起见。
48372,3743,王雪楠,2017-03-02 11:30:44,5,11,6,可怕 冲着尤云弟老师选的 没想到选到假老师 上课的时候语气总是有点很拽的感觉 讲话也迷之清高。尤其别的老师成绩三七开 就她一个四六开 期末考占40% 无语 赶紧退了！
48373,3743,王雪楠,2017-03-02 11:42:15,2,8,6,平时感觉这老师还行，人还挺逗的，期末绩点一出来我整个人就蒙逼了...倒了八辈子血霉被预置到她的课
48396,3743,王雪楠,2017-03-03 01:16:28,1,5,4,剌激。
48415,3743,王雪楠,2017-03-03 03:21:44,5,8,3,上课细枝末节的小事讲很多不知道是不是历史老师的习惯 这我就不说了 考试前不弄清楚复习资料 让全班买一本考研概要里面还全是书上的内容就请问老师您知道考试怎么考吗 全班均绩2.7 据说是少加了一项分数要给我们改的 最后关机搞失联 心疼自己
48420,3743,王雪楠,2017-03-03 04:22:21,5,10,5,渣，上来就让我们买书，如果这书有帮助当然可以理解，还让我们全班把整本书抄了一遍，结果搞到最后一点用没有，甚至不能带进考场！上课完全自由发挥还总是掌握不好进度，总是当着我们班的面说我们是她拿来试验的班，辛苦写读书报告，考试前全寝室就我一个翻史纲的书，出来给分才3.0，绩杀！
48422,3743,王雪楠,2017-03-03 04:36:23,-18,7,25,其实老师讲得还是可以的，作为新来的老师，有些事情不是她可以决定的，也不是很懂浙大的套路。至于怼学生，我觉得她都是说一些查百度之类的，并没有说学生本身不好。
48428,3743,王雪楠,2017-03-12 09:58:18,8,11,3,辣鸡，人渣
48434,3743,王雪楠,2017-03-03 10:48:15,6,12,6,上课有一种我最棒我最棒，关上门老师跟你们讲讲那些历史上不为人知的秘密的感觉，期末之前一直提醒我们考试多难多难，还推荐了一本书，让大家一人抄一页争取带进考场。抄了好久结果根本用不到，真好，浪费了我这么多时间，还花钱去复印了。最后班级里绩点最高的3.3，均绩2.7，真好，没想到史纲成了我绩点最低的一门课，给了我一种我其他课都超级厉害的感觉。给这个分确实是因为没有零分。遇到的最可怕的老师，没有之一。
48508,3743,王雪楠,2017-03-19 07:21:35,5,12,7,不知道她路上会不会被打
48512,3743,王雪楠,2017-03-06 10:33:02,7,13,6,坑新生，讲出去自己3.6被别人笑死，竟然是班里最高的...
48524,3743,王雪楠,2017-03-06 13:27:54,2,7,5,不是历史专业的新生的论文要求引用不能多于多少多少，真把我们当成专业的了，不想说什么
48546,3743,王雪楠,2017-03-07 05:42:54,-33,4,37,我就是要给10分
48573,3743,王雪楠,2017-03-07 14:06:55,-21,2,23,好老师啊?
48601,3743,王雪楠,2017-03-08 06:03:01,5,8,3,她打完分还发短信给她自己洗地
48626,3743,王雪楠,2017-03-08 14:32:57,7,11,4,老师就如上面说的一样，浙大新绩杀，没有原因，真的没有原因，就是这么厉害
48673,3743,王雪楠,2017-03-09 06:45:17,6,11,5,噗\n\n王炸
48767,3743,王雪楠,2017-03-12 13:08:25,2,4,2,。。。。。。。。。
48768,3743,王雪楠,2017-03-12 13:10:04,3,9,6,怎么说呢 史纲是我所有课最低绩点。老师的专业知识可能是有的，但是反正我只听出来了慢慢的自傲和看不起别人。
48946,3743,王雪楠,2017-03-17 14:01:21,20,29,9,忍了很久了，关于那个说自己3.9找怼的评论。讲道理，论文复制粘贴率不高于10%，我问问你，这种论文谁能水过去？谁的读书报告不是挖空心思找一个主题知网上面下一堆论文读然后一点点挤出来的？说真的，您欧皇您了不起，我们甘拜下风。您真的厉害，祝您鸡年大吉门门满绩?
49266,3743,王雪楠,2017-03-31 14:02:11,4,8,4,给一分是因为没有0分
49465,3743,王雪楠,2017-04-14 14:07:57,6,10,4,被预置到就退了吧。事情一堆班里最高级点才三点多，别的班均绩都将近4了。嗯，真是好棒棒。
49664,3743,王雪楠,2017-06-28 00:51:53,2,6,4,只是求个说法…唉
50166,3743,王雪楠,2017-04-30 13:29:49,15,22,7,我这个人比较记仇，看到老师的评分上升了，赶紧来打个1分 ：）
50255,3743,王雪楠,2017-05-02 04:31:44,2,5,3,大绩杀
50429,3743,王雪楠,2017-05-18 07:19:12,-8,2,10,
50437,3743,王雪楠,2017-07-08 07:38:36,3,8,5,无fuck说
51008,3743,王雪楠,2017-05-12 04:14:09,-1,4,5,大绩杀
51020,3743,王雪楠,2017-05-14 01:53:37,2,5,3,刷低分
51085,3743,王雪楠,2017-05-16 10:36:55,-7,1,8,
51422,3743,王雪楠,2017-06-20 03:41:24,-7,5,12,日常刷分\n\n
51423,3743,王雪楠,2017-06-05 09:10:30,-2,3,5,人生转折点
51428,3743,王雪楠,2017-06-20 15:06:57,13,17,4,看到这么多人给那个3.9的点踩我就放心了。。\n\n
51480,3743,王雪楠,2017-06-06 07:45:44,6,10,4,评论最底下说自己3.9的，群号多少？几毛一条？我也想赚点外快
51546,3743,王雪楠,2017-06-07 04:22:33,-6,1,7,略略略
51623,3743,王雪楠,2017-07-04 04:20:54,-8,12,20,这学期给分正常吧，3.9，也没什么好说的了。史纲课，大家的评分基本看老师的给分。还有什么好说的。
51821,3743,王雪楠,2017-06-11 13:41:33,3,6,3,绝望，尤其是出成绩的时候
51881,3743,王雪楠,2017-06-13 06:24:42,8,14,6,老师超好，站在博士生的角度怼本科生，然后会叫你们买各种资料啊(结果不能带进去的)，然后叫你们抄100页(结果也不能带)，然后写论文啊(知网自费检测，抄袭后果自负)，然后绩点3.0已经谢天谢地了
51920,3743,王雪楠,2017-06-13 13:50:20,-2,5,7,这种既不尊重学生也不尊重其他教这门课老师的人居然也是老师。自己教的稀里糊涂还满口傲气，考试只会让学生抄书应付，当每个学生都和她一样以后只能去考研？
51947,3743,王雪楠,2017-06-14 01:05:30,-1,5,6,去你的
51969,3743,王雪楠,2017-06-14 03:20:16,-6,6,12,老师还是不错的，只是均绩不行
52000,3743,王雪楠,2017-06-14 05:32:18,-1,4,5,绩杀!
52115,3743,王雪楠,2017-06-15 02:09:46,-16,6,22,其实老师很负责，知识也很渊博，我很喜欢。
52150,3743,王雪楠,2017-06-15 07:26:49,3,4,1,真是无语
52346,3743,王雪楠,2017-08-08 01:36:39,4,13,9,这种人除了为紫金港的厕所贡献粪便还能贡献什么？
52460,3743,王雪楠,2017-06-20 08:29:23,3,5,2,赶快来拉低分
52515,3743,王雪楠,2017-06-20 16:39:39,13,17,4,垃圾中的垃圾王，说好的调分呢？！还有底下那位绩点3.9的，你是老师本人吗 ? ？她这平均评分应该是1才正常啊！是不是有人手滑分评多了？
52516,3743,王雪楠,2019-01-21 00:13:29,48,81,33,老师上课特别好，人也特别好，听课特别有收获！（5元一条，括号内记得删掉）
52933,3743,王雪楠,2017-07-03 03:44:01,6,12,6,我就是来问一下春夏学期上她的课的你们出分了吗？?（来自秋冬学期的苦逼孩子的凝视）
53006,3743,王雪楠,2017-06-24 15:18:31,3,6,3,还好退了
53037,3743,王雪楠,2017-07-08 08:39:33,5,11,6,天下第一好老师，手动微笑
53053,3743,王雪楠,2017-06-25 07:34:49,-1,2,3,无话可说
53054,3743,王雪楠,2017-06-25 07:36:35,-1,2,3,无话可说
53103,3743,王雪楠,2017-06-25 16:21:44,0,3,3,无语...就是来刷个分
53173,3743,王雪楠,2017-06-26 06:30:11,-1,1,2,...
53211,3743,王雪楠,2017-06-26 07:48:53,-35,4,39,挺好的，2点多的评分太低了，给个十分拉一拉。
53823,3743,王雪楠,2017-06-27 17:24:04,-1,2,3,神尴尬 那历史专业的要求衡量每一个人\n\n
53986,3743,王雪楠,2017-07-08 07:39:16,4,9,5,唉，不说了，是真辣鸡
56539,3743,王雪楠,2017-07-04 03:00:49,-7,8,15,老师还是挺好的，至少学会了用数据库，而且讲的很细致，我看到了不一样的历史。给分嘛，我觉得春夏学期还好。
56566,3743,王雪楠,2017-07-08 01:51:56,-38,14,52,相比某甘某尤注水的给分，王老师算是非常公正了……唉但是公正的代价就是给分很一般 --- 回复：甘均先和尤云弟那么多4以上明显就没有按3:7的规定来，不是自己牛逼靠老师放水分高了还得瑟了？真是服气，我认识的就有两个尤云弟班里的拿去年王雪楠班里的人的论文交了，都是4.5，尤云弟真牛逼啊。王雪楠给分差没的说，但是尤这种放水换别人好评的就了不起了？放水谁不会？有本事下学期统一给分？
56570,3743,王雪楠,2017-07-04 03:59:42,-13,5,18,还好吧，就是给分不能和尤云弟比，但是还可以
56623,3743,王雪楠,2017-07-04 06:02:17,0,7,7,2分以上都是托
56639,3743,王雪楠,2017-07-04 06:24:57,6,11,5,刷绩点的大佬趁早退掉，期末你会死的很难看。其实老师讲课还是可以的，起码是在讲历史而不是那些民间传说的故事。展示的时候直接怼人确实难以接受。
56757,3743,王雪楠,2017-07-04 21:44:31,-34,17,51,楼下那个高评别逼逼了 还他妈托 其他老师那些完全没有原则的给分儿就别拿台面上来行了么 你们世界一流大学的论文都是抄出来的？？分儿都是随便给的？课不听就可以上90的？真鸡儿爆笑。这学期王雪楠老师已经从良了 并且以我个人而言我的3.9从论文到讨论的表现到期末的评分可以按照公正来评判 以我论文2%的查重率在你们心目中的老师中我是不是可以上4了啊 我一直不以为思政课你们就可以随随便便一水而过 都惯的什么臭毛病？
56822,3743,王雪楠,2017-07-04 17:00:19,14,20,6,楼下那个人……首先甘 尤的上课水平绝对不比王雪楠差 凭什么说他们两个的任务少 所以学到的东西就少呢？ 其次 你不喜欢事少给分好的老师 只能说明你脑回路独特
57740,3743,王雪楠,2017-07-13 09:22:40,0,2,2,不能再高了
57904,3743,王雪楠,2017-07-17 08:22:36,3,7,4,绩杀，大绩杀
57978,3743,王雪楠,2017-07-19 07:42:45,7,14,7,一顿复习猛如虎\n\n一看绩点2开头
58038,3743,王雪楠,2017-07-25 10:02:20,-36,10,46,点名其实是老师看当天来的人实在太少了然后报数，报数后交给课代表处理。老师是学历史出身讲课和马克思学院的老师不一样。两次展示一次论文。一直很努力的给学生好处，争取三七开等。第一次上课可能因为经验不足才打分那样，我是她第二次带的学生。个人认为只要兢兢业业完成了展示、论文、出勤，把平时分先拿到。旷课不交作业扣分很严厉。其实老师打分就是实打实的。所以没有师生情是真的，考试前一定要看一遍书。我最后4.2
58518,3743,王雪楠,2017-08-30 13:49:18,0,5,5,给1分是因为不能给0分 \n\n
58792,3743,王雪楠,2017-09-17 16:01:34,-1,1,2,呵呵呵
58798,3743,王雪楠,2017-09-18 01:38:42,2,8,6,新老师...不懂江湖规矩...大家看着办。有这么多评论了我也不需要重新写一遍哪儿差了…1分走起
58990,3743,王雪楠,2017-09-19 03:57:56,-1,4,5,辣鸡！！！
59134,3743,王雪楠,2017-09-20 01:51:22,-1,1,2,没听过
59248,3743,王雪楠,2017-09-20 10:57:23,0,6,6,超级垃圾
59326,3743,王雪楠,2017-09-21 01:54:45,-11,4,15,很好。
59333,3743,王雪楠,2017-09-21 02:31:32,23,42,19,想死。垃圾王雪楠，他妈的挂在这么多老师名下。上学期选了尤云弟，开始还很开心，后来发现是王雪楠就退课了，这学期选了王心月，又tm是王雪楠。现在的我想哭。
59351,3743,王雪楠,2017-09-21 03:22:31,5,12,7,学校这么做，大概是怕如果单独挂名开课的话，这个老师可能会没饭吃。
59367,3743,王雪楠,2017-09-21 04:30:44,-1,5,6,很混乱，很无奈。\n\n
59368,3743,王雪楠,2017-09-21 04:48:41,-1,4,5,就她自我感觉良好，给分渣到不行。
59378,3743,王雪楠,2017-09-21 05:38:32,-17,3,20,唔怎么说呢？第二学期还是比第一学期好很多了。最后3.9的绩点，当然不算高，可是也没有评论上面说的这么恐怖了。
59501,3743,王雪楠,2017-09-22 02:31:07,5,11,6,只要你努力，就能挂科\n\n只要你尽力，就能及格\n\n只要你拼命，就完蛋了
59505,3743,王雪楠,2017-09-22 02:38:40,4,8,4,反正怎么骂也上不了热评
59692,3743,王雪楠,2017-10-01 05:01:16,-2,5,7,吃了屎一般的体验
59710,3743,王雪楠,2017-09-26 05:36:59,-1,6,7,史纲一出拉低我0.22均绩，够形象不
59770,3743,王雪楠,2017-09-27 01:50:15,-2,6,8,sb一个
60063,3743,王雪楠,2017-10-09 07:13:36,-1,6,7,裂开了
60087,3743,王雪楠,2017-10-10 04:23:40,5,11,6,大二了，回来再来讲一讲这个老师，及其不负责任，大一上史纲下3，好多认识的人都被她的史纲拖到死。均绩掉0.1，且史纲算主修影响保研。
60111,3743,王雪楠,2017-10-10 14:29:32,-1,4,5,呵呵呵
60566,3743,王雪楠,2017-10-24 07:48:55,-4,3,7,真的是期待给分
60941,3743,王雪楠,2017-11-04 02:18:05,0,8,8,一副高高在上，老子就全世界最强的感觉\n\n
62143,3743,王雪楠,2017-11-22 14:28:44,-2,3,5,辣鸡哼╭(╯^╰)╮
62272,3743,王雪楠,2017-11-24 00:40:18,4,13,9,时隔一年的大二学长回来看，还是一句话:王雪楠，害了我大一上的成绩。孤儿！
62845,3743,王雪楠,2017-11-27 06:36:07,-2,5,7,听完课学会了忍住不打人
62851,3743,王雪楠,2017-11-27 07:02:30,-4,5,9,呃呃呃
63994,3743,王雪楠,2017-12-20 13:11:25,-1,7,8,人渣老师
64078,3743,王雪楠,2017-12-21 02:06:21,-4,5,9,我可以退课吗。哭
64088,3743,王雪楠,2017-12-21 03:01:51,-4,3,7,巨难受，想哭
64093,3743,王雪楠,2017-12-21 03:14:56,-4,3,7,难受啊
64111,3743,王雪楠,2017-12-21 03:59:01,-4,3,7,垃圾垃圾
64304,3743,王雪楠,2017-12-22 10:08:04,-4,3,7,真的垃圾
64562,3743,王雪楠,2017-12-25 08:16:09,-4,4,8,辣鸡不解释
64642,3743,王雪楠,2017-12-26 02:00:56,3,15,12,很好的老师呀～你们怎么这么说她呢～
64746,3743,王雪楠,2017-12-27 04:43:26,-4,8,12,下次来看病可能把她医死 hhhhh
64793,3743,王雪楠,2017-12-27 06:54:49,-7,4,11,3.9
64882,3743,王雪楠,2017-12-27 15:33:08,-2,8,10,不说了，别人上课做作业水手机3.3，我上课听她吹B2.7
64993,3743,王雪楠,2017-12-28 06:45:23,-3,5,8,一看到这名字就给退了
65074,3743,王雪楠,2017-12-28 13:29:15,-2,6,8,冒牌货
65115,3743,王雪楠,2017-12-29 02:34:14,-2,6,8,千万别选
65174,3743,王雪楠,2017-12-30 03:19:04,-4,4,8,扯淡，全是扯淡
65406,3743,王雪楠,2018-01-16 12:32:46,-5,8,13,垃圾老师
65518,3743,王雪楠,2018-01-05 03:37:20,-4,4,8,你懂的
65538,3743,王雪楠,2018-01-05 11:38:10,-4,4,8,体验很差
66002,3743,王雪楠,2018-01-11 01:58:40,2,20,18,不懂为什么评论里这么多怼老师的 老师备课很认真啊 读书报告每个人都给了评分和点评 讲课内容也很充实清晰 人也还算和善幽默 说她高高在上是什么心态 正常讲课罢了 说怼学生 都是就展示内容作评论 不存在人身攻击也谈不上怼学生这一说 你还要老师跪舔你给你当家教？ 期末准备了提纲重点难道不是为了我们自己认真复习期末多考几分？怼老师的时候你看书了吗背书了吗就怼 恕我直言 在这里说老师垃圾的 自己也没好到哪里去
66334,3743,王雪楠,2018-01-15 07:10:23,15,19,4,老师很不错啊，生物有趣，我是退了特地选她的课的\n\n
66410,3743,王雪楠,2018-01-16 12:40:51,-2,16,18,因为老师给分低要向学生道歉真是闻所未闻。
66421,3743,王雪楠,2018-01-16 07:46:35,-6,8,14,大家一起刷个1.0
66422,3743,王雪楠,2018-01-16 08:12:54,-5,9,14,如果不是查老师没0分，她可能连1都上不了
66428,3743,王雪楠,2018-01-16 08:53:11,-1,3,4,。。。
66482,3743,王雪楠,2018-01-17 03:12:43,9,17,8,老师上课其实是认真负责的，希望绩点能跟其他班差不多的基准上波动。
66698,3743,王雪楠,2019-09-28 08:00:16,27,36,9,很用心教学的老师，用心听，有收获。
66859,3743,王雪楠,2018-01-19 07:45:36,36,61,25,期末考前被告知绩杀...可是每项成绩出来全公布了，读书报告论文全有评分评语，平时成绩垒加起来也还可以了，我交白卷她绩杀么...不明白老师那么认真教学对学生，怎么会这样被骂！太颠倒太夸张了！让人能有收获的老师啊！！我学会了找文献，还有很有趣的家书写作。今天看了她给班上的论文评语想过来写点话给她的。太夸张了....匿评是这种暴力侮辱，我穿越回文革了吗？？
67219,3743,王雪楠,2018-10-22 02:35:49,55,112,57,不懂了我就！！！老师其实人还是挺可爱的（上课时候说，你们倒是抬起头来看看啊，应该是很无奈了），我觉得她年纪比我们大不了多少，也能明白学生想些啥，那么多评论说她不好只是因为绩点，但是这个学期的课每篇论文和读书报告都认认真真打了分写了评语，浙大这么用心的老师不多了吧？史纲课水手机不听讲的学生又有多少？自己想想吧！
70324,3743,王雪楠,2018-01-26 12:40:03,25,29,4,老师其实很好，之前不懂正态，现在给分正常啦！
70336,3743,王雪楠,2018-01-26 13:05:27,0,5,5,
70340,3743,王雪楠,2018-01-26 13:10:39,22,31,9,说实话王老师真的讲的很好的 绩点低了自己就在这里抱怨 请扪心自问自己究竟努力了多少 可能第一年老师不知道怎么评分 但后面真的改进很多了 如果你想真的学到东西 王老师是真的很好的
71325,3743,王雪楠,2018-02-05 01:40:04,23,40,17,这底下有些言论挺有意思的，我在这儿说上两句。第一，当年这位老师班级均绩远低于其他班，在学生要求核查成绩之后，该老师声明有一项平时分没加上，让学生等待改分，之后就玩消失，组长班长均无法联系到该老师，成绩至今过了一年了没改，这不是教的好不好的问题，这是人品问题。第二，你们口中所谓不公平不公正的低评分是怎么来的？是当时被迫上了这位老师的课的学生的真实评价！我们没有义务跟着这位老师的每一次教学班修改这里的评分！第三，也许这位老师认识到了自己的不足，在后来的教学班中表现好了点，但这能掩盖当初的错误吗？重修的绩点都不能覆盖了（笑）。
71404,3743,王雪楠,2018-01-28 11:47:45,30,39,9,4.5 我爱老师
71405,3743,王雪楠,2018-01-28 11:50:58,35,40,5,给雪楠姐打call\n\n
71408,3743,王雪楠,2018-01-28 11:51:59,56,75,19,老师现在已经转变了，已经不是绩杀了，讲课也很有意思，10分
71411,3743,王雪楠,2018-01-28 11:57:25,30,36,6,为老师洗白-2018学年弟子留
71412,3743,王雪楠,2018-01-28 11:57:40,47,53,6,老师的课说实话我觉得是讲得不错的，分数的事也已经做了改变，公正了很多，希望会越来越好。
71413,3743,王雪楠,2018-01-30 17:13:41,29,49,20,我觉的老师很不错 认真 生动 诙谐 幽默 批改也很认真 这样的老师都踩 是些什么样的人呐 顶王老师 我们支持你！
71416,3743,王雪楠,2018-01-28 12:00:30,39,52,13,每次论文两百多个人每人详细评语，每个组展示不管下面多乱都详细点评。其实这个老师真的一直都很好，只是之前一直给分太低，全班最高绩点3.3。BUT！可能是老师开始佛系了，从我们开始恢复正常给分！所以朋友们都选她的课吧！（没反话！）
71420,3743,王雪楠,2018-01-28 12:04:50,46,56,10,老师人真的超级好，我们坐在下面没怎么听课，她却非常尽职的给我们补充每一个知识点，我们交的论文，每一篇都会给出中肯的意见，并且指导我们考研方面的问题，真的亦师亦友。
71421,3743,王雪楠,2018-01-28 12:06:32,48,55,7,单口相声的赶脚，上课有趣，给分好，而且每篇论文老师都有认真看，都有评语，之前老师是不懂流程不会改分才被称为绩杀的，总之选她没错的。
71422,3743,王雪楠,2018-01-28 12:05:16,29,35,6,不知道为什么评分这么低，也许是今年考题变化+老师有了前面给分经验的缘故，这一次的史纲成绩还好。在成绩出来之前我就和朋友说，如果史纲上3我就去给老师好评(上3说明他起码并不像评论区里说的那样大绩杀)。刚预选上老师的课，看到查老师上的评论时我很绝望，但是后来发现老师其实挺有趣的，很可爱，对于我们每次的课前展示都会给很中肯到位的评价。尤其感动的是每一次的论文作业，老师都会很认真的看过，给每一个人评价，这一点让我非常非常感动。老师是非常好的老师，如果平时每一次作业大家都可以认真对待，考试也可以认真对待，那成绩应该不会差。真的很喜欢老师！！！！
71424,3743,王雪楠,2018-01-28 12:06:01,21,27,6,王老师迷途知返啦
71425,3743,王雪楠,2018-01-28 12:06:12,43,52,9,yep 听说是绩杀 还是选择接着听课。真的讲的很棒，可能是因为我本人对历史比较有兴趣，课上听老师侃侃而谈真是太羡慕了！和我高中历史老师风格非常像！然后老师课上还会卖萌，日常十二点（提早十五分钟）下课，日常在讲台上滑来滑去哈哈哈这次给分也非常不错嘻嘻嘻 隔空比心
71427,3743,王雪楠,2018-01-28 12:10:06,45,57,12,老师这学期给分高了许多（应该说和其它史纲老师同一评价标准了），很高兴拿到4.5。听老师的百家讲坛（评书）是种享受，对论文的评价用心有趣，怼人也说的婉转幽默，我忍不住把她的点评全看了一遍。平时事少，考前专门出了一份提醒给我们。总之，其实很喜欢她的个性和教学风格，推荐✧(๑•̀ㅁ•́ฅ
71428,3743,王雪楠,2018-01-28 12:15:33,25,38,13,我不知道为什么会有人抨击老师，上课认真讲课，作业论文每篇认真看过去，写评语，在我因为专业上有的一些问题焦头烂额的时候关心我鼓励我，真的对每位同学都很负责。她是好老师，不应该为以前的所谓给分差一直承受骂名。请那些上过老师课的人问问自己良心，无论是专业知识，还是人品方面，到底哪一点值得打1分？
71429,3743,王雪楠,2018-01-28 12:16:40,6,11,5,好吧 还可以
71432,3743,王雪楠,2019-01-03 09:00:26,81,119,38,绩点4.5，老师已经改邪归正了↖（^ω^）↗
71433,3743,王雪楠,2018-01-28 12:30:50,28,33,5,老师每节课准备的很多啊，但从不会拖堂；对待每次作业，老师也会非常认真地看，并且给评语；而且这次老师会调分，成绩是正常地给的
71438,3743,王雪楠,2018-01-28 12:38:58,18,22,4,老师很认真的讲课，即便知道我们有些人其实并没有在听。而且对于我们的读书报告论文，她都会很认真地看并写上评语。还很照顾学生感受，无论是评语的语气还是提前下课让我们吃饭，在熟悉教学之后，这学期的给分也不错。
71441,3743,王雪楠,2019-09-28 07:59:26,85,127,42,王老师真的很好…一开始看了查老师上的评分低的可怕还觉得自己期末绩点药丸，没想到绩点上4了。平常布置的作业和家书也很有新意。课堂展示的选题和评分，真的是能够提高逻辑能力和查找资料整合的能力，而不是像有些课程的展示一样只是走流程。\n\n最令我感动的一点就是，在写读书报告和家书的时候。每一位同学的作业都会写评语。想想那么多班级那么多学生，一个一个看完并认真点评是多么大的工作量。这真的太辛苦了。\n\n讲课的时候完全不按照课本，说实话因为课程表那一天是满课，我也经常翘史纲…而且除了展示，史纲的平时任务也并不多…考试之前根本就不用手抄笔记嘛，画一点关键词就行了，文科生应付考试轻轻松松，总之史纲真的是最轻松拿到高分的科目了。在此给大家安利一波王雪楠老师(๑´ㅂ`๑)
71445,3743,王雪楠,2018-01-28 12:52:06,24,31,7,这学期上了老师的课并没有那么糟糕啊，老师上课讲的很认真，有时候中间都不休息，很辛苦。而且论文作业什么的也很认真的批阅，给的评语也很认真。在考前还会提醒我们一些注意事项，最后给分也不错。很喜欢老师！
71451,3743,王雪楠,2018-01-28 12:59:27,27,31,4,之前看评论一直以为是绩杀担心的要死，其实说实话老师讲课很用心准备的很充分，论文也是每一篇都认真看过而且都写了评语，我没有担任任何职务没有展示没有发言过，最后绩点4.8，真的超级感谢了。
71455,3743,王雪楠,2018-01-28 13:09:42,27,34,7,老师会说很多有趣的东西，总之接地气，也会挑出你不知道哪个犄角旮旯里找出来的资料的毛病，做错了事也会痞痞地说不好意思，每次作业都很认真地帮每个同学写评语，收获最大的还是第一个学期是史纲教会我找各种资料，查数据。前两个学期老师刚上任，可能评分规则不懂，但这个学期老师给分很ok辣，4.5，安抚了我跳了两个考试周的心脏。考试前老师各种教怎么应考，我们班应该是资料最全的班了吧哈哈哈
71456,3743,王雪楠,2018-01-28 13:09:42,52,63,11,惊喜啊，不是绩杀了!平时会提前下课，每次345上她的课买学霸餐都不用排队?
71457,3743,王雪楠,2018-11-23 00:27:55,54,68,14,老师真的真的不是绩杀了，而且听她的课收货良多乐趣满满。最初遇到她上课，想到查老师评分考虑要不退课吧，但听了一节觉得超棒啊！就顺其自然了。两学期下来，真心觉得她各种意义上都是个可爱的老师。暖心或有趣的细节不胜枚举，其他评论也有所提及。总之，非常用心。4.8作参考。
71473,3743,王雪楠,2018-01-28 13:30:32,24,30,6,老师之前只是不知道评分的规则！今年改进超级多啦 而且人很好！给分已经提高更多啦！
71474,3743,王雪楠,2018-01-28 13:31:44,21,26,5,讲真之前看评价这么差还挺慌的……但是不得不说老师是个好老师 所有人的论文作业都会仔细看过去还会写评价 最重要的是真的真的不绩杀啦 认真付出还是会拿到理想的绩点的
71479,3743,王雪楠,2018-01-28 13:43:03,18,23,5,原来挂着王心月老师的名字发现是这个老师，查了老师之后只想退课? 但是一学期下来真的发现老师超级认真，论文都会认真看完，每个人都写评语，平时讲课也挺有趣，就是大家不太喜欢听?给分也算是很棒的了。
71487,3743,王雪楠,2018-01-28 13:52:40,17,22,5,老师人真的好，没有之前评论里那样绩杀（可能她之前不知道），总给我们提前放学，顶一波
71491,3743,王雪楠,2018-01-28 13:56:51,21,27,6,本来王心月的课但由王雪楠老师代课了  王心月老师来了2次  对比两位老师从听课感受和轻松度而言我觉得王雪楠好太多了  而且其实雪楠老师特别可爱  真的是很负责任的一个老师  把每篇作业都自己看过给分并且写了很用心的评语  我超喜欢她给我写的评语的  临近考试的时候还会给我们别的班没有的应考指南  告诉我们诸如一些（先做论述题之类）考试技巧   一开始因为查老师上的评论吓得我史纲课基本都破罐子破摔的  但出分后惊呆了  只要认真写作业  考试不太水（我因为论述题写的太久有30分时间来不及相当于没写但写了的题得分点应该都有了我觉得）  还是可以轻松上四的   大家因为被查老师吓到王老师已经很久没开课了  希望大家不要怕  我们这届真的很幸运遇到这样可爱给分好（重新做人）的老师  大家要相信老师已经变了！ 真的很奶思！
71495,3743,王雪楠,2018-01-28 14:02:48,4,12,8,王雪楠不绩杀了你敢信！
71515,3743,王雪楠,2018-01-28 14:30:55,12,16,4,很棒啊 给分不像传闻那么差
71522,3743,王雪楠,2018-01-28 14:38:57,15,20,5,王雪楠老师，我爱你!?
71532,3743,王雪楠,2018-01-28 14:54:34,6,16,10,大家扪心自问上史纲的时候在做些什么吧，一学期下来又付出了多少呢？大学生更应明白“师傅领进门，修行在个人”的道理吧。王雪楠老师讲的是有趣，如果单是课本上的内容浙大的学生都有能力自己看懂吧（问题是你去看了吗）；老师回答疑问时也很真诚，会分享她的经验；两篇论文提交后给每个人的评语也都很有针对性；考前的指南实用而充满喜感！老师现在给分已经变好了，我期末就拿了4.8，希望往后的同学能试着放下手机去用心听听看，不要太在意别人的评价，唯有亲身体会过才能形成自己的见解
71535,3743,王雪楠,2018-01-28 14:55:29,12,17,5,2017年秋冬学期，老师不绩杀了，感激…\n\n其实王雪楠上课内容真的不错，只不过曾经的超级绩杀导致这么低的评分。
71541,3743,王雪楠,2018-01-28 15:05:26,14,21,7,其他话不说了，真的不绩杀了，不，绩，杀，了！从良了，而且是很良了。十分！
71562,3743,王雪楠,2018-01-28 15:29:17,10,14,4,老师很棒，很认真
71585,3743,王雪楠,2018-01-28 15:58:14,7,11,4,后悔没有认真听，其实认真对待，总会有好结果。
71661,3743,王雪楠,2018-01-29 00:14:47,6,12,6,给分好，且公正
71714,3743,王雪楠,2018-01-29 01:39:22,4,14,10,雪楠老师真的讲课讲得很好，现在给分也是超公平的，你们不许喷学楠老师，拜托同学们多看看2018年1月的评论，不要被之前的评论吓到，我要为雪楠老师疯狂打call(*´∀`)~♥
71725,3743,王雪楠,2018-01-29 01:56:50,6,11,5,老师讲课很负责任，虽然说是顶王心月的名，但是讲课很认真，而且写的论文每篇都会写评语，给分也很好，感觉真的是一个很好的老师。
71747,3743,王雪楠,2018-02-03 07:36:43,7,15,8,老师很好。真的很好。关于绩点大概已经改了。我们的绩点都不错。
71756,3743,王雪楠,2018-01-29 02:44:53,7,14,7,我喜欢这个老师，有性格有专业还有韧性。上课认真但不教条。每篇论文无论写成什么样都作了不同评语。全班200多份，两次论文400多份。第一次读书报告也是胡乱弄，第二次认真写，评语特别中肯我喜欢！老师不管别人怎么骂你，我挺你，真的让我学到了东西，而且是在公共课上！！！
71822,3743,王雪楠,2018-01-29 03:58:44,6,13,7,很喜欢她，很棒很棒的老师，很认真负责，每一节课都很用心地备，每一篇论文都认真看，还给写十分贴切的评语，给分也很好！强烈推荐！
71825,3743,王雪楠,2018-01-29 04:00:06,4,9,5,其实老师讲课真的蛮有趣的，切入的角度很特别。
71861,3743,王雪楠,2018-01-29 04:44:41,-1,8,9,大绩杀
71869,3743,王雪楠,2018-01-29 04:56:11,4,10,6,读书报告写的评语挺有趣的。永远十二点下课！给分还行。
71932,3743,王雪楠,2018-01-29 06:13:30,4,12,8,终于走了不送
71975,3743,王雪楠,2018-01-29 07:14:24,4,13,9,都说是绩杀   可是我4点5啊  我觉得挺满意的啊
72066,3743,王雪楠,2018-01-29 09:35:24,-2,9,11,坑了一届学生……
72114,3743,王雪楠,2018-01-29 14:19:56,1,15,14,没听过老师的课的我来这边给了十分，主要是想说，我浙学子的素质就是在遭遇不公平（假设王雪楠老师的确是造成了相对严重的不公平）的情况下骂人死全家和孤儿？我三本浙就没有更加文明理性的方法表达自己的意见了？这样的同学，尊人尊己都不知道，如果我是老师，这思修课还能及格？
72449,3743,王雪楠,2018-01-30 06:55:07,0,10,10,认真负责的老师啊 也不绩杀了。骂人的人嘴吧能再脏点?
72594,3743,王雪楠,2018-01-30 13:05:47,-3,10,13,上课看到那么多人玩手机就预感考完这群人要炸。没付出怪别人给分不够水罗，看这些留言还以为是混社会的莽爱家族论坛呢，咋招进来的？
72671,3743,王雪楠,2018-01-30 22:56:07,6,11,5,很认真负责的老师
72683,3743,王雪楠,2018-09-18 00:21:17,-24,25,49,觉得还好呀，虽然可能因为年轻经验少，但是很努力呀，不知道为什么这么多同学会用那么恶毒的话去评自己的老师，因为老师给你的成绩低了？有没有想想自己为什么没有好好学？居然还有同学因为老师没给他改分所以给了很低的评分，真心很好笑！
73067,3743,王雪楠,2018-02-01 00:51:53,8,14,6,思维清晰，受到过规范的训练，学识渊博，确实专业。开放性和启发性有待提高。
73503,3743,王雪楠,2018-02-01 23:39:36,6,11,5,以前看到的都是喷王雪楠老师，起初我也怕怕的，其实老师很好，很负责的，两次作业都有评语，有的评语很幽默风趣，喜欢，平时12:15的课12点准时下，思政课浙大学生有几个会好好听，但是老师还是好好的讲下去，至于绩点认真一点还是比较好看的，
74076,3743,王雪楠,2018-02-05 02:00:20,4,9,5,看查老师上那么多说老师绩杀，刚开始觉得很害怕，史纲课本来就无聊，上课也没怎么好好听，读书报告论文稍微认真一点，最后几点还是上四了，老师挺好啊！
74119,3743,王雪楠,2018-02-05 09:41:25,-4,10,14,本来看查老师下一片差评想退了的，但错过了退课时间。上课后觉得老师的讲的很的玩，就一个的期中论文，一个期末论文，加几次展示，基本是么都没做，但这次给分很高?
74377,3743,王雪楠,2018-02-16 00:06:53,8,13,5,从良不过她课开不下去了，你以为这么多人上史纲就你认真？论文一个字一个字自己写，考试认真准备，最后来个2.7，当年主修掉0.3你们怎么说？她对我们这届负责了吗！说了改分，然后关机？你们现在反过来喷我们？要不是课开不下去，出来又是二点几你们怎么说？\n\n
74434,3743,王雪楠,2018-02-23 12:25:48,2,2,0,too young too simple
74593,3743,王雪楠,2018-03-04 11:04:16,8,14,6,在2.7的恐惧中活了一学期结果最后上4了！后来的同学看看最近的评论！不要担心！
74610,3743,王雪楠,2018-03-04 14:57:03,4,12,8,没人指望往届的来这里修评分 但起码不要吓退想选一个靠谱老师课的学生
74636,3743,王雪楠,2018-03-05 02:23:46,-7,8,15,emmm看评论一度吓死。但是王老师真的从良了啊！！！可能相比别的老师平时事情多了点，两篇论文和很多次展示，还买了本无用的辅导书，而且我一个高中学历史的上课惯常听不懂（但是史纲课为什么要听懂呢(♡˙︶˙♡)）……然而王老师人还是蛮幽默的，每次提前15min下课让我们早吃饭，绩点也不错\n\n综上，1.5的评分低了点，从良后的王老师还是可以选择的
74691,3743,王雪楠,2018-03-05 06:14:57,-3,0,3,。。。。。。
75029,3743,王雪楠,2018-03-07 05:20:06,0,9,9,新一届表示老师给分还是可以的。讲课好，特别好，能学到很多东西。希望大家别被以前的评论蒙蔽了。
75066,3743,王雪楠,2018-03-07 07:49:59,5,11,6,老师可以从良，绩点可以覆盖吗？况且这根本不只是绩点问题，更是人品问题，我还给1分，永远给1分，这届如何我不管，反正王老师在我心里永远是一个大大的1
75096,3743,王雪楠,2018-03-07 10:28:43,0,7,7,老师真的挺好的，讲的好的给分也好!
75119,3743,王雪楠,2018-03-07 11:39:20,9,14,5,有些人得了高绩点，他们说老师好就算了，喷某些诋毁就算了，他们竟然喷所有之前的人！那个说我们不认真的，你自己配不配4。5的认真？如果你配，那你班上多少人配？有个人说了真话，他本来不在乎成绩就想水水的。有些人只不过意外得了高绩点还卖乖罢了。
75213,3743,王雪楠,2018-03-08 04:15:31,-3,1,4,听说程老师的课王老师来带了 有点虚
75411,3743,王雪楠,2018-03-11 09:55:45,-1,0,1,...
75429,3743,王雪楠,2018-03-12 01:27:13,12,16,4,浙大卢本韦，听说卢老爷最近从良了呢，卢老爷真是个好人呢?求问刚上完课的小朋友们。
75437,3743,王雪楠,2018-03-12 01:55:45,0,2,2,呵呵呵
75499,3743,王雪楠,2018-03-12 13:08:13,0,10,10,被口水淹没的、但好好讲课的老师。来这里是学东西的，幸亏自己不太迷信。
75736,3743,王雪楠,2018-03-16 02:00:55,27,37,10,一群何不食肉糜的新生。王老师改了，是好事，你拿了高绩点，是好事，但是这能否定她去年的恶意低分和说话不算话吗？什么叫“不懂为什么有人骂她”？这种思维真的有认真学历史？拿了4.8 4.5觉得自己真是叼的不行了？
75856,3743,王雪楠,2018-03-20 03:37:36,-4,2,6,挺不错，有干货
76821,3743,王雪楠,2018-04-24 07:15:10,20,26,6,你们这帮人，不知道王雪楠所有三百位学生，最高绩点3.6是什么感觉吧？班级均绩2.4是什么意思？从不从良我不管，我没事儿过来给个低分就是了。\n\n\n\n毒枭发誓以后不贩毒，就是无罪了？
77324,3743,王雪楠,2018-09-17 03:07:37,94,126,32,希望那些怼往届学长学姐的小渣渣们闭嘴，如果不是王雪楠给我们低分，教务处会找她谈话？你们绩点还能上3上4？真是猪八戒倒打一耙。
77462,3743,王雪楠,2018-05-11 03:31:29,-1,2,3,辣鸡，请问您有没有脑子
77699,3743,王雪楠,2018-05-07 10:30:14,-9,2,11,真的很好
77814,3743,王雪楠,2018-05-08 02:49:51,-6,7,13,想要为王老师正名
80242,3743,王雪楠,2018-06-22 13:55:24,18,22,4,被绩杀的小白鼠时隔很久来评论。看到最新评论里说老师从良了，也的确觉得自己不应该戴有色眼镜看她。但是不可能的：）她当年是出分之后承诺要改分，结果过两天手机关机联系不到。如果没有史纲的这个成绩，我现在的绩点应该会好看很多。怎么说呢，老师从良是好事，但是这并不能抵消她对我们这几百人造成的影响。也希望小朋友们体谅一下我们的心情啦……
84076,3743,王雪楠,2018-07-12 03:23:49,2,10,8,现在老师给分已经正常了，不希望这么低的评分再挂在查老师上了。雪楠姐真的很可爱的，平时上课也很有意思，认真听是有很大收获的！以及作业也很有新意，每次都会有点评，即使吐槽了一点给分也是很善良的，最后绩点4.5，真的很感谢老师，希望大家不要再有看评分产生的偏见了~
84903,3743,王雪楠,2018-07-14 09:41:22,-1,1,2,挺有趣，作业评语很搞笑\n\n
85973,3743,王雪楠,2018-08-26 09:46:00,3,4,1,呵呵呵
86196,3743,王雪楠,2018-09-10 10:17:07,0,4,4,辣鸡\n\n
86376,3743,王雪楠,2018-09-14 09:10:18,1,8,7,每篇论文和读书报告都认认真真打了分写了评语，付出会有收获，跟一个负责的组我觉得可以了，而且老师真的很热爱历史了
86546,3743,王雪楠,2018-09-17 06:33:44,-1,2,3,无聊，困
86670,3743,王雪楠,2018-09-18 02:18:08,2,4,2,
86811,3743,王雪楠,2018-09-19 02:02:23,4,7,3,混了一学期，都按要求做，期末瞎考，还是有4.2感觉给分好多了
87031,3743,王雪楠,2018-09-20 04:24:21,4,12,8,实锤好老师，新同学请不要被带节奏
87033,3743,王雪楠,2018-09-20 04:27:38,3,8,5,老师的课挺好的，很幽默。作业也有新意，学分上也为学生考虑。绝对是一个好老师！大家不要被之前的评论影响。
87034,3743,王雪楠,2018-09-20 04:27:52,-1,7,8,好老师啊
87042,3743,王雪楠,2018-09-20 05:17:35,6,20,14,我是来给王雪楠老师平反的！老师人真的挺好的。绩杀现在是不存在的。王老师上课很有趣，一下子就抓住了我学历史的好奇心。（虽然我原来就学历史，比较喜欢历史）老师的课堂也很幽默有趣，不存在怼学生这会事吧。而且我觉得最重要的一点是，可以不写论文！老师情景带入写家属的方式很新颖有趣，课堂讨论的方式也多种多样，可以个人展示，可以组队表演微型历史剧，不擅长表达的可以选择写作文！反正我是不相信王老师只有1.1评分的。
87044,3743,王雪楠,2018-09-20 05:28:39,9,11,2,初来乍到，吓我一跳
87168,3743,王雪楠,2018-09-21 06:15:30,17,20,3,感觉非常好，因为我退了
87321,3743,王雪楠,2018-09-27 04:03:28,4,15,11,给了我非常大的惊喜。本来对史纲这种思政课不抱什么期待，结果老师讲课非常生动精彩，明显能感受到是有想法有水平的。我不知道她和往届的各位有什么恩怨，但是这个分数对她太不公平了。
87599,3743,王雪楠,2018-10-08 05:49:22,3,4,1,唉～！！
88272,3743,王雪楠,2018-10-25 10:27:29,2,5,3,各种作业，家书，测试，忙死忙活，最后啊。。。\n\n
88276,3743,王雪楠,2018-10-25 12:15:17,0,4,4,还行，好很多了。
88284,3743,王雪楠,2018-10-26 12:35:10,1,3,2,时运不济
88920,3743,王雪楠,2018-11-12 10:22:24,0,2,2,好有趣
89216,3743,王雪楠,2018-11-17 03:03:16,0,6,6,我哭了，王雪楠老师现在变了吗
89959,3743,王雪楠,2018-11-21 11:31:44,10,13,3,大一上的是各种通识课，现在大二要上各种专业课了，发现专业课和通识课差别挺大。最大的差别在于，专业课的老师会把你当自己的学生，所以要求很高；通识课的老师，很多时候都“多一事不如少一事”。\n\n所以，遇见一个会亲自看你作业，写评语的通识课老师，就不要错过了。这是给以后会参考查老师的学弟学妹看的，虽然王雪楠老师之前可能因为绩点问题被打了很多低分，但是，现在绩点已经是正常水平了。老师本人的态度和水平都是可以的。听过别的老师的史纲课，觉得王雪楠老师的史纲课真的很好。了解了很多不一样的历史，真的是干货，不带水分。至于任务不一定多，而且和专业课相比，可以说很少。
90092,3743,王雪楠,2018-11-22 06:04:23,1,5,4,其实海星
90256,3743,王雪楠,2018-11-23 00:41:27,4,11,7,好像好评都是2018-1-28发的，怀疑刷好评
90979,3743,王雪楠,2018-11-28 10:10:13,6,8,2,讲的很好，听课可以学到从多角度去分析事件，感觉老师超级有水平
91030,3743,王雪楠,2018-11-29 05:54:42,3,7,4,老师上课真的很有意思！任务也不算多感觉。
91713,3743,王雪楠,2018-12-18 10:39:25,7,13,6,1.听一句劝：史纲课想少点作业、任务的，赶紧选别的老师的课；一学期两论文两家书的量真的多\n\n2.近代史王雪楠老师讲得真的不错，不过可能院里老师水平都不错，不存在讲错或者敷衍的情况\n\n3.还没考试，抛开分数的因素，从上课的角度来看，老师人其实挺好的
91840,3743,王雪楠,2018-12-22 07:55:33,4,17,13,再怎么样也不能弥补她在我大一留下的创伤，拼死拼活付出那么多，最后那么难看的绩点，对于大一第一学期初到浙大的我来说，就是摆明了告诉我大学的成绩靠努力是没用的，隔壁同学一次课没去过最后轻松4.8，不是运气还是什么？有些错误可以被原谅，但是这背后的心酸太多了。来自即将申请出国的人的控诉！
92342,3743,王雪楠,2019-01-07 06:53:14,-7,9,16,傻逼老师，不负责任
92408,3743,王雪楠,2018-12-28 09:43:27,-6,4,10,差劲?
92608,3743,王雪楠,2019-01-31 12:26:15,17,29,12,我爱雪楠！！没有绩杀了啊啊啊啊！4.2超级开心了！家书展示好好做考试使劲儿写绝对不会差的！！
93053,3743,王雪楠,2019-01-07 06:52:57,10,13,3,还可以，课堂效果不错，但是老师毕竟年轻，有点意气用事，印象最深的：用人话概括一下……还有，这位老师是真的喜欢历史。
93126,3743,王雪楠,2019-01-07 12:25:15,2,7,5,还是要看个人感觉…
93698,3743,王雪楠,2019-01-12 03:11:23,6,12,6,很好(✪▽✪)，绩点4.8
93726,3743,王雪楠,2019-01-12 12:21:01,4,9,5,666
93791,3743,王雪楠,2019-01-13 19:27:15,7,12,5,好！好好！！好好好！！！
93813,3743,王雪楠,2019-01-14 01:57:59,4,10,6,！！！
94047,3743,王雪楠,2019-01-15 04:15:07,10,15,5,好就完事了
94175,3743,王雪楠,2019-01-15 12:13:27,11,16,5,正名+1
94681,3743,王雪楠,2019-01-17 18:17:05,-2,17,19,我只想说：现在的太平盛世是无数前人的鲜血换来的！！！
94792,3743,王雪楠,2019-01-18 07:06:15,-16,19,35,虽然王老师这学期已经变好了，但是我还是给了一分：请您站出来给学长学姐们一个均绩2.7的理由谢谢。为人师表是要承担责任的，忘记过去就意味着背叛。
95773,3743,王雪楠,2019-01-20 04:31:28,1,11,10,没有先辈们的鞭策，轮得到你们说王老师好话？
96238,3743,王雪楠,2019-01-20 14:50:29,2,6,4,太水了，我一学期没带课本\n\n
96467,3743,王雪楠,2019-01-21 04:41:03,7,10,3,我觉得老师挺好的，上课也挺有趣
96871,3743,王雪楠,2019-01-23 11:46:48,-3,2,5,呵呵呵
97121,3743,王雪楠,2019-01-21 16:31:38,12,15,3,（试毒完成）老师当年年少无知，给分可能的确不好，，但是到我这届开始就超好了，老师是真的挺好的，现在给分挺好的，我们组3.5、4以上也有好几个，大家可以放心选了
98223,3743,王雪楠,2019-01-23 08:15:04,13,22,9,我都大三了，110分的课程，点开学习帝，去掉史纲，绩点涨了0.03.真的跪了
98750,3743,王雪楠,2019-01-24 01:23:06,14,36,22,我咋就这么好奇那些学长学姐这么强调自己的苦难与冤屈。亏你们还年长，越长越幼稚啊。谁没遇到不公平的待遇啊，在这里泄愤有意义吗!老子军训思修都被绩杀，就一科好，这给你们气的。有本事你们线代微积分都满绩啊。我们拿比你们高的绩点对你们是有啥威胁，高中没毕业吧。弟兄们帮我顶上去!
99050,3743,王雪楠,2019-01-24 07:51:10,8,12,4,楼上的暴躁老哥，你消消气。你想想查老师才出来几年，楠楠要是继续保持下去她的评分最终会提高。毕竟愤青和键盘侠常常被历史抛弃...
100499,3743,王雪楠,2019-01-26 08:10:13,0,6,6,老师上课很不错，作业也很少，教学模式较新颖，人也挺不错。只是也许会遇点不公，但是生活就是这样啊
100992,3743,王雪楠,2019-01-27 08:48:28,2,2,0,有点困
101034,3743,王雪楠,2019-02-01 03:39:49,11,13,2,老师讲课很有趣
101083,3743,王雪楠,2019-01-27 12:25:35,4,7,3,老师讲课真的超级棒啊，会讲到很多很有意思的事情，如果对近现代史有兴趣的话强烈推荐她啊，不是单纯的红砖。不过如果真的单纯去水课的话还是算了一学期两篇小论文两篇家书1000-1500字。老师改作业超认真，会对每篇交上的家书核对史料，查重，作业认真写分不会低。不过期末考是真的难。
101085,3743,王雪楠,2019-01-31 15:39:02,5,16,11,4.2……均绩还是被无情拉低，意料之中，毕竟平时分很低。感觉家书没什么问题，抗战家书我连写信的语法都极力贴近当时的用法，不知道哪里出了差错，都只有7分，老师也没给具体理由。总的来说……这个老师还可以，没有很绩杀啦，不过还是慎选。
101109,3743,王雪楠,2019-01-31 16:18:46,15,24,9,被绩杀了不高兴，要喷就喷我，我就是不高兴
101156,3743,王雪楠,2019-02-01 00:51:33,12,28,16,我选的是思政课里的史纲课，不是历史专业的专业课！王老师能不能搞清楚自己的定位和应该对学生的要求！我当然承认你备课用心安排作业用心改作业用心。但是！①上课不用教材，讲课内容和教材差距大，我上史纲课又不是历史课，我既不关心历史真相，也不关心你所讲的什么教材逻辑零碎。②课时安排不合理，讨论时间不订好，第一次两大节课讨论，第二次一大节讨论，王老师身体不适一大节课放视频，国庆中秋放假，才讲了几节课？③作业安排要求均不合理，展示放考试周还嫌学生质量差，要求又那么高，凭什么一群非历史专业学生为了史纲的一个作业去调查一个事件几天几夜查各种资料文献数据库，您还这不满意那不满意。认真做作业凭什么给承诺的最低分？平时分表拿出来一看，一大片最低分。我倒想知道您要求是要多高？家书糊一个和认真肝分一样，展示肝了半天因为王老师之前把时间要求无预告缩短而被迫提前中断而让上台的人无比尴尬 。展示过程还经常打断，直接就问一个个专业/深层次问题，非要学生答不出来才高兴吗？④学生面前和颜悦色，打起分来惨不忍睹。考前特地强调平时分会给好，还给出了给分区间，结果？？大量人在给分区间最低分好意思吗？别的班史纲分早出了，您拖到现在才给个平时分的一部分，给出来的分就这样？既没有区分度又不让人信服。大量低分寥寥无几的高分真不知道是怎么判的。别选别选，毕竟江山易改
102209,3743,王雪楠,2019-01-31 12:07:21,-2,2,4,1分不谢
102210,3743,王雪楠,2019-01-31 16:18:26,-3,3,6,想爆粗口********
102214,3743,王雪楠,2019-01-31 12:23:13,0,3,3,呵呵我就呵呵
102215,3743,王雪楠,2019-01-31 12:33:34,-3,4,7,说实话，原本以为要被绩杀的，但89的分数让我很惊喜，本来以为绩点要下4的。而且平心而论，楠楠讲课还是挺有意思的，我宁愿翘专业课都不想翘的楠楠通识课，而且作业相较于其他老师也不多。至于那些喷老师不讲课本的，说的和讲课本你就能考好似的，史纲这种通识课这门课本身就是为了增长见识准备的呀，反正我基本没学课本算下来卷面分也不低。
102216,3743,王雪楠,2019-01-31 12:36:17,0,4,4,客观说，老师上课内容比较有趣，而且老师本身性格也比较活泼，开朗，挺好的。现在老师已经不是绩杀了。只要平常展示认真做，家书认真写，不抄袭。考试前把书翻几遍，熟悉目录，书本知识结构，期末考试时翻书也比较有效率。然后注意应试技巧，先做论述题什么的，最后做选择题。这些都是我这学期的体会，希望对大家有所帮助。
102220,3743,王雪楠,2019-01-31 13:11:21,7,9,2,老师会认真的看你的家书，用诙谐的语言直接指出你的历史错误，并且，现在评分很好。绝不绩杀。老师讲的历史恰恰是我们这些年纪的人最感兴趣的，能以批判性观点去看待历史事件。表白楠哥！
102225,3743,王雪楠,2019-01-31 13:46:57,-3,6,9,老师真的没你们说的那么不好 一学期认认真真完成作业和展示 有4.8真的很开心 而且任务也没有特别重 最后考试的时候按照老师说的答题顺序做会顺利很多
102226,3743,王雪楠,2019-01-31 13:47:31,2,4,2,老师讲的真的很好
102228,3743,王雪楠,2019-01-31 13:51:06,3,6,3,来吹一波楠哥！！讲课生动可水可不水 家书作业超级有趣 小组展示也超级棒！期末开卷给分好！吹爆！！
102231,3743,王雪楠,2019-01-31 13:56:09,2,5,3,楠哥很好啊我觉得！作业认真做叭，难度也不大其实，最后绩点4.2。在我所有的通识课里面我觉得楠哥算得上很认真而且带着脑子上课的。（diss某个喜欢上课提问弱智问题的思修老师hhhhhh）
102233,3743,王雪楠,2019-01-31 14:04:08,7,11,4,我想说你家书被给低分的，是不是通篇抄的被发现了，老师都指出抄的哪里的，这有什么好呵呵的，敢随便网上找一篇当作业，还不敢来点低分吗，
102234,3743,王雪楠,2019-01-31 14:01:11,3,6,3,老师的课很有意思，作业好好完成，期末前多翻翻书熟悉教材，按老师说的顺序来做，最后89真的感谢老师，老师绝不会绩杀！
102236,3743,王雪楠,2019-01-31 14:02:18,3,6,3,我觉得楠哥很好啊，给分好，平时的作业也不麻烦，只要不抄袭就可以拿到好分数了！！还有家书作业的点评很有意思，考试技巧也很有用！！
102237,3743,王雪楠,2019-01-31 14:08:08,-8,6,14,我就来说说有多不负责吧。首先，史纲这种长学期3分课不建有老师的大群，所有的事情都让课代表搞得像军机处一样跪受笔录上传下达，课代表也不是特别到位，很多文件和通知发的也不太及时，上交家书和展示分工也很随意，到考完以后还因为自己文件保存失败在组长群里催组长交家书。就我所知隔壁yyd老师是有大群的，这点可能是我玻璃心也就算了。其次，每次签到点名都是走个形式，随随便便让组长点一下，其实教室里一看就知道起码有二十几个人没来，很好奇每次为啥只有两三个人是真正请假的。再次，平时分出的巨晚，我本来寻思着您是打算大年三十出分让噼里啪啦的鞭炮声掩盖过学生的骂声，而且小组长评分和小组展示的最终结果也不明不白的，两篇家书的好坏并不与学生的真实水平成挂钩，认认真真和随便写写也没有啥太大的差别。最后，我能够听王老师的上课的时间是真的太少了，一学期好多节课都是不在的，本来高中学文科的还打算认认真真学习中国近现代史纲要，没想到连受教育的机会都直接给我剥夺了。给分挺随机的，就看之前的几条压线评论感觉也不存在着调分，但是不知道为啥出分就是很慢。总之就是，要是渴望事情少并且不担心给分的同学可以选，因为你几乎感受不到老师的存在，全程就只有组长和观察员陪你度过漫长岁月。祝大家新年快乐吧。
102238,3743,王雪楠,2019-01-31 14:11:36,-1,2,3,其实老师讲的很棒，会有很多以前不知道的故事，而且作业只要符合史实，别太放飞自我，别抄袭，一般都不错的
102243,3743,王雪楠,2019-01-31 15:00:51,3,5,2,楠姐人真的挺好的说实话，上课用自己的方式讲课不会显得很古板，而且12点准时下课，作业平心而论也没有那么的多，最后分数给的也还可以。
102244,3743,王雪楠,2019-01-31 15:02:57,1,4,3,海星，给分虽然慢但是还行，可以看老师是在尽量让我们绩点好看一点的。写家书感觉比写论文真的要轻松很多...另外，感谢那些家书抄袭的...你们如果有在这喷也没啥意思吧。
102245,3743,王雪楠,2019-01-31 15:05:28,0,1,1,比预计的好
102246,3743,王雪楠,2019-01-31 15:13:32,3,3,0,出分慢死了
102247,3743,王雪楠,2019-01-31 15:14:17,1,2,1,还好，最后绩点还不错，老师讲课挺有意思的，其实只要家书展示好好做，期末稍写写，成绩都不会差的
102248,3743,王雪楠,2019-01-31 15:15:21,1,2,1,谢老师不杀之恩。
102249,3743,王雪楠,2019-01-31 15:17:04,-1,1,2,我上课挺水的，其实不太喜欢王雪楠老师，但是这这学期下来觉得老师讲的挺好的，可能给分不是太满意吧，不过绩点上4应该挺容易的了现在。
102253,3743,王雪楠,2019-01-31 15:24:49,3,3,0,没啥区分度的感觉
102254,3743,王雪楠,2019-01-31 15:36:27,1,4,3,emmmmmm虽然之前很多人说王老师给分很差，但是现在给分真的还可以吧，平时70%的分数，我觉得给的都很好，我一个历史不通的人，还是有4.5，现在给分还是挺好的，一个组里，只要不是老缺勤，基本都在3.8-4.5之间吧，再高的很少见(至少我还没见到。。。)\n\n\n\n王老师上课真的有意思，会用很趣味的方式来看历史，不枯燥，很容易理解。(虽然会明摆着告诉你考试不考PPT上讲的，只考书上)\n\n课堂展示还是有点东西的，比较好玩(如果真心做的话)。不写论文写家书，比那种东拼西凑的尴尬的干巴巴的论文有意思。\n\n
102256,3743,王雪楠,2019-01-31 15:27:43,2,6,4,为了让老师早点摆脱低粉魔咒来评论一句 肯定是给调分的 在班级中等水平的绩点不会下4 此外如果对历史真相和历史人物的踌躇心酸感兴趣的话 王雪楠是很好的选择。
102259,3743,王雪楠,2019-01-31 15:32:44,2,4,2,老师挺好的啊，给分还行。讲的也挺有意思的。原来可能比较不友善？
102260,3743,王雪楠,2019-01-31 15:33:49,6,8,2,成绩拖到现在终于出了…虽然老师给分还是比其他老师低，但是也比以前2.7那个好多了。客观的说老师的一些方法确实比较新，像两封家书和讨论课确实比较有意思，认认真真查资料搞采访之后两封家书都给了我9分。至于最后成绩不够理想，自己考的差也占了很大的原因。
102264,3743,王雪楠,2019-01-31 15:40:43,4,5,1,水平可以 但今天才给分...有一点点慢（无所谓咯
102267,3743,王雪楠,2019-01-31 15:43:07,12,13,1,王老师真的是被误解了，或许之前真的有不足，但是作为新生，刚刚上过她的课我能感觉到；\n\n1.为人风趣幽默，上史纲课讲的是真正的历史，有着特定时代的特定历史魅力。\n\n2.会点名，一学期五次（这是教学任务）\n\n3.形式很丰富，不用写史纲论文，只需要写两篇一千字左右的家书，抗战家书和改革家书，反正个人感觉比憋史纲论文好多了。\n\n4.会提前下课，一般提前十五分钟。\n\n5.特别用心，讨论课很认真听我们讲，做思维导图，考试前，其他史纲老师都没提注意事项，她提了好几遍，还给我们专门写一个pdf提醒。\n\n虽然我绩点不高，但她真的是一个好老师，选到她的人可以偷着乐了，至少史纲课不会无聊，充满乐趣。
102272,3743,王雪楠,2019-01-31 15:50:36,4,6,2,老师挺好的，说坑的那也是历史了，只要做好学生的本分，都能得到一个满意的分数。
102277,3743,王雪楠,2019-01-31 16:12:01,-2,5,7,为老师正名：之前是因为老师按四分制正太，所以普遍分低。扪心自问这一学期我一节课没听过，考试全靠翻书，也一点都没复习。最后4.2，真的很满意。老师上第一节课就说：爱听不听，可以玩手机睡觉。我觉得老师也知道这是水课。真的是很好的老师了。
102278,3743,王雪楠,2019-01-31 16:12:24,8,9,1,王老师真的应该比这个分高? ? ?
102279,3743,王雪楠,2019-01-31 16:13:08,6,7,1,老师真的是一个好老师，上课讲得很生动，有时候还有段子，平时也很认真负责。一口气连讲两个小时就是为了能让我们12点下课（很少会12点之后放），她那天生病上午在打点滴，因为同学问讨论课和家书的要求下午就发了要求，还有快考试了有同学不知道怎么复习她还给了一个很幽默的考试指南，考试前一天还又特别发了一个很可爱的提醒，还有每个板块都会给四维导图（每个导图我自己的亲身经历感觉是要花好几个小时）。我对历史真的无感，但是楠姐的课真的很有趣，家书和展示会有很幽默的评语。最后给分4.5，很满意了，毕竟自己在家书和讨论课上的表现很一般。
102280,3743,王雪楠,2019-01-31 16:19:11,3,5,2,讲课实在棒，史纲这种无聊的课都能上得很有趣味，能了解到很多课本以外的历史。之前以为大绩杀 出了分看，给分也实在太好了吧\n\n超赞，建议选
102283,3743,王雪楠,2019-01-31 22:51:19,10,11,1,一开始看到1.1我是方的。但是上课下来我发现老师怎么会是1.1的呢。上王老师的课只要好好完成讨论和写作就可以拿到满意的成绩了。而且老师还会在期末考试前整理好多注意事项和答题方法，真心是一个好老师。上课也十分有趣。或许过去老师是1.1，但现在肯定是一个9分以上的高分老师。
102284,3743,王雪楠,2019-01-31 22:55:48,8,9,1,讲课超有趣。这学期最后悔的就是没有坚持好好听课。老师的作业很有趣，小论文也反恶竞，不会看字数。最后给分很好！
102285,3743,王雪楠,2019-01-31 22:56:51,5,7,2,选上这门课的同学就安安心心上课吧，你们将获得一学期干货满满认真教学的史纲课，每节课前老师还会发思维导图帮助理解，平时作业是两篇虚构的历史家书，两次课堂讨论。重点是期末考试!你将获得王老师独家制作发行的期末应试指南，包你史纲不挂科。            王老师有点萌，“同志啊我求求你们把作业交上来，要不然都没法给你们分。”    出分有点慢，但认真负责，原定昨晚8点出分，发现一些小错误，又全部核查一遍。          是个靠谱的老师，为她打call
102287,3743,王雪楠,2019-01-31 23:11:53,1,5,4,我感觉挺好的，付出与回报成正比，挺棒的，不像高数老师他妈胡乱给分。
102288,3743,王雪楠,2019-01-31 23:36:11,5,7,2,老师上课氛围轻松，给分不错的
102289,3743,王雪楠,2019-01-31 23:39:23,4,6,2,老师是真的优秀
102290,3743,王雪楠,2019-01-31 23:50:47,3,5,2,老师非常皮非常可爱，也不是绩杀
102291,3743,王雪楠,2019-01-31 23:56:58,6,7,1,是很负责的老师，我给老师写过几次邮件，基本上很快就能有答复。室友说史纲课水水就行了，我试着在王老师的课上水，水水就开始听课了！老师很萌吖，很有意思的。现在的老师已经不是以前那样的所谓的1.1了。给分很好噶。
102294,3743,王雪楠,2019-02-01 00:15:37,5,6,1,老师评分真的挺好的，而且事真不多。我记得当时家书我没认真审题全离题了，我觉得自己完了，期末考前几天发邮件给老师问能不能重写，老师立刻就回了，说问题不大，放心准备考试就好，当时真的挺感动的，最后成绩也很好
102295,3743,王雪楠,2019-02-01 00:54:44,3,7,4,上课真的讲得很好，能带来很多启发，让我重新思考历史，而且最重要的是，给分真的已经很好了，非常非常好了(●°u°●)​ 」
102297,3743,王雪楠,2019-02-01 00:44:55,10,12,2,看以前的评论感觉这位老师特别恐怖，但是就我这学期的上课经历来看，她的课还是十分有趣的。诙谐幽默的语言，百听不厌的“同志们”，以及她不强求同学们学习历史。她说过类似“我上课是因为我真的喜欢历史，我不会强求你们上课一定认真听，因为并不是所有人都喜欢历史”。确实，上课喜欢历史的同学可以听的津津有味，她会教授书本上的知识以及（划重点）某些历史事件发生的前因后果，各个政治势力的立场与做出决定的合理性。总之就是解决了我以前存留的许许多多的问题，例如从多方面解析了中苏关系破裂的原因、多方面分析文革是如何发生的之类的问题。最后的给分，从我小组的情况来看，有很好的4.8，也有比较低的3.3，但绝不是以前的最高绩点3.3了。对于真正想学历史的同学，这是一门很好的课；对于不想学历史的同学，你也可以大摇大摆地睡觉。绩点较低的同学主要也是期末考试比较差，平时分大家差的并不多的。即使这位老师以前的给分使得她只有1.1的评分，现在我觉得她至少也得上9分，而我给她十分
102299,3743,王雪楠,2019-02-01 00:57:31,-8,8,16,上课一副我最牛的样子…事情多绩点差…无语了
102300,3743,王雪楠,2019-02-01 01:09:27,5,8,3,老师的课很有意思，给分其实还是好的，你自己多看书，总不会给很差。作业布置的很新颖
102301,3743,王雪楠,2019-02-01 01:14:46,7,10,3,老师真的超级nice啊啊啊啊啊\n\n之前说均绩低是因为老师刚从人大转过来不清楚浙大的水平（杠精勿杠，浙大是偏理工类的历史平均水准肯定和人大有差距），以为大家都敷衍了事才给分低的。这两年给分都超级好的好吗？\n\n我今年绩点4.2相当不错了好吗！而且老师讲课也很好，博古通今的。
102305,3743,王雪楠,2019-02-01 01:36:24,7,9,2,第一届老师绩杀是因为不懂浙大的正态分布，完全按原来的成绩给分。但是老师现在已经不是绩杀了，所以大家不用害怕。再者，正态分布本就有高有低
102306,3743,王雪楠,2019-02-01 01:20:59,10,12,2,老师上课很棒好吗，特别有意思，可以学到很多东西。而且最重要的一点老师不是绩杀！不是绩杀！不是绩杀！重要的事情说三遍。
102316,3743,王雪楠,2019-02-01 01:35:57,8,8,0,史纲像3分通识课，轻松是挺轻松的，至于王老师负不负责大概是各花入各眼，如人饮水冷暖自知吧，我是觉得有点随便了，不过上课整体上感觉还是挺轻松的，给分有点随缘。
102319,3743,王雪楠,2019-02-01 01:47:55,5,6,1,很有趣的啦，给分也挺好哒
102322,3743,王雪楠,2019-02-01 02:00:47,6,7,1,老师给分很好，4.2，可以放心选了
102327,3743,王雪楠,2019-02-01 02:44:36,20,21,1,该给王老师正名了，预置课是她的史纲，刚开始看到评分真的很慌，换老师也没有换掉，硬着头皮上了之后发现老师还是很好的，平时上课算有意思的了，平时作业还允许同学一拖再拖，最后分也不错(4.2)，没有绩杀。至于之前的负面评论，大概是她前几届没有做好吧，但现在看来，可以算得上好老师了吧。
102331,3743,王雪楠,2019-02-01 02:59:28,6,6,0,老师挺好的，真的变了，不想以前那样了
102334,3743,王雪楠,2019-02-01 03:45:18,1,6,5,可以看出出分之后大家的评价还是不错的，那些喊冤的人，你们好自为之吧
102336,3743,王雪楠,2019-02-01 03:47:46,13,14,1,现在的她肯定不能用1.14的评分来评判了
102337,3743,王雪楠,2019-02-01 03:59:20,4,6,2,给分很不错
102390,3743,王雪楠,2019-02-01 11:11:01,4,4,0,好了点吧
102395,3743,王雪楠,2019-02-01 11:44:15,11,11,0,老师真的很好，给分也很不错，比某位钟姓思修老师好多了.
102406,3743,王雪楠,2019-02-01 13:54:46,7,8,1,4.5，感谢老师不杀之恩
102409,3743,王雪楠,2019-02-01 14:31:50,6,6,0,不绩杀，事情也不太多，可以接受。也是蛮有个性的一位老师～
102437,3743,王雪楠,2019-02-02 04:14:01,5,5,0,老师炒鸡有趣，讲课很好玩 给分也还好啊
102454,3743,王雪楠,2019-02-02 11:29:03,6,7,1,绩点4.2，理科生觉得够了。
102485,3743,王雪楠,2019-02-03 08:55:59,3,3,0,真的可以
102496,3743,王雪楠,2019-02-03 14:25:36,6,6,0,老师真的很好啊啊。我已经做好了61的打算。竟然最后4.5，老师上课也有趣。事情也不多。现在已经不绩杀了！强推。\n\n
102575,3743,王雪楠,2019-02-09 15:42:34,3,3,0,老师很好?
102649,3743,王雪楠,2019-02-17 10:14:31,6,6,0,犹记老师上课间隙偷喝水（1.5升的那种...）太可爱了。作业和讨论是有点多，但是老师很认真帮我们改或者评论，挺感谢的。史纲考试简直要人命，但是在查老师绩杀的恐吓下理科生能4.5已经受宠若惊了。
102673,3743,王雪楠,2019-02-19 12:20:29,3,4,1,老师说话挺有趣，刚开始的一两节都听的挺认真的。后来每节课都在写微积分线代作业或者睡觉…一学期我们组点了两次名，家书好好写，讨论课水了水，考试前看了老师给的考前提醒，翻了教材，翻了浙精的目录。最后上四了挺感激。
102681,3743,王雪楠,2019-02-20 08:03:29,4,4,0,老师上课是很有趣的，事情也不多，但是平时分真的是不好拿，对文笔和构思有很大的要求，对我这种渣渣真的是很致命，但最后的绩点也勉勉强强，老师好像改邪归正了，所以要是预置上的话，也可以不那么担心啦。
102694,3743,王雪楠,2019-02-20 23:58:22,5,6,1,我给王老师10分，期末绩点上4了，讲真的挺没想到的，老师给绩点没有那么可怕。
102748,3743,王雪楠,2019-02-22 08:20:33,2,3,1,现在给分变好了吧，水一水就到4.2了
102762,3743,王雪楠,2019-02-22 12:29:37,3,4,1,老师很棒啊，上课有活力也很有趣，性子很直爽。打分方面，有小组合作个人作业和最后考试三块，小组一起表演小话剧很有意思，个人作业写写历史剧本还给你限制最高字数，最后考试，基本上把书中小标题整合一下，题目就在里面了。一开始看到老师打分心里发怵的，后来发现没有这个必要啊。
102777,3743,王雪楠,2019-06-24 16:56:39,0,3,3,还行吧
102801,3743,王雪楠,2019-02-23 08:04:45,3,4,1,挺正常一老师，关键看自己能不能认真对待布置的作业吧
102807,3743,王雪楠,2019-02-23 11:38:30,1,2,1,老师上课挺有意思的，给分也没有评论所说的那么差啊
102848,3743,王雪楠,2019-02-24 05:41:06,0,2,2,现在还行了 水了一学期也有4.2
102868,3743,王雪楠,2019-02-24 13:11:32,4,6,2,老师备课不得不说很棒\n\n但就是\n\n很困。。。。。。。。。\n\n绩点3.9看来是改良了
102891,3743,王雪楠,2019-02-25 00:15:47,2,4,2,也不那么绩杀……还可以我和身边的同学都上4了
102928,3743,王雪楠,2019-02-25 04:06:29,4,6,2,为什么那么多人黑啊  期末考试好好考  平时都不用干什么的就可以上4了  我还不是学历史的
102950,3743,王雪楠,2019-02-25 05:56:58,1,1,0,老师备课超级认真，给分也还好\n\n\n\n
102951,3743,王雪楠,2019-02-25 05:59:02,7,9,2,老师现在不是绩杀了，而且上课也很有意思。很负责，作业交上去都会认真写评语反馈，哪里不好会指出来，错别字和标点也被抠出来了。
102992,3743,王雪楠,2019-02-25 08:42:05,10,10,0,老师人很好，不强迫听课，给分也不错啊
103030,3743,王雪楠,2019-02-25 12:34:53,3,9,6,说实话，没有评论说的那么可怕\n\n别的史纲都要写论文，我们就两篇家书就行了，而且我看了一个组给分都挺好，其他方面就是期末考了吧~\n\nemmmm可能老师是绩杀，但是我觉得4.5还不错啊
103055,3743,王雪楠,2019-02-25 23:58:07,-12,4,16,目前有改正，俩次大作业有字数上限（超级好啊，但是给分都不咋地）平时没有什么作业，就是有展示很麻烦Ծ‸Ծ，除此以外，上课讲的什么(ﾟoﾟ;一律不知道π_π
103056,3743,王雪楠,2019-02-25 23:58:07,-5,2,7,目前有改正，俩次大作业有字数上限（超级好啊，但是给分都不咋地）平时没有什么作业，就是有展示很麻烦Ծ‸Ծ，除此以外，上课讲的什么(ﾟoﾟ;一律不知道π_π
103081,3743,王雪楠,2019-02-26 02:17:00,-20,4,24,垃圾老师
103150,3743,王雪楠,2019-02-26 07:35:08,2,4,2,挺好的呀，也有意思，作业也有特色。\n\n给分真的不错，只要认真写就ok。
103194,3743,王雪楠,2019-02-26 14:50:14,5,6,1,还好啦，没那么恐怖，最后4.2已经满意了
103394,3743,王雪楠,2019-02-28 01:56:57,6,7,1,上学期选中雪楠的课还以为绩点完了qwq但是最后绩点4+_(:3」∠)_平时事情不是很多，就两篇家书，家书给分保底很OK，平常上课虽然要不定时点名，但在课上很宽容，直言不听莫得事qwq
103424,3743,王雪楠,2019-02-28 04:43:10,4,5,1,已经改很多啦 上课很有意思的 很有男友力绩点还不错的
103426,3743,王雪楠,2019-02-28 05:09:31,-32,2,34,这老师真的改邪归正了。\n\n我没去上过课，都4.8
103495,3743,王雪楠,2019-02-28 13:17:16,10,11,1,老师现在给分很好，和以前完全不一样了，而且讲课有趣，在她课上学到很多书本外的知识，对历史感兴趣的强推。期末还会讲一些做题技巧，不论她以前怎样，现在是很好的老师
103584,3743,王雪楠,2019-03-01 14:45:56,7,10,3,真的改过自新了！请有心的同学提一下老师的分数！有可能讲的没刘召峰好，但分肯定比刘召峰高！
103596,3743,王雪楠,2019-03-02 04:13:12,5,6,1,爱了爱了，老师给了我生活下去的希望
103597,3743,王雪楠,2019-03-02 04:52:07,4,5,1,出分奇慢
103638,3743,王雪楠,2019-03-03 08:52:24,12,14,2,真的不是绩杀了，轻喷
103672,3743,王雪楠,2019-03-04 04:39:45,6,11,5,我觉得老师上课很有趣啊 不懂为什么打分这么低
103723,3743,王雪楠,2019-03-04 15:08:43,8,10,2,Good！ Excellent! Amazing!
103915,3743,王雪楠,2019-03-07 07:38:22,5,6,1,good！\n\n
104051,3743,王雪楠,2019-03-11 05:41:45,11,15,4,挺好的，期末绩点4.8，改邪归正
104179,3743,王雪楠,2019-03-13 13:02:30,6,8,2,改邪归正
104428,3743,王雪楠,2019-03-20 06:06:56,6,8,2,讲课还不错，分数也还行。
104435,3743,王雪楠,2019-03-20 11:54:33,24,27,3,说差的，你们可以看看老师给家书写的评语。我看前一半时笑了出来，看后一半时热泪盈眶。
104545,3743,王雪楠,2019-03-23 07:49:03,6,8,2,王雪楠牛逼
104551,3743,王雪楠,2019-03-23 11:29:32,10,12,2,已经改过自新！！！！！
104552,3743,王雪楠,2019-03-23 11:29:36,8,10,2,老师会讲故事，虽然听不懂，但很有意思的哟
104656,3743,王雪楠,2019-03-26 01:49:17,11,15,4,老师上课讲的真的很用心呐，而且通宵备课很努力……虽然一直上课睡觉最后3.9，还是很感谢老师的付出～
104902,3743,王雪楠,2019-04-06 01:04:18,3,4,1,出分慢
105374,3743,王雪楠,2019-04-11 03:24:18,-7,2,9,哈哈3.3
105421,3743,王雪楠,2019-04-12 11:04:54,5,6,1,老师是个好老师，就是太喜欢怼学生了。
105424,3743,王雪楠,2019-04-12 14:26:53,2,3,1,还行。。
105443,3743,王雪楠,2019-04-13 10:58:28,-14,3,17,垃圾，，
106468,3743,王雪楠,2019-04-27 15:38:36,7,8,1,挺棒的，上课比较有意思，认真听会有收获的，家书改的也很认真，很多都写了评语，很用心
106707,3743,王雪楠,2019-04-29 04:04:17,1,2,1,声音太响了。。。。\n\n\n\n耳鸣
106716,3743,王雪楠,2019-04-29 05:19:11,10,12,2,改邪归正
106938,3743,王雪楠,2019-04-30 10:20:06,-10,0,10,。。。。
107649,3743,王雪楠,2019-05-08 02:56:07,3,5,2,很有收获
108163,3743,王雪楠,2019-05-16 02:23:17,12,15,3,现在的王老师挺好的，讲的课也有意思，事情不是很多，虽然史纲本身可能不是很受大家的重视，可还是希望同学们能稍微听下课回应下老师呀！不然觉得老师辛苦在上面讲课，下面都在玩手机很不尊重老师
108173,3743,王雪楠,2019-05-16 04:01:07,3,8,5,我爱wxn！
108286,3743,王雪楠,2019-05-20 06:12:29,3,8,5,wxn最棒！
108561,3743,王雪楠,2019-05-28 15:11:06,3,8,5,老师很好哇
108646,3743,王雪楠,2019-05-30 08:46:10,14,19,5,老师真的挺好的，上了真的不亏，不是反话，以前可能是出了一些问题但是在你退课之前去选择试听一节课吧，试一试再做决定。老师非常负责，作业也轻松。
108800,3743,王雪楠,2019-06-02 16:15:55,24,31,7,王老师是真的有水平，如果认真听她的课你不会忍心给这样一位老师打低分的，那么有想法认真备课而且把这么无聊的课本讲的有声有色很有意思的老师很难得。之前分低是因为老师年轻，不知道学生期末考考分低要调分，但她的能力不容置疑，她的授课态度也是不容置疑的，作为曾经的她的课代表，比其他人更明白老师的苦心经营。拜托大家不要被之前的评论影响了，只有上过亲眼看见听见，内心才会告诉你正确的选择是什么。看见老师被这样骂真的心里非常难受。
108828,3743,王雪楠,2019-06-03 04:07:03,5,9,4,真的很棒
108998,3743,王雪楠,2019-06-18 09:17:20,-31,15,46,我来继续1分，你的改邪归正无法弥补给我造成的伤害。你的课至今是我最低绩点，我恨你，王雪楠
109184,3743,王雪楠,2019-06-11 07:56:42,-22,2,24,没啥意思，声音太大，睡不着。评作业，，，，可能是神剧看多了，看啥都像神剧
109745,3743,王雪楠,2019-06-19 03:29:47,3,5,2,就讲课方面来说，老师是挺不错的
109977,3743,王雪楠,2019-06-21 01:45:32,5,7,2,讲真，就我个人而言，我挺喜欢王老师的
110024,3743,王雪楠,2019-06-21 09:54:32,2,4,2,棒棒打
110922,3743,王雪楠,2019-06-28 14:27:38,7,9,2,我是18年上的史纲，不是组长上4了，不知道其他班的情况。
111394,3743,王雪楠,2019-07-01 06:12:02,-4,11,15,希望老师多年以后站在讲台上想起你带的第一节学生不要愧疚！我们都努力去学了，完成作业了，而你没有给我们应得的回报，也没有诚信！你当时短信不回电话不接告诉我们三天后查分，可知我们的煎熬！
112161,3743,王雪楠,2019-07-03 17:56:40,14,18,4,老师对这门课还是很用心的，虽然被正态了，但是不难过，一学期下来，感觉有所收获，这就够了。到浙大来，不是来刷绩点和混的，诸君在校，多想想竺老校长的两个问题，不要为了一点绩点，让学弟学妹耻笑。
112667,3743,王雪楠,2019-07-04 23:56:04,20,22,2,我真的很喜欢老师。史纲这门课本来就容易枯燥，她已经尽力把内容准备得丰富、接地气，讲得生动有活力，老师是真的很用心在准备，也是真的很强大很有实力，会给出中肯的建议，会在你的家书上写下真诚的评语。遗憾的是，没有督促自己认真听老师讲课，也遗憾的是，班长几乎都是低头族。老师给分也不错的，考前也会给指导，考试的时候的温馨提醒也好有趣，总之，王雪楠，我爱了。
112749,3743,王雪楠,2019-07-05 02:03:07,16,19,3,再次提示，老师已经改过自新了！史纲两次展示，两次家书，家书没想象的难写，感觉写作的过程还是很有意思的，展示可以排舞台剧，也是一次不错的经历，其他上课时间全程可以自习，史纲听课对考试么得帮助。老师很贴心，考前整理的考试注意事项对考试非常有帮助，而且最后调分了，没被卡绩，开心(ˆ◡ˆ)
113220,3743,王雪楠,2019-07-06 02:00:49,8,14,6,不管你往届学长学姐们多么惨 反正王老师现在真的很好
113279,3743,王雪楠,2019-07-06 03:38:32,2,5,3,4.2
113396,3743,王雪楠,2019-07-06 16:24:58,10,12,2,当时看查老师已经不抱希望了。\n\n但是听了课之后，即使作为一个工科生，也有种想更加详细了解近代史的冲动。
113609,3743,王雪楠,2019-07-07 01:12:29,0,2,2,好呀真好呀
114843,3743,王雪楠,2019-07-12 03:02:10,2,5,3,老师讲课很好！
115311,3743,王雪楠,2019-07-18 10:38:06,3,6,3,绩点变好了哎
115898,3743,王雪楠,2019-08-24 14:09:28,3,6,3,老师不是绩杀，真的不是！！！
116223,3743,王雪楠,2019-09-06 10:13:00,-1,1,2,还不错
116231,3743,王雪楠,2019-09-06 11:10:00,13,20,7,顶我上去!\n\n大家看评论时注意时间，以前好像是因为刚来浙大不知道满绩是5.0(以为是4.0)所以才有绩杀之名，现在给分很好的，不要再骂了好吗
116252,3743,王雪楠,2019-09-06 15:24:11,1,2,1,不错的
116364,3743,王雪楠,2019-09-09 16:08:49,8,19,11,大四老学长回来评，现在GPA4.6，当年史纲给我2.7，班长3.3，平均2.7，史纲算入了我的主修成绩，且在她能够挽回过失的情况下不愿背教学事故的锅，失联关机直至教务系统无法更改成绩，当时成绩差非王雪楠班一截，别的不说我只希望她表个态度，一直装死了几届也没正式跟我们解释过这届事情，就凭着给下几届甜头想把当年对我们几百号人的伤害掩盖过去。
116773,3743,王雪楠,2019-09-15 12:49:57,4,4,0,
117116,3743,王雪楠,2019-09-19 09:33:35,5,6,1,老师讲课真的很好而且能学到好多东西，不过给分嘛。。。虽然老师“改过自新”了但还是不太友好
117672,3743,王雪楠,2019-10-27 02:37:41,0,1,1,
118120,3743,王雪楠,2019-10-21 04:06:41,-1,2,3,非常好
118708,3743,王雪楠,2019-10-31 02:36:16,0,1,1,听说很憨
118995,3743,王雪楠,2019-11-09 05:02:43,1,5,4,滚回去
119773,3743,王雪楠,2019-11-15 17:55:56,3,5,2,真的不行
120174,3743,王雪楠,2019-11-18 02:57:06,2,10,8,真的醉了，人活久了，还能看到王雪楠这种人评分上5，真是天底下最大的笑话！
120375,3743,王雪楠,2019-12-01 08:14:00,1,1,0,btx
120861,3743,王雪楠,2020-01-18 00:11:30,3,8,5,老师真的很棒！超级喜欢的老师！大家不要被评分吓到了
120862,3743,王雪楠,2020-01-18 00:15:02,2,9,7,非常非常庆幸自己没有退课！在小组讨论环节学到了很多东西，两次家书作业也觉得蛮有意思的，最后绩点上4超开心！
120872,3743,王雪楠,2020-01-18 01:11:26,4,10,6,超爱啊啊啊！每堂课都听得炒鸡认真！老师讲得很有趣的，而且两次家书我觉得很喜欢。两次小组展示，因为我的同组小伙伴都很积极所以搞得很开心并且效果超级好！老师真的好！！！（看起来是可可爱爱的小男孩！）最后绩点差点满了！是我期末考没找到书里的知识点...希望以后上老师课的同学可以多喝喝奶茶咖啡什么的，特别是前排的同学，因为老师不能喝，我们要给她闻（她自己很委屈地跟我们说的哈哈哈哈）...总之！老师很好！选她！安利安利疯狂安利！！！
120949,3743,王雪楠,2020-01-19 01:24:31,2,3,1,选课不推荐也不劝退。但一定要进一个成员积极的小组，不然两次展示够受的。
121306,3743,王雪楠,2019-12-23 03:16:43,0,5,5,退了吧
121572,3743,王雪楠,2019-12-12 11:15:25,-2,0,2,...
121998,3743,王雪楠,2020-01-29 15:03:05,2,4,2,自己分不高，但是老师确实用心也很求是。
122128,3743,王雪楠,2020-02-16 04:33:19,0,5,5,老师明明很棒啊
122189,3743,王雪楠,2020-02-20 01:20:50,6,7,1,上课听她讲故事体验不错，小组展示时有些靠谱的成员就好
122261,3743,王雪楠,2020-02-21 11:29:18,7,11,4,史纲答一波。老师选题避轻就重、讲课层剥缕析，特别风趣幽默，还有很多小故事。评分机制很透明，平时小组合作采用的是贡献分配分数法（所以积极参与的话平时分还挺不错的），有一说一，史纲的课堂展示水平还是很不错哒，老师也会给每个小组评价和改进建议，非常用心了。平时布置的作业要求会表达得很清晰，还会给很多参考文献，教大一小白检索方法（布置作业的同时还会教方法的老师真的超棒！）。期末询问卷面分数的邮件也很快得到了老师的回复，真的很负责一老师。我一个绩点没上4的人觉得老师很值10分的评价。
122589,3743,王雪楠,2020-03-05 06:36:04,1,6,5,人还是很不错的
122620,3743,王雪楠,2020-03-09 04:21:15,2,6,4,不好..
123318,3743,王雪楠,2020-06-02 14:33:21,0,2,2,
123426,3743,王雪楠,2020-06-09 00:57:39,0,5,5,老师挺好的，身体不太好，真的很认真负责！平时的课上得很有趣，布置的作业认真做，能学到很多。看评价的话，老师之前可能在给分上有一些失误？但是老师真的是一个很好的人呀～最后把我拉到正好89，谢谢老师o(^o^)o
123634,3743,王雪楠,2020-06-11 02:02:17,2,7,5,不论王雪楠老师带第一届学生时出过什么岔子，处理是否得当，从现在这届来看，王雪楠老师上课内容充实，事情不多（两次小组展示，期末一千字“抗战家书”/“改革家书”作业，没有论文，统一期末考试），选她的课没问题。
123994,3743,王雪楠,2020-06-19 06:27:59,5,6,1,王老师上课讲的真的很有趣，作业有新意而且量也不大，能学到很多东西，期末给分也不错，给王老师打call!
124000,3743,王雪楠,2020-06-20 02:28:57,-7,4,11,期末作业说是家书，其实不过是换汤不换药的死板论文罢了。\n\n既然到头来还是得像论文一样写，又何必搞什么形式主义的创新呢。
124205,3743,王雪楠,2020-06-27 03:23:15,0,2,2,只能说给分不高，而且很看组长
124213,3743,王雪楠,2020-06-27 07:12:38,3,4,1,喜欢历史的选手表示其授课内容比较有趣丰富；给分上中规中矩吧，感觉遇到一个厉害一点的小组还是很重要的；平时作业没有论文，主要任务就是大讨论的小组汇报以及期末家书（平时上课多提问有加分），感觉任务比写论文轻松（不想写论文选手在此）。虽然绩点没上4，但我觉得还是值得推荐。
124420,3743,王雪楠,2020-06-30 16:21:29,2,2,0,还行吧，给分还是很一般
124439,3743,王雪楠,2020-07-01 09:33:09,6,6,0,wxn老师史纲相较于其它老师来说，事很多。然后很重要的一点是，平时分项目更多了。每一项都扣个几分，加起来还没考呢你最后总分就下90了（至少我们班除了考勤以外的平时分项目没有一项有人满分）。的确，最后不需要写几千字的论文，只有家书，但你的平时分就是比别的班只写论文的人低。小组展示选的题目很重要，我们组就是没抢到喜欢的题被分了一个剩下的，很难找资料讲的题，然后给的均分很低。考试给分方面我不太清楚，但基本上没怎么捞人，实打实给。最后3.6，有点难过。
124524,3743,王雪楠,2020-07-02 10:10:40,3,4,1,教学方面还不错，上课能讲很多不同主流的新鲜的知识，也会给我们很多课外资料供参考。平时分一般吧，每个作业都尽力做了还是扣了7分多…一部分原因是小组讨论组员不太靠谱，两次整组得分都一般。还有一些提问的环节我也都参与了，加了不到一分。最后总分90，有点意料之外，因为期末考的不错，吃高中历史选考的家底还挺爽，材料加论述题写起来很顺手。
124559,3743,王雪楠,2020-07-03 03:03:05,0,3,3,别选 平时分低于其他老师
124588,3743,王雪楠,2020-07-03 09:35:32,5,9,4,事少分高！出分还贼快！上课随你听不听 没什么互动！老师改过自新了 放心选
124621,3743,王雪楠,2020-07-04 03:29:18,3,3,0,老师上课很有趣，不过评作业时也很犀利。给分尚可，选上不亏
125347,3743,王雪楠,2020-09-07 07:19:29,2,3,1,...
125421,3743,王雪楠,2020-09-08 11:27:57,-7,2,9,雪楠啊，分咋还这么低
125491,3743,王雪楠,2020-09-10 11:04:59,-1,9,10,老师上课蛮有趣的，现在史纲给分挺好的，放心选。
125511,3743,王雪楠,2020-09-10 18:03:44,-2,3,5,平时有点难高，特别是小组成员不够给力的时候，自己做很多成绩也就那样，全靠考试往回拉一点
125816,3743,王雪楠,2020-09-14 12:10:39,0,0,0,这这这
126012,3743,王雪楠,2020-09-16 12:00:57,-7,4,11,比以前好并不代表她可以
127222,3743,王雪楠,2020-11-15 12:00:55,-6,2,8,瓜皮老师
128709,3743,王雪楠,2020-12-25 05:12:49,10,11,1,老师没有评论说的那么不堪啊，讲课很好，真正是在讲历史的！
131763,3743,王雪楠,2021-01-28 23:19:25,8,10,2,呜呜呜老师水平很高，就是平时分项目有点多，可能平时分得分有点低，小组合作很重要，没分到好的小组挺吃亏的。最后4.2，显然王老师已经努力打捞了，但还是有点不符合自己的预期
131781,3743,王雪楠,2021-01-29 02:04:47,12,14,2,老师上课还是挺有趣的，尽量把一些复杂的历史内容讲得通俗易懂（虽然对考试没什么帮助就是了），平时作业就是一篇家书（1500字以内），主要还是小组讨论比较重要。老师现在给分确实已经变好了
131860,3743,王雪楠,2021-01-29 06:55:36,5,7,2,从来没有认真听过一节课，老师其实打分也还好，虽然不高，但是不低
133111,3743,王雪楠,2021-02-08 16:03:25,7,8,1,老师的家书点评是我的快乐源泉，希望老师多多分享家书点评
133622,3743,王雪楠,2021-03-03 02:57:45,6,8,2,给分还行啊
135666,3743,王雪楠,2021-05-18 11:18:58,12,14,2,老师讲党史课，讲的非常好，生动吸引接地气，根本就不是评论这么不堪！
136496,3743,王雪楠,2021-06-19 08:42:31,4,5,1,老师党史讲得生动有趣！很赞
136900,3743,王雪楠,2021-06-28 02:40:12,10,11,1,老师真的是很负责任地在讲课，上课有干货！
136962,3743,王雪楠,2021-06-29 03:05:41,-21,4,25,傻逼老师，卡我均绩，爬
137339,3743,王雪楠,2021-07-03 09:44:03,5,6,1,老师课上的很好啊，为什么这么多人给这么差的评论？
138758,3743,王雪楠,2021-07-10 16:40:46,5,6,1,老师挺好的，对历史有自己的见解
139395,3743,王雪楠,2021-07-15 05:07:31,4,7,3,老师很棒！每节课都有百家讲坛的感觉，给分也很公开透明，人也非常可爱ww
139560,3743,王雪楠,2021-07-17 08:52:48,3,5,2,老师的史纲课讲的是很生动的，很吸引我去听。给分和其他老师应该没有太大区别了（毕竟思政课），收货了思政课第一个上四的绩点，作为小组里的小透明是非常意外了。很感激老师！
140707,3743,王雪楠,2021-09-15 08:07:18,6,6,0,十分      分期付
140741,3743,王雪楠,2021-09-15 14:18:15,1,1,0,很不好
141389,3743,王雪楠,2021-10-05 09:20:34,1,2,1,事好多啊
141405,3743,王雪楠,2021-10-06 14:36:15,2,3,1,确实是事多，上课有点无聊，可以摸鱼，但是答题有分
142179,3743,王雪楠,2021-11-08 08:14:52,3,3,0,快逃！
142407,3743,王雪楠,2021-11-11 05:29:59,2,3,1,给个辛苦分八分吧，2021年上半年上的史纲，上课还是比较有趣的，至少会让我偶尔有兴趣听一下，上课回答是有0.1或0.2加分的，对最后分数影响不大，平时分相对来说比较好得（只要不在组内摆烂就可以拿个百分之九十的平时分），家书这个书面作业看上去有点难写，但最后给分也还是不错的。槽点可能就在于老师不重视期末考试吧，平时分拿了68（满分七十），然后老师没有给任何和期末考试有关的消息（也许是我疏漏了也不一定，但总归不是很了解），最后期末考的比较糟糕，似乎卷面分就62，最后4.2，给大家参考一下
144679,3743,王雪楠,2021-12-23 05:43:16,-1,1,2,老师不错
144848,3743,王雪楠,2021-12-25 06:39:40,3,4,1,快逃！
145948,3743,王雪楠,2022-01-04 14:19:37,1,1,0,老师专业知识丰富
146060,3743,王雪楠,2022-01-05 09:45:13,4,5,1,上课很好，现在比评论里说的要改变很多了。但是！小组讨论很多，会需要有很多上台表演这种事，而且组长掌握杀生大权，社恐或者不擅长小组合作无比自己思量！
146379,3743,王雪楠,2022-01-06 11:31:38,2,2,0,非常好！
148032,3743,王雪楠,2022-01-11 11:14:38,5,7,2,1.上课与书本极弱相关，不知道是史纲老师通性与否\n\n2.给分较为求是，现在能不能用绩杀来描述不好说，但总体应该会比其他老师差一些\n\n3.选了他的课千万别被推着当组长，十多个人有一两个划水，你要擦很久的屁股，工作量是普通人的两倍左右
148095,3743,王雪楠,2022-01-11 13:19:15,0,1,1,给分求是
148096,3743,王雪楠,2022-01-11 13:19:39,3,4,1,专业水平极高，教学能力极强。全体学生必修课讲这么专业真的好吗...
148383,3743,王雪楠,2022-01-12 09:53:29,2,3,1,重在小组合作 不用写长篇论文只需写1500字内的家书（微型小说）
148843,3743,王雪楠,2022-01-13 17:13:08,5,5,0,老师人很亲和，给分不知道好不好，本人一学期中规中矩学下来就4.2，上课讲的内容还很有趣，至少比起评论区前几年所描述的那样是会好很多的样子
149440,3743,王雪楠,2022-01-15 10:52:34,3,6,3,很好的老师，讲课出乎意料的有趣。本人史纲没有任何基础，最后还是拿了4.5，根本没有想象的那么可怕，老师很好的。
150279,3743,王雪楠,2022-01-21 09:12:11,3,4,1,课堂非常有趣，本人属于一听历史就困的类型，也会觉得上课很有意思\n\n小组合作很重要，一定要积极参与
150628,3743,王雪楠,2022-02-06 01:47:08,0,2,2,活太多，是我经历过最痛聚痛苦的一门课之一
151628,3743,王雪楠,2022-03-10 02:38:38,6,6,0,21年秋冬还挺好的，讲课有意思（把史纲这种无聊的思政课讲成还有点有趣的历史课，2次小组展示，作为摆烂组长拿了4.5
152320,3743,王雪楠,2022-04-03 11:44:31,12,13,1,这学期的20分期末大作业家书普遍打分极高，超能捞。家书比其他史纲班的论文显然要容易上手，也更有价值的多。（大一能写出什么有意义的论文来……）
153278,3743,王雪楠,2022-04-27 11:09:16,2,9,7,sbsbsbsbsbsbsbsbsbs\n\n歪一句\n\n党史课第二节遇到她真是开了眼了居然会有这样的老师\n\n前面的一些评论已经说的很详细了\n\n看来这么久她是保持初心了啊（微笑）
154962,3743,王雪楠,2022-06-07 06:28:51,0,0,0,挺好的，但是老师溜了
155530,3743,王雪楠,2022-06-14 05:05:39,0,0,0,雪楠老师很好！
155890,3743,王雪楠,2022-06-16 12:58:09,3,3,0,楠姐是个宝藏老师！但是为什么要走…🥹😭
156097,3743,王雪楠,2022-06-17 14:00:48,3,3,0,老师怎么了啊   有人可以说说吗
156098,3743,王雪楠,2022-06-17 14:02:05,1,1,0,上课挺有意思的
156475,3743,王雪楠,2022-06-20 02:46:51,9,9,0,楠姐yyds\n\n上课超有趣 讲话很飒很可爱 会用很多奇奇怪怪可可爱爱的表情\n\n回楼下 楠姐去省中共创建史研究中心啦\n\n祝老师一路顺风～
156557,3743,王雪楠,2022-06-20 09:01:15,10,10,0,老师请了到课的同学吃了三次东西\n\n第一次是麦斯威，一个球，有榴莲味\n\n第二次还是麦斯威，不过有两个球\n\n第三次是奶茶
160998,3743,王雪楠,2022-10-23 16:12:20,1,1,0,老师感觉还是想讲点东西的，上课有自己的内容在里面。但是可能因为是思政课吧，本人四分之三的课都水了过去。老师还是可以的，反正期末还是要靠自己的。
74348,4423,郁建栋,2018-02-13 01:23:37,1,2,1,之前因为老师没有评分，一直很担心给分，但是上完老师的课，觉得还是一个非常棒的老师。资历很老，但是说话很有趣，平时一次小组展示+一篇论文，最后给分也不错。
81118,4423,郁建栋,2018-07-04 04:33:38,0,1,1,老师超级认真 上课也很好 最后一节课还会给我们唱歌 很喜欢老师！
