评论id,老师id,老师姓名,发表时间,点赞减去点踩数量,点赞量,点踩量,内容
175989,9319,Koichi Hattori,2023-06-27 11:02:20,-1,1,2,Koichi老师讲课挺认真，还写了一份讲义，就是不太听得懂\n\n老师对于量子力学的理解应该是很透彻的，就是最后大家的final pre给分都很一般\n\n不过认真听老师讲课应该收获还是会很大的
183731,9319,Koichi Hattori,2023-11-29 10:26:37,14,15,1,抗日精神永存好吧。量子力学II平时分扣了2.1分，这小日子有本事期末一个展示给我们整个寝室都打了40分，最后总评73分（期末占60％）。最后去钉钉和他对线，问他为什么给我们整个寝室打40分，他说他最后提的那个问题我们没答上来，展示的PPT和汇报还是做的蛮认真的。不是大哥，就你那一口流利的日式英语，quantum mechanics念成哐当么堪尼克斯，谁能听得懂你在问什么。这一门往年所有人都90+的水课，硬生生给他挂了两个同学，我问他为什么要给我们打这么低的分数，他说你不要认为给你打40分就是不及格，你看看你的总评不是70+吗，you can take it as 60+，is it good for you？\n\n\n\nOK，fine. I'm good， and f**k you.
190393,9319,Koichi Hattori,2024-02-29 14:58:14,0,1,1,主要是来补充一下点名的信息，每节课都点名，使用签到码的方式\n\n然后目前看来，有一个讲义写的不错，口音比其他日本老师强但是上课我还是听不懂
197698,9319,Koichi Hattori,2024-07-31 14:26:42,-1,0,1,讲义很好，课很好。就是给分有点差
184491,9320,Norimi Yokozaki,2023-12-20 20:50:35,0,0,0,国际友人上岗不用考语言吗，真的听不懂啊。。。
187497,9320,Norimi Yokozaki,2024-01-16 11:14:45,0,1,1,量子力学Ⅱ，这门课的内容基本上属于量子力学Ⅰ的基础延拓，包含了量子计算，量子多体，量子场论和规范场论等方面的入门知识。老师的备课还是挺用心的，最起码ppt做的很好而且挑选的内容也对初学者比较友善，上课也是用黑板推式子而不是只念ppt。老师本人是日本人并且态度也挺好，钉钉群里的问题会主动回复。\n\n唯一的缺点是英语口语还是有点难绷，日式英语也能理解但是讲的还有点慢。只能说当堂听课效率不太高，很容易走神。
168116,9321,曹超,2023-01-28 15:14:56,-10,5,15,懂得都懂
168469,9321,曹超,2023-02-17 11:32:06,6,7,1,什么懂得都懂，我怎么没懂
169670,9321,曹超,2023-02-27 10:22:09,3,7,4,普物二给分很不好
169674,9321,曹超,2023-02-28 12:04:34,-1,8,9,懂了，原来讲得烂给分也烂……
169727,9321,曹超,2023-02-27 14:07:41,-1,3,4,上课笑嘻嘻，给分。。。
169736,9321,曹超,2023-02-27 15:08:04,15,17,2,巨随和，问啥都会好好回答，那些骂老师想想上课在干嘛
169795,9321,曹超,2023-02-28 02:23:19,6,7,1,我觉得老师很好
170203,9321,曹超,2023-03-02 03:34:53,8,8,0,对没有普物基础的确实不太友好，特别是很多积分计算特别耗时间，我认识的物竞生也被绕昏了（晕厥）\n\n老师讲课水平说不上烂，至少说清楚了公式的应用跟麦克斯韦方程是怎么回事，教室气氛也不错，希望来看的同学不要被低分吓跑了
170291,9321,曹超,2023-03-02 13:40:47,4,5,1,非常和蔼，热心解答同学的问题。虽然上课有很多推导容易使人迷糊哈哈哈。（期中考电磁学酱紫难？比期末难多了！）
186631,9321,曹超,2024-01-12 08:26:44,6,6,0,曹老师人很和蔼，讲课也蛮清楚的，板书也写的很好，就是字小了点
188570,9321,曹超,2024-01-19 09:20:59,2,3,1,老师很友善，讲课也能听懂。但给分确实不好，而且分数莫名其妙
188802,9321,曹超,2024-01-20 04:21:50,3,4,1,期中四十多，期末总分拉到了70，cc和llk你们是我的神
189073,9321,曹超,2024-01-21 14:54:08,2,3,1,曹超老师真的有在用心教课，每个公式都会细致地推导一遍。普物学不懂是我的问题，老师是好样的！最后老师是真的大爹降临！哥们期中四十多期末只会抄公式愣是给了70分，真的捞😭😭
191013,9321,曹超,2024-03-28 02:34:47,0,1,1,人很好
193839,9321,曹超,2024-06-20 06:09:57,5,5,0,第一个没有物理课的一学期呀，想起来普物就来评价一下  个人感觉曹老师讲课还好，人很和蔼的，个人觉得人挺不错的，另外会有一些小测试，就是比较基础的题目，可以翻看笔记 我普物一学得很糟糕，大学以来最低的绩点，然后很认真地学了二，结果还不错 捞不捞不是很清楚，但我觉得还是捞了一些的可能（）期末考试的题目还是跟上课推导、作业这种挺紧密关联的
212837,9321,曹超,2025-01-15 04:34:18,-1,0,1,。。。
212859,9321,曹超,2025-01-15 05:30:05,4,4,0,很好很用心的老师，这一届给分好像普遍不错？
212891,9321,曹超,2025-01-15 07:35:11,0,0,0,cc这学期给分很好！！
214078,9321,曹超,2025-01-23 12:20:06,1,2,1,以我自己的绩点来看，给分完全没有达到【很好】的程度，而且建议大家如果不是物竞选手，尽量还是不要选cc/llk的普物二（H）了，，一个学期要学电磁学，光学，原子物理，量子力学，而且你还不能是只搞懂概念，你还得会做题，直接就是达到了物理学专业一个学年好几门课叠加的难度；再加上英文出卷，期末考试的监考老师不是授课老师，单词没法问，字典查不出，更是难受至极。总之就是快跑啊！！
171304,9322,郭红丽,2023-03-21 08:14:17,5,6,1,大物实验霍尔法，老师给分挺好的，也乐于解答问题，但是语速巨巨巨快说话也听不太清，对本物理小白不太友好(｡í _ ì｡)建议选的uus做好充分预习，老师还是很好的
171400,9322,郭红丽,2023-03-23 10:49:31,2,2,0,我评价的是普物实验这门课。很可爱的老师，看的出来对物理很有热情，对同学也相当友善。唯一的不足就是语速很快，思维比较跳跃。给了9分
171410,9322,郭红丽,2023-03-23 15:33:38,0,0,0,语速超快 但是简明扼要 很喜欢
171554,9322,郭红丽,2023-03-28 13:20:54,0,0,0,温柔给分好的老师
172285,9322,郭红丽,2023-04-24 08:42:19,0,0,0,心善人美的好老师。能选她实验就选吧。
172442,9322,郭红丽,2023-04-27 03:01:26,1,1,0,她好温柔，我哭死
178041,9322,郭红丽,2023-07-06 10:43:15,0,1,1,普物实验给分还行，但是我觉得更加认真的两个报告分数没有另一个不太工整的高有点点怪qwq
194585,9322,郭红丽,2024-06-24 12:47:08,0,0,0,不好评价
206453,9322,郭红丽,2024-12-15 07:59:37,0,0,0,普朗克常数，给分为啥这么低😡😡😡
217416,9322,郭红丽,2025-04-10 03:46:45,0,0,0,讲话一定要带一个anyway吗
169473,9323,汤衍浩,2023-03-13 02:49:27,0,5,5,NO，
169984,9323,汤衍浩,2023-03-01 01:44:39,14,18,4,新老师，有一点点紧张捏，上课节奏有点快，简单的知识点和难的知识点同样的速度，刚开始上课可能不能很准确地表达出自己的意思
170326,9323,汤衍浩,2023-03-03 01:50:38,1,4,3,上课太快了，说话声音又太小了，容易💤 ，麻烦讲慢一点
170807,9323,汤衍浩,2023-03-10 03:19:32,-1,6,7,老师讲课一言难尽，感觉他在很努力认清ppt上的字，呃..这个..呃..呃..OK..呃..就是..呃..那么..呃....，建议快跑
170810,9323,汤衍浩,2023-03-10 03:26:36,-1,5,6,讲课水，随机点名
171038,9323,汤衍浩,2023-03-15 01:40:27,0,4,4,跑吧，老师讲课其实挑不出太大的毛病，只是念PPT，语调什么的也没有变化，对我来说很难集中注意力。\n\n物理是我最喜欢的一个学科，能把我讲得犯困也算是很难得了。\n\n不要觉得老师只是讲的内容不行，或者讲的少之类的。好多人以为好老师讲的多，差老师讲的少。其实不是，一个差的老师压抑学生的热情，好的老师恰恰相反。
171437,9323,汤衍浩,2023-03-24 06:32:32,1,5,4,选汤老师的课你能感受到领先别人一大截的感觉，第三周在讲别的班第五周讲的东西，念ppt也念得很快，让你感受飞一般的感觉
171490,9323,汤衍浩,2023-03-26 08:02:44,10,10,0,老师第一次上大物可能没什么经验，不过确实挺用心的
171988,9323,汤衍浩,2023-04-16 06:23:03,3,3,0,新老师上课挺用心，该讲的都讲了，不过稍微有一点点快，但是提前看了ppt就没什么问题的
172098,9323,汤衍浩,2023-04-19 09:34:22,1,2,1,666
173239,9323,汤衍浩,2023-05-16 12:55:08,0,1,1,很好的一个老师，很用心，也会听取学生意见
173635,9323,汤衍浩,2023-05-31 00:28:08,4,5,1,无情的念ppt机器
173651,9323,汤衍浩,2023-06-02 00:27:34,7,7,0,老师人真的很好\n\n可能是因为第一年上课经验不足，导致上课比较快时间分配也不是很好\n\n但老师真的有听取大家的意见，查老师的评论也会看\n\n能感觉到下半学期的上课节奏和开始比有了挺大的变化\n\n目前尽量在往听课更舒适的方向靠\n\n最后一点，老师真的很可爱，很爱笑，也没有什么架子\n\n还是比较推荐老师的大物课程\n\n认真听一定会有收获
173728,9323,汤衍浩,2023-06-02 04:32:48,1,1,0,老师是新老师
174044,9323,汤衍浩,2023-06-16 08:31:27,4,5,1,oh NO！！！
176398,9323,汤衍浩,2023-06-28 17:02:05,3,4,1,上他的课 得他的分 想哭
176405,9323,汤衍浩,2023-06-28 18:00:04,6,8,2,虽然不是老师的锅 是成绩组成有些问题 但绩点真的好低😭😭😭
176443,9323,汤衍浩,2023-06-29 02:25:18,-2,2,4,他是我遇到的最年轻的物理老师，讲课中规中矩，像个学生讲课。\n\n但ppt逻辑清晰，不用听课也能看懂（这是可以说的吗），期中期末会发知识提纲。\n\n老师会详细讲公式推导，只是为了加深我们理解，听个大概就行了。
176773,9323,汤衍浩,2023-06-30 05:16:54,0,0,0,谢谢你
176802,9323,汤衍浩,2023-06-30 08:14:19,1,1,0,基本不点名，小测也会提前通知，是一个适合自学的老师
177595,9323,汤衍浩,2023-07-04 01:43:18,0,0,0,老师的课很适合自学，只要好好学了就没啥问题
179311,9323,汤衍浩,2023-09-09 09:39:23,1,2,1,非常认真负责的老师，赞！
180847,9323,汤衍浩,2023-09-27 06:43:35,0,1,1,很不错 从不点名平时分拉满
182562,9323,汤衍浩,2023-11-17 13:25:53,0,0,0,不点名，小测会提前通知，但是给分很求是
191251,9323,汤衍浩,2024-04-15 03:48:29,-10,3,13,lj老师就他小测不让看书，给分lj
191683,9323,汤衍浩,2024-04-28 00:12:05,5,5,0,下面说不让看书的评论笑死我了，真把小测当开卷喽，况且给书的话也算不完吧。我也没听说其他有哪些老师开卷考。小测严格不严格确实是要狠抓的，你这诉求就有些奇怪了吧。
197051,9323,汤衍浩,2024-07-07 02:40:31,1,1,0,事情很少，小测闭卷要认真准备一下，只要平时认真学好（可听课可自学），考前认真复习，大物还是问题不大的
206258,9323,汤衍浩,2024-12-13 12:01:01,1,1,0,一个学期四次点名，传统点名方式，一次叫15个人左右。一个学期一般就会点到一次名。小测比较严格，也有点难度，主要是ppt和作业题原题。不准备分数会很低，建议准备一下，写得顺利很多。我四次小测3、3.8、4.2、4.8最后平时分39。老师讲课还是很清楚的，ppt做的也比较清晰。推荐选
217648,9323,汤衍浩,2025-04-14 14:25:51,0,0,0,普通物理吃自学
170651,9324,王震,2023-03-07 14:43:40,2,4,2,很喜欢老师的上课方式
178334,9324,王震,2023-07-10 06:21:22,0,1,1,老师不错的，上课不点名，最后一节课有事还录了视频给我们复习
192568,9324,王震,2024-05-24 02:58:03,3,3,0,老师人帅心美，小测开卷，作业不多
193099,9324,王震,2024-06-03 11:50:57,5,5,0,老师怎么这么喜欢刘慈欣的小说哈哈哈哈哈哈哈
195078,9324,王震,2024-06-26 17:14:02,0,0,0,超级好
195263,9324,王震,2024-06-27 13:39:55,0,0,0,老师人很温柔，给分很好
199962,9324,王震,2024-10-09 13:58:59,2,2,0,讲的不咋样，但是作业少，考试开卷
213350,9324,王震,2025-01-17 04:23:44,0,0,0,好好好好好好好
221847,9324,王震,2025-06-27 00:35:51,0,0,0,这学期是和sc老一一起教的大物乙I，总体而言，wz老师教的很不错，考试开卷的，只会在考试时签到，小测题目也很简单，部分来源于书上的原题，总之还是推荐大家去选的
221863,9324,王震,2025-06-27 03:42:40,1,1,0,讲课很清晰，会给做题方法和例题，让同学们学会知识的同时能够应试。小测开卷可以翻笔记和书，除小测外几乎不点名。
167053,9325,肖婷,2023-01-14 17:52:06,15,20,5,大物实验，考前瞎给范围😅
171078,9325,肖婷,2023-03-15 13:46:18,-3,6,9,很差劲，问她问题从来都是已读不回，根本学不到任何知识
171323,9325,肖婷,2023-03-21 15:09:55,5,7,2,分光光度法实验给分很低。。。普遍都很低。。。
192397,9325,肖婷,2024-05-17 12:55:56,0,11,11,讲得很透彻，给分中规中矩两个91，实验报告出分会写评语（我选的老师中唯一一个主动写评语的），是非常认真负责的老师，10分满分
193504,9325,肖婷,2024-06-12 03:13:09,6,6,0,还可以
196458,9325,肖婷,2024-07-03 13:41:32,3,3,0,老师还是挺负责的
196662,9325,肖婷,2024-07-04 15:58:16,2,2,0,大赞！
198358,9325,肖婷,2024-09-08 01:01:17,4,5,1,感觉是很按规矩来的老师。\n\n我同学是她的实验，给分还不错。\n\n后面大物实验我分数登错了给课程组反映，结果出来后肖婷老师给我打电话做了说明并很快改了回来。\n\n除去大物实验本身安排的问题，老师人还可以，做事也符合规矩。
201440,9325,肖婷,2024-11-03 02:34:55,0,3,3,给分挺好的
213158,9325,肖婷,2025-01-16 07:04:48,1,1,0,给分挺好的
213467,9325,肖婷,2025-01-17 13:53:42,2,3,1,勾史大物实验，写那么多实验报告最后被期末毁了，拿这么一个破分，服了这史课
215800,9325,肖婷,2025-03-05 14:43:58,0,1,1,不是你不考虑一下下午第一节课要上课的同学吗，讲那么久，导致一个班最早走的都12：30了，晚的更是要到12：50多，纯纯神金，午饭都来不及吃就要赶去上下午第一节课
215801,9325,肖婷,2025-03-05 14:45:21,3,3,0,示波器就是物理实验中的赤式实验哈，中午是没饭吃的实验是会做不完的下午还是要下课的
216509,9325,肖婷,2025-03-17 14:41:55,0,1,1,你就这么喜欢拖课吗
216778,9325,肖婷,2025-03-25 04:25:08,0,0,0,必做实验纯纯一坨，还讲半天。。。
217514,9325,肖婷,2025-04-12 03:27:00,0,0,0,nmd
217574,9325,肖婷,2025-04-13 14:24:17,3,3,0,老师讲得很仔细，给分超级好！！
217885,9325,肖婷,2025-04-17 12:26:52,-1,3,4,老师给分真的特别好！！！
218108,9325,肖婷,2025-04-21 06:53:29,2,3,1,为什么给我那么低的分数！一学期的实验成绩全被它毁了
219739,9325,肖婷,2025-06-05 04:55:18,0,0,0,没上过老师的实验课，但是导论课讲得很不错呀，后面做导论题有不明白的地方去钉钉问老师，老师很耐心地帮我解答了，实验方面没做过确实不能评价
221402,9325,肖婷,2025-06-23 08:29:42,1,1,0,老师实验报告给的分是真的好，强推！！可能是因为老师教的实验比较恶心，但老师是很耐心很温柔的好老师！
184291,9514,付海龙,2023-12-15 13:12:19,5,5,0,好老师，近物实验最好的老师之一
190801,9522,矫金龙,2024-03-19 15:02:08,2,2,0,讲得好，从不点名，绝对的好老师，认真负责（就是可能比较严格（他说这是第一次带本科生
191304,9522,矫金龙,2024-04-17 06:53:09,16,19,3,老师人非常好，有点像那种憨憨的理工男生，虽然应该有三十多了，但是感觉还有大学生的清澈哈哈哈哈  讲课很仔细，还会讲一些科学小故事。小测的前几节课会提醒你来，平常不点名，原因是他觉得没必要用点名拴住同学来上课，应该要学生自己觉得讲得好，对自己有帮助才来（大意是这样）。学生问问题的时候也都是以一种谦虚探讨的态度来给学生讲解。\n\n很好老师，就是小测有点难（不过赋分制），然后上课例题再多一点就更好啦
192759,9522,矫金龙,2024-05-30 05:34:51,1,1,0,好老师，上课认真备课，讲课耐心细致，而且很温柔的
193086,9522,矫金龙,2024-06-03 10:34:52,2,2,0,非常好老师👍经同学推荐听了他的智云网课，对我帮助很大
193633,9522,矫金龙,2024-06-14 07:15:34,8,8,0,首先他保证不点名而且小测前都会提醒，已经封神。其次他讲课水平绝对是很好的，很注重物理思维，深入浅出，补智云的时候好后悔没去听课。
194661,9522,矫金龙,2024-06-25 01:42:24,3,3,0,好老师，认真学有好成绩的
194850,9522,矫金龙,2024-06-25 17:10:51,1,1,0,很好的老师，上课不点名，很关心同学，钉钉会秒回
215411,9522,矫金龙,2025-02-26 02:45:03,2,2,0,讲课很棒
215597,9522,矫金龙,2025-03-02 10:57:55,6,6,0,封神\n\n绝对应该是10分的存在\n\n谦虚又谨慎，温柔又体贴\n\n深入浅出，还提醒我“哥们儿这个还挺重要的先别打瞌睡了，你打瞌睡肯定是我讲得不好”\n\n有点物理组年轻版童雯雯感觉\n\n希望30年后我儿子也能上到他的课
215744,9522,矫金龙,2025-03-05 04:49:08,3,3,0,讲得条理非常清晰，虽然知识本身比较枯燥但老师经常会用一些梗让昏昏欲睡的我重新醒来。人也很谦虚很认真，还会提醒作业没交的同学，好好好！
216328,9522,矫金龙,2025-03-13 10:22:14,6,6,0,含金量太高了，我的金龙哥\n\n没选上你我当年第2轮选课下一个志愿就是姬扬
219096,9522,矫金龙,2025-05-21 10:47:31,1,1,0,绝不点名，10分
219105,9522,矫金龙,2025-05-21 12:30:20,1,1,0,不点名！！！！！！！！！！！！！！！！
219158,9522,矫金龙,2025-05-22 13:11:11,1,1,0,老师真的好好！！不点名，小测也会提醒！
219211,9522,矫金龙,2025-05-23 04:08:56,4,4,0,😩😭我草，我的金龙老师啊，为什么你下学期不开课了啊😭😭😭
219253,9522,矫金龙,2025-05-23 11:33:12,0,0,0,不点名啊！！！！！
220569,9522,矫金龙,2025-06-18 14:21:17,2,2,0,赞美矫金龙老师！\n\n平时不考勤，小测会提前通知而且开卷，助教jj也是人美心善！\n\n大物这门课的分数组成是统一的，只要你用心学真的会有收获，不存在求不求是（不过我感觉我们助教jj期中真的好捞~爱了爱了）
220575,9522,矫金龙,2025-06-18 14:34:06,2,2,0,超级无敌好的大物老师 绝对是所有老师中最好的 首先第一节课保证不会点名 所以起不来的同学可以自学（bushi）并且平时分无敌 作业只要交了就是满分 作业忘记交了还会在群里一个一个@同学 小测会在群里提前通知 并且相比其他老师难度简单 时间充裕 期中期末助教jj非常捞 无敌给分 预制到他了偷着乐吧 大物2就没有他了。。。。。。。。。。。。。。。
221027,9522,矫金龙,2025-06-21 01:50:09,0,0,0,大物甲1\n\n金龙哥很耐心，很多知识点都不厌其烦地强调，好老师
182984,9542,林海青,2023-11-21 10:07:40,-1,0,1,作业真是有点多
194288,9542,林海青,2024-06-23 06:28:41,0,0,0,给分很好
178182,9546,朱宏博,2023-07-07 16:23:12,-1,2,3,课上的不怎么样，开卷考出卷子出的依托答辩，给分更是恶心人，真的无语
181812,9546,朱宏博,2023-11-01 09:17:16,3,3,0,朱老师上课内容风趣幽默，气质也比较儒雅，声音有点“细细”的哈哈，粒子物理的项目经验也很丰富！考试内容似乎主要来自讲义
183897,9546,朱宏博,2023-12-03 07:03:09,0,1,1,普朗克常熟测了300组数据，拟合数据还要写曲线你给我80，就你事情多你还给人头分
190437,9674,Go Ogiya,2024-03-04 05:12:58,8,10,2,音质好
180389,9739,RENYUE CEN,2023-09-21 10:47:24,16,18,2,岑老师实乃不可多得的良师。去年12月他全职回国加入浙大时，几乎所有人都以为是引进了一个“吉祥物”，只是引进一个大佬提升一些学科排名。没想到他真的收学生做科研项目，并且会毫不吝啬地提供他的资源。暑假他远在美国，还是会发邮件关心科研进度。相较于一些混上了职称就开始养老的老师，岑老师确实让我见识了一个真的有热情的科学家的风采。虽然我研究生期间可能不会继续从事星系宇宙学数值模拟的相关研究，但岑老师的关心和教导仍让我感激不尽。
192170,9739,RENYUE CEN,2024-05-10 15:22:32,16,16,0,强推！！！\n\n首先，毫无疑问岑老师在科研学术上妥妥大牛，来教一门大一通识课更是降维打击。但是，老师讲课特别认真诚恳，儒雅温和，去坐一坐都是一种享受。其次，从不点名，没有小组作业，一路水过来。并且只交10次作业+一次英语论文（作业是中文写，一次两道题，po对于物理啥都不会，尤其是英文授课，作业也没有很对，计算错的也多。论文是先写成中文，机翻英文。内容只要选一个天文小知识展开，搜寻都不难。）\n\n至于知识，岑老师讲的确实较为深入，可能和老师第一次教通识课有关，但不会对作业造成什么困扰。\n\n最后，真的感谢老师给我一个从来没想过的成绩！（po朋友也是4.8+） \n\n助教xy学长也特别好，对于作业问题特别热心解答！也作为学生和老师的桥梁和老师沟通上课情况，及时反馈。平心而论，英文授课确实给听课造成了难度，但是水过去，老师也不会让你失望。\n\n总而言之，强推这门课！！！
194564,9739,RENYUE CEN,2024-06-24 11:18:06,6,6,0,强推！非常好的老师！！\n\n老师之前是普林斯顿的教授，学术水平非常高！上课会和我们分享小故事。\n\n在最后结课的非常谦逊，还向我们询问课程有没有需要改进的地方。\n\n真的是非常好的老师，遇见为我幸。
198523,9739,RENYUE CEN,2024-09-09 12:05:13,0,1,1,超棒的老师
201660,9739,RENYUE CEN,2024-11-05 07:40:59,0,0,0,特别牛但是又很和蔼的老师，上天文学导论就是一种享受，毫不夸张地说我每周都很期待天文学导论，学到了很多新知识。虽然全英授课有些挑战，但是老师真的非常非常棒！
202718,9739,RENYUE CEN,2024-11-14 03:43:39,0,0,0,特别好老师
202721,9739,RENYUE CEN,2024-11-14 04:01:38,0,0,0,很好的老师！从不点名！\n\n不过不是非常喜欢天文学的同学慎入。全英文课程与作业有一定难度。而且貌似给分有些严格。。
202774,9739,RENYUE CEN,2024-11-14 09:25:06,1,1,0,全英文课程很有难度 而且理解起来比较困难 给分挺严格的 但是大家只要好好做作业还是可以拿到满意的分数的 4.8绩点留 加油大家！
205962,9739,RENYUE CEN,2024-12-13 02:12:32,1,1,0,不错，从不点到，但讲的还是比较专业的天文学知识，并且全英文授课，不过只要作业认真写，最后的论文好好写，4.5绝对没问题。
206862,9739,RENYUE CEN,2024-12-18 04:06:33,5,5,0,岑老师是真正的大师！以这样的履历来开一门通识课着实有些大材小用的味道，认真听绝对能有很多收获。\n\n作为一节通识课，蕴含的知识量是足够的，虽然我私心里希望能学到更多公式性的知识。\n\n老师的性格很温和，对提问的学生非常有耐心，平时也从来不点名。\n\n期末成绩构成是8次小作业一次8分，期末论文36分。不要用GPT水作业，做不来可以参考，但照抄AI后果很严重
211639,9739,RENYUE CEN,2025-01-12 05:51:42,2,2,0,老师非常好，在课上可以学到很多知识。就是全英文的听起来有点难，但是只要作业认真做（实在不会做参考一下AI，但是不照抄），就可以拿到一个不错的分数的。不要担心听不懂英文，冲冲冲！！！
190421,9840,焦琳,2024-03-02 12:07:09,10,11,1,不是所有学生都跟得上(-_-) zzz
190708,9840,焦琳,2024-03-15 11:01:51,7,8,1,看得出来老师真的有努力想把课讲得生动有趣一点，会提出一些值得思考的有趣问题，会进行一些拓展。\n\n但是老师好像是第一次教，不了解我们的真实水平，觉得我们什么都懂，讲得很快，PPT过得也快。希望这次的小测能让老师恍然大悟，调整课堂节奏。\n\n作业布置得不多，而且课前就公布，真的什么都懂了的同学可以边听边做原汤化原食（不建议）
192736,9840,焦琳,2024-05-29 23:55:34,5,6,1,感觉老师确实是第一次开设大物这门课👀但是可以看出来老师在很用心的准备课堂内容，包括但不限于课前生活现象引入、课上抛出问题引导学生思考（提醒一下老师喜欢提问后排同学😂）以及课后回答同学问题等等。当然老师讲的速度确实有一点点快，有时候课上跟不上需要课后花一点点时间（20min左右）回顾一下PPT，再做下作业其实发现也没有那么难。\n\n总之，课上注意听讲（最好自己跟着老师讲解做笔记，大物乙课本真的是老太太的裹脚布-又臭又长），课后完成作业，考前刷刷历年题成绩应该不是问题。\n\n老师是个幽默风趣的好老师，学弟学妹可以放心选😘
195130,9840,焦琳,2024-06-27 02:00:13,2,3,1,虽然看得出来老师有在很认真的上课，但有些地方真的听不懂（我自己的原因），考前历年卷也刷了，复习了好久，结果被卡绩（88）了，或许老师真的没什么经验去捞学生一把，也可能我只是个别情况，不过瑕不掩瑜，老师是真的有责任心的老师，主教哥哥也是超级“善解人意”！
196302,9840,焦琳,2024-07-03 00:33:26,3,3,0,虽然听着有点昏昏欲睡，但是其实讲的还是很清楚的。\n\n不过刷历年卷和作业例题还是顶顶重要的事情，是上课最强有力的补充~\n\n助教gg也太能捞了，我稀烂的小测全靠助教哥哥您啊啊啊！！\n\n也因此给分很好。\n\n老师有了经验后面一定会越讲越好的。
220418,9840,焦琳,2025-06-18 01:46:50,1,1,0,老师人很好
219151,10097,徐远锋,2025-05-22 11:05:52,0,0,0,为何没有人？
215356,10228,苟健,2025-02-25 10:09:15,6,9,3,老师人非常非常好，特别绅士而且有能力
215535,10228,苟健,2025-02-28 00:42:57,-4,6,10,讲得不好
215641,10228,苟健,2025-03-03 06:52:29,2,2,0,老师人太好了，双商超高的神仙老师
215642,10228,苟健,2025-03-03 06:59:07,-5,3,8,老师人很好，很绅士，但讲课属实一般
215727,10228,苟健,2025-03-05 01:47:25,1,2,1,老师挺帅的
216046,10228,苟健,2025-03-10 02:19:22,0,1,1,好好好
216179,10228,苟健,2025-03-11 14:12:48,0,1,1,好好好
216459,10228,苟健,2025-03-17 01:34:34,9,9,0,老师很帅，我一个直男都心动惹！
216531,10228,苟健,2025-03-18 04:01:18,1,1,0,讲的很清晰（虽然我没怎么听）签到会提前通知（至少这一次是的），温文尔雅
217270,10228,苟健,2025-04-07 08:34:07,3,3,0,前面的，你最好素直男💅🏼
217610,10228,苟健,2025-04-14 05:49:19,1,1,0,老师真的好好，知道期中周我们考试多要复习，作业就留了四道题，还延迟提交日期了
219146,10228,苟健,2025-05-22 07:52:49,1,1,0,自学友好型老师
219711,10228,苟健,2025-06-04 11:36:34,0,0,0,点名会提前通知，很会体谅学生，不过适合自学能力强的，讲课一般
220485,10228,苟健,2025-06-18 07:41:40,0,0,0,苟健老师真的人非常好！点名和小测都会提前通知，而且非常关心我们的学习情况，小测也都会留充足的时间，总之就是人超级好的。至于讲课，我觉得苟健老师讲得很认真，只是可能新入职zju还没有太熟悉上课的难度，所以讲得基础了一点。但是相信这么认真负责的老师后面会越讲越好的~更偏向自学的同学强烈推荐选苟健老师
220497,10228,苟健,2025-06-18 08:53:25,-1,0,1,我老公
220526,10228,苟健,2025-06-18 11:25:33,0,0,0,很好的老师！幽默风趣同时关心学生！助教哥哥也很nice！这学期预置苟健老师的课真的是大学修来的福分！！！
207172,10246,钟先平,2024-12-19 14:07:02,7,26,19,钟老师好帅啊🥵🥵🥵事少分又高，讲课真可好🥰🥰🥰我要成为钟老师的🐶🐶🥹🥹🥹
217105,10246,钟先平,2025-04-02 02:30:01,10,12,2,都来上钟先平老师的课吧。都来上钟先平老师的课吧。都来上钟先平老师的课吧。都来上钟先平老师的课吧。都来上钟先平老师的课吧。都来上钟先平老师的课吧。都来上钟先平老师的课吧。都来上钟先平老师的课吧。都来上钟先平老师的课吧。都来上钟先平老师的课吧。都来上钟先平老师的课吧。都来上钟先平老师的课吧。都来上钟先平老师的课吧。都来上钟先平老师的课吧。都来上钟先平老师的课吧。都来上钟先平老师的课吧。都来上钟先平老师的课吧。都来上钟先平老师的课吧。都来上钟先平老师的课吧。都来上钟先平老师的课吧。都来上钟先平老师的课吧。都来上钟先平老师的课吧。都来上钟先平老师的课吧。都来上钟先平老师的课吧。都来上钟先平老师的课吧。都来上钟先平老师的课吧。都来上钟先平老师的课吧。
217109,10246,钟先平,2025-04-02 03:01:29,2,7,5,小测时间短难度较大真的好吗？\n\n小测要区分度真的对吗？
217115,10246,钟先平,2025-04-02 05:27:38,2,6,4,小测做不完，呜呜呜
217168,10246,钟先平,2025-04-03 05:02:09,8,9,1,讲课挺好的，老师也很随和，允许你不来听课，作业量也不多，就是小测有点难写不完。
217189,10246,钟先平,2025-04-03 10:07:29,3,6,3,小测时间好短真的写不完
218561,10246,钟先平,2025-04-24 14:45:27,16,16,0,如果你是一只猫，你将得到满绩。
219847,10246,钟先平,2025-06-09 01:56:17,0,0,0,讲课一般，但人很好。会点名但不计成绩
220582,10246,钟先平,2025-06-20 10:02:36,7,7,0,钟：小测虽然有点难 但既然期末是赋分的其实跟简单的也没区别啊\n\n希望出分后发现这句话是真的www  该说不说平时小测前定时补天减小了很多期末周的压力  而且小测严查作弊  公平还是很公平的\n\n\n\n期末成绩出了 我是🤡 看老师怎么捞吧 他可能只捞人上及格线\n\n\n\n密码的扣这么多平时分？？？只能说终究还是错付了哈哈哈哈哈哈哈哈。。。。。。。。。。
220746,10246,钟先平,2025-06-20 10:06:36,8,8,0,大学物理就是这么绩杀的吗
220916,10246,钟先平,2025-06-21 06:16:48,2,3,1,不会捞，一般吧，平时分就那样赋分赋起来。。。\n\n被杀了wwwwwwwwwwwwwww\n\n没实力的别来，有实力的可以选更好的（）\n\n\n\n反驳一下楼下的\n\n其实你是一只猫也不一定管用（）
220937,10246,钟先平,2025-06-20 11:40:31,4,4,0,我看往年的大物，我感觉我轻轻松松上4.5，但今年，怎么说呢，平时分被扣了8分，恩，小测很不合理，就是难度和时间，大家可以跑了。
220995,10246,钟先平,2025-06-20 15:15:06,0,0,0,emm
221148,10246,钟先平,2025-06-21 13:32:33,0,3,3,教学水平上，他自己也承认了就是念ppt，什么水准我也不想赘述了，反正大学大学大不了自己学。\n\n其他方面，开学时反复强调不签到，期中过后又开始随机签到，前一天晚上反复强调线上小测全是选择，第二天线下发卷子全是大题。我不清楚得和学生有什么仇才会这么喜欢骗学生。\n\n平时话说的很好听，反复强调让大家不要担心，到最后也没看出怎么捞，平时分扣了好多。\n\n小测完全不确定，难度不确定时间不确定形式不确定，测了四次改了四次，二十分钟四道大题共十三道小题什么含金量我不多说了。\n\n我理解你是第一次带学生，那你就把我们当小白鼠随便实验？你给我们一个爆炸的绩点，然后自己过自己的好日子去，这就是老师该有的样子？\n\n总之，选上他的课就赶紧跑吧，不然就是纯给自己添堵。
221276,10246,钟先平,2025-06-22 11:36:45,5,6,1,说白了大物平时分本来就很容易拉开差距，赋分会导致你作业和小测一点差距变成总评的很大差距，这是规则不合理和老师捞不捞也没啥太大关系吧。先说签到，老师明说不到不会扣分，但是如果你到了快挂科了老师会捞你。再说小测，我只能说我也是每次小测前补天一晚上学个一两章，但是这让我的期末考会少补很多内容，而且这种闭卷高压考试总比其他那些老师不监考的线上考试，大家随便作弊公平的多吧！不要因为自己不能够靠作弊来水一个不属于你的平时分而来诋毁老师，不过确实会因为小测难度较大对你的平时分有不确定性，如果自学能力强的十分推荐，其他人慎选
221304,10246,钟先平,2025-06-23 00:17:06,0,0,0,复旦院校代码处打卡
221615,10246,钟先平,2025-06-25 02:42:30,1,2,1,一大坨
215492,10285,王孝群,2025-02-27 02:35:59,7,7,0,讲的一坨，作业不少，经常点人回答一些莫名其妙的问题，次次点名，神人👍
215804,10285,王孝群,2025-03-05 15:14:21,3,3,0,上课节奏不好，讲的很无聊🥱
219942,10285,王孝群,2025-06-11 16:08:20,4,4,0,人挺好的，但是教学的模式实在有点蠢了
221461,10285,王孝群,2025-06-24 01:07:52,1,2,1,10分好评！讲课简单细致有思路体系，试卷考察有新意重推导过程，最后给分也很好，是我认为目前接触到的最好的物院老师。
206264,10303,刘彬,2024-12-13 12:18:13,8,11,3,不知道
216611,10303,刘彬,2025-03-19 07:11:35,0,2,2,问他问题就让我们去答疑群 这种不作为的风气太差劲
216976,10303,刘彬,2025-03-30 18:30:31,3,3,0,目前来看感觉还挺好的。
218099,10303,刘彬,2025-04-21 04:17:03,0,0,0,刘斌老师的小测暂时看来比较简单，不用费很多功夫就能做出来，不容易被小测闪击。
220456,10303,刘彬,2025-06-18 04:05:00,0,0,0,推荐来
220961,10303,刘彬,2025-06-20 13:15:00,3,3,0,老师是23年刚入职的，第一次上大物，可以看出花了很多很多精力在准备每节课。虽然大物期中期末占大头，基本上要靠自己考出来，但是能捞的都尽量捞了。老师人很好，很欢迎交流，特别亲切。上课很有物院风味，重推导重思维，应试性的内容偏少一些（和老师反馈了这点，以后应该会改善）。一学期没点过名，小测提前通知，都是学在浙大线上测试。
221149,10303,刘彬,2025-06-21 13:36:01,2,2,0,刘彬老师身上就是有一种新老师的激情，对每个同学都很关心，而且人特别好，10分
221726,10303,刘彬,2025-06-25 13:50:39,0,0,0,老师讲的真的挺不错的，注重推导。平时不点名，小测会提前在群里通知，而且都是选择题，给分也挺好的。
208453,10317,汪臻涛,2024-12-28 05:03:51,7,7,0,汪老师的普物I，当时给我们上了半个学期的课，体验非常好的，老师会认真地写板书
215340,10317,汪臻涛,2025-02-25 08:27:51,2,2,0,老师很有趣
219525,10317,汪臻涛,2025-06-14 04:44:28,4,4,0,是本人。普物这门课一般会有好几个平行班，其中绝大部分班级的期中期末考试是统一出卷统一批改的，最终的打分标准（比如平时分的比例、总评怎么调分）也是统一的。所以，同学们评价普物课的时候，其实不需要讨论哪位老师给分多哪位给分少。写这条的时候第二次上普物课，经验还不多，估计还有不少不足之处，大家多包涵~
220474,10317,汪臻涛,2025-06-18 06:21:11,1,1,0,汪老师是一个很好的老师。每节课也会在学在浙大上上传自己的手写笔记，是一个很负责的好老师。
221335,10317,汪臻涛,2025-06-23 03:58:37,1,1,0,超级好的老师!!上课和答疑都很有水平， 老师人也很好很幽默风趣\n\n而且很能捞啊啊啊啊谢谢老师!!!!
199010,10333,雷海,2024-09-14 02:51:24,14,19,5,抽象抽象
199092,10333,雷海,2024-09-30 01:57:02,8,12,4,英文ppt，起飞的讲课速度，超多的作业量
199106,10333,雷海,2024-09-18 00:32:47,7,11,4,抽象至极，老师不要来折磨我们这些不是物理专业的学生了😭😭
199360,10333,雷海,2024-09-22 03:14:05,9,12,3,抽象，讲得贼快，本来电场电容静电屏蔽那一块就很难，他直接带过了，现在开学两周直接干到磁场，根本消化不了这么快。此外全英文ppt，本来拿中文写ppt我都需要相当部分时间去理解物理原理了，现在还要花费额外的时间去理解英文，效率低了很多。大佬或许听得很爽，但对普通学生来说可能有点难吧。
199378,10333,雷海,2024-09-22 12:42:16,3,4,1,折磨，虽然有基础但还是很折磨，主要是讲的太糙了
199743,10333,雷海,2024-09-28 15:50:34,1,2,1,据我朋友说很抽象
199928,10333,雷海,2024-10-08 13:46:33,6,7,1,很有水平的老师，全英ppt，注重物理思维培养，不关心解题应试，完全有去竺院教普物H的水准，只给我们上上大物真的是屈才了
200043,10333,雷海,2024-10-11 15:30:16,1,3,2,大物甲全英文ppt你是心高气傲……0人听懂他在讲啥
200314,10333,雷海,2024-10-16 01:34:03,6,6,0,老师基本都是在拓展内容，PPT里的方法也比较超纲。非常适合有比较好的物理和数学基础，对于物理水平有自信，渴望得到提升，对于物理有兴趣的同学；很不适合本来学习物理就较为吃力的同学。老师人还是不错的，数字点名。
200693,10333,雷海,2024-10-21 04:21:46,0,0,0,笑飞了，讲什么啊在
200934,10333,雷海,2024-10-25 04:13:38,7,7,0,老师人很不错，很幽默对学生也很认真很耐心。对于教学有一套自己的想法，和其他老师不同，但是因为刚刚开始上大物课，对于要应试的同学来说，全英ppt，飞快的上课速度，知识的简单讲述，本身就需要加强学习的同学听起来会非常非常折磨，整个学期下来全在自学，只能说是一位很优秀的老师，但不适合来上大物这一门应试为主的课程
201025,10333,雷海,2024-10-27 08:51:45,2,4,2,雷海老师好像是新老师，所以讲课的速度节奏会比较快，一般跟不太上，但是自学的话也差不多。老师之前好像一直是在国外授课，24秋讲课纯英文，理解起来确实问题很大，也导致自学任务加重了。不知道以后会不会改善。课内外拓展知识讲的很多，适合想要拓展自己视野的同学。作业量不太多，每次下课布置6道题左右，偶尔会有老师自己加的题目，但是题量不会增加。之前的小测是8选4做，感觉还行，认真复习是可以做出来的。老师人也比较平易近人，有的时候挺幽默的。点名基本都会提前通知，数字点名也有。\n\n总的来说我觉得适合喜欢拓展自己能力的同学，其他同学也可以选，只是学习感受可能不太充足。如果老师能够在以后的教学中有改进自己的教学模式方法的话就更好了。
201037,10333,雷海,2024-10-27 15:11:00,3,3,0,不好，是雷神，我们没救了
201677,10333,雷海,2024-11-05 10:19:41,3,3,0,还可以
201755,10333,雷海,2024-11-06 03:26:27,22,22,0,不知道为啥评分那么低，我给的是10分\n\n好的方面：\n\n1，点名居然会提前通知！这可是大学物理啊，点名提前通知超过99%的大物老师，而且是数字点名\n\n2，作业不多，小测压力不大，作业每次不超过6道题，都是书上的，小测压力完全不大\n\n3，老师真的想教我们点什么，而不只是应付于大物考试，他是新老师，并不愿意完全按学校要求教一些死知识（这也正是不好的地方之一）\n\n不好的方面：\n\n主要是上课内容的问题，他上课很快，极快！其他老师讲到期中考时，他已经快讲到期末考了（这是真的，不是夸张）。但是小测的内容和其他老师是一样的，这点不用担心。他可能讲到第十章，但第一次小测和其他老师一样依然只考第一章 第二三次小测依然如此。还有就是上课英语教学，有时候叽里咕噜讲些什么我完全听不懂。\n\n\n\n总结一下：为什么我打10分呢，因为我选上了他的课但不听，而是听其他老师的智云。如果你选上他的课，建议还是别听了，听其他老师的智云。那你将会收获最好的大学物理体验
202249,10333,雷海,2024-11-13 08:05:17,10,11,1,点名是数字点名而且会提前通知，小测的形式与难度均很友善，老师和助教的性格也都很好，唯一的缺点是上课内容过得很快而且不以做题为导向。个人认为雷海老师的课非常适合有能力自学大雾或平时不学考试周速通的同学选\n\n更新：搞了个突袭雷达点名，无敌了
205794,10333,雷海,2024-12-12 04:22:35,6,6,0,老师人其实挺好的，作业不会很多，小测压力也不大，就是讲课全英文有点不好理解，估计大多数人都跟不上的吧，他是真的想教一些深层次的不拘泥于课本的知识，只不过是我太菜了，还是给十分吧，看其他老师的课也是能自学的
208234,10333,雷海,2024-12-26 09:16:47,4,4,0,期末再评一次，老师后面的ppt换中文了。。。也是在不断调整自己的教学吧。总之老师人很好，讲课也不错，但是会偏难，对自己物理有自信的同学大胆选就行了，可以学很多东西
209124,10333,雷海,2025-01-11 05:17:11,8,8,0,小测压力几乎没有，很少点名，对物理学很有见解。给他打10分，因为不想辜负一个新老师对教学的热情。老师真的很爱物理学吧。\n\n\n\n出分了编辑：给分超特么好。
209180,10333,雷海,2025-01-05 02:34:28,2,2,0,点名会提前说，小测也会提前说，小测压力小，老师和助教人都非常好，唯独就是对内容上有自己的见解，对大物有自信的可以选
211132,10333,雷海,2025-01-11 01:14:15,4,4,0,老师是好人。不过第一次带大物课，导致上的内容比书上的难，要靠自学。
211142,10333,雷海,2025-01-11 01:41:21,1,3,2,给分好
211161,10333,雷海,2025-01-11 02:56:52,3,3,0,讲的有点抽象…不过老师人挺好
211171,10333,雷海,2025-01-11 03:11:37,5,5,0,不准黑我们伟大的雷海老师😭😭😭雷海是真好老师啊
211456,10333,雷海,2025-01-11 13:20:41,0,0,0,给分很好，老师和助教性格也很好！
212480,10333,雷海,2025-01-14 05:14:48,2,3,1,老师和助教都好好，出分很捞，感谢！
219190,10333,雷海,2025-06-16 04:04:32,1,1,0,怎么说呢，我是下学期上他的课，我是真的对物理有兴趣。看大家评论我真的很期待。我就是喜欢课外拓展知识而且讲得很快的老师。给10分了
219133,10441,吴振华,2025-05-22 04:58:56,0,1,1,好好好
219528,10441,吴振华,2025-05-29 08:26:48,2,2,0,希望是好老师。
219529,10441,吴振华,2025-05-29 08:25:44,2,2,0,希望是优秀老师。
215181,10443,杨洪新,2025-02-24 01:09:45,5,5,0,上课较为认真，但是语气较平淡，平淡到了非常容易犯困的地步
215323,10443,杨洪新,2025-02-25 07:05:09,4,5,1,讲课语气是真的一点不变，容易让人走神
215478,10443,杨洪新,2025-02-26 14:59:41,6,6,0,。。讲课能力较弱。\n\n可能学术水平较高。。。
215709,10443,杨洪新,2025-03-04 12:57:36,5,5,0,刚来浙大的老师，对很多事情都不太熟悉\n\n讲课时语气非常平淡，还有点结结巴巴的，让人犯困\n\n上课不分重点，比较简单的部分讲很多，难的部分一笔带过\n\n给人的感觉不是第一年来浙大，而是第一次当老师
216595,10443,杨洪新,2025-03-19 03:29:45,3,3,0,讲的含含糊糊 很难学到具体的做题本领和知识
218113,10443,杨洪新,2025-04-21 07:50:50,4,4,0,你就说期中考捞不捞吧，这老师可太棒了
218790,10443,杨洪新,2025-05-06 02:40:08,1,1,0,感觉讲课真的很烂，语气让人昏昏欲睡，感觉讲的也不是多清楚，已经转战xxp智云自学了
219156,10443,杨洪新,2025-05-22 12:37:25,1,1,0,虽然讲课一般般，但是不点名就很好
219217,10443,杨洪新,2025-05-23 05:25:52,2,2,0,小测比较水 也不点名 老师性格也还可以，就是讲课不太行
221236,10443,杨洪新,2025-06-22 06:44:00,1,1,0,不点名，上课比较乏味。似乎不怎么捞，拿了绩点新低3.3
214887,10582,姬扬,2025-02-19 01:52:44,19,20,1,上课不讲课本，快跑
214888,10582,姬扬,2025-02-19 02:30:09,18,19,1,不知所云
214910,10582,姬扬,2025-02-19 05:03:05,84,88,4,孩子们快跑！这个老师成功地把大物当成水课来上了😰😰😰
214929,10582,姬扬,2025-02-25 14:00:43,-2,19,21,大水王
214959,10582,姬扬,2025-02-19 10:50:05,-24,9,33,这十分我将给智云课堂🤓☝️
215114,10582,姬扬,2025-02-21 10:04:23,22,23,1,快逃！
215116,10582,姬扬,2025-02-21 11:07:55,400,414,14,上完课感觉姬姬扬扬的
215151,10582,姬扬,2025-02-23 02:44:36,31,32,1,上课光吹水\n\n就讲他和deepseek以及他翻译那几本书的故事，毛都学不到\n\n幸好我能通过霸王选课run了\n\n能run的快run 要不然期末后悔来不及
215186,10582,姬扬,2025-02-24 02:25:05,52,55,3,从秦始皇到奥本海默无所不谈\n\n那姬扬老师，您上课什么不讲呢\n\n哦，我们这节课不讲课本，不讲物理\n\n我们来讲讲我的翻译😈\n\n哎\n\n孩子们快跑
215188,10582,姬扬,2025-02-24 02:34:15,68,73,5,不知所云，真的没人劝啊，或者反映一下。\n\n感觉沉浸在自己的世界里，你浙初来乍到的老师没有相关跟踪考核机制吗，这是何方神圣啊？
215189,10582,姬扬,2025-03-01 15:37:04,33,36,3,选上之后只能补谢小平老师的智云课堂了，或者直接去同一时间的其他大雾教学班旁听\n\n开始讲三体了...\n\n水军差不多得了。\n\n寄养是个人物
215190,10582,姬扬,2025-02-24 03:23:47,20,21,1,课前神奇问题，无厘头让人提问，上课不知道在干什么。deepseek魔怔人
215194,10582,姬扬,2025-02-24 03:53:20,10,11,1,不知所云，热爱提问
215197,10582,姬扬,2025-02-24 03:37:23,7,8,1,shit
215208,10582,姬扬,2025-02-24 08:39:57,10,11,1,不知所云，讲课毫无重点
215209,10582,姬扬,2025-02-24 08:55:26,51,52,1,脑袋长姬姬了
215224,10582,姬扬,2025-02-24 13:05:46,10,11,1,这是大学物理导论课嘛
215227,10582,姬扬,2025-02-24 15:05:02,11,12,1,大无语\n\n不讲课本内容，提一些尴尬问题，每节课强推deepseek，在课上想死死不掉，想逃逃不了，浪费时间和精力，只能说，不太适合讲课
215232,10582,姬扬,2025-02-25 00:28:14,19,21,2,你上的是大学物理导论吗😰
215261,10582,姬扬,2025-02-25 02:47:03,9,10,1,快跑，他不讲物理
215287,10582,姬扬,2025-02-25 04:01:59,19,20,1,随时面临提问的自习课
215322,10582,姬扬,2025-02-25 07:02:54,6,7,1,上完第一次课就再没去过了…
215325,10582,姬扬,2025-03-02 05:09:12,18,19,1,大雾甲什么时候变成通识了
215327,10582,姬扬,2025-02-25 07:17:11,5,7,2,sb东西
215347,10582,姬扬,2025-02-26 15:17:50,31,32,1,哈姬扬
215349,10582,姬扬,2025-02-25 10:37:03,3,5,2,上了就完蛋力
215355,10582,姬扬,2025-02-25 09:58:19,14,15,1,xxp启动！
215357,10582,姬扬,2025-02-25 10:17:54,9,10,1,《诶同学们都熟悉我的上课风格了吧》
215359,10582,姬扬,2025-02-25 10:28:18,-13,7,20,感觉老师还是挺有意思的 至少挺想活跃课堂气氛的 上课内容确实难评但人还不错
215360,10582,姬扬,2025-02-25 10:40:45,6,7,1,一分都给高了666
215367,10582,姬扬,2025-02-25 11:43:50,8,9,1,快跑，这人上课像推销中老年保健品的推销员，起码对你的考试没有。当然，不想学的另说。
215372,10582,姬扬,2025-02-25 12:09:22,3,4,1,快跑！！！！！！！！！
215381,10582,姬扬,2025-02-25 14:34:16,-26,3,29,还不知道给分怎么样，再说就上了一周课，没必要扣这么厉害
215396,10582,姬扬,2025-02-26 01:33:26,35,36,1,我很少用迷失幻境来形容一个老师的课
215397,10582,姬扬,2025-02-26 01:21:31,27,30,3,🐳孝子
215400,10582,姬扬,2025-02-26 01:30:27,4,5,1,快跑!!!
215406,10582,姬扬,2025-02-26 01:45:28,19,20,1,同学们，你们都错怪姬扬老师了。他只是想给你们一个自习课而已，他有什么错。（所以大物不会还是去听其他老师吧）
215412,10582,姬扬,2025-02-27 06:17:31,34,38,4,学好热学的最好方法是听你上课讲核聚变吗？哈基扬，你这家伙……🥰
215414,10582,姬扬,2025-02-26 03:52:03,12,13,1,如果您当年的大学物理老师也是这么给你讲课的话，那么这辈子有了
215419,10582,姬扬,2025-02-27 10:30:01,40,45,5,热学变物理通识课\n\n第一节课洋洋洒洒讲自己的经历和情怀已经初见端倪，但想着毕竟第一节课就没退，结果第二节课连ppt都没开，莫名其妙唠嗑一坨...\n\n\n\n\n\n自爆了！他说自己以前'碰巧'学过热学！
215421,10582,姬扬,2025-02-26 04:28:55,20,22,2,臭傻逼
215423,10582,姬扬,2025-02-26 04:42:25,-7,3,10,🐔🐑牛逼
215454,10582,姬扬,2025-02-26 07:57:43,21,23,2,周武王的后代要求连坐制，从奴隶社会一下到了封建社会，实在是太超前啦
215509,10582,姬扬,2025-02-27 07:23:45,2,4,2,呵呵呵
215551,10582,姬扬,2025-02-28 06:20:20,5,6,1,....听课不如不听课
215613,10582,姬扬,2025-03-03 02:11:41,4,5,1,………
215620,10582,姬扬,2025-03-03 03:13:03,56,58,2,大家注意了，zyg改名为jy，大家差评不要打错地方了
215621,10582,姬扬,2025-03-03 03:13:27,4,5,1,沙币玩意
215625,10582,姬扬,2025-03-03 04:15:37,17,18,1,jy老师！我们喜欢你🥰\n\n我们喜欢deepseek🐋\n\n喜欢提问题❓\n\n[ac01]
215649,10582,姬扬,2025-03-03 09:59:30,4,5,1,目前见过所有老师里最让我感到无语的
215657,10582,姬扬,2025-03-03 13:04:29,2,4,2,助力收敛
215660,10582,姬扬,2025-03-03 15:11:40,5,6,1,大学物理课 ×\n\ndeepseek课 √\n\n哲学课 √
215661,10582,姬扬,2025-03-03 15:15:26,8,9,1,达芬奇，但是没有奇
215669,10582,姬扬,2025-03-04 02:01:22,6,7,1,助力收敛🤪😅💪👊
215672,10582,姬扬,2025-03-04 02:32:09,49,51,2,好扬啊☺️好扬啊我的姬姬
215689,10582,姬扬,2025-03-04 05:57:05,5,6,1,大物课有自己的郑音飞
215704,10582,姬扬,2025-03-04 11:14:49,7,8,1,演都不演了，六百六十六
215717,10582,姬扬,2025-03-04 15:43:15,6,7,1,慕名而来，助力收敛
215735,10582,姬扬,2025-03-05 03:16:54,7,9,2,助力一分收敛
215742,10582,姬扬,2025-03-05 04:41:58,14,17,3,第三周热学课依旧各种暴言\n\n“没有人会限制我怎么上课”\n\nbyd还说自己第一次在浙大上课，拿上课当做实验
215746,10582,姬扬,2025-03-05 05:42:57,6,6,0,助力收敛
215750,10582,姬扬,2025-03-05 06:40:36,4,5,1,授课共欣赏，疑义相与析。
215752,10582,姬扬,2025-03-05 07:11:08,51,52,1,一节不上姬扬的，两节不上姬姬扬扬的
215757,10582,姬扬,2025-03-05 07:58:58,15,15,0,老师讲得很好，听完姬姬扬扬的！
215759,10582,姬扬,2025-03-05 08:11:45,6,6,0,笑死我了，笑得我🐔痒
215760,10582,姬扬,2025-03-05 08:13:01,4,4,0,无话可说了
215761,10582,姬扬,2025-03-05 08:17:48,10,10,0,哈姬扬
215763,10582,姬扬,2025-03-05 08:35:38,8,8,0,热烈欢迎知乎实名网友莅临浙大拿本科生做课堂实验研究
215767,10582,姬扬,2025-03-05 10:18:23,14,14,0,物理学院的热学专业课上到第三节终于出现了第一个公式PV=nRT，大家看着办吧
215768,10582,姬扬,2025-03-05 10:26:58,7,7,0,必扬的哈姬扬
215771,10582,姬扬,2025-03-05 11:24:21,5,5,0,真难评
215773,10582,姬扬,2025-03-05 11:33:21,5,6,1,助力1分
215775,10582,姬扬,2025-03-05 11:57:40,7,7,0,授课仅供欣赏，疑义从来不析，大概是人型deepseek广告牌吧。
215777,10582,姬扬,2025-03-05 12:17:54,5,5,0,唯一真实
215802,10582,姬扬,2025-03-05 15:01:41,5,5,0,蒂普西克的狗
215807,10582,姬扬,2025-03-05 15:46:14,6,6,0,博客地址 https://wap.sciencenet.cn/home.php?mod=space&uid=1319915
215809,10582,姬扬,2025-03-05 16:07:59,4,4,0,助力收敛
215810,10582,姬扬,2025-03-05 16:20:06,11,11,0,如何分辨狼和狗\n\n听叫声是否低沉\n\n低沉为狼 激扬是狗
215811,10582,姬扬,2025-03-05 16:20:09,7,7,0,如何分辨狼和狗\n\n听叫声是否低沉\n\n低沉为狼 激扬是狗
215812,10582,姬扬,2025-03-05 16:26:22,4,4,0,哈姬扬哈姬扬哈姬扬
215814,10582,姬扬,2025-03-05 16:38:57,6,6,0,慕名而来上了一节课，越上越感觉姬姬扬扬的，第一次出现这种症状正常吗
215830,10582,姬扬,2025-03-06 02:23:48,3,7,4,挺有意思的
215838,10582,姬扬,2025-03-06 02:55:21,11,11,0,助力收敛
215854,10582,姬扬,2025-03-06 04:00:01,5,5,0,果壳救场
215855,10582,姬扬,2025-03-06 04:01:50,5,5,0,老师真是神人了
215885,10582,姬扬,2025-03-06 12:44:17,6,6,0,姬姬扬扬的
215896,10582,姬扬,2025-03-06 15:25:59,17,17,0,我们姬圣下罪己诏了/(ToT)/~~康康下周是否依然给大家喂石赤
215897,10582,姬扬,2025-03-06 15:43:41,6,7,1,帮每次上完课满口赞美的室友助力收敛
215901,10582,姬扬,2025-03-07 02:20:30,5,5,0,哈哈哈
215909,10582,姬扬,2025-03-07 03:08:36,5,5,0,助力收敛
215936,10582,姬扬,2025-03-07 16:24:38,12,13,1,两天没听🐔老师讲课了，总感觉姬姬扬扬的
215942,10582,姬扬,2025-03-08 01:49:44,37,37,0,一天不听姬扬的（积阳德）\n\n听完以后姬姬扬扬的
216045,10582,姬扬,2025-03-10 02:31:16,13,14,1,所谓“按照课本讲”，指的是有ppt，在一本正经乱讲，换汤不换药。讲了近20分钟还在概念页\n\n我们碰巧遇到技痒。
216052,10582,姬扬,2025-03-10 03:25:07,18,19,1,今天见证了他改革后的第一次课\n他说他这节课迫于无奈要开始用PPT了。\n但是讲的还是一坨屎，根本拎不清。\n上课之后我在看谢小平老师的智云课堂，他的课堂就很精彩，谢老师值得一声“先生”敬称。\n姬扬也算是个人。\n下节课小测，不知道要怎么办
216128,10582,姬扬,2025-03-11 02:17:22,10,11,1,现在开始用PPT了，但他上课的本质不变
216326,10582,姬扬,2025-03-13 10:09:09,9,12,3,差点就选上了，太幸运了😂
216364,10582,姬扬,2025-03-14 10:21:53,4,5,1,还好霸王选课逃了\n\n最逆天的老师
216383,10582,姬扬,2025-03-15 05:36:22,6,6,0,坤坤坤
216417,10582,姬扬,2025-03-16 10:12:25,8,12,4,我打算再相信一次，看得出来老师很有想法，但是实在是缺少教学经验
216542,10582,姬扬,2025-03-18 07:11:34,-25,8,33,我觉得作为浙大的学子，还是不要太极端了。1分过分了。虽然说不上好，但是6分左右还是有的。
216572,10582,姬扬,2025-03-18 15:17:10,19,25,6,姬扬老师自己的水平和上好课的心都是有的，只是可能需要与浙大的教学模式再磨合一下。\n\n我觉得姬扬老师如果去开一门通识选修课搞不好会大受欢迎。
216709,10582,姬扬,2025-03-21 15:46:25,-16,3,19,其实还不错
216759,10582,姬扬,2025-03-24 06:55:18,-1,0,1,666
216815,10582,姬扬,2025-03-26 05:08:21,16,16,0,选上🐔🐏老师的课你就有福了\n\n一节课读课本，两节课讲废话\n\n收获是没有的，提问是不可少的\n\n这就是您所谓的创新吗？
216819,10582,姬扬,2025-03-26 06:48:40,1,2,1,天天提问。。
217091,10582,姬扬,2025-04-01 15:26:07,8,9,1,i4b
217099,10582,姬扬,2025-04-02 00:53:00,18,20,2,彼阳若至，小测出的什么寄吧题目，让你猜月球质量有意义吗？觉得自己会背几个常数很了不起是不是🤣还说“我好为人师”🤣🤣🤣
217108,10582,姬扬,2025-04-02 02:54:11,7,8,1,我要当姬孝子 😍这个老师太棒了
217212,10582,姬扬,2025-04-04 14:04:05,19,19,0,上课的味道和田园薯片的激扬芥末味一样冲
217228,10582,姬扬,2025-04-05 08:33:45,48,49,1,你老公
217369,10582,姬扬,2025-04-09 06:23:51,-21,4,25,上课生动活泼有意思
217466,10582,姬扬,2025-04-11 01:35:55,8,9,1,听这个老师讲课云里雾里，觉得整个人都不好了，唧唧痒痒的。
218297,10582,姬扬,2025-04-22 11:20:45,4,4,0,傻孩子们快逃啊！
218332,10582,姬扬,2025-04-22 16:05:20,8,11,3,客观评价下：老师有想上好课的心，水平也是在线的，但自身的教学方法确实不太契合大学物理这样一门数理基础课，但他自身也在听取意见有些改变，对学生的提问也算上心（会把钉钉私信统一发群里回复），希望能尽快适合自己又能被大家接受的教学方式吧。（老师会点名但一般在小测时或是会提前通知）
218880,10582,姬扬,2025-05-10 13:44:37,7,7,0,fvv，被室友上台单杀了
218986,10582,姬扬,2025-05-16 12:22:04,1,3,2,游戏人数: 6~9人为宜\n\n游戏道具: 使用扑克牌一副， 额外扑克牌4~5副(作为108~162个1分筹码与108个5分筹码; 6人局使用4副， 7~8人局使用4~5副， 9人局使用5副)\n\n游戏流程: 进行至仅剩余一名玩家. 初始盲注级别为1/2， 庄位每转过一圈后提升至2/4， 5/10， 10/20， 20/40(最高). 每当第1， 3， 5， ...圈结束后， 进行一次特殊局: 进行奥马哈游戏， 不设盲注或最小下注， 每个在场玩家在发手牌前就轮流选择下注或放弃， 当所有人下注量相等时直接亮牌比较\n\n备注: 第n圈结束是指在出现一名玩家作为n+1次庄家之前; 每次下注量必须为小盲的倍数， 且最小加注为2倍当前注， 剩余筹码数量不足时除外\n\nMotivations: 人数在一定范围内均可游戏(人数不足6人时可玩其它玩法); 观察盲注上涨的模式是否合理
219052,10582,姬扬,2025-05-20 04:25:37,6,7,1,钾铷镧钐镥铼铂钍铀都有天然放射性同位素
219461,10582,姬扬,2025-05-28 01:23:25,5,6,1,一些论文：\n\nhttps://gzb.cas.cn/kyj/202505/t20250508_7645852.html\n\nhttps://www.isotopx.com/resources/high-precision-os-isotope-ratio-measurements-using-phoenix-x62-tims
219567,10582,姬扬,2025-05-30 01:23:29,6,6,0,又到了一年一度的赛尔号周年庆时间。我们知道精灵许愿每年会有50票的赠送额度，大家肯定会发愁这50票怎么用。我的建议是，图鉴搜索序号190（林奇），全部给它。\n\n大家肯定会奇怪，这只精灵只需要9票，那多余的41票全浪费了？不用担心，对于我们这些云玩家来说，那些需要多于50票的精灵我们根本是用不到的。而你许愿一个林奇之后，只需要每次花5块钱，就能把随便抓的野生精灵克洛亚黑暗化变成古雷亚。这个操作是不限量的，如果你想，一年搞100只古雷亚都可以，只是每只需要花5块钱（也不算很多，对吧）。只需要一只林奇，就能获得不限量的古雷亚了！
219673,10582,姬扬,2025-06-03 20:31:43,1,1,0,mRNA非翻译区有SECIS - 翻译区的UGA对应硒半胱氨酸\n\nmRNA非翻译区无SECIS - 翻译区的UGA对应终止密码子
219675,10582,姬扬,2025-06-04 03:01:40,2,2,0,游戏提示：\n\n打牌至玩家手中没有剩余分牌（或玩家发现自己剩余牌全大）则一局直接结束，玩家收全红时发现自己红桃全大时也可以一起出。\n\n在未出现空变压器、收全红、击中月亮时，所有人在计算变压器翻倍之前的得分之和为−40分，可用于快速检验分数计算是否正确。
219917,10582,姬扬,2025-06-11 04:55:51,0,0,0,假设α衰变不再存在\n\n\n\nRn-212 -> Pb-204 + Be-8\n\nRn-214 -> Pb-206 + Be-8\n\nRn-216 -> Pb-208 + Be-8\n\nRn-217 -> Pb-209 + Be-8\n\nRn-218 -> Pb-210 + Be-8\n\nRn-220 -> Pb-212 + Be-8\n\nRn-222 -> Pb-214 + Be-8\n\nFr-219 -> Bi-211 + Be-8\n\nRa-218 -> Pb-206 + C-12\n\nRa-220 -> Pb-208 + C-12\n\nRa-221 -> Pb-207 + C-14\n\nRa-222 -> Pb-208 + C-14\n\nRa-223 -> Pb-209 + C-14\n\nRa-224 -> Pb-210 + C-14\n\nRa-226 -> Pb-212 + C-14 (> 10^12 y)\n\nAc-225 -> Bi-211 + C-14\n\nTh-224 -> Po-210 + C-14\n\nTh-226 -> Po-212 + C-14， Pb-208 + O-18 (> 10^12 y)\n\nU-230 -> Pb-208 + Ne-22 (> 10^12 y)\n\nU-232 -> Pb-208 + Ne-24 (> 10^12 y)
220771,10582,姬扬,2025-06-19 15:09:23,0,0,0,1A. 常见函数的定义域:\n\nexp(实): [-oo，+oo] -> [0，+oo]; a^(实)， a>0: 表示exp(log(a)*·)(实); [-oo，+oo] -> [0，+oo]\n\nlog(实): [0，+oo] -> [-oo，+oo]， 可定义为exp(实)的反函数或1/x的变上限积分\n\nexp(复): C -> C\{0}; a^(复)， a>0: 无歧义， 表示exp(log(a)*·)(复); C -> C\{0}\n\n| |: Chat -> [0，+oo]\n\n^n: Chat -> Chat\n\nsin， cos， sinh， cosh: C -> C\n\ntan， cot， tanh， coth: C -> Chat\{+-i}， C -> Chat\{1}\n\nsec， csc， sech， csch: C -> Chat\{0}\n\n一般实变量复值函数为Rbar -> Chat\n\n1B.\n\narctan， arccot， artanh， arcoth: 直接用1/2 log(Aut)定义， 或者定义为±1/(1+z^2)， 1/(1-z^2)在复球面上合适的开集的不定积分 (起点0， ∞， 0， ∞)\n\narcsin， arccos， arsinh， arcosh: 定义为1/sqrt(1-z^2)， 1/sqrt(1+z^2)， 1/(z sqrt(1-1/z^2))在复球面上合适的开集的不定积分 (起点0， 1， 0， 1). 由唯一性定理， 在C \ {z<=1}上z sqrt(1-1/z^2) = sqrt(z+1)*sqrt(z-1)\n\n对于取主值的幂函数， 倒是需要考虑问题: 什么时候(z^a)^b = z^(ab)成立?
221019,10582,姬扬,2025-06-21 01:01:05,7,7,0,大学物理甲，上课不好，需要自学，但是因为大物是赋分，给分还可以，推荐自学能力强的人选
221029,10582,姬扬,2025-06-21 02:19:09,3,3,0,热学\n\n讲课真没啥好听的 不点名\n\n但是作业和测试非常简单\n\n满绩估计不少😉
221388,10582,姬扬,2025-06-23 07:15:22,3,3,0,老师有自己的上课想法，但是初来乍到，可能有一些地方还是和大家有点脱轨\n\n适合自学能力强的同学或者比较混的同学\n\n老师偶尔会有纸质点名，但是给分比较好
221425,10582,姬扬,2025-06-23 10:28:16,3,3,0,上课水，给分好，教学方式不见得人人能适应，总而言之自己体验过才会有自己的评价
219207,10745,李杰,2025-05-23 03:29:05,-1,2,3,给了10分，老师人很好，认真负责，教的也好。\n\n讲课的时候能努力把原理讲清楚，然后也会有例题，便于学生理解如何运用讲的知识。\n\n老师还会给期中考和期末考考好的学生发大红包，人可好了。\n\n李杰伟大，无需多言。
220330,10745,李杰,2025-06-17 09:35:24,1,1,0,老师有点史，说实话，大物预制它直接还就好，到时候你被恶心了就知道了。真的牛马，判卷子巨严格，兄弟，每次课堂口头点名，会连续点不到的同学，态度不好，上课容易睡觉。
220726,10745,李杰,2025-06-19 10:46:28,0,0,0,考得好会发红包
