评论id,老师id,老师姓名,发表时间,点赞减去点踩数量,点赞量,点踩量,内容
73697,166,凌君,2018-02-02 16:46:22,1,3,2,干货偏少，讲课非常热情
103839,166,凌君,2019-03-06 07:45:11,6,7,1,高分子构筑学神课，绝对值得一上，虽然英文但是给你足够时间听懂
108591,166,凌君,2019-05-29 07:01:02,3,7,4,虽然我菜，但老师真的好。
112905,166,凌君,2019-07-05 09:44:41,4,5,1,别问，吹爆，强推
116395,166,凌君,2019-09-10 01:32:38,5,6,1,凌老师天下第一！强推计算化学导论
122103,166,凌君,2020-02-13 11:00:18,15,17,2,凌老师是一个真正有师德的老师！Respect
155187,166,凌君,2022-06-09 06:54:03,4,6,2,计算化学导论最后一节课补分真的好
197993,166,凌君,2024-08-23 01:14:27,0,2,2,很好玩的两门课，收货很多，给分也好。想要减肥也是强推，一学期因为这两门暴瘦16斤（bushi）
216230,166,凌君,2025-03-12 14:53:44,1,1,0,上课≠科研
23123,473,宋义虎,2016-03-18 10:34:46,0,2,2,因材施教，如沐春风。理论和实践功底深厚。
142385,473,宋义虎,2021-11-11 02:45:44,0,1,1,不喜欢
49055,505,孙景志,2017-03-23 00:21:14,1,3,2,讨厌这个老师，没有PPT，手写的字又不清楚，根本不管下面的学生有没有听懂，只顾自己讲
80113,505,孙景志,2018-06-20 06:20:39,2,4,2,讲课声音较轻，第三排以外基本没声音\n\n\n\n基本照本宣科，他表示上课内容他也是第一次学\n\n\n\n实践课时间较坑，别的课翘课过去吧\n\n\n\n（微笑
145597,505,孙景志,2021-12-30 11:59:13,0,3,3,老师的大学写作太棒啦！不知道专业课怎么样，总之自然写作课很吸引人，讲的很有意思，能学到东西，事也少
167781,505,孙景志,2023-01-19 04:39:12,2,2,0,大学写作被正太到3，笑
168192,505,孙景志,2023-02-01 09:16:03,1,1,0,额，大学写作被绩杀啦
214511,505,孙景志,2025-02-10 08:58:28,1,1,0,思维方法课可谓是奇思妙想。嗯，颇有生搬硬套之感，说实话没听个明白。给分很低很低很低很低，注意避雷。\n\n\n\n孙老师科研水平还是挺不错的，算是国内率先开展量子点研究的老师。
164533,1042,傅智盛,2022-12-21 13:04:12,0,0,0,老师是好老师，很负责人也挺好，但拜托我们大四上的课有必要一直讲文献吗，建议老师参考一下倪旭峰老师的ppt
24772,1048,高超,2017-01-03 05:56:33,-2,7,9,坑B坑B坑B！！！
24782,1048,高超,2016-05-03 14:29:16,5,14,9,开头第一句：慎选！文科生远离！理工科如非对纳米或高分子材料感兴趣也慎选！老师要求相当高，需要看英文文献，比较花时间。当然如果对课程内容感兴趣确实可以学到东西（前提是感兴趣）。
39985,1048,高超,2017-03-01 10:30:32,-3,1,4,，，，
40369,1048,高超,2017-01-03 05:51:45,-1,4,5,挺好的，谁上谁知道
49376,1048,高超,2017-04-08 13:50:19,0,3,3,选对组，认真准备能学到很多东西。实在不喜欢的还是尽早退课吧…这门课重要的是互相之间的交流和同老师的交流。
50538,1048,高超,2017-05-03 10:29:28,14,18,4,老师人很好，还会在讲知识的时候穿插一些科研的素质熏陶，关键还是看兴趣，如果感兴趣会学到很多，而且能增强读文献的能力。
87963,1048,高超,2018-10-19 00:59:05,0,1,1,很认真
104347,1048,高超,2019-03-18 11:07:24,2,2,0,。。。
123320,1048,高超,2020-06-03 00:38:54,9,13,4,高超老师讲述的不仅是高分子的前沿科技，还有许多做科研的心得，值得一听！因为这次疫情，PPT课堂讨论没有了，作业就是2次PPT，好好做分数不会很低。利益相关：4.8/94.
123970,1048,高超,2020-06-18 10:20:57,-5,4,9,我也是这次疫情期间上的他的课，线上直播大家都明白，很多东西是做不了的，只能做两个ppt。我虽然上课从没听，作为靠复制粘贴，仍然混到了3.6，感觉值了
123972,1048,高超,2020-06-18 10:45:01,5,6,1,高超老师真的非常优秀！讲课认真，能学到东西。就是会比较硬核。有两次作业，ppt形式，好好做加上课认真听，积极回答问题几点就会很高！
140916,1048,高超,2021-09-18 00:16:28,0,2,2,所有课程最低绩点，还是通识，无话说
217475,1048,高超,2025-04-17 00:48:36,0,1,1,春学期的，最后4.5，高老师人很和蔼，关注大家的科研素养，考核方式就是几次点名（有点频繁）+最后每个人都要做10分钟汇报，虽然没什么太惊艳的，但是值得一选
218045,1048,高超,2025-04-19 14:39:11,0,1,1,太烂了，慎选，绩杀
218340,1048,高超,2025-04-23 00:02:40,0,1,1,文科生慎选
87410,1490,朱利平,2018-09-28 10:35:34,0,2,2,老师人很好，上课很风趣。
154409,1490,朱利平,2022-06-01 04:17:53,4,6,2,通识课论文ddl一拍脑袋提前10天，还要求查重率低于百分之10，只想说老师我们水平太低，够不上您的要求😅
156878,1490,朱利平,2022-06-21 08:50:50,3,4,1,4.8，老师还是很好的，平日不善言辞但知识表述很清晰的理科男老师的感觉。材料科学与人类文明这门通识课是一篇2000-5000的论文+最后一堂课简单三分钟展示，想水的话可以很水，想学也可以学到东西。我的论文写了4000多，确实感觉写的过程收获很多。上课点名会提前在钉钉说，提醒大家都到课。课程内容难度还可以，我高中选课是全文科，也可以理解，并且如果感兴趣内容还是挺有趣的。最后开卷考，我是印了ppt+两本参考书，书基本用不到，考试内容都在ppt上，细心翻就可以找到，也会考一点理解和解释。我上课的时候其实没有发言，也没私信过老师，但是老师却在考试结束后找到我，问我觉得这门课的难度怎么样，高中没有学过化学吗？这样上课适应吗？这让我觉得老师真的还是很好的。期末论文本来说6.14左右交，第八周突然提前了接近十天，我认为这是不妥的地方，因为我很早就写完了，所以没太受影响，但我觉得老师还是要提前通知为好！因为考试周大家都焦头烂额的。
177781,1490,朱利平,2023-07-04 23:41:56,4,4,0,事情，是少的\n\n课，是外专业听不懂的\n\n一来就说绩点没问题，是假的\n\n考试，是复印课件都捞不上来的\n\n绩点，是精准卡死的
220498,1490,朱利平,2025-06-18 08:56:41,0,0,0,有一篇课程论文及展示，一次期末开卷考，考试内容ppt上基本都能找到，除了最后的论述题需要结合自己的知识。老师上课很认真负责，有三次人工点名。本人感觉自己的论文和展示其实很一般，但是最后给分很好。总之推荐！
32666,1595,吴子良,2016-07-09 02:03:10,1,2,1,很帅气
172987,1595,吴子良,2023-05-11 01:48:01,1,1,0,老师很帅！给分也很好！！！
22533,1969,毛峥伟,2016-03-07 12:56:23,25,38,13,好老师，很幽默
22870,1969,毛峥伟,2016-03-14 02:24:42,-25,12,37,呵呵，上课前言不搭后语，题目讲不清楚，尼玛，不知道这种老师哪里来的
25409,1969,毛峥伟,2016-06-27 03:23:05,20,33,13,老师真的很棒，我想我爱上他了 可他都有孩子了?
25925,1969,毛峥伟,2016-06-14 10:53:58,8,15,7,比起教同一门课的另一个老师，毛老板不知道高到哪里去了
48335,1969,毛峥伟,2017-03-02 07:26:05,1,3,2,不水啊
50015,1969,毛峥伟,2017-04-28 14:13:45,-2,1,3,老师圆圆的很可爱，事少，给分也好
50091,1969,毛峥伟,2017-04-29 13:07:01,0,4,4,说好的最低80呢。
50256,1969,毛峥伟,2017-05-02 04:36:16,-1,2,3,棒棒哒
50931,1969,毛峥伟,2017-05-09 10:28:25,0,2,2,超级棒！适当拓展，上课也幽默
55258,1969,毛峥伟,2017-07-01 06:31:00,7,10,3,文科生慎选
75115,1969,毛峥伟,2018-03-07 11:19:45,2,3,1,老师好萌呀～
76785,1969,毛峥伟,2018-04-23 08:23:50,-1,5,6,他教的材科基挺烂的，毫无意义。
77297,1969,毛峥伟,2018-05-04 11:56:07,2,3,1,老师挺好的，很幽默
77301,1969,毛峥伟,2018-05-04 12:37:39,2,5,3,呵呵……绩点又创新低，水课慎选
77314,1969,毛峥伟,2018-05-04 14:07:17,-1,0,1,让文科生有机会重温曾经的化学知识，老师很好哒
77335,1969,毛峥伟,2018-05-04 17:40:15,1,2,1,老师很好。对于理工科来说科普性的听着玩一玩就好啦\n\n这里隔空喊话某位甩锅的小姐姐，你那一堆话可真low
77367,1969,毛峥伟,2018-05-05 06:08:16,2,6,4,虽然事情少，但是被正态很失望了
77372,1969,毛峥伟,2018-05-05 06:34:48,-2,3,5,老师挺好的， 毕竟通识，不水开拓视野 相当好！ 老师给分还行
82115,1969,毛峥伟,2018-07-07 07:07:43,2,6,4,被正太了，差评
82580,1969,毛峥伟,2018-07-08 14:42:09,-1,0,1,不错的
106913,1969,毛峥伟,2019-04-30 08:18:02,0,1,1,吹爆老师，事少给分好。欣赏老师的教学理念！！
106914,1969,毛峥伟,2019-04-30 08:19:32,-2,0,2,优秀了！老师讲课超有意思的！
114053,1969,毛峥伟,2019-07-08 13:43:40,3,4,1,讲课很棒，对比明显，只是之后要记清楚考试时间哦
121950,1969,毛峥伟,2020-01-25 11:27:32,4,6,2,只发过一次言，最后5.0飘过，感觉老师给分不错，事还少
122772,1969,毛峥伟,2020-04-02 05:40:59,0,2,2,专业课讲的什么鬼？
122808,1969,毛峥伟,2020-04-08 12:34:04,1,2,1,上老师的材料科学与人类文明，老师特别幽默，也学到了不少东西。奇怪的知识一直在增加！
123270,1969,毛峥伟,2020-05-27 10:20:47,1,2,1,疫情期间在家上课，评分标准变为考察，但是学生完全不能清楚地知道考察的标准到底是什么。最后打分70多完全不理解老师到底按什么标准做的
123439,1969,毛峥伟,2020-06-09 02:23:45,2,3,1,老师讲课很有趣，每节课都有奇怪的知识增加，事情少，线上上课考察方式也改了，原本线下是展示+期末开卷考，线上就变成了一篇论文
127274,1969,毛峥伟,2020-11-19 07:30:58,5,7,2,选了这门通识课你绝对不吃亏，上课水，均绩高，老师随和，只要你作业加考试认认真真完成，绝对能拿到4.0以上的绩点。
127275,1969,毛峥伟,2020-11-19 08:05:41,0,1,1,课程要求比较水，但是课程的内容还是很有意思的。
127281,1969,毛峥伟,2020-11-19 13:40:55,0,1,1,老师上课还挺有意思的，作业少给分也还不错
127284,1969,毛峥伟,2020-11-19 14:26:19,1,2,1,真的很不错，给分很好，老师人也很好
127319,1969,毛峥伟,2020-11-20 04:11:21,1,2,1,老师给分真的是好好，上课也时常会和学生互动、开玩笑，非常体贴学生对绩点的关心，太好了，😺
127349,1969,毛峥伟,2020-11-20 15:41:01,0,1,1,666
127367,1969,毛峥伟,2020-11-21 11:39:56,5,6,1,老师人特别好，上课氛围轻松，讲课风趣幽默，会讲一讲段子。\n\n不点名，老师会给所谓天坑专业的同学解疑答惑。\n\n上的是材料科学与人类文明，平时上课有点划水，最后考试也能拿一个4.5（百分制89分）
127465,1969,毛峥伟,2020-11-23 08:44:45,0,1,1,上课幽默，待人和善，很棒的一个老师
127648,1969,毛峥伟,2020-11-25 10:21:58,0,2,2,选它选它选它
127933,1969,毛峥伟,2020-11-30 12:31:27,1,2,1,强推！！！之前一堆差评给我气死了毛老师必须满分好吗！
128516,1969,毛峥伟,2020-12-23 12:47:03,1,2,1,通识课最佳选择，老师人还是很好的，绩点也很好上去
128609,1969,毛峥伟,2020-12-24 15:00:53,1,2,1,毛老师超级好，上课放视频，不用听课，开卷开看ppt，期末就一个小论文，1000字左右，上课基本不点名
128671,1969,毛峥伟,2020-12-25 03:29:48,1,2,1,好到没话说！！！！选课就要选这种课！！老师随和，体贴学生。认真写论文，也不用恶竟！
129904,1969,毛峥伟,2021-01-13 10:56:32,0,2,2,老师上课很幽默
133917,1969,毛峥伟,2021-03-09 11:33:36,4,7,3,老师好惨，第一节课说来不来平时分都给满，第二节课到的人一半都不到了，其实上课上的挺有趣的
135229,1969,毛峥伟,2021-05-06 08:40:00,1,3,2,好老师，上课超幽默，珍惜他
138318,1969,毛峥伟,2021-07-08 13:40:18,2,6,4,材料科学与人类文明事少分高，速选！
147052,1969,毛峥伟,2022-01-08 14:01:54,9,14,5,算是玩明白了呗。。。本科生教学糊弄糊弄，就喜欢找外校来的同学来给自己打工。。。(*^_^*)
150717,1969,毛峥伟,2022-02-16 02:26:33,-1,1,2,不错不错
152633,1969,毛峥伟,2022-04-16 15:25:50,0,2,2,讲课很幽默，老师人很好，没什么事
153517,1969,毛峥伟,2022-05-03 10:13:59,0,2,2,给我选！！！
153524,1969,毛峥伟,2022-05-05 09:31:31,5,6,1,文科生拿高分比较难，论文认真写，开卷考可能还是找不到答案，考的和讲的没太大关系，别人不听课有专业素养也考的比你好
161598,1969,毛峥伟,2022-11-09 09:22:48,-1,2,3,给分很好，可以大胆选
161882,1969,毛峥伟,2022-11-14 23:58:30,-2,2,4,材料科学与人类文明满绩飘过 跪谢毛老师！\n\n帮我们批改论文的样子真的很帅 上课也比较幽默可以半水\n\n都给我选啊啊啊啊！
161939,1969,毛峥伟,2022-11-15 07:30:42,-1,2,3,诶，3.6，老师人挺好的
173919,1969,毛峥伟,2023-06-04 14:12:31,2,5,3,给1分是因为最低只有一分
174467,1969,毛峥伟,2023-06-12 16:25:55,5,6,1,老师的材料科学基础这门专业课讲课不认真，听了也收获不了什么，总体来讲体验不太好.......希望期末考试能给分好点吧www
185653,1969,毛峥伟,2024-01-03 09:31:41,1,1,0,老师真的很好，希望老师身体健康
187274,1969,毛峥伟,2024-01-15 11:03:28,0,1,1,平时没什么事 但期末考前莫名其妙发了800页的ppt和两本书\n\n让期末周压力很大
187313,1969,毛峥伟,2024-01-15 12:41:03,0,0,0,课比较水，任务很轻一篇1500字和开卷期末考。老师人很好，上课很有趣。给分特别好，强烈推荐
187377,1969,毛峥伟,2024-01-15 17:07:28,-5,1,6,给分玄。。。喜提最低 大一唯一一门下4的
188787,1969,毛峥伟,2024-01-20 02:36:52,0,1,1,不仅课水 ，老师上课也想水。不过期末会发一个很大的课件开卷考打印要点米，期末考一定要记住老师的名字，而且是“峥”不是“铮”！！！
188883,1969,毛峥伟,2024-01-20 11:08:05,-1,1,2,材料科学与人类文明，事少分好。给纯纯文科生一点小建议：考试的客观题对于纯文科生有一定的门槛，想要高分的话比较难，但是考前仔细看两遍ppt，略作一些整理，4.5可以的。
195329,1969,毛峥伟,2024-06-27 17:52:22,1,2,1,老师是非常非常非常非常非常非常好的老师。但是材科基是非常非常非常非常烂的课。
196459,1969,毛峥伟,2024-07-03 13:42:53,2,2,0,材科基真是不想说什么，四百多页a4纸那么大的课本，闭卷考试，全不会
197029,1969,毛峥伟,2024-07-06 23:01:41,3,4,1,tm给分是认真的吗，作业都写了考试几乎都做出来了最后连四都没上？快跑
197046,1969,毛峥伟,2024-07-07 02:11:41,3,3,0,材科基础一定要记得看书看仔细点提前一点复习，不然分会很炸裂像我一样一出直接学期绩点下降0.2
197055,1969,毛峥伟,2024-07-07 03:35:48,6,6,0,给分太差了，本来考试就难，估计还扣了很多平时分
202691,1969,毛峥伟,2024-11-14 01:30:00,0,1,1,4.8耶（狗头
202719,1969,毛峥伟,2024-11-14 03:47:13,2,2,0,高中化学选手表示没被捞起来😨
202851,1969,毛峥伟,2024-11-15 01:44:19,0,0,0,讲课挺有意思的
213183,1969,毛峥伟,2025-01-16 08:57:23,0,0,0,【材料科学与人类文明】\n\n老师上课很风趣幽默呀！也会很仁慈的提前下课！会点名3（？）次+3k字以内小论文+开卷期末考 本人文科生 课上比较摸 考前看了一遍PPT 给分4.2小卡了一下绩、不过已经心满意足！
213316,1969,毛峥伟,2025-01-17 02:29:27,4,5,1,毛老师是难得一见的及其负责的好老师！！！每一篇作业他都会非常认真地批阅，在课堂上进行点评，像高三语文老师那样指导你进行改进。另外，老师人非常和善，关心学生，有任何想法都可以大胆地去找毛老师交流~最后，老师给分真的非常非常棒！！！放心无脑冲！\n\nPS：大家不要被查老师上的均绩误导了，毛老师的给分超级好！！！
213324,1969,毛峥伟,2025-01-17 03:18:46,0,0,0,大学写作课讲案例还是挺幽默的，美国出差回来送同学们巧克力吃
213385,1969,毛峥伟,2025-01-17 07:08:50,0,0,0,【大学写作-自然】\n\n毛老师讲课很有意思，作业是一次读书笔记和一篇科普作文，不算多，老师给分也很好，作为一门通识课如果你想水一水的话是很好的选择
214797,1969,毛峥伟,2025-03-01 13:49:15,0,0,0,材科基不知道在讲啥，感觉不适合教这门课
219651,1969,毛峥伟,2025-06-03 08:08:33,1,1,0,材科基老师不想上，学生也不愿意学😆😆😆😆建议系主任取消这门课，给高系学生减减负。
221967,1969,毛峥伟,2025-06-28 05:37:42,0,0,0,作为高系的专业课，材科基授课内容不知所云，又庞杂又肤浅。虽然主任第一课就说可以不到课，他也不点名，且这门课已经经历了几次改版，硬生生地从硬课改成了只要背诵记忆的水课，但说到底还是无妄地加重了高系同学的负担。尤其是高系培养方案的最低毕业学分要求已经是160+的情况下，这类课程还有无存在的必要，实在是一件值得商榷的事。
4984,2107,王齐,2015-07-02 01:37:03,11,14,3,犀利 刺激 胆战心惊啊
4985,2107,王齐,2015-07-02 02:03:52,4,11,7,呵呵
7922,2107,王齐,2016-06-15 12:15:13,-12,3,15,很帅气\n\n
9809,2107,王齐,2015-11-10 01:42:51,2,3,1,压力很大
19370,2107,王齐,2016-01-24 03:30:40,14,14,0,上课自high型，不得忤逆
26078,2107,王齐,2016-06-29 15:13:32,21,26,5,各位朋友们，在上课过程中，如果因控制不当而被点名回答问题，那么，你就会不知所措，就会被水淹没。
26079,2107,王齐,2016-06-15 12:15:57,2,3,1,好烂啊
27240,2107,王齐,2016-06-24 02:06:18,10,10,0,论绩杀谁比得上高化甲一
27980,2107,王齐,2016-06-29 14:02:41,6,8,2,讲课烂的一b，喜欢用英文ppt装b，没讲到的全考到了，不明白要这老师何用
32322,2107,王齐,2016-07-06 07:07:19,-4,3,7,老师讲的还是不错的，考试准备好的话材明给分不错，就是上课的时候可能会要求比较严格，不允许任何噪音
32826,2107,王齐,2016-07-16 09:51:42,2,3,1,绩杀不解释
45773,2107,王齐,2017-01-20 05:09:11,5,6,1,老师最后的文献阅读课不错…至于上课…王老师可是怼天怼地的存在…
49979,2107,王齐,2017-04-28 02:46:11,3,6,3,没见过这么爱装b的老师  一个每天带着迷之优越感的人  讲课讲的也不明白 说学生不好好听课还不如回家种地 向校长建议提高学费 无语死
50234,2107,王齐,2017-05-02 00:49:16,3,5,2,讲课烂，每堂课用莫名其妙的提问点名。说学生不愿意来上课，不提高自己讲课质量怎么吸引学生？
56662,2107,王齐,2017-07-04 07:51:48,2,2,0,垃圾垃圾
56691,2107,王齐,2017-12-20 14:32:37,-4,3,7,高化这位老师喜欢点名提问，答不出就一个一个点下去。其他方面还可以。从人格上讲，我很敬佩这位老师。
75754,2107,王齐,2018-03-16 11:07:38,17,18,1,年级大会真特么恶心
75760,2107,王齐,2018-03-16 12:34:56,8,8,0,傻逼一个，不要脸
75774,2107,王齐,2018-03-17 05:59:22,6,6,0,还好没选上他的课
78890,2107,王齐,2018-05-16 08:09:54,2,2,0,讲课还行，废话太多，像个大妈一样
85618,2107,王齐,2018-07-21 12:55:29,16,16,0,傻逼老师 还重考 讲课也垃圾 党性太好 一直扯淡 排个雷 一定不要选
86170,2107,王齐,2018-09-09 13:19:08,3,3,0,上课废话多，自身问题导致期末考重考，垃圾
87106,2107,王齐,2018-09-20 10:09:28,8,8,0,上课讲的东西基本和考试没有关系，课后问他考试的范围只回答说看两遍书就好了。根本就一点重点都没有，上课花很长时间的东西一点点都没考到。考试范围不能说的很清楚可以理解，但是你好歹要考的东西多讲点上课也会有印象啊，期末复习他的ppt就跟没复习一样。
104434,2107,王齐,2019-05-06 15:04:26,5,7,2,我喜欢rap，篮球和王齐
106768,2107,王齐,2019-04-29 11:07:28,3,3,0,每次上课前都要点人回答问题。
111011,2107,王齐,2019-06-29 06:21:11,11,13,2,请解释polymer和macromolecule的区别
112079,2107,王齐,2019-07-03 12:16:30,5,5,0,另外一个班没讲过的东西出在试卷里公平吗
112539,2107,王齐,2019-07-06 00:07:12,7,8,1,平时分78，比隔壁班低0.3均绩，全班一个上4，你勇你就来吧
112664,2107,王齐,2019-07-04 23:52:50,6,6,0,孤儿哦
112723,2107,王齐,2019-07-05 01:15:00,2,2,0,....
112781,2107,王齐,2019-07-05 03:02:35,2,3,1,好，假笑。
112879,2107,王齐,2019-07-05 08:17:44,6,6,0,不，首先这根本上的不是一门工科的专业课，而是文科的。其次要么是平时分给的不好要么就是我考的太差了，差到考试只有40分。\n\n以上这些也就算了，那么请问为什么成绩出了之后还要把我们往下调分？
112881,2107,王齐,2019-07-05 08:35:27,3,3,0,。。。
112884,2107,王齐,2019-07-05 08:40:23,3,3,0,请问往下调分是什么操作？
124831,2107,王齐,2020-07-11 12:35:32,2,2,0,人品不行\n\n
126227,2107,王齐,2020-09-20 06:17:13,0,1,1,老师好
134874,2107,王齐,2021-04-20 02:04:32,0,1,1,小天才
195042,2107,王齐,2024-06-26 13:07:11,0,0,0,王sir，教学后勤能不能管一下啊_(꒪ཀ꒪」∠)_
211077,2107,王齐,2025-01-10 13:55:22,-1,0,1,双面齐哥，材料科学与人类文明的通识课很推荐，是真的事少分高。老师上得也挺好的，会有收获
214749,2107,王齐,2025-02-17 09:21:12,1,1,0,人品确实有问题
215668,2107,王齐,2025-03-04 01:42:16,2,2,0,上课讲的挺好的啊，比mzw好多了，不知道分为什么这么低
216732,2107,王齐,2025-03-23 09:24:27,0,0,0,.........
217322,2107,王齐,2025-04-08 11:44:40,0,0,0,讲课不知所云
219278,2107,王齐,2025-05-24 05:15:19,2,2,0,只记得他早八经常问同学“你早饭吃了几块钱”了，然后很得意地说自己只吃了四五块，继而建议大家都去食堂吃
22826,2156,仝维鋆,2016-03-13 06:26:10,2,6,4,一个很好的老师，跟人有很大的帮助
22827,2156,仝维鋆,2016-03-13 06:24:56,13,19,6,非常好
22831,2156,仝维鋆,2016-03-13 07:09:36,1,6,5,棒棒棒
22833,2156,仝维鋆,2016-03-13 07:17:19,2,6,4,老师最帅
22834,2156,仝维鋆,2016-03-13 07:16:13,4,8,4,老师好好
25800,2156,仝维鋆,2016-06-08 11:29:52,-2,4,6,棒棒哒
27237,2156,仝维鋆,2016-06-24 01:40:07,0,4,4,很不错
74002,2156,仝维鋆,2018-02-04 04:49:27,1,3,2,哇哈哈萌萌的但是高物要quiz好烦
86375,2156,仝维鋆,2018-09-14 08:21:30,5,8,3,仝老师是我们的班主任，超级和蔼，还预定班车带我们去参观了高分子系楼，笔芯！！
86961,2156,仝维鋆,2018-09-19 15:08:01,0,4,4,棒棒哒
97130,2156,仝维鋆,2019-01-21 16:57:32,0,4,4,真的好
102556,2156,仝维鋆,2019-02-08 07:26:42,0,4,4,享受哈哈哈哈
158163,2156,仝维鋆,2022-06-27 08:39:53,1,5,4,非常好的老师！！
166183,2156,仝维鋆,2023-01-11 10:56:01,1,5,4,老师人很好，可能是我太菜了，写作课认真修改了好久最后还是被绩杀了呜呜呜
174844,2156,仝维鋆,2023-06-19 03:42:23,2,5,3,累，两个pre
178325,2156,仝维鋆,2023-07-10 05:15:20,1,6,5,别选，快跑
189339,2156,仝维鋆,2024-01-23 09:27:08,2,4,2,大学写作无脑冲！！！最好的老师之一！！！
193206,2156,仝维鋆,2024-06-04 12:02:44,2,2,0,老师人很好，很和善
213118,2156,仝维鋆,2025-01-16 04:39:36,2,2,0,【大学写作】人很好有意思，有两个pre需要小组交流，但是没有强制选组长，贡献度貌似更参考你有没有做pre。很有意思的课喜欢
134236,2241,万灵书,2021-03-20 07:47:17,0,0,0,高化实验考试简单，给分也还行
59842,2255,任科峰,2017-09-27 12:14:26,-1,0,1,喜欢装逼又有蜜汁优越感，高分子的老师有不少都是这种类型。
87665,2255,任科峰,2018-10-09 14:33:09,0,1,1,不负责任  给分极差
90321,2255,任科峰,2018-11-23 06:43:02,0,0,0,还可以
117548,2255,任科峰,2019-09-26 01:02:27,0,0,0,建议去开个催眠所
162079,2255,任科峰,2022-11-16 14:24:49,0,0,0,千万别选，极其垃圾不负责任
162080,2255,任科峰,2022-11-16 14:24:14,0,0,0,喝点b酒，没轻没重的
169756,2255,任科峰,2023-02-27 16:19:23,0,0,0,不负责的老师，给分极差。大四千万别选
169757,2255,任科峰,2023-02-27 16:19:23,0,0,0,不负责的老师，给分极差。大四千万别选
206288,2255,任科峰,2024-12-13 14:28:39,0,0,0,1次考试，2学分课，3次小测，4次展示
58755,2306,张兴宏,2017-09-16 14:56:38,5,9,4,没上过他的课，但却是他把我招进浙，我的命运也将随之展开。兴宏，挺你！
112827,2306,张兴宏,2019-07-05 23:27:49,5,5,0,老师很棒
113091,2306,张兴宏,2019-07-05 23:12:55,4,5,1,老师很好，是我太差
113134,2306,张兴宏,2019-07-06 00:08:29,5,6,1,挺好的，老师还好
114049,2306,张兴宏,2019-07-08 13:40:19,14,17,3,老师高化课上得很棒，材科基考试事件的处理也很妥当，高分子很棒的老师！
125571,2306,张兴宏,2020-09-11 14:38:43,2,4,2,给分很好
166081,2306,张兴宏,2023-01-11 05:00:15,1,3,2,大学写作垃圾给分tmd辛辛苦苦写了四篇论文，全寝室被3⃣️绩杀，屁事多给分低，别的班随随便便上4⃣️，md气死了垃圾老师
166216,2306,张兴宏,2023-01-11 12:35:57,0,4,4,如果你选了他的大学写作，你不仅会把这门课寄掉，还会因为事贼多，把其他课也给寄掉
166667,2306,张兴宏,2023-01-13 07:57:42,1,7,6,高分子的老师，只上过他的大学写作自然。首先，评价主要是后半学期小班上课后自己写的读书笔记和科普文章，但是根本就看不出谁水平高低，给分属于是随便给的，而且给分不太好；其次张老师很喜欢找人回答问题，和同学互动，点评作文；最后大学写作这门课（至少我个人认为）本身没有任何意义，学不到任何东西。
195328,2306,张兴宏,2024-06-27 17:50:31,2,2,0,高化。夏学期换了老师之后没有一天不在想念老师的高化课……9/10
213440,2306,张兴宏,2025-01-17 11:00:32,2,2,0,感谢张老师！！大学写作怎么也想不到会得这么高的分数！感谢老师捞！
215498,2306,张兴宏,2025-02-27 05:13:47,0,0,0,额，高化才上了三节课就调走了，不知道是自愿的还是学校强制的，总之这样有点草台班子了，很难评，最后给分也不知道是谁给。。。
33316,2361,李扬,2016-09-18 05:17:09,0,2,2,
150621,2361,李扬,2022-02-05 08:21:33,1,2,1,怎么没有评论
37311,2404,黄小军,2016-11-18 09:38:12,-1,1,2,英语差
103655,2404,黄小军,2019-03-04 00:43:09,0,2,2,上了一节政治课——从膜材料看国际话语权
103657,2404,黄小军,2019-03-04 01:07:54,0,1,1,上课夹带私货，鼓吹情怀
122481,2404,黄小军,2020-02-29 16:56:24,0,1,1,非常优秀 情商高 讲话有趣
31505,2410,高长有,2016-07-04 04:07:10,0,0,0,听不到重点 不定时时常心惊胆战
132632,2410,高长有,2021-02-03 03:26:47,0,2,2,不得不说这门课背的好多批卷好严，本来感觉project做得不错的最后分数也不是很高
148853,2410,高长有,2022-01-13 17:42:01,-1,2,3,真的不知道每天吹牛逼的意义何在？
22917,2564,徐志康,2016-03-14 16:16:01,5,8,3,第一个！
24512,2564,徐志康,2016-05-01 02:39:51,0,8,8,徐老师是一个和蔼可亲的老师 总是为学生考虑 对学生多以鼓励态度 很少进行严厉批评
24774,2564,徐志康,2016-07-02 08:18:45,17,28,11,徐爸爸很可爱 上课还很喜欢举女同学尼龙袜的例子\n\n
27665,2564,徐志康,2016-06-27 07:38:12,1,4,3,徐爸爸带我飞！
56687,2564,徐志康,2017-07-04 09:15:28,-10,4,14,淡泊名利，教书育人
105493,2564,徐志康,2019-04-15 10:49:07,10,11,1,和另一个老师比起来，差异一下子出来了
112571,2564,徐志康,2019-07-04 18:00:44,23,34,11,以前是系主任，上课总是提起他的辉煌往事，而且重男轻女，上课疯狂diss女生，针对女生，嘲笑染发的女生是“黄毛丫头”，嘲讽打了个哈欠的女生“夜生活丰富”，一骂就会把所有女生都骂在里面“你们这些女生以后是要遭报应的”，但却不会责备迟到整整一节课的男生，会把所有女生叫上去课堂展示，丝毫不尊重女生，以后高分子的女生千万不要选他啊。
112582,2564,徐志康,2019-07-04 18:37:09,0,2,2,佩服老师的为人，但是给分真的不咋地
112885,2564,徐志康,2019-07-05 08:40:59,3,3,0,往下调分什么鬼？
112892,2564,徐志康,2019-07-05 09:07:07,16,20,4,不懂为什么高化平时分低、出分后分数降低这些事，大家都只去王齐那里埋怨？不要厚此薄彼嘛……我想说的是，徐志康对于女生是真的不友好了，以下罗列：\n\n1. 指责女生没有坐前排\n\n2. 打哈欠的女生被疯狂diss。理解老师不喜欢打哈欠的行为，但是男生人数是女生的三四倍，里难道没有一个人打哈欠吗？为什么要揪住一个女生不放。类似情况下，一个男生经常迟到一节课或者半小时，上课时间大摇大摆进门，老师从不指责，对他蛮和蔼……\n\n3. 抽人展示的时候抽的都是女生，除非小组里没有女生\n\n4. 表示研究所里女生太多（1/3女生），如果是他招生不会有这么多女生\n\n5. 非常不喜欢染头发的女生，留有刻板印象，称之“黄毛丫头”\n\n6. 最后一节课再次diss打哈欠的女生，嘲讽“经常打哈欠是夜生活丰富”，指责“会有报应”。不管怎么样，这样的话是不是有点过了？\n\n7. 最重要的是，以上对女生的指责，不管一开始是不是特指某人，最后都上升到对群体的“攻击”——你们这些女生、女生…\n\n身边很多男同学都对徐老师印象很好，老师有专业修养，也挺和蔼。但是从女生的角度看，就更因此经常感到愤懑和委屈。
122135,2564,徐志康,2020-02-16 09:12:39,-5,1,6,严肃认真
122479,2564,徐志康,2020-02-29 16:32:43,8,8,0,有时候性别歧视
123019,2564,徐志康,2020-04-30 17:27:00,10,10,0,性别歧视，人格侮辱
124832,2564,徐志康,2020-07-11 12:37:21,6,6,0,性别歧视
168371,2564,徐志康,2023-02-14 11:15:45,2,2,0,快乐绩杀，讲课不行还硬要我们听
179336,2564,徐志康,2023-09-12 03:26:52,0,0,0,好好干
179337,2564,徐志康,2023-09-12 03:27:27,1,1,0,性别歧视，你6
185651,2564,徐志康,2024-01-03 09:11:18,3,4,1,大学写作课。他跟助教两个人没有沟通好。助教发在群里的公告是读书报告，他上课后来说要写读书笔记。助教还狡辩，推卸责任，拜托，教材上读书报告和读书笔记的格式完全不一样好不好。这个老师本来就比较求是，给分不好，现在更是雪上加霜了。
216439,2564,徐志康,2025-03-16 13:25:07,0,0,0,课程无聊
25627,2592,徐明生,2016-05-30 02:55:13,3,8,5,hhh
25875,2592,徐明生,2016-06-28 08:12:26,8,14,6,真想把所有给两分的都举报，太不实事求是了。
26119,2592,徐明生,2016-06-28 15:58:08,27,45,18,跟各位高分子的同志们讲一下这位神人： 1.脑子不清，上课的时候车轱辘话来回说，交作业收作业的事都不知道怎么做。 2.夹带私货，好好的材料科学基础愣是上成了半导体物理。预置内容都没有，上得满脑子问号。 3.强买强卖，上课内容改了，所以就跟你们推销教材了。4.装逼过度，郑重其事地介绍自己开的会议还说是“不值一提的聚会”。
26254,2592,徐明生,2016-06-16 12:10:17,20,23,3,其他吐槽就不说了  上课总接电话
26258,2592,徐明生,2016-06-16 12:24:04,3,6,3,我只想看看有多低
26270,2592,徐明生,2016-06-16 12:55:46,13,15,2,科研搞得好的老师都不适合本科教学？
26301,2592,徐明生,2016-06-16 16:35:22,4,8,4,让你有一种想拿刀杀了他的冲动\n\n
26370,2592,徐明生,2016-06-17 06:58:52,11,14,3,说开卷考试让我们带电脑的老师也是没谁了?
26377,2592,徐明生,2016-06-17 08:38:02,2,6,4,可惜没0分\n\n
26383,2592,徐明生,2016-06-17 09:55:37,8,11,3,特么为什么没有零分，上课不会上算了，作业不会收，麻蛋考试也不会考，全英文试卷，特么说好带电脑变成了带计算器。把材料科学基础变成了半导体课程。妈蛋的能不能让他只搞科研，别出来祸害本科生了。
26421,2592,徐明生,2016-06-18 07:48:30,0,4,4,怀疑老师有没有备过课。。
26601,2592,徐明生,2016-06-20 09:55:41,1,4,3,看见有这么多人喷他我就放心了
27204,2592,徐明生,2016-06-23 13:29:34,2,5,3,是谁给的二分！敢不敢站出来！！
27213,2592,徐明生,2016-06-23 14:30:33,0,4,4,神一样的老师，没见过这么不靠谱的，高分子系刷新了我的认知
27216,2592,徐明生,2016-06-23 14:51:38,0,1,1,围观中
27295,2592,徐明生,2016-06-28 08:11:26,-6,8,14,老师会跟大家讲很多科研方面的东西，上课很灵活ヾ(Ő∀Ő3)ノ
28073,2592,徐明生,2016-06-28 08:04:19,0,1,1,没啥好说的
29060,2592,徐明生,2016-06-29 07:53:07,0,1,1,咳咳咳
32604,2592,徐明生,2016-07-08 04:30:59,0,1,1,也不是没遇到过上课乱的老师，但是没遇到过给分也乱的。
32631,2592,徐明生,2016-07-08 08:30:25,1,2,1,没零分，挺遗憾的
137236,2592,徐明生,2021-07-02 13:07:46,5,6,1,这位现在是信电学院上IT项目管理与工程伦理的徐明生吗？如果是我就开喷了\n\n上课水平较差，谜之卡顿频繁，ppt非常糟糕，全篇复制课本，读ppt也能读错\n\n后天考试，但已经可以提前说，这门课极其不推荐上（然而是19级的必修课程），这是一门非常不成熟的课程，老师也说“其实我们这方面理解水平也有限”，现在完全不知道该怎么复习
139240,2592,徐明生,2021-07-13 15:15:22,2,3,1,it伦理别选他的，事情多，一节课签到三次，分数低
139960,2592,徐明生,2021-08-22 14:12:45,2,2,0,赶紧逃
193319,2592,徐明生,2024-06-06 07:39:19,3,3,0,学号后四位点名，nt展示题目，太抽象了
196326,2592,徐明生,2024-07-03 02:00:41,1,1,0,有点无语。
221966,2592,徐明生,2025-06-28 05:11:29,0,0,0,事多分少，学不到东西
114050,2611,江黎明,2019-07-08 13:41:52,0,0,0,老师的高化挺好的，给分也很合理～有幸上了老师职业生涯最后一堂课，老师真的很严谨又温柔
115421,2611,江黎明,2019-07-22 13:49:00,0,0,0,老师要退休了，祝福他
16443,2632,计剑,2016-01-18 05:53:49,1,2,1,讲课自high型
125496,2632,计剑,2020-09-10 12:31:57,2,2,0,不把学生当人看
134120,2632,计剑,2021-03-16 09:47:44,-1,1,2,太强了，计老板
154139,2632,计剑,2022-05-24 12:11:57,3,4,1,不把学生当人看\n\n觉得自己很牛逼
154150,2632,计剑,2022-05-24 15:52:12,6,8,2,他不是很喜欢听别人说话\n\n玩手机的时候还坚持听别人报告\n\n我哭死
158105,2632,计剑,2022-06-27 05:30:38,4,5,1,我想 计老师之所以对我们有意见\n\n可能是因为我们有心疾吧
158146,2632,计剑,2022-06-27 07:54:42,2,2,0,야， 이 새끼
119584,2765,马列,2019-11-14 02:49:08,1,2,1,果然没挂
32667,2767,朱蔚璞,2016-07-09 02:03:39,-3,1,4,负责任的朱班班
9941,2873,上官勇刚,2015-11-13 04:08:13,9,17,8,高分子近代史讲得很好
10652,2873,上官勇刚,2015-11-21 13:33:37,-3,3,6,讲的不错。老师也很用心\n\n
22800,2873,上官勇刚,2016-03-12 02:48:28,-3,3,6,好好好
23122,2873,上官勇刚,2019-02-24 06:33:12,3,12,9,讲的很差！听不懂在讲什么，听说课件都是带的研究生帮忙做的。然后自己的学生没有一个正常毕业的，变态导师。
49165,2873,上官勇刚,2017-03-28 07:09:16,4,5,1,高分子系必修爱系教育?
78098,2873,上官勇刚,2019-02-24 06:33:18,1,3,2,无聊，差
88859,2873,上官勇刚,2018-11-10 10:06:37,1,1,0,咕咕 咕咕咕咕
145017,2873,上官勇刚,2021-12-26 13:48:09,3,3,0,很有亲和力的老师
145018,2873,上官勇刚,2021-12-26 13:48:20,1,1,0,老师上课很好，有意思
173279,2873,上官勇刚,2023-05-17 13:15:44,0,0,0,对本专业来说太无聊了
193204,2873,上官勇刚,2024-06-04 11:51:39,3,3,0,高分子近代史\n\n事不算多，小论文+开卷考，但论文不限字数，感觉会比较卷，好像也不点名。\n\n上课主要是高分子发展的介绍，以及一堆国内外相关专家介绍\n\n不算差，但有一点要注意，他特别不喜欢有人上课用电脑（仅电脑，不包括手机，我也不知道为啥），介意这点的慎选\n\n另外中间郑强会来上一次
198100,2873,上官勇刚,2024-08-30 12:43:48,1,1,0,我修改我的说法，考试还是有一部分要有专业知识，不是完全在ppt上，所以我出分依托答辩，外专业千万别选
23617,2919,徐君庭,2016-04-10 08:00:39,0,0,0,饿\n\n很饿
25812,2930,杜滨阳,2016-06-08 18:31:13,0,4,4,杜杜啊……杜杜
32896,2930,杜滨阳,2016-07-25 16:19:26,0,2,2,又一个不会讲课的……
152336,2930,杜滨阳,2022-04-05 03:41:56,0,0,0,DUBIOUS
6551,2991,范志强,2015-07-15 05:05:26,6,7,1,困 困 困 感觉讲课没有侧重点
10643,2991,范志强,2015-11-21 09:39:11,0,0,0,很好，满分
27666,2991,范志强,2016-06-27 07:39:49,0,0,0,虽然上课有点催眠，但是老师人还是蛮好的！而且感觉老师科研能力很厉害的样子?
32709,2991,范志强,2016-07-11 03:14:21,0,0,0,范老师老了啊
39302,2997,李寒莹,2016-12-22 03:55:32,2,3,1,抖啊抖的
41548,2997,李寒莹,2017-01-12 07:28:56,0,1,1,寒莹哥哥好帅好帅的
57667,2997,李寒莹,2017-07-12 01:44:23,2,3,1,莹莹男神不解释
73698,2997,李寒莹,2018-02-02 16:47:00,1,1,0,高物最后一节课会点名，讲得非常棒
126225,2997,李寒莹,2020-09-20 06:11:46,7,9,2,西装书包男
160290,2997,李寒莹,2022-09-17 01:21:18,13,15,2,“我中午吃了点饭，因为下午还要吹牛，噢不，上课。”\n\n“跟我有关的事情没有不牛逼的。”
180799,2997,李寒莹,2023-09-26 10:44:24,1,1,0,口音很有特色
27969,3119,施敏敏,2016-06-28 07:55:38,1,1,0,天啦噜
34086,3119,施敏敏,2016-09-26 15:32:01,0,0,0,小学期很水所以教学也看不怎么出来。反正给分我是不满意的。
124803,3119,施敏敏,2020-07-10 05:13:11,0,0,0,不喜欢略略略略略略略略
125662,3119,施敏敏,2020-09-12 17:12:51,0,0,0,trash
136073,3119,施敏敏,2021-06-10 16:41:41,0,1,1,每节课都点名，整吐了
187418,3119,施敏敏,2024-01-16 04:13:12,4,4,0,考试smm出的贼难，展示分比隔壁班低，太难了，感觉不如隔壁班
7703,3241,杜淼,2015-09-15 10:32:05,9,10,1,很耐心
130047,3241,杜淼,2021-01-16 02:19:38,7,8,1,老师不错，但是要背的实在太多了啊啊啊啊啊啊啊啊啊啊！
133060,3241,杜淼,2021-02-07 11:04:26,0,3,3,工艺3背高分子部分简直要吐血了……考试题和作业题形式什么的完全不同……
38180,3470,陈辰星,2016-11-25 10:37:38,1,3,2,老师上课异常有趣 好老师！
52899,3470,陈辰星,2017-06-23 11:42:50,2,4,2,行测助教 特别好！
53220,3470,陈辰星,2017-06-26 08:16:17,-5,1,6,助教，，调分了吗？
59784,3470,陈辰星,2017-09-27 03:05:41,6,9,3,辅导员老师超可爱
60041,3470,陈辰星,2017-10-08 02:50:25,4,9,5,军训参加队列，参加合唱，思政分数高，但是绩点全班最低，只能怨互评
60308,3470,陈辰星,2017-10-17 05:01:10,-6,3,9,嘴上笑嘻嘻，心里mmp\n\n
60995,3470,陈辰星,2018-05-03 10:38:41,-7,4,11,军训绩点太低，太傻
61170,3470,陈辰星,2017-11-10 00:38:45,8,10,2,超级可爱的一个辅导员，几乎不生气
65326,3470,陈辰星,2018-01-03 04:22:02,7,9,2,老师人挺好哒ヾ(Ő∀Ő๑)ﾉ太好惹，
73627,3470,陈辰星,2018-05-03 11:23:30,-21,4,25,垃圾辅导员
74087,3470,陈辰星,2018-02-05 03:54:03,4,7,3,楼上说垃圾的才是垃圾?
76473,3470,陈辰星,2018-04-10 11:58:26,5,7,2,老师脾气超好，很负责，也很幽默～
77164,3470,陈辰星,2018-05-03 13:15:03,0,5,5,我说打那么长的一段的仁兄，客观评价用垃圾这个词好吗？查老师是为了给这位老师到底平时怎么做让同学们有数，一句垃圾到底是客观评价还是泄愤？就算是评价有意义吗？这样算什么？
77165,3470,陈辰星,2018-05-03 08:46:50,3,5,2,老师超级超级超级好！萌萌哒，又和蔼可亲的，最棒辅导员！奶爸！
77184,3470,陈辰星,2018-05-07 14:37:32,2,7,5,拜托，查老师给的就是每个人最主观的评价，骂这个老师是垃圾也好，评这个老师人超好也好，人家觉得怎么样轮不到你来指责吧？不要一副圣人心的样子，太假了。如果全是好评，每个老师都一样，你看这个公众号有什么意义？看一堆学生吹捧老师吗？说老师不好，肯定是有原因的，不要总因为主观意见，就破口大骂好吗？这样哪怕你们站在对的一面，也显得一样没有素质！
77193,3470,陈辰星,2018-05-03 13:53:00,2,2,0,以绩点来评价老师好坏是最愚蠢的方法，陈辰星老师温柔又幽默，绝对是个国民好奶爸
87103,3470,陈辰星,2018-09-20 09:52:11,2,2,0,不管不管！大爱星哥！
198674,3470,陈辰星,2024-09-10 14:49:48,3,3,0,陈指教师节给我们发红包🧧，爱死了
199109,3470,陈辰星,2024-09-18 01:41:01,1,1,0,老师人特别好
199112,3470,陈辰星,2024-09-18 01:46:02,0,0,0,超鸡好的一个导员，几乎没有不笑脸
199448,3470,陈辰星,2024-09-24 02:07:26,-1,0,1,不回消息
199826,3470,陈辰星,2024-09-30 16:03:26,1,1,0,很温柔的指导员
92471,3512,金桥,2018-12-29 13:27:27,0,1,1,超级超级好的老师！
207122,3512,金桥,2024-12-19 10:21:10,2,2,0,老师很可爱，超级好
218753,3512,金桥,2025-05-01 11:35:13,0,0,0,给分差的要死
98206,3941,王征科,2019-01-23 07:38:57,-1,0,1,无话可说
104031,3941,王征科,2019-03-11 00:50:14,3,3,0,sucker
84772,4036,高微微,2018-07-14 00:00:22,4,4,0,课上起来很佛，老师讲课比较平淡(wuliao)，但老师人很好很温柔，给分也不错。老师要生小宝宝了，祝他们健康
105269,4036,高微微,2019-04-09 01:59:34,1,1,0,不太会讲话
108538,4036,高微微,2019-05-28 02:40:02,1,1,0,一言难尽…
108935,4036,高微微,2019-06-04 11:15:24,8,8,0,人力复读机
112685,4036,高微微,2019-07-05 00:26:03,0,0,0,毫无体验可言
112895,4036,高微微,2019-07-05 09:10:11,1,1,0,很温柔，比高化甲班的某王齐老师好多了好吧。人家上课至少不会把你一脸懵b的拉起来答问题。
114051,4036,高微微,2019-07-08 13:42:48,2,2,0,老师……很努力
161599,4036,高微微,2022-11-09 09:23:21,0,0,0,给分不错
106053,4281,张其胜,2019-04-24 15:19:31,0,0,0,张老师天下无敌，我是张老师忠实的天狗。
106624,4281,张其胜,2019-04-28 12:11:40,0,0,0,坪井老爷子挺有意思的
122426,4298,李昌治,2020-02-27 04:04:02,0,0,0,人挺好
138209,4298,李昌治,2021-07-08 02:44:52,1,1,0,求捞嗷
86351,4580,伍广朋,2018-09-14 00:19:25,-9,2,11,我不太想骂人
125099,4580,伍广朋,2020-08-31 08:52:19,1,2,1,事情少，给分超级好！！！！
125247,4580,伍广朋,2020-09-04 11:57:05,1,2,1,高分子英语，懂得都懂，给十分不过分吧
152516,4580,伍广朋,2022-04-14 00:43:20,0,1,1,非常好，经常讲自己的留学故事\n\n上课不枯燥
195318,4580,伍广朋,2024-06-27 17:30:42,0,0,0,大概是这学期专业课里最喜欢的一位老师，上课很有意思！不过高英就是要每周背背背学学学，但是感谢高分子英语极大的补充了我压根没听过的高分子化学……
218869,4580,伍广朋,2025-05-09 19:04:13,0,0,0,上他的课可以，别选他当导师就行
79414,4721,刘建钊,2018-06-04 03:32:16,1,1,0,老师特别年轻，而且特别帅气。\n\n而且没有架子，脾气又好。
104346,4721,刘建钊,2019-03-18 09:09:50,1,1,0,刘老师很牛的啊
154296,4721,刘建钊,2022-05-29 11:54:26,1,2,1,高化课可能会看你拿没拿作业判断点名，提前来评个分，好老师呀，感觉经常会鼓励同学去向他提问
171799,4924,邱利焱,2023-04-06 03:20:23,-1,0,1,回回点名的答辩
217531,4924,邱利焱,2025-04-12 11:22:08,0,0,0,别的不说，邱老师真的很关心学生啊
122079,5216,郑强,2020-02-11 08:48:19,11,29,18,呵呵呵呵呵呵呵呵哈哈哈
122732,5216,郑强,2020-03-27 00:21:00,-13,40,53,洗脑言论！！！差评！！！
122738,5216,郑强,2020-03-27 07:03:09,113,137,24,郑教授的言论，太过于非此即彼了，初听时有道理，但经不起仔细推敲。\n\n不过大学里应该容纳每一种声音，包括郑教授发声。
122789,5216,郑强,2020-04-07 07:19:41,45,50,5,大学应该有各种各样的声音，有时候郑老师得声音还是可以听听
123110,5216,郑强,2020-05-10 11:05:33,68,80,12,学术水平不错，演讲观点有点偏激
123302,5216,郑强,2020-06-01 06:56:58,49,72,23,很红的老师。爱国没错可是能不能不要煽动极端民族主义和民粹主义？？？
124158,5216,郑强,2020-06-25 20:40:45,15,26,11,强哥说谁是最好的大学，谁就是最好的大学
124924,5216,郑强,2020-07-21 03:23:53,33,42,9,怀念强哥
125575,5216,郑强,2020-09-11 15:51:16,-12,19,31,很牛，逆曾经那个时代而行，痛批左壬托派小鬼的民族主义者，矫枉过正的公知
126098,5216,郑强,2020-09-17 11:56:13,63,73,10,希望郑强老师重回浙大
126389,5216,郑强,2020-09-24 14:44:47,16,19,3,抖音上见过的老师。
126550,5216,郑强,2020-09-30 07:20:45,-79,16,95,哗众取宠，真是笑话
126640,5216,郑强,2020-10-10 14:56:39,-46,6,52,网红老师，本来挺期待的。
133195,5216,郑强,2021-02-16 09:12:20,-46,24,70,我认可需要不同的声音，但这不妨碍我觉得这人是个傻逼
134728,5216,郑强,2021-04-12 08:03:52,100,113,13,学术成就高，亲身办实事，在敌后工作多年，敢说真话，直指社会的病态和教育的悲哀\n\n演讲考据不一定充分，煽动性强\n\n言行一致的民族主义者，建设国家的实干家，无奈的民粹主义者\n\n请不要说强哥极端，因为太多太多站在了天平的一边，摇摇欲坠，必须有站在另一边以一敌万的力量
135499,5216,郑强,2021-05-12 02:40:36,-108,13,121,他调走了才报的浙大，最讨厌这种老师，现在教线代的还有一个一个德行的
135549,5216,郑强,2021-05-13 08:38:30,-67,11,78,跳梁小丑！
135785,5216,郑强,2021-05-26 00:21:42,53,62,9,直指伤疤，言行一致，戳中了某些跳梁小丑的痛处，矫枉必须过正，特别是在那个公知盛行，崇洋媚外的年代
135866,5216,郑强,2021-05-31 01:26:35,25,30,5,矫枉需过正
136172,5216,郑强,2021-06-11 16:35:58,32,40,8,鹰派分子，实干家，实力派\n\n真真正正办教育的人，不是某些“求仕创薪”的小丑\n\n真理与正义刺痛了某些新自由主义者和逆民族主义者的软弱内心
136707,5216,郑强,2021-06-23 08:24:54,29,32,3,真正践行了“求是创新”的教育家！有人文情怀和民族气节的实干家！\n\n某些求仕创薪的的败类，真是为浙大蒙羞
142564,5216,郑强,2021-11-13 11:14:18,39,40,1,鲁迅先生说过：“中国人的性情总是喜欢调和、折中的。礕如你说这屋子太暗，须在这里开一个窗，大家一定不允许的。但如果你主张拆掉屋顶，他们就会来调和，愿意开窗了。”当今像郑强教授这样敢于毫不避讳地揭露社会中存在的问题的人已经不多了。要想在社会中达到振聋发聩的效果，就必须更加辛辣直接地将弊病暴露出来。浙大应该为拥有郑强教授这样的老师感到自豪！
143191,5216,郑强,2021-11-21 06:49:17,15,18,3,浙大应该以他为骄傲
144821,5216,郑强,2021-12-24 18:18:02,19,22,3,确实做实事 能力突出\n\n个性鲜明 研究水平高\n\n有些言论偏激一些 但是无可厚非\n\n真正爱国的知识分子\n\n非常值得尊敬
148230,5216,郑强,2022-01-12 02:14:53,-8,17,25,刚开始觉得就是个爱国人士，后来越来越偏激，爱国言论发表过度，还在公众演讲上说，就怀疑他的目的了，希望小丑是我自己吧！从来不想把人心往坏想，但他说话明显出格了
152244,5216,郑强,2022-03-31 06:38:59,5,7,2,强哥还是让人印象深刻的呀！
154545,5216,郑强,2022-06-02 05:46:11,10,12,2,虽然郑强教授的讲话可能有点偏激，但他是浙大的骄傲！
159316,5216,郑强,2022-07-12 07:28:45,9,10,1,强哥YYDS，可惜知道强哥时候太晚了
159370,5216,郑强,2022-07-15 01:55:09,-27,6,33,这个老师的很多观点我不敢苟同。\n\n用“浙大学生考研考不过双非学校”来抨击我们，说我们是“高考领先的一步使我们再也不会领先别人”
159850,5216,郑强,2022-09-06 05:00:22,17,19,2,浙大之光
159864,5216,郑强,2022-09-07 02:58:37,15,18,3,浙大之光
159911,5216,郑强,2022-09-09 01:21:22,35,40,5,一段时期有一段时期的背景，郑强老师所广为流传的言论，看画质也知道是多年前发表的，而这样的言论偏激么？偏激！对那段时期有用么？有用！矫柱需过正，总有人得逆潮而上站于天平另一侧。所以，我还是认为郑强老师的言论不该用当下环境当下之人当下之势来评判，我认为郑强老师是敢言之人\n\n是浙大的骄傲
160995,5216,郑强,2022-10-23 14:55:36,-86,7,93,纯傻逼，脑残
180656,5216,郑强,2023-09-24 09:01:54,6,7,1,有幸听到郑强老师的讲座，很专业的学者
181206,5216,郑强,2023-10-11 12:31:34,3,5,2,让子弹再飞一会儿
182234,5216,郑强,2023-11-13 05:17:14,-18,7,25,民粹主义者
197889,5216,郑强,2024-08-19 10:31:34,-9,6,15,讲的都是些无关紧要的事。尽量远离看起来大义凛然的人。
199181,5216,郑强,2024-09-18 23:11:59,12,13,1,在那个年代，在那个你在中文互联网上夸一句中国都要称得上一条汉子的年代，他敢公开发表这样的观点，我佩服地五体投地。\n\n再看评论里那些反对者，什么成分我不多说了。任何话脱离了时代背景都经不起考证。你们自以为自己说的是不刊之论，其实是“不堪之论”。\n\n他不是神，只是一个人。你可以要求一个神完美，可你凭什么苛求一个人无缺？你就算要抨击，也应该去抨击那些把他捧上神坛的人。在鸡哥没有塌房前，你到底该骂鸡哥还是鸡哥的粉丝？\n\n恕我直言，就冲他当年在校内用单车别校长的车，批评校长在不该开车的地方开车，我就要给他10分
200964,5216,郑强,2024-10-25 12:08:24,11,12,1,说强哥偏激和民粹主义的，我两句话告诉你为什么：\n\n1.请根据那个年代的公知数量推断社会环境。\n\n2.事急不可不从权，矫枉不可不过正。
216058,5360,沈家骢,2025-03-10 05:15:47,0,0,0,这是彭神彭笑刚的博士生导师，先来打个10分
136647,6121,许震,2021-07-14 04:18:52,0,3,3,给分不好
195236,6593,黄宁,2024-06-27 11:11:04,0,1,1,老师上课讲得很清楚，课程相关资料也提供得很充分，期末作业ddl给的也不紧张，上课也是很好地落实了相应的教学目标的。这学期高专英课程体验还是很不错的，收获不小👍
122482,6716,杨静,2020-02-29 17:06:25,4,10,6,优秀 严格
122480,6888,刘程翔,2020-02-29 16:45:20,4,4,0,认真温柔 工作能力出色 对学生特别好
179907,6888,刘程翔,2023-09-20 03:24:29,1,1,0,老师是很温柔的女生，但工作能力高不敢苟同。。。。希望以后更用点心吧
216440,6888,刘程翔,2025-03-16 13:25:40,1,1,0,美丽知性。
152576,7163,刘英军,2022-04-15 03:20:56,4,4,0,good
163436,7163,刘英军,2022-12-14 09:51:36,0,1,1,上了老师的大学写作，很喜欢刘老师，人挺温吞的，很年轻有为，不拖堂，备课上课真的很认真，感觉有点词不达意，但真的学生几千字的文章都自己看过去了和学生谈起的时候还会有印象能提出优点和改进的地方，学期没结束不知道给分咋样但人真的不错！！！
163440,7163,刘英军,2022-12-14 10:08:48,-1,2,3,上的什么鬼
165862,7163,刘英军,2023-01-10 07:09:04,2,2,0,老师会点名的 老师备课很认真，但是大学写作这门课真的emmm……非必选就别选
199882,7188,方文章,2024-10-06 11:09:55,0,0,0,咦咦咦
197588,8219,左立见,2024-07-20 11:23:55,5,6,1,作为研究生很优秀，作为导师很一般。所以慎重选择研究生导师！
203218,8219,左立见,2024-11-18 05:59:24,1,1,0,选硕博导师要慎重！！
205868,9264,彭博宇,2024-12-12 11:34:31,1,1,0,还可以
205869,9264,彭博宇,2024-12-12 11:35:59,2,2,0,非常好的老师
205871,9264,彭博宇,2024-12-12 11:38:44,0,0,0,彭老师人非常好，上课风趣幽默，不点名
217325,9264,彭博宇,2025-04-08 12:43:50,0,0,0,备课很认真的老师
219497,9711,张成建,2025-05-28 17:17:21,0,0,0,不赖的老师，人很好
