评论id,老师id,老师姓名,发表时间,点赞减去点踩数量,点赞量,点踩量,内容
2293,35,郭兴忠,2015-04-16 12:24:18,1,1,0,无聊，，
12686,35,郭兴忠,2015-12-24 01:52:08,3,7,4,很有亲和力
31645,35,郭兴忠,2016-07-04 10:37:31,0,1,1,很和蔼的一个老师
61433,35,郭兴忠,2017-11-17 07:34:54,0,1,1,讲课有内容，有认真准备，就是ppt给的不及时
78019,35,郭兴忠,2018-05-09 05:04:27,0,1,1,老师人很好，也不卡绩点
85029,35,郭兴忠,2018-07-15 04:47:23,0,0,0,讲的很清楚
106650,35,郭兴忠,2019-04-28 15:58:01,0,2,2,老师人很好，就是上课内容平淡了一点，课堂展示学到了很多，期末考打印ppt心疼money
135248,35,郭兴忠,2021-05-06 18:03:23,7,8,1,上课必点名（签到） 感觉付出与回报根本不成正比 而且查老师上均绩虚高
135290,35,郭兴忠,2021-05-07 15:46:55,3,3,0,感觉老师非常古板 不想吸收学生的有益建议……
153339,35,郭兴忠,2022-04-28 08:32:23,-1,1,2,坐标2022年春学期，上课基本上都点名，有点无聊，但是老师人还算和蔼可亲，展示+课程论文，我承认自己是大意了写的有点跑题废话比较多，最后4.2，也还好吧
185841,35,郭兴忠,2024-01-05 00:46:30,0,0,0,🐶🐱🐭
1398,174,吴进明,2015-03-22 01:43:12,2,11,9,刚好我上了工程材料和材料科学与人类文明。建议大家不要选，看上面的平均绩点就知道了
2628,174,吴进明,2015-05-05 01:21:20,4,11,7,老师人很好，但建议社科类同学不要选这门课\n\n
3219,174,吴进明,2015-05-21 08:57:16,2,7,5,社科的满了。老师讲得不错，关键是要自己认真不要归结于老师，毕竟只是通识
4438,174,吴进明,2015-06-23 05:42:45,6,13,7,讲得可以，理工科表示压力不大，但文科估计觉得挺难的。
5310,174,吴进明,2018-06-19 03:55:00,-17,18,35,傻逼一样老师，这个老师过于死板，瞎鸡巴搞
6572,174,吴进明,2015-07-15 13:55:24,2,9,7,材料力学上老师讲的内容很丰富，很充实。。不过零基础的同学就悲剧了\n\n
6722,174,吴进明,2015-07-20 03:36:08,1,6,5,不错
17779,174,吴进明,2016-01-21 01:17:14,2,6,4,老师上课很有趣  知识点讲的浅显易懂
20952,174,吴进明,2018-06-19 03:54:46,-14,15,29,简直一个鸡巴老师，不说了，给分超坑
24085,174,吴进明,2016-04-26 16:02:19,2,5,3,明天考试希望考好的。233 老师手下留情
24907,174,吴进明,2016-05-04 09:35:54,1,9,8,垃圾老师！
24942,174,吴进明,2016-05-04 11:24:50,1,5,4,老师很好，社科的。。工程材料和材料科学与人类文明都给分不错
27682,174,吴进明,2016-06-27 08:11:18,1,2,1,挺好的，很有意思的课
47018,174,吴进明,2017-01-23 09:46:05,4,5,1,上得还算ok吧，相对于其他水课，材基章节的课时分配不合理
49563,174,吴进明,2017-04-18 13:39:05,5,13,8,一匿名我浙的有些学生和低素质的人就雌雄难辨了
49682,174,吴进明,2017-04-23 15:29:17,0,2,2,老师水平高的，讲课很丰富(很喜欢从基础开始一点点讲，但是就会太累赘。。)\n\n很喜欢这个老师，但是不是很喜欢金属方向2333
49766,174,吴进明,2017-04-25 15:06:53,8,17,9,我觉得吴进明老师上课很有意思啊，也都有重点啊，很有趣啊
49821,174,吴进明,2017-04-26 08:51:32,0,1,1,给分好 上课一般
49837,174,吴进明,2017-04-26 10:42:17,1,1,0,老师上课很好的
80536,174,吴进明,2018-06-27 14:18:27,0,2,2,老师讲课讲得很好，上课会与学生有较多互动，但是不点名的，没来也不用怕，干货满满，很喜欢～
81159,174,吴进明,2018-07-04 07:41:29,-5,4,9,辣鸡。。
81167,174,吴进明,2018-07-04 07:55:58,10,17,7,老师是有水平的，也很和蔼\n\n但是上课确实是很没有条理了，非常乱
81328,174,吴进明,2018-07-04 18:17:11,3,4,1,低的一批
105313,174,吴进明,2019-04-10 02:01:16,14,14,0,为什么一讲到关键点声音变小?感觉抑扬顿挫的语气OK但是抑扬的重点不对啊...
105315,174,吴进明,2019-04-10 02:16:49,5,6,1,上课的语气阴阳怪气根本听不清，还总是一个个点同学来回答问题，选上的都退了选别人吧
105585,174,吴进明,2019-04-17 01:59:01,3,5,2,还行，但我是真的听不懂他的语言
106626,174,吴进明,2019-09-23 05:55:41,-5,6,11,我从来没骂过人，但是这个，真的是狗屎
106747,174,吴进明,2019-04-29 08:18:37,-1,3,4,工程材料讲得挺好的吧，该讲得也都讲得很清楚了。每节课前都会差不多花半个小时复习下前面的内容，形式不定，点名也有，直接叫同学回答也有。 单纯就春学期的工程材料课程而言，上课的时候，一般不在讲台上讲，而是在大概三四排的中间。不管是作为专业选修课还是个性课程，只要别把它当通识课程来对待，最后的结果也不会差到哪儿去吧。 如果以后想当个近机械方面的工程师的话，这些内容也会挺亲切的，材料总是绕不过去的。
123145,174,吴进明,2020-05-13 02:48:41,2,3,1,为啥每个名词都要念一遍并写一遍英文呢？即使是不重要的名词。迷惑
123195,174,吴进明,2020-05-19 00:28:46,7,9,2,材科基每节课都要小测谁顶得住啊……题目还贼难
125116,174,吴进明,2020-09-01 04:45:19,1,2,1,老师讲的还是蛮清晰的，只是材科基2真的太难了。嘤嘤嘤……
127268,174,吴进明,2020-11-18 15:50:50,2,2,0,听不懂
127384,174,吴进明,2020-11-22 06:12:40,2,3,1,上的吴老师的工程材料\n\n老师上课很风趣 我这种经常上课睡觉的都听得很有兴致 老师声音也很好听\n\n平时作业字有点多 但基本都是书上的知识点 也是为复习做概括性准备\n\n每节课一杯麦斯威 很可爱的老师\n\n考试不难 平时听进去了 考前背背PPT足够了
127897,174,吴进明,2020-11-30 02:48:03,1,2,1,材科基靠吴老师的部分拿分
127925,174,吴进明,2020-11-30 11:00:22,2,3,1,老师人挺好，但给分真的坑
134494,174,吴进明,2021-03-30 06:05:41,2,3,1,工程材料，讲课极差。
135860,174,吴进明,2021-05-30 09:22:48,1,2,1,分数有点。。。那啥
137080,174,吴进明,2021-07-08 02:16:16,2,3,1,老师很博学讲课也很好 材科基还没出分 先给老师打十分为敬
141488,174,吴进明,2021-10-12 02:03:05,3,3,0,B西西结构
152922,174,吴进明,2022-06-13 06:24:56,11,11,0,第一节课就点名加提问，很会让人紧张起来，一节课叫了七八个同学回答问题。\n\n还有这教材太垃圾了，课后布置的题书上都没有公式什么的，书本的知识点分布非常零散，经常找不到。
153100,174,吴进明,2022-04-25 12:40:05,3,3,0,感觉上课的逻辑有一些混乱
157121,174,吴进明,2022-06-22 03:22:14,25,30,5,这位老师上课完全不按教材讲，自己讲自己的，看似和学生有互动，实则根本不在乎学生的想法，课堂交互为零。讲AL的固溶强化的时候从课本37页跳到了137页，全班同学都不知所云，直到下课有同学去问，他才翻了翻课本，说这个是按我的思路来的，你们课本上是有的，但是自己找。上课只要讲到重点，声音就会莫名其妙轻下来，徒留我和旁边同学面面相觑，不知所云，想听懂但真的听不懂，心里很窝火。本人14次课全勤，作业认真书写，遇到忘记的知识点还会回头复习书本，考前也全书都复习了，最后绩点怒夺3.3.以上内容仅代表个人看法，希望各位同学引以为鉴。最后，不管这门课以后会不会被取缔，它创造的巅峰体验，至尊享受，无与伦比的垃圾课堂，不可否认地都在我的学习生活中留下了浓墨重彩的一笔。
157126,174,吴进明,2022-06-22 03:35:09,3,3,0,不知道这个6.7的分数怎么刷到的，本人工程材料课，全勤全部认真听，作业全部认真做，但是从作业分开始就是乱给的，上课讲的什么东西我相信听过的都知道。纯纯瞎讲。最后3.6，学弟学妹跑吧
157992,174,吴进明,2022-06-26 04:14:50,3,3,0,呜呜呜呜太难了
174463,174,吴进明,2023-06-12 15:09:21,2,2,0,工材，建议上课看别的老师的录播，这课真的听不下去
176449,174,吴进明,2023-06-29 02:54:33,1,1,0,工程材料，老师口齿不清，ppt很乱，讲课乱，听课、学习体验最差的一门课了
177486,174,吴进明,2023-07-03 11:57:07,3,3,0,丑话在前，吴老师的工程材料课程确实使人感到迷惑和摸不着头脑，ppt中也存在部分错误和解释不清的情况（复习时可辅以别班老师ppt构建框架），但是吴老师本人是一位很和蔼的老师，小测中的误判可以及时找老师更正，学习有困难时，吴老师会一对一地把测试题目全部梳理一遍，可见老师在这方面还是非常认真负责的，关于考评，期末60%，考前复习充分，关注复习课，可以取得比较理想的成绩。
177682,174,吴进明,2023-07-04 08:12:09,3,4,1,｡ﾟ(ﾟ≧□≦ﾟ)ﾟ｡
177683,174,吴进明,2023-07-04 08:14:55,1,3,2,。。。。。。
178996,174,吴进明,2023-08-16 14:44:41,5,6,1,个人感觉吴老师上材科基2的时候讲课挺清晰的，前提是要一直跟着上课的思路。吴老师讲课速率并不快，并且由于不知道同学对于前面内容的掌握程度，还会常常给同学回顾（甚至会拖慢上课节奏，但经过调整也能拉回进度，从不拖堂）。这门课吴老师部分拿分的关键在于听懂上课老师着重强调的部分，考试的大头还是在于理解。
194916,174,吴进明,2024-06-26 02:30:45,3,4,1,老师讲课讲得挺好的，但感觉有些抓不住重点
201695,174,吴进明,2024-11-05 12:54:15,0,1,1,老师讲得很好，很和蔼
218630,174,吴进明,2025-04-27 12:03:04,1,1,0,不点名可以一直睡，看智云根本不知道重点是什么
218808,174,吴进明,2025-05-06 10:40:07,0,0,0,上课不知所云，声音时轻时重变化无常，很难听明白他在讲什么。你会发现你想要认真听，但是一点听不进去。老师有水平？老师的水平应该是讲课的能力而不是学术水平，这样子还不如让我自学。好在不点名不小测，建议全部翘课
221944,174,吴进明,2025-06-27 14:51:47,0,0,0,不知所云，嘻嘻哈哈
1835,185,杨德仁,2015-03-26 01:29:33,13,15,2,很牛的老师
24486,185,杨德仁,2016-04-30 15:42:28,11,12,1,硅所大boss，把专业课当通识一般讲，但该讲的全没有落下，上课特别好玩，喜欢讲故事，略微自恋，但自恋得异常萌，丝毫不让人反感那种。良心老师。
49181,185,杨德仁,2017-03-28 15:28:54,1,2,1,讲的挺好的
76150,185,杨德仁,2018-03-28 03:39:37,0,1,1,中科院院士求罩
87890,185,杨德仁,2018-10-17 02:49:20,3,3,0,膜拜院士大佬\n\n\n\n\n\n话说杨老师的讲座真的很有趣啊´∀`
122856,185,杨德仁,2020-04-15 05:35:31,20,24,4,杨老师 爱了爱了！！
122889,185,杨德仁,2020-04-17 03:56:03,10,11,1,一位有温度的老师。在浙大唯一的遗憾就是没能成为杨老师的学生，但能与杨老师同为浙大人，我已深感荣幸！
128124,185,杨德仁,2020-12-08 03:09:33,-1,1,2,祝贺！3位浙大人荣获全国先进工作者荣誉称号\n\nhttps://mp.weixin.qq.com/s/f0TP-b6rSCSVnyQph9J2Xw
26318,221,涂江平,2016-06-17 00:55:54,9,13,4,看不起我们
27514,221,涂江平,2016-06-26 16:22:44,3,7,4,mdzz
28730,221,涂江平,2016-06-28 13:22:36,23,27,4,工艺基础的考试没有任何意义
31076,221,涂江平,2016-07-03 07:50:26,2,5,3,上课声音不够大
31323,221,涂江平,2016-07-03 15:57:50,12,14,2,烂透了
123170,221,涂江平,2020-05-15 02:03:49,5,10,5,讲课不行，脾气倒是大得一批
123202,221,涂江平,2020-05-19 07:00:28,16,23,7,老师好凶啊呜呜呜 作业讲评的时候直播没按时开起来就直接被骂了
124131,221,涂江平,2020-06-25 02:50:55,3,7,4,考试复习，几百页ppt，要背死了
124801,221,涂江平,2020-07-10 04:59:59,12,15,3,上课讲得差就算了，期末背了这么久还卡我绩！！！垃圾垃圾垃圾！！！
124849,221,涂江平,2020-07-13 08:55:16,11,15,4,脾气烂，给分差。助教也迷。努力备考发现根本没用
125108,221,涂江平,2020-08-31 14:22:00,7,10,3,能不能别老是叫我
128489,221,涂江平,2020-12-23 11:01:51,-2,2,4,掉点课
136743,221,涂江平,2021-06-24 01:47:09,4,6,2,就不想给你平时分呗
138270,221,涂江平,2021-07-08 09:03:32,-2,1,3,好吧，成绩出来，还行，平时分还是给了的，可能上次运气不大好
138324,221,涂江平,2021-07-08 13:53:44,-2,1,3,就这？
152353,221,涂江平,2022-04-06 07:29:36,2,5,3,每一届都是最差的一届\n\n单调递减
156729,221,涂江平,2022-06-20 23:51:17,-2,3,5,材料工艺学给分也太差了\n\n就算是考作业一模一样的题\n\n但你作业答的就全对吗，平时作业都不知道自己答的对不对
174334,221,涂江平,2023-06-09 15:46:17,1,4,3,😆😅😇
193632,221,涂江平,2024-06-14 05:39:32,-3,1,4,讲课不行，脾气倒是大得一批
219566,221,涂江平,2025-05-30 01:21:08,0,0,0,😅？莫名其妙
219576,221,涂江平,2025-06-05 10:26:23,0,0,0,😫😫😫
221466,221,涂江平,2025-06-24 02:22:54,0,0,0,给分不错
221946,221,涂江平,2025-06-27 14:54:05,0,0,0,专业课来说，中规中矩，没什么问题
653,223,杜丕一,2015-03-15 10:20:35,-1,4,5,老师不给课件，这点不能忍！！！材基1题目不算难，但是貌似没有所谓的过程分
6128,223,杜丕一,2015-07-11 05:43:58,0,4,4,材料基础1很坑，不给课件，问他问题爱理不理，考试也很坑。真想xxxxx.\n\n
20014,223,杜丕一,2016-01-26 01:57:36,0,2,2,呵呵。。。材基提了绩点，结晶化学拉了绩点。。。真不知道说什么好
26598,223,杜丕一,2017-01-23 09:44:25,8,9,1,结晶化学考试有点坑
27989,223,杜丕一,2016-06-28 07:57:22,4,5,1,讲得很细，很认真。
28704,223,杜丕一,2016-06-28 12:36:17,0,0,0,通融合了
29009,223,杜丕一,2016-06-29 06:17:33,1,2,1,觉得老师挺可爱，也挺认真的
29022,223,杜丕一,2016-06-29 06:42:13,3,3,0,平时没作业，讲课清楚但是不够精准
32644,223,杜丕一,2016-07-08 12:07:24,2,4,2,给分不合理，不给步骤分
32660,223,杜丕一,2016-07-09 00:58:33,4,6,2,材基1给分完全看大题，全对5.0，错一道4.0左右，错两道3.0，错三道2.0，全错挂
44526,223,杜丕一,2017-01-18 02:26:38,-1,3,4,杜不二老师人很好啊，他的两门课我都修了，材基1我大题也不是全对给了我4.6，结晶还不知道，感觉老师很可爱啊，就是不上课的时候遇到表情有点严肃
73200,223,杜丕一,2018-02-01 06:59:10,3,4,1,课讲得很细，讲得有点慢。不二老头还是很和蔼的，就是问他问题的时候他很严肃。材科基1内容又多又杂，但考试不会很偏，熟悉基本知识就好。
75097,223,杜丕一,2018-03-07 10:34:38,0,0,0,老杜很萌的，虽然不给PPT，但课讲的很不错，最后期末考大题做好分肯定不会低。
76602,223,杜丕一,2018-04-16 06:29:15,0,0,0,萌萌的杜老师
114093,223,杜丕一,2019-07-08 22:48:19,1,1,0,材料结晶化学给分真的坑，不过全英文的，听听还不错
117481,223,杜丕一,2019-09-25 02:05:43,0,0,0,这老师怕是对高考有什么误解……\n\n
50760,1169,朱丽萍,2017-05-05 02:55:02,0,2,2,垃圾老师，垃圾给分，原地爆炸
93769,1233,李东升,2019-01-13 11:38:04,1,9,8,太阳能电池这门通识课慎选，从来没见过一门通识课要小测，展示和写论文的。
93790,1233,李东升,2019-01-13 18:12:15,0,10,10,事情巨多，
195518,1233,李东升,2024-06-28 13:34:21,2,5,3,1分是系统的极限，不是你的极限
196863,1233,李东升,2024-07-05 14:03:33,5,7,2,李东升，男，博士，教授，2002年在浙江大学硅材料国家重点实验室获半导体材料工学博士学位。1999.10-2000.9年获日本财团法人协会资助，作为联合培养博士生，在日本静冈大学工作一年，主要从事光电薄膜晶体生长及光学特性的研究工作；2002年6月赴意大利Milano－Bicocca大学进行为期三个月的访问研究，从事光致发光谱研究。近年来主要从事硅基光电子材料及器件、表面等离激元微结构制备以及表面等离激元增强发光/Raman研究。先后主持国家自然科学基金3项、国家重点研发计划课题1项、863计划1项、973二级子课题2项，出生东西你🐎没了全家赤石并作为骨干参加了多项国家自然科学基金、863计划等项目的研究工作。至今，共发表论文一百七十余篇（SCI收录140余篇），并拥有发明专利二十余项。获浙江省科技进步奖一等奖两项，国家自然科学二等奖一项。
5078,1466,蒋建中,2015-07-03 11:01:24,-3,10,13,最后一节课点名，简直坑，分数会正太完全看运气
24237,1466,蒋建中,2016-04-28 16:12:42,4,5,1,我觉得老师蛮好的呀。。。展示要好好做。。。上课认真听可以学到东西。。。新材料的东西比较多。。。然后我觉得老师很好的一点就是对文科的学生没有偏见。。。。。。我觉得真的蛮好
24242,1466,蒋建中,2016-04-28 17:17:07,24,27,3,感觉老师讲的挺好的，研究的内容也很新颖。然而大家不要被这个课的名字迷惑，其实这是一门材料物理课。
39425,1466,蒋建中,2016-12-22 14:43:11,1,1,0,还不错
48263,1466,蒋建中,2017-03-07 12:44:06,0,1,1,一般般
52449,1466,蒋建中,2017-06-20 07:09:04,3,5,2,作为一门新生研讨课，事情确实不多，论文回答几个问题就OK了(大部分内容可以复制粘贴)，翘课，不点名，给分，怎么说呢，勉强上4，搞科研的不懂师生情，给分不算很高，但这么轻松的课确实还过得去。老师人还是蛮好的。当然，也有同学给分呵呵，估计是论文思考题的见解不够吧。
52451,1466,蒋建中,2017-06-20 07:28:10,-1,1,2,给分……看情况吧，反正我很低，没翘过课\n\n
52454,1466,蒋建中,2017-06-20 07:55:04,7,7,0,老师绝对是材料领域的大佬，讲课很认真，注重学生的主动思考能力。期末交一篇报告就OK了，认真写成绩不会差的。
52737,1466,蒋建中,2017-06-22 11:18:55,5,5,0,很不错的老师，很能够鼓励学生，激发我们主动学习的热情事也不多，最后的报告不算很考验专业知识，只要记得写认真些，多用自己的话说，少点复制粘贴。认真一点给分就很好的。
52855,1466,蒋建中,2017-06-23 08:05:50,4,5,1,老师上课是真的很认真。是我大学第一节一整节课都没看手机的课。上课要注意跟老师的互动，要有自己的想法，多表达。认真了就能拿到好分数，这门课的绩点真的跟付出成正比。
66215,1466,蒋建中,2018-01-13 09:58:45,-7,3,10,这个傻逼老师
81811,1466,蒋建中,2018-07-06 08:35:20,0,1,1,老师超级好 虽然我是文科学生 但每节课按时到了 论文认真写了（虽然他加了两个方面的题目真的不会 没有写）就满了 虽然上课可能会比较多涉及材料物理 但是其实认真找材料就可以的
81820,1466,蒋建中,2018-07-06 09:02:18,0,1,1,被正态了呵呵
81845,1466,蒋建中,2018-07-06 09:53:11,-2,0,2,一般般吧，蛮水的。我每节课都到，论文写的还行，最后4.2，也能接受，毕竟这门课真的挺水的。
81850,1466,蒋建中,2018-07-06 10:03:54,1,2,1,蒋老师是材料物理方面很厉害的开拓者。也是一个好的教育者。上课氛围很轻松，鼓励自由发声。虽然我对这方面的知识并不了解，但听老师讲课还是很有趣的！（对于一些专业的名词，老师会做出简单易懂的解释，人很nice，对同学称呼“您”）。前几节课都是小组展示+老师总结+交流。最后是一篇论文，认真付出就会有回报叭。（感谢老师）
81934,1466,蒋建中,2018-07-06 13:51:10,1,1,0,我们都没资格评价这位老师。
81984,1466,蒋建中,2018-07-06 16:58:05,2,2,0,老师上课个人觉得很有趣，笑眯眯的，会让同学踊跃发言，发言占平时分，期末靠论文，还是挺棒的
84229,1466,蒋建中,2018-07-12 09:42:59,0,1,1,文科生慎选，挺浪费时间的，打分看运气，绩杀
106957,1466,蒋建中,2019-04-30 12:10:24,0,1,1,不(一）知(片）所(乱）云(扯）。
113991,1466,蒋建中,2019-07-08 06:26:38,0,0,0,给分不错，不过内容还是很硬的
155961,1736,王晓东,2022-06-17 01:58:38,28,34,6,医学院也有个王晓东老师，性格很有趣，讲课挺好玩的，评的是他^ ^
174558,1736,王晓东,2023-06-14 05:06:03,23,25,2,我也是评医学院的王晓东，老师人很好，关心学生，在认真教书，希望把课讲得有趣来让我们学的好一些，讲课超级好
192805,1736,王晓东,2024-05-30 14:48:30,5,10,5,晓东老师喝XO吐了一地自由基
210539,1736,王晓东,2025-01-09 10:20:54,0,3,3,国家大科学装置同步光源\n\n老师讲得激情澎湃，但是课实在是有点无聊，考核形式是一篇综述，给分还行
210817,1736,王晓东,2025-01-10 04:21:41,0,3,3,老师真的很有热情诶，我真的很想很想听他的课，前几节在认真听，到后面跟我自己的专业不挂钩真的听不下去，啊啊好希望能回答上他的问题，给分感觉还行，认真就会有收获
214424,1736,王晓东,2025-02-02 15:00:55,2,2,0,555
217235,1736,王晓东,2025-04-05 14:47:14,5,5,0,医学院的王晓东老师讲课真的很有趣，上的是病生的IRS、HF和Shock三个章节。不仅关心学生PPT都是中文，而且逻辑清晰内容与时俱进。希望医学院都是王晓东这样的好老师呜呜呜
220429,1736,王晓东,2025-06-18 02:20:13,1,1,0,上的国家大科学先进光源，老师人很耐心，会提出修改意见，给分还行，就是课好像没人听
3167,1738,洪樟连,2015-05-18 12:28:59,29,51,22,在专业领悟研究很深。很想上好通识课，做了很多努力，但欠缺些讲课的技巧和表达能力
3426,1738,洪樟连,2015-06-12 04:34:38,11,15,4,想把课讲好 只是每次都重复 就没意思了
5035,1738,洪樟连,2015-07-02 11:24:16,21,29,8,老师很认真，不过课很无聊
6724,1738,洪樟连,2015-07-20 03:37:25,-16,5,21,老师很负责，很注重启发学生回答问题哦
8022,1738,洪樟连,2015-09-16 13:58:18,21,25,4,我听第一节课就退了。一直在东扯西拉，很不脚踏实地。官僚气很重，每说几个字就说“对吧”“是吧”。据他自己说，每年第一次课后都会有五分之一的同学退课
8032,1738,洪樟连,2015-09-16 15:03:55,-19,2,21,好好好
8376,1738,洪樟连,2015-09-20 02:44:36,31,45,14,上纳米科技的课，完全不讲有关知识，东拉西扯一堆废话
9086,1738,洪樟连,2015-10-12 14:55:44,7,9,2,东拉西扯………
9468,1738,洪樟连,2015-10-28 10:49:38,10,20,10,简直就是江湖神棍，每周两个半小时，有一大半的时间都在扯什么哲学，作为老师连一些基础的物理和化学知识都不清楚，讲的都是错误的价值观。说话也毫无逻辑，索然无味
9756,1738,洪樟连,2015-11-08 11:12:12,8,11,3,老师讲课不咋地 就瞎掰掰
9757,1738,洪樟连,2015-11-08 11:08:42,43,64,21,上课完全和纳米没什么联系啊，一只谈人生谈价值观的，还讲如何制作好PPT。。。我就是想了解一下纳米拓宽一下视野，不想心灵鸡汤凸(>皿<)凸
9880,1738,洪樟连,2015-11-11 14:13:56,23,31,8,我觉得他是一个很有思想的老师，本身也是一个很优秀的学者，但是可能就是因为这些他在课上更多的时候都在讲一些不着边际的东西，他思想太过前卫以至于我很难有显著收获
9963,1738,洪樟连,2015-11-13 09:15:49,-13,5,18,不仅能成为纳米方面的小专家，还能学会很多别的东西。
9993,1738,洪樟连,2015-11-14 03:08:23,28,35,7,Ppt制作理论，鸡蛋里挑骨头技巧学习。
10012,1738,洪樟连,2015-11-14 08:29:00,-6,0,6,还行吧。。
10372,1738,洪樟连,2015-11-18 09:46:46,28,30,2,如果你是想来学纳米科技的，呵呵那你就错了。
10935,1738,洪樟连,2017-10-17 13:05:00,8,9,1,听了5分钟就想退课了、这老师什么鬼？！尽扯些与课程无关的东西。！都扯到文革了！！
11224,1738,洪樟连,2015-11-25 10:56:30,4,7,3,我觉得给分还不错……不过上课从来不讲纳米科技……
11227,1738,洪樟连,2015-11-25 11:52:32,9,11,2,几乎不讲纳米科技  不过讲了很多通识教育 有思想但是和课无关
11243,1738,洪樟连,2015-11-25 15:20:01,4,5,1,和纳米基本无关，思修课，但是水不水就不好说了，还是可以领悟到一些东西的
11309,1738,洪樟连,2015-11-26 15:00:32,1,7,6,反正不是绩杀，亲测5.0
11723,1738,洪樟连,2015-12-12 10:17:43,2,3,1,其实懂得挺多的，有想法，但是通识课没怎么真正讲课，没学到什么特别专业的东西，给分还可以，希望能改一改讲课方式
11993,1738,洪樟连,2015-12-21 12:44:05,2,3,1,赌脸。\n\n
11994,1738,洪樟连,2017-10-17 13:05:46,5,8,3,欧皇可以选，非洲人退散
12270,1738,洪樟连,2015-12-22 16:20:36,5,7,2,几乎不讲纳米科技  不停的说通识教育
13326,1738,洪樟连,2015-12-26 16:37:14,2,5,3,不管怎么说，反正是个好老师，分低的都是不去参与的人
13791,1738,洪樟连,2015-12-31 03:55:00,2,3,1,东扯西扯
16345,1738,洪樟连,2016-01-18 03:24:34,-5,1,6,特别好
17142,1738,洪樟连,2016-01-19 16:32:38,4,4,0,反正课跟纳米科技没啥关系.
17148,1738,洪樟连,2016-01-19 16:38:52,1,3,2,每节课要签到+_+喜欢讲通识到底是什么！！hh很可爱的老师，课上多发言绩点很厚道！！
18884,1738,洪樟连,2016-01-22 16:30:49,5,5,0,纳米科技小专家，呵呵了
21381,1738,洪樟连,2016-02-28 11:16:58,5,6,1,垃圾课程，适合上课睡觉水手机，帮人点到以及翘课自学。
22115,1738,洪樟连,2016-03-02 11:26:42,3,3,0,只是想了解纳米科技知识，能不能不要灌鸡汤啊啊啊ಥ_ಥ
22658,1738,洪樟连,2018-03-12 01:10:09,13,27,14,丫就一傻逼
23275,1738,洪樟连,2016-03-23 11:34:15,3,3,0,空洞乏味 自以为是 上他的课完全就是在浪费时间
23462,1738,洪樟连,2016-03-30 13:06:53,1,1,0,根本学不到任何东西，除了他口中所谓的人文情怀\n\n
23718,1738,洪樟连,2016-04-13 11:23:35,2,4,2,纳米知识小专家
24428,1738,洪樟连,2016-04-30 13:40:46,0,2,2,这门课基本学不到什么东西。上课比较水事还挺多，不过可以拿来刷成绩。作业交齐考试抱紧助教大腿上四应该不是问题。助教特，别，好！是这门课唯一的希望了……
24911,1738,洪樟连,2016-05-04 10:03:30,18,22,4,作业认真做，给分不会低的。（刚上他的课觉得不讲纳米科技整天扯通识教育很无聊，不过后来想想，就算他讲纳米科技，也不一定会听啊，所以也不用抱怨吧。就酱）
26193,1738,洪樟连,2016-06-16 08:02:23,1,1,0,老师虽然上课会讲一些奇怪的观点，每节课也有A4作业有点烦，但老师人很好，上课认真回答问题好好写作业，给分就会很好。
26502,1738,洪樟连,2016-06-19 09:17:09,1,1,0,水啊 特别水 实时教授如何制作ppt
30603,1738,洪樟连,2016-07-02 04:45:01,6,6,0,上了纳米科技导论，就知道了纳米尺度是啥，摆脱别这么弱智教我们做ppt！
32912,1738,洪樟连,2018-03-12 01:10:01,5,5,0,江湖神棍
33752,1738,洪樟连,2016-09-21 10:31:28,1,1,0,一脸懵逼
33763,1738,洪樟连,2016-09-21 11:35:03,-5,3,8,我是来听纳米技术的，你都讲了些什么乱七八糟的鬼玩意？要不是听说你给满绩，我背了包就走。
33765,1738,洪樟连,2016-09-21 11:41:15,2,3,1,江湖神棍！事儿确实多！
35341,1738,洪樟连,2016-11-22 03:54:01,7,8,1,上课极无聊但给分好
36359,1738,洪樟连,2016-11-22 02:35:00,-1,1,2,"虽然，作业真的很多\n\n虽然，老师真的上课很额(⊙o⊙)…O__O""…\n\n但是，老师给分真的不要太好，太感动了"
37831,1738,洪樟连,2016-11-21 09:51:03,3,4,1,每天讲讲通识教育什么的，基本和纳米科技无关，但是只要上课发言PRE准备的好，分会很高。本人文科生，期末考试按照文综答题办法，亲测满绩。
37833,1738,洪樟连,2016-11-21 09:58:21,-5,0,5,小组一片满绩。。。
37856,1738,洪樟连,2016-11-21 11:48:29,-2,2,4,给分可以 上的纳米科学技术概论 作为文科生 期末考按着他给的范围整理一遍提纲就差不多了 平时两次小组展示 对ppt要求比较高 然后八次作业 都交了就可以 不知道给差评的都什么心态啊ˊ_>ˋ 作为一门选修课本来不应该抱着学习纳米专业知识的心态来上的....
37878,1738,洪樟连,2016-11-21 13:24:55,-5,1,6,给分很好，大学第一次满绩了感动哭。但是老师上课不知道在讲什么，一直扯，想水的可以选
37894,1738,洪樟连,2016-11-22 00:37:30,1,3,2,作业都交了，任务也做了，考试也复习，给分这么低，上课就一直在说PPT，傻逼老师傻逼课，大家不要选
37899,1738,洪樟连,2017-03-01 11:33:38,1,1,0,鸡汤老师
37963,1738,洪樟连,2016-11-22 10:00:43,3,3,0,他会和你讲怎么教老外用筷子，会教你怎么做PPT。讲课没怎么听过，因为第一节课就发现他是个大水逼。这课只要你不漏交作业，期末考试带的资料齐的话，不会挂科。
37986,1738,洪樟连,2016-11-22 16:47:01,0,1,1,给分好！
38618,1738,洪樟连,2016-12-12 12:47:54,1,2,1,巨无聊，讲通识教育，讲ppt怎么做，讲怎么查资料，就讲一点纳米技术，然后被狂灌鸡汤。
38981,1738,洪樟连,2016-12-20 07:17:35,2,3,1,每堂课都要签到，每次课都有作业。\n\n没论文，有考试。\n\n不会做ppt的同学可以选一选/滑稽\n\n给分看人品 反正我水上4了
46685,1738,洪樟连,2019-01-04 12:07:31,7,9,2,看似是纳米技术课 其实是通识教育分析课 看似是通识教育分析课 其实是ppt制作分析课 看似是ppt制作分析课 其实是鸡蛋里挑骨头技巧课 你问课存在的意义？ 刷分不能停
55436,1738,洪樟连,2017-07-01 13:17:28,2,2,0,乱七八糟   \n\n乱七八遭\n\n乱七八唣
58961,1738,洪樟连,2017-09-19 01:18:05,0,0,0,不要…
59253,1738,洪樟连,2017-09-20 11:15:55,1,1,0,无语 这是纳米吗\n\n
59258,1738,洪樟连,2017-09-20 11:32:02,1,2,1,怎么说呢，先被洗脑通识教育是干什么讲述。学纳米级材料知识？呵呵呵→_→的。接着来人生观价值观的
59294,1738,洪樟连,2018-03-12 01:10:42,3,4,1,垃圾老师，只会瞎扯，浪费时间\n\n还说的多少伟大，简直吃屎
59317,1738,洪樟连,2017-09-21 00:41:22,-2,0,2,很想有情怀的老师\n\n但是说实话\n\n要讲什么是通识教育\n\n通识课的来历的话\n\n张凯老师的大学与现代中国更有深度和广度\n\n来自听完第一次课的第一节就退课的人
59435,1738,洪樟连,2017-09-21 10:22:48,0,1,1,书本内容讲得少但上课内容思想都挺好的，作业的话比较重视自学能力
59832,1738,洪樟连,2017-09-27 10:32:21,0,1,1,每堂都要写听课记录表 像小学生上课
60148,1738,洪樟连,2017-10-11 11:10:01,-1,2,3,强烈建议不要选
60243,1738,洪樟连,2017-10-15 12:17:18,1,1,0,对专业研究很深，但是上课很少不沾边。让讲纳米科技，他讲通识，指出来后也直接告诉学生，这节课不是教你纳米科技的，想学纳米科技的出门右转不谢。
60381,1738,洪樟连,2017-10-18 12:51:00,-2,0,2,思想深刻
62093,1738,洪樟连,2017-11-22 11:17:52,3,3,0,上课一直在吹牛逼，根本不讲和纳米相关的内容。
62117,1738,洪樟连,2017-11-29 23:35:50,2,2,0,仁者见仁智者见智吧。老师自己也说他的课对大多数人不适合。
62121,1738,洪樟连,2017-11-22 12:20:42,2,2,0,烦死人了
62456,1738,洪樟连,2017-11-25 10:01:14,-1,0,1,如果上课自已不动脑子，光想听老师讲纳米科技知识，喜欢被老师填鸭的，这课立马可以走人了，，，
62529,1738,洪樟连,2017-11-26 00:11:50,0,2,2,居然满绩了。。。。\n\n
62569,1738,洪樟连,2017-11-26 03:21:46,-6,0,6,真的给老师打call\n\n就给分超级好的\n\n那些说不讲纳米科技的\n\n讲了你们也不一定听啊\n\n通识讲那么高深的东西文科生也真的无能为力啊\n\n而且感觉老师还是挺贯穿纳米的基础知识的啊
62618,1738,洪樟连,2017-11-26 07:46:04,1,1,0,凉凉夜色为你思念成河…
63037,1738,洪樟连,2018-01-30 16:22:44,3,3,0,这个老师真是无语，灌鸡汤用力过猛
63058,1738,洪樟连,2018-01-30 16:22:52,0,2,2,太垃圾
63252,1738,洪樟连,2017-11-29 13:05:53,6,6,0,标题党不过如此！打着纳米科技的标题扯一堆这的那的，不去uc工作可惜了！好心劝各位一句慎选！
63543,1738,洪樟连,2017-12-06 10:45:41,1,2,1,看似是纳米技术课 其实是通识教育分析课 看似是通识教育分析课 其实是ppt制作分析课 看似是ppt制作分析课 其实是鸡蛋里挑骨头技巧课
63549,1738,洪樟连,2017-12-06 12:20:00,1,2,1,感觉还好
64897,1738,洪樟连,2017-12-28 01:22:12,-1,2,3,洪老师的课虽然水，但是上课轻松作业不多，关键是给分高啊。。千万不要被查老师中极端的评论所吓到诶。。有思想的好老师！！
65028,1738,洪樟连,2017-12-28 08:52:53,-1,1,2,老师讲得很好造诣很深 但是还是忍不住吐槽 鸡汤说一遍就差不多啦ppt讲一遍就差不多啦 可不可以专注地讲一些纳米知识啊 ppt技术课果然名副其实
65449,1738,洪樟连,2018-01-04 04:05:35,5,13,8,确实上洪老师的课没学到太多专业知识，不过老师在第一节课就已经说过，上通识课绝不应是记忆性学习。老师是一直秉持着授人以鱼不如授人以渔来教学的，会提供好多新思想、高质量的学习资料，还让大家学着自己去检索知识。一些同学说老师“胡扯”、“吹牛”等，我觉得可能是没有进入老师的思想，作为东京大学博士，老师肯定有一肚子的知识，只不过老师认为本科生的通识课应该是一种培养学生素养的课。认真听老师讲的确会收获很多在其他通识课里学不来的东西，这些东西对未来的学习、工作会有很大帮助。\n\n   总之，个人感觉洪老师的这门课值得所有本科生一上。但也期待老师讲课更幽默一些~~~
65451,1738,洪樟连,2018-01-04 04:36:44,3,8,5,上大学的第一门通识课，做个稍微详细一些的评价。首先，老师挺好的，下课解答问题很有耐心，有时还会不怕麻烦地给学生发一些资料学习，很负责，上课讲得有逻辑性，也注意提问交流，唯一的不足可能是纳米科技实在是有点难讲，我好多都没听懂，总的来说我觉得给老师打8，9分至少还是可以的。至于好多同学吐槽的上课，确实洪老师不是都在讲纳米科技，还讲了很多PPT，做学问的态度，学生应该掌握的知识等等方面，但我觉得也很有用啊（最主要也很好玩），就像老师自己说的，只想学纳米或者水课别选这门课。老师他自身希望不仅授业，而且传道，就这样，个人挺推荐这门课的。
65454,1738,洪樟连,2018-01-04 04:47:48,0,6,6,首先老师无论是备课还是上课态度都很认真，是真的想教给我们东西。作业也不难，课上认真听，课后作业ppt上基本都能找到。上课讲一些ppt的内容其实对我们以后也是很有好处的，而且老师很注重科学研究素养培养，不只是局限于课本知识，还有很多做人的道理。同学们不要光想着水课啊，能学到很多不只是纳米技术的东西。其次，如果你们觉得上的不是自己想学的东西，可以退课，而且老师三节课也只留了最后一节课讲他的“闲聊”，不想听的可以早点走，还把他的宝贵资料分享给大家。\n\n虽然可能老师理科出身不像别的老师那样会讲，但是平心而论，能够遇上这样资历老，真心付出的老师真的很好。
65460,1738,洪樟连,2018-01-04 05:56:53,1,4,3,老师讲的很好很负责，这毕竟是一门通识课，所以专业知识不会涉及太多，老师更多地教给我们如何获取、整理信息，以及如何做好ppt展示。看起来感觉都是小事但是非常重要，对于我们以后的学业、科研会有比较大的帮助。
65913,1738,洪樟连,2018-01-30 16:22:06,10,10,0,垃圾老师，坑的一批，上课瞎bb，教你做PPT，跟纳米一点关系都没有，每天扯思维，美国培养方案2.0。“你们思维都不行，像我这样的做一件事成一件。”
66069,1738,洪樟连,2018-03-12 01:10:16,4,4,0,大水逼
68251,1738,洪樟连,2018-01-30 16:22:00,8,8,0,想学东西我就哈哈哈了\n\n这位牛逼的老师听你说得头头是道，就没见你做出了什么牛逼的东西\n\n还二流学者，去搬砖吧，砖家
73513,1738,洪樟连,2018-02-02 00:51:00,0,2,2,说实话，老师很有想法。但是似乎没有考虑过自己是否把思想表达到位，学生是否能接受这样的方式。如果说选这门课的理由，那只有一个，，，给分好啊！
73524,1738,洪樟连,2018-02-02 01:38:23,-1,2,3,其实你只要平时作业真的有认真写，考试自然就会（因为有很多原题），高绩点自然不是梦想。再者，洪老师虽然讲课是有点无聊（尴尬），但认真听其实是有收获的！关键在于你自己。
73529,1738,洪樟连,2018-02-02 01:46:21,0,3,3,给分真的好啊！平时事情很多，上课有点无聊，但其实老师是个很有想法的老师，最后感谢老师救了把我的均绩！
75139,1738,洪樟连,2018-03-07 15:11:10,0,0,0,通识课教育
76557,1738,洪樟连,2018-04-14 08:15:43,1,1,0,自以为是
78626,1738,洪樟连,2018-05-14 03:14:31,0,0,0,…………
81453,1738,洪樟连,2018-07-05 06:20:59,0,0,0,你还要我怎样？？要怎样？？
87220,1738,洪樟连,2018-09-26 01:24:36,0,2,2,学到了很多PPT制作技巧和注意事项，这在以后有很大的帮助。虽然课程本身和课程名没有什么内容上的太大关联，但是老师很多想法都十分有前瞻性，认真听课总能收获到许多东西。毕竟老师如果真的讲纳米也不一定听得懂什么。
87274,1738,洪樟连,2018-09-26 11:54:32,1,1,0,垃圾\n\n明明叫纳米科技概论 讲的都是乱七八糟的东西，和纳米完全无关\n\n作业多事情多，给分一般
87556,1738,洪樟连,2018-10-05 08:18:11,3,3,0,讲的什么鬼东西
87905,1738,洪樟连,2018-10-17 11:21:21,1,1,0,惹不起惹不起，随便讲讲随便听听咯
89992,1738,洪樟连,2018-11-21 13:07:50,0,1,1,我觉得老师上得挺好的呀，完全是理想中科学研究类通识课的样子，谈谈人生看看小视频了解了解纳米技术
107994,1738,洪樟连,2019-05-12 17:11:06,-4,0,4,名是每节课必点的，脑子是每节课都可以不带的。PPT展示准备也是可以不用太emm就是没有鹅颈吧。\n\n课程结构一般展示+讲课+教育+视频。\n\n一开始我都怀疑老师是不是入错门了，应该去当教育家，印象很深，毕竟大学生了，很少有老师能在课上跟你讲对你以后自身发展有用的一些话。\n\n（作为一位倾向于搞研究方向的理科生，觉得学到了很多，他确实展示的时候在dissPPT制作，但是教的方向还是偏向于学术报告形式的。也教大家如何使用学校的学术资源，学到挺多的）\n\n（就讲课的内容，认真学真的能学到挺多，但是我建议得有一定的学科背景，我就感觉上课有种变相在复习另一门专业课...作为理科类学生的拓展还是很有意思的。但是讲的内容实在多，没什么背景的话，估计就傻眼了，会觉得学不深，学不到什么东西。课程安排还是很充实的）\n\n老师人挺好的，就是那种安安静静的搞科研，想把自己学到的，人生中体会到的交给大家。
180728,1738,洪樟连,2023-09-25 11:23:31,0,0,0,一眼顶针，看不到学术水平，不懂装懂，适合去搞文科，好好做ppt。
52390,1852,刘芙,2017-06-19 12:25:26,1,3,2,巨事儿逼...
128545,1852,刘芙,2020-12-23 17:19:19,13,17,4,请问企业实习是不打算出分了吗
139489,1852,刘芙,2021-07-16 12:02:23,-3,1,4,呵呵。。
175673,1852,刘芙,2023-06-26 10:14:10,9,10,1,sb。
185848,1852,刘芙,2024-01-05 02:08:19,0,4,4,纯纯出生
185849,1852,刘芙,2024-01-05 02:13:03,1,4,3,b事一堆，还不负责，出问题了就装死不回
188713,1852,刘芙,2024-01-19 16:07:44,0,4,4,没话说嗷
214409,1852,刘芙,2025-02-02 15:00:50,0,0,0,555
49993,2031,陈湘明,2017-04-28 08:06:10,0,1,1,很和善的老师，难得的诗人，讲课十分细致，仔细听收获颇丰。
126618,2031,陈湘明,2020-11-03 08:37:39,1,1,0,老教授，扯，就硬扯，扯错了自己也意识不到（汗）
141691,2031,陈湘明,2021-10-20 08:47:20,1,1,0,不下课？读ppt？
173668,2031,陈湘明,2023-05-31 12:12:48,2,3,1,上课不点名，课堂作业也就一次，不会做的作业题可以到老师博客上去找，O(∩_∩)O哈哈~，期末开卷考，可以去98找，但是期末给分好像不高，全写出来了，最后只有4.2，也可能是太菜了，很烦
183350,2031,陈湘明,2023-11-24 04:24:15,1,1,0,上课云里雾里，给分还行( っ'-')╮ =͟͟͞͞🏀
205416,2031,陈湘明,2024-12-06 04:18:24,0,0,0,上课很无趣，压根不管学生听没听懂，自顾自讲
51141,2155,皮孝东,2017-05-18 11:47:47,-5,0,5,老师超级可爱，材尿的尿……
85025,2155,皮孝东,2018-07-15 04:43:34,-1,2,3,上课摸鱼，给分贼差。
85026,2155,皮孝东,2018-07-15 04:44:06,5,7,2,ppt，出卷子，改卷子都是别人做的，不知道他为什么这么忙？
86919,2155,皮孝东,2018-09-19 11:30:17,-1,2,3,不想讲了让学生讲呗
123129,2155,皮孝东,2020-05-11 09:22:01,7,11,4,一定要滚瓜烂熟，滚瓜烂熟……
123194,2155,皮孝东,2020-05-19 00:26:25,7,12,5,材科基习题也太多了呜呜呜
128363,2155,皮孝东,2020-12-21 08:56:08,18,25,7,皮孝东，彭新生，材科基双子星
128364,2155,皮孝东,2020-12-21 08:55:59,1,4,3,语速起伏极大，有些材科基内容“准备不充分”，称与我们“共同学习”，要求自己看文献解惑
128963,2155,皮孝东,2020-12-27 12:32:04,0,4,4,呵呵！
129008,2155,皮孝东,2020-12-28 08:49:39,14,18,4,东子哥的🐴危险了
129476,2155,皮孝东,2021-01-06 03:33:50,-3,1,4,呵呵呵
135272,2155,皮孝东,2021-05-07 09:48:54,6,8,2,"论阿皮是如何把只有三十分钟内容的一堂半导体材料课上到九十分钟的，只要复读每句话就行了，三回啊三回。\n\n""一定要滚瓜烂熟啊，滚瓜烂熟啊，嗯滚瓜烂熟。"""
179292,2155,皮孝东,2023-09-07 13:24:42,-3,1,4,纯纯的傻篮子
18703,2231,韩高荣,2016-01-22 11:11:33,1,3,2,有点意思哦！！
27624,2231,韩高荣,2016-06-27 05:32:10,-1,2,3,涉及领域非常广
43517,2231,韩高荣,2017-01-16 12:08:28,2,5,3,新晚的奖品太少了，我再赞助十台！
45192,2231,韩高荣,2017-04-04 12:43:06,8,17,9,被随意正态
45209,2231,韩高荣,2017-11-19 14:43:49,-13,10,23,是材料学院的院长。上课学不到什么东西，但一场展示还是能够锻炼自己的能力。不考试，事情少，给分也不错。
45224,2231,韩高荣,2017-01-19 07:38:37,0,6,6,好老师，作业少，给分也好，强推。。。
45332,2231,韩高荣,2017-01-19 11:09:40,-2,6,8,挺好的。。查老师的均绩怕是不准
69741,2231,韩高荣,2018-01-25 09:59:25,3,5,2,课堂氛围轻松愉快，讲的东西却很多很有趣，平时事情不多，期末给分又好
69838,2231,韩高荣,2018-01-25 13:28:01,-2,3,5,让大家去学材料……
69880,2231,韩高荣,2018-01-25 15:18:46,1,4,3,被正态
70038,2231,韩高荣,2018-01-26 04:45:05,0,2,2,给分超好
71318,2231,韩高荣,2018-01-28 09:32:56,0,3,3,老师的课以学生为主，气氛很轻松～
123769,2231,韩高荣,2020-06-14 03:39:45,1,2,1,一言难尽\n\n
129604,2231,韩高荣,2021-01-08 10:57:27,-1,3,4,蛮轻松的，一次展示，然后论文正式，格式要求不少，但是可以接受
182801,2231,韩高荣,2023-11-20 09:35:38,-17,0,17,就该评不上yuanshi
209316,2231,韩高荣,2025-01-05 11:47:22,3,6,3,上的是老师的新材料与现代科技，纸质签到单点名（我是24冬学期的，总共签到了4次，但是貌似可以签完到直接走orz），考核方式是点名+一次展示+上交展示ppt和论文，无期末考试，前三节课老师讲课，后面是所有人从四个主题（信息材料，能源材料，工程材料和生物材料）中选一个进行展示；\n\n①点名：纸质签到单点名，但是我感觉就算前面有一次没签上后面上课在纸上签貌似也可以（bushi），可以签到完直接走；值得注意的是上课是韩老师和任老师轮流上，韩老师有时候会点人起来提问，所以保险起见他上课的时候还是不要翘课（）；还有第一次课会让所有人站起来自我介绍所以不能翘课！！！\n\n②展示：会在大概第二次课的时候让大家开始选主题，我当时选的是信息材料然后讲了一个和半导体相关的，个人感觉是老师比较看重学术性（因为下面反正没什么同学听，所以从功利角度来说让老师听着觉得你很厉害就行0.0），同时ppt不要放太多文字，可以放一些框图or表格or流程图之类的，然后以讲为主；\n\n③论文：格式要求比较多，我用的是98上吕强老师的军理论文模版，应该是不查重的，因为我用了很多gpt（bushi）；\n\n整体来讲作为一个通识课还是可以的，只要自己展示结束了就可以着手开始写论文，写完论文就没事了，上课可以点完名直接走也可以找别人帮忙签到，不翘课的话也可以课上自习老师也不会管，作为一门水课没什么槽点，最后92/4.8，仅供参考
48533,2300,肖学章,2017-03-07 01:21:45,4,4,0,呵呵呵
50661,2300,肖学章,2017-05-04 06:09:58,1,2,1,最次的，
50674,2300,肖学章,2017-05-04 07:00:36,3,4,1,给分贼迷，材料化学拖很久，最后出的很奇怪。
122995,2300,肖学章,2020-04-28 10:00:34,2,4,2,课件和讲的都不大行
123102,2300,肖学章,2020-05-09 18:32:07,4,5,1,材化感觉非常不好TAT
126561,2300,肖学章,2020-10-01 07:18:00,13,15,2,材化出分贼慢！给分很不好！已经这么低了还卡我绩有意思吗？！
137798,2300,肖学章,2021-07-06 07:27:10,10,13,3,储氢给分实在太好了
171106,2300,肖学章,2023-03-16 04:19:46,0,1,1,ㄟ( ▔， ▔ )ㄏ
172790,2300,肖学章,2023-05-07 06:52:20,3,4,1,( *・ω・)✄╰ひ╯
175140,2300,肖学章,2023-06-22 01:24:11,3,4,1,肖老师虽然上课比较严厉会让大家好好听，有时候还会点名，但是其实是讲的很好很认真的一位老师
131975,2367,姜银珠,2021-01-29 19:21:13,1,2,1,老师课讲得很清楚明白，课件也会及时发给同学。但在和同学沟通以及答疑方面表现得很敷衍……
134931,2367,姜银珠,2021-04-23 03:24:14,2,2,0,传输原理\n\n课觉得还讲得蛮有趣，虽然不点名，不过选的人很少所以也没必要了。我自己本身不太行，所以上课听着有点吃力，老师讲的例题一道都做不出。不过考试题不难，允许翻书也有小测原题，考前还会专门讲讲小测题。现在已经没有98上讲得那么恐怖了\n\n上面讲得答疑敷衍是真的，经常就“回去想想，以后再说”，然后不了了之
140326,2367,姜银珠,2021-09-09 02:44:57,2,2,0,表面化学呵呵哒
1834,2378,凌国平,2015-03-26 01:28:42,14,17,3,超级有水平的一个老师，人也很帅
43415,2378,凌国平,2017-01-16 08:44:15,3,7,4,老师很好
43510,2378,凌国平,2017-01-16 11:49:33,5,9,4,综合实习和毕设在凌老师的课题组。凌老师真的是一位良师，循循善诱，会引导你去自己思考。你要是不积极他也不会管你，但你要是积极跟他交流探讨，他一定会抽出时间跟你聊。
43511,2378,凌国平,2017-01-16 11:49:48,5,9,4,感觉老师有一种淡定从容的态度，印象中总是笑眯眯的
47389,2378,凌国平,2017-01-26 00:42:31,1,5,4,有人可能会觉得老师上课闲扯的很多，但是他是真的很注重启发学生的思维，而且很容易激发学生的兴趣，人很好呀。
47495,2378,凌国平,2017-01-28 06:46:15,3,7,4,听了很有收获，相对于另一个性能而言
76411,2378,凌国平,2018-04-08 07:33:20,2,4,2,凌老师上课十分有趣，循循善诱，上他的课从不无聊，也不翘课，这是我那个学期学的最认真的一门课了！
84852,2378,凌国平,2018-07-14 05:16:46,-2,3,5,满了满了
87372,2378,凌国平,2018-09-27 16:45:52,-2,1,3,很棒哦
88336,2378,凌国平,2018-10-29 02:11:05,0,2,2,讲课逻辑很清晰，人很好
126251,2378,凌国平,2020-09-21 02:30:44,-5,0,5,老师是挺循循善诱的，但是感觉讲课内容有点零散，系统性还差一点
129246,2378,凌国平,2021-01-02 08:59:12,1,3,2,用4倍速回放依然能分辨出老师在讲什么😂
132423,2378,凌国平,2021-02-01 12:27:09,11,15,4,性能2讲课可以 给分并不好
134043,2378,凌国平,2021-03-14 06:00:41,10,14,4,粉笔杀手凌国平老师[ac01]
141895,2378,凌国平,2021-10-30 12:31:37,-1,2,3,凌老师的教学算是我最理想的学习模式了。凡事都问一个为什么，从事物的本质考虑，这是我在学习初期就给自己定下的目标，但由于时间不够，也未能实现，唯有在凌老师的课堂上能够感受到和我的目标非常相似的思考问题的模式。
165448,2378,凌国平,2023-01-06 02:06:13,-4,0,4,还好啊
192780,2378,凌国平,2024-05-30 10:18:38,-4,0,4,真滴好
127691,2430,潘新花,2020-11-26 00:43:19,5,7,2,这老师有毒吧，上课40分钟全是学生在讲，其中30分钟没人说话，教室安静。虽然槽点满满，但是这个课只有这老师，自求多福吧
130049,2430,潘新花,2021-01-16 02:27:55,0,7,7,真空需要哪些条件？影响真空度的因素？\n\n然后她自己又回答不出来，等学生回答。同学回答完，她说，这个同学基本上答对了。再问她，她说答案就是刚才这位同学回答的。自己硬是不给回答……
47279,2433,朱铁军,2017-01-25 04:53:40,4,6,2,老师很好，大家要认真听课，语速略快，激动起来拦不住（好吧，听课和讲课的都激动）
47449,2433,朱铁军,2017-01-26 13:59:57,-2,4,6,第一年开材料物理的课，三个老师，朱老师讲电导和热导。有ppt，讲得细，很清楚，老师人挺好。另：格波（be二声）
64211,2433,朱铁军,2017-12-21 14:06:54,-1,2,3,老师讲课思路蛮清楚的，有的时候会提前下课，不过语速非常快hhh
73548,2433,朱铁军,2018-02-02 03:03:24,0,2,2,朱老师讲材物，讲得内容多但每次都能提前一点下课，很赞！上他的课最好有比较好的物理基础。
76604,2433,朱铁军,2018-04-16 06:34:47,3,7,4,材料物理三个老师里面他讲的内容最多，但是讲的很清楚，重点会反复强调。语速很快，偶尔会讲讲物理大牛们的故事，经常提前下课，口音萌点很多。总之很棒。
78245,2433,朱铁军,2018-05-10 07:10:51,1,3,2,老师hin好，讲课很清楚，而且会提前下课哈哈
93690,2433,朱铁军,2019-01-11 16:35:02,13,18,5,材料物理三个老师中讲的最好的了，很细致，重点突出，讲课有条理，而且比较有意思，不会无聊到玩手机。感觉是大二上专业课讲的最好的老师。
119712,2433,朱铁军,2019-11-15 03:10:23,-6,0,6,讲的不错，但是非常自嗨，不想理他。\n\n好好听课\n\n
121333,2433,朱铁军,2019-12-19 10:27:41,8,13,5,三个老师中唯一一个讲的好的，而且是特别好的那种
151308,2433,朱铁军,2022-02-28 08:05:08,-1,2,3,铁军哥yyds
165657,2433,朱铁军,2023-01-09 06:44:57,4,9,5,朱院真实在人，给你看原题他真的不改，考试题基本都是历年题，他真的为了捞我们太努力了，我哭死。上课也很好，大二上三门专业课声音最洪亮最清晰的，知识点不多讲的很细致，题目全部来自ppt，很不错的老师！！
168319,2433,朱铁军,2023-02-11 05:01:47,-2,3,5,赞赞赞
208635,2433,朱铁军,2024-12-30 09:09:30,1,3,2,铁军哥，我期末复习周听了你好久的智云，保佑我拿个好成绩好吗，求求了
211101,2433,朱铁军,2025-01-15 06:55:17,-6,0,6,考的是上课讲过但PPT上没有的内容，让我考试的时候绞尽脑汁想他讲了什么来着
212268,2433,朱铁军,2025-01-13 15:39:10,8,10,2,先打10分，求满绩
213765,2433,朱铁军,2025-01-19 14:36:00,2,5,3,不愧是院长，上课也是有两把刷子的，通俗易懂
214421,2433,朱铁军,2025-02-02 15:00:45,0,0,0,555
126330,2449,何海平,2020-09-23 01:10:24,7,7,0,何老师喜欢写写诗，下下围棋，是材料学院里难得的有趣老师。
152651,2449,何海平,2022-04-17 12:00:14,1,1,0,何老师人挺好的，但是半导体发光讲的挺难的，上课听不懂，作业也巨难呜呜呜，等出分再来反馈一下
153166,2449,何海平,2022-04-26 10:30:52,3,3,0,发光材料给我选！\n\n知识点讲得差不多都齐了\n\n而且上课速度也不算快
153340,2449,何海平,2022-04-28 08:34:58,2,2,0,上课不怎么点名，但是不怎么听得懂，作业巨难，东西都认认真真写了最后居然只给我3.6？？？好失望
172611,2449,何海平,2023-05-02 05:23:23,0,0,0,感觉挺好的，事少(四道作业题加一篇课程论文)，给分还不错，建议选
25535,2466,曹高劭,2016-06-13 00:28:52,-12,4,16,很不怎么样
33056,2466,曹高劭,2016-09-11 10:20:01,6,7,1,上课认真，平时随和
70301,2466,曹高劭,2018-01-26 11:49:57,-2,2,4,(●'◡'●)ﾉ❤
128228,2466,曹高劭,2020-12-17 05:25:38,2,5,3,老师人很不错，但讲课一般，说实话
128930,2466,曹高劭,2020-12-27 05:23:48,-1,2,3,个人评价是曹高劭老师比较理解学生。\n\n作业会留几次，期末前交上去都可以，布置作业的目的是老师希望大家课后能及时跟进复习；我们这学期还没结课，平时不点名，不过有一次课堂小练（只有一道题，题目是应用二分法求一个无理数）。\n\n老师的课像他自己说的那样，他上课不会讲太深，不讲太多的公式也不考大家记忆公式的能力，每次课适当花几分钟时间回顾前一节课的内容，讲的比较有条理，课下再看看课件对照课本复习一下，知识基本能掌握。\n\n《数值分析与应用统计》（好像是叫这个）这门课本身学下来对我们实际处理实验数据也有一些帮助，虽然还没考试，但感觉学这门课没有浪费学分，最起码不亏。
132248,2466,曹高劭,2021-01-31 09:02:48,-2,1,3,课程难度不大，给分好，为人随和好相处。
142411,2466,曹高劭,2021-11-11 06:15:19,5,8,3,老公好帅！想和老公困觉！
166391,2466,曹高劭,2023-01-12 06:54:37,0,3,3,100分🈵️啦！！！课程不难，可以学到一些数据处理的方法！！！
186385,2466,曹高劭,2024-01-16 12:44:30,-4,0,4,老师讲课其实一般，主要是这课本身就比较水。但是老师人很好，最后给分也好
188571,2466,曹高劭,2024-01-19 09:21:35,-4,0,4,啊啊啊，老曹我爱你
8086,2518,王智宇,2015-09-17 02:48:15,12,15,3,面瘫萌
8089,2518,王智宇,2015-09-17 02:56:00,20,20,0,儒雅工科男
8095,2518,王智宇,2015-09-17 03:31:24,2,6,4,奇怪的萌点
42786,2518,王智宇,2017-01-15 05:28:10,9,9,0,老师很好
43217,2518,王智宇,2017-01-16 03:48:56,14,16,2,材料学院最帅的老师
43262,2518,王智宇,2017-03-07 14:49:05,4,7,3,很有气质的一位男老师
43392,2518,王智宇,2017-01-16 08:11:06,6,8,2,智宇男神！
47494,2518,王智宇,2017-01-28 06:44:56,9,10,1,听老师的课是一种享受，尤其最后一节
51461,2518,王智宇,2017-06-06 02:32:23,19,19,0,喝可乐的帅气大叔\n\n
80538,2518,王智宇,2018-06-27 14:20:29,9,10,1,老师很帅啊，人也很好，会跟同学一起聊天，PPT是真的多！！
83602,2518,王智宇,2018-07-10 20:46:49,3,5,2,特别有意思。讲的是真的好，而且很亲民。
110320,2518,王智宇,2019-06-25 15:26:18,2,4,2,表征背不下去辽
126775,2518,王智宇,2020-10-20 01:21:20,5,7,2,除了爱拖课，没有其他缺点。讲课自带体系，非常不错
127532,2518,王智宇,2020-11-24 05:02:54,4,6,2,给分好差（其实是我太菜）
141610,2518,王智宇,2021-10-17 10:08:23,-4,0,4,真是个行为严谨的好老师呀
142254,2518,王智宇,2021-11-09 10:47:24,1,3,2,很有趣
156622,2518,王智宇,2022-06-20 12:09:34,0,3,3,一伯混
169405,2518,王智宇,2023-02-26 03:35:04,6,7,1,智宇哥是靠喝可乐保养得那么好的嘛
169406,2518,王智宇,2023-02-26 03:35:04,4,6,2,智宇哥是靠喝可乐保养得那么好的嘛
176719,2518,王智宇,2023-06-30 00:49:52,1,4,3,材料标准，2023-6-30 ，学不动了
181488,2518,王智宇,2023-10-19 04:47:59,9,12,3,百事给你多少钱，我可口给你双倍
182146,2518,王智宇,2023-11-10 15:00:53,-4,1,5,老师真的很好，也捞
182245,2518,王智宇,2023-11-13 08:00:35,-1,2,3,111老师真捞吗
194629,2518,王智宇,2024-06-24 16:56:33,2,5,3,长得很帅 材料院草
218809,2518,王智宇,2025-05-06 10:57:03,1,1,0,以为很严肃，实际上很慈祥随和，而且下课会跟学生聊天，点名也只是走个形式（不会计入评分），很好很帅（而且很喜欢百事可乐）的老师！\n\nps：作业是真多，做好心理准备（但基本都是PPT上的内容）
221940,2518,王智宇,2025-06-27 14:44:34,0,0,0,感谢智宇哥，给我捞满了
48470,2529,程逵,2017-03-06 00:21:35,3,3,0,水水水
80537,2529,程逵,2018-06-27 14:19:10,-1,1,2,老师挺好的，不过上课的内容感觉讲的不是很清楚？
125076,2529,程逵,2020-08-28 02:55:40,3,4,1,讲课还行，不过ppt好多错别字和语病，复习起来有点困扰
221945,2529,程逵,2025-06-27 14:52:27,0,0,0,课件能不能上点心，有些地方读都读不通，别说理解了。。。
42475,2555,钱国栋,2017-01-14 09:19:43,13,18,5,上课点名是统一开卷小测 很有意思的生活问题 老师性格也很开朗 在材料学院算是比较好的课程和老师了
51462,2555,钱国栋,2017-06-06 02:37:19,3,6,3,美滋滋
124807,2596,张启龙,2020-07-10 06:56:59,0,4,4,不想多做评价
127219,2596,张启龙,2020-11-15 06:31:20,4,13,9,老师您自己来背一下复习题试试？tm考前复习快吐了
182797,2596,张启龙,2023-11-20 09:34:08,0,2,2,不好评价
33098,2601,谷长栋,2016-09-12 17:05:05,3,4,1,认识实习用等级制有点坑啊
54484,2601,谷长栋,2017-06-29 11:18:48,2,2,0,上课比较无聊
58004,2601,谷长栋,2019-07-06 00:59:42,5,6,1,实验安全教育，听得人想死
85442,2601,谷长栋,2018-07-18 02:13:45,1,3,2,老师人不错的，大热天的连续讲了好几天，老师讲着一定很累，但安全教育很重要
89920,2601,谷长栋,2018-11-21 09:12:24,2,2,0,金属与合金讲课挺好的，但最后给分真的很迷，大作业给分低是因为排版不好？这种论文形式的还能排版能什么样？
90044,2601,谷长栋,2018-11-22 02:19:35,-1,1,2,建议学院调查一下这个老师期末论文成绩的评分标准
158145,2601,谷长栋,2022-06-27 07:27:37,2,3,1,如果是高中我会觉得他的课很有趣
158432,2601,谷长栋,2022-06-29 08:23:12,-1,1,2,。。。
160677,2601,谷长栋,2022-09-30 04:50:23,-1,0,1,平衡。
178906,2601,谷长栋,2023-07-30 08:22:01,0,1,1,实验安全教育，是个人都能满绩
197037,2601,谷长栋,2024-07-07 01:02:06,-1,0,1,能不能看一下钉钉消息我请问呢
199174,2601,谷长栋,2024-09-18 15:33:02,0,0,0,实验安全教育 给分好
135865,2629,杨雨,2021-05-30 16:53:48,3,6,3,老师给分超好 上课会叫我们翻译英文论文的摘要 最后的展示和论文要求也不高
153341,2629,杨雨,2022-04-28 08:37:29,-3,1,4,新型功能玻璃直接吹爆，轻轻松松满绩，快选！
172308,2629,杨雨,2023-04-25 00:10:43,2,3,1,很尊重我们，循循善诱的师长
173343,2629,杨雨,2023-05-20 08:36:44,-1,2,3,挺好的一个老师，上课从不点名，随便翻译几次就拿满平时分了，一个展示一个论文，期末成绩出差错还给我们申请改回来，简直不要太棒
191949,2629,杨雨,2024-05-06 05:43:06,-1,1,2,课程轻松，工作不多，课程里的英语概要翻译让我们受益匪浅，并且给分超棒，强烈推荐！
192180,2629,杨雨,2024-05-11 02:44:58,-1,1,2,神中神
202211,2629,杨雨,2024-11-10 21:22:01,-3,0,3,课程内容难度不高，甚至可以作为跨专业课程，上课的口译和文献摘要阅读很有意义，老师好有耐心地帮忙修改ppt和大论文，完美10分
182684,2678,高明霞,2023-11-19 12:49:19,12,12,0,无语死了
183605,2678,高明霞,2023-11-28 00:52:53,5,6,1,一点都不捞人，太无语了
183607,2678,高明霞,2023-11-28 08:21:20,4,5,1,。。。
183628,2678,高明霞,2023-11-28 06:29:46,2,5,3,老师真的很认真，奈何这门课对外专业的学生确实不是很友好QAQ
183741,2678,高明霞,2023-11-29 12:00:13,2,3,1,缺国际化的同学还是看看其他课吧
202269,2678,高明霞,2024-11-11 06:19:17,0,0,0,补药选这门国际化，材料的学生不要觉得自己学过物化基就敢选，很不一样
202322,2678,高明霞,2024-11-11 14:53:53,1,1,0,跨专业者另寻它课，国际化分勿入斯门。材热大舞台，想寄你就来。
129837,2688,刘永锋,2021-01-12 21:45:05,2,18,16,随意更改成绩评定方式，举手表决考试15-13论文，最后为了满足某位同学公忠坚毅的理想，在近一半人反对，三分之一人没举手的情况下把教育大纲里的论文改成考试，很棒。头铁你可以选。另外，讲课话都说不清，看书自学才能有好成绩哦
130693,2688,刘永锋,2021-01-24 08:42:57,16,28,12,电化学给分超好
157442,2688,刘永锋,2022-06-23 08:44:45,0,6,6,人真的一般，给分确实不错，但是除了分数，确实什么都收获不到
215989,2688,刘永锋,2025-03-09 02:53:58,23,25,2,刘老师一路走好🙏🏻🙏🏻🙏🏻
215992,2688,刘永锋,2025-03-09 04:51:26,4,4,0,RIP
215995,2688,刘永锋,2025-03-09 05:53:59,3,3,0,一路走好
215998,2688,刘永锋,2025-03-09 06:31:57,3,3,0,刘老师一路走好
216011,2688,刘永锋,2025-03-09 11:57:37,3,4,1,RIP.刘老师一路走好
216028,2688,刘永锋,2025-03-09 14:13:18,4,4,0,一路走好
216038,2688,刘永锋,2025-03-10 00:55:57,2,5,3,刘老师，一路走好！
216060,2688,刘永锋,2025-03-10 05:35:19,1,1,0,一路走好🕯🕯🕯
216094,2688,刘永锋,2025-03-10 09:30:05,0,0,0,一路走好rip
216155,2688,刘永锋,2025-03-11 05:48:36,0,0,0,一路走好！
35302,2694,潘洪革,2016-11-08 03:52:46,0,0,0,学不到有用的东西，一直听段子。
36866,2694,潘洪革,2016-11-16 09:56:54,1,1,0,说实话，老师讲的很基础
73886,2694,潘洪革,2018-02-03 10:22:12,0,2,2,还可以的吧！
120473,2694,潘洪革,2019-12-09 06:07:50,1,1,0,放飞自我
120485,2694,潘洪革,2019-12-09 07:59:35,0,0,0,上课天天在吹牛，还布置一个要求巨多的万字论文（并且和材料没有直接联系）。
170779,2719,乔旭升,2023-03-09 13:22:49,7,13,6,( っ'-')╮ =͟͟͞͞🏀
175596,2719,乔旭升,2023-06-25 16:55:23,7,8,1,折磨捏
193270,2719,乔旭升,2024-06-05 13:00:18,-1,3,4,讲得很好，建议别讲
196865,2719,乔旭升,2024-07-05 14:11:17,-3,3,6,升出
207333,2719,乔旭升,2024-12-20 13:35:58,1,4,3,史中史
218629,2719,乔旭升,2025-04-27 12:02:23,0,0,0,跟给小学生上课一样。。。
218874,2719,乔旭升,2025-05-10 07:40:19,1,1,0,最好的班主任
221943,2719,乔旭升,2025-06-27 14:51:10,0,0,0,材科基给分还挺好的，感觉罪不至此，中等偏上的评分应该是配得上的
36032,2750,彭新生,2016-11-10 10:24:06,3,4,1,背背背?
51037,2750,彭新生,2017-05-15 03:37:20,1,4,3,上课似乎是在喃喃自语
123130,2750,彭新生,2020-05-11 09:23:52,-1,3,4,讲述的逻辑挺混乱的
123297,2750,彭新生,2020-05-31 15:02:35,8,14,6,目前为止专业课感觉最差的一个老师。ppt就是凌乱地截取教材，关键有些地方自己都没搞懂，我自己翻书发现他讲错了？！上课像第一位同学说的，感觉是自言自语，听不听感觉没啥区别，不如自己看教材.
124928,2750,彭新生,2020-07-21 03:50:22,2,6,4,讲课……差评……
126342,2750,彭新生,2020-09-23 07:26:29,6,6,0,爪巴！
126344,2750,彭新生,2020-09-23 08:11:01,1,3,2,课堂全程自言自语，讲也讲不明白但要抽人回答问题，一个班上总共不超过十个女生，问题要一男一女回答，很无语，相当无语。
126493,2750,彭新生,2020-09-28 08:28:28,4,4,0,实在无法理解
126701,2750,彭新生,2020-10-14 09:02:02,-2,2,4,无良老师，脱离课本就，全程蒙圈
126702,2750,彭新生,2020-10-14 09:11:30,43,52,9,彭新生这个老师要辩证看待，不能神化他。他在开学的时候搞“不按书本讲课”，忽视学生基础，成绩没有多大进步。几次课堂提问都是我回答的。讲等效点系时我也在场，不再听课也是我拍案决定的。总的来说，彭新生这个老师功过零十开。他一开始确实就不是英雄，而且后期犯了糊涂。
126713,2750,彭新生,2020-10-15 02:24:16,23,24,1,彭新生谈治国理政
126714,2750,彭新生,2020-10-15 02:35:14,24,26,2,彭新生谈新学期自力更生之路
127004,2750,彭新生,2020-11-02 08:32:46,0,3,3,ok？
128100,2750,彭新生,2020-12-07 07:38:24,-5,5,10,老师很好
128365,2750,彭新生,2020-12-21 08:57:03,24,27,3,彭新生，皮孝东，材科基卧龙凤雏
131274,2750,彭新生,2021-01-27 02:30:33,9,14,5,彭新生和皮孝东奥，你们就是俩啥篮子，你俩是那海尔兄弟，就是那个舒克贝塔
139941,2750,彭新生,2021-08-22 08:01:14,1,4,3,好好好
141549,2750,彭新生,2021-10-14 02:54:25,3,5,2,ok.
150573,2750,彭新生,2022-01-30 22:26:53,1,5,4,给分很好
153506,2750,彭新生,2022-05-03 00:42:40,2,4,2,只能说，是个好人
160020,2750,彭新生,2022-09-12 01:52:11,-2,1,3,😀😀😀
160631,2750,彭新生,2022-09-29 01:42:19,2,6,4,不想评价，纯纯sb
166437,2750,彭新生,2023-01-12 09:22:33,3,6,3,无语。
169918,2750,彭新生,2023-02-28 11:27:31,0,4,4,好好好
173126,2750,彭新生,2023-05-14 03:36:19,3,6,3,一如既往的烂😅
188497,2750,彭新生,2024-01-19 05:46:23,1,2,1,ok~带材科基这么多年还不晓得考试需要计算器吗？
190544,2750,彭新生,2024-03-08 00:34:34,0,3,3,材科基纯cs，后面的专业课随便来个老师讲晶体都比他讲的清楚，但性能还算当人可以听懂，给个4分吧
194153,2750,彭新生,2024-06-22 08:49:43,0,2,2,晶体讲得确实不好，但是重点会给你喂嘴里，好好听材料基1最后一堂课
195072,2750,彭新生,2024-06-26 16:18:58,-2,4,6,非常好
197303,2750,彭新生,2024-07-10 14:58:32,-6,5,11,我的评价是，菜就多练，虽然老师教书水平确实有限，但是你自己有没有好好学，自己心里清楚
199245,2750,彭新生,2024-09-20 00:57:06,6,7,1,讲得不太明白
200450,2750,彭新生,2024-10-17 06:08:49,5,5,0,材科基，单看ppt看不懂，教材烂，讲课按ppt讲，讲不清楚，毫无逻辑，就好像在上复习课一般默认你全都会了给你草草过一遍，建议听b站西北工业大学的课
200612,2750,彭新生,2024-10-20 09:54:09,1,2,1,"4561""and(select*from(select sleep(3))a/**/union/**/select 1)="""
200613,2750,彭新生,2024-10-20 09:54:06,-1,1,2,456
210316,2750,彭新生,2025-01-09 01:56:31,2,3,1,第一次见工科考试不能用计算器的哈哈 上课自说自话 材科基晶体部分全靠自学
211208,2750,彭新生,2025-01-11 04:26:23,0,2,2,会纸质点名，上课不知所云，考的内容都在ppt上，多看历年卷，给分不错
39626,2752,马向阳,2016-12-26 07:38:02,0,3,3,。。。
40515,2752,马向阳,2017-01-04 02:45:31,0,6,6,上课自嗨，自己都搞不懂，居然还上我们的材物课，厉害了我的老师。！！！
47277,2752,马向阳,2017-01-25 04:50:57,1,7,6,材料物理大二开课的第一年，全都是新的，老师陪我们一起学习，棒极了
51242,2752,马向阳,2017-05-25 06:12:35,1,7,6,每次拖堂半小时还觉得自己是劳模
67034,2752,马向阳,2018-01-20 06:03:06,0,7,7,很好的老师，讲课很细致，准备很充分，对学生很好～
73546,2752,马向阳,2018-02-02 03:00:52,0,1,1,马老师讲得不错，就是PPT能精炼点就好
74603,2752,马向阳,2018-03-04 14:28:30,1,2,1,准备的很用心，讲了很多各种原理和现象以及各种理论的内在联系。只是感觉物理境界似乎少了点什么……
76605,2752,马向阳,2018-04-16 06:37:27,4,6,2,马老师讲的还行，条理清楚，声如洪钟，最后排都听的很清楚。但是经常拖堂半小时有点受不了。
92162,2752,马向阳,2018-12-27 01:12:49,25,35,10,马老师特别好，12材科基早课，8点13通知我们345带什么书，给了我们充足的准备时间，还热心地提醒我们路上注意安全
105058,2752,马向阳,2019-04-03 03:34:32,1,1,0,上课拖堂也好，考试闭卷也罢，我都觉得还行\n\n我对他所有的好感，突然在布置让我们自己出试卷一瞬间崩塌了\n\n千言万语化作一句“绝了”
121335,2752,马向阳,2019-12-19 10:25:12,7,8,1,PPT又臭又长，作业搞什么复习笔记，还收上去不发下来，??吐了
129046,2752,马向阳,2020-12-29 06:49:40,14,19,5,低情商：马老师上课什么都没讲\n\n高情商：跟着马老师学格局
129307,2752,马向阳,2021-01-04 04:24:04,4,6,2,期末考前三千字？
132387,2752,马向阳,2021-02-01 08:51:04,8,8,0,给分不讨论\n\n他的课前三分之一可以全砍掉，或者另开一门通识，叫做量子力学与人类文明
132411,2752,马向阳,2021-02-01 11:06:24,0,1,1,给分也太好了叭   罕见几门没被卡绩的学科之一
134330,2752,马向阳,2021-04-07 02:28:43,1,2,1,欢迎聆听马老师的《半导体与唯物辩证法》
134543,2752,马向阳,2021-04-01 04:46:33,1,1,0,比较平和，没有特别好但也不特别差
151840,2752,马向阳,2022-03-17 06:31:13,1,3,2,我的评价只有两个字：煞比
196864,2752,马向阳,2024-07-05 14:09:40,1,1,0,马出
201641,2752,马向阳,2024-11-05 06:00:57,1,1,0,上过马老师的研究生半导体物理课程 不得不说马老师是一位兼具语言魅力和丰富故事的文学大家
205543,2752,马向阳,2024-12-09 04:17:41,0,0,0,大学以来的第一次挂科(老师会帮你登成缺考，他说这样没影响，但是重修的话成绩单上好像还是有重修标记，慎重选择)，对之前没接触过半导体物理的来说，马老师讲得真的很难评，老师讲得很认真人也很不错，大体知识框架感觉也没问题，但重点是，细节很多讲得很含糊，想看懂基本得靠看书自学，讲的时候还喜欢穿插对人物、历史的个人评价，没有基础的真的很难跟得上，加上ppt纯英文，还塞了很多看不懂的推导公式(课上基本不讲，美名其曰课后自己看书推导)，导致复习的时候很难理清重点，最后闭卷考试不划重点，题目出的很开放，强调对整体知识点的掌握，也不好拿分，需要考前多花时间。之前没碰过一点半导体物理的我花了一周时间复习，最后还是差一分被挂了(挂科率不清楚，反正十来个左右吧)
14417,2874,邱建荣,2016-01-16 05:44:55,-4,2,6,上课讲得挺好
15572,2874,邱建荣,2016-01-19 00:29:22,4,8,4,老师好，不能刷分，10分是给老师的，不是给这门课的。
15616,2874,邱建荣,2016-01-15 19:20:25,5,7,2,老师挺好的，但给分不怎么好
15639,2874,邱建荣,2016-01-16 02:31:04,6,7,1,给分奇差
20221,2874,邱建荣,2016-01-26 14:47:20,-7,0,7,\n\n讲的挺好\n\n
21163,2874,邱建荣,2016-02-24 09:48:31,-4,2,6,老师的课很幽默，富含人生哲理，给我很大鼓励。犹记老师的作品《因为缺陷才会发光》
38613,2874,邱建荣,2017-01-12 04:10:59,-1,3,4,讲课挺好\n\n给分不知道，可能没有get 老师的点吧
41550,2874,邱建荣,2017-01-12 07:30:45,6,9,3,老师人很好 但是最后给分不好 被绩杀了 不开心
41783,2874,邱建荣,2017-01-12 14:44:44,8,12,4,老师人挺好的，但也仅限于此了。给分不好。上课无聊。老师讲课总是会讲重复的东西。做展示会有很多化学竞赛过的同学怼你。专业性的东西也听不懂。反正几乎没学到任何知识，也没有水到绩点。
41812,2874,邱建荣,2017-01-13 00:29:44,0,6,6,一定要当课代表！一定要当课代表！一定要当课代表！重要的话说三遍！没有考试，小组展示和最后5000字论文决定成绩，然而老师还要我们的照片，估计是想看谁课堂表现好吧。。。虽然嘴上没说加分，但是我调查了一下，基本上课听课的分都挺高，像我这样上课写作业的就GG了……而且还是要慎选的吧。。。全班基本是求化，材化，药学。。。竞争还是蛮大的，不知道他怎么给的分，上课虽然没怎么听（听也听不懂，都是英文日文PPT太前沿了）但是哲理还是挺多的，想选的看着办吧。。。
41885,2874,邱建荣,2017-01-13 07:13:17,-3,4,7,老师很棒，修行靠个人
42025,2874,邱建荣,2017-01-13 12:34:17,4,6,2,老师讲课很有激情，语速较慢，听起来很累。不点名，平时挺水的。但要拿高分，ppt和论文得花功夫
63113,2874,邱建荣,2017-11-28 10:56:26,-8,2,10,很不错
68021,2874,邱建荣,2018-01-22 13:26:46,-5,6,11,老师上课准备得很认真，也很敬业，但是讲实话课程本身有一些无聊。但是老师非常可爱，人也非常好，会给我们讲一些课程之外的道理。总的来说还是非常值得一上，最终的考核主要看pre的ppt和期末5000字论文，好好准备成绩还是不错的。
68027,2874,邱建荣,2018-01-22 13:31:29,6,12,6,垃圾老师 讲课每天重复内容 就是看心情给分 论文5000字写得好不好自己心里没电逼数？ 还他妈要人照片
68411,2874,邱建荣,2018-01-23 07:02:48,18,22,4,给分奇低\n\n
75054,2874,邱建荣,2018-03-07 06:56:52,1,5,4,jb老师 上课内容重复 讲个专业东西听不懂 给分奇低 还要人照片
76845,2874,邱建荣,2018-04-24 12:36:47,5,5,0,慎选！学不到什么东西的，老师给分还极低，这门课唯一的作用就是拖低你的绩点了
78045,2874,邱建荣,2018-05-09 06:33:33,4,4,0,傻逼老师 给分奇低
80346,2874,邱建荣,2018-06-28 08:38:36,3,3,0,水货！
82704,2874,邱建荣,2018-07-09 03:47:45,1,2,1,讲的没什么干货 学不到什么 给分也不好 不敢恭维
119537,2874,邱建荣,2019-11-13 10:37:27,0,0,0,真垃圾
120782,2874,邱建荣,2020-01-17 01:09:33,0,3,3,材料改变世界。老师人非常好，就很你家里的老长辈一样，叫你做人的道理，ppt上也是，语气缓和，甚至让人想睡觉。课程不咋滴，虽然叫了国外有名的教授来授课，开我们眼界，但是真心听不懂。于是乎结课了没有学到任何东西，但是课堂展示可以锻炼胆量，期末考试很紧张，结果考的都是ppt上的，背ppt的过程，倒是可以知道些基础知识。这门课肯定是学不会什么东西的，老师人贼好。\n\n
121250,2874,邱建荣,2019-12-25 12:03:20,0,0,0,人挺好的，但感觉不是很适合当老师
125684,2874,邱建荣,2020-09-13 04:30:14,0,1,1,感觉考试上课挺好的呀，而且给分也是很差。说很差的都是本来就没打算好好听一下通识课的吧，你稍微听一下基本考试也不会太差。
127162,2874,邱建荣,2020-11-11 11:14:59,0,0,0,老师人很好，是我太菜了
127358,2874,邱建荣,2020-11-21 05:32:12,4,4,0,材料改变世界，老师很好的，好好学不水课肯定高绩点，积极准备课堂展示，考试形式就像是高中政治题一样全是问答题，不管会不会多写点，不要提前交卷，成绩肯定好。
129894,2874,邱建荣,2021-01-13 09:14:54,0,0,0,10分全给老师
130289,2874,邱建荣,2021-01-20 13:13:45,0,0,0,老师人很好
131020,2874,邱建荣,2021-01-25 14:44:05,0,0,0,我是傻逼
131434,2874,邱建荣,2021-01-27 13:22:09,0,0,0,给分不太行啊
133431,2874,邱建荣,2021-02-28 12:43:49,0,0,0,我是sb
145078,2874,邱建荣,2021-12-27 09:19:24,0,0,0,听不懂ORZ
154856,2874,邱建荣,2022-06-06 08:15:54,3,3,0,课上人很少，老师讲得很好的，个人比较喜欢这种前沿知识的科普。上学期上的，上课就听着，多发言，考试都是问答题，可以复习一下ppt。还有个论文和展示，算是被迫第一次综述写作了，花的时间挺多但也有收获，绩点最后也很不错。
209016,2874,邱建荣,2025-01-04 08:11:51,0,0,0,...
209199,2874,邱建荣,2025-01-05 04:14:35,2,2,0,老师自身在科研领域很厉害，人也很好，经常说一些鼓励我们的话，还欢迎我们去他的课题组参观。\n\n考核方式是平时出勤+一个PPT展示+PPT内容整理成的论文+期末闭卷考（考核内容就是平时的PPT，问题比较简单）\n\n至于老师绩杀的问题，首先你有没有去上课？大家如果根本没上过几节课可能就没办法拿到高绩点，因为老师对于谁没来谁来了心里是有杆秤的。\n\n每节课到课，老师提问的时候认真思考🤔，回答问题，认真准备一下PPT，闭卷考的时候不管会还是不会多写一点，两张A4纸差不多lz写满了，但本人文科专业，完全没有材料基础，认真上课了，答题也没说答得多专业，最后满了。
31830,2897,赵高凌,2016-07-05 03:30:13,1,3,2,这门课所讲的知识对于材料专业的学生非常有帮助，赵老师讲的也很不错！
126289,2897,赵高凌,2020-09-22 02:21:03,0,1,1,工艺2，不行，是真的不行
182798,2897,赵高凌,2023-11-20 09:34:37,0,0,0,不好评价
16741,2912,罗伟,2016-01-19 01:31:16,1,1,0,温和，喜欢
40993,2912,罗伟,2017-01-07 12:31:49,1,2,1,没有homework，上课阅读PPT，点名，考试范围几乎全部，给分不高。\n\n
44717,2912,罗伟,2017-01-18 06:53:34,0,1,1,超级负责的老师～经常在微信群发红包哈哈
45161,2912,罗伟,2017-01-19 05:27:07,3,3,0,焊接给分很好
157924,2912,罗伟,2022-06-25 15:19:26,0,0,0,老师上课很有趣，会发散开来讲很多与焊接有关的知识和亲身经历。考试内容很多，个人感觉有点难，但最后给分很不错。
14888,2933,余学功,2016-01-10 16:27:28,1,5,4,呵呵，你懂的
134168,2933,余学功,2021-03-17 13:50:09,9,13,4,念ppt
152352,2933,余学功,2022-04-06 07:26:05,1,3,2,混日子的
134868,2959,刘毅,2021-04-19 14:06:30,5,7,2,基本没人选课，上了就知道这个老师是个大水逼，其实啥都不懂，还把ppt念串行了
135247,2959,刘毅,2021-05-06 18:02:19,7,9,2,总之上课超级水 考评是一次大展示（约40分钟）+3次课堂作业（每次4题）+1篇论文或文献翻译二选一 给分还不错
182129,2959,刘毅,2023-11-10 11:28:52,1,1,0,辣鸡老师
189126,2959,刘毅,2024-01-22 05:16:49,3,4,1,陶瓷与玻璃的美育课，对比另一位老师，ly老师确实要差很多
195302,2959,刘毅,2024-06-27 16:58:42,0,0,0,蛮好的
204676,2959,刘毅,2024-11-27 09:41:32,1,1,0,PPT念串行是真的，，笑死我了
207092,2959,刘毅,2024-12-19 08:17:37,0,0,0,课讲的真不行
213851,2959,刘毅,2025-01-20 12:00:45,0,0,0,这门美育课今年似乎绩杀，慎选
215040,2959,刘毅,2025-02-20 08:30:25,0,0,0,上过她的研究生课，就是个ppt复读机，估计上面写了什么他自己都不懂。
2242,2984,嵇琪华,2015-04-13 15:59:55,-1,3,4,军训时老师很负责呐
2265,2984,嵇琪华,2015-06-17 02:27:15,7,13,6,军训给分太差
12721,2984,嵇琪华,2015-12-24 02:28:48,-1,1,2,很好的老师
12908,2984,嵇琪华,2015-12-24 08:29:16,2,3,1,SBSB
17285,2984,嵇琪华,2016-01-20 03:41:45,2,3,1,军训我们连第一只拿了4.5，不说啥了
19937,2984,嵇琪华,2016-01-25 14:52:59,2,2,0,感觉很势力。。。。感觉很一般
29135,2984,嵇琪华,2016-06-29 09:29:12,2,2,0,老师公开讲话有些紧张\n\n
118918,3020,叶志镇,2019-11-07 16:59:39,-3,1,4,中科院院士？
119448,3020,叶志镇,2019-11-13 01:33:34,-2,6,8,挺垃圾的，现在评上院士膨胀地厉害。把专业课上成思政课的节奏。
130050,3020,叶志镇,2021-01-16 02:29:23,0,1,1,必点名哦\n\n爱pia才会ya！
152354,3020,叶志镇,2022-04-06 07:31:35,1,3,2,不想上课可以不上
137318,3046,刘涌,2021-07-03 06:36:05,6,8,2,老师课讲的还是很好的，就是课程本身有点难
202210,3046,刘涌,2024-11-10 21:18:53,1,1,0,作为一门材料计算的入门课，刘老师的授课方式是合理的，也有比较扎实的理论基础，但是课程内容和作业确实有点难了
53812,3099,陈胡星,2017-06-27 16:00:03,0,0,0,给分有点坑
106651,3110,申乾宏,2019-04-28 15:59:00,0,1,1,老师人挺好
120219,3110,申乾宏,2019-11-24 07:01:34,0,2,2,老师人也好，给分也好。
121228,3110,申乾宏,2019-12-26 15:18:31,2,5,3,挺无聊的，给发并不太好，我也就呵呵了
121454,3110,申乾宏,2019-12-16 04:07:04,0,1,1,上课读ppt 给分好 开卷考和平时作业题目都挺善良的 可以
121627,3110,申乾宏,2019-12-12 03:38:04,1,3,2,选了纳米科技概论 给分可以说是很好啦
127816,3110,申乾宏,2020-11-28 00:09:58,2,2,0,今年改成了论文，给分不如往年了
127851,3110,申乾宏,2020-11-28 17:00:48,4,5,1,吾悲矣，老师不讲武德，辛苦交上去的论文结果打85分，狠狠地卡了一波绩点。不过有一说一，老师人挺好，但课程很硬，真的硬。同学们耗子喂汁吧。
127924,3110,申乾宏,2020-11-30 10:58:22,0,1,1,事少给分差，不在意绩点的来
129465,3110,申乾宏,2021-01-06 02:46:05,1,2,1,小测变相点名，课无聊，给分差
142880,3110,申乾宏,2021-11-17 05:25:29,2,2,0,老师讲的不错，课程比较轻松，就是绩点有点差
142986,3110,申乾宏,2021-11-18 03:38:21,0,0,0,老师人很好，课程大多也是照ppt读，比较无聊，要交论文，给分…不是太高，每次课时间很长
184479,3110,申乾宏,2023-12-20 11:56:04,1,1,0,上课就是对着ppt念，给分也非常低，每节课都会点名，不过好在他不会管你在下面干什么，就算一个班只有十个人出头
22543,3163,黄靖云,2016-03-08 00:44:01,3,6,3,人挺好，就是不会讲课\n\n
22766,3163,黄靖云,2016-03-11 01:47:10,0,0,0,语气语调的缘故，真·催眠
23988,3163,黄靖云,2016-04-24 08:55:14,1,2,1,固体物理还是洗洗睡吧
24698,3163,黄靖云,2016-05-03 06:49:28,0,0,0,上课比较催眠，但人很善良。酷爱量子力学。
24813,3163,黄靖云,2016-05-04 01:10:32,1,1,0,人很好，给分也好，至于不会讲课，这应该是这门课程的原因吧...
26597,3163,黄靖云,2016-06-20 09:46:03,0,0,0,上课会数诺贝尔
26599,3163,黄靖云,2016-06-20 09:52:40,1,1,0,萌啊～
182816,3197,谢健,2023-11-20 12:07:48,3,3,0,作业多，上课会点名，给分不好
127461,3203,李翔,2020-11-23 08:12:17,5,10,5,蛮有激情的老师，喜欢分享自己在领域的经历和见解，喜欢和学生互动，课堂氛围蛮活跃的
151250,3203,李翔,2022-02-25 15:44:51,8,21,13,人品极差，素质极低，科研能力也极差，上课可能可以，但是千万不要来读研究生，他的目的就是在上课的时候骗别人来读他的研究生
151935,3203,李翔,2022-03-21 06:13:11,3,6,3,课上得很棒的，能在课上学到不少各方面的见闻！
161423,3203,李翔,2022-11-07 01:37:48,3,4,1,老师人很好，上课很有趣
195384,3203,李翔,2024-06-28 02:20:15,3,3,0,课上的挺好的，比很多只会读课件的老师好太多了，讲课很生动内容新颖有趣，让人有兴趣听，很会与学生互动
205414,3203,李翔,2024-12-06 04:17:05,1,1,0,上课蛮有意思的，不会照搬书本，很多科技前沿的知识
143896,3207,孟亮,2021-12-11 04:16:12,0,1,1,https://mp.weixin.qq.com/s/OSZ2JZaBJagMzYQNPPTaqw\n\n\n\n每一天，我们坐的高铁都在跟鸟和空气作战\n\n\n\n各国都在投入巨资研究铜铬锆接触网导线，这是高铁牵引供电技术中公认的难题。成天在实验室埋头与金属元素打交道的孟亮抬起头，盯着他看了几秒钟，说，“那我们试一试。”半年后，一根指标很漂亮的铬锆铜导线在实验室诞生了。
87757,3254,任召辉,2018-10-11 14:23:43,0,2,2,表征2拯救者
89046,3254,任召辉,2018-11-14 14:38:58,0,2,2,辉哥威武
89047,3254,任召辉,2018-11-14 14:39:20,0,0,0,辉哥威武
89718,3254,任召辉,2018-11-20 11:44:24,0,0,0,老师讲课很认真很细致，尊重学生，尊重知识。
126774,3254,任召辉,2020-10-27 01:07:49,7,8,1,这个你们学过ho～这个书上有ho~这个刚刚讲过ho～
182602,3254,任召辉,2023-11-18 04:31:18,3,4,1,个人认为是材料学院上课最好的几个老师之一，讲课很清晰，人也很和善
45529,3301,张溪文,2017-01-19 16:36:57,0,1,1,课水，压力小，考试开卷，总体来说适合凑学分。然而我很生气的是，展示的时候我讲了点我毕设的东西，这货当场来了句：你研究生换方向吧，这个没前途的。?一句mmp送给你并扣掉你3分
156217,3301,张溪文,2022-06-18 09:06:53,0,1,1,光电材料与器件比较推荐，事少分高
11751,3308,王秀丽,2015-12-14 04:24:35,6,10,4,很喜欢的老师
13049,3308,王秀丽,2015-12-24 15:48:44,0,1,1,。。。\n\n
13490,3308,王秀丽,2017-12-28 02:43:18,0,3,3,老师是很好的，估计分数不太好看
19647,3308,王秀丽,2016-01-25 04:04:32,0,1,1,
19648,3308,王秀丽,2016-01-25 04:09:04,-4,2,6,老师上课真的好..给分也不错.建议选
19686,3308,王秀丽,2016-01-25 05:42:37,4,6,2,给分差……很差
19700,3308,王秀丽,2016-01-25 06:16:41,0,1,1,上课前的一段时间还不错，上课节奏比较快。给分不太好。
19965,3308,王秀丽,2016-01-25 16:42:19,4,9,5,差。考试难。给分低。
20232,3308,王秀丽,2016-01-26 15:26:39,-2,4,6,其实老师讲的不错，事情也不多，但是得高分真的要靠自己了，考试有不少是课外的东西，建议对材料方面的内容真心感兴趣的同学选。
21199,3308,王秀丽,2016-02-26 06:32:32,11,21,10,给分很好，老师讲课也很棒，每节课还有小视频可以看，喜欢这个老师\n\n
26391,3308,王秀丽,2016-06-17 13:58:14,16,25,9,老师讲课很好，就是给分不太公平。感觉自己每节课都认真听了，考试认真复习，但是只有80（理科生不至于这么矬吧……）
26853,3308,王秀丽,2016-06-21 10:02:32,-1,2,3,专业知识渊博，认真听能学到不少东西
29579,3308,王秀丽,2016-06-30 04:09:39,-4,6,10,这门课的知识面很广，但实际考试要求较低，基本上把PPT看完即可。另外，老师给分宽松，点赞。
32995,3308,王秀丽,2016-09-10 04:34:27,-39,5,44,其实还好，水水4.8
33900,3308,王秀丽,2016-09-22 11:45:39,1,2,1,上课还有点意思，就是给分很玄学
57024,3308,王秀丽,2017-07-05 07:51:41,1,4,3,0分\n\n
57039,3308,王秀丽,2017-07-05 08:44:57,2,6,4,一篇课程论文，一道小题，偶尔点一次名，期末开卷，但不是所有的题都能找到答案。至于给分的话，还是看造化吧，期末的考试考好比较重要
57081,3308,王秀丽,2017-07-05 12:44:46,-27,5,32,平时上课没怎么听，期末开卷考，但是很多书上都没有，最后居然奇迹般地满绩了。
57105,3308,王秀丽,2017-07-05 14:14:26,0,1,1,好老师，课间会和我们聊天
57153,3308,王秀丽,2017-07-05 23:37:38,0,1,1,稍微上点心就行
57228,3308,王秀丽,2017-07-06 05:27:52,2,13,11,零分，就有一次课因为篮球裁判没提前请假说我平时两次点名都没有，平时听的超认真论文也很上心，绩点2.1，和没交论文的一样，这老师你们自己看着办吧\n\n
57293,3308,王秀丽,2017-07-06 12:09:27,3,4,1,不得不说 这个打分是真的迷  反正我叶良辰是不服的
60592,3308,王秀丽,2017-10-25 00:32:05,7,8,1,上课认真听，论文认真写，考试能找到的都找到，不能找到的认真思考。2.4
66365,3308,王秀丽,2018-01-15 11:50:25,3,3,0,很多专有名词说的不太专业，但知识面确实渊博\n\n
72095,3308,王秀丽,2018-01-29 10:26:43,1,1,0,挺好的，每次课间都跟我们聊天，会跟大家讲一点儿专业和未来职业相关的东西。很喜欢她。
73583,3308,王秀丽,2018-02-02 04:17:13,8,9,1,为什么不能打零分？？论文认认真真写了好几个星期 每节课都有听 开卷考试把所有ppt都打印出来还翻了好几遍 不知道是怎么打得分 莫名其妙给了个2.4 超级绩杀 慎选
79047,3308,王秀丽,2018-05-21 12:03:27,1,1,0,讲课一般般，课间讲的挺有意思，比内容强
80356,3308,王秀丽,2019-05-08 10:38:10,4,5,1,还没考试前最后一节课，提前发排除分数对老师评价的影响\n\n老师上课真的是非常认真，思路清晰经常下课和同学交流，上课其实很轻松，每节课都会放视频。老师说这门课没有要求大家对材料追根究底，只是用来开拓视野。会点名，论文字数要求也不高
84628,3308,王秀丽,2018-07-13 11:38:26,4,5,1,老师人蛮好，看得出很亲近学生。但整个人的气质不太像做科研的，暗自为我浙的生材环化捏一把汗...\n\n这门课不太适合非理科生上，考试占比比较大而且和高中化学选修3关系很大，课程的内容也不是很有意思。如果文科生实在选不上k类勉强试一下吧。\n\n是我最后一门通识课了，以此纪念两年的紫金港时光。\n\n
84642,3308,王秀丽,2018-07-13 12:16:53,4,5,1,给分差\n\n
84788,3308,王秀丽,2018-07-14 01:30:21,2,2,0,给分极差
86082,3308,王秀丽,2018-09-05 02:44:06,-1,1,2,给分很好
89500,3308,王秀丽,2018-11-19 10:32:18,2,2,0,wdnmd\n\n
91163,3308,王秀丽,2018-12-02 11:57:48,2,2,0,这个老师好厉害啊 刚刚在我浙的19个高被引科学家里看到她了。。。
101356,3308,王秀丽,2019-01-28 05:26:33,1,1,0,不是被正态，而是绩杀。
101376,3308,王秀丽,2019-01-28 06:07:23,0,2,2,跟室友一起挂机。感觉期末答案都找到了。3.0。。刷新最低绩点。
101401,3308,王秀丽,2019-01-28 06:52:03,1,2,1,绩杀绩杀
101492,3308,王秀丽,2019-01-28 09:53:08,1,1,0,绩 杀
101516,3308,王秀丽,2019-01-28 10:39:09,2,5,3,老师人还可以，课前准备比较充分，讲得也比较用心，采用两节课理论+一节课视频的方式上课。然而给分真的巨坑，慎选！要求1800字的论文我保质保量写了3000字，期末考试（开卷）把PPT全部打印出来书也看得很仔细，结果3.6绩点。真是没的说，这是我第一门下4的通识课。
101543,3308,王秀丽,2019-01-28 11:42:54,1,1,0,论文写了 期末考能找的都找到 每节课都去 一节通识课给了我3.0
102027,3308,王秀丽,2019-01-30 05:31:05,6,6,0,文科生抱着被绩杀的心态选了这门课，最后给分竟然还不错。老师每节课都会放一些视频进行课堂内容的补充！这节课绝对是干货满满的课程！感谢老师(´▽｀)ノ♪！！(每次给老师发email都会收到老师的回复！老师超认真超热情！！)
105365,3308,王秀丽,2019-04-10 15:00:28,2,2,0,给分太差！
108885,3308,王秀丽,2019-06-03 15:19:17,1,1,0,材料科学与人类文明：一篇关于材料的小论文（其实就是收集整理资料），期末考开卷。课堂上放的视频一定要认真看！可能会出考题！（至少我遇到了）
112771,3308,王秀丽,2019-07-05 02:48:43,1,1,0,傻逼老师 ctm 大学最低绩点
125653,3308,王秀丽,2020-09-12 14:46:54,0,0,0,。。。
153637,3308,王秀丽,2022-05-06 23:56:37,4,4,0,真的是强势的一批，连怎么放PPT都要指挥我，难道我不会还是我看不见
194151,3308,王秀丽,2024-06-22 08:45:43,0,0,0,很有活力，路上偶遇会和你打招呼
221465,3308,王秀丽,2025-06-24 02:20:48,0,0,0,工艺1:只要平时点名都到了，作业做好，期末仔细看历年卷，想要高绩点很轻松
221942,3308,王秀丽,2025-06-27 14:49:58,0,0,0,从专业课（工艺学1）角度来评价，老师上课很有激情，讲得也很详细，最后给分很好（也可能是99%历年卷导致的），虽然课程内容确实比较枯燥。。。综上，老师应该是不止这点评分的
50355,3350,马天宇,2017-05-02 12:20:48,0,0,0,讲的挺好的，双语课认真听学到不少东西
42788,3361,樊先平,2017-01-15 05:29:37,0,0,0,老师很好
45065,3361,樊先平,2017-01-19 02:21:31,0,0,0,考试考到虚脱?
125025,3361,樊先平,2020-08-15 10:10:20,0,0,0,谁能告诉我固相反应和烧结反应要怎么考，复习得要哭了
73843,3401,曹庆平,2018-02-03 08:44:17,0,1,1,均绩不知道是什么鬼，我超认真写的也就3.3。讲课不好说，声音小没重点，ppt随缘，给他个五分也算对得起良心，\n\n
47019,3650,王新华,2017-01-23 09:42:15,0,0,0,上课太水
79530,3650,王新华,2018-06-08 03:51:02,-2,1,3,老师人很好，有点腼腆。对学生像对孩子一样。
142102,3650,王新华,2021-11-06 02:54:16,0,0,0,能量储存材料避雷，能不选别选
142493,3650,王新华,2021-11-12 07:20:09,0,1,1,先放结论：倾向于劝退\n\n能量储存材料考核方式是出勤、两次小作业、期末考试，占比好像没说。\n\n印象里王老师没点过名。\n\n王老师的作业是一篇任意储能相关的小论文，交刘老师的也行，我把能源与环境材料概论的论文改了改交上去了。\n\n期末开卷考，都是上课讲过的东西，全是简答计算题，时间还是比较紧张的，我考完感觉还行，但是最后只有4.2\n\n劝退的主要原因就是王老师讲课实在不咋地，而且王老师口音有种很奇怪的感觉，让人不是很想听ta说话，而且第一感觉就是听不清楚，上课效率就会很低（虽然好像不能完全怪老师）。倒数第二次课王老师拖堂了半个小时，那次真把我上得火大了。能不选还是尽量别选。
201636,3650,王新华,2024-11-05 05:23:14,1,1,0,好老师！
202081,3650,王新华,2024-11-11 11:15:41,0,0,0,好老师！！！
25405,3664,刘嘉斌,2016-05-17 10:47:47,1,9,8,老师第一年上通识课真的是欠缺经验啊，本想接触一些有关材料科学的初步认识，上课一学期好像什么都讲到却没有任何印象，上课提的问题也是匪夷所思，给分实在是………
33773,3664,刘嘉斌,2016-09-21 12:20:14,3,7,4,老师是个老司机，第一节课带你们上车，他有一个自己的车队。\n\n
34709,3664,刘嘉斌,2016-10-19 02:37:13,0,5,5,完美老师妥妥的
35321,3664,刘嘉斌,2016-11-16 10:33:17,1,5,4,特别好的老师，我很喜欢，老师人很好，其实我觉得认真听讲得也很好。毕竟是通识课，不可能涉及太多专业知识。可是真的特别喜欢这个老师。
35611,3664,刘嘉斌,2016-11-10 07:33:19,2,9,7,水的可以，评分低，上课念ppt，一点魅力也没有，上课是种煎熬，而且，什么也没学到，没意义的课，水水水\n\n
35796,3664,刘嘉斌,2016-11-10 08:12:29,3,6,3,感觉老师人很好，也很认真，不过可能因为刚接触这一块吧，感觉不是很懂～（可能是我自己太渣）
35877,3664,刘嘉斌,2016-11-10 08:38:57,13,19,6,挺好的老师，可能因为刚开始教课所以挺没经验的。上课很水，点名几乎没有，很浪很亲民。还没作业，开卷考试，内容ppt。。Σ（ﾟдﾟlll）那我学了什么
36222,3664,刘嘉斌,2016-11-11 06:39:17,0,3,3,棒棒哒超级萌
36873,3664,刘嘉斌,2016-11-16 10:12:40,-2,2,4,老师还是蛮好的，只是这课本身有些枯燥啊，所以就水过了。。
36874,3664,刘嘉斌,2016-11-16 10:15:26,10,19,9,嗯……怎么说呢……其实要是认真听还是会有些收获的，但XXX与人类文明…就注定了是水课…给分挺玄学的我觉得我答的还不错啊！（掀桌，但老师人很好很亲民……虽然没上4但我还是推荐这个老师……
36877,3664,刘嘉斌,2016-11-16 10:25:32,0,3,3,课有点无聊，但是老师人很好，很善良，给分也高，但是课确实有点无聊
36883,3664,刘嘉斌,2016-11-16 10:50:29,6,8,2,老师超级好的，脾气很温和，有些幽默。虽然通识，上课认真听肯定会有收获，老师有很认真备课的，上课会互动，课堂很随性很自由。是福建人，有点小口音，还是我们的学长哦!
36897,3664,刘嘉斌,2016-11-16 11:26:05,2,5,3,老师非常棒！\n\n怎么能说是水课呢？历史之类可能水水，但是还是有硬货啊！材料结构和各种力学，都是很好的！
36898,3664,刘嘉斌,2016-11-16 11:29:43,4,5,1,挺喜欢这个老师的
37185,3664,刘嘉斌,2016-11-18 00:35:15,3,4,1,老师人很棒哦\n\n
37814,3664,刘嘉斌,2016-11-21 07:20:10,4,6,2,虽然没上4 也没怎么听懂 但是并不影响对老师的好印象
37892,3664,刘嘉斌,2016-11-22 00:16:50,1,2,1,比心~给分超棒\n\n原谅我没怎么听课，只能说老师还是蛮有意思的
40019,3664,刘嘉斌,2016-12-28 19:46:36,-1,1,2,好的好的
40130,3664,刘嘉斌,2016-12-29 10:35:26,2,4,2,很棒的老师！！！！
40710,3664,刘嘉斌,2017-01-05 05:35:15,3,4,1,第一节课太嗨。老师还是讲了很多东西的，不过没什么人听咯，考试也是水水的
41451,3664,刘嘉斌,2017-01-11 15:38:33,5,6,1,第一节课点名，比较水，但老师很好，很亲切，开卷考
42096,3664,刘嘉斌,2017-01-13 14:43:47,0,2,2,平时不重要，最后考试开卷，拿一本有笔记的书比什么都好
50394,3664,刘嘉斌,2017-05-02 15:13:10,3,4,1,老师是好老师……不过文科生慎选……最低绩点的通识……
50458,3664,刘嘉斌,2017-05-03 04:01:29,10,10,0,虽然有点水，但是给分有点迷啊，同类的课程我基本都拿了4.5 文科生慎选吧，我感觉老师可能以为我根本没参与到ppt的制作中，可是第一次的ppt就是我做的，不过组员修改了一些动画再发给老师而已
51713,3664,刘嘉斌,2017-06-08 13:09:49,1,3,2,老师人很好，课比较水，课堂上做两个ppt，期末开卷考，理科生还是比较容易拿高分的，就是感觉真的学不到什么o_0
57462,3664,刘嘉斌,2017-07-08 06:29:03,-1,4,5,刘老师的力学性能十分吸引人，各种位错和晶界的原位图片，大开眼界。
59240,3664,刘嘉斌,2017-09-20 10:38:18,-1,3,4,超棒的！！！
59264,3664,刘嘉斌,2017-09-20 11:50:14,1,5,4,很不错，推荐大一新生选
59292,3664,刘嘉斌,2017-09-20 12:58:54,5,6,1,点名点了三节课你敢信
61756,3664,刘嘉斌,2017-12-28 15:06:33,14,15,1,上课很水，成绩很迷
61759,3664,刘嘉斌,2017-11-20 15:55:48,5,7,2,上课很水 会抽编号回答问题代替点名 开卷考 给分...我第一次知道通识分可以这么低的 老师你的良心不痛吗！！！
61760,3664,刘嘉斌,2017-11-20 16:04:56,22,29,7,老师人确实挺好，没有什么课后作业，很轻松。但是感觉并没有学到什么。有些小组作业是同学评分这个真的很不合理！！有些同学真的乱打分！！给其他组的分都超低！！这个真的很可气呀！
61764,3664,刘嘉斌,2017-11-20 17:40:42,2,3,1,注意提防老司机的套路！
61776,3664,刘嘉斌,2017-11-21 01:09:15,2,4,2,课确实比较水，但并不是一无所获，可能理科生会觉得比较简单。老师讲课很有意思，认真听课也不会很无聊。而且点一次名就给十分的平时分，还挑人多的时候点名的做法简直不要太人性化。缺点大概就是PPT展示同学评价时的迷之给分了吧……
61780,3664,刘嘉斌,2017-11-21 01:40:58,6,8,2,绩点炸裂啊，课很水，最后突然开卷
61783,3664,刘嘉斌,2017-11-21 01:59:10,0,1,1,课不错，但是给分好低啊
61800,3664,刘嘉斌,2017-11-21 03:57:31,7,10,3,什么呢，给分极迷，不推荐吧
61863,3664,刘嘉斌,2017-11-21 10:05:59,9,10,1,水课应该有水课的样子，到最后突然在成绩上给同学们打击谁心里都不舒服，只能说老师不太近情理
61868,3664,刘嘉斌,2017-11-21 10:23:01,1,4,3,被正态了。。。。79分
62070,3664,刘嘉斌,2017-11-22 10:32:38,1,2,1,老师很近人，给分还可以吧，不过上课很水，没学到什么东西
62076,3664,刘嘉斌,2017-11-22 10:46:26,3,3,0,贼无聊
62079,3664,刘嘉斌,2017-11-29 16:46:45,0,1,1,真不咋地
62505,3664,刘嘉斌,2017-11-25 14:05:24,0,1,1,给分真的很迷啊明明很认真在做课程很水给分是玄学
62813,3664,刘嘉斌,2017-11-27 04:55:10,1,2,1,一直说闭卷 考试当天突然开卷\n\n黑人问号？？？
63430,3664,刘嘉斌,2017-12-04 02:38:30,2,5,3,老实说这老师人还是很好的，这门课也算是有趣，不过作为水课确实难以学到一些真东西，给分有些迷，不过认认真真我还是知道很多同学上了4的。。。
64183,3664,刘嘉斌,2017-12-21 08:31:45,7,7,0,千万别选
66348,3664,刘嘉斌,2018-01-15 08:07:02,-3,2,5,很好的老师，课水，但老师人超好
80909,3664,刘嘉斌,2018-07-02 15:18:50,-4,1,5,老师人很好
82339,3664,刘嘉斌,2018-07-08 02:37:02,1,2,1,老师很善良上课也很风趣。而且确实能学到点东西。而且给分不算差很知足了。总之感激！
82491,3664,刘嘉斌,2018-07-08 10:33:04,1,2,1,? ? ? 上课很水，但是会抽人起来回答问题，给分很迷，两次课堂大作业，早知道当初就跟同学一起就退课了
83240,3664,刘嘉斌,2018-07-10 03:25:32,-1,1,2,慎选吧
84609,3664,刘嘉斌,2018-07-13 10:00:02,0,1,1,还不错
93032,3664,刘嘉斌,2019-01-07 04:40:25,-1,1,2,给分查 考试难
120312,3664,刘嘉斌,2019-11-28 03:47:12,2,6,4,上课就是点名点名点名，说是小组展示有加分，我们组上去展示了，然后最后几点3都没有上（同组三位一样的悲惨命运），不懂这个sb老师是怎么给分的，早知道一开始把课推了，这课一开始人就很少，好选上也是有原因的。反正不推荐，给分不仅迷还低
123770,3664,刘嘉斌,2020-06-14 04:14:17,4,6,2,从来不回学生消息，跟个zz似的，请问您是穿越过来的嘛？
127896,3664,刘嘉斌,2020-11-30 02:38:43,17,18,1,性能课，喜欢打一些尬而不形象的比喻
128220,3664,刘嘉斌,2020-12-14 02:45:46,13,16,3,槽点太多，不知从何喷起
129820,3664,刘嘉斌,2021-01-12 14:15:02,15,19,4,这老师讲课云里雾里的……当然他的助教更矬……
132424,3664,刘嘉斌,2021-02-01 12:27:40,20,21,1,宁讲课和给分还能再烂一点吗？
134505,3664,刘嘉斌,2021-03-30 10:27:45,10,11,1,实验要求太变态
143399,3664,刘嘉斌,2021-11-25 04:54:48,-11,7,18,老师很好(✪▽✪)\n\n之前一直没有评分是因为还没出分，看到大家说评价不好有些不安，今天出分很惊喜～希望看到这里的同学不要太犹豫啦，我高中没学化学都能接受欸
143606,3664,刘嘉斌,2021-11-28 14:11:14,17,19,2,少有的上台展示组了，ppt全我做的，给分还那么烂，闭着眼睛打分。快跑，别来，求是精神就是这样子的吗？
184211,3664,刘嘉斌,2023-12-13 05:47:19,4,8,4,性能作业给分还能再烂点吗( *・ω・)✄╰ひ╯
203128,3664,刘嘉斌,2024-11-17 06:27:53,2,2,0,老师经常会课上到一半点名，一学期二到三次，喜欢逃课的快跑，期末无考试，打分全看点名和ppt，楼主4.5飘过，会做ppt且愿意认真做作业的推荐
210682,3664,刘嘉斌,2025-01-09 16:37:01,0,2,2,点名，平时分差，但是其他还好
213881,3664,刘嘉斌,2025-01-21 06:04:15,8,9,1,客观来讲，老师课讲的还行，但给分极不合理。\n\n平时分由作业分+点名+PPT展示组成，其中作业占比很大且每年题目几乎不变，扣分严重（某次作业甚至大多数人都是总评1/5），且存在主观臆断；点名经常在课间点名，建议不要翘课，老师一般会提前几分钟下课；PPT是否展示凭老师主观选择，展示组和不展示组分差大，最终大家平时分平均会被扣10分且老师非常求是不调整。\n\n考试今年改革，是24分填空+36分不定项选择题+40分大题，填空是正常知识点，不定项选择题一个3分，部分考得偏难怪（正常很难复习到的那种），大题基本来自历年题和平时作业题思考题，最后考完大多数同学分数都不理想，最高分仅87分。\n\n另外最后总分应该就是按照平时分+卷面分来算，没有别的算法。\n\n建议平时作业认真完成，多找找往届资料对下（尤其是计算题），PPT做的不一定要内容丰富但一定要美观，考试今年改革结果非常失败不知道以后会不会再改，如果给分不合理建议多向老师反映（虽然不一定有用
213883,3664,刘嘉斌,2025-01-21 03:47:37,8,10,2,不想说什么了，喜欢搞改革？改了个？？试卷是全新的，平时分是不合理的，提出的意见是踢皮球的，分高分低无所谓了，就这还tm配当老师？作业题是不换的，PPT评分是主观的，小组安排是离谱的，你要不会上课可以不上，知道你想评优秀，就这？拿学生的成绩开玩笑？
213893,3664,刘嘉斌,2025-01-21 04:47:41,8,9,1,点名是频繁的、给分是烂透的、自己主见是没有的、在学生之间煽风点火是必要的，在考试周天天搞投票表决2/3是为了彰显自己的存在感？改成哪样您没点主见吗？？
213899,3664,刘嘉斌,2025-01-21 05:32:27,3,6,3,优点：讲课还行，上课会提一提斗罗大陆什么的\n\n缺点：1.平时分给分巨烂，而且极其不合理。最好的同学和班级平均分能差9分，注意是总成绩里的9分，折合成绩点0.9。最高和最低平时分差32分！平时作业分非常影响成绩，而且因为老师巨懒，从来不改作业题，一定要找往年学长要答案！\n\n2.老师出尔反尔，拿同学的信任开玩笑。平时分给出后有同学认为不合理，并且提出开根乘十拉小差距的方案。之后老师要求投票，超过三分之二通过实行。票投了，也符合要求了，老师自己甚至都在群里明确说明同意了，之后却开始反悔。而且反悔的方式非常恶心，自己不明确说，而是踢皮球。拿少数同学的其他方案的意见来当挡箭牌，说什么“看来同学们的意见还没有达成一致，欢迎继续讨论”。这句话提了好多次，并且把自己抛的一干二净。最离谱的，在考试周大家都在复习的时候还在反复提，还说要重新投票，影响大家复习，最后有同学考前一晚群里对所有提出的方案再次发起投票，开根乘十再次超过总人数三分之二，投票人数的四分之三，然后老师当鸵鸟，最后按照原来的方式给成绩。\n\n3.期末周回答问题非常水，极其不认真。本人问了两个问题，都是有图片有文字描述的清晰问题，老师的回答惜字如金，没有一次超过一行，并且隔着好几天才回。不过这个可以理解，比较大学老师本职工作还是搞科研评优秀。
213910,3664,刘嘉斌,2025-01-21 08:24:13,0,3,3,平心而论，课上得还行，但是平时分给得4000+了。
213942,3664,刘嘉斌,2025-01-21 17:34:41,2,4,2,6的，给个1分，不多说了
214085,3664,刘嘉斌,2025-01-23 14:56:33,11,11,0,假君子比真小人更让人厌恶
214765,3664,刘嘉斌,2025-02-17 15:22:43,3,6,3,第一，如果要改平时分政策，为什么不在上课初期就定好？考试周假惺惺搞改革投票是什么意思？\n\n第二，有同学提不公平的建议，你就拿出来投票，三分之二通过就推广，那我说大家都满分，不要考试了，谁不同意？投票通过就真的能实施吗？如果不能，为什么要假惺惺搞少数服从多数？作为老师你没有自己的判断吗？作业搞出来的分差为什么要拿拉平点名和大作业的分数来弥补？那我次次都来，大作业做的好点得来的那几分还有什么意义？如果早知道你会搞这种投票采纳这种提议，我少来一次或者随便敷衍下大作业不就得了，你是想助长这种想法吗？\n\n第三，我很赞同那句话“假君子比真小人更可怕”，以为自己特别民主吗？以为投票表决就能讨好那些投了票的莫名其妙获利的多数人？现在的最新评论都看出来是他们写的吧，这就是你想要的？他们赞美你了吗？\n\n就这样，材料性能二，懂得都懂
215980,3664,刘嘉斌,2025-03-08 16:05:53,3,3,0,控到2/3
219271,3664,刘嘉斌,2025-05-23 15:08:07,0,0,0,懒得喷
30061,3688,金传洪,2016-07-01 01:22:26,-4,2,6,我们的班主任(๑• . •๑)
65688,3688,金传洪,2018-01-08 08:38:27,7,9,2,绝对的好老师
92322,3688,金传洪,2018-12-27 17:49:15,-1,2,3,金老师很愿意帮助同学们的，好老师
125159,3688,金传洪,2020-09-02 11:12:00,1,3,2,老师课讲的超级清楚，人也超级好
130051,3688,金传洪,2021-01-16 02:30:54,-4,1,5,还不错，要是能连贯一点就更好了
184400,3688,金传洪,2023-12-19 02:32:38,1,4,3,抱负激情的老师，讲课很清楚
185583,3688,金传洪,2024-01-02 12:09:14,-3,2,5,老师讲课很清晰很有激情，就是英文ppt学着有点难受
189196,3688,金传洪,2024-01-22 09:59:55,7,8,1,(๑ó﹏ò๑)
211849,3688,金传洪,2025-01-12 16:44:25,2,4,2,给分好，人也好
91488,3799,彭华新,2018-12-11 12:10:41,4,10,6,老师很好，科研大牛但平易近人，很替学生着想，上课认真，内容全面，不生搬硬套PPT，很好！
70874,3955,刘艳辉,2018-01-27 16:08:05,14,21,7,呵呵哒，形策给分和屎一样
71430,3955,刘艳辉,2018-01-28 12:26:01,9,10,1,不好，给分极差
71760,3955,刘艳辉,2018-01-29 02:48:20,0,6,6,。。。\n\n
75541,3955,刘艳辉,2018-03-13 06:21:24,6,9,3,2.4。。。。\n\n
79180,3955,刘艳辉,2018-05-25 16:57:20,7,9,2,非常的，laji
81270,3955,刘艳辉,2018-07-04 13:15:06,0,5,5,两个字 laji
82431,3955,刘艳辉,2018-07-08 09:35:08,8,13,5,垃圾中的战斗机，浙大最垃圾的老师没有之一，压堂到九点，官僚作风严重，看到这么多人骂她我就放心了
82712,3955,刘艳辉,2018-07-11 16:11:40,2,5,3,还行吧
84129,3955,刘艳辉,2018-07-12 05:51:39,-21,6,27,给分很准，与付出成正比
84149,3955,刘艳辉,2018-07-12 06:43:56,-14,4,18,给分没有想象中的查，感觉没太绩杀，但是上课一般般，官腔有点重，勉强及格吧
84430,3955,刘艳辉,2018-07-12 23:54:15,-12,7,19,还行吧，不会太严厉，给分也没有想象中的绩杀，认真背还是能上4的
91624,3955,刘艳辉,2018-12-16 12:43:42,6,10,4,自己明明什么东西都没有 非要装模作样搞事情  还随堂小测 课堂讨论  拖堂  全体起立  shadiao
92683,3955,刘艳辉,2019-01-03 15:12:55,8,11,3,终于可以评分了，这个人给分极差，形策16级全班没有上四的，上三的就得仰望了
104338,3955,刘艳辉,2019-07-04 03:03:22,-22,7,29,不知道为什么只有4.2\n\n
112367,3955,刘艳辉,2019-07-05 16:20:39,1,4,3,。。。
128495,3955,刘艳辉,2020-12-23 11:15:47,-2,1,3,傻逼东西
130124,3955,刘艳辉,2021-01-17 13:27:03,2,4,2,很严格 要求又多 寒假留作业还教我们怎么卷 多好一老师😊
138237,3955,刘艳辉,2021-07-08 06:11:49,-1,1,2,以前不相信老师与老师之间的差距会这么大，觉得只要自己努力，总能拿到一个理想的成绩。
141752,3955,刘艳辉,2021-10-24 12:02:14,0,2,2,上课让大家把手机电脑都收了 在底下转 讲的很认真 但是这水课上得和小学生一样干嘛？？想水的快逃 我受不了
155381,3955,刘艳辉,2022-06-16 15:03:49,1,3,2,给你刷十分不要绩杀我求求了
156754,3955,刘艳辉,2022-06-21 01:59:23,3,3,0,给分没有想象中差，但是上课不能看电脑就很难受
164166,3955,刘艳辉,2022-12-18 15:23:40,6,8,2,删回放的操作，真的是闻所未闻，不明白目的在哪
169304,3955,刘艳辉,2023-02-25 10:03:51,2,4,2,正在写让人无语的作业
175800,3955,刘艳辉,2023-06-26 17:22:17,2,3,1,字写得多还比室友低十分？？都不会啊？？？
176191,3955,刘艳辉,2023-06-28 04:18:37,0,2,2,这是一门我上的最恶心的课，十多个人的小组作业，闻所未闻，最后还是我自己一个人做完的，只能说，形策选个好老师比自己刷题更有用
176207,3955,刘艳辉,2023-06-28 05:12:00,1,3,2,给分不错，纯裸考，一分钟都没看，考试的时候乱写写满，最后91/4.5
191405,3955,刘艳辉,2024-04-19 11:27:27,-1,2,3,形策本来就是矢。形策+lyh就是矢中矢。建议取消形策，直接并入思政和军理课中去。90%的学生上这门课不会有任何收获。
194941,3955,刘艳辉,2024-06-26 03:56:31,-2,1,3,上课很无聊，但这应该是形策课常态吧。事情不多。唯一的槽点其实就是不让人坐最后一排，可能会管你玩电脑，但也没那么严，最后给分其实还行（与相同评分的老师相比）
125315,3986,吴琛,2020-09-06 12:51:56,2,4,2,相比之下，您的ppt真是令人舒畅（指材化）
126415,3986,吴琛,2020-09-25 08:34:50,1,2,1,吴琛老师很可爱！！！
151852,3986,吴琛,2022-03-18 00:43:19,2,3,1,老师讲课条理清楚，ppt逻辑和顺序让学生易懂，而且老师讲话清晰，不会有听不清的情况，声音清楚就不会有想睡觉的情况。超级喜欢老师！（虽然疫情上网课没见过老师）
159448,3986,吴琛,2022-07-20 12:43:05,0,1,1,上过吴老师的研究生课程，用心参与的话会有很大收获
168426,3986,吴琛,2023-02-16 03:45:38,0,1,1,真不错，真好
182299,3986,吴琛,2023-11-14 09:09:32,1,1,0,讲课很清晰明了
218889,4037,崔元靖,2025-05-11 11:46:36,1,1,0,无聊。。。。。。
72019,4099,林文平,2018-01-29 08:15:11,6,6,0,interesting
79132,4099,林文平,2018-05-24 01:17:53,3,4,1,娘娘腔
79133,4099,林文平,2018-05-24 01:18:26,2,3,1,听狼外婆的课真特么享受
79748,4099,林文平,2018-06-13 08:23:36,1,4,3,被他军训就等死吧
83629,4099,林文平,2018-07-11 00:54:28,2,3,1,呵呵呵
84734,4099,林文平,2018-07-13 16:21:22,-4,3,7,很用心的很有理念的老师，短时间可能感觉严厉，长时间接触会发觉真的很好很好
108759,4099,林文平,2019-06-29 15:16:25,0,1,1,狼外婆?皮
109453,4099,林文平,2019-06-14 16:23:27,0,1,1,辣鸡鬼鬼
111094,4099,林文平,2019-06-29 15:16:24,1,2,1,lwp凭什么4分
127571,4099,林文平,2020-11-24 13:02:47,2,2,0,欢送教官时候骂全连
95776,4128,张辉,2019-01-20 04:34:04,0,2,2,晶体生长基础赞
130048,4128,张辉,2021-01-16 02:20:51,1,1,0,晶体生长基础棒
145976,4181,杜淼,2022-01-04 18:14:58,-3,0,3,怎么会有这么臭的ppt！
74605,4270,王勇,2018-03-04 14:30:54,1,1,0,讲的略快，是因为本来课程内容就多。
75608,4270,王勇,2018-03-14 03:54:07,2,2,0,无聊的很
76603,4270,王勇,2018-04-16 06:30:47,4,4,0,讲得不是很透彻，ppt结构也有点乱，当然量子力学本身也不是很好学
86997,4270,王勇,2018-09-20 02:05:53,17,19,2,我们为什么要学材尿物理？材尿物理有什么尿？
87876,4270,王勇,2018-10-16 15:03:54,1,2,1,讲的听不懂
97078,4270,王勇,2019-01-21 15:48:48,-5,1,6,很好，很有收获
117629,4270,王勇,2019-09-27 02:19:27,4,5,1,zz老师
132385,4270,王勇,2021-02-01 08:49:11,2,3,1,材料物理，听课觉得不太行\n\n但考试考到一半，说“我想再重复一点，我讲过了，某题应该怎么怎么做，解答可以这么解答”云云\n\n给分是三个老师给分，所以难讲总分与他关联，人品（指考试现场捞人）感觉还可以
162415,4270,王勇,2022-11-22 02:41:40,3,3,0,对啊对啊😀
186917,4270,王勇,2024-01-13 13:58:24,0,0,0,老师讲的很好
188567,4270,王勇,2024-01-19 09:11:02,0,0,0,刚玉泉的同学
208721,4270,王勇,2025-01-15 03:01:41,1,1,0,讲课依托，出分巨慢
209946,4270,王勇,2025-01-07 13:50:23,0,0,0,上课难听懂
213560,4270,王勇,2025-01-18 07:52:57,5,5,0,量子力学部分确实有些东西比较抽象，老师讲得不是特别清楚，三个老师里面，他的ppt是最乱的（），但期末考试这部分就是嘎嘎默写历年卷
74270,4302,徐刚,2018-02-08 15:13:45,-2,1,3,没有人吗
76608,4302,徐刚,2018-04-16 06:53:07,1,2,1,教工程材料的，上课有点无聊，会点名叫人回答问题。但给分很好。
102592,4302,徐刚,2019-02-11 18:30:10,-1,1,2,emmmmmm既然没人写那我来写第一条吧。本人材料学院，上过徐刚老师18年的工程材料，韩院长只是挂名，不会来上课的。说实话上课基本没听过（我估计听的人也不多），徐刚老师上课真的是很无聊…但是这门课内容很多，而且大多数以记忆性为主，个人并不建议材料学院的朋友们在课那么多的大二上学期选这门课。但是这门课其实还挺不错，让我一个材料学子真正的了解到很多材料的特点和特性，大概比较适合作为材料学科的启蒙课程吧（？）…给分从学习帝来看似乎给分并不太好，但是我期末临时认真看了PPT（虽然没记住多少）的情况下还是能拿到4.5，不过期末复习的时候心态确实是有点崩的…
131828,4302,徐刚,2021-01-29 04:23:46,-2,1,3,新材料与现代科技   绩杀\n\n吐了\n\n不用整那些没用的。不要找新材料！千万不要！\n\n你只要讲基础的就行。和新材料没关系\n\n一定要和老师多私聊打好关系。不然你凭本事只能被绩杀！
161864,4302,徐刚,2022-11-14 14:49:55,0,0,0,上课确实无聊，不考试，一篇论文一个pre，不用和老师攀关系也不用听课，好好摆烂就能上4.8，给分超好
163275,4302,徐刚,2022-12-12 02:37:57,0,2,2,pre、课堂作业、课堂点人提问、课后作业、课程论文、考试全部拉满，没见过这么恶心的，上的课本来就无聊至极，还整得一套一套的恶心人，狗都不听
167365,4302,徐刚,2023-01-15 15:52:24,5,5,0,上的是新材料与现代科技，老师人很好👍
167392,4302,徐刚,2023-01-16 02:45:06,2,3,1,新材料与现代科技，老师挺随和的，一次展示+论文，最后给分不错。
190753,4302,徐刚,2024-03-18 00:22:25,0,0,0,事少给分好 新材料与科技
103654,4359,陆赟豪,2019-03-04 00:14:49,1,2,1,上课念ppt，语无伦次，一言难尽。\n\n本来以为选上了王浩华老师的课，结果是挂名呵呵，还是一个第一次上大物的老师。?
103659,4359,陆赟豪,2019-03-04 01:24:20,0,2,2,全程念PPT，语气毫无波动，
108488,4359,陆赟豪,2019-05-27 01:36:47,3,4,1,真的没学到什么东西，除了读ppt还是读ppt
109192,4359,陆赟豪,2019-06-11 11:23:24,0,2,2,非常好
111898,4359,陆赟豪,2019-07-03 02:19:39,-2,0,2,OK，
112065,4359,陆赟豪,2019-07-03 11:15:03,1,3,2,大物靠自己叭，基本物理老师都这样，貌似会捞人，还是有人情味的
112066,4359,陆赟豪,2019-07-03 13:02:27,0,1,1,虽然教学能力很差，毕竟是第一次上课，但是会海底捞人，过得去吧
113303,4359,陆赟豪,2019-07-06 05:02:32,3,5,2,我大雾课没听过，但为了交作业或者签到哪怕是早八我也会去，到也签了，作业也交了。。。20给16，我的平时分是被拿去捞人了么？
122916,4359,陆赟豪,2020-04-21 00:07:16,6,6,0,老师很烂 感觉自己都不怎么会，PPT漏洞百出，很多符号都有问题 然后自己还平淡无奇地念过去自己都不知道错了。。这样老师怎么教？
134671,4359,陆赟豪,2021-04-08 06:53:05,5,5,0,上课讲得非常不清楚，时常疙疙瘩瘩，听得非常累还听不懂
136147,4359,陆赟豪,2021-06-11 10:01:44,1,3,2,来自大物丙。老师很温柔，语气很平和。但是课讲得比较差，而且对课堂节奏的把握不好。仔细斟酌吧。
136241,4359,陆赟豪,2021-07-03 14:13:18,13,15,2,讲课很无聊，自己讲自己的，就念PPT，钉钉问问题也懒得回，已读不回我真服了。线上线下两副嘴脸。赶快结课吧，这样的老师是咋进来的
136548,4359,陆赟豪,2021-06-21 01:19:08,11,12,1,虽然老师科研水平很高，但真的不适合教书。啊这…真的，大雾丙是什么地位老师心中无数，ppt上的题目难得一批真的不是在刁难我等学高数的医学生么😅课后钉钉问他题已读不回，我说解决了给我发👏👍我：？？？我需要的是鼓励？？平时分如果课堂不发言也不给满，我可****，第一次在自然科学课上见到设置发言分的，乌鸡鲅鱼。选上了快逃，讲课声音也贼不清楚。
151062,4359,陆赟豪,2022-02-22 12:31:55,1,1,0,还可以
157000,4359,陆赟豪,2022-06-21 13:37:48,0,2,2,老师讲课就是念ppt，纯靠自学，一个学期一无所获。上课也没有热情，对教书漠不关心，对学生也很冷漠，也没什么师生情。但是助教很好，解答很耐心。
170944,4359,陆赟豪,2023-03-13 05:28:56,5,7,2,他的课真的好睡，昏暗的灯光，淡淡的讲解，听不听都不会的题目
177028,4359,陆赟豪,2023-07-01 07:42:41,1,1,0,😅😅😅
177095,4359,陆赟豪,2023-07-03 01:24:57,0,1,1,给分不太好没啥师生情，上课就是emm就是额很雾里，对，很物理
179454,4359,陆赟豪,2023-09-16 06:33:13,0,1,1,第一节课就说可以不来教室，我去看病都是逃他的课(不要学我)，偶尔get到他的冷笑话会觉得好好笑，大物丙确实是考前突击刷题就行(虽然我分不高😭)
190847,4359,陆赟豪,2024-03-21 10:43:04,0,1,1,很物理\n\n很无力
194873,4359,陆赟豪,2024-06-25 19:19:14,0,2,2,老师讲课真的不怎么样
219769,4359,陆赟豪,2025-06-05 10:49:42,-2,0,2,1分奉上，听了一学期物理学习方法，除了听扯嘴皮啥都没学到。天天这题简单、那题简单，没看出来您有多大能耐
221399,4359,陆赟豪,2025-06-23 08:15:38,1,1,0,说实话老师讲课没有很多人在听，讲课声音比较小，课上似乎还会穿插一些冷笑话，总之他的课很适合自习\n\n老师的小测水水的，感觉周围的人平时分都拿的挺高的，推荐喜欢自学的同学选他的课\n\n大物丙这门课感觉还是自学效率更高，考前刷个5、6套历年题基本就差不多了，平时也没有必要花很多时间
221770,4359,陆赟豪,2025-06-26 06:52:49,1,1,0,前沿专题给分很好，人很儒雅，陆老师yyds
116315,4372,王宗荣,2019-09-08 07:10:09,-3,3,6,棒棒棒
125934,4372,王宗荣,2020-09-16 01:46:28,4,7,3,就这就这?
152714,4372,王宗荣,2022-04-18 20:33:28,6,7,1,sb老师
153612,4372,王宗荣,2022-05-06 02:46:27,10,10,0,快逃！别来！
162340,4372,王宗荣,2022-11-20 11:56:24,2,2,0,转到航院了吧，我只能说懂得都懂，能润的快润
130052,4763,田鹤,2021-01-16 02:31:43,-1,0,1,讲课可以，课件不太行，全是图片
185512,4763,田鹤,2024-01-01 07:16:44,1,1,0,英文课件有点难顶
189146,4763,田鹤,2024-01-22 07:14:10,0,0,0,@_@
71865,4849,杨倩,2018-01-29 04:50:14,23,34,11,这是我所有课程拿最高分的一门课了，上课不水，还有国王游戏，没有考试，职业生涯规划书要好好写
71871,4849,杨倩,2018-01-29 04:57:31,13,17,4,老师太棒了!给分超级好，人超级温柔，作业也不多!啊，超棒的大姐姐
71878,4849,杨倩,2018-01-29 05:03:24,13,17,4,老师超棒哇，女神老师很温柔。，职规课真的挺有用，会有平时作业，但是作业内容本身对我们很有帮助～第一门满绩，谢谢老师！
71879,4849,杨倩,2018-01-29 05:03:35,3,11,8,老师很亲切，人超级nice，最后期末是小组展示，绩点很不错der
71880,4849,杨倩,2018-01-29 05:04:04,8,13,5,老师很漂亮很温柔，上课形式很有创意。给分也挺好的。
71883,4849,杨倩,2018-01-29 05:05:08,7,11,4,绩点目前最高～就是生涯规划书不太好写，只要肯花时间都能拿到不错的成绩的
71884,4849,杨倩,2018-01-29 05:06:38,5,10,5,杨老师人很优秀的，上职规课是很棒的体验。课上基本都会有讨论，课后作业虽然有点麻烦，但认真做之后发现都挺有意义的。还有老师人美声音甜。
71886,4849,杨倩,2018-01-29 05:07:40,1,7,6,好看又温柔，事少给分好。写好职规报告，上课发几次言，4以上妥妥的！
71887,4849,杨倩,2018-01-29 05:08:08,6,10,4,生涯规划书占比很高要好好写 认真完成作业? 点很不错  上课老师也是用各种办法调动我们的积极性 很不错的老师
71890,4849,杨倩,2018-01-29 05:08:50,2,7,5,杨老师宇宙第一好!对同学认真负责，教学方法很独特，上课会领着做游戏，很有趣也能让我们学会很多东西。最后给分还特别好!
71897,4849,杨倩,2018-01-29 05:14:11,3,5,2,杨老师超耐心、对人超温柔，上课的形式很丰富，跟同学们的关系也很好。重点是给分高!强推啊!
71901,4849,杨倩,2018-01-29 05:16:48,2,5,3,老师真的超温柔，期末考核也很轻松。
71912,4849,杨倩,2018-01-29 05:35:11,4,5,1,老师人很好的，上课用的PPT也很丰富，作业可以接受，给分好啊(敲黑板)
71948,4849,杨倩,2018-01-29 06:27:37,0,4,4,不错，分最高的通识
72376,4849,杨倩,2018-01-30 03:59:42,4,5,1,很棒的学姐哦~上课有趣给分高
72904,4849,杨倩,2018-01-31 09:50:13,0,3,3,觉得是个很好的老师啊，
74527,4849,杨倩,2018-03-03 03:10:51,1,2,1,老师上课很好，给分也挺好，就是职业生涯规划书有点难写，不过得到那么高的分数也是应该的。
75175,4849,杨倩,2018-03-08 01:26:53,43,55,12,她把我人生中的第一次\n\n\n\n\n\n\n\n\n\n\n\n满绩\n\n夺走了
77748,4849,杨倩,2018-05-07 13:34:26,1,5,4,职业生涯规划，老师是研究生辅导员，给我们请了非常优秀的硕士生博士生做分享，上课互动比较多，老师还会记得很多同学的名字，人很好，有耐心，给分也高。
78623,4849,杨倩,2018-05-15 01:04:31,-10,5,15,这么轻松就满绩了，感觉好没有成就感…
78675,4849,杨倩,2018-05-14 10:58:45,0,4,4,老师水平还行，给分还行，但是她似乎觉得不善在陌生人面前表达自己对所有人而言都是一种必须克服的缺陷。这点我十分不赞同。
78686,4849,杨倩,2018-05-14 12:35:54,3,4,1,首先定位是女神老师，认真负责，上课很有趣，她在讲医院里的经历时流下的眼泪我永远都不会忘
78711,4849,杨倩,2018-05-14 16:16:42,3,6,3,老师给的分实在是太好了，心超软超温柔，职业规划书一定要花时间写，最后展示积极参与，轻松满绩
78718,4849,杨倩,2018-05-15 00:15:59,2,5,3,杨老师的课内容非常充实\n\n尤其是最后一次面试经验的教学，对我帮助很大，比较系统地讲解了面试的注意事项，要点。\n\n老师回答问题特别耐心。\n\n课堂上的各种活动也非常有意思啦，国王与天使这个活动特别暖心～\n\n赞！
78727,4849,杨倩,2018-05-15 01:27:59,1,3,2,不错，就是感觉没有收获
78739,4849,杨倩,2018-05-15 02:54:44,-1,1,2,老师超级好！上职规课收获很大！绩点也很高！
79511,4849,杨倩,2018-06-07 13:51:19,2,3,1,女神老师，不接受任何反驳\n\n
79933,4849,杨倩,2018-06-15 11:00:44,-2,1,3,还可以
80575,4849,杨倩,2018-06-28 04:20:55,-1,3,4,女神老师啊，给分太好了！！！！\n\n
80749,4849,杨倩,2018-06-30 09:35:59,-1,2,3,办活动请过一次假\n\n绩点4.5
90803,4849,杨倩,2018-11-26 07:09:57,3,4,1,女神！
91655,4849,杨倩,2018-12-17 09:43:55,-6,2,8,男神！
94422,4849,杨倩,2019-01-16 11:39:12,5,8,3,特别好的老师，会给我们找学长学姐分享！可能很多人觉得蔡云老师的职规课的形式更有意思，更有利于加强同学之间的联系。但是我觉得，就这样平淡一点挺好的，整个氛围很轻松，老师很和蔼，就很好(✪▽✪)。给杨倩老师打call！
101303,4849,杨倩,2019-01-28 03:54:33,0,3,3,老师很温柔 很知性 上课条理很棒 内容不错形式也新颖 必须满分！
101915,4849,杨倩,2019-01-29 16:02:39,5,7,2,作业都认真做了，不知道为什么给分这么低。。。。。。无语
101919,4849,杨倩,2019-01-29 16:17:06,7,15,8,不是很明白emmm\n\n老师上课还行，但是出分好晚。作业都认真做了，也没有缺过席，职规报告书也认真写了，给分确是出乎意料的差。是真的没有想到(*꒦ິ⌓꒦ີ)伤心?
101927,4849,杨倩,2019-01-29 18:30:17,4,7,3,给分比想象的低....
103358,4849,杨倩,2019-02-27 12:43:12,2,2,0,不错呦
104442,4849,杨倩,2019-03-20 16:02:23,2,4,2,其实客观来说老师还可以 但没有想象中那么好 其实是个蛮严肃的老师吧 还有一点就是作业有点多 而且上课有一点点无聊？看下面的同学听课的越来越少了
104511,4849,杨倩,2019-03-22 05:43:56,0,1,1,老师也太有韵味了吧…
106330,4849,杨倩,2019-04-26 11:01:31,3,4,1,美丽的杨老师啊\n\n您什么时候出分呀
106347,4849,杨倩,2019-04-26 13:15:41,-4,0,4,给分一般，但确实怪自己没有认真展示
106354,4849,杨倩,2019-04-26 14:37:19,-3,0,3,还行吧，但不适合我
106358,4849,杨倩,2019-08-20 14:47:18,-1,1,2,不太好，我哭了
106389,4849,杨倩,2019-04-27 03:14:58,0,2,2,舒服了
106470,4849,杨倩,2019-04-27 15:40:05,0,2,2,有一点点无聊，事情有一点点多(不过职规课都是这样的)，给分还可以
106495,4849,杨倩,2019-04-28 01:58:34,3,3,0,老师很好，上课也很有收获，但是考察制度有点问题，期末的小组展示占分太多，而且要求组内必须拉开差距（六分呃.......
106711,4849,杨倩,2019-04-29 04:51:52,-2,2,4,老师很温柔，讲课很用心，能学到很多。而且老师人超级好啊，我职规书提交的时候出了点小问题超时了，然后只能交到老师邮箱，老师也没有扣分，还给我满了！杨女神！
106888,4849,杨倩,2019-04-30 07:06:27,8,21,13,emmmmm想问一下大家这个均绩是不是真的
106969,4849,杨倩,2019-04-30 13:01:35,1,1,0,职规这门课吧 我也没指望学到多少有用的东西 但老师人好好 给分也好
113901,4849,杨倩,2019-07-08 00:11:05,1,2,1,太棒了
113904,4849,杨倩,2019-07-08 00:18:59,0,3,3,啊啊啊啊啊啊人生第一个满绩…小组展示的时候，看到杨老师一直在皱眉头心里特别紧张，结果给分这么好！！温柔严肃并济的女神
113956,4849,杨倩,2019-07-08 02:42:58,-2,1,3,喜欢杨倩老师讲课的方式，学长分享也很有用！作业用心做+一个靠谱的小组≈高绩点
113977,4849,杨倩,2019-07-08 05:37:31,-1,0,1,很认真做了职业生涯规划书 认真准备了展示 可最后不是很理想 有点难过但是我还是要落着泪夸杨老师 很温柔 很有韵味～
114229,4849,杨倩,2019-07-09 06:39:37,2,4,2,会被绩杀，慎选
120197,4849,杨倩,2019-11-23 13:50:52,0,3,3,给分好
120431,4849,杨倩,2019-12-04 15:16:33,1,4,3,还行吧，不适合我。我尽力了。老师女神，我不行
124227,4849,杨倩,2020-06-27 14:28:15,6,7,1,平时作业认真完成，职规书按照模版认真写，差不多就能满绩了！老师给分太好了，吹爆！
124409,4849,杨倩,2020-06-30 11:11:16,0,3,3,只要认真听课做作业，学到的东西会很多，而且给分超赞！
124976,4849,杨倩,2020-07-28 12:29:48,-2,3,5,老师确实好，各方面认真做，高分完全没有问题。
162410,4849,杨倩,2022-11-22 01:21:20,2,2,0,老师人很好，职规算事情少的了，给分也不错
162419,4849,杨倩,2022-11-22 03:48:37,0,2,2,期末展示以为凉了，结果满。谢谢老师！
179122,4849,杨倩,2023-08-28 07:37:52,-1,1,2,上的形势与政策，总体还不错。形策课基本没人听，大家都在写作业，她也不怎么管。\n\n不过最后好像全宿舍都卡绩了。
191200,4849,杨倩,2024-04-11 15:52:39,0,4,4,不理解老师为什么默认大家都应该会用职业规划网站，高年级学生事情真的很多，个人认为没有必要学会这个系统怎么用，自己传视频不就行了，不理解为什么一定要用网站上的模拟面试，不过不可否认的是老师讲的一些内容对于职业规划是有用的
195916,4849,杨倩,2024-07-01 00:48:50,1,4,3,形策课只突击了半个小时，给分好好\n\n在知道的形策老师中事情是最少的，只有全校都要做的两次任务，而且展示是自愿的
207502,4849,杨倩,2024-12-22 12:24:29,-2,1,3,选就完了
220690,4849,杨倩,2025-06-19 08:30:28,1,1,0,随机点名，形策给分好烂，卡绩了，避雷
221869,4849,杨倩,2025-06-27 03:53:43,0,0,0,这老师太好了，形策无脑冲
97124,4941,刘宾虹,2019-01-21 16:36:43,0,0,0,太水了
140172,4941,刘宾虹,2021-09-02 07:16:50,0,0,0,PPT做的太差了
142101,4941,刘宾虹,2021-11-06 02:53:09,0,1,1,能量储存材料排雷，能不选别选
142492,4941,刘宾虹,2021-11-12 07:17:23,0,0,0,先放结论：倾向于劝退\n\n考核方式是出勤、两次小作业、期末考试，占比好像没说。\n\n刘老师偶尔会点名。\n\n刘老师的作业是一篇英文SCI期刊非综述论文的评述，2000字左右（这个俺真的不太会写）。\n\n期末开卷考，都是上课讲过的东西，全是简答计算题，时间还是比较紧张的，我考完感觉还行，但是最后只有4.2\n\n劝退的主要原因就是刘老师讲课实在不咋地，课件做得极差，基本上全是从外文论文之类的地方照搬的图，文字量小而且大部分是英文。而且说话有种很奇怪的感觉，让人不是很想听ta说话，上课效率就会很低（虽然好像不能完全怪老师）。能不选还是尽量别选。
74285,5093,韩伟强,2018-02-09 05:55:31,12,13,1,emmmmm
85027,5093,韩伟强,2018-07-15 04:45:24,13,16,3,没见过这么差的吧
85028,5093,韩伟强,2018-07-15 04:46:55,20,23,3,这老师是人？
86920,5093,韩伟强,2018-09-19 11:31:59,17,18,1,希望能评上分吧\n\n我很想问:材料学院的老师，为什么不能评分？
87197,5093,韩伟强,2018-09-22 02:29:27,14,17,3,听课很难受
87286,5093,韩伟强,2018-09-26 14:59:21,27,29,2,求求您了做个人吧…
87287,5093,韩伟强,2018-09-26 15:01:33,38,41,3,放我们去自习好么？！
87288,5093,韩伟强,2018-09-26 15:01:43,19,23,4,念ppt我也会…
87289,5093,韩伟强,2018-09-26 15:03:14,14,16,2,emmmm
87300,5093,韩伟强,2018-09-27 00:21:02,9,13,4,怎么没有零分啊\n\n
87317,5093,韩伟强,2018-09-27 03:43:52,28,32,4,100%的同学认为该老师会在这节课小测…
87427,5093,韩伟强,2018-09-29 01:32:09,15,16,1,补觉时间
87433,5093,韩伟强,2018-09-29 03:20:27,18,21,3,“你们做ppt不能抄”但是解释一下你自己的ppt咋这么像中南大学发在百度文库的呢？小测题都一样？这是唯一一门我觉得老师可以放我们自习的专业课了
87434,5093,韩伟强,2018-09-29 02:37:48,20,23,3,没有一分，老师是真的差，念ppt，正着念倒着念都念的流利，低头看名单连名字都念不对几个
87435,5093,韩伟强,2018-09-29 02:42:14,28,29,1,上课就带了肚子。
87438,5093,韩伟强,2018-09-29 02:45:50,21,23,2,大家课程结束之后教务网评价老师不要顺手好评了
87439,5093,韩伟强,2018-09-29 02:46:41,16,18,2,-“老师你能不能解释一下balabala”\n\n-“没有时间（霸气摆手）这个你自己回去看书”“这位同学你回去北渡（百度）一下就可以了”\n\n\n\n是很想回去自己看书自学了，复读机老师放过我们吧求您了！
87440,5093,韩伟强,2018-09-29 02:52:07,19,20,1,每上一节课，评论++...还不见好评...每一条都想点赞，全员吐槽。他到底是怎么当上老师的？？？
87441,5093,韩伟强,2018-09-29 03:14:04,16,17,1,上课完全复读，提问即使答对了也说不对。提问也不回答。。。
87443,5093,韩伟强,2018-09-29 03:22:57,5,10,5,我就想看看打10分能把均分抬上1吗?
87444,5093,韩伟强,2018-09-29 03:23:44,18,20,2,北渡，北渡，惊起一滩鸥鹭
87446,5093,韩伟强,2018-09-29 03:28:59,8,11,3,浙大我上过的最辣鸡的老师，没有之一！\n\n真心辣鸡，他是怎么在浙大待下来的？
87447,5093,韩伟强,2018-09-29 03:32:51,6,9,3,求求你了换个老师吧
87448,5093,韩伟强,2018-09-29 03:33:55,10,12,2,求您去做科研吧，您真的真的不适合教书
87450,5093,韩伟强,2018-09-29 03:45:32,8,9,1,求求您放我们自习吧
87452,5093,韩伟强,2018-09-29 03:58:03,9,10,1,这样的老师 睡觉就好了 你们就别计较了
87454,5093,韩伟强,2018-09-29 04:04:22,9,11,2,态度实在太敷衍了
87456,5093,韩伟强,2018-09-29 04:12:26,8,10,2,大学以来见过的讲课最差的老师
87457,5093,韩伟强,2018-09-29 04:40:19,13,13,0,我可以把PPT读得更认真，只要五分之一工资，我可以来给学生上课吗？
87478,5093,韩伟强,2018-09-29 10:25:50,10,11,1,大家都别喷这个老师了，其实他还是有一个优点的，起码上完他的课之后，我听其他老师的课都十分认真
87484,5093,韩伟强,2018-09-29 12:35:58,8,10,2,琼射角，琪数\n\n听到过的点赞
87635,5093,韩伟强,2018-10-09 00:21:30,4,6,2,没上低分榜实在太可惜了
87790,5093,韩伟强,2018-10-13 12:29:00,3,5,2,没错的人类的本质就是。。。好吧至少不是卡壳的复读机
89517,5093,韩伟强,2018-11-19 11:10:53,2,5,3,emmm，睡了睡了
89712,5093,韩伟强,2018-11-20 11:23:04,3,5,2,垃圾老师
117638,5093,韩伟强,2019-09-27 05:58:10,7,10,3,老师很不容易的，你们别骂了。哦，我也骂了？那没事了。
119186,5093,韩伟强,2019-11-11 05:25:02,-1,3,4,没什么体验，因为实在太差听不进去
187496,5253,杨士宽,2024-01-16 11:02:00,2,4,2,讲的个啥呀，毫无头绪
202927,5253,杨士宽,2024-11-15 07:48:38,4,4,0,讲课讲着讲着就开始扯到其他东西，讲的也比较稀里糊涂，上课是真的无聊。\n\n也可能是材科基这门课本身就非常难绷（
213755,5253,杨士宽,2025-01-19 12:45:33,1,1,0,上课从不点名，但是有点水。喜欢扯一堆别的东西，好在扩散部分内容考的不是很多，重点会提醒你，非晶部分内容不少但是考的很少，建议多看ppt。如果他说某个东西你大概知道有这么回事就行，你也就不需要掌握
144803,5276,吴浩斌,2021-12-24 03:25:17,-3,3,6,男神!
149381,5276,吴浩斌,2022-01-15 08:04:18,1,3,2,上课完全按照书本讲，思路很清楚，逻辑很清晰
149984,5276,吴浩斌,2022-01-18 07:28:54,6,7,1,听得我稀里糊涂
167521,5276,吴浩斌,2023-01-17 03:34:57,7,8,1,第1次100٩(๑òωó๑)۶
171114,5276,吴浩斌,2023-03-16 06:44:23,2,2,0,不错不错
178117,5276,吴浩斌,2023-07-07 04:47:31,1,2,1,期末给分超好！物化还是啥也不会
178192,5276,吴浩斌,2023-07-08 00:43:10,0,2,2,期末给分超好，人总是是笑嘻嘻的，想要学懂需要课后认真复习，期末考比想象的简单
178243,5276,吴浩斌,2023-07-08 12:55:29,2,2,0,老师人很仁慈！期末专门出了120分的题（上限100分）留出20分的空间捞我们
179073,5276,吴浩斌,2023-08-27 12:12:32,1,2,1,上的物化基。讲课方面，我不是很能习惯，因为课程内容还是比较抽象的，而且要在一个长学期上完所有内容。whb老师的小测开卷，会给附加题，难度也适中。期末考试半开卷，出题不为难学生，还给附加题，很赞。偶尔点名。
199138,5276,吴浩斌,2024-09-18 05:07:51,2,2,0,上课能讲理论绝不举例…如果不是专业课快逃
131949,5323,张泽,2021-01-29 13:10:44,1,4,3,打开这个催化反应“黑匣子”，看清楚催化过程如何发生是科学界长久以来的梦想。经过近五年的研究，浙江大学电子显微镜中心张泽院士团队的王勇教授联合中科院上海高等研究院高嶷研究员、丹麦科技大学Wagner教授和Hansen博士等团队，在环境透射电子显微镜中，首次在原子尺度下一氧化碳催化氧化过程中观察到催化剂界面活性位点的可逆变化，并据此实现了界面活性位点的原子级别原位调控。这项成果对今后设计更好的环境催化剂、高效稳定地处理污染气体具有重要意义。\n\nhttps://mp.weixin.qq.com/s/wAkCfSMOQAmN_bk-unu9YQ
198195,5351,魏晓,2024-09-04 11:50:30,2,4,2,老师上课太好了
159677,5364,刘小峰,2022-08-23 05:29:58,1,12,11,教材料的。。。。
163350,5364,刘小峰,2022-12-13 11:48:44,1,6,5,啊，一开始是讲陶瓷历史，后来开始讲结构、材料那些深奥的东西就听不懂了，不过是开卷考！！！！！！！好吧我还没考，祝自己好运
166459,5364,刘小峰,2023-01-12 09:59:42,0,3,3,有幸上过老师的中国陶瓷与玻璃，客观来说，这门课不太适合人文社科的同学学习（因为会涉及到化学知识，确实很陌生）。但是老师人很好，比较佛系，考试也很简单，都是课内的知识，如果有问题，老师也会认真给你解答。
167657,5364,刘小峰,2023-01-18 06:11:24,10,13,3,老师的陶瓷与玻璃，美育课，上课不点名，可认真听可水。\n\n作业就一次小组展示和10道问答题，期末开卷考试，考前老师会把所有课件和期末考相关题目（覆盖考试内容的90％）发在群里。\n\n本人虽然平时上课很少认真听，但期末复习时通过反复阅读课件还是了解了很多知识，期末绩点也不错。
167665,5364,刘小峰,2023-01-18 07:40:43,-1,3,4,多的不说，事少分高
167703,5364,刘小峰,2023-01-18 12:23:01,2,3,1,刘老师人很好，遇到问题都会耐心解答，通识课任务相对轻松，期末开卷，给分也很高，yyds。
167787,5364,刘小峰,2023-01-19 05:20:29,0,2,2,还不错，讲的挺细致，内容有点深不过考试是开卷。事少分也好！
172350,5364,刘小峰,2023-04-25 08:51:19,-1,1,2,美育课是真的很好 短学期一次ppt展示十几个人一组很水。作业是十道大题，百度都有。期末开卷，打印ppt就行。最后给分也很好，4.8朵朵上也看到不少满的
183749,5364,刘小峰,2023-11-29 13:52:23,-3,0,3,刘老师的陶瓷与玻璃课讲课语调平淡，念PPT，声音小而且不用话筒，比较催眠，上课不点名，适合水课，不太适合认真听课，但是PPT做的很好很细致，适合用PPT复习
186876,5364,刘小峰,2024-01-13 10:18:25,1,2,1,考前来拜一拜，峰神保我！！
189078,5364,刘小峰,2024-01-21 15:22:37,-3,1,4,老师的美育课，事少分高。有三次作业，每次选做五道简答题，最后两节课是期末小组展示，最后还有一个期末开卷考试，考试的内容几乎全部来自PPT和考前发的复习题（我这次有一道题只找到了关键词，没找到详细内容），复习题这两年没有变，我直接找去年的同学要到了答案。平时有点名分，但是没点过名（不理解）。老师上课讲解PPT，lxf老师会扩展一些，但是ly老师基本上是照着PPT念，讲历史的部分还是有一定吸引力的，但是开始讲材料之后就有些无聊了。看得出来老师是用心做过PPT的，而且学识比较渊博。老师上课不用话筒，所以通过智云上课或者旁听是行不通的。最后给分还不错。
189286,5364,刘小峰,2024-01-23 01:26:15,-2,3,5,纯纯绩杀，给分超烂，大家不要选，期末开卷找不到。
189640,5364,刘小峰,2024-01-26 08:16:03,-7,0,7,真的绩杀，期末也不好找
203512,5364,刘小峰,2024-11-20 02:11:17,2,3,1,宝藏老师，给分超好
203807,5364,刘小峰,2024-11-21 06:54:08,-2,1,3,给分好，但是有时候上课有点催眠
135713,5391,王江伟,2021-05-20 12:04:25,5,11,6,建议备好枕头
214632,5463,陈宗平,2025-02-15 08:37:46,0,1,1,偶尔点过一次名。给分挺慷慨的。最后是做ppt汇报（材料湿化学）\n\n\n\n上课是念ppt，认真听能学到一点东西。自己上课看文献也行。
121781,5483,余倩,2020-01-22 01:24:33,-23,12,35,很有趣 老师也很活泼
122085,5483,余倩,2020-02-12 08:57:53,4,20,16,经常点名。上课生动有趣。期末给PPT。给分真不咋地。
125021,5483,余倩,2020-08-13 11:33:10,5,10,5,有好几次小测 上课之前喜欢点名 期末给PPT 给分一般
127160,5483,余倩,2020-11-11 09:28:02,12,23,11,很喜欢yby的一句话：gc她不是长得和你挺像的嘛
164135,5483,余倩,2022-12-18 10:12:31,53,58,5,蠢货一个
164180,5483,余倩,2022-12-19 02:20:42,4,10,6,(´O｀)
169759,5483,余倩,2023-02-27 17:33:50,9,14,5,感觉余倩老师的长相和气质有点像电视剧《狂飙》里的“大嫂”陈书婷……
170780,5483,余倩,2023-03-09 13:28:37,19,22,3,( っ'-')╮ =͟͟͞͞🏀
172720,5483,余倩,2023-05-05 05:11:09,23,27,4,蠢货没脑子
173120,5483,余倩,2023-05-14 00:59:21,34,35,1,混研纸质点名，很恶心
173905,5483,余倩,2023-06-04 09:08:49,40,42,2,混研司马
174606,5483,余倩,2023-06-14 12:43:38,35,36,1,混研很无语
178802,5483,余倩,2023-07-23 14:49:26,-39,5,44,很好的老师
180597,5483,余倩,2023-09-23 08:13:58,23,26,3,来当官的
181430,5483,余倩,2023-10-17 13:00:10,28,29,1,表现欲太强，体会一下上了一天课的学生的感受
184762,5483,余倩,2023-12-22 14:22:52,3,8,5,😀😂😅
185203,5483,余倩,2023-12-27 05:08:36,19,21,2,混研课疑似有点太辣鸡了
185601,5483,余倩,2024-01-02 14:51:35,19,22,3,混研喜欢自嗨
185798,5483,余倩,2024-01-04 12:35:14,22,23,1,一分都嫌多
188495,5483,余倩,2024-01-19 05:45:18,-51,5,56,满绩撒花，感觉罪不至此
189826,5483,余倩,2024-01-30 08:57:50,23,24,1,感觉脑子不清不楚的，明明科研听说还不错，也很有当官的前途，奇了怪了
189859,5483,余倩,2024-01-31 09:53:24,17,19,2,混合研讨学习班这个课程完全就是看老师和学生的关系，我们班主任给班里的几位当班干部的同学都打了很高的分，所以我们班干部学生基本都是4.5。以及这个老师上课完全就是瞎扯，不懂为什么要开设这门课程？
190176,5483,余倩,2024-02-24 08:10:22,11,14,3,lj
199481,5483,余倩,2024-09-24 11:09:08,16,19,3,上课飙英文，吹天吹地。自嗨姐，揪着她那2010年的science一作不放了。听感不太好。但有些建议还是值得听的。
200781,5483,余倩,2024-10-22 08:05:22,6,6,0,zhendelj
200782,5483,余倩,2024-10-22 08:06:04,9,11,2,混研是我上过最水最糟的课，没有之一。在这里你学不到任何想学的专业知识，明确不了自己的专业志向，纯纯浪费时间
203397,5483,余倩,2024-11-19 12:13:54,-2,3,5,幽默。。。
203398,5483,余倩,2024-11-19 12:14:18,-3,2,5,666
203402,5483,余倩,2024-11-19 12:23:26,6,8,2,中英混杂姐，“相信同学们一定听的非常excited”
203413,5483,余倩,2024-11-19 12:36:41,7,8,1,拖堂！
204542,5483,余倩,2024-11-26 14:05:03,11,12,1,strong姐，每次这strong姐一开口就令我极度不是。还喜欢讲各种没人听得懂的笑话，没人get到笑点还会生物。令同学恶心，让教授尴尬
206753,5483,余倩,2024-12-17 11:31:49,12,13,1,情商巨低，死装姐一个，无聊透顶的混研还要卷发言
207550,5483,余倩,2024-12-23 04:16:09,-12,4,16,讲的好
207591,5483,余倩,2024-12-23 07:43:27,6,8,2,遮沙避风了
208784,5483,余倩,2025-01-02 02:07:19,7,8,1,混研论文gs
210537,5483,余倩,2025-01-09 10:18:55,8,10,2,材科基讲得还蛮好的，重点明确
211807,5483,余倩,2025-01-12 13:52:54,8,11,3,材科基考点会反复强调，宝宝巴士
214094,5483,余倩,2025-01-24 01:54:41,9,10,1,恶心💩
215044,5483,余倩,2025-02-20 09:06:37,17,17,0,怎么说呢。我的期末大论文和neoscholar用了一个作业，在国际化课程上拿了92前10%，这门课3.5绩杀，是因为我脑出血住院请了两次假还是单纯因为我上课没发几次言？我也不知道应该说什么好了。
215048,5483,余倩,2025-02-20 10:03:05,13,13,0,它的给分是对我成绩单的侮辱
215050,5483,余倩,2025-02-20 09:45:35,13,13,0,全员3.5，真有你的
215052,5483,余倩,2025-02-20 10:27:43,13,13,0,混研没有缺勤，积极发言，混研喜提3.5，真好
215055,5483,余倩,2025-02-20 10:18:51,11,11,0,五级制+正态=3.8-的均绩！就算出个“84/3.9”也比出个“良好/3.5”好。以及这玩意基本只取决于班主任的给分（除非处于2.5和3.5的交界处），这简直就是在抽奖！！！
215075,5483,余倩,2025-02-20 15:16:49,13,13,0,史，Ambitious but SHITTTTTT!\n\n没什么别的想骂的了，她现在cls评分还能有1.6，在座所有混合的同学都有责任！
215076,5483,余倩,2025-02-20 15:21:28,10,10,0,现在还有1.6只能说上混研的诸位都有责任\n\n喜欢我入课就送良好3.5吗？
215077,5483,余倩,2025-02-20 15:23:43,7,8,1,纯史，就踏马春竹一个，3.5的给分踏马的怎么想的。
215078,5483,余倩,2025-02-20 15:38:40,5,5,0,助力收敛
215079,5483,余倩,2025-02-20 15:42:47,5,5,0,全员3.5，666
215083,5483,余倩,2025-02-20 16:05:49,3,3,0,你生活不如意吗
215095,5483,余倩,2025-02-21 03:36:44,5,5,0,诗人握持
215215,5483,余倩,2025-02-24 09:44:19,3,6,3,材科基教得很好
216600,5483,余倩,2025-03-19 05:10:21,14,14,0,有签到又有签退，签退的时候刚好在跑步，被同学打了四个视频还没有接，服辣
216601,5483,余倩,2025-03-19 05:10:41,0,0,0,无解了
221342,5483,余倩,2025-06-23 04:09:31,0,0,0,混研这个给分标准赤石去吧
205158,5488,李雷,2024-12-02 08:44:11,0,0,0,24新生之友，期待一下^_^
144806,5518,邓人仁,2021-12-24 04:18:38,8,11,3,老师卡文迪许实验室的!
149380,5518,邓人仁,2022-01-15 08:02:48,15,20,5,老师水平很高，但讲课略有一点青涩
171646,5518,邓人仁,2023-03-30 15:02:12,-1,2,3,老师看起来好年轻啊啊啊啊，站在讲台上像一个刚毕业的大学生\n\n但是真大佬！！！
179037,5518,邓人仁,2023-08-24 03:33:54,-1,2,3,帅老师，给分高
179038,5518,邓人仁,2023-08-24 03:33:54,-2,1,3,帅老师，给分高
179039,5518,邓人仁,2023-08-24 03:33:55,-2,1,3,帅老师，给分高
181031,5518,邓人仁,2023-10-05 14:19:37,-1,2,3,帅老师，给分好
190545,5518,邓人仁,2024-03-08 00:46:53,0,5,5,宝宝宝宝，你是一个可爱帅气的宝宝😘
199341,5518,邓人仁,2024-09-21 10:12:52,1,2,1,。。。
207551,5518,邓人仁,2024-12-23 04:18:29,-1,0,1,老师很好
217474,5518,邓人仁,2025-04-11 02:53:04,0,0,0,老师特别可爱，给分也好
192929,5669,朱晓莉,2024-05-31 15:55:52,2,8,6,我觉得挺好的
213443,5669,朱晓莉,2025-01-17 11:43:23,2,4,2,给班主任打高分
219232,5669,朱晓莉,2025-05-23 08:23:14,1,1,0,给分好，人温柔，可无脑冲
173667,6280,范修林,2023-05-31 12:03:47,0,1,1,好老师，给分也不错的
217896,6280,范修林,2025-04-17 15:27:01,3,3,0,材料化学讲得比较零碎，给分也很一般
218329,6280,范修林,2025-04-22 15:27:52,2,2,0,材料化学 出分心碎💔上课还行，老师人也挺好
124914,6289,程继鹏,2020-07-19 01:42:19,4,8,4,课前计划表是实习报告及感想3k，到课程结束时变成了报告3k与感想3k，还说不今天下午交是对你们的仁慈🔨🔨🔨\n\n原来这个及是分开的意思啊，你真棒
125173,6289,程继鹏,2020-09-13 01:11:23,4,12,8,真的很不错，上课每次都到，即使三千变六千，但我依然认真写，报告认真配了好多图，感想真的是自己的感想，每一份的字数都远超三千，老师也很好，看我那么辛苦，轻轻松松地给了我一个比我一学年最低的绩点还要低了两档左右的绩点，让我不要为了绩点那么努力，强烈推荐这门课（虽然也莫得选择）
125180,6289,程继鹏,2020-09-03 05:25:25,3,7,4,3k字变6k，我是zz选这门课（虽然我莫得选择
128104,6289,程继鹏,2020-12-07 07:41:13,4,8,4,态度恶劣，看不起学生
158950,6289,程继鹏,2022-07-04 01:28:35,-2,3,5,😄😄😄
160676,6289,程继鹏,2022-09-30 04:48:05,0,4,4,继你抬眉
171010,6289,程继鹏,2023-03-14 05:06:52,5,6,1,( っ'-')╮ =͟͟͞͞🏀
179825,6289,程继鹏,2023-09-20 01:59:05,9,13,4,什么伞柄玩意，认识实习每天都来了，两篇报告给交了就nm给1.5是吧，什么挠弹一个评分2.9不是没有道理，要不是必修课龟儿子才来上课，早点remake吧别祸害人了😊😊😊
196029,6289,程继鹏,2024-07-01 08:09:52,6,8,2,材料学院这种没用还拖拉的课可以关了。。。。
197401,6289,程继鹏,2024-07-13 01:38:49,4,5,1,先打1分观察，若出分还行就改为2分
198254,6289,程继鹏,2024-09-06 02:18:20,3,6,3,出生东西
198300,6289,程继鹏,2024-09-06 09:17:15,2,5,3,无话可说
198528,6289,程继鹏,2024-09-09 12:59:52,5,6,1,纯傻逼
199169,6289,程继鹏,2024-09-18 12:13:45,4,6,2,zssn
199865,6289,程继鹏,2024-10-05 08:23:53,5,7,2,神金嘻嘻
207685,6289,程继鹏,2024-12-23 23:57:46,7,7,0,初升东曦
213766,6289,程继鹏,2025-01-19 14:38:32,1,4,3,乱七八糟的课程安排，给分还一坨屎，沟槽的五级制拉低一大截绩点
221948,6289,程继鹏,2025-06-27 14:57:34,0,0,0,。。。。。。
216338,6452,黄玉辉,2025-03-13 13:09:52,0,0,0,人美心善
221525,6476,朱杭,2025-06-24 08:20:14,1,1,0,和yl搭板的形策老师吗，嗯上课没听，不过满绩了，暂时就不评价了
177532,6539,孙威,2023-07-03 15:18:18,10,11,1,神中神
209910,6539,孙威,2025-01-07 11:24:04,0,0,0,老师非常好！
199624,6542,Diana Carolina Santacruz Estevez,2024-09-26 10:36:49,0,0,0,¡Muy Bien!
134167,6643,原帅,2021-03-17 13:49:15,0,2,2,新老师帮忙带院士大佬的课，看出来很努力准备的样子，但语速太快了容易跟不上。有几次提前结束了还特别不好意思，有点好玩。希望自信一点
150700,6643,原帅,2022-02-14 10:28:54,0,0,0,大四划水，整个课有两次课堂作业，两次大作业，一篇大论文。给分还行。上课语速快
162383,6643,原帅,2022-11-21 09:07:01,0,0,0,提前下课
197603,6643,原帅,2024-07-21 04:09:25,0,0,0,原老师真的很为学生考虑，细节不说了，yyds！！！
180303,7158,吴勤明,2023-09-21 04:39:30,0,1,1,好好好
188952,7158,吴勤明,2024-01-20 22:09:20,0,1,1,老师真的非常细心负责，给分也很好，低碳与零碳科技这门课是第一次开设，当时抱着开盲盒的心思来的，结果真的出乎意料，对文科生也非常友好，炒鸡推荐😭
188953,7158,吴勤明,2024-01-21 03:26:12,-3,2,5,纯纯傻逼嘛，你他妈会给分吗，不会给就去死，别跑过来祸害别人
188961,7158,吴勤明,2024-01-21 00:40:10,3,3,0,老师人很好，比较佛系，也很耐心。上课可以不听，没什么事情，课下任务几乎没有。期末考开卷，分数占比不高。给分方面，两位老师都是第一次给本科生开课，不清楚我们绩点的规则，分数比较求是，但是老师卷子和课程论文改的很松，算是一种变相捞捞吧。总得来说给分还行，课程事情很少，推荐。
190275,7158,吴勤明,2024-02-27 03:44:41,0,0,0,老师事儿少 但给分真的很差🥲🥲🥲
206983,7158,吴勤明,2024-12-19 02:24:55,0,1,1,给分太可怕了呜呜呜
210224,7158,吴勤明,2025-01-08 12:37:45,0,1,1,老师很好，点名也是教学要求，上课没有强制要求，非常自由，对于文科生而言完全感觉不到隔阂（主要是一些化学方程式根本没法理解，当然不需要去理解去记，老师也不做要求），有平时作业，但都是ppt里找得到的，上完一章节的课，老师就会在群里发课件。个人觉得作业很有用，翻翻ppt，多熟悉熟悉，毕竟期末开卷考，就靠它（自己打印，说实话，有点多，我怕看不清打印的A4纸双面，四张一面，其实六张一面也没问题，但真的答案百分之九十九全在上面）。本来是对低碳很感兴趣选的这门课，开始听得很认真，也确实获得很多东西，但后面因为自己有时候有事情，再加上老师管得松，后期就做自己的了。除了三次平时作业，还有一篇期末论文，我觉得看看文献，再发表一点个人的看法，早一点交，不要抄，问题应该不大的，而且老师期限放得很宽很宽。抛开那些纯文科生完全不懂的方程式啊催化反应啊什么的，这门课还是很有意义的。哦，还有，老师课件很新，应该是边更新边教学，紧跟时事紧跟热点紧跟国际。老师也特别负责，虽然同学上课水，但老师真的一点都不水，会催交作业，甚至还在作业批改了后线上给我们评讲最后考试的时候两位老师都来了，全程陪着我们。两位老师都是很厉害的人，但一点架子都没有，人特别好。作为一门科技创新类通识课程，应该说是很值得了。老师会点名，有的同学最后绩点不是很好，可能因为这个掉了平时分，或者是三次平时作业不太好或论文抄袭了。非常喜欢这门课，也非常乐意向大家推荐！！平时不缺勤，作业按时交，翻翻ppt，最后不会差的！
214918,7158,吴勤明,2025-02-19 05:47:43,-2,0,2,lz满绩，课程里面有一部分比较难懂，是一些材料，分子筛一类的，但是大部分都很通俗易懂，以科普为主的那种。\n\n这个课真的很适合水课的同学，实在不想听可以当作自习来上，老师PPT会发到群里，平常的三次作业和期末考试的原题都在PPT里，而且PPT每一页安排的很清晰，看好标题答案不难找。最后一节课还会讲三次的作业，里面也有一些原题。\n\n会有一篇课程论文，论题和课程相关就可，三千字，写起来很快，认真写给分很好。\n\n都来选这门课！
218567,7158,吴勤明,2025-04-24 15:56:30,0,0,0,老师太好了，这门课事少学分多
124841,7789,毛传斌,2020-07-12 05:01:23,2,2,0,给分还不错，但是上课大部分时间在放视频，甚至放其他老师讲的视频。作业也比较多，两篇纯英文论文，不过给分还好，也算值了吧。
199989,8168,张玲洁,2024-10-10 09:46:45,6,8,2,垃圾
200247,8168,张玲洁,2024-10-15 06:30:35,5,6,1,每日一骂，弱智的工程伦理，垃圾，怪不得手下学生都改行了
200276,8168,张玲洁,2024-10-15 09:19:11,-1,2,3,神马牛魔
200766,8168,张玲洁,2024-10-22 04:57:05,0,2,2,史
209672,8168,张玲洁,2025-01-06 12:55:24,0,2,2,自行体会。。。
210099,8168,张玲洁,2025-01-08 06:47:45,0,2,2,社恐人的地狱，上课可能会被点到回答问题甚至演舞台剧，如果侥幸躲过一切，最后得分也难看
214501,8168,张玲洁,2025-02-10 05:01:45,1,1,0,舞台剧抽象，随机点名，没给她留下印象最后分数不会太高
214512,8168,张玲洁,2025-02-10 09:01:39,0,0,0,挺不错的啊，能认识很多朋友。适合不那么社恐的。还有小礼物。
164997,9019,付晨光,2022-12-28 09:13:43,2,10,8,∪･ω･∪
185318,9019,付晨光,2023-12-28 01:15:59,0,3,3,讲课很好
191238,9019,付晨光,2024-04-14 12:55:33,1,3,2,付老师真好，讲课通俗，备课认真，但是毕竟课程难度较大，大家要认真听啊
191542,9019,付晨光,2024-04-24 11:25:07,-1,3,4,老师备课真的炒鸡认真
193002,9019,付晨光,2024-06-02 09:26:16,-1,3,4,课比较难，平时需要认真听，考试题课件里都有，可以结合资料提前复习
194983,9019,付晨光,2024-06-26 07:32:07,0,4,4,付老师人真的非常好
207958,9019,付晨光,2024-12-25 04:59:01,1,4,3,讲的很细，老师人很好。多说无益直接nb！
212944,9019,付晨光,2025-01-15 10:05:56,5,5,0,好老师，课虽然很难，但是考试很容易，上课一定要认真听，考试重点他上课都反复强调了，真的是很好的老师！
213558,9019,付晨光,2025-01-18 07:50:35,9,9,0,老师备课很认真，讲课会强调重难点，课程难度（能带理论部分）确实比较大，但期末考试难度确实不大，只要认真听课，期末复习把ppt完整过一遍，分不会低的
214050,9019,付晨光,2025-01-23 09:49:47,4,5,1,跨专业满绩了，上课真的很难，可能是课时太少根本没办法把推导过程讲清楚，但考试很简单，虽然考的比较细，但只要把他当文科学，把PPT基本内容背下来就轻松拿下了
195303,9159,许鹏,2024-06-27 17:04:50,0,1,1,很好的老师，耐心负责，今年毕业啦~
171662,9406,许国良,2023-03-31 09:15:00,2,2,0,我来写第一个评论\n\n上个实验是qxs 形成鲜明对比\n\n上课很轻松
196862,9406,许国良,2024-07-05 13:56:50,1,1,0,绝代双骄：许国良、王智宇
175141,9408,张跃飞,2023-06-22 01:26:22,0,0,0,张跃飞老师是第一次在浙大开这门课，课程也还在改进中，还可以去实验室进行原味拉伸实验的观察，老师人很好相处，期末考核很简单而且给分好！
196861,9450,薛晶晶,2024-07-05 13:57:43,0,1,1,靴子姐
