评论id,老师id,老师姓名,发表时间,点赞减去点踩数量,点赞量,点踩量,内容
167885,9214,Dominic Mark Graham,2023-01-20 01:12:44,6,6,0,Not bad
168025,9214,Dominic Mark Graham,2023-01-23 03:04:08,24,27,3,Very good. A very kind and humorous person.
168044,9214,Dominic Mark Graham,2023-01-24 07:45:26,15,15,0,他真的很好！！
168559,9214,Dominic Mark Graham,2023-02-19 11:51:37,13,13,0,很照顾我们 总是给机会我们讲英语 如果讲不出来他也会耐心地提示 真的很友善的老师
169388,9214,Dominic Mark Graham,2023-02-26 01:50:30,3,3,0,很好的老师！
169501,9214,Dominic Mark Graham,2023-02-26 13:14:20,2,2,0,nice and kind xdm快冲吧
169715,9214,Dominic Mark Graham,2023-02-27 13:34:57,2,2,0,老师人很好 Very nice and patient！
169717,9214,Dominic Mark Graham,2023-02-27 13:36:01,2,2,0,Dominic和蔼慈祥
170313,9214,Dominic Mark Graham,2023-03-02 16:39:00,1,1,0,很友善很幽默，很容易沟通。\n\n给分中规中矩，但是课堂上比其他几位外教舒适多了。
170552,9214,Dominic Mark Graham,2023-03-06 10:45:47,5,5,0,认真细致的英国外教
170563,9214,Dominic Mark Graham,2023-03-06 14:09:54,2,2,0,世界上最好的口语老师
170772,9214,Dominic Mark Graham,2023-03-09 10:15:40,2,3,1,Dominic这么好的老师还不速速选！谁选上谁赚！really niceeeeee！kind， patient and humorous. 很喜欢他的课！
170883,9214,Dominic Mark Graham,2023-03-11 08:50:06,2,3,1,超级超级超级好的老师！！！
172974,9214,Dominic Mark Graham,2023-05-10 15:03:15,-1,1,2,老师人很温和。但是上课有点无聊，我每节课都会发呆。学到的不是特别多。不过过去坐着还行。
173881,9214,Dominic Mark Graham,2023-06-04 05:41:27,6,6,0,大一两个学期都是Dominic教，特别好
174589,9214,Dominic Mark Graham,2023-06-14 09:42:36,10,10,0,真的特别好！！口语考试会认真和蔼地听你讲话，会积极互动，会引导你往下说，到后面更像是一种对话而不是一场考试！！他真的我哭死人真的很好！！
174624,9214,Dominic Mark Graham,2023-06-14 16:10:57,5,5,0,今天就口语期末，和Domi愉快地聊了10分钟，他说时间到了的时候还有一点难过，没说够哈哈哈哈哈\n\n口语课堂是很轻松的 除了每节课必点名之外，想水也可以水，但是他也确实会准备一些非母语者可能没见过的习语和绕口令教大家，也可以学到东西\n\n如果有不会的词什么的他会用通俗的英语解释 但是他不太会讲中文 说中文带口音还很好玩哈哈哈有些时候会问我们某些词中文怎么说\n\n另，他对英国文学是很了解的，个人觉得英国文学相关的课如果能选也可以冲
174873,9214,Dominic Mark Graham,2023-06-19 08:34:24,2,3,1,英语辩论，上课要求不多，到课加小组展示加期末一切顺利，就看给分了，估计也会不错的。
175243,9214,Dominic Mark Graham,2023-06-22 19:53:02,6,6,0,不想说太多，一句话够了：我遇过外院最好的外教
176256,9214,Dominic Mark Graham,2023-06-28 07:25:03,6,6,0,English is the most interesting subject. It's not controversial at all in his class.
178973,9214,Dominic Mark Graham,2023-08-10 02:19:30,1,2,1,多米尼克我真的 他真的太好了 大家都去选他求求了
180898,9214,Dominic Mark Graham,2023-09-28 02:50:25,2,2,0,关心学生的好老师
183918,9214,Dominic Mark Graham,2023-12-03 17:10:13,9,9,0,老师人很好，英音超级好听\n\n为啥看不到均绩
184356,9214,Dominic Mark Graham,2023-12-18 06:59:25,1,1,0,开学以来遇到的最负责任且水平高的老师！真希望能把下学期预制的那位换成dominic
185363,9214,Dominic Mark Graham,2023-12-28 10:54:23,-2,2,4,正在上英美文学赏析，正如前面关于他其他课的评价，Dom人挺好的，这门课主要是介绍英语文学的发展史，还连带着一部分赏析的知识，所以非常浅而泛。主要需要做的就是课前阅读材料（其实不读也行），写四个要求不高的Creative Writing，再就是一个期末论文。但是期末论文要求英语1500词真的很多现在正在写要写疯了啊啊啊啊啊啊啊啊啊啊啊啊啊啊啊啊啊啊啊啊啊啊啊啊啊啊啊啊啊啊啊啊啊啊啊啊啊啊啊啊啊啊啊啊啊啊啊啊啊啊啊啊啊啊啊啊冲着这一点其实不太建议选，因为选题和写作都会很折磨，最好有一篇自己非常喜欢且熟悉的英语作品再来上这门课，还是劝大家慎重。出分以后我再来追评。
186258,9214,Dominic Mark Graham,2024-01-10 06:47:01,1,1,0,人真的蛮好的！不知道给分如何，之前听说比较求是？但是也很好啦，上他的课很轻松愉快～
188611,9214,Dominic Mark Graham,2024-01-19 11:29:09,2,2,0,老师的口语很清晰，上课绝对不会有听力上的压力！而且老师人很好，给分也尚可。不过英美文学赏析这门课还是有点硬核的，经常会出现老师讲得很激情台下没什么反应的情况，有时候感觉老师也挺无奈的
188731,9214,Dominic Mark Graham,2024-01-19 17:40:53,1,3,2,给分太求是了，好低，难过一整天
188754,9214,Dominic Mark Graham,2024-01-20 00:32:35,3,5,2,【英美文学赏析】事少给分不错\n\n上过老师的英语演讲和英美文学赏析，老师超级温柔，对我这样一个英语不好的人都非常友好！（指老师本人和给分上）\n\n估计之后不会再上他的课了，非常感谢老师
189034,9214,Dominic Mark Graham,2024-01-21 10:10:34,-17,5,22,给分超级烂。。。哪来的那么多好评，身边朋友几乎都被绩杀了。。。\n\n绩点比我的大英4低了整整0.9，分数无所谓的随便选，要分的快跑！！！
189190,9214,Dominic Mark Graham,2024-01-22 09:40:35,-22,2,24,每节课都点名，然后给分不好，感觉有点偏袒女生，不建议选
192974,9214,Dominic Mark Graham,2024-06-01 12:48:37,3,3,0,英美文学赏析每节课点名，但是每节课都很有意思，上课交流环节可以跟小伙伴练练口语。差不多就像高中语文课一样吧，学不到太多很深的知识，但是对英美文学可以有一个粗浅的了解，下课了跟老师聊天也挺好的，除了最后的1500字课程论文，平时任务量几乎为0，英语还不错的可以考虑。
195370,9214,Dominic Mark Graham,2024-06-28 01:32:06,2,2,0,上的是英语辩论，平时没啥事，老师特别特别亲切和友善，上课内容也很有趣，会有讨论环节和组内辩论环节，一般都很轻松，只有期中一个pre和期末的辩论考试，抽到了最难的题目时，感觉都要寄了，但最后给分超级好！ 记得上课多跟老师互动
196431,9214,Dominic Mark Graham,2024-07-03 10:08:46,2,2,0,一百昏！上的是英美文学赏析，老师人非常非常nice，虽然内容讲的不是很深，但是可以学到不少东西。最后期末1500词英文论文写完好有成就感🤤给分的话感觉是比较求是的，我论文和creative writing好好写了，最后给分非常满意。
199054,9214,Dominic Mark Graham,2024-09-14 11:55:56,0,0,0,外教老师特别可爱，而且发音很清晰标准，真的能听懂哈哈哈哈，是我来大学上的第一堂课，一下子就爱上了，并且敢说话了，十分！！！
201313,9214,Dominic Mark Graham,2024-10-31 12:28:27,6,6,0,老师超好，很温柔又有趣，永远都在笑啦，不会因为指到你回答问题时说不出来生气
204716,9214,Dominic Mark Graham,2024-11-27 13:12:32,1,1,0,Dominic，有耐心得不得了，和幼教一样。事情很少，也会很鼓励你发言。情绪稳定得没话说。纯正英国人，口音大家都放心昂。
206542,9214,Dominic Mark Graham,2024-12-16 03:03:51,4,4,0,Very kind，very patient，very humorous.You can learn a lot from him.
208311,9214,Dominic Mark Graham,2024-12-26 17:32:51,0,1,1,和评论说的一模一样，kind， humorous and patient，笑起来超级温柔可爱，脾气很好，上英美文学鉴赏学到很多，非常好的老师。
211405,9214,Dominic Mark Graham,2025-01-11 10:38:41,2,2,0,急刹，但人很好，人很nice，但是为了绩点还是别选他了吧。。。。。。
211408,9214,Dominic Mark Graham,2025-01-11 10:43:33,1,1,0,Dominic很绅士，英美文学赏析这门课相对比较浅，但事情比较少，整体也比较轻松，最后给分应该算比较求是
212980,9214,Dominic Mark Graham,2025-01-15 11:51:43,0,1,1,给分超级烂，绩杀，懂得都懂，建议追求绩点的朋友不要选择他的课程
213599,9214,Dominic Mark Graham,2025-01-18 12:47:35,1,1,0,超级好的外教老师，很绅士，也会鼓励大家在课堂上多互动。\n\n个人对英语口语和英语写作的绩点比较满意，\n\n不过选英语写作前建议先考虑一下自己能否比较高质量地完成1500词的论文。（当然写完了还是很有成就感的）
214868,9214,Dominic Mark Graham,2025-02-18 13:23:23,0,0,0,老师非常好！很有耐心，经常鼓励我们开口交流，但我英语口语分数稀烂，一定是我自己的问题😭
217839,9214,Dominic Mark Graham,2025-04-17 06:22:19,0,0,0,上课很有趣，口语完全轻松听懂无压力，课后几乎无作业，也会鼓励学生的pre。期末考氛围轻松，给分还挺好的，可能这几年有改进。
221067,9214,Dominic Mark Graham,2025-06-21 05:39:08,2,2,0,纸质点名，平时事很少，上课完全不用听，但大作业尽量早点做，不然堆到周末会及其痛苦（我做了三个周末加两个晚上才做完）\n\n推荐英语水平比较好的同学选这门课，Dominic是真会检查你有没有用AI，我找Dominic交流了好几次，写了三周的论文可能因为AI用的有点多被发现直接给毙了，喜提85卡绩3.9（what can i say）
221112,9214,Dominic Mark Graham,2025-06-21 09:33:27,1,1,0,认真写其实也能拿挺高的分
221126,9214,Dominic Mark Graham,2025-06-21 11:01:25,0,0,0,英美文学赏析：老师人很好，温柔幽默，上课也很有意思，每节课纸质点名。平时事情也比较少，主要是每周看一些老师提供的文章，最后交四篇小作文和一篇英语论文。比较认真地完成，老师就会给不错的分数。
221162,9214,Dominic Mark Graham,2025-06-21 15:27:40,0,0,0,刚刚看了朵朵 发现大家都被卡绩了 但是老师可能不知道卡绩呜呜呜
221482,9214,Dominic Mark Graham,2025-06-24 04:19:49,1,1,0,每节课都点名，给分一般，论文难度不小，如果有更好的选择，还是不要选了
171442,9215,Dylan Rimpault,2023-03-24 11:01:16,17,19,2,温柔可爱的法国老师
179466,9215,Dylan Rimpault,2023-09-16 11:53:18,4,7,3,很爱的老师
179685,9215,Dylan Rimpault,2023-09-19 09:20:46,3,6,3,parfait！
179686,9215,Dylan Rimpault,2023-09-19 09:20:46,3,6,3,parfait！
179693,9215,Dylan Rimpault,2023-09-19 10:44:58,6,9,3,温柔邻家大哥哥
184324,9215,Dylan Rimpault,2023-12-17 06:16:15,33,34,1,王迪你怎么黑化了
184669,9215,Dylan Rimpault,2023-12-22 06:26:00,19,21,2,老师人很好，肢体语言和绘画技术很强，très bien！
186027,9215,Dylan Rimpault,2024-01-08 01:22:06,14,15,1,人还可以，上课水平也可以，但是这学期不知为什么突然开始特别喜欢搞创新，pre和各种作业真的有点多，最后期末了又突然加了小测
187214,9215,Dylan Rimpault,2024-01-15 05:51:15,14,17,3,J’aime bien Dylan 💙
188666,9215,Dylan Rimpault,2024-01-19 13:28:23,4,7,3,兄弟我爱你，我的法国义父
188832,9215,Dylan Rimpault,2024-01-20 06:34:45,10,13,3,人挺好，上课水平可以，之前给分不太好是因为按法国的给分方式在给分，这学期除了pre什么的事情有点多以外给分变好了！
191370,9215,Dylan Rimpault,2024-04-18 14:53:10,18,18,0,论文是真的很麻烦，作为选修课来说并没有那么轻松😂
191451,9215,Dylan Rimpault,2024-04-22 15:18:31,11,11,0,没事别逃他的课，他看见人少了真的会点名，毕竟本来上课的人就不多
191904,9215,Dylan Rimpault,2024-05-04 11:58:34,8,8,0,论文真的有点麻烦
193192,9215,Dylan Rimpault,2024-06-04 09:28:02,7,9,2,滴狼！你是我的神！！喜欢Dylan一万年！！！！！！！！
193246,9215,Dylan Rimpault,2024-06-05 05:28:55,-4,4,8,emmmm
193344,9215,Dylan Rimpault,2024-06-06 16:01:39,4,5,1,emmmm虽然他确实有时候有点迷但有些事也不能全怪他吧。
193635,9215,Dylan Rimpault,2024-06-14 14:42:27,5,5,0,还好吧，期末小测也不是很难，只要不是一点都没听课都不至于写不出来，而且他说他给分还是gentil的，关键词写出来就给分
195120,9215,Dylan Rimpault,2024-10-14 12:03:23,7,7,0,dylan你是真的火了
195658,9215,Dylan Rimpault,2024-06-29 09:36:07,2,3,1,王迪虽然说是黑化了，但给分还行
197508,9215,Dylan Rimpault,2024-07-17 17:48:42,4,8,4,上课很水\n\n给分也迷\n\n不知道他的查老师九分是怎么给出来的\n\n只能说同学们真的很宽容
197687,9215,Dylan Rimpault,2024-07-29 18:13:43,4,4,0,Dylan超温柔啊！
207294,9215,Dylan Rimpault,2024-12-20 07:49:29,3,4,1,虽然作业不算少，但是给分很捞，而且平时情绪价值给得很足，跟他交流真的很治愈
208312,9215,Dylan Rimpault,2024-12-26 17:35:07,5,5,0,备课非常认真，上他的课能学到很多很多东西，人也很风趣幽默，很喜欢的老师!
209849,9215,Dylan Rimpault,2025-01-07 08:55:52,4,4,0,法国义父求求不要挂我不要挂我（求佛（求佛（求佛
210923,9215,Dylan Rimpault,2025-01-10 07:13:00,7,7,0,谢谢义父，下学期努力不en retard！！给你做更多小周边！！
211043,9215,Dylan Rimpault,2025-01-10 11:43:35,6,6,0,💙🤍❤️
212904,9215,Dylan Rimpault,2025-01-15 08:09:14,1,4,3,je t'aime dylan!\n\nJ'ai de la chance que tu me donnes des cours\n\n满绩点回来还愿，开心
172887,9216,Jarula Maria Immanouel Wegner,2023-05-09 07:20:23,0,3,3,不谈论教学态度，仅谈论教学质量，课堂对我没有任何帮助...难度完全超纲，全靠ai翻译。
179498,9216,Jarula Maria Immanouel Wegner,2023-09-17 14:38:18,0,2,2,感觉wegner对学术是有追求的，人也不错，但实在不适合本科生。一个学期上了两门他的课，一开始还有热情读文献听课，现在看见专业必修课授课教师是他会两眼一黑的程度。上课感觉不太能学到东西，本身中文读起来都有难度的文献变成德语真的很要命。期末两篇德语论文一起写得想死，给分还一般般。\n\n说这么多只是致敬我苦难的上学期，反正你也没得选对吧，哈哈。
180368,9216,Jarula Maria Immanouel Wegner,2023-09-21 08:45:50,1,1,0,老师水平太高，对于成绩差的同学这里特指我本人真的很不友好，因为他准备的文献阅读材料实在太长也太难了，并且我觉得在一定程度上那些文献和课程的名字也并不完成相符，总之什么也没学会，整个学期都是战战兢兢地度过的
185958,9216,Jarula Maria Immanouel Wegner,2024-01-06 13:44:43,3,4,1,很认真负责的老师，是德语所少见的认真负责的老师。讲课也是德语所少见的有干货还调理清楚的老师。太珍贵了
186131,9216,Jarula Maria Immanouel Wegner,2024-01-08 19:43:35,3,3,0,很好的老师~备课认真，上课能学到很多东西，课后有问题也会认真解答。课程设置很清晰，每门课都会布置阅读材料，看下来德语进步很大。他的课作业不多，但是考核确实有难度。不适合想水课的同学。
189883,9216,Jarula Maria Immanouel Wegner,2024-02-01 05:40:20,1,1,0,好老师，适合真的想学东西的同学，讲义难度高一些，但是认真参与的话会尽量往满绩给
201831,9216,Jarula Maria Immanouel Wegner,2024-11-06 18:23:52,2,2,0,认真对待课堂和学生的负责任的好老师！
170630,9217,KAMINSKAYA SOFYA,2023-03-07 09:55:28,0,2,2,索菲亚很美！中文很棒！很热情！
173353,9217,KAMINSKAYA SOFYA,2023-05-20 16:38:25,2,4,2,打分过于严苛
173904,9217,KAMINSKAYA SOFYA,2023-06-04 09:03:54,0,3,3,。。。。。。。。。。。。。。。给分好差。。。。。。。。。。。。。但是人很好看。。。。。。
175201,9217,KAMINSKAYA SOFYA,2023-06-22 09:24:43,1,3,2,我爱索菲亚！！
175543,9217,KAMINSKAYA SOFYA,2023-06-25 12:26:29,2,3,1,平时上课很尽职尽责，老师是真的想教会学生。上课一点儿也不水。相对于大英五给分不错，能学到知识。
175861,9217,KAMINSKAYA SOFYA,2023-06-27 03:45:06,5,7,2,超爱София！！！特别可爱特别漂亮。这学期上了俄语1，一开始害怕听不懂，但是她中文说得很好，上课特别有趣，感觉回到小学学英语的时候。俄语本身比较难，所以课后可能需要多花一点时间。老师给分很好，人美心善😘
176210,9217,KAMINSKAYA SOFYA,2023-06-28 05:17:52,2,3,1,Софья очень хорошая учителя.\n\nбзб
177777,9217,KAMINSKAYA SOFYA,2023-07-04 23:28:45,0,2,2,美丽可爱有原则！女神！
180128,9217,KAMINSKAYA SOFYA,2023-09-20 10:41:34,4,4,0,每节课开始的时候数字点名。\n\n会尽力记住我们所有人的俄语名。
190606,9217,KAMINSKAYA SOFYA,2024-03-11 11:47:48,0,3,3,管理选课的诸位能不能让补选的三十个人坐到你们办公室去？
194425,9217,KAMINSKAYA SOFYA,2024-06-24 00:55:51,2,2,0,София很温柔的，打分规则比较细化，但是给分很好
195936,9217,KAMINSKAYA SOFYA,2024-07-01 02:03:03,1,1,0,打分很严，需要认真学。
196637,9217,KAMINSKAYA SOFYA,2024-07-04 11:56:25,2,2,0,俄语Ⅰ\n\n俄语入门还是有难度的，想考高分需要花时间；但毕竟是入门，学习内容也不算多。总的来说，期末补大天是不可能的，但坚持每天学一点也不难。老师上课经常问问题，也有一定督促作用，至少班上剩下的同学考前都有一点底子。\n\n个人感觉老师打分还可以。虽然她自己也说有点严，但我们学的单词和语法大都是很明确的东西，没什么捞的理由；此外根据最后的成绩我认为期末改卷还是相对宽松的。
206417,9217,KAMINSKAYA SOFYA,2024-12-15 04:40:26,0,0,0,老师真的很好，学大英四的时候感觉到压力很大，之后选了小语种，那是我春夏学期学的最开心的一门课，老师很会鼓励我们，会尽力记住我们每个人的俄语名，让我们每个人都有开口说的机会，让我感到少有的鼓舞与慰藉，无数次在五点五十下课后，看着启真湖都能让我有一种如释重负的感觉。考核难度也还好，老师一般都是数字点名，不会现场点。
219964,9217,KAMINSKAYA SOFYA,2025-06-12 12:41:10,0,0,0,老师人美心善又很有耐心，就算我磕磕绊绊很久说不出来话她也会等着我！老师真的很可爱！
169692,9220,Sami Farhad,2023-02-27 11:52:22,6,15,9,第一次写评论，给Sami！！\n\n他真的是天使，有很多干货很多思想\n\n同时无比负责，是真正愿意教学生的老师
170799,9220,Sami Farhad,2023-03-10 02:07:49,-3,5,8,非常好
171845,9220,Sami Farhad,2023-04-07 13:05:45,19,29,10,强到爆的一位老师，哈佛毕业，曾任阿里巴巴外事法律总监，上课会很细心地安排教学内容，会提前下发阅读材料，会用很标准的美音和通俗的用词，不用担心听不懂，并且老师精通中文会经常开玩笑......总之他的课对想提高全球视野的同学会很有用的（就是会每节课点名，而且就目前来看应该比较求是
178261,9220,Sami Farhad,2023-07-09 03:42:34,22,23,1,唉……..事真的好多
178479,9220,Sami Farhad,2023-07-12 07:55:33,5,12,7,有收获，但分很求是
179444,9220,Sami Farhad,2023-09-15 15:03:19,-4,5,9,本科哈佛 硕士人大 博士哥大 强强强
179528,9220,Sami Farhad,2023-09-18 02:49:17,-7,1,8,好好好
184309,9220,Sami Farhad,2023-12-16 17:11:22,-6,1,7,好好好
186149,9220,Sami Farhad,2024-01-09 05:34:08,-5,4,9,课是真好，人是真牛，给分是真求是。。。
187587,9220,Sami Farhad,2024-01-16 16:38:07,-2,6,8,能学到些干货，一学期一门可以闭眼入。但是如果要同时选他两门课或以上，建议先问清楚学东西的“代价”。相信很少有人想体验，班群里大家互相打气熬大夜来肝论文的“暖心场景”吧。
189586,9220,Sami Farhad,2024-01-25 12:57:54,-3,7,10,上课硬核，给分友好，GEP课程里非常能学到东西的课程，毕竟大学也不能都上水课，如果对国际治理感兴趣，选他的课绝对不会吃亏。
190069,9220,Sami Farhad,2024-02-19 06:07:18,1,9,8,特别特别好。会点名，给分求是是真的，但是你和他聊过之后发现就该这么求是，多参与讨论得分会高。抛开分不谈，非常认真负责，阅读任务每周很重但是会学到非常多东西。会有意照顾同学，尽量用简单词讲，发音非常标准清晰。老师很厉害，很有水平。如果不想水课强推！
191812,9220,Sami Farhad,2024-05-01 07:00:53,5,11,6,1分都不想给 高贵什么 总是一种威胁人的语气 没见过这么无耻的用分数威胁学生的老师
192308,9220,Sami Farhad,2024-05-14 13:13:12,6,11,5,给1分都嫌多\n\n上这傻逼老师的课就是在进行服从行训练
193373,9220,Sami Farhad,2024-06-07 13:05:01,2,4,2,很无语
193807,9220,Sami Farhad,2024-06-19 08:22:22,7,7,0,上sami的課感覺壓力略大，但是確實能學到東西的，老師講得很好～～
198777,9220,Sami Farhad,2024-09-11 14:50:38,4,7,3,1.一开始会觉得老师很严厉，但是几次课后会发现老师很照顾英语水平不好的学生\n\n2.感觉老师更看重学习态度，课前需要阅读材料，而且上课会提问，但是尽力回答了老师也很包容\n\n3.老师水平挺高的，认真听可以收获很多东西\n\n4.虽然上课一知半解，回答问题用破烂英语，但是老师最后的给分也很不错，给老师点赞。
207295,9220,Sami Farhad,2024-12-20 07:59:22,5,5,0,喜欢萨米，很有意思的老师，另外读联合国报告的量可以让我顺便把英语学好。
208732,9220,Sami Farhad,2025-01-01 05:13:09,11,11,0,上zju以来遇见最好的老师\n\n国精班唯一的良心
219937,9220,Sami Farhad,2025-06-11 12:22:52,3,3,0,上了国际组织与全球治理，国精班为数不多有干货的课程，说sami要求严格是真的，每一个星期都会有很多的英文文献需要打印和阅读（大多是国际组织官网的文献），如果没有读上课被提问会感到有压力，我的建议是到大三大四甚至研究生再去修读这门课程，这样有时间去读布置的任务，也能带着一定积累参与课堂。sami的口语很好，中文也不错的，经常会穿插一些中文活跃课堂气氛，上他的课也是一个锻炼口语和胆量很不错的机会，关于课堂要求：sami希望我们少用电脑阅读文献、慎用ai【在课程中也会有相关章节提及】、结课是一个2000-2500字的英语论文【不能用ai】。
219951,9220,Sami Farhad,2025-06-12 04:29:28,2,2,0,给分确实低 压力确实大 学到的东西确实多
172080,9224,陈振铎,2023-04-19 03:17:04,6,8,2,666
178837,9224,陈振铎,2023-07-25 00:30:30,-8,0,8,谢谢老师…
178846,9224,陈振铎,2023-07-25 10:28:51,13,14,1,上课… 给分也…..   慎选
178850,9224,陈振铎,2023-07-25 18:15:50,9,10,1,真无语卡绩了😅
180953,9224,陈振铎,2023-09-29 03:52:25,27,27,0,完全不考虑学生实际情况，强制规定分组和pre的时间，提前一周才通知，并且没有调整余地。给分也一言难尽。
180956,9224,陈振铎,2023-09-29 07:23:21,16,16,0,只能说没有什么同理心
180966,9224,陈振铎,2023-09-29 16:36:40,22,22,0,很傻逼一老师，背后污蔑学生不说。。。还自以为自己很牛逼，我不知道你在拽什么啊真的无语了。。。。。。
180968,9224,陈振铎,2023-09-29 16:43:04,16,16,0,只能说纯纯脑瘫老师，上课屁事儿不干，下课给学生一堆破事儿，整这整那最后给的分也依托答辩，我看他就是答辩；而且还对学生极其无礼，进行人身攻击，真是讲课课不行，做人人不行。总结：答辩
180969,9224,陈振铎,2023-09-29 16:48:09,20,20,0,没有师德的人不配称之为老师，无视学校的规章制度，既然学校规定可以退课，你有什么不让学生退？还把学生踢出钉钉群之后在群里污蔑学生然后恶人先告状？后来事情败露之后又不道歉又不表态？你很牛吗？搞笑得很，从哪来回哪去，别在浙大祸害学生！
180973,9224,陈振铎,2023-09-30 07:12:52,23,23,0,在课程群里公然污蔑毫无过失的学生，离谱行为令人咋舌，师德师风问题突出。
180980,9224,陈振铎,2023-09-30 11:47:44,13,16,3,分组完全不考虑实际情况，以刁难学生为乐还满嘴跑火车说学生态度问题。在完全不了解实情的情况下就在群里公开侮辱学生，你长张嘴就是为了找屎吃吧。以为自己很了不起是吧，全世界都能力不行就你牛逼是吧，在法国读几年书就烂泥上镀金了是吧，给我滚出拆拿。撒泡尿好好照照镜子看看自己长什么逼样吧别来祸害学生。
181156,9224,陈振铎,2023-10-10 09:45:31,-5,2,7,陈迹千秋\n\n振袖高歌振师风，\n\n铎鸣激荡奏嘹亮。\n\n牛衣素笔书经纶，\n\n逼出英杰传古方。
181931,9224,陈振铎,2023-11-05 14:13:38,6,7,1,幸好退了
182389,9224,陈振铎,2023-11-15 12:13:09,11,11,0,除了不点名，其他非常的逆天………
182447,9224,陈振铎,2023-11-16 08:00:08,14,14,0,很迷惑的老师，学不到东西
183753,9224,陈振铎,2023-11-29 14:39:21,-12,1,13,讲课确实是有东西的…
184850,9224,陈振铎,2023-12-23 12:08:57,-3,0,3,额嗯嗯
185218,9224,陈振铎,2023-12-27 06:12:15,8,8,0,绩杀3.6，不好评价
185381,9224,陈振铎,2023-12-28 14:21:43,15,15,0,课程是无聊的 任务是繁杂的 给分是随意的
185733,9224,陈振铎,2024-01-04 03:17:27,18,18,0,人不如其名。突然想起可以来查老师评下，我的评价是，慎选这门课，客观来说可以知道老师书看得不少，但实际上，上课不够系统，泛泛而谈，缺乏思想深度不够。被公认喜欢说文解字，把各种字拆开仔细琢磨，但我上的不是汉语言文学啊老师！从字中能发现深意，是很有趣，但对于我积累知识有什么帮助呢。而且每次布置阅读任务，有小组评价，有同学提出问题，您也不仔细探讨一下，那布置阅读书籍意义何在？如果没有在这方面深入探讨问题，我只能归咎于老师思想深度不够水平不行了。再者，文科的思想与观点应该是没有对错的吧，为什么似乎到您这只能有一种原因与一种观点呢？
186274,9224,陈振铎,2024-01-10 09:44:48,-21,2,23,老师知识很丰富，对很多事情有自己的思考，认真听可以收获很多。
190439,9224,陈振铎,2024-03-04 06:53:46,12,12,0,陈陈腐腐化神奇，\n\n振振钟声穷经语。\n\n铎铎掷地声何在？\n\n真真切切世人语：\n\n无尽莱茵空流水，\n\n知识似海雾人材。
200430,9224,陈振铎,2024-10-17 03:03:28,0,0,0,加油啊
200528,9224,陈振铎,2024-10-18 09:22:15,5,6,1,*一生巴黎情，不知道的还以为他的教学任务是让全班都知道他在巴黎上过学...上课不知所云，就知道吹嘘自己，甚至搞了一整个自我介绍ppt来讲自己的学业和科研成果，讲了一整节课。\n\n*pre强制分组，且完全不考虑开学前两周退课的情况。题目也是强制安排。分组后不告知具体pre形式，当时我们是两人一组，但是两个人分别拿到不同的题目，我们就自行准备去讲了，结果被他批评不懂得合作，但他在前期并没有说明需要两人一起做。下课后询问应当如何合作，老师顾左右而言他。\n\n*要求一节课一变，前一节课还允许同学们做pre带稿子上去辅助，后一节课直接劈头盖脸把拿着稿子的同学骂了一顿。非常莫名其妙\n\n*期末论文的题目和具体要求在考试周期间才布置，几乎让人没时间写。如果期末有考试的千万慎选！！提前钉钉问他就已读不回。\n\n*思想非常独断，明明讲的内容和国际政治相关，却不允许同学们和他有不同的观点，说了他就批评你，反驳你\n\n*喜欢当众羞辱学生，喜欢人身攻击，用侮辱性词汇等
206392,9224,陈振铎,2024-12-14 21:33:27,1,1,0,无话可说
206475,9224,陈振铎,2024-12-15 11:42:07,5,5,0,师德有问题。浙江大学最差劲的老师。没有之一。
206602,9224,陈振铎,2024-12-16 11:30:46,1,1,0,在他课上做过人生最短一次pre，台下准备不到三天（因为czd提前了三天给我们布置题目），台上做了1分钟就被赶下台了，现在想起来还是不禁拍手叫绝
167121,9225,练斐,2023-01-15 04:05:58,20,21,1,温柔的pljj😭😭
170153,9225,练斐,2023-03-01 14:47:02,15,15,0,温柔的pljj！
175827,9225,练斐,2023-06-27 01:35:02,8,8,0,我爱练老师！
180714,9225,练斐,2023-09-25 08:37:04,14,14,0,23级德专生能遇到这么温柔漂亮有耐心的小姐姐真的很幸运！
181094,9225,练斐,2023-10-08 06:38:15,10,10,0,Frau Lian 太好啦
181279,9225,练斐,2023-10-13 01:55:54,6,7,1,FrauLian我女神不接受反驳！！！
181280,9225,练斐,2023-10-13 01:56:14,8,8,0,真的超喜欢Frau lian
181536,9225,练斐,2023-10-21 16:02:28,6,7,1,Frau LIAN我真的太喜欢她了嘤嘤嘤！讲课讲得好好！超级有耐心，温柔又美丽，气质也超好，我滴女神！！！！！！
184243,9225,练斐,2023-12-14 01:43:43,5,7,2,天不生我Frau练，德语万古如长夜
184244,9225,练斐,2023-12-14 01:43:42,4,6,2,天不生我Frau练，德语万古如长夜
184523,9225,练斐,2023-12-21 10:37:36,5,6,1,呜呜呜 日专生听了frau lian的课想转专业了
184711,9225,练斐,2023-12-22 09:41:16,4,5,1,天不生我Frau Lian，德语万古如长夜
185692,9225,练斐,2024-01-03 14:55:52,6,7,1,温柔漂亮jj！体贴学生，课堂引入很丝滑，超级好的老师！！
187673,9225,练斐,2024-01-17 05:12:55,5,6,1,我爱Frau Lian！！她真的又温柔又有耐心，讲课也很会从学生的角度出发，总之就是非常喜欢嘻嘻嘻嘻嘻嘻嘻
187812,9225,练斐,2024-01-17 13:49:52,1,2,1,超爱她啊！
188216,9225,练斐,2024-01-18 12:17:27,3,4,1,非常好老师，使我德语很好
188442,9225,练斐,2024-01-19 04:18:45,3,4,1,超级有气质超级漂亮，人很好很耐心，超级喜欢
192694,9225,练斐,2024-05-28 11:03:50,2,3,1,Frau Lian真是天选老师人，对学生超级超级耐心，讲得让人很容易听懂，爱她！
192775,9225,练斐,2024-05-30 07:00:25,1,2,1,中外文化精萃最喜欢的老师！好有魅力！！！！！！！！好喜欢好温柔的美女姐姐！！
192837,9225,练斐,2024-05-31 02:54:22,2,4,2,非常好老师，只是课程菌剂被一起上的老师拉低了
194802,9225,练斐,2024-06-25 12:41:48,2,3,1,她真的，我哭死！！！！下学期可以继续上她的课真是太好了！！！
195542,9225,练斐,2024-06-28 17:12:30,1,1,0,捞神啊捞神啊我爱死fraulian了！！期中考太烂了提心吊胆到现在了现在出分我哭了5555我爱fraulian！
197138,9225,练斐,2024-07-08 04:46:48,1,1,0,非常好老师
209073,9225,练斐,2025-01-04 11:02:39,1,1,0,pljj不解释
214228,9225,练斐,2025-01-29 23:11:02,0,0,0,农资大神前来报道！
219642,9225,练斐,2025-06-03 02:26:52,0,0,0,人美心善Frau Lian，温柔有耐心
167129,9226,任洁,2023-01-15 07:19:02,47,59,12,仅通识课日语:rj老师人美心善，课前有日语歌，课间还有日本文化视频，讲单词有拓展知识，课堂轻松有趣，只有3次不提前通知的点名，小测不计入总成绩，但是考得好会有小礼物，作业只有一套卷拍照上传和一些课文的朗读录音上传，平时分直接拉满，期末考试有挺多陌生单词，题型有一堆选择、4偏阅读还有中日互译和作文（题目私の夢)，中日互译完全出自课本练习2，上课都讲到了。日语2零基础来也能完美跟上（我刚开始只认识五十音但是后来也能跟上）～\n\n\n\n然后上个学期成功找到了一个日本女朋友～～～
167154,9226,任洁,2023-01-15 04:25:34,7,14,7,给任老师打call！！全校最负责的老师没有之一
167555,9226,任洁,2023-01-17 09:23:09,6,13,7,日语二：三次不提前通知的点名，平时基本没作业。然后期末平时分基本拉满，只要好好背单词拿个高分很容易！\n\n然后针对老师来说，老师人很关心学生，有问必答，有任何学习生活上的问题都可以找老师～真的很亚撒西！
168154,9226,任洁,2023-07-06 13:21:51,3,10,7,讲课有趣，事少分高，语言类没修够快冲日语～\n\n日语2和3都满绩啦～平时分拉满，选择题全都出自课后单词和平时发的小纸，翻译题都来自课本，作文题预先告知，努把力就能上4！
169039,9226,任洁,2023-02-24 05:38:09,0,6,6,任老师人超好，虽然带大班工作量很大，但为了尽量满足同学的需求把班级容量集乎变成了教室容量，考前答疑特别认真，还会整理同学们的问题上课解答，每节课都充实有趣，课上课下都很照顾同学，而且明确告诉大家绩点都会往高了打！女神TAT
169439,9226,任洁,2023-02-26 07:14:20,0,6,6,女神YYDS，人美心善
169722,9226,任洁,2023-02-27 13:54:55,2,8,6,超级爱任老师，平时作业很少，认真背单词看语法就能4+，课间可以点课，课堂二次元浓度超高✧*｡ (ˊᗜˋ*) ✧*｡
170429,9226,任洁,2023-03-04 13:36:23,8,14,6,任老师是世界上最好的老师！老师人很可爱很温柔，上课非常非常认真，从来不水课，从PPT也可以看出来老师备课花了非常非常多的心思，不仅图文并茂，老师还会自己录听力以及搜集很多课外有趣的知识，比如日本的文化好吃的好玩的之类，课间也会放日本相关的视频。老师讲课也不局限于书本，会讲一些拓展的方面，从单词到语法到会讲到。虽说要听写，但也不计入总评，上课几乎不点名，期末考试的内容范围是划定好的，甚至翻译题范围和作文题也会提前告诉，单词也只考单词表1的内容，而且狂会捞人，平时分基本拉满！下课甚至会提前五分钟，这样去食堂就从来都不需要排队！总之，任洁老师的日语课无脑冲就是啦！
170624,9226,任洁,2023-03-07 09:10:33,0,6,6,女神老师超可爱！人美心善任老师，不管多晚发消息必回，真的太好了！
171888,9226,任洁,2023-04-11 08:08:18,0,6,6,一学期只点三次名，没来和老师解释一下就可以了。老师非常非常负责，期末考的内容很少而且很会捞人！选就是啦！
172097,9226,任洁,2023-04-19 09:21:07,0,7,7,天使⁽⁽ଘ( ˊᵕˋ )ଓ⁾⁾*
173864,9226,任洁,2023-06-04 02:28:32,8,13,5,耶？怎么那么低分，人美心善事少给分好的美女老师不应该10.0？
174936,9226,任洁,2023-06-20 05:54:52,1,7,6,超好的日语老师~非常认真负责，而且经常会鼓励我们
175137,9226,任洁,2023-06-22 00:42:30,1,7,6,很nice
176367,9226,任洁,2023-06-28 14:34:47,0,6,6,女神！！！！！完美！！！！！
176369,9226,任洁,2023-06-28 14:38:22,1,7,6,老师人超好！！！！！！！
178328,9226,任洁,2023-07-10 05:51:08,7,7,0,老师怎么还不出分呀，12天了
181524,9226,任洁,2023-10-21 04:55:37,0,5,5,任老师特别可爱TT日语Ⅰ选到就是赚到
181858,9226,任洁,2023-11-02 12:38:29,1,6,5,学识渊博的好老师。发音揪得很细
184875,9226,任洁,2023-12-24 01:56:54,-1,4,5,人美心善 我的超级大女神 选到就偷着乐吧
186281,9226,任洁,2024-01-10 10:11:42,-1,4,5,大爱任老师❤️❤️❤️
187559,9226,任洁,2024-01-16 14:29:11,-1,4,5,呜呜呜呜呜呜呜呜呜呜呜呜如果老师下学期还教日语二我一定去学 女神
195154,9226,任洁,2024-06-27 03:21:47,5,11,6,日语所最真实&平易近人的，有种被生活毒打过的社畜美感（当然老师本人还是职场丽人来的）
199084,9226,任洁,2024-09-16 09:17:30,-1,4,5,任老师风趣幽默，认真负责，给人莫名的亲切感
200374,9226,任洁,2024-10-16 10:46:50,-1,3,4,你们不许说她 她是我女神！！
200547,9226,任洁,2024-10-18 14:22:53,4,7,3,还行，学术能力dddd
201533,9226,任洁,2024-11-04 06:25:48,1,5,4,超级好，温柔细心负责，绝了简直，而且超级关心学生
205314,9226,任洁,2024-12-04 08:16:56,2,6,4,虽然第一次写日语作文但是日语I满绩，来还愿了
207995,9226,任洁,2024-12-25 07:09:45,1,3,2,感谢任老师，太好的老师了
208796,9226,任洁,2025-01-02 04:27:07,1,3,2,摇到就是赚到，学习上生活上超级棒的老师，人美心善，能力超强，天使
212147,9226,任洁,2025-01-13 09:11:40,2,3,1,任老师太好了！人美心善！选到就是赚到！
212198,9226,任洁,2025-01-13 10:55:00,1,2,1,超级爱的好吗，日语认真学，每节课课后都把单词背掉，高分根本不是问题好吗
212747,9226,任洁,2025-01-15 00:03:14,5,6,1,神中神
219025,9226,任洁,2025-05-19 07:11:46,2,2,0,世界の一番先生！
219149,9226,任洁,2025-05-22 10:45:20,0,0,0,没上过大英不知道你和你的日语有多好，现在被大英折磨得回光返照了，回来给你打10分
219899,9226,任洁,2025-06-10 14:13:19,2,2,0,真的好啊，无脑选
221348,9226,任洁,2025-06-23 04:13:05,1,1,0,女神的恩情还不完😭
167039,9227,阮孝煜,2023-01-14 17:09:28,12,20,8,经理的第一评是我的！！！
168137,9227,阮孝煜,2023-01-30 03:03:59,5,12,7,＜GG我的男神！！
168215,9227,阮孝煜,2023-02-03 09:19:26,15,26,11,阮经理是21年入职的年轻老师，超级热心负责，对学生是真的特别特别好！跟着gerente认真学是能够学到东西的！经理怎么能没有10分！！！
169246,9227,阮孝煜,2023-02-25 03:25:36,5,12,7,我爱你❤️❤️😘
169463,9227,阮孝煜,2023-02-26 09:41:41,3,12,9,人帅心善，事少分高，上课准备很认真，我们也能学到东西，感恩。
169483,9227,阮孝煜,2023-02-26 11:26:52,2,11,9,喜欢gg
170194,9227,阮孝煜,2023-03-02 02:49:20,4,11,7,男神！！
170274,9227,阮孝煜,2023-03-02 11:15:08,4,11,7,又帅又🐮的老师
170485,9227,阮孝煜,2023-03-05 16:57:39,6,15,9,经理是我的男神！我不允许他不是十分！！！超级帅气又超级认真负责的那种，永远忘不了作为大学生还被抓去办公室背课文的惨痛经历，对不起经理我一定好好学😭❤️❤️❤️
170534,9227,阮孝煜,2023-03-06 07:36:24,0,8,8,给经理满分
170768,9227,阮孝煜,2023-03-09 08:59:51,0,8,8,讲的超级细，新手友好！
170934,9227,阮孝煜,2023-03-12 16:20:24,6,13,7,满分给gerente!
171175,9227,阮孝煜,2023-03-17 11:59:15,12,22,10,经理竟然有主页了，那我必然要来评价一下\n\n作为一个外专业同学来选了洗浴一门几乎没有门槛而且很有趣的专业课，感觉他上课讲得很认真准备也挺充足。我上的那门课程任务也不多，给分很好
172188,9227,阮孝煜,2023-04-30 08:10:48,6,14,8,老师上课放的歌都好好听
173011,9227,阮孝煜,2023-05-11 07:38:41,8,17,9,老师真的超可爱超温柔，西班牙语课也上得很好，几乎一两节课就能把同学的名字记住，很用心
173290,9227,阮孝煜,2023-05-18 01:50:03,1,11,10,真的很喜欢
173620,9227,阮孝煜,2023-05-30 11:03:17,8,18,10,很可爱有耐心，会记住每个同学的名字甚至能记住谁不会哪个知识点，上课答不出来会慢慢引导，在路上看见你还会主动打招呼，知识点讲的很清楚明白，非常非常非常的喜欢。
174129,9227,阮孝煜,2023-06-06 11:45:59,5,13,8,点赞！
174259,9227,阮孝煜,2023-06-08 10:28:03,8,17,9,经理人超好 备课超认真 讲课也好！！！选他！选他！！！
175714,9227,阮孝煜,2023-06-26 09:44:13,-4,15,19,两个小时140道选择和10个翻译怎么做呢？
176302,9227,阮孝煜,2023-06-28 10:14:59,4,16,12,特别特别认真负责的老师！
176358,9227,阮孝煜,2023-06-28 14:22:46,-6,18,24,快跑！！！建议不是高中就学过虚拟或者是神童，对西语领悟能力特别好，能一下子学过去的人，不要再选这个老师的课了。\n\n老师讲课挺好的，但是课程设置和期末考试简直是乱七八糟。上课之前不会告诉学生期末成绩构成和评分标准，全部靠学生自己瞎猜。每个学期上课小测两次，给分很低，非常的求是。老师讲课速度特别快，但是进度很慢，这个学期甚至期末考试前都差点没有讲完。小测难度非常高。属于是标点符号也要扣分的那种程度。期末考试140道选择，10道翻译。全部不是原题，都是他自己出的。两个小时基本写不完，而且非常的难。考的都是词汇辨析之类的很细的知识点。\n\n老师最后期末给分也非常的求是基本上是考多少给多少。完全不会调分或者是捞人。
176359,9227,阮孝煜,2023-06-28 14:22:08,-15,8,23,140道选择，没考勤分，我请问呢😅
176360,9227,阮孝煜,2023-06-28 14:22:27,-29,10,39,傻逼，脑瘫，🦐头老师🐭
176362,9227,阮孝煜,2023-06-28 14:26:17,0,10,10,只适合旁听但是不适合参加该课程考试
176365,9227,阮孝煜,2023-06-28 14:30:04,-20,8,28,大哥你没事吧😅 140道选择认真的吗\n\n这个课真的就只适合听，给分和考试稀碎
176368,9227,阮孝煜,2023-06-28 14:38:36,-17,10,27,无语，真无语\n\n讲课还行，但是课程成绩组成也不提前说，考勤也不算分，整个学期成绩只包含考试，考试一场两场还很难，期末md140道选择题，平时小测给分也不高。最后期末考试直接考多少给多少
176370,9227,阮孝煜,2023-06-28 14:38:34,-16,11,27,就你那卷子谁tm能做，分数组成也极其不科学，没水平别当老师真的笑死
176540,9227,阮孝煜,2023-06-29 08:26:46,13,21,8,老师真的特别特别特别特别好！讲课虽然进度比较慢但是讲得很细很全面，自己肯定是要认真听课做笔记的。一学期有两次听写，改得比较严，但是只要你听写前有自己下过功夫，结果也不会差到哪去。我是平常课后没怎么学西语，但是听写前有专门复习，两次都是95。最后期末考试140个选择题10个翻译，个人感觉时间是完全够的，我做完剩了四十分钟。考的内容基本全是上课讲过的，只要你考前两三天有认真复习做起来还是很顺畅的。最后98满了。老师真的教的很好，但拿高分肯定自己要上课认真听➕做笔记➕考前复习，不要寄希望于老师捞你。
176659,9227,阮孝煜,2023-06-29 15:24:34,7,11,4,真的是很好的老师，负责，其实也蛮严格的。但绝对可以跟着他学到东西。
176775,9227,阮孝煜,2023-06-30 05:37:32,28,31,3,反驳楼上关于老师教学安排和期末考试的言论。首先，学期初老师就说过，平时听写（2次）占比40%，期末考试占比60%，不存在隐瞒成绩构成的情况；第二，期末考试的题型由140道选择题和10道翻译题构成，听上去是很多，但是真的有那么不可理喻吗？先拿lz来说（个例，不能代表全体同学哈，仅作分享）lz没有复习完全，比如西语1学的前六个单元就没有看，12课也没有看；但是期末考试的题目中基本没有完全没见过的知识点，仅有几题是没有记牢而不太确定的；lz是做题一般比较谨慎（就是比较慢哈哈哈），但是也在一小时十五分的时候做完了。虽然题量看上去很大，但是真的大部分都是基础题，只要认真听课了都可以很快做对。而且，考前老师强调过选择题的考查内容（应该是10题为一小题，不太记得了，每小题重点考察一个知识点，比如第一小题考察冠词，第二小题考察代词这样的。具体可以自己看回放。），只要认真听了+有针对性地复习，选择题部分是很轻松的。句子翻译题老师也强调过范围，就是10-12课的重点词汇（有例句的那些），复习了也不会有任何难度。再说听写。两次听写的内容都是动词变位+句子听写（老师念句子，一共4遍，两遍常速两遍慢速带标点），对错都是非黑即白的，没有调分的余地，给分不求是能咋办？
176778,9227,阮孝煜,2023-06-30 05:31:05,14,17,3,反驳楼上关于老师教学安排和期末考试的言论。先说成绩，lz两次听写88，最后总评92.首先，学期初老师就说过，平时听写（2次）占比40%，期末考试占比60%，不存在隐瞒成绩构成的情况；第二，期末考试的题型由140道选择题和10道翻译题构成，听上去是很多，但是真的有那么不可理喻吗？先拿lz来说（个例，不能代表全体同学哈，仅作分享）lz没有复习完全，比如西语1学的前六个单元就没有看，12课也没有看；但是期末考试的题目中基本没有完全没见过的知识点，仅有几题是没有记牢而不太确定的；lz是做题一般比较谨慎（就是比较慢哈哈哈），但是也在一小时十五分的时候做完了。虽然题量看上去很大，但是真的大部分都是基础题，只要认真听课了都可以很快做对。而且，考前老师强调过选择题的考查内容（应该是10题为一小题，不太记得了，每小题重点考察一个知识点，比如第一小题考察冠词，第二小题考察代词这样的。具体可以自己看回放。），只要认真听了+有针对性地复习，选择题部分是很轻松的。句子翻译题老师也强调过范围，就是10-12课的重点词汇（有例句的那些），复习了也不会有任何难度。再说听写。两次听写的内容都是动词变位+句子听写（老师念句子，一共4遍，两遍常速两遍慢速带标点），对错都是非黑即白的，没有调分的余地，给分不求是能咋办？最后说说老师的教学方式。每开一篇新课，老师会先讲语法、再讲单词、讲课文，最后讲评练习题，一整篇新课下来大概3-4个课时。个人认为这样的顺序是非常合理的，因为在熟悉了语法和单词的基础上再学习课文，接受程度会更好，理解难度也会降低；同时，老师的讲解是非常细致的，对于一些重要的知识点会重点讲解，包括举例子、点同学造句或回答问题等等。
176798,9227,阮孝煜,2023-06-30 07:51:50,17,21,4,请那些质疑期末140道选择题&10道翻译题的同学自己反思一下平常的西语课到底有没有在认真听讲，下来有没有认真复习。这个题量看上去很大，但其实都是考的最最基础的西语知识，像冠词、代词、介词等的用法。并且每道题的题干都只有一句话，没有设置什么坑，意思都很好理解。时间是真的绰绰有余，很多同学都可以提前完成试卷。\n\n\n\n顺便夸夸阮老师！真的是超级负责可爱的老师，上课讲的内容很充实，可以学到很多！以及在开学短短几周的里面就可以记住全班同学的西语名字，超级感动qaq \n\n\n\n学习语言是需要付出时间的，没有做好这个准备就请慎重选二外，不要以为二外是来水分的喔！
176829,9227,阮孝煜,2023-06-30 09:38:27,17,19,2,看评论被吓晕…外专业来修西语二每节课都认真听了，最后也认真准备了，考的全是老师强调过的知识。阮老师上课讲的非常细致，有高中英语老师授课的感觉，也有非常多的补充，人还很随和，我不知道评论区里嘴这么臭的人这样一位好老师你们怎么骂得出口的。小语种本来就特殊，需要勤勤恳恳地学，你还指望不听课临时抱佛脚等着分数喂到你嘴边？6级考试抱佛脚都会稀巴烂，何况一门小语种2？
176832,9227,阮孝煜,2023-06-30 10:04:09,-21,3,24,适合听但是不适合考试 最基本的分数构成完全不说明 甚至学生主动去问都遮遮掩掩不明说 用意何在？
179687,9227,阮孝煜,2023-09-19 09:24:34,16,18,2,经理我真的真的真的真的真的很想你。。。。写于西语3课堂
180378,9227,阮孝煜,2023-09-21 10:10:12,16,17,1,西语3第二天，还是好想念经理的一天🥺🥺🥺
180379,9227,阮孝煜,2023-09-21 10:10:47,11,11,0,好想经理…..
181828,9227,阮孝煜,2023-11-02 01:50:37,6,7,1,爱你经理！
181845,9227,阮孝煜,2023-11-02 06:40:27,11,12,1,很好软小鱼，爱来自基础西语
185383,9227,阮孝煜,2023-12-28 14:26:07,6,6,0,经理人特别好！！！做什么都很认真，对学生也超级耐心
189203,9227,阮孝煜,2024-01-22 10:12:24,-6,3,9,给分不好
192830,9227,阮孝煜,2024-05-31 02:37:29,8,8,0,tan amable
195770,9227,阮孝煜,2024-06-30 02:08:10,12,13,1,老师很有人情味，特别会考虑学生自身和其他课程负担，给分也还不错，满昏！
196996,9227,阮孝煜,2024-07-06 12:32:03,-54,1,55,煞笔老师，最最最最最无敌的煞笔，来浙大后唯一一个希望他非升即走走掉的呵呵了。中国外交上课口头点名，每节课提问上一节课讲了什么，自己讲的无聊枯燥没人听讲，点的同学谁回答的出来？评分体系无语至极！全看小组pre和小组论文，小组论文懂得都懂，写再好分数能高到什么地方去，也就是全看pre，既然是小组pre，每个组员的分数还不一样，我的部分当然要和其他成员一起听啊，说我和另一个同学偏题了？我讲例子大哥，我偏什么题，我的组员自会做总结，那不是我的part啊。。。最最无敌的老师，最最无语的打分，不知道您会不会看自己的评分，祝您早日离开，说不定我呆的时间能比您长哈哈哈哈哈哈
201212,9227,阮孝煜,2024-10-30 08:40:45,6,8,2,老师很体贴 对同学很好
206070,9227,阮孝煜,2024-12-13 04:50:07,4,6,2,阮老师真的很好，对课堂富有激情！
215031,9227,阮孝煜,2025-02-20 06:58:53,3,3,0,很体贴学生
215071,9227,阮孝煜,2025-02-20 13:53:28,3,3,0,喜欢喜欢！！备课特别认真的老师！请多多给我们上课吧！
215490,9227,阮孝煜,2025-02-27 01:59:19,5,5,0,喜欢！！进大学以来碰到的第一位好老师！！
220604,9227,阮孝煜,2025-06-19 01:26:19,-1,1,2,一个中国外交水课 每节课点名回答问题 还要好几次课结束之前全体点名 只要有ai痕迹就打低分。。。可以严格 但在一个较水的课上这样做是不是有点反人类了呢？？
173670,9228,阎建玮,2023-05-31 12:45:09,18,24,6,似乎是新来的老师，人还是很好的，会记住班里人的名字
174427,9228,阎建玮,2023-06-12 06:11:15,12,15,3,超好、超喜欢、超爱\n\n感觉有点呆呆的（应该是新老师的缘故）人有点搞笑的，上课氛围比较轻松，会跟学生打招呼！\n\n上课认真负责，是真的想教会我们东西（虽然今年每课的语块整理都要发学在浙大，有点麻烦，但讲真他不这么搞，我可能不会那么勤快整理，还是挺感谢的）
174585,9228,阎建玮,2023-06-14 09:16:04,9,9,0,超级好的老师，非常认真负责！
174619,9228,阎建玮,2023-06-14 14:46:12,8,8,0,老师人真的很好！！！上课很认真也很有收获，人很耐心也很温和，好老师快冲！！真的能学到东西
175106,9228,阎建玮,2023-06-21 13:46:00,5,5,0,挺好的(˵¯͒〰¯͒˵)
175193,9228,阎建玮,2023-06-22 09:09:07,11,11,0,10分，没有任何不给满分的理由，英语四级500出头，大英4捞到3.0，选了一定没错，教得好，事少。人超级好
175215,9228,阎建玮,2023-06-22 12:29:20,8,8,0,你要不选阎老师，我直接哭给你看
175903,9228,阎建玮,2023-06-27 05:50:12,6,6,0,老师很好很温柔，因为是新来的老师所以可能会有一点腼腆，但是很可爱呀(❁´◡`❁)*✲ﾟ*老师会记得班上所有同学的名字，每节课请同学回答问题的时候气氛也不会很紧张，上大英四课是一种享受，每一节课都很开心，学习英语更加有动力了٩(๑ᵒ̴̶̷͈᷄ᗨᵒ̴̶̷͈᷅)و最后给分也很好，感觉老师有捞捞 (ૢ˃ꌂ˂⁎)教学也很认真负责，每个同学的作文都会有评语，非常荣幸能选到老师的课！！！！
179618,9228,阎建玮,2023-09-19 01:36:15,4,4,0,好老师啊
181592,9228,阎建玮,2023-10-24 01:01:50,4,4,0,好好好
182247,9228,阎建玮,2023-11-13 08:15:23,2,2,0,好老师，人超好，但是不知道最后GPA咋样
182248,9228,阎建玮,2023-11-13 08:15:25,1,2,1,好老师，人超好，但是不知道最后GPA咋样
185065,9228,阎建玮,2023-12-26 05:10:32,2,2,0,大爆炸~大爆炸~我的生活大爆炸~\n\n课间的生活大爆炸真的很好玩
185802,9228,阎建玮,2024-01-04 12:51:09,2,2,0,老师很好哇
186310,9228,阎建玮,2024-01-10 12:58:30,3,3,0,好老师，无需多言
186436,9228,阎建玮,2024-01-11 05:12:06,2,2,0,大学英语IV，绩点3.6分，还是很满意的。老师上课很认真很温柔，会记住所有同学的名字，好老师
186438,9228,阎建玮,2024-01-11 05:34:53,4,4,0,大英四出完分特地前来感谢阎老师捞捞~阎老师超级真诚，超级温柔，超级负责，真的会记住每一个同学的名字，每一篇作文也都会写评语。老师口语听起来也很舒服，备课也很认真，课间还会放The Big Bang Theory！当然，大英确实事情比较多，老师还会要求每篇课文整理词组，不过认真整理对quiz还是很有帮助滴。
186443,9228,阎建玮,2024-01-11 05:46:47,1,1,0,好老师，好老师，事少分多，还在等什么，快选他就对了
186500,9228,阎建玮,2024-01-11 11:01:40,1,1,0,大英四的学生。老师超级好，第二节课就记住了好多同学的名字www。上课有引导力，会提一些有趣且发人深思的问题，而且比较风趣，我很喜欢他的课。（P.S.事少给分好，宝藏老师选就对了）
186798,9228,阎建玮,2024-01-13 06:01:30,4,4,0,非常认真负责对待大英4的老师，作业少（基本就是整理词组并拍照），偶尔写作文，上课提问不会刁难，会记住每个同学的名字。老师脾气很好，发音相对标准，课堂氛围也不错，真的值得一选
187358,9228,阎建玮,2024-01-15 15:07:14,3,3,0,事少分高，人很和善而且帅，大英四唯一真神，无需多言，选他就稳了
187722,9228,阎建玮,2024-01-17 08:16:49,3,3,0,事少作业少，教的认真，温柔，会记住学生名字；给分过得去
206121,9228,阎建玮,2024-12-13 05:49:26,3,3,0,老师相当棒，只是我太菜
207583,9228,阎建玮,2024-12-23 07:33:49,6,6,0,太感动了阎老师能记住所有人的名字。
207918,9228,阎建玮,2024-12-25 03:14:35,5,5,0,老师真的很博学！人也很认真很温柔～事情真的很少而且很关心同学们，提的建议都会听ww选他就稳啦！
207920,9228,阎建玮,2024-12-25 03:22:19,8,8,0,阎老师😭人超好。讲课特别有意思，会拓展。像是很温柔的的长辈（但老师很年轻的！）\n\n是我太菜了😭😭
207930,9228,阎建玮,2024-12-25 03:50:20,13,13,0,世界上最温柔、最用心的大英老师！！！答不出问题会鼓励，会很快记住每一个学生的名字。每一次小测都会捞捞，每一次作文批改都会写出你的亮点和需要改进的地方(最低也能拿到12分)。会告诉我们他真正能够决定的只有5分平时分，但行动告诉我们他真的有在自己能力范围之内尽可能拉住每一个人。课堂内容永远充实，是那种希望让学生学得轻松学得快乐尽可能削弱优绩主义带来的影响与冲击，但又不以课堂内容与质量为牺牲的周全考量。啊啊啊不能再写了眼泪汪汪了已经，不想结课想上一辈子阎老师的大英四。只能说10分是查老师的天花板而不是阎老师的，展现出来有限的好是因为我语言的单薄。希望阎老师开更多种类的英语课程，我一定无脑冲！！！
208011,9228,阎建玮,2024-12-25 07:57:09,10,10,0,预置的大英四，随机的缘分，很有幸遇到阎老师
208821,9228,阎建玮,2025-01-02 08:50:18,4,4,0,很温柔很有耐心的老师～
209146,9228,阎建玮,2025-01-04 16:59:43,6,6,0,正如下面的长评论，阎老师就像一个超级好的朋友来给你上课，课上的互动永远是鼓励式的，课间的生活大爆炸也炒鸡好看。相较于其他dayinglaoshi，阎老师会留一定的课后作业，但是你的quiz和final会报答你的。出分前来许个愿，很高兴在入学第一个学期能上到阎老师的英语课
210157,9228,阎建玮,2025-01-08 09:02:40,2,2,0,强推！好老师！课上不push，给大家营造一个温和的学习环境，比较慢节奏，可以充分利用来背单词（bushi）认真听可以对英语文化有更深的了解，总之，推荐！
210374,9228,阎建玮,2025-01-09 04:15:00,1,1,0,老师人真的很好啊，感觉没几节课就把大家的名字全都记住了（会根据座位表点学生回答一些ppt上的内容），一直鼓励式教育。最后绩点差纯粹我菜，老师好！！！
210558,9228,阎建玮,2025-01-09 10:45:23,2,2,0,老师特别好，感觉有捞我555，不过大英大部分分还是靠自己实力。\n\n平时事很少，对英语不太好的uu也会鼓励。
211859,9228,阎建玮,2025-01-12 17:41:52,1,1,0,太好了，太好了
169956,9229,赵苓岑,2023-02-28 15:30:34,19,21,2,很有气质涵养的美女老师( ´▽` )很荣幸能选到您的课。但是不建议将法语作为兴趣去学的人选，因为课都是专业水平要求，而且语速飞快，内容切换飞快。但平时会放歌、有趣视频，一肚子法国墨水^ω^
170963,9229,赵苓岑,2023-03-13 10:44:34,2,3,1,稳定9 大赛发挥20（满分20）
173400,9229,赵苓岑,2023-05-23 06:39:50,3,5,2,人美，教的好，满了～
173747,9229,赵苓岑,2023-06-02 07:11:43,14,15,1,她好美好有气质 我第一次看到她就觉得她就是该教法语的 苓岑真的不会要求次次课必须到教室 有事情可以课后自己补智云 要签到会提前跟大家说 会认真听同学的意见 很友好的苓岑姐姐 回答问题错了的话她会笑然后帮你改正 有的时候讲的会有点点快但大多时候自己复习一下是能跟得上的  我的女神姐姐🥺
174099,9229,赵苓岑,2023-06-06 07:52:13,5,6,1,老师真的很好！
174100,9229,赵苓岑,2023-06-06 07:52:13,1,2,1,老师真的很好！
174928,9229,赵苓岑,2023-06-20 02:46:32,9,10,1,赵苓岑老师我的女神！！！！！好有气质的美女老师，非常自由，不强制到班上课，可以补智云。会随机摇人回答问题，但是答错了也没有关系。脾气很好很温柔。我的女神我的女神我的女神！！！！
175033,9229,赵苓岑,2023-06-21 07:46:02,4,5,1,美女老师真的好耐心！！\n\n就是感觉上课速度有点太快了wwww，拿法语当爱好来学结果总是跟不上要花好多时间补……
175825,9229,赵苓岑,2023-06-27 01:28:55,5,6,1,我要给赵老师把分打上去！
176230,9229,赵苓岑,2023-06-28 06:24:03,2,3,1,超好的老师，就是法语真的太难啦~~
176520,9229,赵苓岑,2023-06-29 07:36:44,16,18,2,祝赵老师母子安康！
177936,9229,赵苓岑,2023-07-05 15:18:50,5,6,1,我滴神
178851,9229,赵苓岑,2023-07-25 18:17:10,2,3,1,是真的可以听智云的🥹
180510,9229,赵苓岑,2023-09-22 06:38:24,5,6,1,人美心善的赵老师！！一伯分！！
191031,9229,赵苓岑,2024-03-29 03:07:44,7,9,2,专业术语对于外专业同学来说还是困难了些
191032,9229,赵苓岑,2024-03-29 03:07:44,2,5,3,专业术语对于外专业同学来说还是困难了些
207487,9229,赵苓岑,2024-12-22 10:38:19,-4,5,9,法国现当代文学极其折磨
208310,9229,赵苓岑,2024-12-26 17:28:03,-5,5,10,法国现当代文学上课极其抽象，非常折磨，上课如同坐牢。
209851,9229,赵苓岑,2025-01-07 08:56:37,7,8,1,这就是我妈不解释
210770,9229,赵苓岑,2025-01-10 02:29:12,7,8,1,坐标法语 I，给分真的太好了🤩 感谢上课经常放视频的热巧巧老师～
215140,9229,赵苓岑,2025-02-22 10:26:54,1,2,1,妈妈我爱你！！！你是我女神！！！人美心善，真的很有气质
220241,9229,赵苓岑,2025-06-16 14:52:48,1,1,0,很热情很有学术精神的好老师
220808,9229,赵苓岑,2025-06-20 01:41:37,3,3,0,女王拿皮鞭抽我，法语视听说一百分，上课真的很创新，这就是我妈妈
220816,9229,赵苓岑,2025-06-20 03:13:37,0,0,0,超级喜欢老师！人特别好！
222086,9229,赵苓岑,2025-06-29 12:46:36,0,0,0,感谢老师带我两年 也算小小入门了吧hh\n\n真的喜欢🥰
199027,10211,周鹏,2024-09-14 06:58:01,31,35,4,学语言的，逻辑严谨。
200069,10211,周鹏,2024-10-12 08:08:41,49,51,2,大一秋冬选上了周老师的《探索人类语言的奥秘》通识课 ⦁֊⦁ \n\n课程本身就很有意思，涉及语言学的发展历史、人类语言的特性、国际音标、动物能否学会人类语言等方面。\n\n课堂互动很多，经常小组讨论，气氛很棒，老师也很鼓励大家发言。\n\n这门课的参考文献很多是全英文的，经常要放全英文的文字资料和研究视频。\n\n（因为周老师以前是在清华教的，所以查老师上没什么人评分，其实是非常随和的老师，讲课的趣味性也适中，(ˊᵕˋ)
201841,10211,周鹏,2024-11-07 01:49:47,32,35,3,老师讲课很有意思，有兴趣的同学可以直接选
202318,10211,周鹏,2024-11-11 14:11:21,43,45,2,上了老师的《探索人类语言的奥秘》老师上课会有特别多有趣的视频，有趣的案例，能学到很多有用有趣的东西。人也非常随和，鼓励大家积极思考讨论，发言是话筒轮流传的。课程内容只要听了就很好理解的。因为语言学国外发展的确实系统，所以涉及了挺多英文概念和理论，刚开始学到音标和各种概念确实有点模糊，但是慢慢就能理解，而且这些概念也没有让大家死记硬背，就是根据一些实例了解含义就可以了。老师说他教这门课不是赶进度，是希望大家真的学到一些东西，能够对语言学感兴趣。和老师一样，也希望语言学能够尽早建立它的范式。
202340,10211,周鹏,2024-11-12 00:54:57,33,35,2,周老师的课很有趣且很丰富，很有启发性，周老师人也非常nice！
202641,10211,周鹏,2024-11-13 14:45:39,36,38,2,很好的老师，从清华来的，课程没啥要求，基本认真听很有收获，从对语言学一无所知到目前也能够对某些问题有自己的看法，得到老师的肯定（也可能是鼓励性质的吧），总觉得有了一定小小的成就感，前几节课会有点偏理论，目前期中来说更接近实践了，有的资料视频真的很有趣，能让人在课堂上忍不住笑出来，很推荐老师的课程，讲的很有深度，还会引导学生深度思考，希望老师能够给分给力一点。
202895,10211,周鹏,2024-11-15 04:43:46,42,43,1,自信有才又有个性的老师，印象很深的是第一节课就和我们说“无论如何我们每个人都拥有一个由语言构成的独特世界对吗？”，顿时感受到老师对语言的理解。并且无论作业还是考试都完全允许AI，可能是出自一种AI绝对不会有真的真知灼见的自信吧，“你们写到1500字是什么水平已经很清楚了。对语言学讲解很透彻，对于描绘语言稍稍侧重（可能是因为语言与思维的关系到现在语言学界几乎也无人解答），有几个案例都是老师自己的研究结果，感觉对于如何解析语言以及语言与思维的关系都有进一步的认识。老师应该是刚来到浙大，很庆幸学期初在没有查老师评分的情况下就“赌”的选了这么课，很有收获。
203627,10211,周鹏,2024-11-20 07:52:58,31,32,1,老师讲得非常好，作业不多，助教姐姐很漂亮（\n\n下午一点多连上三节课完全不是压力，反而非常享受课堂（然而我有时会犯困\n\n现在还没到期末 球球老师和助教姐姐给我高分
203654,10211,周鹏,2024-11-20 10:29:02,25,29,4,老师很好，温柔细心，准备的资料很丰富，很有趣！课堂发言是传话筒，不用卷发言（本i人友好）作业也不是很多，课堂条理清晰！就是感觉学术理论性较强，没啥基础的我有的时候会有点晕晕的，感觉在和老师一起搞研究哈哈哈哈，希望给分好
204294,10211,周鹏,2024-11-25 06:51:51,31,33,2,老师很友好，助教小姐姐真的很漂亮，平时上课也可以划划水，虽然会传话筒提问，但是一般不太难。就课程而言内容丰富，较为有趣，课程毕竟是双语，资料和上课时也会有很多英语，但都会给你解释。如果给分好就是一个很好的老师了！
204636,10211,周鹏,2024-11-27 07:09:23,35,38,3,期中考允许带电脑，期末考提前一周把试题原封不动地告诉你，什么神仙老师！对语言学有兴趣的强烈推荐！
205548,10211,周鹏,2024-12-09 05:28:29,30,34,4,就冲期末考提前一周公布原题来说，就必须打高分
205762,10211,周鹏,2024-12-12 03:07:25,43,44,1,周老师是今年刚从清华来的老师，谦和包容，风趣幽默，很有学者风度。老师备课认真，极富情怀，这里引用老师的一句话：“如果你们中有一个人能够受到启发从事这项事业，那我这门课就算没有白开。”\n\n课程内容本身也很有意思，从语言学发展史到语言的基本结构，从动物语言的可能性到语言和思维的关系等等，无所不包。课堂氛围轻松活泼，会有很多非常有意思的资料和视频，正如楼上同学所说，就像老师手把手带你做科研一样。课上传话筒回答问题，也经常小组讨论，问题难度不高，回答不出来也没什么。每次课都能收获满满。老师上课不点名，但是从来不会有同学舍得翘课；每节课下课时，大家都会自发地鼓掌。\n\n考评方面，不点名，作业是真的少，课下完成的只有两次语言日记（300字以内）和一次小组作业。期中开卷，甚至可以随意使用电子产品；期末闭卷，但是提前一周会发布原题。\n\n如果期末给分好，这将是这门课最微不足道的优点。
206653,10211,周鹏,2024-12-18 09:53:07,23,25,2,神中神
207263,10211,周鹏,2025-01-24 02:57:01,26,28,2,老师有学者风度，风趣幽默，谦和包容，对语言学充满热情，对学生也很好
207586,10211,周鹏,2024-12-23 07:35:08,23,26,3,绝对的好老师，为人儒雅随和，课很有意思，期末考试提前告诉我们题目，事少分高。冲就完了!
207590,10211,周鹏,2024-12-23 07:42:06,22,25,3,很幸运在大一第一学期选了周老师的课，甫一入学便看到了他身上的学者风范，儒士气度。
207705,10211,周鹏,2024-12-24 04:01:25,-9,9,18,上的语言学导论 人好教学水平也是真高 论文也是真难写。。我是弱智我已经写得神经衰弱情绪崩溃感觉随时可能一命呜呼了🏳️🏳️🏳️🏳️🏳️🏳️求老师手下留情如果还开别的专业课的话我还会回来的
207991,10211,周鹏,2024-12-25 06:59:19,25,26,1,强烈推荐啊啊啊啊啊！！！周老师性格稳定，风趣幽默，内容硬核但不无聊，真的是会循循善诱来传授知识和价值观的！《探索人类语言的奥秘》就是这个👍
207998,10211,周鹏,2024-12-25 07:16:54,26,27,1,大三上才选了周老师的《探索语言学的秘密》，之前就听朋友说过这个课很不错，亲身体验后会发现更好，无论是作业、考试还是成绩，希望以后顶天立地，大有所为
208000,10211,周鹏,2024-12-25 07:31:55,24,25,1,就通识课来说，选这门课不亏，老师真的是以希望学生学会知识为主，而不是纯讲，还说如果我们不会，就是他教得不好，老师是希望让语言这方面的知识普遍化，因为老师也有提到国内目前这方面的研究并不多，希望可以透过普及化，让更多感兴趣的人投身到科研上。老师第一眼就看起来是一位非常有涵养的人www上课一开始会问问题复习上一节的内容，课上也会问问题，就是以传话筒的方式回答，每节都看着话筒传到哪了www不会回答也没关系，老师会引导你或是让你传给下一位同学，课上会有小组讨论，讨论的时候助教会巡，但其实也很轻松。作业也就三次语言日记（后两次基本上所有人都给满分了）和一次小组作业，小组是第一节课就分好的了，每节是固定座位。今天最后一节，老师提到了「顶天立地」，和我们平时想的意思并不⼀样，特别是立地，是想让我们所研究的可以化为服务社会的结果。期中考也挺轻松的其实，就是些简答题，可以用电子设备，但老师说Ai也查不到，都是乱吹的www但，反正反正！选这门课不亏！
208541,10211,周鹏,2024-12-29 06:29:39,15,19,4,老师博学儒雅，课程本身也很有趣味性
208610,10211,周鹏,2024-12-30 05:33:28,15,19,4,这学期上了周老师的《探索人类语言的奥秘》，真的很有收获感。我之前没有任何语言学的背景，在老师的带领下，一点一点了解了语言学的相关研究，并且可以对一些语言现象进行分析，探讨语言背后的相关机制。再说说老师，周老师本人很随和，风趣幽默，博学儒雅。强烈推荐！
210021,10211,周鹏,2025-01-08 02:26:14,19,22,3,虽然老师的语言学是有点偏向认知神经学的方法范式的，但老师是我在浙大见过最有人文关怀的老师之一。课上有一章是讲儿童语言障碍和发育行为性疾病，比如孤独症谱系综合症、威廉姆斯综合症之类的。老师在上课反复强调不要以一种治疗疾病的眼光去看待他们，不要“fix them”而是要“live with them”，强调神经多样性的观点。我觉得这恰恰是一门通识课最需要教授的东西：不仅仅的学科相关的知识，更是对待这门学科应有的态度。最后 虽然这门课还没出分，但我想分数是这门课最无关紧要的东西。
210793,10211,周鹏,2025-01-19 13:48:00,22,25,3,老师有个性，有才华，也很幽默，能够让每个同学都发出自己的声音，对语言学理解透彻并且能把这种思维传递给我们
211504,10211,周鹏,2025-01-12 00:10:34,19,21,2,很好的课，老师风趣幽默，善于引导，很有风度。
212034,10211,周鹏,2025-01-13 05:19:07,16,19,3,老师非常好，博学而风趣。课程设置也很有思辨性。
212279,10211,周鹏,2025-01-14 00:12:01,20,21,1,很有内容的课程。非常欣赏老师对语言学的态度和传递给我们的价值观。
212819,10211,周鹏,2025-01-16 02:12:44,19,21,2,老师讲课方式很有意思，很有启发！
212931,10211,周鹏,2025-01-15 09:34:11,21,22,1,我选上课时还没有评分，老师是从清华大学来的，今年应该是第一次带班，我只想说周老师真的特别好，\n\n上课内容非常的硬核，涉及语言学的各种知识\n\n但是考核有非常的简单，平常的几次作业给分都很高，而且期中考试在第8周课上考，可以使用各种电子设备，期末考试提前一周告诉你试题，就6道简答题，提前搜一搜答案记一记考场上直接默写就可以，真的是一个特别好的老师
213138,10211,周鹏,2025-01-16 05:49:44,21,24,3,啊啊啊啊啊啊周鹏老师和助教姐姐真的超级好！！！周老师很很很有人文关怀，上课蛮有意思的能学到很多平时接触不到（lz是理科专业）的知识o(*≧▽≦)ツ 学习语言学的一些知识，了解非典型群体的特征等等，老师上课常强调我们不是要修正他们，而是应该思考怎么更好地和他们生活在一起。\n\n感觉这门课还蛮硬的，老师第一节课就说了这门课是不能水过去的（）课上也会有好多英文的内容，也会让我们读全英论文（后面助教姐姐会带读）和看电影（这个是有一次的作业(◍•ᴗ•◍)），虽然我的英文水平并不高但还是基本能跟上的！上课会先回顾前一节课的内容然后继续讲，老师很会举例子和引导，所以一些知识不知不觉就慢慢强化记住啦。\n\n第一节课抽签分了小组，课上会传话筒（回答一些小问题啊读一下ppt啊，都很简单的，老师会引导，回答不来也没关系传给下一个人就好了），有时候小组讨论或者小组完成一项作业，助教会到处看看并适时提供帮助；期中考开卷可带电子产品，主要是简答题，题目的话一般是老师上课有提到让同学们思考/回答过的，时间也很够；期末考闭卷，六道简答题，最后一节课会告诉原题，整理好背上去就ok，时间也很够。\n\n老师说他和助教都是easy marker，平时分（几次语言日记和小组作业）真的给的很好，期中考老师没公布成绩（说比他预想的要低所以最后得再调整就不公布了），期末考也没公布。刚刚出成绩了大一小登荣获第一个满绩!感动wwwwwwww\n\n老师说对语言学感兴趣的同学都很欢迎联系他和助教，如果这堂课后能有同学深耕这个方向他这门课就不算白上qaq\n\n最后祝大家都能像老师说的那样“顶天立地，大有可为”！！！
213152,10211,周鹏,2025-01-16 06:47:33,14,17,3,好老师，选就对了！
213659,10211,周鹏,2025-01-19 02:31:51,15,17,2,周老师对待课堂内容非常认真投入，还记得他说这门课的目标之一是培养我们的“元语言意识”，一个学期下来学到了很多关于语言学的干货知识！上课气氛轻松，会传话筒回答一些复习的问题或者是朗读、翻译英文论述，回答不出也没有关系。考试是开卷或者给原题，且最后总评老师会捞一档，真的很好！庆幸自己来zju的第一门通识课就遇见了满意的课程
214265,10211,周鹏,2025-01-31 09:03:12,12,16,4,老师教学认真，考虑学生的感受。同时，老师又风度翩翩，温文尔雅，是我学习的典范。
214481,10211,周鹏,2025-02-07 08:38:45,18,20,2,这学期所有课程里最喜欢的老师QWQ，上了老师的语言学导论，对我来说是跨专业的课程但是可以说是几乎没有学习障碍，老师是真的可以用简单易懂的方式让学生学会有一定深度的知识。课堂内容也很有意思，是我上过的少数上课的时候会情不自禁笑出来的课。上课可能会被抽到回答问题，但是问题都很简单，而且就算回答不出来也没关系。有很多有意义的小组讨论环节，学生课堂参与感很强。期末考核方式是完成一篇论文，平时作业也不多，总的来说比较轻松。老师幽默风趣且很有人文关怀，喜欢周老师！
214730,10211,周鹏,2025-02-17 06:29:19,13,15,2,好老师，点赞点赞点赞
214824,10211,周鹏,2025-02-18 05:47:02,-15,4,19,已出分，虽然老师特别好，但是感觉给分一般，我平时小作业和小组作业完成得挺认真的，期末提前给的题目也好好准备了，最后综评85，绩点3.9，有点小伤心
215081,10211,周鹏,2025-02-20 15:59:51,16,17,1,已经很多人夸周老师的为人和授课了，浅浅说说给分。周老师真的是心慈手软的神😭👍不管是平时作业还是期末的research proposal真的是能捞则捞、应捞尽捞，客观题捞不了就附加权分，他真的我哭死😭👍
216583,10211,周鹏,2025-06-18 02:04:07,11,11,0,非常棒的老师，很喜欢老师的讲课风格，很会引导我们去探索和发现
216889,10211,周鹏,2025-03-28 06:29:04,11,11,0,老师的课程很有趣，也能引发思考
217067,10211,周鹏,2025-04-01 05:59:15,9,9,0,第一次选语言学方向的通识课，太有意思了。老师的讲课方式和内容极大地打开了我的思路和对人类语言的认识，赞！
217088,10211,周鹏,2025-04-01 13:34:18,9,9,0,博学而有风度，上课有趣，不只是照本宣科，对语言学感兴趣的人有福了！！
217179,10211,周鹏,2025-04-03 06:38:42,9,9,0,上了老师一门英专的专业课，学术性很强能学到很多东西，一点不水，推荐大一大二的同学去上，了解语言学
217625,10211,周鹏,2025-04-14 08:13:21,10,10,0,去年上了老师的课，得了高分。老师真的是有才华，有温度，能够照顾学生的感受，同时能够以通俗易通的方式把他对语言学的理解传递给大家。
217748,10211,周鹏,2025-04-16 02:04:19,8,8,0,我这学期上的是《探索人类语言的奥秘》，这应该是我上过的最有收获感的一门课程。课程内容很丰富也很有趣，非常推荐对语言学感兴趣的同学去上。
217907,10211,周鹏,2025-04-18 01:22:16,3,3,0,神中神
218823,10211,周鹏,2025-05-07 03:52:44,5,5,0,这学期选修的老师的通识课，很有收获感，就是我心目中理想的课程的样子
218940,10211,周鹏,2025-05-14 02:00:12,6,6,0,浙大有先生，实属我们之幸
219291,10211,周鹏,2025-05-24 08:51:19,3,4,1,非常棒的老师！
219351,10211,周鹏,2025-05-25 14:55:34,0,0,0,无脑冲
220845,10211,周鹏,2025-06-20 05:59:06,2,2,0,很喜欢老师的课，对语言学感兴趣的同学一定要去上，而且老师给分也不错
198693,10268,刘益光,2024-09-11 02:28:02,5,5,0,严谨幽默，对学术有极致的热爱，上刘老师的课是一种享受
198726,10268,刘益光,2024-09-11 06:42:28,4,4,0,好好好
199312,10268,刘益光,2024-09-21 01:07:47,7,8,1,人很好，作业少，效率高，这样的老师哪里找
199326,10268,刘益光,2024-09-21 04:49:58,3,3,0,刘老师很有趣哦！！！
199400,10268,刘益光,2024-09-23 02:40:54,3,3,0,老师认真负责，风趣幽默！
199444,10268,刘益光,2024-09-24 01:19:02,4,4,0,好好好
199512,10268,刘益光,2024-09-25 01:18:24,15,17,2,刘老师很幽默，而且是新老师，跟别的老师教学方式还是很不一样的。很关心我们，听力视频有些难辨别发音，他就自己写完了三分钟的翻译，不是很多老师愿意下这种苦功夫吧。整体教学在reading上是循规蹈矩的先跟读再通篇浏览提问题，但是对各方面的拓展很有心了
199975,10268,刘益光,2024-10-10 05:20:59,5,5,0,好评没得说
201515,10268,刘益光,2024-11-04 04:15:34,3,3,0,好好好
202324,10268,刘益光,2024-11-11 15:08:42,8,8,0,玛雅特别好一老师😘新老师特别有活人气息🤩刚开学还不会骑自行车，选课选得特别差通勤时间很紧，给刘老师说前几周没学会自行车都可能会迟到，本来很忐忑老师态度怎样，结果刘老师还让我路上小心走慢一点😍上课也很好循循善诱🥰quiz前十还会送奖品😚人还特别幽默和蔼
202894,10268,刘益光,2024-11-15 04:43:03,11,12,1,很认真负责的老师，10分奉上。\n\n预置刘老师的同学有福了。\n\n上课有幽默感，很年轻有活力，所以也和同学们有共同语言，上课干货很多。大英有quiz和dictation是必然的，但是刘老师上课讲的很到位，所以其实还好。有一次翻到刘老师的主页，震惊了，30岁的博导...这么优秀的青年学者在给我们上课orz
203935,10268,刘益光,2024-11-22 05:51:12,5,5,0,虽然大英这门课史，但老师还是可以的
204600,10268,刘益光,2024-11-27 03:26:44,6,6,0,人真的超级好的帅气男老师，作业少上课风趣，男神！
205994,10268,刘益光,2024-12-13 02:45:43,3,3,0,刘老师真的很好！！！但是我自己不努力导致成绩没那么好 辜负刘老师了… 一定要珍惜！！！上课认真听就可以！！
206510,10268,刘益光,2024-12-15 15:20:33,4,4,0,老师人巨好，经常没有作业，问他，他说“提高课堂效率”，非常人性化，课堂氛围也很轻松
207188,10268,刘益光,2024-12-19 15:42:39,4,4,0,刘老师我的男神
207922,10268,刘益光,2024-12-25 03:25:12,9,9,0,伟大无需多言。选就完事了。帅哥男神
207927,10268,刘益光,2024-12-25 03:38:28,4,4,0,讲课风格轻松幽默，事情少
207975,10268,刘益光,2024-12-25 06:14:57,11,14,3,刘老师应该是今年的新老师，讲课很仔细很负责任，会耐心地解释生词，小测前十名会发奖品。唯一不足就是老师的发音不是很好听。
208002,10268,刘益光,2024-12-25 07:34:18,7,7,0,超好的老师，quiz和作文都尽可能的给分高，课堂还是很有趣的（因为是年轻老师高强度冲浪），quiz前十和进步的同学还会有奖品，最后一节课也是送了每个同学糖吃。本来补选是抱着什么老师都能接受的心态，结果开盲盒开到宝藏了。
208781,10268,刘益光,2025-01-02 01:04:55,5,5,0,人超好，小测还会给前十和进步的同学发奖品
209112,10268,刘益光,2025-01-04 13:46:38,8,9,1,特别好！to learn to unlearn to relearn
209324,10268,刘益光,2025-01-05 12:09:50,8,8,0,出分前夕来打10分\n大英0分，老师10分\n刘老师教的确实很细很到位\n班里没人挂大英🥰
209879,10268,刘益光,2025-01-07 10:09:32,4,4,0,男神级别的幽默儒雅温柔，只能说在大学的开场遇见这么好的老师实乃一生之幸。虽然大英这门课很难评，能学到的记住的东西也很有限，但刘老师真的有很用心地深挖很多有价值的东西来讲授给我们，不仅仅是language points，更重要的是一些很有意义的思维方式和人生智慧——这也是老师真正想让我们在大英课上收获的、能够受益一生的东西。总而言之，选择不要犹豫，选到务必珍惜。
217752,10268,刘益光,2025-04-16 03:04:42,2,2,0,特别特别好，有趣，有新意，答不上来也会给台阶下，对同学特别好
217807,10268,刘益光,2025-04-16 22:08:42,1,1,0,好好好
220014,10268,刘益光,2025-06-13 13:17:44,1,1,0,想不出不给刘老师满分的理由 刘老师特别特别好！上大英四收获满满的一个学期，刘老师专业水准高，而且很有自己的视野和视角，可以说是真正的英语课堂。而且刘老师人也很好 总之是满分10分肯定要给20分的程度
199745,10288,施嘉伟,2024-09-28 23:07:45,-14,5,19,课堂氛围很好，课间还可以看哈利波特，但你有通知是真什么都不发啊
200990,10288,施嘉伟,2024-10-26 07:00:22,13,15,2,上课之前会放哈利波特，课程确实不错，不局限于课本内容，教学有拓展。上课主要看课件(虽然过的有点快，但是课后会发课件到钉钉里)总的来说还是不错哒！
201899,10288,施嘉伟,2024-11-07 08:44:39,20,20,0,施老师说话很好听，课堂挺欢乐，推荐～
205101,10288,施嘉伟,2024-12-01 12:06:32,14,14,0,同学们还是有点害羞，要是人人都积极参与进来，课堂氛围会更欢乐(上课讨论不会为难学生，知识储备丰富，很好的老师！)
205482,10288,施嘉伟,2024-12-07 12:36:54,17,17,0,施老师挺好的，很博学，也很照顾我们的情绪大家都不会感觉到尴尬或者为难，有在鼓励大家积极表达。而且会记住学生，遇见会主动给我们打招呼。期待期末给分好就真的男神啦！
205683,10288,施嘉伟,2024-12-11 06:41:23,14,14,0,很nice的老师！！
205843,10288,施嘉伟,2024-12-12 08:45:25,10,10,0,老师很好很温柔，上课虽然是主要看ppt，但是也有延伸
205912,10288,施嘉伟,2024-12-12 15:40:04,17,17,0,老师发音和声音都很好听！课堂氛围也比较轻松，会点人回答但不强求。课内之外会讲一些拓展的东西，偶尔会提到自己研究的领域（语言学），感觉很有意思！
205916,10288,施嘉伟,2024-12-12 15:57:31,9,9,0,老师十分博学，上课很有趣，任务量也很少。
206126,10288,施嘉伟,2024-12-13 05:51:43,14,14,0,在我心里就是那种声音好听脾气好性格温柔的文科男生，上课会提到自己的研究领域（挺有趣的哈哈哈），而且事少没pre，钉钉上有问必答已读必回（哪怕你只是说个谢谢他都会回一句没事）\n\n很好的老师
206142,10288,施嘉伟,2024-12-13 06:12:28,8,8,0,作业很少
206713,10288,施嘉伟,2024-12-17 08:01:00,9,9,0,课堂氛围很欢乐，每个人都能得到充分的发言锻炼机会，但不会强求让你尴尬。有求必应，出差国外还给学生带好吃的特产
207009,10288,施嘉伟,2024-12-25 13:34:28,7,8,1,（听说老师以前是清华合唱团的
207869,10288,施嘉伟,2024-12-24 15:22:43,8,8,0,平时分是会捞的，课间是有哈利波特看的，出差回来是会带巧克力的，非常温柔的老师，而且不强求回答问题，简直是我男神！！！
207932,10288,施嘉伟,2024-12-25 03:54:33,8,8,0,祝温文尔雅儒雅和善的施老师圣诞快乐🎄\n\n感谢老师每节课前课间的Harry Potter，感谢老师时不时刷新的巧克力投喂，感谢老师捞满的平时分和不强制的回答问题！\n\nAuld Lang Syne\n\n施老师你是我男神！！！
207935,10288,施嘉伟,2024-12-25 04:00:45,7,7,0,泪目，最后一节课组织小游戏，侥幸收获巧克力一枚(嘻嘻😁)，施老师真的人特别好，选他的课你就偷着乐吧！(Merry Christmas，友谊天长地久！)
208016,10288,施嘉伟,2024-12-25 08:31:44,12,12,0,最后一节课上完啦\n\n预置大英四的时候挺忐忑的，开学初也查不到分数，但也没换，事实证明，惊喜值得期待！\n\n无pre，发言按顺序，作业基本就是偶尔布置教材习题，大英的分数更多还是靠自己双手创造的（我不勤背单词，在此忏悔）老师已经尽力给分内的分数了。\n\n温文尔雅，幽默风趣，博学多才，整体课堂氛围轻松愉快一些，答不出或者作业忘写（问就是我真的忘写了一次）也很包容。\n\n还有，你怎么知道课间可以看哈利波特，你怎么知道老师波士顿回来带了巧克力，你怎么知道最后一节复习课是笑着上的。\n\n今天是圣诞，Merry Xmas!\n\nAuld Lang Syne!
208096,10288,施嘉伟,2024-12-25 14:41:06,6,6,0,🥹🥹🥹😭😭😭👍👍👍👍👍👍👍
208733,10288,施嘉伟,2025-01-01 05:16:16,5,5,0,很好的老师
209076,10288,施嘉伟,2025-01-04 11:03:47,5,7,2,还没出分但我10分来了！！选上施老师的课你就偷着乐吧😎预置上的时候查还没有评分，但开盲盒真让我开着宝了哈哈哈，事少无pre不卷发言不强求回答问题，总之上课超级舒服了。老师人也特别好～最后一节课的goodbye message是友谊天长地久 真的泪目了ww。祝老师做大做强🥳我不允许任何人忤逆你！
209240,10288,施嘉伟,2025-01-05 07:05:45,4,4,0,分还没出来（其他老师的分都登上了），在怀疑是不是在悄悄捞人嘻嘻，施老师很好的，学期初预置大英四还挺忐忑的，但是施老师上课完全感受不到压力，时间很轻松就过了。而且课前一定放哈利波特，导致我现在也入坑啦嘻嘻，出国考察还带巧克力回来给大家，做实验的被试是真的舍得给钱，二十分钟抵上其他的一个小时的价了（），平时分给的也很好的，强烈推荐
209740,10288,施嘉伟,2025-01-07 02:11:22,3,4,1,出分后赶来评价一下，施老师教得很好的，但是大英这门课课程设置比较逆天导致给分不高，不能算是老师的问题。上课还是很轻松愉快的，每个单元结束会报听写，督促背单词，我觉得挺好的，不然小测和期末会吃亏的；课间会放哈利波特，最后一节课还给大家拍了合照纪念
209755,10288,施嘉伟,2025-01-07 03:40:04,4,4,0,很好的老师
209762,10288,施嘉伟,2025-01-07 03:49:09,4,4,0,很好很好的老师！上课会放哈利波特，出差回来会给我们带巧克力，平时也没有pre事情相对比较少，是见识很广的年轻老师！
209848,10288,施嘉伟,2025-01-07 08:53:53,2,3,1,施老师超好的！发言基本都是轮流制，每个人都有锻炼机会，每个单元单词都听写，对我这样的懒蛋起到极大督促作用（虽然每次小测仍然因为太懒惰单词马马虎虎分数糟糕）。老师从波士顿回来还给我们带巧克力！最后一次复习课非常有意思，用游戏的方式复习重点，因为荣获倒数第一的好成绩以及座位地理优势再一次拿到巧克力哈哈哈。超级幸运可以选到这么好的老师，平时的事真的很少。最后分数老师其实也不能怎么样吧，还是要靠自己努力，绩点低只能怪我自己太懒了小测期末成绩不好看。
210154,10288,施嘉伟,2025-01-08 08:57:09,4,4,0,老师真的好啊啊啊啊啊！！单词有小测但是就是督促根本不计分，上课也好细心！
213429,10288,施嘉伟,2025-01-17 09:53:59,3,3,0,一位极有人格魅力的好老师。
214257,10288,施嘉伟,2025-01-31 03:59:41,2,2,0,老师出差还会带礼物
219810,10288,施嘉伟,2025-06-07 03:44:56,0,0,0,伟大无需多言
220216,10288,施嘉伟,2025-06-16 11:32:44,1,1,0,很有风度的老师！老师说这次班上没有fail的同学，并且平均分在平行班中遥遥领先
208708,10361,宣奔昂,2024-12-31 06:49:49,6,11,5,难绷，建议删除
214685,10361,宣奔昂,2025-02-16 22:53:27,-3,7,10,宣老师非常认真负责，是真的想让我们从课堂中学到东西。不仅花大量时间备课，准备前沿知识，不落窠臼，听后非常有启发。并且老师会让同学们相互讨论发表相关问题的观点，进行思想的碰撞，氛围轻松。更重要的一点是老师会给作业的反馈，能很有效地提高我们的写作能力。选宣老师的课就对啦！！！
214978,10361,宣奔昂,2025-02-19 15:39:04,-6,3,9,宣老师的课让我对英美文学有了全新的认识。他的讲解深入浅出，总能将复杂的文学理论和作品背景讲的很好，让每一部经典都变得生动有趣。无论是课堂上的讨论还是课后的思考，宣老师都鼓励我们大胆表达自己的见解，同时引导我们从不同角度去解读作品，这让我受益匪浅。宣老师的课堂氛围轻松而充满活力，他的热情和幽默感让每一节课都变得特别有趣。他不仅注重知识的传授，更注重培养我们的独立思考能力，这让我在学习过程中不仅收获了知识，还学会了如何用更开阔的视野去看待文学和世界。总之，宣老师的课让我对文学的热爱更加深刻，也让我在学习中找到了更多的乐趣和意义。如果有机会，我一定会继续选择宣老师的课程！
215085,10361,宣奔昂,2025-02-20 21:00:11,-6,2,8,作为文学基础or素养比较薄弱的选手，被老师在文学和艺术上的博学和独到的学术眼光深深地折服。跟着老师细读作品，回归文本，不用大谈各种抽象的理论，感觉自己在慢慢沉淀和积累，还蛮有成就感的。
218818,10361,宣奔昂,2025-05-07 02:09:36,16,16,0,带恶人
220944,10361,宣奔昂,2025-06-20 12:10:36,6,6,0,如果不会当老师的话就不要来当老师了好吗？我真的会谢 难评。
221519,10361,宣奔昂,2025-06-24 07:34:22,2,2,0,不喜欢课前预习的宝宝慎选。\n\n不喜欢文学的宝宝慎选。\n\n不喜欢互动的宝宝慎选。\n\n爱用ai的宝宝慎选。\n\ni人宝宝慎选。\n\n不然你就既会感到没参与感，又会收获一个很微妙的结果。😭\n\n不说了，至少这一切都结束了。
221920,10361,宣奔昂,2025-06-27 12:06:11,3,3,0,看到有人在骂我就放心了
198555,10375,李莎,2024-09-10 02:39:58,21,22,1,最好的英语老师！
198679,10375,李莎,2024-09-10 23:34:59,15,15,0,大英三大英四都是李莎老师，上课讲的很好，没有pre，小测分数改的挺高的，很完美
199499,10375,李莎,2024-09-24 14:41:10,16,17,1,事少，通情达理
200151,10375,李莎,2024-10-14 04:54:45,11,11,0,挺不错的
201004,10375,李莎,2024-10-26 12:42:22,9,10,1,很好的老师👍🏻
201135,10375,李莎,2024-10-29 08:09:53,10,10,0,大一，现在目前感觉很好
203357,10375,李莎,2024-11-19 10:37:15,10,11,1,超级好老师，上课会分享她自己的经历，课前就放点小视频，而且超级体贴学生，要不要pre都来征求我们的意见。而且老师非常非常好说话，上次我出车祸了，和老师说一下就请假了，都没有要求有什么什么手续的，然后第二节课还主动来问我有没有事，人怎么样，尸体暖暖的\n\n平时也会有听写什么的，但是不会很苛刻，主要就是为了促进学习的，而且会给听写得很好的同学发小礼物，虽然没有发我，但是不妨碍我吹她。\n\n总之就是非常非常好的老师，然后给分的话，大英课的给分能操作空间不大，所以选好老师就完事啦，选李莎就完事啦～
203789,10375,李莎,2024-11-21 05:28:22,13,13,0,很好的老师，很温柔，不会强制发言，没有杂七杂八的事，上课很有意思
205293,10375,李莎,2024-12-04 03:46:18,12,12,0,无作业无pre
205812,10375,李莎,2024-12-12 06:07:04,3,6,3,事情很少课上挺轻松的适合没那么想学英语的人
205969,10375,李莎,2024-12-13 02:24:49,8,9,1,老师应该是刚上大英没几年，但是上课的时候还是给人感觉很有经验，很有亲和力。预置了李莎老师的大英，真的很幸运。但是就是老师好像是习惯把考试安排（就是quiz内容这些）都放在教学日历里，然后会在开学初就全部展示一遍。对考试和平时的quiz要求较高的同学可能要提前注意一下。\n\nps:忘了说，李莎老师还会主动给听写满分的同学发小礼品，对英语基础不好的同学也很耐心，真的很喜欢李老师！！！
206244,10375,李莎,2024-12-13 10:53:03,6,6,0,非常好老师，事少分高，希望大英四还能选上
206286,10375,李莎,2024-12-13 14:22:38,2,3,1,事少分高，伟大无需多言
206473,10375,李莎,2024-12-15 11:39:38,5,5,0,老师很温柔，上课氛围很好，而且很轻松
206675,10375,李莎,2024-12-17 04:57:36,7,7,0,老师超温柔，又带有小幽默，事情也少，回答问题时会微笑着看着你点头鼓励，总之超级好
206896,10375,李莎,2024-12-18 08:26:15,7,7,0,伟大无需多言
207365,10375,李莎,2024-12-21 02:41:34,7,7,0,很好的老师！
207626,10375,李莎,2024-12-23 10:52:34,12,12,0,"去年上的老师的大英三和大英四，老师很温柔，上课不强制发言，没有作业，听写全对可以拿到老师的小奖励，小测还会帮大家再改高几分。永远记得老师说的""English learning is a lifelong process""，最好的大英老师！"
208076,10375,李莎,2024-12-25 13:02:55,8,8,0,伟大 无需多言。\n\n事真的少，听写不收。
208134,10375,李莎,2024-12-26 01:33:29,6,6,0,老师发fortune cookie 老师好\n\n老师大英三事真少 课上知识点也到位 老师真好\n\n续费续费
208145,10375,李莎,2024-12-26 02:39:37,6,6,0,完美
208214,10375,李莎,2024-12-26 07:42:18,6,6,0,很好的老师，虽然我由于听力不好成绩有点差，但老师真是好人，很关心学生
208570,10375,李莎,2024-12-29 14:04:21,6,6,0,Lisa老师真的是上大学之后见到的为数不多的真正把学生放在心上的老师 我们有问题是可以随时去找她的 我们慧学外语没完成她是比我们还着急的 结课是会发fortune cookie作礼物的 关键是上课从不点名 没pre 课间我们趴下睡觉也会很温柔地敲话筒把我们叫醒 老师其实很幽默很有梗 而且总是一本正经地讲很好笑的话哈哈哈 Lisa老师的课闭眼冲就好啦
208606,10375,李莎,2024-12-30 03:16:05,6,6,0,超级好超级通情达理的老师，小测给分也好，很温柔，喜欢喜欢！！
209032,10375,李莎,2025-01-04 09:07:07,5,5,0,李莎老师真的好 \n\n小测打分也很好\n\n上课也很用心\n\n不会强制发言\n\n课后没有作业\n\n只有两次听写\n\n能选上的都是有福之人\n\n大英三还没出分\n\n但估计不会太差
209295,10375,李莎,2025-01-05 10:57:09,4,4,0,好老师，放心选
209391,10375,李莎,2025-01-06 01:27:53,2,2,0,老师人好极了
209420,10375,李莎,2025-01-06 02:34:29,6,6,0,满分满分 没有任何pre，也没有作业，上课也很老道，而且老师人很温柔很好，有时候也很幽默，总是不经意间玩梗的感觉，小测批的比较松，最后也上4了～～～
209473,10375,李莎,2025-01-06 04:59:53,1,1,0,老师人很好，平时不要求发言，i人狂喜，小测改得很松，可惜下学期没选到她的课
209482,10375,李莎,2025-01-06 05:16:47,1,1,0,挺好的，事少
209491,10375,李莎,2025-01-06 05:35:35,1,1,0,好！好极了！
209492,10375,李莎,2025-01-06 05:36:38,1,1,0,好老师，放心选！
209516,10375,李莎,2025-01-06 07:10:55,2,2,0,事少分高，最完美的老师！\n\n无作业，无pre，上课只有一节课一两次的回答问题，讲课也很有趣！
209541,10375,李莎,2025-01-06 08:11:25,0,0,0,蛮好的老师
209582,10375,李莎,2025-01-06 09:36:06,0,0,0,老师牛逼
209602,10375,李莎,2025-01-06 10:40:46,0,0,0,非常好的老师，很贴心也很幽默
209617,10375,李莎,2025-01-06 11:10:45,1,1,0,喜欢莎莎
214549,10375,李莎,2025-02-12 06:33:18,2,3,1,没有作业没有pre，很好的老师，而且给分挺好
217738,10375,李莎,2025-04-16 00:02:16,2,2,0,很好啊，没有点名，没有作业，没有pre，只有听写和小测，还给听写全对的同学发了小礼品哦
219721,10375,李莎,2025-06-05 00:39:41,2,2,0,Fortune Biscuits😋
219893,10375,李莎,2025-06-10 09:23:45,3,3,0,为什么评论这么少，个人感觉李莎老师应该是大英里面最好的了，事情少，人也好，小测改得也宽，尤其课内翻译那里，几乎随便写都算对了\n\n听写全对有小礼品，我领到了一个小本子嘿嘿
219921,10375,李莎,2025-06-11 06:54:38,2,2,0,母亲般的关怀😭😭
220523,10375,李莎,2025-06-18 11:18:45,1,1,0,很好的大英老师 本人大英四几乎不听课 一直写其他作业 只有两次小测前认真背了单词看课文\n\n再加上期末前一天晚上临时突击刷夜 最后给了我4.2 老师人很好 小测改得松 结课给同学们发幸运饼干 慧学外语还会提醒完成 感觉从小到大英语老师都是我最喜欢的老师🥰
220614,10375,李莎,2025-06-19 02:23:59,0,0,0,最好的大英老师 大英三预置到的时候还没有评分 \n\n太幸运了能上李莎老师的课 通情达理 关心学生 \n\n助教quiz也很捞 ！
221141,10375,李莎,2025-06-21 12:17:02,0,0,0,事少分高的好老师！
197787,10591,Alvaro Lopez Del Rio,2024-08-13 04:11:15,11,15,4,很严格且很认真的老师。人高马大、大光头、络腮胡，长得像北欧维京狂战士，看起来有点凶凶的，其实人很可爱很善良。
200531,10591,Alvaro Lopez Del Rio,2024-10-18 10:13:52,4,6,2,给分一言难尽，完全不懂浙大评价体系。明明都是二外却无法和其他二外打分水平对齐，合着就选西语的是冤种呗😅😅😅
207525,10591,Alvaro Lopez Del Rio,2024-12-22 16:14:09,-9,1,10,人确实很亲切，也看得出来上课很认真，很可爱的大高个。但是期末口语考试要求讲12分钟，提前给4份不同题目随机抽，就等于要准备48分钟左右的语料，千辛万苦准备一场背课文大会，也没有切实考察到口语能力，只能说是纯恶竞哈
219531,10591,Alvaro Lopez Del Rio,2025-05-29 08:41:26,3,5,2,Hola， muy buenas. La clase ha terminado. Ciao ciao ciao
219558,10591,Alvaro Lopez Del Rio,2025-05-29 15:41:50,1,2,1,特别好的alva，上课超级认真，很风趣，有一种独特的幽默感jajaja
219864,10591,Alvaro Lopez Del Rio,2025-06-09 07:26:30,1,2,1,老师特别好，给分和其他语言的相比有点太差了，好伤心。。。。
197131,10592,Minhans Liu,2024-07-08 04:19:44,-5,24,29,德语系唯一真史。
197133,10592,Minhans Liu,2024-07-08 04:23:34,-7,19,26,De Gesellschaft 第一节课上来就说不知道要上什么，整个学期全让学生pre，完了就放视频，究极抽象烂活
197135,10592,Minhans Liu,2024-07-08 04:38:14,-12,17,29,从头到尾只有一套衣服的老鼠精课烂给分也烂
198407,10592,Minhans Liu,2024-09-08 14:39:25,-9,15,24,无力吐槽，就这样吧
198824,10592,Minhans Liu,2024-09-12 03:17:25,-14,11,25,水，上课喜欢放视频
198985,10592,Minhans Liu,2024-09-13 15:39:23,-12,11,23,给分太烂
199284,10592,Minhans Liu,2024-09-20 11:02:31,15,29,14,不知道评论区的同学为什么戾气这么重，老师人很好，很风趣智慧，上课有深刻也有趣味，给分也不错。是德语专业很好的老师！
206229,10592,Minhans Liu,2024-12-13 09:42:15,-18,6,24,两个字，避雷
206489,10592,Minhans Liu,2024-12-15 13:32:12,4,11,7,其实汉民上课挺好的，不过由于本身是德国裔华人（貌似？）普通话讲的不是很好，比较熟悉粤语，英语和德语语速比较快，可能上课会有点吃力\n\n评论区戾气不要太重了。。。
207123,10592,Minhans Liu,2024-12-19 10:24:59,-16,4,20,给分不行
207422,10592,Minhans Liu,2024-12-21 12:55:18,26,30,4,Minhans上课挺好的呀，很欢乐哈哈哈哈
207810,10592,Minhans Liu,2024-12-24 11:10:26,5,8,3,上课挺好玩的 德语一
208409,10592,Minhans Liu,2024-12-27 11:41:39,6,10,4,戾气有点太重了吧..Liu其实是很好一人，对于德语初学者来说课堂还是有趣的。可能确实适应多语系统和口音需要时间，但他本身中文也不错。只能说课堂模式因人而异吧，
208837,10592,Minhans Liu,2025-01-02 10:43:57,-22,5,27,给大一高起作文打88分零起打95分是吧😅
208943,10592,Minhans Liu,2025-01-03 13:09:10,24,27,3,Herr Liu是很好的老师！
210142,10592,Minhans Liu,2025-01-08 08:28:35,27,28,1,有什么教学安排都会和学生讨论，很尊重学生
210413,10592,Minhans Liu,2025-01-09 06:26:25,25,27,2,Herr Liu很搞笑很可爱哈哈哈哈，上课“这是德国人的幽默你们懂吗”，对同学们的提问也会在群里耐心解答
212811,10592,Minhans Liu,2025-01-15 03:19:41,18,21,3,Herr Liu真的很好！查老师分也太低了
214679,10592,Minhans Liu,2025-02-16 15:03:31,3,6,3,不错的老师
214721,10592,Minhans Liu,2025-02-17 05:46:19,5,9,4,很可爱的老师，很喜欢～
215027,10592,Minhans Liu,2025-02-20 06:42:13,13,16,3,评论区里的某些人不要太酸了哈，想想为什么自己分低，自己不行还怪老师，真的炸裂。另外那些人身攻击的我请问呢，有没有点素质。。。老师是很好的老师，别因为自己期末没做好就诋毁别人。
215857,10592,Minhans Liu,2025-03-06 04:42:58,-8,0,8,不看钉钉[笑哭]
216070,10592,Minhans Liu,2025-03-10 07:08:19,3,4,1,挺认真的，上课也蛮轻松，就是进度稍微慢了点
219640,10592,Minhans Liu,2025-06-03 02:20:53,-3,0,3,上课还拉小群，期末考试要求不说清楚
220930,10592,Minhans Liu,2025-06-20 11:23:49,2,2,0,遇到过的最会给情绪价值的老师！！
221367,10592,Minhans Liu,2025-06-23 05:32:21,0,0,0,老师人很好，语法解释得很清晰，也会带大家复习，平时有点小幽默。期末考主要是课后题（早知道狠狠背课后题了），出分应该有捞，总之除了上课进度实在有点慢（真的真的好慢啊老师！要不下次英语授课吧）以外别的都挺好的。
198091,10593,NAOKO KUMADA,2024-08-30 06:31:44,3,5,2,人还蛮好的一个老师，就是回消息有点延迟。上课还算轻松愉快，展示和讨论环节会比较多，怎么不是一种美国style呢。\n\n熊田老师是日语专业来过的，真的有一点学术视野、经历比较丰富的外教，而不像之前喜欢刁难学生的各种怪老头...
214794,10593,NAOKO KUMADA,2025-02-18 02:58:41,1,2,1,老师...你让日专生怎么活 预约一个学期自学
221250,10593,NAOKO KUMADA,2025-06-22 08:29:56,0,0,0,很好的老师
197132,10594,THORSTEN HOLGER MULLER,2024-07-08 04:22:22,25,26,1,daad派来救赎我的真神😭\n\n我的德国男妈妈😭
197134,10594,THORSTEN HOLGER MULLER,2024-07-08 04:24:49,15,15,0,真神，sy老师的后继者
197136,10594,THORSTEN HOLGER MULLER,2024-07-08 04:42:10,14,14,0,很会上课很会教的一歪果仁！我高低得叫一声大爹！
197139,10594,THORSTEN HOLGER MULLER,2024-07-08 04:51:16,14,14,0,唯一真神
198874,10594,THORSTEN HOLGER MULLER,2024-09-12 09:59:32,11,12,1,mueller查老师不到十分我是不会放过各位的😡
198984,10594,THORSTEN HOLGER MULLER,2024-09-13 15:38:07,8,8,0,不给十分的你们什么意思
205668,10594,THORSTEN HOLGER MULLER,2024-12-11 03:58:54,5,5,0,好好好
208101,10594,THORSTEN HOLGER MULLER,2024-12-25 14:51:54,5,5,0,老师真的好好，学到很多
208819,10594,THORSTEN HOLGER MULLER,2025-01-02 08:36:02,8,8,0,特别尊重学生，甚至因为怕大家压力太大取消了原定的期末加试。没架子。上课特别想和学生互动。有一些stereotype，但是思想完全不固化，很愿意听学生说话。
208945,10594,THORSTEN HOLGER MULLER,2025-01-07 12:37:45,12,12,0,Mueller老师讲课很有体系！
209139,10594,THORSTEN HOLGER MULLER,2025-01-04 15:39:11,4,4,0,先上10分，求你明天善待我
212889,10594,THORSTEN HOLGER MULLER,2025-01-15 07:27:02,4,4,0,给分感动得要哭了 真神🥺🥺🥺
215569,10594,THORSTEN HOLGER MULLER,2025-02-28 13:35:33,4,4,0,老师非常非常好诶，比我高中的外教好太多了
216363,10594,THORSTEN HOLGER MULLER,2025-03-14 10:15:29,5,5,0,我亲爱的diu！
217226,10594,THORSTEN HOLGER MULLER,2025-04-05 07:48:19,6,6,0,浙大德语这个家没有mue要散🥹
219639,10594,THORSTEN HOLGER MULLER,2025-06-03 02:18:41,1,1,0,Mue哥是个大好人
221122,10594,THORSTEN HOLGER MULLER,2025-06-21 10:53:51,0,0,0,超级无敌mueller
197788,10595,Weijie Ring Zhao,2024-08-13 04:25:49,-7,5,12,可能是新老师不知道评分规矩，同另一个二外德语平行班相比，给分很烂（本人有德语基础，德语1那期末考试难度考着和玩一样，到课率100%但是因为社恐上课从来不会回答问题，最后出分低低的）。讲课挺有活力的，也看得出来认真备课，想提供多元一点的课堂，比朱更生老师上课更有生趣一些。不知道之后老师有经验后在评分上会不会有改进。
198023,10595,Weijie Ring Zhao,2024-08-25 04:34:47,5,6,1,大一一年做您的班长太幸运了，无比感谢您！DANKE!
198387,10595,Weijie Ring Zhao,2024-09-08 12:08:39,4,4,0,Perfekt!!!!!!
198987,10595,Weijie Ring Zhao,2024-09-13 15:43:08,3,3,0,喜欢老师
203529,10595,Weijie Ring Zhao,2024-11-20 02:50:26,3,3,0,老师是有趣的灵魂，眼中有光，课间还会给我们放音乐
208818,10595,Weijie Ring Zhao,2025-01-02 08:27:24,-3,0,3,不多言
209880,10595,Weijie Ring Zhao,2025-01-07 10:10:06,3,3,0,老师很好
210340,10595,Weijie Ring Zhao,2025-01-09 03:04:38,8,8,0,赵蔚婕你带我走吧 不敢想象上不到你的课我的德语会学成什么鬼样子
210959,10595,Weijie Ring Zhao,2025-01-10 08:43:00,5,5,0,Der innere Reichtum der Leute ist，wie Licht bunt， durch Farbglas hereinzuscheinen.
214899,10595,Weijie Ring Zhao,2025-02-19 03:36:07,3,3,0,非常好啊啊啊啊
198725,10596,张苑,2024-09-11 06:41:52,13,14,1,非常温柔的美女老师😭完全鼓励式教育，太爱了😍😍
198895,10596,张苑,2024-09-12 13:47:11,5,6,1,美女老师超温柔
199007,10596,张苑,2024-09-14 02:46:16,7,7,0,美女老师超绝鼓励式教育
199269,10596,张苑,2024-09-20 07:16:13,5,5,0,美女老师！上课超认真！！
199576,10596,张苑,2024-09-25 15:05:48,6,6,0,很温柔而且很耐心的老师
199991,10596,张苑,2024-10-10 10:43:21,6,6,0,超级喜欢的西班牙语老师！
200120,10596,张苑,2024-10-13 11:15:07,1,1,0,太好啦 ！
201984,10596,张苑,2024-11-08 02:50:14,4,5,1,上课鼓励为主，特别适合入门！！！
203923,10596,张苑,2024-11-22 04:23:03,1,1,0,强烈推荐！！！
205337,10596,张苑,2024-12-04 12:48:30,2,2,0,老师上课很认真，对每一位同学都很关心，节奏也不快，适合入门!!
205460,10596,张苑,2024-12-06 16:54:22,5,5,0,人美心善
206259,10596,张苑,2024-12-13 12:06:08,5,5,0,老师太美了我哭死，直接颜撑课😍😍
206441,10596,张苑,2024-12-15 06:36:39,1,1,0,强烈推荐
208270,10596,张苑,2024-12-26 12:25:28,6,6,0,离了Valeria谁还把我们当小孩子教啊
209268,10596,张苑,2025-01-05 09:19:34,3,3,0,女神级别的！
217388,10743,骆蓉,2025-04-09 11:08:55,3,3,0,女神！！去日本开会会给我们带白色恋人，会努力记住每个同学的名字，lr老师我将永远追随你！！！！
219140,10743,骆蓉,2025-05-22 07:20:50,2,4,2,事情不少的
219761,10743,骆蓉,2025-06-05 07:58:24,1,2,1,课友天天迟到，但老师也没有生气\n\n以德报怨，完不成任务也不会怪你，超多礼物，给我整不好意思了
220145,10743,骆蓉,2025-06-17 09:37:32,-1,0,1,骆老师人很好！！！！！很温柔很美丽的一个老师！！！中国文化与国际传播的内容和四六级的作文和翻译内容超适配，前几天刚复习完，六级就考到了！！！而且课上老师还会带我们品茶，看画！！！骆老师人真的很好啊啊啊啊啊\n\n\n\n成绩出来了！！！再来二评一下！！！！给分挺好的，完全的努力和成绩正相关，只要平时智慧树好好刷，最后期末给的语料库好好背，高绩点不是梦，而且最后期末考也没有考特别难的翻译，被大英4的3.9绩点创飞的我在这门课上得到了4.8的救赎，LR老师就是神无需多言！！！！
220146,10743,骆蓉,2025-06-15 14:02:20,1,1,0,老师人超级好，分低是我不争气，是一个很有情怀的老师，会认真备课，会分享自己的经历，还会带小礼物，态度超级超级认真，鼓励发言，但不强迫，不会说她会引导的，真的超级好！
220288,10743,骆蓉,2025-06-17 06:57:15,0,0,0,温柔美丽的老师！虽然课程任务有点点碎 但是小组合作完成起来还是很快的 而且老师对大家的作业也都是以鼓励引导为主 给分也不错
220339,10743,骆蓉,2025-06-17 10:17:29,1,1,0,怎么说呢，这门课确实事情比较多，但是呢给分也相当不错。智慧树要求的部分看完，期末考要求的语言点认真背了，基本都能拿到不错的分数。
220922,10743,骆蓉,2025-06-20 10:54:09,1,1,0,老师人很负责很温柔，会听取同学们的意见，上课还会带我们品茶吃小零食，课程任务平时还是稍微有一点点多的，但是认真做起来比大英性价比高很多
217460,10746,DIAZ PONCE CAROLINA FABIOLA MARIETT,2025-04-10 16:03:40,6,7,1,女神老师！！超爱上西班牙语课
219328,10746,DIAZ PONCE CAROLINA FABIOLA MARIETT,2025-05-25 09:20:28,4,5,1,Carolina老师有种拉丁人骨子里的热情，每次上课都是活力满满的状态，很能带动气氛，而且还很喜欢音乐，课间都会放西语歌，课上还会用唱歌教单词。老师自己就是西语母语者，所以能教会大家更地道的表达。唯一的缺点是老师中文不太好，有的时候上课提出问题可能会误解意思然后答非所问。
219425,10746,DIAZ PONCE CAROLINA FABIOLA MARIETT,2025-05-27 04:59:38,6,6,0,新老师还没开分，课程体验很好可选，到时候有空再补具体评价。\n\n个人估计开分后至少9.
220067,10746,DIAZ PONCE CAROLINA FABIOLA MARIETT,2025-06-14 12:09:21,5,5,0,给分超好！无脑选！
221396,10746,DIAZ PONCE CAROLINA FABIOLA MARIETT,2025-06-23 08:02:47,4,4,0,西语二出分后来还愿。Carolina老师在捞我上做出的努力比我在考试时做出的努力还要多！
221504,10746,DIAZ PONCE CAROLINA FABIOLA MARIETT,2025-06-24 06:40:19,3,3,0,老师真的太好了！老师上课非常热情，经常鼓励同学们，还会分享很多在智利的趣事，同学要是说西语的时候有错误，她会说“没关系慢慢来”，她说汉语出错的时候同学们也帮她，说“没关系慢慢来”，整个课的氛围很好哈哈哈，感觉大家都在一起进步！西语2真的是我最喜欢上的课！！最后老师给分也特别好，拿到了两年以来除了体育课的第一个满绩！！感谢老师 ¡Muchas gracias!
221514,10746,DIAZ PONCE CAROLINA FABIOLA MARIETT,2025-06-24 06:51:49,3,3,0,太棒了，无脑选，讲课活泼有趣，能学到很多东西，事少给分极好。
221596,10746,DIAZ PONCE CAROLINA FABIOLA MARIETT,2025-06-25 00:45:29,1,1,0,我爱你！！！！！！
221951,10746,DIAZ PONCE CAROLINA FABIOLA MARIETT,2025-06-27 15:11:08,0,0,0,Carolina老师，我将永远追随您
