评论id,老师id,老师姓名,发表时间,点赞减去点踩数量,点赞量,点踩量,内容
4390,1589,李凤旺,2015-06-21 04:40:48,1,2,1,挺幽默的，会拖堂
7144,1674,吴子贵,2015-09-06 08:38:23,2,7,5,讲课巨无聊
15105,1674,吴子贵,2016-01-12 05:30:48,-6,1,7,很一般很一般不过可以水
40441,1674,吴子贵,2017-01-03 10:10:40,-10,2,12,上课我都在抄实验报告来着。。。不过偶尔听一下发现老师还是很幽默的
48466,1674,吴子贵,2017-03-05 11:44:22,-10,3,13,每次要签到，上课一直在那讲，但有时候很有趣。。
53293,1674,吴子贵,2017-06-26 10:01:58,13,15,2,时政讲的可以，但是一讲时政就停不下来，给分一言难尽，不要信均?
55817,1674,吴子贵,2017-07-02 12:10:28,-7,0,7,挺负责认真的。不过形策老师也都那样吧。
85602,1674,吴子贵,2018-07-20 15:01:03,-7,3,10,老师讲课很风趣会结合自己的经历
91623,1674,吴子贵,2018-12-16 12:32:51,7,7,0,太会拖课
91625,1674,吴子贵,2018-12-16 13:27:51,22,26,4,同学们辛辛苦苦收集资料做PPT为什么不给一个机会展示？假期留五千字作业不说了，能不能尊重同学们的劳动成果?
91626,1674,吴子贵,2018-12-16 14:14:49,17,19,2,上课天天吹水，一讲时政根本停不下来，经常拖堂。同学们辛辛苦苦收集资料做ppt准备展示，最后居然有几个组不给展示，结束之后才告诉同学展示作业只占总成绩的5％？
91638,1674,吴子贵,2018-12-17 03:49:11,5,5,0,呵呵呵
91639,1674,吴子贵,2018-12-17 03:49:42,5,6,1,课讲的还行，但是5000字作业是什么想法？
102582,1674,吴子贵,2019-02-11 04:38:47,26,29,3,讲的不知道什么玩意儿，每次疯狂拖课，qq群签到不知道怎么想的。不尊重同学，助教狗腿，官僚得一批，寒假作业5000保底暗示恶竞才有分。说课堂上除了他不允许有第二台电脑，不许干别的事情，可拉倒吧……倒是自信得很，讲点什么助教就带头鼓掌……
104638,1674,吴子贵,2019-03-25 15:55:13,19,19,0,上课疯狂吹牛，官僚主义真的太浓厚了，动不动就说什么书记啊校长啊是什么级别的官员，又说自己天天忙这忙那，张口书记闭口校长的，可能这就是他没有博士学位就爬到副教授职称的秘诀吧。作业蛮多的，假期有五千字论文，现在又弄学习强国。强制积分打卡，学习是好事，但请不要让学习成为形式与强迫。我浙有这样官僚主义的老师真的堪忧。
104734,1674,吴子贵,2019-03-26 16:31:12,10,10,0,五千字寒假调研报告+学习强国800积分+小组展示+拖堂
104821,1674,吴子贵,2019-03-28 08:57:15,6,6,0,竟敢骂副师长？不看看副师长是什么级别的？（滑稽
106577,1674,吴子贵,2019-05-12 12:32:48,6,6,0,经常性拖课，习惯性八点四十五下课：）
107961,1674,吴子贵,2019-05-12 12:39:16,5,5,0,无聊。特别爱拖堂。
108012,1674,吴子贵,2019-05-13 01:33:30,5,5,0,拖堂严重
112528,1674,吴子贵,2019-07-04 17:04:41,20,20,0,有一天我真的很惶恐，老师说总理几个礼拜前和李光耀他老人家见面了。我真的晚上睡不着觉，我一个人瑟瑟发抖，想着是什么把他老人家从棺材里挖出来。
112615,1674,吴子贵,2019-07-05 01:37:22,9,9,0,垃圾，不解释。
112689,1674,吴子贵,2019-07-05 00:32:40,10,10,0,哈哈哈上这个老师第一节课我就知道他要绩杀，果然。
112734,1674,吴子贵,2019-07-05 01:39:20,5,7,2,我靠 假期5000字调研报告+ppt展示+学习强国800积分+巨无敌拖堂，关键是事儿贼多给分还巨无敌烂，上课阴阳怪气，说不能出现电脑。各位朋友选上还是退了吧，其他老师都没有这些作业，啥都没干，给分还好。现在我已经要哭了。
112796,1674,吴子贵,2019-07-05 03:28:48,6,7,1,卡绩...难受...多给一分会怎么样吗
112798,1674,吴子贵,2019-07-05 03:33:10,7,7,0,绩杀绩杀
112802,1674,吴子贵,2019-07-05 03:35:32,6,6,0,绩杀绩杀绩杀
112803,1674,吴子贵,2019-07-05 03:36:35,6,6,0,令人说不出话来
112816,1674,吴子贵,2019-07-05 04:02:10,6,6,0,不要选
112817,1674,吴子贵,2019-07-05 04:13:42,5,5,0,绩杀老师
113368,1674,吴子贵,2019-07-06 10:40:37,6,6,0,绩杀妥妥的
113369,1674,吴子贵,2019-07-06 10:41:39,6,6,0,给分一言难尽 唉
113719,1674,吴子贵,2019-07-07 05:56:37,-14,1,15,老师确实有点官僚主义，事情也挺多的。但是认真背了一下午，平时作业也挺认真，最后4.5的成绩我觉得也可以接受啊...给分还行吧
114881,1674,吴子贵,2019-07-12 08:44:41,4,4,0,。。。
115560,1674,吴子贵,2019-08-03 15:42:14,2,2,0,。。。。。
119513,1674,吴子贵,2019-11-13 07:36:21,3,3,0,假期5000字调研报告+ppt展示+学习强国800积分\n\n期末好好背了 自以为还不错\n\n结果绩杀 现在想起来还耿耿于怀\n\n“因为老师出差了所以成绩要晚一点登记”\n\n呵呵
127920,1674,吴子贵,2020-11-30 08:46:27,2,3,1,真的不大可以！
128317,1674,吴子贵,2020-12-18 06:01:33,2,3,1,一般般
143760,1674,吴子贵,2021-12-05 05:25:19,3,4,1,怎么说呢，选上的同学，祝你好运
149017,1674,吴子贵,2022-01-14 06:51:08,4,5,1,你是真的傻逼啊
155416,1674,吴子贵,2022-06-12 10:07:00,3,5,2,吴子贵老师总是苦口婆心地让我们关注国际大势，我感觉挺不错一个人
155807,1674,吴子贵,2022-06-16 05:14:12,7,7,0,绩杀！
155851,1674,吴子贵,2022-06-16 09:47:54,7,7,0,大绩杀！！
155884,1674,吴子贵,2022-06-16 12:20:52,4,6,2,每次课都点名，但是点完名直接走就可以，听课意义不大甚至为0，就是这老师在装逼而已，每逢上课必要就是本人负责紫金港的什么什么职务之类。。。。。\n\n但是还是拿到了4.5，好像没有那么绩杀，可以参考其他评论。考前看一下ppt就行，反正这次什么浙大精神、冬奥会精神我也不会，简答题大概对了一半的感觉吧，可以在最后作文下下功夫，我是写满了八百字的，结合绩点和讲课打个7分吧
156459,1674,吴子贵,2022-06-20 01:00:27,-8,0,8,觉得老师还行吧，还是挺尊重同学的，对学生也比较友善，去年网课上课前还给我们演奏口风琴，今年事情没有很多吧，横向比较和纵向比较我觉得都还好。最后没上四，不过也可以接受。
163563,1674,吴子贵,2022-12-15 07:33:30,4,4,0,狠狠赞同前排
170867,1674,吴子贵,2023-03-10 18:13:03,8,9,1,八千字写你坟头上好了
170903,1674,吴子贵,2023-03-12 05:07:52,8,8,0,我不懂，凭啥一个行策课，为啥别人不超过1000字的观后感，我们tm就要8000字以上的报告，50页以上的ppt，还有打包参考文献，还图文并茂？？？可能老师没乐子想拿我们找点乐子吧
170904,1674,吴子贵,2023-03-12 05:14:25,5,5,0,离谱捏，形策，八千字以上调研报告，50页以上ppt，图文并茂，造孽啊补天啊，怎么说，选上的同学下辈子好运，阿门
170914,1674,吴子贵,2023-03-12 10:57:23,4,4,0,垃圾老师，依托答辩
170916,1674,吴子贵,2023-03-12 11:05:59,4,4,0,好大的官威
171493,1674,吴子贵,2023-03-26 11:41:49,6,6,0,分低事多还删评？但凡有8k字的报告的评论都删了是吗？
173913,1674,吴子贵,2023-06-04 12:04:36,5,5,0,应老师要求夸夸他，您坟头上的草长得真好
174807,1674,吴子贵,2023-06-18 09:10:41,0,0,0,考前cy
174810,1674,吴子贵,2023-06-18 10:03:24,2,2,0,形式主义，日常装13，高高在上
175646,1674,吴子贵,2023-06-26 04:23:54,0,0,0,卡nmb
178079,1674,吴子贵,2023-07-06 15:37:19,1,1,0,希望老师减轻一下作业要求
6746,2237,顾冬健,2015-07-20 12:29:19,0,0,0,浙大许巍，男神！
174468,6304,陈浩,2023-06-12 16:34:14,-1,0,1,冲着他不鼓励内卷 取消反转课堂就得给10分
192072,6304,陈浩,2024-05-08 16:57:50,0,0,0,老师真名叫做陈昊，可惜查老师上没有。这里给个 9 分，原因是无翻转课堂+Project 几乎都是满分+课讲的还不错，可以说是非常nice的老师了。不足之处，就是上课水平还可以提高~
221787,6304,陈浩,2025-06-26 08:44:52,0,0,0,电气学院陈浩，评价就是一坨，课是讲的烂的，作业是要自学的，还要做一个恶心的大作业，最后期末考试更是一坨
