评论id,老师id,老师姓名,发表时间,点赞减去点踩数量,点赞量,点踩量,内容
212367,9284,宋旭华,2025-01-14 02:17:59,1,1,0,已老实，求出分
214097,9284,宋旭华,2025-01-24 05:19:44,1,1,0,已出分，已老实
167642,9285,王挺斌,2023-01-18 03:22:24,13,17,4,首评，承自裘老一脉，古文字造诣自不必多说。平时说话喜欢打太极
167649,9285,王挺斌,2023-01-18 04:35:41,21,22,1,很帅很亲切捏！老师水平很高，好好听会有很多收获！古文字学冲冲～～
168906,9285,王挺斌,2023-02-23 10:25:47,20,20,0,学科能力毋庸置疑，教学态度也很认真，顺手还送了我几本书，对专业的认识相当深刻，是相当好的老师。
171077,9285,王挺斌,2023-03-15 13:15:11,10,11,1,给我的tbgg打call！
173253,9285,王挺斌,2023-05-17 04:34:55,-5,7,12,古文字当然重要。但讲古代汉语，对解释原文完全没帮助的地方也要花大篇幅讲古文字，就有专业病发作之嫌。
173644,9285,王挺斌,2023-05-31 03:34:43,-25,5,30,为什么没有0分
173681,9285,王挺斌,2023-06-01 06:41:29,8,10,2,斌哥早日做大做强！
184313,9285,王挺斌,2023-12-16 14:27:46,5,5,0,所以虽然还没出成绩，但是先来给淘宝老师打个高分
186882,9285,王挺斌,2024-01-13 11:00:48,5,6,1,老师居然也看death note！（夜神月推狂喜）\n\n上课很有意思！给分也不错嘻嘻（感谢）
189304,9285,王挺斌,2024-01-23 03:40:37,9,9,0,喜欢听淘宝哥课前唠嗑，像朋友一样聊几句。
190719,9285,王挺斌,2024-03-15 14:27:11,-10,3,13,耳朵有点太好使了，和同学坐教室最后一排小声讨论上课内容也能打断他的讲课思路耶～
190854,9285,王挺斌,2024-03-21 15:33:30,6,6,0,淘宝哥！满分！
191047,9285,王挺斌,2024-03-30 06:15:04,3,4,1,每周上淘宝哥的课是我最幸福的时候[疯狂哭泣]我爱文字学啊啊啊啊啊！！！很纯粹地对自己的专业抱有热情的老师，也很有趣很耐心解决同学的问题。水平太高了。
191908,9285,王挺斌,2024-05-04 14:17:33,4,4,0,爱淘宝哥！！！文字学从开始学到考完试都一整个忐忑因为真的很硬核……但是淘宝哥讲课真的是深入浅出，古汉基础没打好但也能听得很明白；出题也还比较友好，基本都是上课强调的重点。老师人也特别好，疯狂赞美！
191982,9285,王挺斌,2024-05-06 16:14:05,4,4,0,文字学 外专业最后拿了2.4（没挂我已经很感激了）\n\n真的很难，教务网上没有标预修要求，但老师在最后几次课才说没上过古汉语的别选这门课，这课还是短学期的弃修不了，最后硬着头皮考的闭卷考试。一个短学期根本没办法入门，而且外专业曾向老师发钉钉求助也没有得到回应。所以外专业的真的不建议选。\n\n老师上课不错，课堂氛围很好，知识也很渊博，个人素养很高，但这课没点基础真学不明白。
193165,9285,王挺斌,2024-06-04 06:17:56,1,1,0,真的赞，王老师很厉害，看得出治学的严谨态度和高超的文字学素养，不得不佩服
202752,9285,王挺斌,2024-11-14 07:04:31,1,1,0,文字学背的昏天地暗总算没挂。除了裘锡圭，感觉《章太炎说文解字授课笔记》也可以看看。
213888,9285,王挺斌,2025-01-21 04:25:30,1,1,0,上的是老师的古典文献学课，因为是给强基班开的所以集中学先秦部分的，老师的课程准备的很充分，也很博学，笨人收获很大，尽管感觉自己很菜。tb老师为了给我们减压把期末考也给取消了，只让我们写论文和做展示。爱他😭
217790,9285,王挺斌,2025-04-16 12:39:50,1,1,0,上的春学期古文字学研究，平时从来不点名，作业很轻松，期末考也不难（和98回忆卷相似度极高
218177,9285,王挺斌,2025-04-22 02:07:59,1,1,0,能学到很多东西\n\n最后考试很难，但是被捞了
218179,9285,王挺斌,2025-04-22 02:24:38,1,1,0,伟大无需多言。古文字你崛起吧！
218181,9285,王挺斌,2025-04-22 02:27:07,1,1,0,特别喜欢淘宝哥，上过三次淘宝哥的课，平时是很小透明不敢找老师说话的那种，，淘宝哥真的很努力的在记每一个人，很尊重每一个学生，应该是考试的时候交论文到讲台上那一下，淘宝哥竟然就记住我的名字了！！很受宠若惊\n\n很喜欢老师上课，文字学概要那本书真的很专业，但是在淘宝哥的帮助下学到了很多东西（其实考试完还会怀疑这一点，会思考是不是我学这门课程只是为了应付考试，，，）直到看到什么文献和字形，立马下意识去分析它的字形结构和本义，从而很好的成为了一个辅助工具，所以真的很感谢老师带来的很优质的课程。\n\n老师给分也不会为难人，综上所述，我不允许任何人忤逆淘宝哥，，，
218283,9285,王挺斌,2025-04-22 10:52:55,1,1,0,感谢tb老师放大一乱选课的小登一条生路，最后恶补一周，成效还不戳
190409,9286,余欣,2024-03-01 08:03:20,4,5,1,“中国古代博物学”课程让我对“博物学”产生了全新的认知——中国博物学不仅是一个知识体系，更是我们在人文语境下理解世界的方式。余老师的讲授与每一次课堂讨论都让人收获颇丰。出土文献、传世史志、域外典籍、考古文物的互证，启发着我们通过思索知识-信仰整体视角下器物的历史学意义，进一步理解“人与物”的关系。
190456,9286,余欣,2024-03-04 15:56:14,2,2,0,2023年2月的某一天，正在选课的我在选课界面的搜索引擎上输入“博物”二字，尝试找寻一门与我专业相关的课程。在选择当儿，我赫然看见余欣老师的“中国古代博物学”课程，便选择了这门课。幸运的是我成功选上，并在余老师的教导下开启我对中国古代博物学的认识。\n\n与西方以“自然”概念和科学观念所构建的“博物学”不同，中国古代博物学中的自然知识构架皆起源于先秦时期的方术，不只是关于自然中“（异）物”本身，还包括了天道人伦等不同的学说，乃至囊括了对于异域的想象和建构。在老师的带领下，我们也从古代中国博物学所塑造的知识，得以一窥当时对世界的想象。\n\n对我来说，这门课程启发了我从博物学的路径，让我认知了不同时代的知识、物质文明和时代精神的趋向，使我获益良多。我由衷地希望，在未来的学习和研究道路上，能结合和运用这堂课上所学习到的知识和研究方法，书写历史上的声音。
190733,9286,余欣,2024-03-16 12:34:44,5,6,1,先生之风，山高水长。另外：助教小姐姐呆呆的好可爱
195036,9286,余欣,2024-06-26 12:52:00,0,3,3,老师讲的不错，但给分在通识课里算低的了
205517,9286,余欣,2024-12-08 12:02:57,6,8,2,本来不是通核的，但也按照通核的形式来上（一节理论课一节讨论课）\n\n讨论课分六组，基本三周一次pre，期中期末另开\n\n主要看分到的小组怎么样，碰到摆的就会辛苦一些\n\n老师博闻多识，是从复旦挖过来的\n\n但是博物学内容比较艰深，需要一定的古代知识基础\n\n不过分组时会尽量保证每组有文史类的同学\n\n好像只有春夏学期会开，总体还是挺好的
169375,9287,张逸旻,2023-02-25 17:02:02,-12,24,36,老师美听课有收获助教善良，好好好好好
169864,9287,张逸旻,2023-05-10 02:50:46,8,32,24,事情真多 听了课之后发现上课不仅语速毫无起伏很无聊而且并没有什么知识性，可能也不是她的研究范围，所以讲的东西并不深入也没有很多价值。或许老师应该思考如何提升自己的课堂内容质量吸引同学听课而不是强制点名且不让用电子设备。
170248,9287,张逸旻,2023-03-02 07:39:20,31,57,26,讲课水平匹配不上超大的任务量
170759,9287,张逸旻,2023-03-09 06:51:11,11,31,20,快逃！！！！！！！！啊！！！！！！！！
170760,9287,张逸旻,2023-03-09 06:56:47,4,17,13,刺激!!!!
170762,9287,张逸旻,2023-03-09 07:04:12,5,20,15,很崩溃
170765,9287,张逸旻,2023-03-09 08:11:12,2,19,17,奇葩^^
170786,9287,张逸旻,2023-03-09 16:04:40,1,15,14,呵呵呵
170787,9287,张逸旻,2023-03-09 16:06:00,0,14,14,难绷。
171135,9287,张逸旻,2023-03-16 14:49:59,-2,14,16,事太多而且上课一般
171359,9287,张逸旻,2023-03-22 09:25:18,-4,11,15,真的很奇葩，事情贼多
171456,9287,张逸旻,2023-03-24 17:58:57,28,52,24,感觉这个老师非常不体谅学生 很高傲的样子 一句话就否定辛辛苦苦的成果 能不能对本科生有点谅解 不是所有人都能想出很多创新点和意义  要是什么事情都有意义 她也不至于天天研究一个人的诗歌十几年不换吧？以及上课事情真的很多
171457,9287,张逸旻,2023-03-24 18:01:12,-6,8,14,事情很多
171808,9287,张逸旻,2023-04-06 08:19:20,-1,7,8,任务量有点大\n\n每节课有要签到\n\n上课不让看手机（电子设备）\n\n但还是给6分吧，只能说勉强及格了。
172111,9287,张逸旻,2023-04-20 00:05:36,-4,10,14,事情真的很多 赞同楼下 态度也挺傲慢 感觉和学生有壁 我经常怀疑她是不是刚从学生时代过来的  为什么对学生一点点共情都不肯给 当然如果最后她专业课给分不错也可以当我没说
172320,9287,张逸旻,2023-04-25 04:42:20,-4,10,14,一直阴阳怪气学生，真的很受不了！每一次上她的课都倍感压力，真的想死！！
172321,9287,张逸旻,2023-04-25 04:49:47,-5,10,15,一直阴阳怪气学生，真的很受不了！每一次上她的课都倍感压力，真的很想死！
172452,9287,张逸旻,2023-04-27 05:34:12,10,31,21,给美女老师救救，老师上课容量和思考性还是很好的~
172730,9287,张逸旻,2023-05-05 11:32:34,15,22,7,客观来说，上课任务量真的很大（至少于我而言就很焦虑，有点难度），但老师上课真的不能说是水，老师真的很强而且讲课真的很好（可能老师上课语调平平会给人一种水的感觉）但真的没看出来大家说的傲慢，感觉老师真的蛮真诚的，反正过程虽然痛苦但确实收获很大
173322,9287,张逸旻,2023-05-19 02:46:24,-4,6,10,事情太多了
173920,9287,张逸旻,2023-06-04 14:15:36,5,18,13,帮老师上个分吧，老师很优雅知性，很博学
174430,9287,张逸旻,2023-06-12 06:23:07,6,16,10,毫无同理心，要求巨多巨麻烦，建议去教世一大的本科生，也许会让她满意，整天一副“我很专业很厉害”的既视感
174539,9287,张逸旻,2023-06-14 01:24:57,7,13,6,前几节课讲的很好，看得出来是精心备课了的，干货满满学到很多，但是后面的课特别是到了图像与诗歌就开始不知所云了，太玄学太牵强了，感觉点同学起来回答都比她讲得好\n\n不过课程总体来说还是有意思的，诗歌之美\n\n事情很多就是了，每节课点名，不让用电子设备，三次一千字小作业，结课作业是真的难，并不是所有学生都有艺术灵感的啊啊
175264,9287,张逸旻,2023-06-23 04:13:05,-1,6,7,事情太多
176488,9287,张逸旻,2023-06-29 05:53:20,10,30,20,之前上课的时候查老师上还没有张老师，今天随手刷到评分，给我吓了一跳。3分开头的老师在我的概念里已经接近十恶不赦的地步了......真不至于吧。老师人还挺好的，之前失意的时候去找过她，她的安慰至今还让我很暖。
177879,9287,张逸旻,2023-07-05 08:06:36,-3,8,11,给个9分吧...希望老师给我高点分数
178179,9287,张逸旻,2023-07-07 15:56:35,2,11,9,给分还是不错的
178187,9287,张逸旻,2023-07-07 17:20:47,3,10,7,要求很严格，给分也很严格
178195,9287,张逸旻,2023-07-08 03:13:52,1,9,8,太无语
178199,9287,张逸旻,2023-07-08 02:03:20,3,12,9,自大会自噬
178213,9287,张逸旻,2023-07-08 05:56:33,20,28,8,张老师今年是第一次开课，我上的是美育课世界名诗导读（问就是马上要去玉泉了，只能着急选一门）。这个课还是颇有争议的，以致于每周我最痛苦的时光就是上这门课，课堂规定上不允许使用电子产品，并且每节课都会高强度提问，但是课堂的内容，至少对于我一个彻头彻尾的工科学生而言是很难吸收的。我认为张老师一个很大的问题在于她认为选这门课的所有学生都具有良好的诗歌欣赏能力和兴趣，但是至少从事实上来看有许多人都是为了美育学分来的。
178216,9287,张逸旻,2023-07-08 07:08:48,5,21,16,这个讲课水平真不知道有什么资格高傲，自诩为艺术家，可能是人家的所谓“艺术”咱不懂吧，那我一本科生的“艺术”您没看懂为社么给我低分呢。本来听说文学院海归的老师风评差，听完之后看来是真的，chunchun niu ma!!!不要因为美育那点小分选这个
178220,9287,张逸旻,2023-07-08 07:36:04,4,12,8,🤣👉🏻🤡
178222,9287,张逸旻,2023-07-08 08:02:26,-5,4,9,呵呵6 是通识课诶
178241,9287,张逸旻,2023-07-08 12:31:15,-1,6,7,水平还可以，后面讲的很玄学。
178333,9287,张逸旻,2023-07-10 06:12:10,9,15,6,对于一个喜欢诗歌的人来说，其实老师讲的还是不错的，如果只是想水美育分，那还是算了吧！
178342,9287,张逸旻,2023-07-10 13:31:38,-10,13,23,我就说一件事吧，这门两位老师一起上的课一直没有“给分低”的风评，但今年其中一位老师换成这位老师后分数就极端了，那问题出在谁身上？我承认我文学水平不好，我本身就不是文学院的，但许多课只要你有付出努力就能得到不错的成绩，这位老师明显没有这种想法。作为一个老师，他只能够拿2分，不能再多了。
178348,9287,张逸旻,2023-07-10 12:43:14,-2,8,10,事多给分少，讲课水平一般，如果这还不算对学生态度傲慢。可惜世界文学史大概逃不掉。\n\n关于老师上课内容，外专业也不用总怀疑自己水平太差吸收不了，老师的讲课水平真的一般。属于我上过的课的老师里比较极端的一位，我觉得她这个评分还挺正常的。
178490,9287,张逸旻,2023-07-12 13:26:42,4,14,10,很无语 给分奇差
178584,9287,张逸旻,2023-07-15 11:10:06,1,8,7,讲课还是可以的但看到分数心梗了
178984,9287,张逸旻,2023-08-12 03:22:06,-1,7,8,逃逃逃
178992,9287,张逸旻,2023-08-15 09:44:14,5,21,16,喜欢的老师，习惯于她每一节课都点名、禁止使用电子设备，每一节课有硬性阅读、提问作业，痛并快乐地享受着很有可能随时被叫起来分享自己问题和感受的焦虑。上课很认真、负责，把syllabus和阅读要求写得清清楚楚，只要有课下的阅读和思考，作为一个工科生来说进入课堂并不困难。老师学术产出蛮多的，非常有专业性，且非常擅长把同学的提问和课堂进程编织在一起，绝对是慎重对待同学提的问题。最后给分也上了90。。。。
179504,9287,张逸旻,2023-09-17 22:40:15,1,10,9,事多给分还差😅
180410,9287,张逸旻,2023-09-21 12:58:13,6,18,12,说实话真的没感觉到其他人说的老师很傲慢...老师真的对学生很认真很负责人也非常温柔 课后排长队去问问题也会有耐心地解答 外国诗歌研究几乎是本学期唯一一节让我非常喜欢的课 ymjj真的是我女神的程度
181013,9287,张逸旻,2023-10-02 10:38:43,-1,13,14,对自己班的人也很“求是”。2.5学分的暑期实习课程，也是计入保研主修专业的课程，别的很多老师不说满绩好歹也是90往上打的吧，张老师给班里的同学打了一堆4.2，请问您知道这有多影响班里同学吗？上专业课要求高给分严我也能理解，但是对于这种课程给这样的分数我真tm醉了。
182050,9287,张逸旻,2023-11-09 04:26:30,18,22,4,外国诗歌研究 对我来说这样一门严禁电子设备、经常点名、强制发言、要求严格的课竟然是体验感最好的一门，老师对诗歌研究非常广博，讲课质量上可能并不是每一节课都能带来惊喜，但是课程安排、课程任务都很清晰，也非常耐心地和学生的交流讨论，在浮躁和功利的学习生活中需要有这样一门能够强迫我去思考的课，只要好好阅读一定有收获
182368,9287,张逸旻,2023-11-15 07:55:30,6,10,4,四分和五分思量再三，还是决定打四分\n\n课不错（除了事情太多），老师也不错\n\n但不是真喜欢，还是别来上了\n\n不太清楚自己是不是真喜欢的，建议旁听
184042,9287,张逸旻,2023-12-07 05:02:40,9,21,12,事多分低，她给我绩点多少，我还她评分多少
184045,9287,张逸旻,2023-12-07 05:51:55,2,13,11,我第一次在查老师上发评论。水平如何我听不出来，只觉得配不上她不让用电子设备的要求吧。上的外国诗歌研究大作业互评89以上，最后3.6。我思来想去不知道为什么。原来是我水平低到这种地步吗。因为亚运志愿者工作请了两次假，正好都遇上她点名没点上。但是我每次课前都跟她请假过，她一次都不回。后来又跟助教说过。真的很莫名其妙，第一次想来发评论，从来没遇到那么无语的人。
184173,9287,张逸旻,2023-12-11 16:15:52,5,15,10,除了诗歌爱好者，其他的没事儿少沾点
184304,9287,张逸旻,2023-12-16 06:19:10,-6,20,26,既上过张老师的世界文学史也上过她的外国诗歌研究，最后给的分数都对得起我在这门课上下的功夫。说张老师傲慢我是完全没有感受到，不管是下课耐心和同学们讨论，还是上课备课的用心我都能感受到。其次我很喜欢世界文学史硬性要求课后阅读材料的要求，由此真的学到很多。以及上课不允许使用电子产品对我而言也随着课程推进而不断变成享受的过程，全神贯注地听课和思绪的联动、课程结束后满满的收获都让我感到幸福。
193571,9287,张逸旻,2024-06-13 06:32:56,2,16,14,极其nt的一节课，上课点名提问，不能使用电子产品，赏析的部分外国诗也极其奇怪，或许是我太俗欣赏不来一点。这是我这学期上得最痛苦的一节课，最后期末还要做个展品，结果自己组织得极其混乱。老师的艺术是高高在上的那种，上课也只是在做最离谱的语文阅读理解，快跑！
194317,9287,张逸旻,2024-06-23 08:29:25,10,22,12,这是我三年以来上过的最糟糕的通识课。极其敷衍的结课展，同学都挤坐在一块，根本看不到其他人的作品，老师您自己倒是看得开心了，我们坐两节课的牢。选取展品的方式也极其敷衍，就看前期填的一个问卷？很多同学那个时候还没有动手做，他们的努力成果完全没有被公正对待，连“被看到”的基本需求都没有被满足，真的太失望了。平时上课有多无聊我就不想吐槽了，恶评如潮我也加一条。
196349,9287,张逸旻,2024-07-03 04:45:00,-1,16,17,反驳一下最新评论说结课展的那位同学，老师根据前期的问卷选的其实只是最后上台展示分享的同学，但最后展出的东西还是以她看到的实物为准的，之前根据问卷选的有些同学她觉得还是比较粗糙，最后也没有展出了。确实我觉得老师最后组织观看的方式不够好，我当时坐在底下也想去看看其他人的作品。作为一个选过老师其他课的学生，我觉得张老师的课对我来说是很享受的，认真上最后拿到的分数也并不低，完全对得起我付出的努力，我和认识的上课认真的同学几乎都满了，甚至有98的高分，但想水水过去拿个还不错的分数确实是不可能的，在我看来底下说给分不好的同学确实都应该反思一下自己的态度或者水平。碍于课程要求的问题或许确实没法要求来上课的人都喜欢外国诗歌，但确实张老师的课对于喜欢诗歌的人来说是很享受的，细读文本的方式也让我受益颇多。
196562,9287,张逸旻,2024-07-04 05:37:56,9,20,11,首先，毕业班同学千万不要选这门课。不然在毕业审核学分但这门课还没出分时，你去问她能不能快点时，你会遇到邮箱、钉钉全方位未读，最后只能和文学院教务科老师打电话才能得到分数的情况。然后就是上课体验，首先基本都需要点名，还会随机cue你回答问题，对于社恐人士或者毕业实习的同学而言，是件非常痛苦的事情。其次上课不能使用电脑手机pad一切电子产品。最后老师上课语气平淡得想睡觉，认真听又没有干货，纯属坐牢2节课。综上，给分非常非常差，事情非常非常多，体验非常非常差。给学弟学妹们一句忠告，还有很多事情少给分好的美育课，去选别的，别碰这个老师！
196841,9287,张逸旻,2024-07-05 12:33:13,2,12,10,太差了，千万别选，选的会在出分后想要剁了自己的手
196846,9287,张逸旻,2024-07-05 13:01:34,1,11,10,课本身挺不错的，老师备课很充分，但是只适合真正喜欢诗歌的同学，作为美育课事情不少大概是两篇essay+期末展品，平时上课不能用电子产品，需要卷发言，个人认为多多发言认真写essay给分还是相当nice的
196912,9287,张逸旻,2024-07-06 01:23:31,0,11,11,听劝，别选
197098,9287,张逸旻,2024-07-07 15:34:09,1,11,10,选了会死
197190,9287,张逸旻,2024-07-09 01:49:25,0,13,13,它只值一分
198578,9287,张逸旻,2024-09-10 05:01:51,-5,9,14,一句话，我至今遇到的最差的一个老师，我上的世界名诗导读，我很用心的去学习，任务也在积极完成，但是给分很低，除此之外，这个老师特别形而上，喜欢批评和自己意见不相同的，给我的感觉就是很歧视很高傲很作很自认为清高的“搞文学的”
198638,9287,张逸旻,2024-09-10 09:48:48,3,9,6,唉ym真的很好
198785,9287,张逸旻,2024-09-11 15:40:48,11,16,5,ym的课也许是我本科阶段上过最特别的一堂课，自愿/被动地收起了电子设备，沉浸在诗意的氛围里，下课后还会觉得余韵悠长，很享受，最后的给分也算对得起我的付出吧。总之，如果你能接受课堂要求，其实还蛮值得的。
199039,9287,张逸旻,2024-09-14 08:54:47,9,14,5,个人觉得老师是有点社恐的，面对很多人不知道做什么表情……结果被一些同学误认为是傲慢或者高冷，课后单独问问题感觉她挺温柔和平易近人的
199180,9287,张逸旻,2024-09-18 15:52:35,-2,7,9,给分真的差，区别对待
199195,9287,张逸旻,2024-09-19 02:42:56,4,13,9,老师人挺好的，恶评太过分了
202006,9287,张逸旻,2024-11-08 04:55:31,4,7,3,别相信世界名诗导读的均绩！别相信！
202126,9287,张逸旻,2024-11-09 18:03:39,2,8,6,老师是有水平的，讲课风格萝卜白菜各有所爱吧
204854,9287,张逸旻,2024-11-28 07:04:56,5,10,5,努力是有回报的，所以想来写一写感受，主要是《春秋》读不下去了\n\n外国诗歌研究（只有文本是英文的，然后会有中文译文，上课是中文）\n\n首先这门课不允许使用电子产品，然后会有几次点名。\n\n成绩构成是发言（量多且要质量）+诗人竞赛（一个展示吧，但是首先得互评，然后选出10个人，那10个人才有资格最后展示）+课程论文（对一位诗人的诗的批判性论文）\n\n因为不让用电子产品，刚开始几节课我上的特别痛苦，特别特别痛苦，前几次课基本上就是困困地听不懂，蠢蠢地发言。\n\n后面突然就慢慢听懂了，然后对某一位诗人的诗很有感觉，发了几次言，（我个人觉得对我来说还是比较高质量的，和班上大佬不能比），然后就开始主动地学习，发言，困也真的就克服了。\n\n那个诗人竞赛，我做的还是很潦草的，然后没被选上，但是由于诗人竞赛上大佬出色的演讲，我就很害怕我的最终成绩，然后我就用尽所有力气去完成最后的诗歌论文。我借了很多书，查了很多资料，那篇论文算得上是我入学以来写的最认真的一篇论文了。现在想想真的很开心啊。\n\n张老师是一位很负责很温柔的老师，她真的用心备课的，然后她会努力去记住每个人的名字，哈哈哈，这个感觉真的不一样，我以为张老师记不住我的，没想到老师记住了，我一开始选课的时候也很害怕，因为查老师风评很不好，但是还是选了，一是因为选必修，二是因为其他的课选不上，三是成绩本来就不好，绩点还是比较摆烂的哈哈哈，但现在回想，还是比较感动的，真的，我还是比较建议中文系的同学去选这门课的，真的是收获很大的。\n\n可能会介意的点：\n\n点名\n\n老师很讲纪律性，中间不允许出去，也不下课\n\n不允许用电子设备\n\n可能会有一点鼓励内卷（发言）\n\n最后作业工作量很大，而且比较要求批判
206253,9287,张逸旻,2024-12-13 11:46:06,2,6,4,冲美育选的名诗导读，一次发言没有，但是论文和大作业认真做了，一次点名没到，最后4.2。给分一般般，上课如果没有人主动举手会一直点人回答问题。感觉还是比较有文学素养的老师，声音也很好听。
209290,9287,张逸旻,2025-01-05 10:41:00,6,10,4,不明白老师为什么分数这么低，，，明明上课是用心安排过的，给分也还不错，就是可能事情对于一门短学期课而言稍多了。\n\n老师不会像高中讲知识点那样一二三地给你串一套“现代诗解读方法论”，但她对文本的智性化解读是值得一听的。
215708,9287,张逸旻,2025-03-04 12:38:06,3,5,2,喜欢老师的风度，适合了解清楚并接受课程要求的对诗歌感兴趣的同学，屏蔽网络打扰沉浸式读诗的感觉很棒！
216259,9287,张逸旻,2025-03-12 18:16:56,4,5,1,老师十分负责，大纲写得很清晰（j人很满意），有时会按人头点名/认人，上课不能使用电子设备，两节课间不休息但有需要可以自行前往卫生间，按要求进入课堂真的能学到许多
217767,9287,张逸旻,2025-04-16 06:54:13,-5,0,5,诗歌赏析得挺好，但是上课那破规矩太多了，还按人头点名。
220206,9287,张逸旻,2025-06-16 09:02:37,1,2,1,这学期上的世界名诗导读，先说几点大家关心的，老师手工点名，上课不允许干其他事情（这一点并不绝对），作业量不算大，两个诗歌短评，一个期末展品（这个略显复杂），这门课上课发言情况以及老师对你的印象对成绩的影响最大，其次是期末展品。我全勤，作业认真做，没有发过言，最后4.2，并不那么满意。\n\n这门课本身是很有意义的，给自己一个时间读读诗挺好，老师的专业性没有问题。上课方式上主要以班上的人发言为主，老师可能是性格原因，我只能说课堂气氛不算轻松活跃。同时题材主要是近现代美国诗，老师的专业性理解可能并不和大家的感性认识那么符合。\n\n总之要打分，我给7分，面板里的4分就这门课程而言我认为不客观。
167123,9791,黄鹏程,2023-01-15 04:26:07,24,24,0,呜呜呜呜呜呜我超棒的班主任！满分满分！
167155,9791,黄鹏程,2023-01-15 04:26:50,24,26,2,徐永明中国文学名家名作的课都是他上的\n\n不点名 人还很有气质 作业也算相对较少的 给分也不错 最后4.8 😍😍😍感天谢地
167207,9791,黄鹏程,2023-01-15 05:43:27,15,15,0,pcgg!
167931,9791,黄鹏程,2023-01-20 11:46:04,21,23,2,老师到这边来上的第一门课，来评价一下。\n\n老师不错，平时布置了两次作业，最后还有一篇课程论文，说过成绩会顶格给。\n\n有一次上课让同学们轮流上去读自己写的读书报告，这在众多课中还是第一次。\n\n老师上课的讲课方式和角度很不一样。可能由于是特聘的副研究员，选的内容和讲的内容既非对文本的翻译，也非对文学的赏析角度，而是从一些比较不一样、比较新的视角来上这门课，体验和其他老师都很不同。\n\n在讲一个作品时，会从其他人的作品或他的其他作品来辅佐阅读理解，从而形成一个开环的阐释和多角度理解。\n\n上课传授的不是成为定论的知识点，会把不同的理解都讲一讲。\n\n上课会准备比较多的内容，奈何时间有限，一般都是讲不太完的。\n\n上课有时会有些停顿和结巴，但是总体感受还是不错的。\n\n老师还比较年轻的吧，最后一节课说把“文学作为一块自留地”，不知道他以后还会开什么课。
168061,9791,黄鹏程,2023-02-05 12:59:20,17,17,0,pcgg!
170640,9791,黄鹏程,2023-03-07 11:24:51,18,18,0,鹏程哥哥很年轻，而且也会讲很多中文系学术研究的方法角度。上课会准备的很认真，作业不是很多。
179680,9791,黄鹏程,2023-09-19 08:20:11,17,17,0,PC哥哥人真的超好！
180036,9791,黄鹏程,2023-09-28 06:45:45,17,18,1,妙！！
181419,9791,黄鹏程,2023-10-17 09:26:38,17,17,0,风格新颖独特的年轻老师！妙！
181509,9791,黄鹏程,2023-10-19 14:08:07,16,16,0,我男神🥰真的特别认真负责的老师，单独和他交流会发现他可爱的一面～
181562,9791,黄鹏程,2023-10-23 02:13:30,17,17,0,打Call！是位备课很认真的老师，会提出一些特别的角度引发思考。可能是新来的，自己上课也会有点小紧张啊哈哈哈哈！很体贴学生。
183556,9791,黄鹏程,2023-11-27 10:11:16,15,15,0,很年轻的老师 人很好 还蛮帅的
187268,9791,黄鹏程,2024-01-15 10:41:41,13,13,0,老师不点名，上课也讲得很有趣！给分也超好！
187277,9791,黄鹏程,2024-01-15 11:21:49,14,15,1,pcgg🥺特别好的老师！名家名作一学期认真写了一篇读书报告+一篇期末论文，并在期中被邀请做了一次展示，最后满啦！🥰
187323,9791,黄鹏程,2024-01-15 13:07:46,-20,6,26,我名家名作被老师卡绩了TAT 这还是我专业课 差一分上四很难过。。。 作业只有论文读书报告 但是我每次都摸不清老师的要求 老师要求挺高的哪怕是大一新生写论文 所以我分数可能拉了
189306,9791,黄鹏程,2024-01-23 03:42:22,17,17,0,好帅，真的好帅
190191,9791,黄鹏程,2024-02-25 06:21:11,11,11,0,非常好！！不鹅颈~~给分超高！！
192824,9791,黄鹏程,2024-05-31 02:18:24,13,13,0,超棒超棒
193296,9791,黄鹏程,2024-06-06 03:33:50,13,13,0,老师人好好！！！
196319,9791,黄鹏程,2024-07-03 01:20:39,10,11,1,明清文学思潮，读《原诗》和《列朝诗集小传》，工作量是不小的，讲课是好的，给分是高的，东西也是能学到的。助教姐姐也好美是可以说的吗……\n\n给分是平时50+期末论文50，平时是《原诗》报告和平时表现（主要体现在提问式点名，好像听课认真老师会记住然后捞一点点），期末是《列朝诗集小传》论文。\n\n但是老师说为了防止平时的印象会请助教按高考双评三评制度给分，所以最后得90+的分主要还是看论文的真正实力，平时表现好也许可以有一个好的保底。老师很想给大家都上90说大家进步很大，但是卡优秀率没办法，最后89应该挺多的。
197950,9791,黄鹏程,2024-08-21 12:33:12,13,13,0,很用心在上课的老师，很帅很可爱哈哈。\n\n上过老师的名家名作和明清文学思潮研究，老师在上课的时候经常还会分享做学术和写文章的方法，真的颇有收获。\n\nBTW给分也无敌好。
198321,9791,黄鹏程,2024-09-07 02:34:09,12,12,0,老师不管上什么课备课都非常认真，绝对不是水课，每节课干货都超级多！而且黄老师给分都是顶格给了，因为学院卡优秀率最后非常多4.5，助教姐姐人美心善，超级耐心的qwq
199504,9791,黄鹏程,2024-09-24 16:21:46,11,11,0,干货批发输出，89分和90+批发给。\n\n人很年轻很nice，愿意和大家聊天，老师还说有空可以和他约乒乓球hh老师好可爱！
205704,9791,黄鹏程,2024-12-11 11:10:24,4,4,0,【名家名作】人很好，偶尔会叫人回答问题。不过没有点名，事少分高
206213,9791,黄鹏程,2024-12-13 08:44:54,11,11,0,pcgg人真的很好，很年轻很帅，每次背着双肩包走进教室上课的时候，如果你不认识他，你会以为他是一个普通的男大hhh，讲课更注重方法上的东西，可能稍稍有一点枯燥，但是对于喜欢古代文学的同学来说应该还是可以学到很多东西的，给分也很好，很理解大家。
208132,9791,黄鹏程,2024-12-26 01:29:05,13,13,0,很棒的老师，学到了很多
211278,9791,黄鹏程,2025-01-11 06:06:51,6,6,0,很棒的老师。
211600,9791,黄鹏程,2025-01-12 03:48:51,6,6,0,【中国文学名家名作】平时无举手发言➕无展示➕认真写论文=满绩\n\n\n\n永远的男神❤️
211619,9791,黄鹏程,2025-01-12 04:33:34,5,5,0,老师文学名家名作上课不是注重特别硬核的知识（当然也有，需要很认真地听），而更多地在于一种更加科学严谨的文学研究的视角和思路，作为基础课非常非常有收获。而且给分非常好。
211638,9791,黄鹏程,2025-01-12 05:47:42,5,5,0,非常好老师，爱老师TT
213593,9791,黄鹏程,2025-01-18 12:36:54,2,2,0,帅帅嘟pcgg，伟大无需多言。
221811,9791,黄鹏程,2025-06-26 11:11:07,0,0,0,爱你pcgg🥰🥰给分超级无敌好，出分那天群里谢谢老师如潮水般涌来～平时没发过言，没展示过，老师看了初版论文提意见后，重新修改一下，最后满啦🥹🥹
198562,10153,赵江红,2024-09-10 03:02:09,0,1,1,抢沙发！！很可爱的姐姐！
218216,10153,赵江红,2025-04-22 05:50:38,1,1,0,不允许任何人忤逆我们赵江红姐姐！真的很喜欢老师！\n\n客观来说，上课很有货，老师很有耐心，很有趣且幽默！！\n\n给分超级好，任务不重，可以和老师协调，老师非常非常非常有耐心！！
219184,10153,赵江红,2025-05-23 01:26:32,2,2,0,女神…妈咪…赵江红老师我跪求你多开点课程好不好…上完之后戒断反应好难受🥹🥹🥹好想你😭😭😭
198339,10330,何诗海,2024-09-07 10:34:24,7,8,1,挺不错的老师
199193,10330,何诗海,2024-09-19 02:40:31,0,0,0,老师人挺好的但是课堂稍微有点沉闷无聊......考试前会给例题，好好按他说的复习应该不会考太差的
208761,10330,何诗海,2025-01-01 12:04:36,2,2,0,老师人很好，很严谨。会引入一些新的视角和问题。
211133,10330,何诗海,2025-01-11 01:19:46,3,3,0,老师人非常好 讲课也很有意思 会讲一些自己的思考 事情很少 发言或者写一次发言稿就行 遗憾的是老师因病没能完成这学期的教学 希望老师能早日康复！健健康康！
212361,10330,何诗海,2025-01-14 02:10:22,2,2,0,老师真的很好，很尊重学生，从小事就能看出来，有同学提醒他用话筒他马上就改还感谢那位同学，出分后让一些同学补交平时作业也用词非常小心真的很好哇，感受到了老师对学生的尊重和用心，身体不好还一直跟同学们道歉真的好好哇老师，不要欺负老师呀
212584,10330,何诗海,2025-01-14 08:44:27,2,2,0,老师讲课比较贴合课本，会较多地结合实际，思路和重点清晰，鼓励自主思考并且非常尊重我们的想法；课下答疑也特别耐心，面对同学们很谦逊，细节拉满。老师身体不舒服仍尽力讲了半学期课TT希望老师健健康康！！
217505,10330,何诗海,2025-04-11 15:27:21,0,0,0,老师尊重学生 气质儒雅 讲课内容也很丰富 有自己的思考 跨专业选中国古代文学史1 课听的很开心 最后分数也很好
201052,10395,徐隆垚,2024-10-28 03:30:10,0,13,13,老师讲课很有意思
201767,10395,徐隆垚,2024-11-06 04:57:52,-2,14,16,老师知识很渊博，旁征博引，一点也不无聊，不点名，也没有课后作业，被王德华摧残后的心灵受到极大的治愈，都给我去报！！！
205528,10395,徐隆垚,2024-12-08 15:55:19,1,18,17,xly的古代文学史3，好课无需多言，三年来足以排到前列的文学院专业课
205760,10395,徐隆垚,2024-12-12 02:42:35,-1,12,13,老师很可爱，不点名，希望真的能教会我们些东西
209103,10395,徐隆垚,2025-01-04 13:17:22,23,30,7,不知道是不是新老师的原因，讲课的内容有点莫名其妙，一学期古代文学史学下来，对于元明清文学还是几乎一窍不通，对于徐老师的学术经历以及研究方向倒是了解了不少。然后老师第一节说不会点名，说大家如果有自己想做的事情可以不来，一学期也确实没点名，但是一旦要讲关于考试、考研这种重要的话题，就故意放下麦克风不让智云课堂的听，我就觉得真没必要这样。
209453,10395,徐隆垚,2025-01-06 03:37:06,-3,12,15,一句话忒好忒可爱。老师学识渊博，而且对于教学有自己的见解。不强制发言，不要求展示，作业少(名家名作他上的部分只布置了一个期末作业)。我想说，他是真的在想怎么样教学才是对学生好。
209792,10395,徐隆垚,2025-01-07 06:15:46,22,25,3,不怎么讲书上的内容，有一种老师学术思想史的既视感
210209,10395,徐隆垚,2025-01-08 11:22:18,1,5,4,名家名作给分特别烂。。。明明去年wdh老师自己上的时候给分还是很好。。。
210296,10395,徐隆垚,2025-01-09 00:54:53,-5,4,9,名家名作前来还愿，感谢老师捞捞我
210766,10395,徐隆垚,2025-01-10 02:23:04,9,13,4,老师第一次开课，人是很有激情很好的，就是对大部分同学的水平存在巨大的误解🤣🤣🤣感觉把大家当做要读这个方向的研究生在教一样。基础知识基本不讲，全部都是思辨和拔高的，让人摸不着头脑。期末考试也很难评，考得很创新，复习也抓不住重点。建议是没有这方面兴趣和比较扎实的功底的同学避雷🥲🥲🥲
210785,10395,徐隆垚,2025-01-10 02:57:51,13,16,3,老师你可以直接扇我的但你还要出套卷子给我谢主隆恩
210833,10395,徐隆垚,2025-01-10 04:54:22,-2,10,12,备考古代文学史三的过程当中虽然也有质疑老师课程安排考试要求有些出尔反尔，但是考完之后真正感受到自己背文学史的功夫都在创意写作和笺注之中发挥出来了，出考场感觉神清气爽。考完后看到老师戏为绝句“油壁轻车待柳郎，苍天枯木演《西厢》。销形化骨魂不灭，梦执桃扇入茗堂”回复大家，几乎要掉泪。第一次感受到浙大文学院的三古学科充满了活力与朝气，昂扬着人文之光，真的是有志于学术的同学不可多得的体验。希望老师明年课程安排务实一些哈哈哈，讲自己的学术成果虽然也有收获但还是不太系统。支持小鲤鱼！！
210854,10395,徐隆垚,2025-01-16 04:31:23,7,12,5,讲课真好，准备真用心，考试也是真抽象。\n\n人文关怀闪烁其间，“独立之精神，自由之思想”，庶几可见，就算挂了我也并不后悔；然而间或流露种种，说是徐师一厢情愿，恐怕伤心，怪只怪我辈学艺不精吧。\n\n\n\n补：分数下来老师均分也变高了，乐......大家打分还是就事论事好点
211034,10395,徐隆垚,2025-01-10 11:20:34,4,6,2,上课体验非常好，提供了很多前沿的思考，对非元明清文学方向的文学生也特别有启发。老师人也很热情。很建议有志于学术的同学选课，一定能收获新的视角和方法
211192,10395,徐隆垚,2025-01-11 03:56:50,4,6,2,徐老师备课很认真，ppt设计上用了不少古典画作，让人不经意间沉浸其中。老师在课上多次诚恳地向我们讲他的作业设计，希望我们在文学史课堂上学到一些东西。诚然，我们会对作业安排和考试内容感到摸不着头脑。但是，这种与日常文学史课不大一样的形式，是一种背弃文学史还是靠近文学史呢？徐老师说，这是大三学生最后一次文学史课，希望我们能有更广阔和系统的视角看待文学史（原句不记得了）。他也在钉钉告诉我们，文学史上的东西会过时，他讲的东西也会过时。私以为他希望教授我们文学史的方法，而非一时一地的具体内容。 这会让我们为难，徐老师的本心是好的，但老实说，对绩点的期待让我们希望老师循规蹈矩。不知道该怎么说，或许老师下一次授课的时候可以提升文学史实的讲授比例吧。希望老师能继续保有教学热情❤️！
211711,10395,徐隆垚,2025-01-12 08:47:18,0,3,3,名家名作我真的谢谢你。。。给分烂的一匹
213052,10395,徐隆垚,2025-01-16 01:34:41,2,3,1,磕一个
213090,10395,徐隆垚,2025-01-16 08:09:10,3,5,2,老师很体谅学生，知道这是核心课，海底捞了我们
213117,10395,徐隆垚,2025-01-16 04:36:40,0,4,4,老公…
213119,10395,徐隆垚,2025-01-16 04:45:52,1,3,2,很复旦（褒义）
213123,10395,徐隆垚,2025-01-16 05:01:46,8,11,3,第一节课的时候就觉得老师很好了。会很认真地准备课程内容，上课语速也是认真听的同学听得很顺畅（这种基本的事情其实是很多老师都没有做好的吧）。文学院对学生的培养相当放任自流，到了大三才有这一位新来的老师给我们认真讲论文的体例，怎么找内网外网的资料。认真分享自己的学术成果，让我们真的了解一点前沿的东西。\n\n说实话准备考试的时候是挺忐忑的，我思辨训练和校读自认为做的很差劲（都是一天写完的），考试的题型也很不知道怎么去做，一度给自己心理建设到三点几算我活该，四点几算我赚了。后来又想，在一种随意给分和多给高分，在分数给得膨胀和不细致的当下，我也真的很想知道外界对自己真实的认知和评价吧，自己到底几斤几两，于是给打什么样的分数都可以。而xly能换位思考我们对分数的焦虑，大幅捞我们，这人真真没得说吧！\n\n\n\n说老师不讲基础知识，不知所云的，让你们一直听百年不换ppt、只讲基础知识的老师的课，出去之后一点学术能力学术前沿的竞争力都没有，就老实了。我很喜欢xly这位新老师，他带来的风气是很好的。老师加油！
213125,10395,徐隆垚,2025-01-16 05:07:38,2,2,0,很好的老师，没得说
213132,10395,徐隆垚,2025-01-16 05:22:13,0,1,1,老师上课很好，很喜欢这样开拓眼界的课堂。老师对学生能力素养培养的关心我们也看在眼里，少有的对学生真诚且热情的老师，换位思考了解浙大的评分习俗更是神来之笔（）\n\n有些同学说老师高估了学生的能力，我想说两点，一是没有多少老师认为我们很厉害，只是懒得用什么方式提高我们的能力，更无论对我们的课程成果（论文或考试）做什么反馈建议，当然也有，比如wwh；二是老师出的卷子已经很开放了也很实在了，一退再退总觉得要求高小心最后退成沙北。不过现在好像也就是这样，比如浙大文学生在同层次大学圈子里就很被看不起吧
213159,10395,徐隆垚,2025-01-16 07:14:20,2,3,1,好老师，真的很关心我们中文系人的能力提升。讲的内容虽然有点硬核但是考试不那么难。给分真的很捞，很期待老师能把浙大汉语言的氛围带起来，汉语言人真的被放养太久了，上课老师的课才体会到汉语言也可以很有思想。好老师好老师好老师
213216,10395,徐隆垚,2025-01-16 11:17:18,0,0,0,无论如何，老师真的很用心，也让我反思，中文系应是一片读书之地。
213219,10395,徐隆垚,2025-01-16 13:56:30,1,1,0,无论如何，xly真的很用心，中文系应该是一片读书之地，哎。
213372,10395,徐隆垚,2025-01-17 05:39:16,0,2,2,我只能说，在最后的答卷中我没有给王实甫他们完整的一生。
213460,10395,徐隆垚,2025-01-17 13:18:09,2,3,1,徐老师是一位知识渊博的老师，希望每一位觉得学习好玩、知识有趣的同学都选他的课，他的课不只有元明清文学，你能收获的远大于此。徐老师也是很谦虚的老师，非常乐意与学生交流，每周五十二点多下课之后，有时候甚至为了某个问题与老师交流，中午饭经常没有吃，老师当然也是。他对学生真的很好，所谓抽象的考试并不是为了为难学生，希望大家放心去选徐老师的课
213695,10395,徐隆垚,2025-01-19 07:35:25,3,3,0,有第一次当老师特有的课程设计感和责任感，关心学生真正学了什么，但同样因为第一次教，在课程作业的设置上有很多生疏的地方。\n\n\n\n老师比较年轻，比较能体会学生的感受同时要求比大部分老师要高，非常建议要考研究生或者保研的同学多与这位老师交流。另外老师从不点名，不用请假，不想来直接不来也行，对想做其他方向的同学也比较友好
213744,10395,徐隆垚,2025-01-19 11:38:08,2,2,0,老师上课不太讲基础知识，但是学术方法和前沿学术思想的普及也让人受益匪浅
197399,10436,边田钢,2024-07-12 13:29:27,3,3,0,老师上课非常注重与同学的互动，古代汉语课会尽力将生涩枯燥的知识用形象生动的语言表达出来。劳动与中国语言文化课程给分比较高。
197776,10436,边田钢,2024-08-12 12:18:38,6,6,0,鋼子終於有査老師了，來給個好評！沒見過比鋼子更親切更愛學生愛專業的老師了，但是對學術也是真的真的熱愛+嚴謹。
197953,10436,边田钢,2024-08-21 12:48:34,3,3,0,大学以来碰到的第一位连听他讲三节课也不会感到丝毫困意的老师。\n\n必须给钢子一百分！！！
198256,10436,边田钢,2024-09-06 02:24:27,2,2,0,超可爱的老师一枚！上课特别生动有趣，互动性超强，老师自称“表演型人格”，给分也挺好的，必须10分！
198926,10436,边田钢,2024-09-13 03:07:16,1,1,0,钢哥真的赞
199192,10436,边田钢,2024-09-19 02:38:13,1,1,0,非常可爱的边老师~考试不难但最后给分比较求是，学古代汉语的朋友要认真复习啊
199201,10436,边田钢,2024-09-19 03:40:56,3,3,0,上的古代汉语，连着三节课听下来也不会觉得累，非常诙谐幽默的老师，对学生也非常亲近友好，最后给分也比较求是，记得复习他上课讲过的繁体字！虽然他说上课不用记笔记，但是最好还是多多少少记一下，这样复习才有抓手，上课很有趣，要认真听哟！但是没有汪老师要求严格也是真的，边老师课上不用背很多，汪老师要背的比较多
204583,10436,边田钢,2024-11-27 02:10:27,0,0,0,说文解字慎选，不知道怎么给分的，什么都用心了，最后只有70多分，真的是大崩溃
204895,10436,边田钢,2024-11-28 11:00:02,1,1,0,\感谢钢子/
205506,10436,边田钢,2024-12-08 07:36:20,3,3,0,钢子我不允许任何人忤逆你
215583,10436,边田钢,2025-03-01 23:55:04,-1,2,3,表面一套背后一套
218390,10436,边田钢,2025-04-23 06:16:08,0,1,1,很真诚的老师，对专业很上心，对学术要求很高但是现在也会尊重学生的志向
219779,10436,边田钢,2025-06-05 14:03:31,1,1,0,怎么会有钢子这么有趣的老师，上课感觉像是单口相声（笑哭）人也超好，谦逊耐心，对本科同学挺好
222013,10436,边田钢,2025-06-29 01:02:32,1,1,0,绝世好老师，古代汉语1疯狂打捞，上课也很有意思，一点也不无聊！！
197681,10672,陈奇佳,2024-07-28 17:54:10,12,20,8,没听出哪儿好，都是概念人名的堆砌
220358,10672,陈奇佳,2025-06-17 12:44:44,1,1,0,非常好的老师！\n\n抛开学期前和后几周，其他时间都会点名，但是只是雷达签到。\n\n有期中作业和期末论文，期中作业是捞平时分的，只需要写自己喜欢的电影和导演。期末论文要求比较高，需要看一部电影然后写论文。感觉老师比较看中切口，好的电影选择和好的切口就已经赢很多了。\n\n可以不听课，但是听的话也会收获挺多，在老师的带领下认识了许多之前从未了解的导演、电影，总之是门挺好的课！
221696,10675,蒋三军,2025-06-25 09:27:55,1,1,0,数字出版，作业只有一篇论文，事少分少
221719,10675,蒋三军,2025-06-25 12:35:28,0,0,0,不点名水课 只有一篇论文 非常水、真的、
203247,10677,虞万里,2024-11-18 10:57:49,0,1,1,老师学问很好，但给分emmm姓名与传统文化已经是第二年开课了，但怎么能比我的音韵学分还低啊……
203283,10677,虞万里,2024-11-19 02:09:26,0,0,0,很可爱很谦和的老师~知识渊博
219155,10677,虞万里,2025-05-22 12:08:03,0,0,0,绝对称得上顶级学者，和蔼敦普的老爷爷，有自己的书斋名“榆枋斋”～不过上课内容有有时会有点艰深难懂，讲中国姓氏起源和发展，考核方式是一篇论文➕最后一节课期末小测试，课程内容是比较有挑战性的，容量也很大，期末背无数个人名姓氏有点辛苦，如果文学素养和知识面比较好的同学可以选来听听看，但如果对上课内容不感兴趣的同学要慎重
206458,10738,戚悦,2024-12-15 09:00:22,8,8,0,沙发！！老师人美讲课也非常有趣，希望有机会还能再上她的课TT
206551,10738,戚悦,2024-12-16 03:52:47,7,7,0,美女老师！！讲课有自己的想法，平时事很少！回复邮件特别特别用心！我写了差不多700多字老师回了好多！（还没出分先给老师打10分）还有就是上次单独找老师交流老师还说对我有印象qaq人美心善！
207117,10738,戚悦,2024-12-19 09:58:25,7,7,0,古代文学史，不点名，课后作业的邮件回复真的很用心！讲课也是很少见的非常有趣的那种，必须满分
207555,10738,戚悦,2024-12-23 04:43:21,7,7,0,老师对文学有很独到的见解，不论是学术观点还是教学都非常有人情味。之前向老师咨询推荐书目，老师列了很详细的表单，还发了书目的pdf。作为大一中文新生，能接触到这样的文学课，真是一件幸福的事。
211134,10738,戚悦,2025-01-11 01:22:07,3,3,0,老师年轻美丽又漂亮！！讲课超级有水平认真负责 上她的课从来不会溜号  给分也很好！！本学期上的最有获得感的一门课！
211259,10738,戚悦,2025-01-11 05:41:44,5,5,0,老师讲课特别认真，富有热情，会有不同于课本的课堂内容和独特的见解，可以学到更丰富的知识和研究问题的视角，答疑和作业回复也特别用心～期末出题紧密围绕课堂内容，所以无论是分数绩点还是能力素养，可以说认真对待就能有所收获！
212100,10738,戚悦,2025-01-13 07:32:51,2,2,0,上课非常好的一位老师
212356,10738,戚悦,2025-01-14 02:07:35,2,2,0,老师很厉害，可以启发很多
212421,10738,戚悦,2025-01-17 00:34:42,2,2,0,超级棒的老师！许愿以后还能上她的课TT
214489,10738,戚悦,2025-02-08 08:29:27,2,2,0,qyjj我爱你😭特别认真特别温柔也特别有思想的好老师！讲课风格比起文学史知识性的传授更像是围绕某个主题思考和启发的专题讲座，很多主题我都非常喜欢并且收获了很多新的视角，尤其老师还很注重女性的古文史书写～邮件回复非常用心，给分也很好，qyjj我还会再来的！
